Run Id,Run Time (UTC),Interval,Subreddit,Ticker Symbol,Total Hype Level,Current Hype Level,Previous Hype Level,Change Hype Level,Posts  #,Upvotes  #, Comments #, Distinct Authors  #,Market Symbol
5299,17-02-2021 14:00,24 hrs.,wallstreetbets,CAI,6,6,0,6,1,1,0,1,NYSE
5299,17-02-2021 14:00,24 hrs.,wallstreetbets,FSR,6,0,6,-6,1,1,0,1,NYSE
5299,17-02-2021 14:00,24 hrs.,wallstreetbets,GME,21315,529,20786,-20257,40,9628,1899,31,NYSE
5299,17-02-2021 14:00,24 hrs.,wallstreetbets,HPE,7,0,7,-7,1,1,1,1,NYSE
5299,17-02-2021 14:00,24 hrs.,wallstreetbets,IBM,4,4,0,4,1,0,0,1,NYSE
5299,17-02-2021 14:00,24 hrs.,wallstreetbets,IFF,6,0,6,-6,1,1,0,1,NYSE
5299,17-02-2021 14:00,24 hrs.,wallstreetbets,MAC,7,0,7,-7,1,1,1,1,NYSE
5299,17-02-2021 14:00,24 hrs.,wallstreetbets,MRK,7,0,7,-7,1,1,1,1,NYSE
5299,17-02-2021 14:00,24 hrs.,wallstreetbets,NGA,7,0,7,-7,1,1,1,1,NYSE
5299,17-02-2021 14:00,24 hrs.,wallstreetbets,NOK,40,12,28,-16,6,6,4,4,NYSE
5299,17-02-2021 14:00,24 hrs.,wallstreetbets,PFE,14,0,14,-14,2,2,2,1,NYSE
5299,17-02-2021 14:00,24 hrs.,wallstreetbets,PPL,7,0,7,-7,1,1,1,1,NYSE
5299,17-02-2021 14:00,24 hrs.,wallstreetbets,PSA,13,13,0,13,2,2,1,2,NYSE
5299,17-02-2021 14:00,24 hrs.,wallstreetbets,SOS,21,0,21,-21,3,3,3,3,NYSE
5299,17-02-2021 14:00,24 hrs.,SPACs,NAV,1086,0,1086,-1086,1,288,506,1,NYSE
5299,17-02-2021 14:00,24 hrs.,SPACs,AJAX,13,0,13,-13,1,0,9,1,NYSE
5299,17-02-2021 14:00,24 hrs.,SPACs,ALUS,7,0,7,-7,1,1,1,1,NYSE
5299,17-02-2021 14:00,24 hrs.,SPACs,CCIV,2786,19,2767,-2748,5,1028,710,4,NYSE
5299,17-02-2021 14:00,24 hrs.,SPACs,FUSE,29,0,29,-29,3,4,9,3,NYSE
5299,17-02-2021 14:00,24 hrs.,SPACs,GSAH,7,0,7,-7,1,1,1,1,NYSE
5299,17-02-2021 14:00,24 hrs.,SPACs,PSTH,27,0,27,-27,1,0,23,1,NYSE
5299,17-02-2021 14:00,24 hrs.,SPACs,SCVX,7,0,7,-7,1,1,1,1,NYSE
5299,17-02-2021 14:00,24 hrs.,SPACs,STPK,82,0,82,-82,1,19,40,1,NYSE
5299,17-02-2021 14:00,24 hrs.,SPACs,AACQ,233,0,233,-233,1,96,37,1,NASDAQ
5299,17-02-2021 14:00,24 hrs.,SPACs,CFAC,21,0,21,-21,1,3,11,1,NASDAQ
5299,17-02-2021 14:00,24 hrs.,SPACs,NGAC,17,0,17,-17,2,1,7,1,NASDAQ
5299,17-02-2021 14:00,24 hrs.,SPACs,THCB,8,0,8,-8,1,1,2,1,NASDAQ
5299,17-02-2021 14:00,24 hrs.,stocks,SENS,6,0,6,-6,1,1,0,1,AMEX
5299,17-02-2021 14:00,24 hrs.,stocks,AYX,6,6,0,6,1,1,0,1,NYSE
5299,17-02-2021 14:00,24 hrs.,stocks,GME,62,62,0,62,1,2,54,1,NYSE
5299,17-02-2021 14:00,24 hrs.,stocks,GPS,153,153,0,153,1,42,65,1,NYSE
5299,17-02-2021 14:00,24 hrs.,stocks,MRK,30,0,30,-30,1,9,8,1,NYSE
5299,17-02-2021 14:00,24 hrs.,stocks,NET,82,82,0,82,1,30,18,1,NYSE
5299,17-02-2021 14:00,24 hrs.,stocks,RKT,82,0,82,-82,1,31,16,1,NYSE
5299,17-02-2021 14:00,24 hrs.,stocks,APRN,6,6,0,6,1,1,0,1,NYSE
5299,17-02-2021 14:00,24 hrs.,stocks,FVRR,6,0,6,-6,1,1,0,1,NYSE
5299,17-02-2021 14:00,24 hrs.,stocks,PANW,82,82,0,82,1,30,18,1,NYSE
5299,17-02-2021 14:00,24 hrs.,stocks,OGI,7,7,0,7,1,1,1,1,NASDAQ
5299,17-02-2021 14:00,24 hrs.,stocks,OSW,6,0,6,-6,1,1,0,1,NASDAQ
5299,17-02-2021 14:00,24 hrs.,stocks,SLS,153,153,0,153,1,42,65,1,NASDAQ
5299,17-02-2021 14:00,24 hrs.,stocks,AGTC,74,0,74,-74,1,19,32,1,NASDAQ
5299,17-02-2021 14:00,24 hrs.,stocks,AMTX,6,0,6,-6,1,1,0,1,NASDAQ
5299,17-02-2021 14:00,24 hrs.,stocks,APHA,6,0,6,-6,1,1,0,1,NASDAQ
5299,17-02-2021 14:00,24 hrs.,stocks,AVCT,6,0,6,-6,1,1,0,1,NASDAQ
5299,17-02-2021 14:00,24 hrs.,stocks,AXSM,6,0,6,-6,1,1,0,1,NASDAQ
5299,17-02-2021 14:00,24 hrs.,stocks,CRWD,82,82,0,82,1,30,18,1,NASDAQ
5299,17-02-2021 14:00,24 hrs.,stocks,CTRM,7,0,7,-7,1,1,1,1,NASDAQ
5299,17-02-2021 14:00,24 hrs.,stocks,CTSO,31,0,31,-31,1,11,5,1,NASDAQ
5299,17-02-2021 14:00,24 hrs.,stocks,FTNT,82,82,0,82,1,30,18,1,NASDAQ
5299,17-02-2021 14:00,24 hrs.,stocks,IBKR,6,0,6,-6,1,0,2,1,NASDAQ
5299,17-02-2021 14:00,24 hrs.,stocks,IMVT,6,6,0,6,1,1,0,1,NASDAQ
5299,17-02-2021 14:00,24 hrs.,stocks,LIVE,6,6,0,6,1,1,0,1,NASDAQ
5299,17-02-2021 14:00,24 hrs.,stocks,MICT,6,0,6,-6,1,1,0,1,NASDAQ
5299,17-02-2021 14:00,24 hrs.,stocks,MOGO,6,0,6,-6,1,1,0,1,NASDAQ
5299,17-02-2021 14:00,24 hrs.,stocks,NKLA,24,0,24,-24,1,4,12,1,NASDAQ
5299,17-02-2021 14:00,24 hrs.,stocks,OKTA,82,82,0,82,1,30,18,1,NASDAQ
5299,17-02-2021 14:00,24 hrs.,stocks,ONTX,6,0,6,-6,1,1,0,1,NASDAQ
5299,17-02-2021 14:00,24 hrs.,stocks,SNBR,6,0,6,-6,1,1,0,1,NASDAQ
5299,17-02-2021 14:00,24 hrs.,stocks,TLRY,6,0,6,-6,1,1,0,1,NASDAQ
5299,17-02-2021 14:00,24 hrs.,stocks,TSLA,153,153,0,153,1,42,65,1,NASDAQ
5299,17-02-2021 14:00,24 hrs.,stocks,USWS,7,0,7,-7,1,1,1,1,NASDAQ
5299,17-02-2021 14:00,24 hrs.,Daytrading,COMS,14,14,0,14,1,1,8,1,OTC
5299,17-02-2021 14:00,24 hrs.,wallstreetbets,LKCO,15,0,15,-15,2,2,3,2,NASDAQ
5299,17-02-2021 14:00,24 hrs.,wallstreetbets,MARA,14,0,14,-14,2,2,2,2,NASDAQ
5299,17-02-2021 14:00,24 hrs.,wallstreetbets,MAXN,13,0,13,-13,2,2,1,1,NASDAQ
5299,17-02-2021 14:00,24 hrs.,wallstreetbets,MGPI,6,6,0,6,1,1,0,1,NASDAQ
5299,17-02-2021 14:00,24 hrs.,wallstreetbets,MRNA,6,6,0,6,1,1,0,1,NASDAQ
5299,17-02-2021 14:00,24 hrs.,wallstreetbets,MVIS,19,7,12,-5,3,3,1,3,NASDAQ
5299,17-02-2021 14:00,24 hrs.,wallstreetbets,NAKD,25,18,7,11,4,4,1,3,NASDAQ
5299,17-02-2021 14:00,24 hrs.,wallstreetbets,NCTY,14,0,14,-14,2,2,2,2,NASDAQ
5299,17-02-2021 14:00,24 hrs.,wallstreetbets,NGAC,7,0,7,-7,1,1,1,1,NASDAQ
5299,17-02-2021 14:00,24 hrs.,wallstreetbets,NNDM,33,33,0,33,1,7,15,1,NASDAQ
5299,17-02-2021 14:00,24 hrs.,wallstreetbets,NUAN,4,4,0,4,1,0,0,1,NASDAQ
5299,17-02-2021 14:00,24 hrs.,wallstreetbets,NURO,8,0,8,-8,1,1,2,1,NASDAQ
5299,17-02-2021 14:00,24 hrs.,wallstreetbets,OCGN,6,6,0,6,1,1,0,1,NASDAQ
5299,17-02-2021 14:00,24 hrs.,wallstreetbets,PACB,6,6,0,6,1,1,0,1,NASDAQ
5299,17-02-2021 14:00,24 hrs.,Daytrading,GAXY,6,0,6,-6,1,1,0,1,OTC
5299,17-02-2021 14:00,24 hrs.,Daytrading,AMC,6,0,6,-6,1,1,0,1,NYSE
5299,17-02-2021 14:00,24 hrs.,Daytrading,CTXR,14,14,0,14,1,1,8,1,NASDAQ
5299,17-02-2021 14:00,24 hrs.,Daytrading,PULM,14,14,0,14,1,1,8,1,NASDAQ
5299,17-02-2021 14:00,24 hrs.,Daytrading,TXMD,14,14,0,14,1,1,8,1,NASDAQ
5299,17-02-2021 14:00,24 hrs.,trakstocks,COMS,10,10,0,10,1,1,4,1,OTC
5299,17-02-2021 14:00,24 hrs.,trakstocks,INOTF,6,0,6,-6,1,1,0,1,OTC
5299,17-02-2021 14:00,24 hrs.,trakstocks,SENS,141,0,141,-141,1,57,23,1,AMEX
5299,17-02-2021 14:00,24 hrs.,trakstocks,PDAC,29,0,29,-29,1,11,3,1,NYSE
5299,17-02-2021 14:00,24 hrs.,trakstocks,AYRO,10,10,0,10,1,1,4,1,NASDAQ
5299,17-02-2021 14:00,24 hrs.,trakstocks,CFII,62,0,62,-62,2,20,14,2,NASDAQ
5299,17-02-2021 14:00,24 hrs.,trakstocks,CTXR,10,10,0,10,1,1,4,1,NASDAQ
5299,17-02-2021 14:00,24 hrs.,trakstocks,HEPA,25,0,25,-25,1,10,1,1,NASDAQ
5299,17-02-2021 14:00,24 hrs.,trakstocks,IMMR,18,0,18,-18,1,3,8,1,NASDAQ
5299,17-02-2021 14:00,24 hrs.,trakstocks,KTRA,18,18,0,18,3,3,0,1,NASDAQ
5299,17-02-2021 14:00,24 hrs.,trakstocks,PULM,10,10,0,10,1,1,4,1,NASDAQ
5299,17-02-2021 14:00,24 hrs.,trakstocks,RIOT,7,0,7,-7,1,1,1,1,NASDAQ
5299,17-02-2021 14:00,24 hrs.,trakstocks,STLD,6,0,6,-6,1,1,0,1,NASDAQ
5299,17-02-2021 14:00,24 hrs.,trakstocks,TRIT,7,7,0,7,1,1,1,1,NASDAQ
5299,17-02-2021 14:00,24 hrs.,trakstocks,TXMD,10,10,0,10,1,1,4,1,NASDAQ
5299,17-02-2021 14:00,24 hrs.,trakstocks,CMCSA,16,16,0,16,1,5,2,1,NASDAQ
5299,17-02-2021 14:00,24 hrs.,StockMarket,NDVAF,468,0,468,-468,1,143,178,1,OTC
5299,17-02-2021 14:00,24 hrs.,StockMarket,BAC,6,6,0,6,1,1,0,1,NYSE
5299,17-02-2021 14:00,24 hrs.,StockMarket,GME,6,6,0,6,1,1,0,1,NYSE
5299,17-02-2021 14:00,24 hrs.,StockMarket,JPM,6,6,0,6,1,1,0,1,NYSE
5299,17-02-2021 14:00,24 hrs.,StockMarket,UBS,6,6,0,6,1,1,0,1,NYSE
5299,17-02-2021 14:00,24 hrs.,StockMarket,LGVW,6,0,6,-6,1,1,0,1,NYSE
5299,17-02-2021 14:00,24 hrs.,StockMarket,PLTR,51,0,51,-51,1,11,25,1,NYSE
5299,17-02-2021 14:00,24 hrs.,StockMarket,APHA,64,0,64,-64,1,25,10,1,NASDAQ
5299,17-02-2021 14:00,24 hrs.,StockMarket,NGAC,14,14,0,14,1,5,0,1,NASDAQ
5299,17-02-2021 14:00,24 hrs.,StockMarket,SCKT,12,12,0,12,1,3,2,1,NASDAQ
5299,17-02-2021 14:00,24 hrs.,StockMarket,SNDL,468,0,468,-468,1,143,178,1,NASDAQ
5299,17-02-2021 14:00,24 hrs.,pennystocks,AABB,31,0,31,-31,4,5,5,3,OTC
5299,17-02-2021 14:00,24 hrs.,pennystocks,ASTI,7,0,7,-7,1,1,1,1,OTC
5299,17-02-2021 14:00,24 hrs.,pennystocks,BIEL,6,6,0,6,1,1,0,1,OTC
5299,17-02-2021 14:00,24 hrs.,pennystocks,BLSP,6,6,0,6,1,1,0,1,OTC
5299,17-02-2021 14:00,24 hrs.,pennystocks,BOTY,72,72,0,72,1,20,28,1,OTC
5299,17-02-2021 14:00,24 hrs.,pennystocks,BRGO,6,0,6,-6,1,1,0,1,OTC
5299,17-02-2021 14:00,24 hrs.,pennystocks,BRTX,6,0,6,-6,1,1,0,1,OTC
5299,17-02-2021 14:00,24 hrs.,pennystocks,CANN,7,7,0,7,1,1,1,1,OTC
5299,17-02-2021 14:00,24 hrs.,pennystocks,CBTC,7,0,7,-7,1,1,1,1,OTC
5299,17-02-2021 14:00,24 hrs.,pennystocks,CETY,64,0,64,-64,1,24,12,1,OTC
5299,17-02-2021 14:00,24 hrs.,pennystocks,COMS,30,30,0,30,1,3,20,1,OTC
5299,17-02-2021 14:00,24 hrs.,wallstreetbets,ZOM,918,0,918,-918,2,368,174,2,AMEX
5299,17-02-2021 14:00,24 hrs.,wallstreetbets,SENS,13,0,13,-13,2,2,1,2,AMEX
5299,17-02-2021 14:00,24 hrs.,wallstreetbets,TRXC,6,0,6,-6,1,1,0,1,AMEX
5299,17-02-2021 14:00,24 hrs.,wallstreetbets,ALK,104,0,104,-104,1,33,34,1,NYSE
5299,17-02-2021 14:00,24 hrs.,wallstreetbets,AMC,650,163,487,-324,22,237,88,17,NYSE
5299,17-02-2021 14:00,24 hrs.,wallstreetbets,ASX,6,6,0,6,1,1,0,1,NYSE
5299,17-02-2021 14:00,24 hrs.,wallstreetbets,BMY,6,6,0,6,1,1,0,1,NYSE
5299,17-02-2021 14:00,24 hrs.,RobinHoodPennyStocks,DFFN,6,0,6,-6,1,1,0,1,NASDAQ
5299,17-02-2021 14:00,24 hrs.,RobinHoodPennyStocks,HEPA,44,44,0,44,2,8,20,2,NASDAQ
5299,17-02-2021 14:00,24 hrs.,RobinHoodPennyStocks,LKCO,6,0,6,-6,1,1,0,1,NASDAQ
5299,17-02-2021 14:00,24 hrs.,RobinHoodPennyStocks,NGAC,6,6,0,6,1,1,0,1,NASDAQ
5299,17-02-2021 14:00,24 hrs.,RobinHoodPennyStocks,NMTR,6,6,0,6,1,1,0,1,NASDAQ
5299,17-02-2021 14:00,24 hrs.,RobinHoodPennyStocks,NVIV,6,0,6,-6,1,1,0,1,NASDAQ
5299,17-02-2021 14:00,24 hrs.,RobinHoodPennyStocks,NXTD,6,0,6,-6,1,1,0,1,NASDAQ
5299,17-02-2021 14:00,24 hrs.,RobinHoodPennyStocks,RWLK,6,6,0,6,1,1,0,1,NASDAQ
5299,17-02-2021 14:00,24 hrs.,RobinHoodPennyStocks,SNCA,9,0,9,-9,1,2,1,1,NASDAQ
5299,17-02-2021 14:00,24 hrs.,RobinHoodPennyStocks,SNDL,29,29,0,29,1,8,9,1,NASDAQ
5299,17-02-2021 14:00,24 hrs.,RobinHoodPennyStocks,SONM,54,0,54,-54,1,17,16,1,NASDAQ
5299,17-02-2021 14:00,24 hrs.,RobinHoodPennyStocks,SSPK,6,0,6,-6,1,1,0,1,NASDAQ
5299,17-02-2021 14:00,24 hrs.,RobinHoodPennyStocks,TXMD,18,12,6,6,3,3,0,3,NASDAQ
5299,17-02-2021 14:00,24 hrs.,RobinHoodPennyStocks,TYME,6,6,0,6,1,1,0,1,NASDAQ
5299,17-02-2021 14:00,24 hrs.,RobinHoodPennyStocks,YTRA,12,0,12,-12,2,2,0,1,NASDAQ
5299,17-02-2021 14:00,24 hrs.,wallstreetbets,TAP,6,6,0,6,1,1,0,1,NYSE
5299,17-02-2021 14:00,24 hrs.,wallstreetbets,AQUA,12,0,12,-12,2,2,0,1,NYSE
5299,17-02-2021 14:00,24 hrs.,wallstreetbets,ARGO,7,0,7,-7,1,1,1,1,NYSE
5299,17-02-2021 14:00,24 hrs.,wallstreetbets,CCIV,56,0,56,-56,8,8,8,8,NYSE
5299,17-02-2021 14:00,24 hrs.,wallstreetbets,CORR,6,6,0,6,1,1,0,1,NYSE
5299,17-02-2021 14:00,24 hrs.,wallstreetbets,COTY,12,12,0,12,2,2,0,2,NYSE
5299,17-02-2021 14:00,24 hrs.,wallstreetbets,FVRR,7,0,7,-7,1,1,1,1,NYSE
5299,17-02-2021 14:00,24 hrs.,wallstreetbets,HUYA,100,100,0,100,1,36,24,1,NYSE
5299,17-02-2021 14:00,24 hrs.,wallstreetbets,IACA,7,0,7,-7,1,1,1,1,NYSE
5299,17-02-2021 14:00,24 hrs.,wallstreetbets,IMAX,21,0,21,-21,3,3,3,2,NYSE
5299,17-02-2021 14:00,24 hrs.,wallstreetbets,PGRE,7,0,7,-7,1,1,1,1,NYSE
5299,17-02-2021 14:00,24 hrs.,wallstreetbets,PLTR,8627,1879,6748,-4869,27,3884,751,23,NYSE
5299,17-02-2021 14:00,24 hrs.,wallstreetbets,PSTH,7,0,7,-7,1,1,1,1,NYSE
5299,17-02-2021 14:00,24 hrs.,wallstreetbets,SPCE,6,6,0,6,1,1,0,1,NYSE
5299,17-02-2021 14:00,24 hrs.,wallstreetbets,AMD,6,6,0,6,1,1,0,1,NASDAQ
5299,17-02-2021 14:00,24 hrs.,wallstreetbets,API,7,0,7,-7,1,1,1,1,NASDAQ
5299,17-02-2021 14:00,24 hrs.,wallstreetbets,FUV,7,0,7,-7,1,1,1,1,NASDAQ
5299,17-02-2021 14:00,24 hrs.,wallstreetbets,OSW,14,0,14,-14,2,2,2,2,NASDAQ
5299,17-02-2021 14:00,24 hrs.,wallstreetbets,PDD,7,0,7,-7,1,1,1,1,NASDAQ
5299,17-02-2021 14:00,24 hrs.,wallstreetbets,UAL,7,0,7,-7,1,1,1,1,NASDAQ
5299,17-02-2021 14:00,24 hrs.,wallstreetbets,VFF,17,17,0,17,2,4,1,2,NASDAQ
5299,17-02-2021 14:00,24 hrs.,wallstreetbets,ADMP,13,6,7,-1,2,2,1,2,NASDAQ
5299,17-02-2021 14:00,24 hrs.,wallstreetbets,AGTC,7,0,7,-7,1,1,1,1,NASDAQ
5299,17-02-2021 14:00,24 hrs.,wallstreetbets,APHA,32,0,32,-32,5,5,2,4,NASDAQ
5299,17-02-2021 14:00,24 hrs.,wallstreetbets,ASML,7,0,7,-7,1,1,1,1,NASDAQ
5299,17-02-2021 14:00,24 hrs.,wallstreetbets,ASTC,7,0,7,-7,1,1,1,1,NASDAQ
5299,17-02-2021 14:00,24 hrs.,wallstreetbets,AUUD,6,6,0,6,1,1,0,1,NASDAQ
5299,17-02-2021 14:00,24 hrs.,wallstreetbets,BEAT,6,0,6,-6,1,1,0,1,NASDAQ
5299,17-02-2021 14:00,24 hrs.,wallstreetbets,BLDP,6,6,0,6,1,1,0,1,NASDAQ
5299,17-02-2021 14:00,24 hrs.,wallstreetbets,BLNK,7,0,7,-7,1,1,1,1,NASDAQ
5299,17-02-2021 14:00,24 hrs.,wallstreetbets,BNGO,20,20,0,20,1,0,16,1,NASDAQ
5299,17-02-2021 14:00,24 hrs.,wallstreetbets,CAAS,21,0,21,-21,3,3,3,2,NASDAQ
5299,17-02-2021 14:00,24 hrs.,wallstreetbets,CDTX,7,0,7,-7,1,1,1,1,NASDAQ
5299,17-02-2021 14:00,24 hrs.,wallstreetbets,CLEU,7,0,7,-7,1,1,1,1,NASDAQ
5299,17-02-2021 14:00,24 hrs.,wallstreetbets,CRON,7,0,7,-7,1,1,1,1,NASDAQ
5299,17-02-2021 14:00,24 hrs.,wallstreetbets,CRSP,6,6,0,6,1,1,0,1,NASDAQ
5299,17-02-2021 14:00,24 hrs.,wallstreetbets,CRSR,1638,0,1638,-1638,2,701,228,2,NASDAQ
5299,17-02-2021 14:00,24 hrs.,wallstreetbets,CTRM,21,0,21,-21,3,3,3,3,NASDAQ
5299,17-02-2021 14:00,24 hrs.,wallstreetbets,DKNG,6,6,0,6,1,1,0,1,NASDAQ
5299,17-02-2021 14:00,24 hrs.,wallstreetbets,DLPN,7,0,7,-7,1,1,1,1,NASDAQ
5299,17-02-2021 14:00,24 hrs.,wallstreetbets,DOYU,14,0,14,-14,2,2,2,1,NASDAQ
5299,17-02-2021 14:00,24 hrs.,wallstreetbets,FOLD,6,6,0,6,1,1,0,1,NASDAQ
5299,17-02-2021 14:00,24 hrs.,wallstreetbets,GAIN,6,6,0,6,1,1,0,1,NASDAQ
5299,17-02-2021 14:00,24 hrs.,wallstreetbets,GLBS,14,0,14,-14,2,2,2,2,NASDAQ
5299,17-02-2021 14:00,24 hrs.,wallstreetbets,GOOG,4,4,0,4,1,0,0,1,NASDAQ
5299,17-02-2021 14:00,24 hrs.,wallstreetbets,HEPA,7,0,7,-7,1,1,1,1,NASDAQ
5299,17-02-2021 14:00,24 hrs.,wallstreetbets,KBNT,7,0,7,-7,1,1,1,1,NASDAQ
5299,17-02-2021 14:00,24 hrs.,wallstreetbets,LEGN,6,6,0,6,1,1,0,1,NASDAQ
5299,17-02-2021 14:00,24 hrs.,wallstreetbets,LIFE,7,0,7,-7,1,1,1,1,NASDAQ
5299,17-02-2021 14:00,24 hrs.,pennystocks,FPVD,12,0,12,-12,1,3,2,1,OTC
5299,17-02-2021 14:00,24 hrs.,pennystocks,GAXY,91,6,85,-79,7,25,13,4,OTC
5299,17-02-2021 14:00,24 hrs.,pennystocks,GFTX,18,18,0,18,1,6,2,1,OTC
5299,17-02-2021 14:00,24 hrs.,pennystocks,HCMC,20,7,13,-6,3,3,2,3,OTC
5299,17-02-2021 14:00,24 hrs.,pennystocks,HEME,7,0,7,-7,1,1,1,1,OTC
5299,17-02-2021 14:00,24 hrs.,pennystocks,INKW,6,0,6,-6,1,1,0,1,OTC
5299,17-02-2021 14:00,24 hrs.,pennystocks,INTV,22,0,22,-22,1,6,6,1,OTC
5299,17-02-2021 14:00,24 hrs.,pennystocks,KNOS,6,6,0,6,1,1,0,1,OTC
5299,17-02-2021 14:00,24 hrs.,pennystocks,RSSV,64,0,64,-64,1,26,8,1,OTC
5299,17-02-2021 14:00,24 hrs.,pennystocks,SANP,25,25,0,25,1,7,7,1,OTC
5299,17-02-2021 14:00,24 hrs.,pennystocks,SFOR,54,0,54,-54,2,17,12,2,OTC
5299,17-02-2021 14:00,24 hrs.,pennystocks,SSFT,16,0,16,-16,1,4,4,1,OTC
5299,17-02-2021 14:00,24 hrs.,pennystocks,UBQU,40,0,40,-40,1,10,16,1,OTC
5299,17-02-2021 14:00,24 hrs.,pennystocks,ZPAS,10,0,10,-10,1,2,2,1,OTC
5299,17-02-2021 14:00,24 hrs.,pennystocks,BFARF,6,0,6,-6,1,1,0,1,OTC
5299,17-02-2021 14:00,24 hrs.,pennystocks,DIGAF,6,0,6,-6,1,1,0,1,OTC
5299,17-02-2021 14:00,24 hrs.,pennystocks,EFLVF,7,7,0,7,1,1,1,1,OTC
5299,17-02-2021 14:00,24 hrs.,pennystocks,FUNFF,25,0,25,-25,1,8,5,1,OTC
5299,17-02-2021 14:00,24 hrs.,pennystocks,HVBTF,7,0,7,-7,1,1,1,1,OTC
5299,17-02-2021 14:00,24 hrs.,pennystocks,NUSMF,6,0,6,-6,1,1,0,1,OTC
5299,17-02-2021 14:00,24 hrs.,pennystocks,SOLCF,6,6,0,6,1,1,0,1,OTC
5299,17-02-2021 14:00,24 hrs.,pennystocks,SPRWF,476,0,476,-476,3,194,76,3,OTC
5299,17-02-2021 14:00,24 hrs.,pennystocks,ZBISF,16,0,16,-16,1,4,4,1,OTC
5299,17-02-2021 14:00,24 hrs.,wallstreetbets,PHUN,6,0,6,-6,1,1,0,1,NASDAQ
5299,17-02-2021 14:00,24 hrs.,wallstreetbets,PLUG,7,0,7,-7,1,1,1,1,NASDAQ
5299,17-02-2021 14:00,24 hrs.,wallstreetbets,RIOT,21,0,21,-21,3,3,3,3,NASDAQ
5299,17-02-2021 14:00,24 hrs.,wallstreetbets,SCKT,40,6,34,-28,6,6,4,6,NASDAQ
5299,17-02-2021 14:00,24 hrs.,wallstreetbets,SHIP,7,0,7,-7,1,1,1,1,NASDAQ
5299,17-02-2021 14:00,24 hrs.,wallstreetbets,SNDL,287,253,34,219,6,98,67,4,NASDAQ
5299,17-02-2021 14:00,24 hrs.,wallstreetbets,SOLO,7,0,7,-7,1,1,1,1,NASDAQ
5299,17-02-2021 14:00,24 hrs.,wallstreetbets,SPWR,13,0,13,-13,2,2,1,1,NASDAQ
5299,17-02-2021 14:00,24 hrs.,wallstreetbets,SXTC,7,0,7,-7,1,1,1,1,NASDAQ
5299,17-02-2021 14:00,24 hrs.,wallstreetbets,TECH,6,0,6,-6,1,1,0,1,NASDAQ
5299,17-02-2021 14:00,24 hrs.,wallstreetbets,TLRY,274,253,21,232,4,96,66,4,NASDAQ
5299,17-02-2021 14:00,24 hrs.,wallstreetbets,TOPS,7,0,7,-7,1,1,1,1,NASDAQ
5299,17-02-2021 14:00,24 hrs.,wallstreetbets,TRCH,7,0,7,-7,1,1,1,1,NASDAQ
5299,17-02-2021 14:00,24 hrs.,wallstreetbets,TRIT,6,6,0,6,1,1,0,1,NASDAQ
5299,17-02-2021 14:00,24 hrs.,wallstreetbets,TRVG,7,0,7,-7,1,1,1,1,NASDAQ
5299,17-02-2021 14:00,24 hrs.,wallstreetbets,TSLA,388,388,0,388,2,131,118,2,NASDAQ
5299,17-02-2021 14:00,24 hrs.,wallstreetbets,USWS,7,0,7,-7,1,1,1,1,NASDAQ
5299,17-02-2021 14:00,24 hrs.,wallstreetbets,VUZI,14,0,14,-14,2,2,2,1,NASDAQ
5299,17-02-2021 14:00,24 hrs.,wallstreetbets,WKHS,6,0,6,-6,1,1,0,1,NASDAQ
5299,17-02-2021 14:00,24 hrs.,wallstreetbets,WRAP,7,0,7,-7,1,1,1,1,NASDAQ
5299,17-02-2021 14:00,24 hrs.,wallstreetbets,WTER,7,0,7,-7,1,1,1,1,NASDAQ
5299,17-02-2021 14:00,24 hrs.,RobinHoodPennyStocks,BOTY,6,6,0,6,1,1,0,1,OTC
5299,17-02-2021 14:00,24 hrs.,RobinHoodPennyStocks,ENKS,6,0,6,-6,1,1,0,1,OTC
5299,17-02-2021 14:00,24 hrs.,RobinHoodPennyStocks,PFFOF,6,0,6,-6,1,1,0,1,OTC
5299,17-02-2021 14:00,24 hrs.,RobinHoodPennyStocks,DNN,29,29,0,29,1,5,15,1,AMEX
5299,17-02-2021 14:00,24 hrs.,RobinHoodPennyStocks,GTE,7,0,7,-7,1,1,1,1,AMEX
5299,17-02-2021 14:00,24 hrs.,RobinHoodPennyStocks,NAK,29,29,0,29,1,5,15,1,AMEX
5299,17-02-2021 14:00,24 hrs.,RobinHoodPennyStocks,EMAN,17,0,17,-17,1,5,3,1,AMEX
5299,17-02-2021 14:00,24 hrs.,RobinHoodPennyStocks,GSAT,6,0,6,-6,1,1,0,1,AMEX
5299,17-02-2021 14:00,24 hrs.,RobinHoodPennyStocks,AMC,38,38,0,38,1,7,20,1,NYSE
5299,17-02-2021 14:00,24 hrs.,RobinHoodPennyStocks,CPE,6,0,6,-6,1,1,0,1,NYSE
5299,17-02-2021 14:00,24 hrs.,RobinHoodPennyStocks,KOS,6,0,6,-6,1,1,0,1,NYSE
5299,17-02-2021 14:00,24 hrs.,RobinHoodPennyStocks,SND,6,0,6,-6,1,1,0,1,NASDAQ
5299,17-02-2021 14:00,24 hrs.,RobinHoodPennyStocks,ABEO,46,0,46,-46,1,17,8,1,NASDAQ
5299,17-02-2021 14:00,24 hrs.,RobinHoodPennyStocks,ACST,9,0,9,-9,1,2,1,1,NASDAQ
5299,17-02-2021 14:00,24 hrs.,RobinHoodPennyStocks,AGTC,508,0,508,-508,5,171,146,4,NASDAQ
5299,17-02-2021 14:00,24 hrs.,RobinHoodPennyStocks,APHA,6,0,6,-6,1,1,0,1,NASDAQ
5299,17-02-2021 14:00,24 hrs.,RobinHoodPennyStocks,ATOS,18,18,0,18,1,4,6,1,NASDAQ
5299,17-02-2021 14:00,24 hrs.,RobinHoodPennyStocks,CTRM,18,0,18,-18,3,3,0,3,NASDAQ
5299,17-02-2021 14:00,24 hrs.,RobinHoodPennyStocks,CTXR,199,193,6,187,3,62,63,3,NASDAQ
5299,17-02-2021 14:00,24 hrs.,RobinHoodPennyStocks,CYCC,6,0,6,-6,1,1,0,1,NASDAQ
5299,17-02-2021 14:00,24 hrs.,pennystocks,DNN,64,0,64,-64,1,22,16,1,AMEX
5299,17-02-2021 14:00,24 hrs.,pennystocks,GTE,7,0,7,-7,1,1,1,1,AMEX
5299,17-02-2021 14:00,24 hrs.,pennystocks,ISR,6,0,6,-6,1,1,0,1,AMEX
5299,17-02-2021 14:00,24 hrs.,pennystocks,ITP,23,0,23,-23,1,6,7,1,AMEX
5299,17-02-2021 14:00,24 hrs.,pennystocks,NGD,30,30,0,30,1,11,4,1,AMEX
5299,17-02-2021 14:00,24 hrs.,pennystocks,GSAT,8,8,0,8,1,1,2,1,AMEX
5299,17-02-2021 14:00,24 hrs.,pennystocks,ATH,6,0,6,-6,1,1,0,1,NYSE
5299,17-02-2021 14:00,24 hrs.,pennystocks,CBD,23,0,23,-23,2,5,5,2,NYSE
5299,17-02-2021 14:00,24 hrs.,pennystocks,GME,13,6,7,-1,2,2,1,2,NYSE
5299,17-02-2021 14:00,24 hrs.,pennystocks,HPQ,10,0,10,-10,1,2,2,1,NYSE
5299,17-02-2021 14:00,24 hrs.,pennystocks,NOK,6,6,0,6,1,1,0,1,NYSE
5299,17-02-2021 14:00,24 hrs.,pennystocks,NUS,6,0,6,-6,1,1,0,1,NYSE
5299,17-02-2021 14:00,24 hrs.,pennystocks,SOS,6,0,6,-6,1,1,0,1,NYSE
5299,17-02-2021 14:00,24 hrs.,pennystocks,HEXO,16,0,16,-16,1,4,4,1,NYSE
5299,17-02-2021 14:00,24 hrs.,pennystocks,BNGO,32,32,0,32,1,2,24,1,NASDAQ
5299,17-02-2021 14:00,24 hrs.,pennystocks,CLBS,6,6,0,6,1,1,0,1,NASDAQ
5299,17-02-2021 14:00,24 hrs.,pennystocks,CTXR,36,36,0,36,2,4,20,2,NASDAQ
5299,17-02-2021 14:00,24 hrs.,pennystocks,GLBS,8,0,8,-8,1,0,4,1,NASDAQ
5299,17-02-2021 14:00,24 hrs.,pennystocks,MICT,151,132,19,113,2,52,39,2,NASDAQ
5299,17-02-2021 14:00,24 hrs.,pennystocks,NEOS,6,6,0,6,1,1,0,1,NASDAQ
5299,17-02-2021 14:00,24 hrs.,pennystocks,NMTR,40,40,0,40,1,14,8,1,NASDAQ
5299,17-02-2021 14:00,24 hrs.,pennystocks,PULM,30,30,0,30,1,3,20,1,NASDAQ
5299,17-02-2021 14:00,24 hrs.,pennystocks,SONM,6,0,6,-6,1,1,0,1,NASDAQ
5299,17-02-2021 14:00,24 hrs.,pennystocks,TBLT,6,6,0,6,1,1,0,1,NASDAQ
5299,17-02-2021 14:00,24 hrs.,pennystocks,TXMD,30,30,0,30,1,3,20,1,NASDAQ
5299,17-02-2021 14:00,24 hrs.,pennystocks,WTER,16,0,16,-16,1,4,4,1,NASDAQ
5299,17-02-2021 14:00,24 hrs.,pennystocks,XSPA,6,0,6,-6,1,1,0,1,NASDAQ
5299,17-02-2021 14:00,24 hrs.,wallstreetbets,AABB,7,0,7,-7,1,1,1,1,OTC
5299,17-02-2021 14:00,24 hrs.,wallstreetbets,AITX,6,6,0,6,1,1,0,1,OTC
5299,17-02-2021 14:00,24 hrs.,wallstreetbets,ALYI,7,0,7,-7,1,1,1,1,OTC
5299,17-02-2021 14:00,24 hrs.,wallstreetbets,BCCI,6,0,6,-6,1,1,0,1,OTC
5299,17-02-2021 14:00,24 hrs.,wallstreetbets,CETY,8,0,8,-8,1,2,0,1,OTC
5299,17-02-2021 14:00,24 hrs.,wallstreetbets,ESSE,7,7,0,7,1,1,1,1,OTC
5299,17-02-2021 14:00,24 hrs.,wallstreetbets,EVBC,6,0,6,-6,1,1,0,1,OTC
5299,17-02-2021 14:00,24 hrs.,wallstreetbets,GBLX,7,0,7,-7,1,1,1,1,OTC
5299,17-02-2021 14:00,24 hrs.,wallstreetbets,HCMC,39,12,27,-15,6,6,3,6,OTC
5299,17-02-2021 14:00,24 hrs.,wallstreetbets,HYSR,13,6,7,-1,2,2,1,2,OTC
5299,17-02-2021 14:00,24 hrs.,wallstreetbets,INTV,7,0,7,-7,1,1,1,1,OTC
5299,17-02-2021 14:00,24 hrs.,wallstreetbets,MKTY,7,0,7,-7,1,1,1,1,OTC
5299,17-02-2021 14:00,24 hrs.,wallstreetbets,OWCP,6,0,6,-6,1,1,0,1,OTC
5299,17-02-2021 14:00,24 hrs.,wallstreetbets,OZSC,6,6,0,6,1,1,0,1,OTC
5299,17-02-2021 14:00,24 hrs.,wallstreetbets,RMRK,7,0,7,-7,1,1,1,1,OTC
5299,17-02-2021 14:00,24 hrs.,wallstreetbets,SEGI,6,6,0,6,1,1,0,1,OTC
5299,17-02-2021 14:00,24 hrs.,wallstreetbets,SGMD,14,0,14,-14,2,2,2,1,OTC
5299,17-02-2021 14:00,24 hrs.,wallstreetbets,SOBS,7,0,7,-7,1,1,1,1,OTC
5299,17-02-2021 14:00,24 hrs.,wallstreetbets,TPAC,6,6,0,6,1,1,0,1,OTC
5299,17-02-2021 14:00,24 hrs.,wallstreetbets,WHEN,6,6,0,6,1,1,0,1,OTC
5299,17-02-2021 14:00,24 hrs.,wallstreetbets,ZPAS,7,0,7,-7,1,1,1,1,OTC
5299,17-02-2021 14:00,24 hrs.,wallstreetbets,ARBKF,14,0,14,-14,2,2,2,2,OTC
5299,17-02-2021 14:00,24 hrs.,wallstreetbets,CNIKF,7,0,7,-7,1,1,1,1,OTC
5299,17-02-2021 14:00,24 hrs.,wallstreetbets,ICNAF,7,0,7,-7,1,1,1,1,OTC
5299,17-02-2021 14:00,24 hrs.,wallstreetbets,ISCNF,7,0,7,-7,1,1,1,1,OTC
5299,17-02-2021 14:00,24 hrs.,wallstreetbets,JUVAF,6,0,6,-6,1,1,0,1,OTC
5299,17-02-2021 14:00,24 hrs.,wallstreetbets,LKNCY,6,0,6,-6,1,1,0,1,OTC
5299,17-02-2021 14:00,24 hrs.,wallstreetbets,MMNFF,6,6,0,6,1,1,0,1,OTC
5299,17-02-2021 14:00,24 hrs.,wallstreetbets,PLNHF,4,0,4,-4,1,0,0,1,OTC
5299,17-02-2021 14:00,24 hrs.,wallstreetbets,RLLCF,35,0,35,-35,5,5,5,2,OTC
5299,17-02-2021 14:00,24 hrs.,wallstreetbets,RYCEY,7,0,7,-7,1,1,1,1,OTC
5299,17-02-2021 14:00,24 hrs.,wallstreetbets,SOLCF,6,6,0,6,1,1,0,1,OTC
5299,17-02-2021 14:00,24 hrs.,wallstreetbets,DNN,27,6,21,-15,4,4,3,4,AMEX
5299,17-02-2021 14:00,24 hrs.,wallstreetbets,GTE,10,0,10,-10,1,2,2,1,AMEX
5299,17-02-2021 14:00,24 hrs.,pennystocks,DPLS,6,6,0,6,1,1,0,1,OTC
5299,17-02-2021 14:00,24 hrs.,pennystocks,ENZC,6,0,6,-6,1,1,0,1,OTC
5299,17-02-2021 14:00,24 hrs.,pennystocks,ETFM,11,5,6,-1,2,1,1,2,OTC
5288,17-02-2021 12:00,24 hrs.,pennystocks,NUS,6,0,6,-6,1,1,0,1,NYSE
5288,17-02-2021 12:00,24 hrs.,pennystocks,SOS,19,0,19,-19,3,3,1,3,NYSE
5288,17-02-2021 12:00,24 hrs.,pennystocks,ARGO,6,0,6,-6,1,1,0,1,NYSE
5288,17-02-2021 12:00,24 hrs.,pennystocks,HEXO,16,0,16,-16,1,4,4,1,NYSE
5288,17-02-2021 12:00,24 hrs.,pennystocks,PUMP,6,0,6,-6,1,1,0,1,NYSE
5288,17-02-2021 12:00,24 hrs.,pennystocks,TSC,6,0,6,-6,1,1,0,1,NASDAQ
5288,17-02-2021 12:00,24 hrs.,pennystocks,ADMA,621,0,621,-621,1,291,35,1,NASDAQ
5288,17-02-2021 12:00,24 hrs.,pennystocks,ADMP,6,0,6,-6,1,1,0,1,NASDAQ
5288,17-02-2021 12:00,24 hrs.,pennystocks,BNGO,32,32,0,32,1,2,24,1,NASDAQ
5288,17-02-2021 12:00,24 hrs.,pennystocks,CLBS,6,6,0,6,1,1,0,1,NASDAQ
5288,17-02-2021 12:00,24 hrs.,pennystocks,CTXR,33,33,0,33,2,3,19,2,NASDAQ
5288,17-02-2021 12:00,24 hrs.,pennystocks,EBON,32,0,32,-32,1,12,4,1,NASDAQ
5288,17-02-2021 12:00,24 hrs.,pennystocks,GLBS,8,0,8,-8,1,0,4,1,NASDAQ
5288,17-02-2021 12:00,24 hrs.,pennystocks,GLMD,10,0,10,-10,1,2,2,1,NASDAQ
5288,17-02-2021 12:00,24 hrs.,pennystocks,MICT,149,130,19,111,2,55,31,2,NASDAQ
5288,17-02-2021 12:00,24 hrs.,pennystocks,NBEV,6,0,6,-6,1,1,0,1,NASDAQ
5288,17-02-2021 12:00,24 hrs.,pennystocks,AABB,31,0,31,-31,4,5,5,3,OTC
5288,17-02-2021 12:00,24 hrs.,pennystocks,AQSP,6,0,6,-6,1,1,0,1,OTC
5288,17-02-2021 12:00,24 hrs.,pennystocks,ASTI,7,0,7,-7,1,1,1,1,OTC
5288,17-02-2021 12:00,24 hrs.,pennystocks,BIEL,6,6,0,6,1,1,0,1,OTC
5288,17-02-2021 12:00,24 hrs.,pennystocks,BLSP,6,6,0,6,1,1,0,1,OTC
5288,17-02-2021 12:00,24 hrs.,pennystocks,BMIX,6,0,6,-6,1,1,0,1,OTC
5288,17-02-2021 12:00,24 hrs.,pennystocks,BOTY,64,64,0,64,1,16,28,1,OTC
5288,17-02-2021 12:00,24 hrs.,pennystocks,BRGO,6,0,6,-6,1,1,0,1,OTC
5288,17-02-2021 12:00,24 hrs.,pennystocks,BRRN,53,0,53,-53,2,18,9,2,OTC
5288,17-02-2021 12:00,24 hrs.,pennystocks,BRTX,6,0,6,-6,1,1,0,1,OTC
5288,17-02-2021 12:00,24 hrs.,pennystocks,BRZL,6,0,6,-6,1,1,0,1,OTC
5288,17-02-2021 12:00,24 hrs.,pennystocks,CANN,7,7,0,7,1,1,1,1,OTC
5288,17-02-2021 12:00,24 hrs.,pennystocks,CBTC,7,0,7,-7,1,1,1,1,OTC
5288,17-02-2021 12:00,24 hrs.,pennystocks,CETY,62,0,62,-62,1,23,12,1,OTC
5288,17-02-2021 12:00,24 hrs.,pennystocks,COMS,27,27,0,27,1,2,19,1,OTC
5288,17-02-2021 12:00,24 hrs.,pennystocks,CRWG,7,0,7,-7,1,1,1,1,OTC
5288,17-02-2021 12:00,24 hrs.,pennystocks,NEOS,6,6,0,6,1,1,0,1,NASDAQ
5288,17-02-2021 12:00,24 hrs.,pennystocks,NMTR,35,35,0,35,1,12,7,1,NASDAQ
5288,17-02-2021 12:00,24 hrs.,pennystocks,NVCR,32,0,32,-32,1,12,4,1,NASDAQ
5288,17-02-2021 12:00,24 hrs.,pennystocks,OCGN,6,0,6,-6,1,1,0,1,NASDAQ
5288,17-02-2021 12:00,24 hrs.,pennystocks,OKTA,32,0,32,-32,1,12,4,1,NASDAQ
5288,17-02-2021 12:00,24 hrs.,pennystocks,PLUG,32,0,32,-32,1,12,4,1,NASDAQ
5288,17-02-2021 12:00,24 hrs.,pennystocks,PULM,612,27,585,-558,2,243,118,2,NASDAQ
5288,17-02-2021 12:00,24 hrs.,pennystocks,QCOM,32,0,32,-32,1,12,4,1,NASDAQ
5288,17-02-2021 12:00,24 hrs.,pennystocks,SESN,31,0,31,-31,1,8,11,1,NASDAQ
5288,17-02-2021 12:00,24 hrs.,pennystocks,SNDL,6,0,6,-6,1,1,0,1,NASDAQ
5288,17-02-2021 12:00,24 hrs.,pennystocks,SOLO,32,0,32,-32,1,12,4,1,NASDAQ
5288,17-02-2021 12:00,24 hrs.,pennystocks,SONM,6,0,6,-6,1,1,0,1,NASDAQ
5288,17-02-2021 12:00,24 hrs.,pennystocks,TBLT,6,6,0,6,1,1,0,1,NASDAQ
5288,17-02-2021 12:00,24 hrs.,pennystocks,TXMD,27,27,0,27,1,2,19,1,NASDAQ
5288,17-02-2021 12:00,24 hrs.,pennystocks,WTER,18,0,18,-18,1,5,4,1,NASDAQ
5288,17-02-2021 12:00,24 hrs.,pennystocks,XSPA,6,0,6,-6,1,1,0,1,NASDAQ
5288,17-02-2021 12:00,24 hrs.,pennystocks,DPLS,12,6,6,0,2,2,0,2,OTC
5288,17-02-2021 12:00,24 hrs.,pennystocks,ENZC,6,0,6,-6,1,1,0,1,OTC
5288,17-02-2021 12:00,24 hrs.,pennystocks,ETFM,101,5,96,-91,3,37,15,3,OTC
5288,17-02-2021 12:00,24 hrs.,pennystocks,FPVD,12,0,12,-12,1,3,2,1,OTC
5288,17-02-2021 12:00,24 hrs.,pennystocks,GAXY,94,6,88,-82,8,24,14,5,OTC
5288,17-02-2021 12:00,24 hrs.,pennystocks,GFTX,17,17,0,17,1,6,1,1,OTC
5288,17-02-2021 12:00,24 hrs.,pennystocks,GPFT,10,0,10,-10,1,1,4,1,OTC
5288,17-02-2021 12:00,24 hrs.,pennystocks,HCMC,26,7,19,-12,4,4,2,4,OTC
5288,17-02-2021 12:00,24 hrs.,pennystocks,HEME,7,0,7,-7,1,1,1,1,OTC
5288,17-02-2021 12:00,24 hrs.,pennystocks,HPMM,4,0,4,-4,1,0,0,1,OTC
5288,17-02-2021 12:00,24 hrs.,pennystocks,INKW,12,0,12,-12,2,2,0,2,OTC
5288,17-02-2021 12:00,24 hrs.,pennystocks,INTV,18,0,18,-18,1,4,6,1,OTC
5288,17-02-2021 12:00,24 hrs.,pennystocks,KNOS,6,6,0,6,1,1,0,1,OTC
5288,17-02-2021 12:00,24 hrs.,pennystocks,KYNC,6,0,6,-6,1,1,0,1,OTC
5288,17-02-2021 12:00,24 hrs.,pennystocks,NEOM,7,0,7,-7,1,1,1,1,OTC
5288,17-02-2021 12:00,24 hrs.,pennystocks,OPTI,9,0,9,-9,1,1,3,1,OTC
5288,17-02-2021 12:00,24 hrs.,pennystocks,RLBD,6,0,6,-6,1,1,0,1,OTC
5288,17-02-2021 12:00,24 hrs.,pennystocks,RSSV,66,0,66,-66,1,27,8,1,OTC
5288,17-02-2021 12:00,24 hrs.,pennystocks,SANP,16,16,0,16,1,4,4,1,OTC
5288,17-02-2021 12:00,24 hrs.,pennystocks,SFOR,56,0,56,-56,2,18,12,2,OTC
5288,17-02-2021 12:00,24 hrs.,pennystocks,SGMD,6,0,6,-6,1,1,0,1,OTC
5288,17-02-2021 12:00,24 hrs.,pennystocks,SRMX,6,0,6,-6,1,1,0,1,OTC
5288,17-02-2021 12:00,24 hrs.,pennystocks,SSFT,20,0,20,-20,1,6,4,1,OTC
5288,17-02-2021 12:00,24 hrs.,pennystocks,UBQU,38,0,38,-38,1,9,16,1,OTC
5288,17-02-2021 12:00,24 hrs.,pennystocks,ZPAS,16,0,16,-16,1,5,2,1,OTC
5288,17-02-2021 12:00,24 hrs.,pennystocks,BFARF,6,0,6,-6,1,1,0,1,OTC
5288,17-02-2021 12:00,24 hrs.,pennystocks,DIGAF,6,0,6,-6,1,1,0,1,OTC
5288,17-02-2021 12:00,24 hrs.,pennystocks,EFLVF,7,7,0,7,1,1,1,1,OTC
5288,17-02-2021 12:00,24 hrs.,pennystocks,FUNFF,33,0,33,-33,1,12,5,1,OTC
5288,17-02-2021 12:00,24 hrs.,pennystocks,HVBTF,7,0,7,-7,1,1,1,1,OTC
5288,17-02-2021 12:00,24 hrs.,pennystocks,MMEDF,32,0,32,-32,1,12,4,1,OTC
5288,17-02-2021 12:00,24 hrs.,pennystocks,NMGRF,6,0,6,-6,1,1,0,1,OTC
5288,17-02-2021 12:00,24 hrs.,pennystocks,NUSMF,6,0,6,-6,1,1,0,1,OTC
5288,17-02-2021 12:00,24 hrs.,pennystocks,REZZF,13,0,13,-13,2,2,1,1,OTC
5288,17-02-2021 12:00,24 hrs.,pennystocks,SOLCF,6,6,0,6,1,1,0,1,OTC
5288,17-02-2021 12:00,24 hrs.,pennystocks,SPRWF,458,0,458,-458,3,186,74,3,OTC
5288,17-02-2021 12:00,24 hrs.,pennystocks,ZBISF,16,0,16,-16,1,4,4,1,OTC
5288,17-02-2021 12:00,24 hrs.,pennystocks,DNN,58,0,58,-58,1,19,16,1,AMEX
5288,17-02-2021 12:00,24 hrs.,pennystocks,GTE,7,0,7,-7,1,1,1,1,AMEX
5288,17-02-2021 12:00,24 hrs.,pennystocks,ISR,6,0,6,-6,1,1,0,1,AMEX
5288,17-02-2021 12:00,24 hrs.,pennystocks,ITP,23,0,23,-23,1,6,7,1,AMEX
5288,17-02-2021 12:00,24 hrs.,pennystocks,GSAT,8,8,0,8,1,1,2,1,AMEX
5288,17-02-2021 12:00,24 hrs.,pennystocks,ATH,6,0,6,-6,1,1,0,1,NYSE
5288,17-02-2021 12:00,24 hrs.,pennystocks,CBD,31,0,31,-31,3,7,5,3,NYSE
5288,17-02-2021 12:00,24 hrs.,pennystocks,GME,13,6,7,-1,2,2,1,2,NYSE
5288,17-02-2021 12:00,24 hrs.,pennystocks,HPQ,10,0,10,-10,1,2,2,1,NYSE
5288,17-02-2021 12:00,24 hrs.,pennystocks,JKS,32,0,32,-32,1,12,4,1,NYSE
5288,17-02-2021 12:00,24 hrs.,pennystocks,NOK,6,6,0,6,1,1,0,1,NYSE
5276,17-02-2021 10:00,24 hrs.,pennystocks,SNDL,6,0,6,-6,1,1,0,1,NASDAQ
5276,17-02-2021 10:00,24 hrs.,pennystocks,SOLO,32,0,32,-32,1,12,4,1,NASDAQ
5276,17-02-2021 10:00,24 hrs.,pennystocks,SONM,6,0,6,-6,1,1,0,1,NASDAQ
5276,17-02-2021 10:00,24 hrs.,pennystocks,TBLT,6,6,0,6,1,1,0,1,NASDAQ
5276,17-02-2021 10:00,24 hrs.,pennystocks,TXMD,26,26,0,26,1,2,18,1,NASDAQ
5276,17-02-2021 10:00,24 hrs.,pennystocks,NEOM,7,0,7,-7,1,1,1,1,OTC
5276,17-02-2021 10:00,24 hrs.,pennystocks,OPTI,9,0,9,-9,1,1,3,1,OTC
5276,17-02-2021 10:00,24 hrs.,pennystocks,RLBD,6,0,6,-6,1,1,0,1,OTC
5276,17-02-2021 10:00,24 hrs.,pennystocks,RSSV,66,0,66,-66,1,27,8,1,OTC
5276,17-02-2021 10:00,24 hrs.,pennystocks,SANP,16,16,0,16,1,4,4,1,OTC
5276,17-02-2021 10:00,24 hrs.,pennystocks,SFOR,48,48,0,48,2,14,12,2,OTC
5276,17-02-2021 10:00,24 hrs.,pennystocks,SGMD,6,0,6,-6,1,1,0,1,OTC
5276,17-02-2021 10:00,24 hrs.,pennystocks,SRMX,6,0,6,-6,1,1,0,1,OTC
5276,17-02-2021 10:00,24 hrs.,pennystocks,SRNA,6,0,6,-6,1,1,0,1,OTC
5276,17-02-2021 10:00,24 hrs.,pennystocks,SSFT,20,0,20,-20,1,6,4,1,OTC
5276,17-02-2021 10:00,24 hrs.,pennystocks,UBQU,35,0,35,-35,1,8,15,1,OTC
5276,17-02-2021 10:00,24 hrs.,pennystocks,ZPAS,12,0,12,-12,1,3,2,1,OTC
5276,17-02-2021 10:00,24 hrs.,pennystocks,ARBKF,92,0,92,-92,1,33,22,1,OTC
5276,17-02-2021 10:00,24 hrs.,pennystocks,BFARF,6,0,6,-6,1,1,0,1,OTC
5276,17-02-2021 10:00,24 hrs.,pennystocks,DIGAF,6,0,6,-6,1,1,0,1,OTC
5276,17-02-2021 10:00,24 hrs.,pennystocks,EFLVF,7,7,0,7,1,1,1,1,OTC
5276,17-02-2021 10:00,24 hrs.,pennystocks,FUNFF,33,0,33,-33,1,12,5,1,OTC
5276,17-02-2021 10:00,24 hrs.,pennystocks,HVBTF,7,0,7,-7,1,1,1,1,OTC
5276,17-02-2021 10:00,24 hrs.,pennystocks,MMEDF,32,0,32,-32,1,12,4,1,OTC
5276,17-02-2021 10:00,24 hrs.,pennystocks,MNXXF,100,0,100,-100,2,37,18,1,OTC
5276,17-02-2021 10:00,24 hrs.,pennystocks,NMGRF,6,0,6,-6,1,1,0,1,OTC
5276,17-02-2021 10:00,24 hrs.,pennystocks,NUSMF,6,0,6,-6,1,1,0,1,OTC
5276,17-02-2021 10:00,24 hrs.,pennystocks,REZZF,13,0,13,-13,2,2,1,1,OTC
5276,17-02-2021 10:00,24 hrs.,pennystocks,SPRWF,454,0,454,-454,3,184,74,3,OTC
5276,17-02-2021 10:00,24 hrs.,pennystocks,ZBISF,16,0,16,-16,1,4,4,1,OTC
5276,17-02-2021 10:00,24 hrs.,pennystocks,DNN,58,0,58,-58,1,19,16,1,AMEX
5276,17-02-2021 10:00,24 hrs.,pennystocks,GTE,7,0,7,-7,1,1,1,1,AMEX
5276,17-02-2021 10:00,24 hrs.,pennystocks,ISR,6,0,6,-6,1,1,0,1,AMEX
5276,17-02-2021 10:00,24 hrs.,pennystocks,ITP,25,0,25,-25,1,7,7,1,AMEX
5276,17-02-2021 10:00,24 hrs.,pennystocks,SYN,6,0,6,-6,1,1,0,1,AMEX
5276,17-02-2021 10:00,24 hrs.,pennystocks,GSAT,5,5,0,5,1,0,1,1,AMEX
5276,17-02-2021 10:00,24 hrs.,pennystocks,IBIO,6,0,6,-6,1,1,0,1,AMEX
5276,17-02-2021 10:00,24 hrs.,pennystocks,ATH,6,6,0,6,1,1,0,1,NYSE
5276,17-02-2021 10:00,24 hrs.,pennystocks,CBD,31,7,24,-17,3,7,5,3,NYSE
5276,17-02-2021 10:00,24 hrs.,pennystocks,GME,13,0,13,-13,2,2,1,2,NYSE
5276,17-02-2021 10:00,24 hrs.,pennystocks,HPQ,10,0,10,-10,1,2,2,1,NYSE
5276,17-02-2021 10:00,24 hrs.,pennystocks,JKS,32,0,32,-32,1,12,4,1,NYSE
5276,17-02-2021 10:00,24 hrs.,pennystocks,NOK,6,6,0,6,1,1,0,1,NYSE
5276,17-02-2021 10:00,24 hrs.,pennystocks,NUS,6,0,6,-6,1,1,0,1,NYSE
5276,17-02-2021 10:00,24 hrs.,pennystocks,SOS,19,0,19,-19,3,3,1,3,NYSE
5276,17-02-2021 10:00,24 hrs.,pennystocks,ARGO,13,0,13,-13,2,1,3,2,NYSE
5276,17-02-2021 10:00,24 hrs.,pennystocks,HEXO,16,0,16,-16,1,4,4,1,NYSE
5276,17-02-2021 10:00,24 hrs.,pennystocks,PUMP,6,0,6,-6,1,1,0,1,NYSE
5276,17-02-2021 10:00,24 hrs.,pennystocks,MKD,324,0,324,-324,1,141,38,1,NASDAQ
5276,17-02-2021 10:00,24 hrs.,pennystocks,TSC,6,0,6,-6,1,1,0,1,NASDAQ
5276,17-02-2021 10:00,24 hrs.,pennystocks,ADMA,623,0,623,-623,1,292,35,1,NASDAQ
5276,17-02-2021 10:00,24 hrs.,pennystocks,ADMP,6,0,6,-6,1,1,0,1,NASDAQ
5276,17-02-2021 10:00,24 hrs.,pennystocks,BNGO,31,31,0,31,1,2,23,1,NASDAQ
5276,17-02-2021 10:00,24 hrs.,pennystocks,CKPT,21,0,21,-21,1,6,5,1,NASDAQ
5276,17-02-2021 10:00,24 hrs.,pennystocks,CTXR,32,32,0,32,2,3,18,2,NASDAQ
5276,17-02-2021 10:00,24 hrs.,pennystocks,EBON,32,0,32,-32,1,12,4,1,NASDAQ
5276,17-02-2021 10:00,24 hrs.,pennystocks,GLBS,8,0,8,-8,1,0,4,1,NASDAQ
5276,17-02-2021 10:00,24 hrs.,pennystocks,GLMD,10,0,10,-10,1,2,2,1,NASDAQ
5276,17-02-2021 10:00,24 hrs.,pennystocks,MICT,141,120,21,99,2,53,27,2,NASDAQ
5276,17-02-2021 10:00,24 hrs.,pennystocks,NBEV,6,0,6,-6,1,1,0,1,NASDAQ
5276,17-02-2021 10:00,24 hrs.,pennystocks,NEOS,6,6,0,6,1,1,0,1,NASDAQ
5276,17-02-2021 10:00,24 hrs.,pennystocks,NNDM,15,0,15,-15,1,3,5,1,NASDAQ
5276,17-02-2021 10:00,24 hrs.,pennystocks,NVCR,32,0,32,-32,1,12,4,1,NASDAQ
5276,17-02-2021 10:00,24 hrs.,pennystocks,OCGN,6,0,6,-6,1,1,0,1,NASDAQ
5276,17-02-2021 10:00,24 hrs.,pennystocks,OKTA,32,0,32,-32,1,12,4,1,NASDAQ
5276,17-02-2021 10:00,24 hrs.,pennystocks,PLUG,32,0,32,-32,1,12,4,1,NASDAQ
5276,17-02-2021 10:00,24 hrs.,pennystocks,PULM,610,26,584,-558,2,243,116,2,NASDAQ
5276,17-02-2021 10:00,24 hrs.,pennystocks,QCOM,32,0,32,-32,1,12,4,1,NASDAQ
5276,17-02-2021 10:00,24 hrs.,pennystocks,SESN,31,0,31,-31,1,8,11,1,NASDAQ
5276,17-02-2021 10:00,24 hrs.,StockMarket,CBD,6,0,6,-6,1,1,0,1,NYSE
5276,17-02-2021 10:00,24 hrs.,StockMarket,CVS,239,0,239,-239,1,110,15,1,NYSE
5276,17-02-2021 10:00,24 hrs.,StockMarket,LUV,239,0,239,-239,1,110,15,1,NYSE
5276,17-02-2021 10:00,24 hrs.,StockMarket,PGR,239,0,239,-239,1,110,15,1,NYSE
5276,17-02-2021 10:00,24 hrs.,StockMarket,SOS,239,0,239,-239,1,110,15,1,NYSE
5276,17-02-2021 10:00,24 hrs.,StockMarket,STZ,239,0,239,-239,1,110,15,1,NYSE
5276,17-02-2021 10:00,24 hrs.,StockMarket,UBS,6,6,0,6,1,1,0,1,NYSE
5276,17-02-2021 10:00,24 hrs.,StockMarket,CLGX,239,0,239,-239,1,110,15,1,NYSE
5276,17-02-2021 10:00,24 hrs.,StockMarket,DASH,7,0,7,-7,1,0,3,1,NYSE
5276,17-02-2021 10:00,24 hrs.,StockMarket,LGVW,6,0,6,-6,1,1,0,1,NYSE
5276,17-02-2021 10:00,24 hrs.,StockMarket,PDAC,239,0,239,-239,1,110,15,1,NYSE
5276,17-02-2021 10:00,24 hrs.,StockMarket,PLTR,287,0,287,-287,2,120,39,2,NYSE
5276,17-02-2021 10:00,24 hrs.,StockMarket,PSTH,239,0,239,-239,1,110,15,1,NYSE
5276,17-02-2021 10:00,24 hrs.,StockMarket,SNY,239,0,239,-239,1,110,15,1,NASDAQ
5276,17-02-2021 10:00,24 hrs.,StockMarket,AAPL,239,0,239,-239,1,110,15,1,NASDAQ
5276,17-02-2021 10:00,24 hrs.,StockMarket,APHA,63,0,63,-63,1,25,9,1,NASDAQ
5276,17-02-2021 10:00,24 hrs.,StockMarket,ATOM,7,0,7,-7,1,0,3,1,NASDAQ
5276,17-02-2021 10:00,24 hrs.,StockMarket,CSGP,239,0,239,-239,1,110,15,1,NASDAQ
5276,17-02-2021 10:00,24 hrs.,StockMarket,CTAS,239,0,239,-239,1,110,15,1,NASDAQ
5276,17-02-2021 10:00,24 hrs.,StockMarket,DFFN,12,0,12,-12,2,2,0,1,NASDAQ
5276,17-02-2021 10:00,24 hrs.,StockMarket,EBON,239,0,239,-239,1,110,15,1,NASDAQ
5276,17-02-2021 10:00,24 hrs.,StockMarket,GLBS,239,0,239,-239,1,110,15,1,NASDAQ
5276,17-02-2021 10:00,24 hrs.,StockMarket,GTHX,239,0,239,-239,1,110,15,1,NASDAQ
5276,17-02-2021 10:00,24 hrs.,StockMarket,LIVE,239,0,239,-239,1,110,15,1,NASDAQ
5276,17-02-2021 10:00,24 hrs.,StockMarket,MSFT,239,0,239,-239,1,110,15,1,NASDAQ
5276,17-02-2021 10:00,24 hrs.,StockMarket,MSTR,239,0,239,-239,1,110,15,1,NASDAQ
5276,17-02-2021 10:00,24 hrs.,StockMarket,NNDM,239,0,239,-239,1,110,15,1,NASDAQ
5276,17-02-2021 10:00,24 hrs.,StockMarket,NVDA,239,0,239,-239,1,110,15,1,NASDAQ
5276,17-02-2021 10:00,24 hrs.,StockMarket,OTLK,11,0,11,-11,1,1,5,1,NASDAQ
5276,17-02-2021 10:00,24 hrs.,StockMarket,QCOM,239,0,239,-239,1,110,15,1,NASDAQ
5276,17-02-2021 10:00,24 hrs.,StockMarket,RIOT,239,0,239,-239,1,110,15,1,NASDAQ
5276,17-02-2021 10:00,24 hrs.,StockMarket,SNDL,456,456,0,456,1,140,172,1,NASDAQ
5276,17-02-2021 10:00,24 hrs.,StockMarket,GOOGL,239,0,239,-239,1,110,15,1,NASDAQ
5276,17-02-2021 10:00,24 hrs.,StockMarket,PTVCB,239,0,239,-239,1,110,15,1,NASDAQ
5276,17-02-2021 10:00,24 hrs.,pennystocks,AABB,31,0,31,-31,4,5,5,3,OTC
5276,17-02-2021 10:00,24 hrs.,pennystocks,AQSP,6,0,6,-6,1,1,0,1,OTC
5276,17-02-2021 10:00,24 hrs.,pennystocks,ASTI,7,0,7,-7,1,1,1,1,OTC
5276,17-02-2021 10:00,24 hrs.,pennystocks,BIEL,6,6,0,6,1,1,0,1,OTC
5276,17-02-2021 10:00,24 hrs.,pennystocks,BMIX,6,0,6,-6,1,1,0,1,OTC
5276,17-02-2021 10:00,24 hrs.,pennystocks,BOTY,64,64,0,64,1,16,28,1,OTC
5276,17-02-2021 10:00,24 hrs.,pennystocks,BRGO,6,0,6,-6,1,1,0,1,OTC
5276,17-02-2021 10:00,24 hrs.,pennystocks,BRRN,53,0,53,-53,2,18,9,2,OTC
5276,17-02-2021 10:00,24 hrs.,pennystocks,BRTX,6,6,0,6,1,1,0,1,OTC
5276,17-02-2021 10:00,24 hrs.,pennystocks,BRZL,6,0,6,-6,1,1,0,1,OTC
5276,17-02-2021 10:00,24 hrs.,pennystocks,CANN,7,7,0,7,1,1,1,1,OTC
5276,17-02-2021 10:00,24 hrs.,pennystocks,CBTC,7,7,0,7,1,1,1,1,OTC
5276,17-02-2021 10:00,24 hrs.,pennystocks,CETY,64,0,64,-64,1,24,12,1,OTC
5276,17-02-2021 10:00,24 hrs.,pennystocks,COMS,26,26,0,26,1,2,18,1,OTC
5276,17-02-2021 10:00,24 hrs.,pennystocks,CRWG,7,0,7,-7,1,1,1,1,OTC
5276,17-02-2021 10:00,24 hrs.,pennystocks,DPLS,12,6,6,0,2,2,0,2,OTC
5276,17-02-2021 10:00,24 hrs.,pennystocks,ENZC,6,6,0,6,1,1,0,1,OTC
5276,17-02-2021 10:00,24 hrs.,pennystocks,ETFM,93,0,93,-93,2,36,13,2,OTC
5276,17-02-2021 10:00,24 hrs.,pennystocks,FPVD,12,0,12,-12,1,3,2,1,OTC
5276,17-02-2021 10:00,24 hrs.,pennystocks,GAXY,105,18,87,-69,8,24,25,5,OTC
5276,17-02-2021 10:00,24 hrs.,pennystocks,GFTX,15,15,0,15,1,5,1,1,OTC
5276,17-02-2021 10:00,24 hrs.,pennystocks,GPFT,10,0,10,-10,1,1,4,1,OTC
5276,17-02-2021 10:00,24 hrs.,pennystocks,HCMC,32,7,25,-18,5,5,2,5,OTC
5276,17-02-2021 10:00,24 hrs.,pennystocks,HEME,7,0,7,-7,1,1,1,1,OTC
5276,17-02-2021 10:00,24 hrs.,pennystocks,HPMM,4,0,4,-4,1,0,0,1,OTC
5276,17-02-2021 10:00,24 hrs.,pennystocks,INKW,12,0,12,-12,2,2,0,2,OTC
5276,17-02-2021 10:00,24 hrs.,pennystocks,INTV,20,0,20,-20,1,5,6,1,OTC
5276,17-02-2021 10:00,24 hrs.,pennystocks,KNOS,6,6,0,6,1,1,0,1,OTC
5276,17-02-2021 10:00,24 hrs.,pennystocks,KWBT,7,0,7,-7,1,1,1,1,OTC
5276,17-02-2021 10:00,24 hrs.,pennystocks,KYNC,6,0,6,-6,1,1,0,1,OTC
5276,17-02-2021 10:00,24 hrs.,stocks,TSLA,96,71,25,46,2,29,30,2,NASDAQ
5276,17-02-2021 10:00,24 hrs.,stocks,USWS,7,0,7,-7,1,1,1,1,NASDAQ
5276,17-02-2021 10:00,24 hrs.,stocks,VIRT,25,0,25,-25,1,8,5,1,NASDAQ
5276,17-02-2021 10:00,24 hrs.,stocks,VYNE,12,0,12,-12,1,1,6,1,NASDAQ
5276,17-02-2021 10:00,24 hrs.,Daytrading,COMS,8,8,0,8,1,0,4,1,OTC
5276,17-02-2021 10:00,24 hrs.,Daytrading,GAXY,6,0,6,-6,1,1,0,1,OTC
5276,17-02-2021 10:00,24 hrs.,Daytrading,AMC,1198,0,1198,-1198,2,505,180,2,NYSE
5276,17-02-2021 10:00,24 hrs.,Daytrading,LAC,1192,0,1192,-1192,1,504,180,1,NYSE
5276,17-02-2021 10:00,24 hrs.,Daytrading,SOS,1192,0,1192,-1192,1,504,180,1,NYSE
5276,17-02-2021 10:00,24 hrs.,Daytrading,CCIV,1192,0,1192,-1192,1,504,180,1,NYSE
5276,17-02-2021 10:00,24 hrs.,Daytrading,PLTR,1192,0,1192,-1192,1,504,180,1,NYSE
5276,17-02-2021 10:00,24 hrs.,Daytrading,STPK,1192,0,1192,-1192,1,504,180,1,NYSE
5276,17-02-2021 10:00,24 hrs.,Daytrading,WBAI,1192,0,1192,-1192,1,504,180,1,NYSE
5276,17-02-2021 10:00,24 hrs.,Daytrading,MYT,1192,0,1192,-1192,1,504,180,1,NASDAQ
5276,17-02-2021 10:00,24 hrs.,Daytrading,APHA,1192,0,1192,-1192,1,504,180,1,NASDAQ
5276,17-02-2021 10:00,24 hrs.,Daytrading,AREC,1192,0,1192,-1192,1,504,180,1,NASDAQ
5276,17-02-2021 10:00,24 hrs.,Daytrading,ARTL,7,0,7,-7,1,1,1,1,NASDAQ
5276,17-02-2021 10:00,24 hrs.,Daytrading,BEAM,1192,0,1192,-1192,1,504,180,1,NASDAQ
5276,17-02-2021 10:00,24 hrs.,Daytrading,BLUE,1192,0,1192,-1192,1,504,180,1,NASDAQ
5276,17-02-2021 10:00,24 hrs.,Daytrading,CTXR,8,8,0,8,1,0,4,1,NASDAQ
5276,17-02-2021 10:00,24 hrs.,Daytrading,DFFN,1192,0,1192,-1192,1,504,180,1,NASDAQ
5276,17-02-2021 10:00,24 hrs.,Daytrading,FTFT,1192,0,1192,-1192,1,504,180,1,NASDAQ
5276,17-02-2021 10:00,24 hrs.,Daytrading,GILT,1192,0,1192,-1192,1,504,180,1,NASDAQ
5276,17-02-2021 10:00,24 hrs.,Daytrading,GTHX,1192,0,1192,-1192,1,504,180,1,NASDAQ
5276,17-02-2021 10:00,24 hrs.,Daytrading,MARA,1192,0,1192,-1192,1,504,180,1,NASDAQ
5276,17-02-2021 10:00,24 hrs.,Daytrading,NNDM,1192,0,1192,-1192,1,504,180,1,NASDAQ
5276,17-02-2021 10:00,24 hrs.,Daytrading,PULM,8,8,0,8,1,0,4,1,NASDAQ
5276,17-02-2021 10:00,24 hrs.,Daytrading,PYPL,1192,0,1192,-1192,1,504,180,1,NASDAQ
5276,17-02-2021 10:00,24 hrs.,Daytrading,RIOT,1192,0,1192,-1192,1,504,180,1,NASDAQ
5276,17-02-2021 10:00,24 hrs.,Daytrading,SCKT,1192,0,1192,-1192,1,504,180,1,NASDAQ
5276,17-02-2021 10:00,24 hrs.,Daytrading,TLRY,1192,0,1192,-1192,1,504,180,1,NASDAQ
5276,17-02-2021 10:00,24 hrs.,Daytrading,TRCH,1192,0,1192,-1192,1,504,180,1,NASDAQ
5276,17-02-2021 10:00,24 hrs.,Daytrading,TXMD,8,8,0,8,1,0,4,1,NASDAQ
5276,17-02-2021 10:00,24 hrs.,trakstocks,COMS,7,7,0,7,1,0,3,1,OTC
5276,17-02-2021 10:00,24 hrs.,trakstocks,INOTF,6,0,6,-6,1,1,0,1,OTC
5276,17-02-2021 10:00,24 hrs.,trakstocks,NMGRF,71,0,71,-71,1,23,21,1,OTC
5276,17-02-2021 10:00,24 hrs.,trakstocks,SENS,122,0,122,-122,1,50,18,1,AMEX
5276,17-02-2021 10:00,24 hrs.,trakstocks,PDAC,31,0,31,-31,1,12,3,1,NYSE
5276,17-02-2021 10:00,24 hrs.,trakstocks,QQQ,6,0,6,-6,1,1,0,1,NASDAQ
5276,17-02-2021 10:00,24 hrs.,trakstocks,AYRO,7,7,0,7,1,0,3,1,NASDAQ
5276,17-02-2021 10:00,24 hrs.,trakstocks,CFII,60,9,51,-42,2,19,14,2,NASDAQ
5276,17-02-2021 10:00,24 hrs.,trakstocks,CTXR,7,7,0,7,1,0,3,1,NASDAQ
5276,17-02-2021 10:00,24 hrs.,trakstocks,HEPA,23,0,23,-23,1,9,1,1,NASDAQ
5276,17-02-2021 10:00,24 hrs.,trakstocks,IMMR,20,0,20,-20,1,4,8,1,NASDAQ
5276,17-02-2021 10:00,24 hrs.,trakstocks,KTRA,18,18,0,18,3,3,0,1,NASDAQ
5276,17-02-2021 10:00,24 hrs.,trakstocks,LKCO,13,0,13,-13,1,3,3,1,NASDAQ
5276,17-02-2021 10:00,24 hrs.,trakstocks,NNDM,206,0,206,-206,1,76,50,1,NASDAQ
5276,17-02-2021 10:00,24 hrs.,trakstocks,PULM,7,7,0,7,1,0,3,1,NASDAQ
5276,17-02-2021 10:00,24 hrs.,trakstocks,RIOT,7,0,7,-7,1,1,1,1,NASDAQ
5276,17-02-2021 10:00,24 hrs.,trakstocks,STLD,6,0,6,-6,1,1,0,1,NASDAQ
5276,17-02-2021 10:00,24 hrs.,trakstocks,TQQQ,6,0,6,-6,1,1,0,1,NASDAQ
5276,17-02-2021 10:00,24 hrs.,trakstocks,TXMD,7,7,0,7,1,0,3,1,NASDAQ
5276,17-02-2021 10:00,24 hrs.,trakstocks,CMCSA,12,12,0,12,1,3,2,1,NASDAQ
5276,17-02-2021 10:00,24 hrs.,StockMarket,AQSP,6,0,6,-6,1,1,0,1,OTC
5276,17-02-2021 10:00,24 hrs.,StockMarket,KYNC,6,0,6,-6,1,1,0,1,OTC
5276,17-02-2021 10:00,24 hrs.,StockMarket,LINK,239,0,239,-239,1,110,15,1,OTC
5276,17-02-2021 10:00,24 hrs.,StockMarket,MOST,239,0,239,-239,1,110,15,1,OTC
5276,17-02-2021 10:00,24 hrs.,StockMarket,SRMX,6,0,6,-6,1,1,0,1,OTC
5276,17-02-2021 10:00,24 hrs.,StockMarket,NDVAF,456,456,0,456,1,140,172,1,OTC
5276,17-02-2021 10:00,24 hrs.,StockMarket,MXC,12,0,12,-12,2,2,0,2,AMEX
5276,17-02-2021 10:00,24 hrs.,StockMarket,AMC,10,0,10,-10,1,0,6,1,NYSE
5276,17-02-2021 10:00,24 hrs.,StockMarket,BMY,239,0,239,-239,1,110,15,1,NYSE
5276,17-02-2021 10:00,24 hrs.,StockMarket,BNY,239,0,239,-239,1,110,15,1,NYSE
5276,17-02-2021 10:00,24 hrs.,StockMarket,BUD,239,0,239,-239,1,110,15,1,NYSE
5276,17-02-2021 10:00,24 hrs.,SPACs,TEKK,336,0,336,-336,2,119,90,1,NASDAQ
5276,17-02-2021 10:00,24 hrs.,SPACs,THCB,8,8,0,8,1,1,2,1,NASDAQ
5276,17-02-2021 10:00,24 hrs.,SPACs,TLRY,7,0,7,-7,1,1,1,1,NASDAQ
5276,17-02-2021 10:00,24 hrs.,SPACs,TMPM,214,0,214,-214,1,71,68,1,NASDAQ
5276,17-02-2021 10:00,24 hrs.,SPACs,TMTS,336,0,336,-336,2,119,90,1,NASDAQ
5276,17-02-2021 10:00,24 hrs.,SPACs,TSIA,2096,0,2096,-2096,1,53,1986,1,NASDAQ
5276,17-02-2021 10:00,24 hrs.,SPACs,TSLA,7,0,7,-7,1,1,1,1,NASDAQ
5276,17-02-2021 10:00,24 hrs.,SPACs,TWCT,214,0,214,-214,1,71,68,1,NASDAQ
5276,17-02-2021 10:00,24 hrs.,SPACs,VACQ,214,0,214,-214,1,71,68,1,NASDAQ
5276,17-02-2021 10:00,24 hrs.,SPACs,VMAC,336,0,336,-336,2,119,90,1,NASDAQ
5276,17-02-2021 10:00,24 hrs.,SPACs,YSAC,336,0,336,-336,2,119,90,1,NASDAQ
5276,17-02-2021 10:00,24 hrs.,SPACs,ZGYH,336,0,336,-336,2,119,90,1,NASDAQ
5276,17-02-2021 10:00,24 hrs.,SPACs,ACTCW,2096,0,2096,-2096,1,53,1986,1,NASDAQ
5276,17-02-2021 10:00,24 hrs.,SPACs,CGROW,2096,0,2096,-2096,1,53,1986,1,NASDAQ
5276,17-02-2021 10:00,24 hrs.,SPACs,GNRSW,2096,0,2096,-2096,1,53,1986,1,NASDAQ
5276,17-02-2021 10:00,24 hrs.,SPACs,TWCTW,2096,0,2096,-2096,1,53,1986,1,NASDAQ
5276,17-02-2021 10:00,24 hrs.,SPACs,VACQW,2096,0,2096,-2096,1,53,1986,1,NASDAQ
5276,17-02-2021 10:00,24 hrs.,stocks,AQSP,6,0,6,-6,1,1,0,1,OTC
5276,17-02-2021 10:00,24 hrs.,stocks,CBBT,6,0,6,-6,1,1,0,1,OTC
5276,17-02-2021 10:00,24 hrs.,stocks,HCMC,7,0,7,-7,1,1,1,1,OTC
5276,17-02-2021 10:00,24 hrs.,stocks,GTE,6,0,6,-6,1,1,0,1,AMEX
5276,17-02-2021 10:00,24 hrs.,stocks,LNG,11,0,11,-11,1,3,1,1,AMEX
5276,17-02-2021 10:00,24 hrs.,stocks,NHS,345,0,345,-345,1,107,127,1,AMEX
5276,17-02-2021 10:00,24 hrs.,stocks,SENS,6,0,6,-6,1,1,0,1,AMEX
5276,17-02-2021 10:00,24 hrs.,stocks,AMC,25,0,25,-25,1,8,5,1,NYSE
5276,17-02-2021 10:00,24 hrs.,stocks,ASX,8,0,8,-8,1,1,2,1,NYSE
5276,17-02-2021 10:00,24 hrs.,stocks,AYX,6,6,0,6,1,1,0,1,NYSE
5276,17-02-2021 10:00,24 hrs.,stocks,CAH,25,0,25,-25,1,8,5,1,NYSE
5276,17-02-2021 10:00,24 hrs.,stocks,CBD,6,0,6,-6,1,1,0,1,NYSE
5276,17-02-2021 10:00,24 hrs.,stocks,GME,31,0,31,-31,2,9,5,2,NYSE
5276,17-02-2021 10:00,24 hrs.,stocks,GPS,71,71,0,71,1,21,25,1,NYSE
5276,17-02-2021 10:00,24 hrs.,stocks,MRK,29,0,29,-29,1,9,7,1,NYSE
5276,17-02-2021 10:00,24 hrs.,stocks,NOK,25,0,25,-25,1,8,5,1,NYSE
5276,17-02-2021 10:00,24 hrs.,stocks,RKT,101,0,101,-101,2,36,21,2,NYSE
5276,17-02-2021 10:00,24 hrs.,stocks,TSE,18,0,18,-18,3,3,0,1,NYSE
5276,17-02-2021 10:00,24 hrs.,stocks,ARGO,7,0,7,-7,1,1,1,1,NYSE
5276,17-02-2021 10:00,24 hrs.,stocks,FVRR,6,0,6,-6,1,1,0,1,NYSE
5276,17-02-2021 10:00,24 hrs.,stocks,GLOG,11,0,11,-11,1,3,1,1,NYSE
5276,17-02-2021 10:00,24 hrs.,stocks,PLTR,967,0,967,-967,2,276,407,2,NYSE
5276,17-02-2021 10:00,24 hrs.,stocks,FUV,18,0,18,-18,3,3,0,1,NASDAQ
5276,17-02-2021 10:00,24 hrs.,stocks,OGI,7,7,0,7,1,1,1,1,NASDAQ
5276,17-02-2021 10:00,24 hrs.,stocks,OSW,6,0,6,-6,1,1,0,1,NASDAQ
5276,17-02-2021 10:00,24 hrs.,stocks,SLS,71,71,0,71,1,21,25,1,NASDAQ
5276,17-02-2021 10:00,24 hrs.,stocks,AAPL,6,0,6,-6,1,1,0,1,NASDAQ
5276,17-02-2021 10:00,24 hrs.,stocks,AGTC,78,78,0,78,1,21,32,1,NASDAQ
5276,17-02-2021 10:00,24 hrs.,stocks,AMTX,6,0,6,-6,1,1,0,1,NASDAQ
5276,17-02-2021 10:00,24 hrs.,stocks,APHA,6,0,6,-6,1,1,0,1,NASDAQ
5276,17-02-2021 10:00,24 hrs.,stocks,AVCT,6,0,6,-6,1,1,0,1,NASDAQ
5276,17-02-2021 10:00,24 hrs.,stocks,AXSM,6,0,6,-6,1,1,0,1,NASDAQ
5276,17-02-2021 10:00,24 hrs.,stocks,CTRM,7,0,7,-7,1,1,1,1,NASDAQ
5276,17-02-2021 10:00,24 hrs.,stocks,CTSO,26,0,26,-26,1,9,4,1,NASDAQ
5276,17-02-2021 10:00,24 hrs.,stocks,EXPI,13,0,13,-13,2,2,1,2,NASDAQ
5276,17-02-2021 10:00,24 hrs.,stocks,FIII,6,0,6,-6,1,1,0,1,NASDAQ
5276,17-02-2021 10:00,24 hrs.,stocks,FLWS,25,0,25,-25,1,8,5,1,NASDAQ
5276,17-02-2021 10:00,24 hrs.,stocks,IBKR,6,6,0,6,1,0,2,1,NASDAQ
5276,17-02-2021 10:00,24 hrs.,stocks,IMVT,6,6,0,6,1,1,0,1,NASDAQ
5276,17-02-2021 10:00,24 hrs.,stocks,IRDM,53,0,53,-53,1,16,17,1,NASDAQ
5276,17-02-2021 10:00,24 hrs.,stocks,MICT,6,0,6,-6,1,1,0,1,NASDAQ
5276,17-02-2021 10:00,24 hrs.,stocks,MOGO,6,0,6,-6,1,1,0,1,NASDAQ
5276,17-02-2021 10:00,24 hrs.,stocks,NKLA,26,0,26,-26,1,5,12,1,NASDAQ
5276,17-02-2021 10:00,24 hrs.,stocks,ONTX,6,0,6,-6,1,1,0,1,NASDAQ
5276,17-02-2021 10:00,24 hrs.,stocks,SNBR,6,0,6,-6,1,1,0,1,NASDAQ
5276,17-02-2021 10:00,24 hrs.,stocks,THRM,6,0,6,-6,1,1,0,1,NASDAQ
5276,17-02-2021 10:00,24 hrs.,stocks,TLRY,6,0,6,-6,1,1,0,1,NASDAQ
5276,17-02-2021 10:00,24 hrs.,SPACs,SNDL,7,0,7,-7,1,1,1,1,NASDAQ
5276,17-02-2021 10:00,24 hrs.,SPACs,STWO,214,0,214,-214,1,71,68,1,NASDAQ
5276,17-02-2021 10:00,24 hrs.,SPACs,SVAC,214,0,214,-214,1,71,68,1,NASDAQ
5276,17-02-2021 10:00,24 hrs.,SPACs,FIII,18,0,18,-18,1,0,14,1,NASDAQ
5276,17-02-2021 10:00,24 hrs.,SPACs,FSDC,2096,0,2096,-2096,1,53,1986,1,NASDAQ
5276,17-02-2021 10:00,24 hrs.,SPACs,FTIV,122,0,122,-122,1,48,22,1,NASDAQ
5276,17-02-2021 10:00,24 hrs.,SPACs,FVAM,214,0,214,-214,1,71,68,1,NASDAQ
5276,17-02-2021 10:00,24 hrs.,SPACs,GNRS,336,0,336,-336,2,119,90,1,NASDAQ
5276,17-02-2021 10:00,24 hrs.,SPACs,GRCY,336,0,336,-336,2,119,90,1,NASDAQ
5276,17-02-2021 10:00,24 hrs.,SPACs,GRNV,336,0,336,-336,2,119,90,1,NASDAQ
5276,17-02-2021 10:00,24 hrs.,SPACs,GWAC,336,0,336,-336,2,119,90,1,NASDAQ
5276,17-02-2021 10:00,24 hrs.,SPACs,GXGX,2432,0,2432,-2432,3,172,2076,1,NASDAQ
5276,17-02-2021 10:00,24 hrs.,SPACs,HEAR,301,0,301,-301,1,102,93,1,NASDAQ
5276,17-02-2021 10:00,24 hrs.,SPACs,IGAC,214,0,214,-214,1,71,68,1,NASDAQ
5276,17-02-2021 10:00,24 hrs.,SPACs,INAQ,2096,0,2096,-2096,1,53,1986,1,NASDAQ
5276,17-02-2021 10:00,24 hrs.,SPACs,ITAC,336,0,336,-336,2,119,90,1,NASDAQ
5276,17-02-2021 10:00,24 hrs.,SPACs,JYAC,214,0,214,-214,1,71,68,1,NASDAQ
5276,17-02-2021 10:00,24 hrs.,SPACs,KSMT,336,0,336,-336,2,119,90,1,NASDAQ
5276,17-02-2021 10:00,24 hrs.,SPACs,LACQ,122,0,122,-122,1,48,22,1,NASDAQ
5276,17-02-2021 10:00,24 hrs.,SPACs,LATN,336,0,336,-336,2,119,90,1,NASDAQ
5276,17-02-2021 10:00,24 hrs.,SPACs,LCAP,336,0,336,-336,2,119,90,1,NASDAQ
5276,17-02-2021 10:00,24 hrs.,SPACs,LFTR,214,0,214,-214,1,71,68,1,NASDAQ
5276,17-02-2021 10:00,24 hrs.,SPACs,LIVE,7,0,7,-7,1,1,1,1,NASDAQ
5276,17-02-2021 10:00,24 hrs.,SPACs,LIVK,336,0,336,-336,2,119,90,1,NASDAQ
5276,17-02-2021 10:00,24 hrs.,SPACs,LOAC,122,0,122,-122,1,48,22,1,NASDAQ
5276,17-02-2021 10:00,24 hrs.,SPACs,LSAQ,214,0,214,-214,1,71,68,1,NASDAQ
5276,17-02-2021 10:00,24 hrs.,SPACs,MAAC,336,0,336,-336,2,119,90,1,NASDAQ
5276,17-02-2021 10:00,24 hrs.,SPACs,MACU,336,0,336,-336,2,119,90,1,NASDAQ
5276,17-02-2021 10:00,24 hrs.,SPACs,MCMJ,214,0,214,-214,1,71,68,1,NASDAQ
5276,17-02-2021 10:00,24 hrs.,SPACs,MLAC,336,0,336,-336,2,119,90,1,NASDAQ
5276,17-02-2021 10:00,24 hrs.,SPACs,MOTN,336,0,336,-336,2,119,90,1,NASDAQ
5276,17-02-2021 10:00,24 hrs.,SPACs,NBAC,37,0,37,-37,1,16,1,1,NASDAQ
5276,17-02-2021 10:00,24 hrs.,SPACs,NGAC,17,0,17,-17,2,1,7,1,NASDAQ
5276,17-02-2021 10:00,24 hrs.,SPACs,NHIC,336,0,336,-336,2,119,90,1,NASDAQ
5276,17-02-2021 10:00,24 hrs.,SPACs,NMMC,336,0,336,-336,2,119,90,1,NASDAQ
5276,17-02-2021 10:00,24 hrs.,SPACs,OTRA,336,0,336,-336,2,119,90,1,NASDAQ
5276,17-02-2021 10:00,24 hrs.,SPACs,PAIC,336,0,336,-336,2,119,90,1,NASDAQ
5276,17-02-2021 10:00,24 hrs.,SPACs,PSAC,2096,0,2096,-2096,1,53,1986,1,NASDAQ
5276,17-02-2021 10:00,24 hrs.,SPACs,RCHG,336,0,336,-336,2,119,90,1,NASDAQ
5276,17-02-2021 10:00,24 hrs.,SPACs,SAII,214,0,214,-214,1,71,68,1,NASDAQ
5276,17-02-2021 10:00,24 hrs.,SPACs,SGAM,336,0,336,-336,2,119,90,1,NASDAQ
5276,17-02-2021 10:00,24 hrs.,SPACs,CPSR,336,0,336,-336,2,119,90,1,NYSE
5276,17-02-2021 10:00,24 hrs.,SPACs,CTAC,122,0,122,-122,1,48,22,1,NYSE
5276,17-02-2021 10:00,24 hrs.,SPACs,DFNS,214,0,214,-214,1,71,68,1,NYSE
5276,17-02-2021 10:00,24 hrs.,SPACs,DMYD,114,0,114,-114,1,45,20,1,NYSE
5276,17-02-2021 10:00,24 hrs.,SPACs,EMPW,336,0,336,-336,2,119,90,1,NYSE
5276,17-02-2021 10:00,24 hrs.,SPACs,ENPC,2096,0,2096,-2096,1,53,1986,1,NYSE
5276,17-02-2021 10:00,24 hrs.,SPACs,FMAC,2096,0,2096,-2096,1,53,1986,1,NYSE
5276,17-02-2021 10:00,24 hrs.,SPACs,FUSE,29,0,29,-29,3,4,9,3,NYSE
5276,17-02-2021 10:00,24 hrs.,SPACs,GLEO,336,0,336,-336,2,119,90,1,NYSE
5276,17-02-2021 10:00,24 hrs.,SPACs,GOAC,336,0,336,-336,2,119,90,1,NYSE
5276,17-02-2021 10:00,24 hrs.,SPACs,GSAH,7,7,0,7,1,1,1,1,NYSE
5276,17-02-2021 10:00,24 hrs.,SPACs,HIGA,336,0,336,-336,2,119,90,1,NYSE
5276,17-02-2021 10:00,24 hrs.,SPACs,HZON,214,0,214,-214,1,71,68,1,NYSE
5276,17-02-2021 10:00,24 hrs.,SPACs,IPOD,2096,0,2096,-2096,1,53,1986,1,NYSE
5276,17-02-2021 10:00,24 hrs.,SPACs,IPOF,2096,0,2096,-2096,1,53,1986,1,NYSE
5276,17-02-2021 10:00,24 hrs.,SPACs,OACB,214,0,214,-214,1,71,68,1,NYSE
5276,17-02-2021 10:00,24 hrs.,SPACs,PDAC,2863,0,2863,-2863,4,336,2175,4,NYSE
5276,17-02-2021 10:00,24 hrs.,SPACs,PIAI,336,0,336,-336,2,119,90,1,NYSE
5276,17-02-2021 10:00,24 hrs.,SPACs,PLTR,7,0,7,-7,1,1,1,1,NYSE
5276,17-02-2021 10:00,24 hrs.,SPACs,PMVC,336,0,336,-336,2,119,90,1,NYSE
5276,17-02-2021 10:00,24 hrs.,SPACs,PRPB,2310,0,2310,-2310,2,124,2054,1,NYSE
5276,17-02-2021 10:00,24 hrs.,SPACs,PSTH,2122,0,2122,-2122,2,53,2008,2,NYSE
5276,17-02-2021 10:00,24 hrs.,SPACs,RBAC,2310,0,2310,-2310,2,124,2054,1,NYSE
5276,17-02-2021 10:00,24 hrs.,SPACs,RPLA,2432,0,2432,-2432,3,172,2076,1,NYSE
5276,17-02-2021 10:00,24 hrs.,SPACs,SCPE,336,0,336,-336,2,119,90,1,NYSE
5276,17-02-2021 10:00,24 hrs.,SPACs,SCVX,228,0,228,-228,3,73,70,3,NYSE
5276,17-02-2021 10:00,24 hrs.,SPACs,SEAH,336,0,336,-336,2,119,90,1,NYSE
5276,17-02-2021 10:00,24 hrs.,SPACs,SFTW,336,0,336,-336,2,119,90,1,NYSE
5276,17-02-2021 10:00,24 hrs.,SPACs,STPK,76,0,76,-76,1,16,40,1,NYSE
5276,17-02-2021 10:00,24 hrs.,SPACs,TREB,214,0,214,-214,1,71,68,1,NYSE
5276,17-02-2021 10:00,24 hrs.,SPACs,ADV,2096,0,2096,-2096,1,53,1986,1,NASDAQ
5276,17-02-2021 10:00,24 hrs.,SPACs,CFO,301,0,301,-301,1,102,93,1,NASDAQ
5276,17-02-2021 10:00,24 hrs.,SPACs,HAS,301,0,301,-301,1,102,93,1,NASDAQ
5276,17-02-2021 10:00,24 hrs.,SPACs,JAN,37,0,37,-37,1,16,1,1,NASDAQ
5276,17-02-2021 10:00,24 hrs.,SPACs,AACQ,2329,218,2111,-1893,3,147,2023,3,NASDAQ
5276,17-02-2021 10:00,24 hrs.,SPACs,ACAC,214,0,214,-214,1,71,68,1,NASDAQ
5276,17-02-2021 10:00,24 hrs.,SPACs,ACAM,2096,0,2096,-2096,1,53,1986,1,NASDAQ
5276,17-02-2021 10:00,24 hrs.,SPACs,ADOC,336,0,336,-336,2,119,90,1,NASDAQ
5276,17-02-2021 10:00,24 hrs.,SPACs,AGBA,336,0,336,-336,2,119,90,1,NASDAQ
5276,17-02-2021 10:00,24 hrs.,SPACs,AHAC,336,0,336,-336,2,119,90,1,NASDAQ
5276,17-02-2021 10:00,24 hrs.,SPACs,ALAC,122,0,122,-122,1,48,22,1,NASDAQ
5276,17-02-2021 10:00,24 hrs.,SPACs,AMCI,2096,0,2096,-2096,1,53,1986,1,NASDAQ
5276,17-02-2021 10:00,24 hrs.,SPACs,AMHC,214,0,214,-214,1,71,68,1,NASDAQ
5276,17-02-2021 10:00,24 hrs.,SPACs,ANDA,122,0,122,-122,1,48,22,1,NASDAQ
5276,17-02-2021 10:00,24 hrs.,SPACs,APHA,7,0,7,-7,1,1,1,1,NASDAQ
5276,17-02-2021 10:00,24 hrs.,SPACs,BHSE,336,0,336,-336,2,119,90,1,NASDAQ
5276,17-02-2021 10:00,24 hrs.,SPACs,BOWX,336,0,336,-336,2,119,90,1,NASDAQ
5276,17-02-2021 10:00,24 hrs.,SPACs,BREZ,336,0,336,-336,2,119,90,1,NASDAQ
5276,17-02-2021 10:00,24 hrs.,SPACs,BRLI,336,0,336,-336,2,119,90,1,NASDAQ
5276,17-02-2021 10:00,24 hrs.,SPACs,BTAQ,214,0,214,-214,1,71,68,1,NASDAQ
5276,17-02-2021 10:00,24 hrs.,SPACs,BWAC,214,0,214,-214,1,71,68,1,NASDAQ
5276,17-02-2021 10:00,24 hrs.,SPACs,CAPA,336,0,336,-336,2,119,90,1,NASDAQ
5276,17-02-2021 10:00,24 hrs.,SPACs,CFAC,18,0,18,-18,1,3,8,1,NASDAQ
5276,17-02-2021 10:00,24 hrs.,SPACs,CHPM,336,0,336,-336,2,119,90,1,NASDAQ
5276,17-02-2021 10:00,24 hrs.,SPACs,CONX,214,0,214,-214,1,71,68,1,NASDAQ
5276,17-02-2021 10:00,24 hrs.,SPACs,CRSA,336,0,336,-336,2,119,90,1,NASDAQ
5276,17-02-2021 10:00,24 hrs.,SPACs,DBDR,336,0,336,-336,2,119,90,1,NASDAQ
5276,17-02-2021 10:00,24 hrs.,SPACs,DFPH,214,0,214,-214,1,71,68,1,NASDAQ
5276,17-02-2021 10:00,24 hrs.,SPACs,DSAC,214,0,214,-214,1,71,68,1,NASDAQ
5276,17-02-2021 10:00,24 hrs.,SPACs,EDIT,301,0,301,-301,1,102,93,1,NASDAQ
5276,17-02-2021 10:00,24 hrs.,SPACs,ERES,336,0,336,-336,2,119,90,1,NASDAQ
5276,17-02-2021 10:00,24 hrs.,SPACs,ESSC,336,0,336,-336,2,119,90,1,NASDAQ
5276,17-02-2021 10:00,24 hrs.,SPACs,ETAC,214,0,214,-214,1,71,68,1,NASDAQ
5276,17-02-2021 10:00,24 hrs.,SPACs,EUCR,336,0,336,-336,2,119,90,1,NASDAQ
5276,17-02-2021 10:00,24 hrs.,SPACs,NBA,336,0,336,-336,2,119,90,1,AMEX
5276,17-02-2021 10:00,24 hrs.,SPACs,PTK,336,0,336,-336,2,119,90,1,AMEX
5276,17-02-2021 10:00,24 hrs.,SPACs,CHAQ,2432,0,2432,-2432,3,172,2076,1,AMEX
5276,17-02-2021 10:00,24 hrs.,SPACs,BSN,336,0,336,-336,2,119,90,1,NYSE
5276,17-02-2021 10:00,24 hrs.,SPACs,CCX,336,0,336,-336,2,119,90,1,NYSE
5276,17-02-2021 10:00,24 hrs.,SPACs,DEH,336,0,336,-336,2,119,90,1,NYSE
5276,17-02-2021 10:00,24 hrs.,SPACs,EQD,214,0,214,-214,1,71,68,1,NYSE
5276,17-02-2021 10:00,24 hrs.,SPACs,GIX,336,0,336,-336,2,119,90,1,NYSE
5276,17-02-2021 10:00,24 hrs.,SPACs,GME,7,0,7,-7,1,1,1,1,NYSE
5276,17-02-2021 10:00,24 hrs.,SPACs,HPX,336,0,336,-336,2,119,90,1,NYSE
5276,17-02-2021 10:00,24 hrs.,SPACs,NAV,1326,0,1326,-1326,2,370,578,2,NYSE
5276,17-02-2021 10:00,24 hrs.,SPACs,NSH,336,0,336,-336,2,119,90,1,NYSE
5276,17-02-2021 10:00,24 hrs.,SPACs,RTP,2103,0,2103,-2103,2,54,1987,2,NYSE
5276,17-02-2021 10:00,24 hrs.,SPACs,SBG,2905,0,2905,-2905,5,361,2163,3,NYSE
5276,17-02-2021 10:00,24 hrs.,SPACs,WPF,214,0,214,-214,1,71,68,1,NYSE
5276,17-02-2021 10:00,24 hrs.,SPACs,YAC,336,0,336,-336,2,119,90,1,NYSE
5276,17-02-2021 10:00,24 hrs.,SPACs,ACND,122,0,122,-122,1,48,22,1,NYSE
5276,17-02-2021 10:00,24 hrs.,SPACs,AJAX,13,0,13,-13,1,0,9,1,NYSE
5276,17-02-2021 10:00,24 hrs.,SPACs,ALUS,7,0,7,-7,1,1,1,1,NYSE
5276,17-02-2021 10:00,24 hrs.,SPACs,APSG,214,0,214,-214,1,71,68,1,NYSE
5276,17-02-2021 10:00,24 hrs.,SPACs,ASAQ,336,0,336,-336,2,119,90,1,NYSE
5276,17-02-2021 10:00,24 hrs.,SPACs,ASPL,214,0,214,-214,1,71,68,1,NYSE
5276,17-02-2021 10:00,24 hrs.,SPACs,ATAC,214,0,214,-214,1,71,68,1,NYSE
5276,17-02-2021 10:00,24 hrs.,SPACs,AVAN,214,0,214,-214,1,71,68,1,NYSE
5276,17-02-2021 10:00,24 hrs.,SPACs,BOAC,214,0,214,-214,1,71,68,1,NYSE
5276,17-02-2021 10:00,24 hrs.,SPACs,CCAC,2096,0,2096,-2096,1,53,1986,1,NYSE
5276,17-02-2021 10:00,24 hrs.,SPACs,CCIV,2599,1500,1099,401,5,954,671,4,NYSE
5276,17-02-2021 10:00,24 hrs.,wallstreetbets,ZYNE,6,0,6,-6,1,1,0,1,NASDAQ
5276,17-02-2021 10:00,24 hrs.,RobinHoodPennyStocks,AQSP,12,0,12,-12,2,2,0,2,OTC
5276,17-02-2021 10:00,24 hrs.,RobinHoodPennyStocks,ENKS,6,0,6,-6,1,1,0,1,OTC
5276,17-02-2021 10:00,24 hrs.,RobinHoodPennyStocks,PFFOF,6,0,6,-6,1,1,0,1,OTC
5276,17-02-2021 10:00,24 hrs.,RobinHoodPennyStocks,DNN,23,23,0,23,1,2,15,1,AMEX
5276,17-02-2021 10:00,24 hrs.,RobinHoodPennyStocks,GTE,7,0,7,-7,1,1,1,1,AMEX
5276,17-02-2021 10:00,24 hrs.,RobinHoodPennyStocks,ITP,6,0,6,-6,1,1,0,1,AMEX
5276,17-02-2021 10:00,24 hrs.,RobinHoodPennyStocks,NAK,23,23,0,23,1,2,15,1,AMEX
5276,17-02-2021 10:00,24 hrs.,RobinHoodPennyStocks,EMAN,15,0,15,-15,1,4,3,1,AMEX
5276,17-02-2021 10:00,24 hrs.,RobinHoodPennyStocks,GSAT,6,0,6,-6,1,1,0,1,AMEX
5276,17-02-2021 10:00,24 hrs.,RobinHoodPennyStocks,AMC,27,27,0,27,1,4,15,1,NYSE
5276,17-02-2021 10:00,24 hrs.,RobinHoodPennyStocks,CBD,12,0,12,-12,2,2,0,2,NYSE
5276,17-02-2021 10:00,24 hrs.,RobinHoodPennyStocks,CPE,6,0,6,-6,1,1,0,1,NYSE
5276,17-02-2021 10:00,24 hrs.,RobinHoodPennyStocks,GME,6,0,6,-6,1,1,0,1,NYSE
5276,17-02-2021 10:00,24 hrs.,RobinHoodPennyStocks,KOS,6,0,6,-6,1,1,0,1,NYSE
5276,17-02-2021 10:00,24 hrs.,RobinHoodPennyStocks,PLTR,6,0,6,-6,1,1,0,1,NYSE
5276,17-02-2021 10:00,24 hrs.,RobinHoodPennyStocks,SND,6,0,6,-6,1,1,0,1,NASDAQ
5276,17-02-2021 10:00,24 hrs.,RobinHoodPennyStocks,ABEO,46,0,46,-46,1,17,8,1,NASDAQ
5276,17-02-2021 10:00,24 hrs.,RobinHoodPennyStocks,ACST,9,0,9,-9,1,2,1,1,NASDAQ
5276,17-02-2021 10:00,24 hrs.,RobinHoodPennyStocks,AGTC,493,70,423,-353,5,166,141,4,NASDAQ
5276,17-02-2021 10:00,24 hrs.,RobinHoodPennyStocks,APHA,12,0,12,-12,2,2,0,2,NASDAQ
5276,17-02-2021 10:00,24 hrs.,RobinHoodPennyStocks,ATOS,18,18,0,18,1,4,6,1,NASDAQ
5276,17-02-2021 10:00,24 hrs.,RobinHoodPennyStocks,CTRM,18,6,12,-6,3,3,0,3,NASDAQ
5276,17-02-2021 10:00,24 hrs.,RobinHoodPennyStocks,CTXR,90,84,6,78,2,26,30,2,NASDAQ
5276,17-02-2021 10:00,24 hrs.,RobinHoodPennyStocks,CYCC,6,0,6,-6,1,1,0,1,NASDAQ
5276,17-02-2021 10:00,24 hrs.,RobinHoodPennyStocks,DFFN,773,6,767,-761,4,304,149,3,NASDAQ
5276,17-02-2021 10:00,24 hrs.,RobinHoodPennyStocks,EOLS,17,0,17,-17,1,6,1,1,NASDAQ
5276,17-02-2021 10:00,24 hrs.,RobinHoodPennyStocks,HEPA,27,27,0,27,1,4,15,1,NASDAQ
5276,17-02-2021 10:00,24 hrs.,RobinHoodPennyStocks,IDEX,73,0,73,-73,2,30,5,2,NASDAQ
5276,17-02-2021 10:00,24 hrs.,RobinHoodPennyStocks,LIVE,6,0,6,-6,1,1,0,1,NASDAQ
5276,17-02-2021 10:00,24 hrs.,RobinHoodPennyStocks,LKCO,6,0,6,-6,1,1,0,1,NASDAQ
5276,17-02-2021 10:00,24 hrs.,RobinHoodPennyStocks,NDRA,17,0,17,-17,1,4,5,1,NASDAQ
5276,17-02-2021 10:00,24 hrs.,RobinHoodPennyStocks,NVIV,6,0,6,-6,1,1,0,1,NASDAQ
5276,17-02-2021 10:00,24 hrs.,RobinHoodPennyStocks,NXTD,6,0,6,-6,1,1,0,1,NASDAQ
5276,17-02-2021 10:00,24 hrs.,RobinHoodPennyStocks,OPGN,6,0,6,-6,1,1,0,1,NASDAQ
5276,17-02-2021 10:00,24 hrs.,RobinHoodPennyStocks,RWLK,6,6,0,6,1,1,0,1,NASDAQ
5276,17-02-2021 10:00,24 hrs.,RobinHoodPennyStocks,SNCA,9,0,9,-9,1,2,1,1,NASDAQ
5276,17-02-2021 10:00,24 hrs.,RobinHoodPennyStocks,SNDL,6,0,6,-6,1,1,0,1,NASDAQ
5276,17-02-2021 10:00,24 hrs.,RobinHoodPennyStocks,SONM,52,52,0,52,1,16,16,1,NASDAQ
5276,17-02-2021 10:00,24 hrs.,RobinHoodPennyStocks,SSPK,6,0,6,-6,1,1,0,1,NASDAQ
5276,17-02-2021 10:00,24 hrs.,RobinHoodPennyStocks,TLRY,6,0,6,-6,1,1,0,1,NASDAQ
5276,17-02-2021 10:00,24 hrs.,RobinHoodPennyStocks,TNXP,6,0,6,-6,1,1,0,1,NASDAQ
5276,17-02-2021 10:00,24 hrs.,RobinHoodPennyStocks,TRCH,6,0,6,-6,1,1,0,1,NASDAQ
5276,17-02-2021 10:00,24 hrs.,RobinHoodPennyStocks,TSLA,6,0,6,-6,1,1,0,1,NASDAQ
5276,17-02-2021 10:00,24 hrs.,RobinHoodPennyStocks,TXMD,18,12,6,6,3,3,0,3,NASDAQ
5276,17-02-2021 10:00,24 hrs.,RobinHoodPennyStocks,TYME,6,6,0,6,1,1,0,1,NASDAQ
5276,17-02-2021 10:00,24 hrs.,RobinHoodPennyStocks,VBIV,11,0,11,-11,1,0,7,1,NASDAQ
5276,17-02-2021 10:00,24 hrs.,RobinHoodPennyStocks,YTRA,12,12,0,12,2,2,0,1,NASDAQ
5276,17-02-2021 10:00,24 hrs.,wallstreetbets,CRON,7,0,7,-7,1,1,1,1,NASDAQ
5276,17-02-2021 10:00,24 hrs.,wallstreetbets,CRSP,6,6,0,6,1,1,0,1,NASDAQ
5276,17-02-2021 10:00,24 hrs.,wallstreetbets,CRSR,1535,0,1535,-1535,2,654,219,2,NASDAQ
5276,17-02-2021 10:00,24 hrs.,wallstreetbets,CTRM,34,0,34,-34,5,5,4,5,NASDAQ
5276,17-02-2021 10:00,24 hrs.,wallstreetbets,DLPN,7,7,0,7,1,1,1,1,NASDAQ
5276,17-02-2021 10:00,24 hrs.,wallstreetbets,DOYU,14,0,14,-14,2,2,2,1,NASDAQ
5276,17-02-2021 10:00,24 hrs.,wallstreetbets,EBON,7,0,7,-7,1,1,1,1,NASDAQ
5276,17-02-2021 10:00,24 hrs.,wallstreetbets,FLDM,7,0,7,-7,1,1,1,1,NASDAQ
5276,17-02-2021 10:00,24 hrs.,wallstreetbets,GAIN,6,6,0,6,1,1,0,1,NASDAQ
5276,17-02-2021 10:00,24 hrs.,wallstreetbets,GLBS,14,0,14,-14,2,2,2,2,NASDAQ
5276,17-02-2021 10:00,24 hrs.,wallstreetbets,GOOG,11,4,7,-3,2,1,1,2,NASDAQ
5276,17-02-2021 10:00,24 hrs.,wallstreetbets,GRWG,6,0,6,-6,1,1,0,1,NASDAQ
5276,17-02-2021 10:00,24 hrs.,wallstreetbets,GTHX,60,0,60,-60,1,7,42,1,NASDAQ
5276,17-02-2021 10:00,24 hrs.,wallstreetbets,HEPA,7,0,7,-7,1,1,1,1,NASDAQ
5276,17-02-2021 10:00,24 hrs.,wallstreetbets,HJLI,6,0,6,-6,1,1,0,1,NASDAQ
5276,17-02-2021 10:00,24 hrs.,wallstreetbets,IDEX,14,0,14,-14,2,2,2,2,NASDAQ
5276,17-02-2021 10:00,24 hrs.,wallstreetbets,INPX,7,0,7,-7,1,1,1,1,NASDAQ
5276,17-02-2021 10:00,24 hrs.,wallstreetbets,KBNT,7,0,7,-7,1,1,1,1,NASDAQ
5276,17-02-2021 10:00,24 hrs.,wallstreetbets,LEGN,6,6,0,6,1,1,0,1,NASDAQ
5276,17-02-2021 10:00,24 hrs.,wallstreetbets,LIFE,7,0,7,-7,1,1,1,1,NASDAQ
5276,17-02-2021 10:00,24 hrs.,wallstreetbets,LKCO,15,8,7,1,2,2,3,2,NASDAQ
5276,17-02-2021 10:00,24 hrs.,wallstreetbets,MARA,21,7,14,-7,3,3,3,3,NASDAQ
5276,17-02-2021 10:00,24 hrs.,wallstreetbets,MAXN,13,0,13,-13,2,2,1,1,NASDAQ
5276,17-02-2021 10:00,24 hrs.,wallstreetbets,MGPI,6,6,0,6,1,1,0,1,NASDAQ
5276,17-02-2021 10:00,24 hrs.,wallstreetbets,MRNA,6,6,0,6,1,1,0,1,NASDAQ
5276,17-02-2021 10:00,24 hrs.,wallstreetbets,MSTR,6,0,6,-6,1,1,0,1,NASDAQ
5276,17-02-2021 10:00,24 hrs.,wallstreetbets,MVIS,12,6,6,0,2,2,0,2,NASDAQ
5276,17-02-2021 10:00,24 hrs.,wallstreetbets,NAKD,33,12,21,-9,5,5,3,3,NASDAQ
5276,17-02-2021 10:00,24 hrs.,wallstreetbets,NCTY,14,0,14,-14,2,2,2,2,NASDAQ
5276,17-02-2021 10:00,24 hrs.,wallstreetbets,NGAC,7,0,7,-7,1,1,1,1,NASDAQ
5276,17-02-2021 10:00,24 hrs.,wallstreetbets,NUAN,4,4,0,4,1,0,0,1,NASDAQ
5276,17-02-2021 10:00,24 hrs.,wallstreetbets,NURO,8,8,0,8,1,1,2,1,NASDAQ
5276,17-02-2021 10:00,24 hrs.,wallstreetbets,OCGN,27,6,21,-15,4,4,3,4,NASDAQ
5276,17-02-2021 10:00,24 hrs.,wallstreetbets,OPGN,7,0,7,-7,1,1,1,1,NASDAQ
5276,17-02-2021 10:00,24 hrs.,wallstreetbets,PACB,6,6,0,6,1,1,0,1,NASDAQ
5276,17-02-2021 10:00,24 hrs.,wallstreetbets,PHUN,6,6,0,6,1,1,0,1,NASDAQ
5276,17-02-2021 10:00,24 hrs.,wallstreetbets,PLUG,7,0,7,-7,1,1,1,1,NASDAQ
5276,17-02-2021 10:00,24 hrs.,wallstreetbets,PTON,7,0,7,-7,1,1,1,1,NASDAQ
5276,17-02-2021 10:00,24 hrs.,wallstreetbets,PYPL,13,0,13,-13,2,2,1,1,NASDAQ
5276,17-02-2021 10:00,24 hrs.,wallstreetbets,QQQJ,7,0,7,-7,1,1,1,1,NASDAQ
5276,17-02-2021 10:00,24 hrs.,wallstreetbets,RIDE,7,0,7,-7,1,1,1,1,NASDAQ
5276,17-02-2021 10:00,24 hrs.,wallstreetbets,RIOT,28,7,21,-14,4,4,4,4,NASDAQ
5276,17-02-2021 10:00,24 hrs.,wallstreetbets,SCKT,40,13,27,-14,6,6,4,6,NASDAQ
5276,17-02-2021 10:00,24 hrs.,wallstreetbets,SHIP,26,0,26,-26,4,4,2,4,NASDAQ
5276,17-02-2021 10:00,24 hrs.,wallstreetbets,SNDL,54,0,54,-54,8,8,6,6,NASDAQ
5276,17-02-2021 10:00,24 hrs.,wallstreetbets,SOLO,7,0,7,-7,1,1,1,1,NASDAQ
5276,17-02-2021 10:00,24 hrs.,wallstreetbets,SPWR,13,0,13,-13,2,2,1,1,NASDAQ
5276,17-02-2021 10:00,24 hrs.,wallstreetbets,SRNE,7,0,7,-7,1,1,1,1,NASDAQ
5276,17-02-2021 10:00,24 hrs.,wallstreetbets,STAY,7,0,7,-7,1,1,1,1,NASDAQ
5276,17-02-2021 10:00,24 hrs.,wallstreetbets,SXTC,7,0,7,-7,1,1,1,1,NASDAQ
5276,17-02-2021 10:00,24 hrs.,wallstreetbets,TBLT,6,0,6,-6,1,1,0,1,NASDAQ
5276,17-02-2021 10:00,24 hrs.,wallstreetbets,TECH,6,6,0,6,1,1,0,1,NASDAQ
5276,17-02-2021 10:00,24 hrs.,wallstreetbets,TLRY,684,0,684,-684,6,267,126,6,NASDAQ
5276,17-02-2021 10:00,24 hrs.,wallstreetbets,TOPS,14,0,14,-14,2,2,2,2,NASDAQ
5276,17-02-2021 10:00,24 hrs.,wallstreetbets,TRCH,7,0,7,-7,1,1,1,1,NASDAQ
5276,17-02-2021 10:00,24 hrs.,wallstreetbets,TRVG,7,0,7,-7,1,1,1,1,NASDAQ
5276,17-02-2021 10:00,24 hrs.,wallstreetbets,TSLA,228,228,0,228,1,68,88,1,NASDAQ
5276,17-02-2021 10:00,24 hrs.,wallstreetbets,USWS,7,0,7,-7,1,1,1,1,NASDAQ
5276,17-02-2021 10:00,24 hrs.,wallstreetbets,VBIV,5,0,5,-5,1,0,1,1,NASDAQ
5276,17-02-2021 10:00,24 hrs.,wallstreetbets,VUZI,14,0,14,-14,2,2,2,1,NASDAQ
5276,17-02-2021 10:00,24 hrs.,wallstreetbets,WKHS,6,0,6,-6,1,1,0,1,NASDAQ
5276,17-02-2021 10:00,24 hrs.,wallstreetbets,WRAP,7,0,7,-7,1,1,1,1,NASDAQ
5276,17-02-2021 10:00,24 hrs.,wallstreetbets,WTER,7,7,0,7,1,1,1,1,NASDAQ
5276,17-02-2021 10:00,24 hrs.,wallstreetbets,XSPA,12,0,12,-12,2,2,0,2,NASDAQ
5276,17-02-2021 10:00,24 hrs.,wallstreetbets,HPE,7,0,7,-7,1,1,1,1,NYSE
5276,17-02-2021 10:00,24 hrs.,wallstreetbets,IBM,4,4,0,4,1,0,0,1,NYSE
5276,17-02-2021 10:00,24 hrs.,wallstreetbets,IFF,6,0,6,-6,1,1,0,1,NYSE
5276,17-02-2021 10:00,24 hrs.,wallstreetbets,IVR,10,0,10,-10,1,2,2,1,NYSE
5276,17-02-2021 10:00,24 hrs.,wallstreetbets,LOW,36,0,36,-36,1,12,8,1,NYSE
5276,17-02-2021 10:00,24 hrs.,wallstreetbets,MAC,7,0,7,-7,1,1,1,1,NYSE
5276,17-02-2021 10:00,24 hrs.,wallstreetbets,MRK,7,0,7,-7,1,1,1,1,NYSE
5276,17-02-2021 10:00,24 hrs.,wallstreetbets,NAV,13,0,13,-13,2,2,1,1,NYSE
5276,17-02-2021 10:00,24 hrs.,wallstreetbets,NGA,7,0,7,-7,1,1,1,1,NYSE
5276,17-02-2021 10:00,24 hrs.,wallstreetbets,NOK,55,13,42,-29,8,8,7,6,NYSE
5276,17-02-2021 10:00,24 hrs.,wallstreetbets,PFE,14,0,14,-14,2,2,2,1,NYSE
5276,17-02-2021 10:00,24 hrs.,wallstreetbets,PPL,7,0,7,-7,1,1,1,1,NYSE
5276,17-02-2021 10:00,24 hrs.,wallstreetbets,PSA,14,6,8,-2,2,3,0,2,NYSE
5276,17-02-2021 10:00,24 hrs.,wallstreetbets,SKY,7,0,7,-7,1,1,1,1,NYSE
5276,17-02-2021 10:00,24 hrs.,wallstreetbets,SOS,28,7,21,-14,4,4,4,4,NYSE
5276,17-02-2021 10:00,24 hrs.,wallstreetbets,SUN,6,0,6,-6,1,1,0,1,NYSE
5276,17-02-2021 10:00,24 hrs.,wallstreetbets,TAP,6,6,0,6,1,1,0,1,NYSE
5276,17-02-2021 10:00,24 hrs.,wallstreetbets,AQUA,12,0,12,-12,2,2,0,1,NYSE
5276,17-02-2021 10:00,24 hrs.,wallstreetbets,ARGO,21,0,21,-21,3,3,3,3,NYSE
5276,17-02-2021 10:00,24 hrs.,wallstreetbets,CCIV,56,21,35,-14,8,8,8,8,NYSE
5276,17-02-2021 10:00,24 hrs.,wallstreetbets,CORR,6,6,0,6,1,1,0,1,NYSE
5276,17-02-2021 10:00,24 hrs.,wallstreetbets,COTY,6,0,6,-6,1,1,0,1,NYSE
5276,17-02-2021 10:00,24 hrs.,wallstreetbets,FVRR,7,0,7,-7,1,1,1,1,NYSE
5276,17-02-2021 10:00,24 hrs.,wallstreetbets,HUYA,62,62,0,62,1,22,14,1,NYSE
5276,17-02-2021 10:00,24 hrs.,wallstreetbets,IACA,7,0,7,-7,1,1,1,1,NYSE
5276,17-02-2021 10:00,24 hrs.,wallstreetbets,IMAX,21,0,21,-21,3,3,3,2,NYSE
5276,17-02-2021 10:00,24 hrs.,wallstreetbets,LGVW,21,0,21,-21,3,3,3,1,NYSE
5276,17-02-2021 10:00,24 hrs.,wallstreetbets,PGRE,7,0,7,-7,1,1,1,1,NYSE
5276,17-02-2021 10:00,24 hrs.,wallstreetbets,PLTR,13959,701,13258,-12557,39,6081,1641,29,NYSE
5276,17-02-2021 10:00,24 hrs.,wallstreetbets,PSTH,7,0,7,-7,1,1,1,1,NYSE
5276,17-02-2021 10:00,24 hrs.,wallstreetbets,SPCE,6,6,0,6,1,1,0,1,NYSE
5276,17-02-2021 10:00,24 hrs.,wallstreetbets,TRTN,8,0,8,-8,1,1,2,1,NYSE
5276,17-02-2021 10:00,24 hrs.,wallstreetbets,TWTR,7,0,7,-7,1,1,1,1,NYSE
5276,17-02-2021 10:00,24 hrs.,wallstreetbets,VALE,514,0,514,-514,3,210,82,2,NYSE
5276,17-02-2021 10:00,24 hrs.,wallstreetbets,WBAI,7,0,7,-7,1,1,1,1,NYSE
5276,17-02-2021 10:00,24 hrs.,wallstreetbets,AMD,57,6,51,-45,2,14,21,2,NASDAQ
5276,17-02-2021 10:00,24 hrs.,wallstreetbets,API,7,0,7,-7,1,1,1,1,NASDAQ
5276,17-02-2021 10:00,24 hrs.,wallstreetbets,CFO,6,0,6,-6,1,1,0,1,NASDAQ
5276,17-02-2021 10:00,24 hrs.,wallstreetbets,FUV,7,0,7,-7,1,1,1,1,NASDAQ
5276,17-02-2021 10:00,24 hrs.,wallstreetbets,III,5,0,5,-5,1,0,1,1,NASDAQ
5276,17-02-2021 10:00,24 hrs.,wallstreetbets,MYT,7,0,7,-7,1,1,1,1,NASDAQ
5276,17-02-2021 10:00,24 hrs.,wallstreetbets,OGI,7,0,7,-7,1,1,1,1,NASDAQ
5276,17-02-2021 10:00,24 hrs.,wallstreetbets,OSW,14,0,14,-14,2,2,2,2,NASDAQ
5276,17-02-2021 10:00,24 hrs.,wallstreetbets,PDD,7,0,7,-7,1,1,1,1,NASDAQ
5276,17-02-2021 10:00,24 hrs.,wallstreetbets,SLP,6,0,6,-6,1,1,0,1,NASDAQ
5276,17-02-2021 10:00,24 hrs.,wallstreetbets,UAL,7,0,7,-7,1,1,1,1,NASDAQ
5276,17-02-2021 10:00,24 hrs.,wallstreetbets,VFF,17,17,0,17,2,4,1,2,NASDAQ
5276,17-02-2021 10:00,24 hrs.,wallstreetbets,VRA,7,0,7,-7,1,1,1,1,NASDAQ
5276,17-02-2021 10:00,24 hrs.,wallstreetbets,WIX,43,0,43,-43,1,9,21,1,NASDAQ
5276,17-02-2021 10:00,24 hrs.,wallstreetbets,ADMP,28,6,22,-16,4,4,4,4,NASDAQ
5276,17-02-2021 10:00,24 hrs.,wallstreetbets,AGTC,14,0,14,-14,2,2,2,2,NASDAQ
5276,17-02-2021 10:00,24 hrs.,wallstreetbets,AKBA,7,0,7,-7,1,1,1,1,NASDAQ
5276,17-02-2021 10:00,24 hrs.,wallstreetbets,ALLT,7,0,7,-7,1,1,1,1,NASDAQ
5276,17-02-2021 10:00,24 hrs.,wallstreetbets,APHA,39,6,33,-27,6,6,3,5,NASDAQ
5276,17-02-2021 10:00,24 hrs.,wallstreetbets,ASML,7,0,7,-7,1,1,1,1,NASDAQ
5276,17-02-2021 10:00,24 hrs.,wallstreetbets,ASTC,7,0,7,-7,1,1,1,1,NASDAQ
5276,17-02-2021 10:00,24 hrs.,wallstreetbets,BEAT,6,0,6,-6,1,1,0,1,NASDAQ
5276,17-02-2021 10:00,24 hrs.,wallstreetbets,BLDP,6,6,0,6,1,1,0,1,NASDAQ
5276,17-02-2021 10:00,24 hrs.,wallstreetbets,BLNK,7,0,7,-7,1,1,1,1,NASDAQ
5276,17-02-2021 10:00,24 hrs.,wallstreetbets,BNGO,19,19,0,19,1,0,15,1,NASDAQ
5276,17-02-2021 10:00,24 hrs.,wallstreetbets,CAAS,21,0,21,-21,3,3,3,2,NASDAQ
5276,17-02-2021 10:00,24 hrs.,wallstreetbets,CDTX,7,0,7,-7,1,1,1,1,NASDAQ
5276,17-02-2021 10:00,24 hrs.,wallstreetbets,CLEU,7,0,7,-7,1,1,1,1,NASDAQ
5276,17-02-2021 10:00,24 hrs.,wallstreetbets,CMPS,14,0,14,-14,2,2,2,1,NASDAQ
5276,17-02-2021 10:00,24 hrs.,pennystocks,VBIV,4,0,4,-4,1,0,0,1,NASDAQ
5276,17-02-2021 10:00,24 hrs.,pennystocks,WTER,18,0,18,-18,1,5,4,1,NASDAQ
5276,17-02-2021 10:00,24 hrs.,pennystocks,XSPA,6,0,6,-6,1,1,0,1,NASDAQ
5276,17-02-2021 10:00,24 hrs.,wallstreetbets,AABB,7,0,7,-7,1,1,1,1,OTC
5276,17-02-2021 10:00,24 hrs.,wallstreetbets,ALYI,7,0,7,-7,1,1,1,1,OTC
5276,17-02-2021 10:00,24 hrs.,wallstreetbets,BANI,7,0,7,-7,1,1,1,1,OTC
5276,17-02-2021 10:00,24 hrs.,wallstreetbets,BANT,7,0,7,-7,1,1,1,1,OTC
5276,17-02-2021 10:00,24 hrs.,wallstreetbets,BCCI,6,6,0,6,1,1,0,1,OTC
5276,17-02-2021 10:00,24 hrs.,wallstreetbets,CETY,8,0,8,-8,1,2,0,1,OTC
5276,17-02-2021 10:00,24 hrs.,wallstreetbets,CRWG,14,0,14,-14,2,2,2,1,OTC
5276,17-02-2021 10:00,24 hrs.,wallstreetbets,ENZC,7,0,7,-7,1,1,1,1,OTC
5276,17-02-2021 10:00,24 hrs.,wallstreetbets,ESSE,7,7,0,7,1,1,1,1,OTC
5276,17-02-2021 10:00,24 hrs.,wallstreetbets,EVBC,6,0,6,-6,1,1,0,1,OTC
5276,17-02-2021 10:00,24 hrs.,wallstreetbets,GBLX,7,0,7,-7,1,1,1,1,OTC
5276,17-02-2021 10:00,24 hrs.,wallstreetbets,GTEH,6,0,6,-6,1,1,0,1,OTC
5276,17-02-2021 10:00,24 hrs.,wallstreetbets,HCMC,46,12,34,-22,7,7,4,7,OTC
5276,17-02-2021 10:00,24 hrs.,wallstreetbets,HYSR,14,0,14,-14,2,2,2,2,OTC
5276,17-02-2021 10:00,24 hrs.,wallstreetbets,INTV,7,0,7,-7,1,1,1,1,OTC
5276,17-02-2021 10:00,24 hrs.,wallstreetbets,MAXD,6,0,6,-6,1,1,0,1,OTC
5276,17-02-2021 10:00,24 hrs.,wallstreetbets,MKTY,7,0,7,-7,1,1,1,1,OTC
5276,17-02-2021 10:00,24 hrs.,wallstreetbets,NPHC,7,0,7,-7,1,1,1,1,OTC
5276,17-02-2021 10:00,24 hrs.,wallstreetbets,OWCP,6,0,6,-6,1,1,0,1,OTC
5276,17-02-2021 10:00,24 hrs.,wallstreetbets,PAPA,7,0,7,-7,1,1,1,1,OTC
5276,17-02-2021 10:00,24 hrs.,wallstreetbets,PKTX,6,0,6,-6,1,1,0,1,OTC
5276,17-02-2021 10:00,24 hrs.,wallstreetbets,RMRK,7,7,0,7,1,1,1,1,OTC
5276,17-02-2021 10:00,24 hrs.,wallstreetbets,SGMD,14,0,14,-14,2,2,2,1,OTC
5276,17-02-2021 10:00,24 hrs.,wallstreetbets,SOBS,7,0,7,-7,1,1,1,1,OTC
5276,17-02-2021 10:00,24 hrs.,wallstreetbets,WHEN,6,6,0,6,1,1,0,1,OTC
5276,17-02-2021 10:00,24 hrs.,wallstreetbets,ZPAS,7,0,7,-7,1,1,1,1,OTC
5276,17-02-2021 10:00,24 hrs.,wallstreetbets,ARBKF,14,0,14,-14,2,2,2,2,OTC
5276,17-02-2021 10:00,24 hrs.,wallstreetbets,BDRBF,7,0,7,-7,1,1,1,1,OTC
5276,17-02-2021 10:00,24 hrs.,wallstreetbets,CBDEF,14,0,14,-14,2,2,2,1,OTC
5276,17-02-2021 10:00,24 hrs.,wallstreetbets,CIOXY,7,0,7,-7,1,1,1,1,OTC
5276,17-02-2021 10:00,24 hrs.,wallstreetbets,CNIKF,7,7,0,7,1,1,1,1,OTC
5276,17-02-2021 10:00,24 hrs.,wallstreetbets,HTZGQ,7,0,7,-7,1,1,1,1,OTC
5276,17-02-2021 10:00,24 hrs.,wallstreetbets,ICNAF,7,0,7,-7,1,1,1,1,OTC
5276,17-02-2021 10:00,24 hrs.,wallstreetbets,ISCNF,7,0,7,-7,1,1,1,1,OTC
5276,17-02-2021 10:00,24 hrs.,wallstreetbets,JUVAF,6,0,6,-6,1,1,0,1,OTC
5276,17-02-2021 10:00,24 hrs.,wallstreetbets,LGORF,7,0,7,-7,1,1,1,1,OTC
5276,17-02-2021 10:00,24 hrs.,wallstreetbets,LKNCY,6,0,6,-6,1,1,0,1,OTC
5276,17-02-2021 10:00,24 hrs.,wallstreetbets,LYSCF,6,0,6,-6,1,1,0,1,OTC
5276,17-02-2021 10:00,24 hrs.,wallstreetbets,MMNFF,6,6,0,6,1,1,0,1,OTC
5276,17-02-2021 10:00,24 hrs.,wallstreetbets,PLNHF,4,0,4,-4,1,0,0,1,OTC
5276,17-02-2021 10:00,24 hrs.,wallstreetbets,RLLCF,35,21,14,7,5,5,5,2,OTC
5276,17-02-2021 10:00,24 hrs.,wallstreetbets,RYCEY,7,0,7,-7,1,1,1,1,OTC
5276,17-02-2021 10:00,24 hrs.,wallstreetbets,DNN,54,6,48,-42,8,8,6,6,AMEX
5276,17-02-2021 10:00,24 hrs.,wallstreetbets,GTE,17,10,7,3,2,3,3,2,AMEX
5276,17-02-2021 10:00,24 hrs.,wallstreetbets,NOG,6,0,6,-6,1,1,0,1,AMEX
5276,17-02-2021 10:00,24 hrs.,wallstreetbets,ZOM,875,0,875,-875,2,350,167,2,AMEX
5276,17-02-2021 10:00,24 hrs.,wallstreetbets,SENS,13,0,13,-13,2,2,1,2,AMEX
5276,17-02-2021 10:00,24 hrs.,wallstreetbets,TRXC,6,0,6,-6,1,1,0,1,AMEX
5276,17-02-2021 10:00,24 hrs.,wallstreetbets,AIR,7,0,7,-7,1,1,1,1,NYSE
5276,17-02-2021 10:00,24 hrs.,wallstreetbets,ALK,107,0,107,-107,1,35,33,1,NYSE
5276,17-02-2021 10:00,24 hrs.,wallstreetbets,AMC,4308,179,4129,-3950,47,1946,228,37,NYSE
5276,17-02-2021 10:00,24 hrs.,wallstreetbets,AMN,7,0,7,-7,1,1,1,1,NYSE
5276,17-02-2021 10:00,24 hrs.,wallstreetbets,BIT,7,0,7,-7,1,1,1,1,NYSE
5276,17-02-2021 10:00,24 hrs.,wallstreetbets,BTT,7,0,7,-7,1,1,1,1,NYSE
5276,17-02-2021 10:00,24 hrs.,wallstreetbets,CAI,6,6,0,6,1,1,0,1,NYSE
5276,17-02-2021 10:00,24 hrs.,wallstreetbets,FCX,514,0,514,-514,3,210,82,2,NYSE
5276,17-02-2021 10:00,24 hrs.,wallstreetbets,FFG,6,0,6,-6,1,1,0,1,NYSE
5276,17-02-2021 10:00,24 hrs.,wallstreetbets,FSR,13,0,13,-13,2,2,1,2,NYSE
5276,17-02-2021 10:00,24 hrs.,wallstreetbets,GEO,7,0,7,-7,1,1,1,1,NYSE
5276,17-02-2021 10:00,24 hrs.,wallstreetbets,GER,7,0,7,-7,1,1,1,1,NYSE
5276,17-02-2021 10:00,24 hrs.,wallstreetbets,GME,20203,376,19827,-19451,51,9015,1969,40,NYSE
5241,17-02-2021 04:00,24 hrs.,pennystocks,HCMC,25,13,12,1,4,4,1,4,OTC
5241,17-02-2021 04:00,24 hrs.,pennystocks,HEME,7,7,0,7,1,1,1,1,OTC
5241,17-02-2021 04:00,24 hrs.,pennystocks,HIPH,22,0,22,-22,1,2,14,1,OTC
5241,17-02-2021 04:00,24 hrs.,pennystocks,HPMM,4,0,4,-4,1,0,0,1,OTC
5241,17-02-2021 04:00,24 hrs.,pennystocks,IJJP,6,0,6,-6,1,1,0,1,OTC
5241,17-02-2021 04:00,24 hrs.,pennystocks,INKW,12,6,6,0,2,2,0,2,OTC
5241,17-02-2021 04:00,24 hrs.,pennystocks,INTV,17,17,0,17,1,4,5,1,OTC
5241,17-02-2021 04:00,24 hrs.,pennystocks,KOSK,13,0,13,-13,1,3,3,1,OTC
5241,17-02-2021 04:00,24 hrs.,pennystocks,KWBT,7,0,7,-7,1,1,1,1,OTC
5241,17-02-2021 04:00,24 hrs.,pennystocks,KYNC,6,0,6,-6,1,1,0,1,OTC
5241,17-02-2021 04:00,24 hrs.,pennystocks,NEOM,7,0,7,-7,1,1,1,1,OTC
5241,17-02-2021 04:00,24 hrs.,pennystocks,OPTI,9,0,9,-9,1,1,3,1,OTC
5241,17-02-2021 04:00,24 hrs.,pennystocks,PCTL,6,0,6,-6,1,1,0,1,OTC
5241,17-02-2021 04:00,24 hrs.,pennystocks,RLBD,6,0,6,-6,1,1,0,1,OTC
5241,17-02-2021 04:00,24 hrs.,pennystocks,RSSV,60,60,0,60,1,24,8,1,OTC
5241,17-02-2021 04:00,24 hrs.,pennystocks,SFOR,14,14,0,14,1,4,2,1,OTC
5241,17-02-2021 04:00,24 hrs.,pennystocks,SGMD,6,0,6,-6,1,1,0,1,OTC
5241,17-02-2021 04:00,24 hrs.,pennystocks,SIML,254,0,254,-254,1,91,68,1,OTC
5241,17-02-2021 04:00,24 hrs.,pennystocks,SINC,7,0,7,-7,1,1,1,1,OTC
5241,17-02-2021 04:00,24 hrs.,pennystocks,SRMX,6,0,6,-6,1,1,0,1,OTC
5241,17-02-2021 04:00,24 hrs.,pennystocks,SRNA,6,0,6,-6,1,1,0,1,OTC
5241,17-02-2021 04:00,24 hrs.,pennystocks,SSFT,20,20,0,20,1,6,4,1,OTC
5241,17-02-2021 04:00,24 hrs.,pennystocks,SUGR,6,0,6,-6,1,1,0,1,OTC
5241,17-02-2021 04:00,24 hrs.,pennystocks,TSNP,6,0,6,-6,1,1,0,1,OTC
5241,17-02-2021 04:00,24 hrs.,pennystocks,UBQU,33,33,0,33,1,7,15,1,OTC
5241,17-02-2021 04:00,24 hrs.,pennystocks,ZPAS,13,13,0,13,1,4,1,1,OTC
5241,17-02-2021 04:00,24 hrs.,pennystocks,ARBKF,86,0,86,-86,1,30,22,1,OTC
5241,17-02-2021 04:00,24 hrs.,pennystocks,BFARF,6,6,0,6,1,1,0,1,OTC
5241,17-02-2021 04:00,24 hrs.,pennystocks,DIGAF,6,6,0,6,1,1,0,1,OTC
5241,17-02-2021 04:00,24 hrs.,pennystocks,FUNFF,29,29,0,29,1,10,5,1,OTC
5241,17-02-2021 04:00,24 hrs.,pennystocks,HTZGQ,6,0,6,-6,1,1,0,1,OTC
5241,17-02-2021 04:00,24 hrs.,pennystocks,HVBTF,7,7,0,7,1,1,1,1,OTC
5241,17-02-2021 04:00,24 hrs.,pennystocks,KBEVF,9,0,9,-9,1,2,1,1,OTC
5241,17-02-2021 04:00,24 hrs.,pennystocks,MMEDF,32,0,32,-32,1,12,4,1,OTC
5241,17-02-2021 04:00,24 hrs.,pennystocks,MNXXF,107,0,107,-107,3,38,19,2,OTC
5241,17-02-2021 04:00,24 hrs.,pennystocks,NMGRF,245,0,245,-245,2,83,71,2,OTC
5241,17-02-2021 04:00,24 hrs.,pennystocks,NMTLF,171,0,171,-171,2,61,41,2,OTC
5241,17-02-2021 04:00,24 hrs.,pennystocks,NUSMF,6,6,0,6,1,1,0,1,OTC
5241,17-02-2021 04:00,24 hrs.,pennystocks,REZZF,13,0,13,-13,2,2,1,1,OTC
5241,17-02-2021 04:00,24 hrs.,pennystocks,SPRWF,346,346,0,346,3,132,70,3,OTC
5241,17-02-2021 04:00,24 hrs.,pennystocks,ZBISF,14,14,0,14,1,3,4,1,OTC
5241,17-02-2021 04:00,24 hrs.,pennystocks,DNN,45,45,0,45,1,13,15,1,AMEX
5241,17-02-2021 04:00,24 hrs.,pennystocks,GTE,7,7,0,7,1,1,1,1,AMEX
5241,17-02-2021 04:00,24 hrs.,pennystocks,ISR,6,6,0,6,1,1,0,1,AMEX
5241,17-02-2021 04:00,24 hrs.,pennystocks,ITP,21,21,0,21,1,6,5,1,AMEX
5241,17-02-2021 04:00,24 hrs.,pennystocks,AABB,31,31,0,31,4,5,5,3,OTC
5241,17-02-2021 04:00,24 hrs.,pennystocks,TSC,6,0,6,-6,1,1,0,1,NASDAQ
5241,17-02-2021 04:00,24 hrs.,pennystocks,ACST,6,0,6,-6,1,1,0,1,NASDAQ
5241,17-02-2021 04:00,24 hrs.,pennystocks,ADMA,601,0,601,-601,1,282,33,1,NASDAQ
5241,17-02-2021 04:00,24 hrs.,pennystocks,ADMP,6,0,6,-6,1,1,0,1,NASDAQ
5241,17-02-2021 04:00,24 hrs.,pennystocks,AIKI,82,0,82,-82,2,31,12,1,NASDAQ
5241,17-02-2021 04:00,24 hrs.,pennystocks,AYTU,82,0,82,-82,2,31,12,1,NASDAQ
5241,17-02-2021 04:00,24 hrs.,pennystocks,BEAT,28,0,28,-28,1,10,4,1,NASDAQ
5241,17-02-2021 04:00,24 hrs.,pennystocks,BKEP,25,0,25,-25,1,8,5,1,NASDAQ
5241,17-02-2021 04:00,24 hrs.,pennystocks,CETX,82,0,82,-82,2,31,12,1,NASDAQ
5241,17-02-2021 04:00,24 hrs.,pennystocks,CKPT,23,0,23,-23,2,5,5,1,NASDAQ
5241,17-02-2021 04:00,24 hrs.,pennystocks,CRBP,15,0,15,-15,1,4,3,1,NASDAQ
5241,17-02-2021 04:00,24 hrs.,pennystocks,DOGZ,25,0,25,-25,1,8,5,1,NASDAQ
5241,17-02-2021 04:00,24 hrs.,pennystocks,EBON,32,0,32,-32,1,12,4,1,NASDAQ
5241,17-02-2021 04:00,24 hrs.,pennystocks,EPSN,25,0,25,-25,1,8,5,1,NASDAQ
5241,17-02-2021 04:00,24 hrs.,pennystocks,GLBS,8,8,0,8,1,0,4,1,NASDAQ
5241,17-02-2021 04:00,24 hrs.,pennystocks,GLMD,10,0,10,-10,1,2,2,1,NASDAQ
5241,17-02-2021 04:00,24 hrs.,pennystocks,GRIL,82,0,82,-82,2,31,12,1,NASDAQ
5241,17-02-2021 04:00,24 hrs.,pennystocks,LGHL,25,0,25,-25,1,8,5,1,NASDAQ
5241,17-02-2021 04:00,24 hrs.,pennystocks,LKCO,25,0,25,-25,1,8,5,1,NASDAQ
5241,17-02-2021 04:00,24 hrs.,pennystocks,MICT,16,16,0,16,1,4,4,1,NASDAQ
5241,17-02-2021 04:00,24 hrs.,pennystocks,NBEV,6,0,6,-6,1,1,0,1,NASDAQ
5241,17-02-2021 04:00,24 hrs.,pennystocks,NEOS,82,0,82,-82,2,31,12,1,NASDAQ
5241,17-02-2021 04:00,24 hrs.,pennystocks,NNDM,19,0,19,-19,1,5,5,1,NASDAQ
5241,17-02-2021 04:00,24 hrs.,pennystocks,NVCR,32,0,32,-32,1,12,4,1,NASDAQ
5241,17-02-2021 04:00,24 hrs.,pennystocks,OCGN,6,0,6,-6,1,1,0,1,NASDAQ
5241,17-02-2021 04:00,24 hrs.,pennystocks,OKTA,32,0,32,-32,1,12,4,1,NASDAQ
5241,17-02-2021 04:00,24 hrs.,pennystocks,PANL,25,0,25,-25,1,8,5,1,NASDAQ
5241,17-02-2021 04:00,24 hrs.,pennystocks,PLUG,32,0,32,-32,1,12,4,1,NASDAQ
5241,17-02-2021 04:00,24 hrs.,pennystocks,PULM,562,0,562,-562,1,230,98,1,NASDAQ
5241,17-02-2021 04:00,24 hrs.,pennystocks,QCOM,32,0,32,-32,1,12,4,1,NASDAQ
5241,17-02-2021 04:00,24 hrs.,pennystocks,RAVE,82,0,82,-82,2,31,12,1,NASDAQ
5241,17-02-2021 04:00,24 hrs.,pennystocks,SESN,29,0,29,-29,1,7,11,1,NASDAQ
5241,17-02-2021 04:00,24 hrs.,pennystocks,SNDL,33,0,33,-33,4,7,3,3,NASDAQ
5241,17-02-2021 04:00,24 hrs.,pennystocks,SNGX,89,0,89,-89,3,32,13,2,NASDAQ
5241,17-02-2021 04:00,24 hrs.,pennystocks,SOLO,32,0,32,-32,1,12,4,1,NASDAQ
5241,17-02-2021 04:00,24 hrs.,pennystocks,SONM,6,6,0,6,1,1,0,1,NASDAQ
5241,17-02-2021 04:00,24 hrs.,pennystocks,TRVG,82,0,82,-82,2,31,12,1,NASDAQ
5241,17-02-2021 04:00,24 hrs.,pennystocks,VBIV,4,0,4,-4,1,0,0,1,NASDAQ
5241,17-02-2021 04:00,24 hrs.,pennystocks,WTER,16,16,0,16,1,4,4,1,NASDAQ
5241,17-02-2021 04:00,24 hrs.,pennystocks,XSPA,6,6,0,6,1,1,0,1,NASDAQ
5241,17-02-2021 04:00,24 hrs.,pennystocks,ZYNE,15,0,15,-15,1,4,3,1,NASDAQ
5241,17-02-2021 04:00,24 hrs.,RobinHoodPennyStocks,AQSP,12,0,12,-12,2,2,0,2,OTC
5241,17-02-2021 04:00,24 hrs.,RobinHoodPennyStocks,ENKS,6,6,0,6,1,1,0,1,OTC
5241,17-02-2021 04:00,24 hrs.,RobinHoodPennyStocks,HCMC,6,0,6,-6,1,1,0,1,OTC
5241,17-02-2021 04:00,24 hrs.,RobinHoodPennyStocks,NMGRF,6,0,6,-6,1,1,0,1,OTC
5241,17-02-2021 04:00,24 hrs.,pennystocks,AITX,6,0,6,-6,1,1,0,1,OTC
5241,17-02-2021 04:00,24 hrs.,pennystocks,AQSP,6,0,6,-6,1,1,0,1,OTC
5241,17-02-2021 04:00,24 hrs.,pennystocks,ASTI,7,7,0,7,1,1,1,1,OTC
5241,17-02-2021 04:00,24 hrs.,pennystocks,BMIX,6,0,6,-6,1,1,0,1,OTC
5241,17-02-2021 04:00,24 hrs.,pennystocks,BOTH,12,0,12,-12,2,2,0,1,OTC
5241,17-02-2021 04:00,24 hrs.,pennystocks,BRGO,6,6,0,6,1,1,0,1,OTC
5241,17-02-2021 04:00,24 hrs.,pennystocks,BRRN,53,0,53,-53,2,18,9,2,OTC
5241,17-02-2021 04:00,24 hrs.,pennystocks,BRZL,6,0,6,-6,1,1,0,1,OTC
5241,17-02-2021 04:00,24 hrs.,pennystocks,CBTC,34,0,34,-34,1,8,14,1,OTC
5241,17-02-2021 04:00,24 hrs.,pennystocks,CETY,51,51,0,51,1,18,11,1,OTC
5241,17-02-2021 04:00,24 hrs.,pennystocks,CRWG,7,0,7,-7,1,1,1,1,OTC
5241,17-02-2021 04:00,24 hrs.,pennystocks,DPLS,6,0,6,-6,1,1,0,1,OTC
5241,17-02-2021 04:00,24 hrs.,pennystocks,ENZC,6,0,6,-6,1,1,0,1,OTC
5241,17-02-2021 04:00,24 hrs.,pennystocks,ETFM,104,6,98,-92,4,37,14,4,OTC
5241,17-02-2021 04:00,24 hrs.,pennystocks,FLES,7,0,7,-7,1,1,1,1,OTC
5241,17-02-2021 04:00,24 hrs.,pennystocks,FPVD,12,12,0,12,1,3,2,1,OTC
5241,17-02-2021 04:00,24 hrs.,pennystocks,GARB,7,0,7,-7,1,1,1,1,OTC
5241,17-02-2021 04:00,24 hrs.,pennystocks,GAXY,106,82,24,58,8,25,24,5,OTC
5241,17-02-2021 04:00,24 hrs.,pennystocks,GPFT,16,0,16,-16,2,2,4,2,OTC
5241,17-02-2021 04:00,24 hrs.,RobinHoodPennyStocks,CPE,6,6,0,6,1,1,0,1,NYSE
5241,17-02-2021 04:00,24 hrs.,RobinHoodPennyStocks,GME,6,0,6,-6,1,1,0,1,NYSE
5241,17-02-2021 04:00,24 hrs.,RobinHoodPennyStocks,KOS,6,6,0,6,1,1,0,1,NYSE
5241,17-02-2021 04:00,24 hrs.,RobinHoodPennyStocks,NOK,37,0,37,-37,1,9,15,1,NYSE
5241,17-02-2021 04:00,24 hrs.,RobinHoodPennyStocks,SOS,33,0,33,-33,2,8,9,2,NYSE
5241,17-02-2021 04:00,24 hrs.,RobinHoodPennyStocks,CCIV,12,0,12,-12,2,2,0,1,NYSE
5241,17-02-2021 04:00,24 hrs.,RobinHoodPennyStocks,PLTR,12,0,12,-12,2,2,0,2,NYSE
5241,17-02-2021 04:00,24 hrs.,RobinHoodPennyStocks,OEG,6,0,6,-6,1,1,0,1,NASDAQ
5241,17-02-2021 04:00,24 hrs.,RobinHoodPennyStocks,SND,6,6,0,6,1,1,0,1,NASDAQ
5241,17-02-2021 04:00,24 hrs.,RobinHoodPennyStocks,ABEO,37,37,0,37,1,13,7,1,NASDAQ
5241,17-02-2021 04:00,24 hrs.,RobinHoodPennyStocks,ACST,9,9,0,9,1,2,1,1,NASDAQ
5241,17-02-2021 04:00,24 hrs.,RobinHoodPennyStocks,AGTC,390,372,18,354,7,141,80,5,NASDAQ
5241,17-02-2021 04:00,24 hrs.,RobinHoodPennyStocks,APHA,12,6,6,0,2,2,0,2,NASDAQ
5241,17-02-2021 04:00,24 hrs.,RobinHoodPennyStocks,BEAT,21,0,21,-21,1,8,1,1,NASDAQ
5241,17-02-2021 04:00,24 hrs.,RobinHoodPennyStocks,CTRM,12,12,0,12,2,2,0,2,NASDAQ
5241,17-02-2021 04:00,24 hrs.,RobinHoodPennyStocks,CTXR,6,6,0,6,1,1,0,1,NASDAQ
5241,17-02-2021 04:00,24 hrs.,RobinHoodPennyStocks,CYCC,6,6,0,6,1,1,0,1,NASDAQ
5241,17-02-2021 04:00,24 hrs.,RobinHoodPennyStocks,DFFN,756,6,750,-744,4,298,144,3,NASDAQ
5241,17-02-2021 04:00,24 hrs.,RobinHoodPennyStocks,EOLS,19,0,19,-19,1,7,1,1,NASDAQ
5241,17-02-2021 04:00,24 hrs.,RobinHoodPennyStocks,IDEX,76,0,76,-76,3,30,4,3,NASDAQ
5241,17-02-2021 04:00,24 hrs.,RobinHoodPennyStocks,LIVE,6,0,6,-6,1,1,0,1,NASDAQ
5241,17-02-2021 04:00,24 hrs.,RobinHoodPennyStocks,LKCO,6,6,0,6,1,1,0,1,NASDAQ
5241,17-02-2021 04:00,24 hrs.,RobinHoodPennyStocks,NAKD,37,0,37,-37,1,9,15,1,NASDAQ
5241,17-02-2021 04:00,24 hrs.,RobinHoodPennyStocks,NDRA,19,0,19,-19,1,5,5,1,NASDAQ
5241,17-02-2021 04:00,24 hrs.,RobinHoodPennyStocks,NVIV,6,6,0,6,1,1,0,1,NASDAQ
5241,17-02-2021 04:00,24 hrs.,RobinHoodPennyStocks,NXTD,6,6,0,6,1,1,0,1,NASDAQ
5241,17-02-2021 04:00,24 hrs.,RobinHoodPennyStocks,OPGN,6,0,6,-6,1,1,0,1,NASDAQ
5241,17-02-2021 04:00,24 hrs.,RobinHoodPennyStocks,SNCA,9,9,0,9,1,2,1,1,NASDAQ
5241,17-02-2021 04:00,24 hrs.,RobinHoodPennyStocks,SNDL,6,0,6,-6,1,1,0,1,NASDAQ
5241,17-02-2021 04:00,24 hrs.,RobinHoodPennyStocks,SSPK,6,6,0,6,1,1,0,1,NASDAQ
5241,17-02-2021 04:00,24 hrs.,RobinHoodPennyStocks,TLRY,6,0,6,-6,1,1,0,1,NASDAQ
5241,17-02-2021 04:00,24 hrs.,RobinHoodPennyStocks,TNXP,6,0,6,-6,1,1,0,1,NASDAQ
5241,17-02-2021 04:00,24 hrs.,RobinHoodPennyStocks,TRCH,6,0,6,-6,1,1,0,1,NASDAQ
5241,17-02-2021 04:00,24 hrs.,RobinHoodPennyStocks,TSLA,6,0,6,-6,1,1,0,1,NASDAQ
5241,17-02-2021 04:00,24 hrs.,RobinHoodPennyStocks,TXMD,6,6,0,6,1,1,0,1,NASDAQ
5241,17-02-2021 04:00,24 hrs.,RobinHoodPennyStocks,TYME,6,0,6,-6,1,1,0,1,NASDAQ
5241,17-02-2021 04:00,24 hrs.,RobinHoodPennyStocks,VBIV,11,0,11,-11,1,0,7,1,NASDAQ
5241,17-02-2021 04:00,24 hrs.,RobinHoodPennyStocks,PFFOF,6,6,0,6,1,1,0,1,OTC
5241,17-02-2021 04:00,24 hrs.,RobinHoodPennyStocks,GTE,245,7,238,-231,2,106,25,2,AMEX
5241,17-02-2021 04:00,24 hrs.,RobinHoodPennyStocks,ITP,18,0,18,-18,3,3,0,1,AMEX
5241,17-02-2021 04:00,24 hrs.,RobinHoodPennyStocks,ZOM,37,0,37,-37,1,9,15,1,AMEX
5241,17-02-2021 04:00,24 hrs.,RobinHoodPennyStocks,EMAN,13,13,0,13,1,3,3,1,AMEX
5241,17-02-2021 04:00,24 hrs.,RobinHoodPennyStocks,GSAT,6,6,0,6,1,1,0,1,AMEX
5241,17-02-2021 04:00,24 hrs.,RobinHoodPennyStocks,TRXC,6,0,6,-6,1,1,0,1,AMEX
5241,17-02-2021 04:00,24 hrs.,RobinHoodPennyStocks,CBD,12,0,12,-12,2,2,0,2,NYSE
5241,17-02-2021 04:00,24 hrs.,pennystocks,SYN,6,0,6,-6,1,1,0,1,AMEX
5241,17-02-2021 04:00,24 hrs.,pennystocks,AMPE,25,0,25,-25,1,8,5,1,AMEX
5241,17-02-2021 04:00,24 hrs.,pennystocks,IBIO,6,0,6,-6,1,1,0,1,AMEX
5241,17-02-2021 04:00,24 hrs.,pennystocks,AFC,6,0,6,-6,1,1,0,1,NYSE
5241,17-02-2021 04:00,24 hrs.,pennystocks,ATH,6,6,0,6,1,1,0,1,NYSE
5241,17-02-2021 04:00,24 hrs.,pennystocks,CBD,22,16,6,10,2,5,4,2,NYSE
5241,17-02-2021 04:00,24 hrs.,pennystocks,DSX,25,0,25,-25,1,8,5,1,NYSE
5241,17-02-2021 04:00,24 hrs.,pennystocks,FPL,25,0,25,-25,1,8,5,1,NYSE
5241,17-02-2021 04:00,24 hrs.,pennystocks,GME,13,7,6,1,2,2,1,2,NYSE
5241,17-02-2021 04:00,24 hrs.,pennystocks,HPQ,8,8,0,8,1,1,2,1,NYSE
5241,17-02-2021 04:00,24 hrs.,pennystocks,JKS,32,0,32,-32,1,12,4,1,NYSE
5241,17-02-2021 04:00,24 hrs.,pennystocks,NAT,25,0,25,-25,1,8,5,1,NYSE
5241,17-02-2021 04:00,24 hrs.,pennystocks,NUS,6,6,0,6,1,1,0,1,NYSE
5241,17-02-2021 04:00,24 hrs.,pennystocks,SOS,25,6,19,-13,4,4,1,4,NYSE
5241,17-02-2021 04:00,24 hrs.,pennystocks,ARGO,13,0,13,-13,2,1,3,2,NYSE
5241,17-02-2021 04:00,24 hrs.,pennystocks,HEXO,14,14,0,14,1,3,4,1,NYSE
5241,17-02-2021 04:00,24 hrs.,pennystocks,PUMP,6,0,6,-6,1,1,0,1,NYSE
5241,17-02-2021 04:00,24 hrs.,pennystocks,MKD,323,0,323,-323,1,141,37,1,NASDAQ
5241,17-02-2021 04:00,24 hrs.,pennystocks,PXS,82,0,82,-82,2,31,12,1,NASDAQ
5211,16-02-2021 22:00,24 hrs.,pennystocks,GTXO,18,0,18,-18,1,4,6,1,OTC
5211,16-02-2021 22:00,24 hrs.,pennystocks,HCMC,19,19,0,19,3,3,1,3,OTC
5211,16-02-2021 22:00,24 hrs.,pennystocks,HEME,7,7,0,7,1,1,1,1,OTC
5211,16-02-2021 22:00,24 hrs.,pennystocks,HEMP,7,0,7,-7,1,1,1,1,OTC
5211,16-02-2021 22:00,24 hrs.,pennystocks,HIPH,22,0,22,-22,1,2,14,1,OTC
5211,16-02-2021 22:00,24 hrs.,pennystocks,HPMM,4,4,0,4,1,0,0,1,OTC
5211,16-02-2021 22:00,24 hrs.,pennystocks,IJJP,6,0,6,-6,1,1,0,1,OTC
5211,16-02-2021 22:00,24 hrs.,pennystocks,INKW,13,6,7,-1,2,2,1,2,OTC
5211,16-02-2021 22:00,24 hrs.,pennystocks,INND,76,0,76,-76,1,22,28,1,OTC
5211,16-02-2021 22:00,24 hrs.,pennystocks,KOSK,11,0,11,-11,1,2,3,1,OTC
5211,16-02-2021 22:00,24 hrs.,pennystocks,KWBT,7,7,0,7,1,1,1,1,OTC
5211,16-02-2021 22:00,24 hrs.,pennystocks,KYNC,6,6,0,6,1,1,0,1,OTC
5211,16-02-2021 22:00,24 hrs.,pennystocks,MCOA,99,0,99,-99,1,29,37,1,OTC
5211,16-02-2021 22:00,24 hrs.,pennystocks,MJNA,21,0,21,-21,3,3,3,1,OTC
5211,16-02-2021 22:00,24 hrs.,pennystocks,NEOM,7,7,0,7,1,1,1,1,OTC
5211,16-02-2021 22:00,24 hrs.,pennystocks,NOVC,12,0,12,-12,2,2,0,1,OTC
5211,16-02-2021 22:00,24 hrs.,pennystocks,OPTI,9,9,0,9,1,1,3,1,OTC
5211,16-02-2021 22:00,24 hrs.,pennystocks,PCTL,6,0,6,-6,1,1,0,1,OTC
5211,16-02-2021 22:00,24 hrs.,pennystocks,PHIL,6,0,6,-6,1,1,0,1,OTC
5211,16-02-2021 22:00,24 hrs.,pennystocks,PURA,12,0,12,-12,1,1,6,1,OTC
5211,16-02-2021 22:00,24 hrs.,pennystocks,RLBD,6,6,0,6,1,1,0,1,OTC
5211,16-02-2021 22:00,24 hrs.,pennystocks,RSSV,37,37,0,37,1,14,5,1,OTC
5211,16-02-2021 22:00,24 hrs.,pennystocks,SGMD,6,6,0,6,1,1,0,1,OTC
5211,16-02-2021 22:00,24 hrs.,pennystocks,SIML,217,0,217,-217,1,79,55,1,OTC
5211,16-02-2021 22:00,24 hrs.,pennystocks,SINC,7,0,7,-7,1,1,1,1,OTC
5211,16-02-2021 22:00,24 hrs.,pennystocks,SNPW,130,0,130,-130,3,48,22,2,OTC
5211,16-02-2021 22:00,24 hrs.,pennystocks,SRMX,61,6,55,-49,3,19,11,3,OTC
5211,16-02-2021 22:00,24 hrs.,pennystocks,SRNA,6,6,0,6,1,1,0,1,OTC
5211,16-02-2021 22:00,24 hrs.,pennystocks,SSFT,24,18,6,12,2,6,4,2,OTC
5211,16-02-2021 22:00,24 hrs.,pennystocks,BMIX,6,6,0,6,1,1,0,1,OTC
5211,16-02-2021 22:00,24 hrs.,pennystocks,BNGI,6,0,6,-6,1,1,0,1,OTC
5211,16-02-2021 22:00,24 hrs.,pennystocks,BOTH,12,0,12,-12,2,2,0,1,OTC
5211,16-02-2021 22:00,24 hrs.,pennystocks,BOTY,7,0,7,-7,1,1,1,1,OTC
5211,16-02-2021 22:00,24 hrs.,pennystocks,BRGO,6,6,0,6,1,1,0,1,OTC
5211,16-02-2021 22:00,24 hrs.,pennystocks,BRRN,69,50,19,31,5,20,9,3,OTC
5211,16-02-2021 22:00,24 hrs.,pennystocks,BRZL,6,6,0,6,1,1,0,1,OTC
5211,16-02-2021 22:00,24 hrs.,pennystocks,CBBT,141,0,141,-141,4,21,83,3,OTC
5211,16-02-2021 22:00,24 hrs.,pennystocks,CBDL,6,0,6,-6,1,1,0,1,OTC
5211,16-02-2021 22:00,24 hrs.,pennystocks,CBTC,34,0,34,-34,1,8,14,1,OTC
5211,16-02-2021 22:00,24 hrs.,pennystocks,CRWG,7,7,0,7,1,1,1,1,OTC
5211,16-02-2021 22:00,24 hrs.,pennystocks,DPLS,6,6,0,6,1,1,0,1,OTC
5211,16-02-2021 22:00,24 hrs.,pennystocks,ENZC,6,0,6,-6,1,1,0,1,OTC
5211,16-02-2021 22:00,24 hrs.,pennystocks,ERBB,99,0,99,-99,1,29,37,1,OTC
5211,16-02-2021 22:00,24 hrs.,pennystocks,ETFM,114,87,27,60,5,40,14,4,OTC
5211,16-02-2021 22:00,24 hrs.,pennystocks,FDMF,6,0,6,-6,1,1,0,1,OTC
5211,16-02-2021 22:00,24 hrs.,pennystocks,FLES,7,0,7,-7,1,1,1,1,OTC
5211,16-02-2021 22:00,24 hrs.,pennystocks,ABQQ,27,0,27,-27,2,7,5,1,OTC
5211,16-02-2021 22:00,24 hrs.,pennystocks,ABWN,7,0,7,-7,1,1,1,1,OTC
5211,16-02-2021 22:00,24 hrs.,pennystocks,AITX,277,0,277,-277,5,102,53,4,OTC
5211,16-02-2021 22:00,24 hrs.,pennystocks,APYP,6,0,6,-6,1,1,0,1,OTC
5211,16-02-2021 22:00,24 hrs.,pennystocks,AQSP,6,6,0,6,1,1,0,1,OTC
5211,16-02-2021 22:00,24 hrs.,pennystocks,ASTI,79,7,72,-65,3,10,47,3,OTC
5211,16-02-2021 22:00,24 hrs.,pennystocks,BBRW,99,0,99,-99,1,29,37,1,OTC
5211,16-02-2021 22:00,24 hrs.,RobinHoodPennyStocks,ALPP,6,0,6,-6,1,1,0,1,OTC
5211,16-02-2021 22:00,24 hrs.,RobinHoodPennyStocks,AQSP,12,12,0,12,2,2,0,2,OTC
5211,16-02-2021 22:00,24 hrs.,RobinHoodPennyStocks,HCMC,6,0,6,-6,1,1,0,1,OTC
5211,16-02-2021 22:00,24 hrs.,RobinHoodPennyStocks,NMGRF,6,0,6,-6,1,1,0,1,OTC
5211,16-02-2021 22:00,24 hrs.,RobinHoodPennyStocks,PFFOF,6,6,0,6,1,1,0,1,OTC
5211,16-02-2021 22:00,24 hrs.,pennystocks,SUGR,6,0,6,-6,1,1,0,1,OTC
5211,16-02-2021 22:00,24 hrs.,pennystocks,TLSS,66,0,66,-66,1,8,46,1,OTC
5211,16-02-2021 22:00,24 hrs.,pennystocks,TSNP,6,0,6,-6,1,1,0,1,OTC
5211,16-02-2021 22:00,24 hrs.,pennystocks,VPRB,6,0,6,-6,1,1,0,1,OTC
5211,16-02-2021 22:00,24 hrs.,pennystocks,AMYZF,67,0,67,-67,1,27,9,1,OTC
5211,16-02-2021 22:00,24 hrs.,pennystocks,ARBKF,84,84,0,84,1,29,22,1,OTC
5211,16-02-2021 22:00,24 hrs.,pennystocks,BFARF,6,6,0,6,1,1,0,1,OTC
5211,16-02-2021 22:00,24 hrs.,pennystocks,CANSF,233,0,233,-233,1,100,29,1,OTC
5211,16-02-2021 22:00,24 hrs.,pennystocks,DIGAF,6,6,0,6,1,1,0,1,OTC
5211,16-02-2021 22:00,24 hrs.,pennystocks,FUNFF,20,20,0,20,1,7,2,1,OTC
5211,16-02-2021 22:00,24 hrs.,pennystocks,GWMGF,6,0,6,-6,1,1,0,1,OTC
5211,16-02-2021 22:00,24 hrs.,pennystocks,HTZGQ,6,0,6,-6,1,1,0,1,OTC
5211,16-02-2021 22:00,24 hrs.,pennystocks,KBEVF,9,0,9,-9,1,2,1,1,OTC
5211,16-02-2021 22:00,24 hrs.,pennystocks,MLLOF,95,0,95,-95,1,40,11,1,OTC
5211,16-02-2021 22:00,24 hrs.,pennystocks,MMEDF,32,32,0,32,1,12,4,1,OTC
5211,16-02-2021 22:00,24 hrs.,pennystocks,MNXXF,103,96,7,89,3,36,19,2,OTC
5211,16-02-2021 22:00,24 hrs.,pennystocks,MPXOF,14,0,14,-14,1,4,2,1,OTC
5211,16-02-2021 22:00,24 hrs.,pennystocks,NMGRF,232,6,226,-220,2,77,70,2,OTC
5211,16-02-2021 22:00,24 hrs.,pennystocks,NMTLF,156,0,156,-156,2,55,38,2,OTC
5211,16-02-2021 22:00,24 hrs.,pennystocks,PYRNF,26,0,26,-26,1,8,6,1,OTC
5211,16-02-2021 22:00,24 hrs.,pennystocks,REZZF,13,13,0,13,2,2,1,1,OTC
5211,16-02-2021 22:00,24 hrs.,pennystocks,DNN,23,0,23,-23,1,8,3,1,AMEX
5211,16-02-2021 22:00,24 hrs.,pennystocks,ISR,158,0,158,-158,1,61,32,1,AMEX
5211,16-02-2021 22:00,24 hrs.,pennystocks,NAK,7,0,7,-7,1,1,1,1,AMEX
5211,16-02-2021 22:00,24 hrs.,pennystocks,SYN,6,6,0,6,1,1,0,1,AMEX
5211,16-02-2021 22:00,24 hrs.,pennystocks,UEC,158,0,158,-158,1,61,32,1,AMEX
5211,16-02-2021 22:00,24 hrs.,pennystocks,AMPE,25,0,25,-25,1,8,5,1,AMEX
5211,16-02-2021 22:00,24 hrs.,pennystocks,GSAT,6,0,6,-6,1,1,0,1,AMEX
5211,16-02-2021 22:00,24 hrs.,pennystocks,IBIO,6,6,0,6,1,1,0,1,AMEX
5211,16-02-2021 22:00,24 hrs.,pennystocks,UAMY,44,0,44,-44,1,12,16,1,AMEX
5211,16-02-2021 22:00,24 hrs.,pennystocks,ACB,233,0,233,-233,1,100,29,1,NYSE
5211,16-02-2021 22:00,24 hrs.,pennystocks,AFC,6,0,6,-6,1,1,0,1,NYSE
5211,16-02-2021 22:00,24 hrs.,pennystocks,AMC,6,0,6,-6,1,1,0,1,NYSE
5211,16-02-2021 22:00,24 hrs.,pennystocks,ASX,164,0,164,-164,2,62,32,2,NYSE
5211,16-02-2021 22:00,24 hrs.,pennystocks,BMO,233,0,233,-233,1,100,29,1,NYSE
5211,16-02-2021 22:00,24 hrs.,pennystocks,CBD,239,6,233,-227,2,101,29,2,NYSE
5211,16-02-2021 22:00,24 hrs.,pennystocks,DSX,25,0,25,-25,1,8,5,1,NYSE
5211,16-02-2021 22:00,24 hrs.,pennystocks,EAT,239,0,239,-239,2,101,29,2,NYSE
5211,16-02-2021 22:00,24 hrs.,pennystocks,FPL,25,0,25,-25,1,8,5,1,NYSE
5211,16-02-2021 22:00,24 hrs.,pennystocks,GME,6,6,0,6,1,1,0,1,NYSE
5211,16-02-2021 22:00,24 hrs.,pennystocks,JKS,32,32,0,32,1,12,4,1,NYSE
5211,16-02-2021 22:00,24 hrs.,pennystocks,NAT,25,0,25,-25,1,8,5,1,NYSE
5211,16-02-2021 22:00,24 hrs.,pennystocks,NYT,53,0,53,-53,1,11,27,1,NYSE
5211,16-02-2021 22:00,24 hrs.,pennystocks,PEG,332,0,332,-332,1,156,16,1,NYSE
5211,16-02-2021 22:00,24 hrs.,pennystocks,PEN,158,0,158,-158,1,61,32,1,NYSE
5211,16-02-2021 22:00,24 hrs.,pennystocks,SOS,39,19,20,-1,6,6,3,5,NYSE
5211,16-02-2021 22:00,24 hrs.,pennystocks,THC,233,0,233,-233,1,100,29,1,NYSE
5211,16-02-2021 22:00,24 hrs.,pennystocks,ARGO,13,13,0,13,2,1,3,2,NYSE
5211,16-02-2021 22:00,24 hrs.,pennystocks,FLOW,332,0,332,-332,1,156,16,1,NYSE
5211,16-02-2021 22:00,24 hrs.,pennystocks,FUBO,26,0,26,-26,1,7,8,1,NYSE
5211,16-02-2021 22:00,24 hrs.,pennystocks,PLTR,23,0,23,-23,1,6,7,1,NYSE
5211,16-02-2021 22:00,24 hrs.,pennystocks,PUMP,6,6,0,6,1,1,0,1,NYSE
5211,16-02-2021 22:00,24 hrs.,pennystocks,CGC,233,0,233,-233,1,100,29,1,NASDAQ
5211,16-02-2021 22:00,24 hrs.,pennystocks,ESG,95,0,95,-95,1,40,11,1,NASDAQ
5211,16-02-2021 22:00,24 hrs.,pennystocks,GARB,7,0,7,-7,1,1,1,1,OTC
5211,16-02-2021 22:00,24 hrs.,pennystocks,GAXY,24,24,0,24,2,2,12,2,OTC
5211,16-02-2021 22:00,24 hrs.,pennystocks,GPFT,16,10,6,4,2,2,4,2,OTC
5211,16-02-2021 22:00,24 hrs.,pennystocks,GRNH,99,0,99,-99,1,29,37,1,OTC
5211,16-02-2021 22:00,24 hrs.,pennystocks,GTLL,7,0,7,-7,1,1,1,1,OTC
5211,16-02-2021 22:00,24 hrs.,RobinHoodPennyStocks,TRXC,6,0,6,-6,1,1,0,1,AMEX
5211,16-02-2021 22:00,24 hrs.,RobinHoodPennyStocks,ACB,166,0,166,-166,1,67,28,1,NYSE
5211,16-02-2021 22:00,24 hrs.,RobinHoodPennyStocks,AMC,6,0,6,-6,1,0,2,1,NYSE
5211,16-02-2021 22:00,24 hrs.,RobinHoodPennyStocks,BTU,166,0,166,-166,1,67,28,1,NYSE
5211,16-02-2021 22:00,24 hrs.,RobinHoodPennyStocks,CBD,12,12,0,12,2,2,0,2,NYSE
5211,16-02-2021 22:00,24 hrs.,RobinHoodPennyStocks,DSX,166,0,166,-166,1,67,28,1,NYSE
5211,16-02-2021 22:00,24 hrs.,pennystocks,MKD,317,317,0,317,1,139,35,1,NASDAQ
5211,16-02-2021 22:00,24 hrs.,pennystocks,PFC,7,0,7,-7,1,1,1,1,NASDAQ
5211,16-02-2021 22:00,24 hrs.,pennystocks,PXS,82,0,82,-82,2,31,12,1,NASDAQ
5211,16-02-2021 22:00,24 hrs.,pennystocks,TSC,6,6,0,6,1,1,0,1,NASDAQ
5211,16-02-2021 22:00,24 hrs.,pennystocks,ACST,6,0,6,-6,1,1,0,1,NASDAQ
5211,16-02-2021 22:00,24 hrs.,pennystocks,ADMA,422,422,0,422,1,198,22,1,NASDAQ
5211,16-02-2021 22:00,24 hrs.,pennystocks,ADMP,6,6,0,6,1,1,0,1,NASDAQ
5211,16-02-2021 22:00,24 hrs.,pennystocks,AIKI,82,0,82,-82,2,31,12,1,NASDAQ
5211,16-02-2021 22:00,24 hrs.,pennystocks,AKBA,6,0,6,-6,1,1,0,1,NASDAQ
5211,16-02-2021 22:00,24 hrs.,pennystocks,APHA,233,0,233,-233,1,100,29,1,NASDAQ
5211,16-02-2021 22:00,24 hrs.,pennystocks,AYTU,82,0,82,-82,2,31,12,1,NASDAQ
5211,16-02-2021 22:00,24 hrs.,pennystocks,BEAT,24,0,24,-24,1,8,4,1,NASDAQ
5211,16-02-2021 22:00,24 hrs.,pennystocks,BKEP,25,0,25,-25,1,8,5,1,NASDAQ
5211,16-02-2021 22:00,24 hrs.,pennystocks,CASH,332,0,332,-332,1,156,16,1,NASDAQ
5211,16-02-2021 22:00,24 hrs.,pennystocks,CETX,82,0,82,-82,2,31,12,1,NASDAQ
5211,16-02-2021 22:00,24 hrs.,pennystocks,CIDM,26,0,26,-26,1,7,8,1,NASDAQ
5211,16-02-2021 22:00,24 hrs.,pennystocks,CKPT,23,17,6,11,2,5,5,2,NASDAQ
5211,16-02-2021 22:00,24 hrs.,pennystocks,CRBP,15,0,15,-15,1,4,3,1,NASDAQ
5211,16-02-2021 22:00,24 hrs.,pennystocks,CRON,233,0,233,-233,1,100,29,1,NASDAQ
5211,16-02-2021 22:00,24 hrs.,pennystocks,CTRM,7,0,7,-7,1,1,1,1,NASDAQ
5211,16-02-2021 22:00,24 hrs.,pennystocks,DOGZ,25,0,25,-25,1,8,5,1,NASDAQ
5211,16-02-2021 22:00,24 hrs.,pennystocks,EBON,32,32,0,32,1,12,4,1,NASDAQ
5211,16-02-2021 22:00,24 hrs.,pennystocks,EDIT,40,0,40,-40,1,0,36,1,NASDAQ
5211,16-02-2021 22:00,24 hrs.,pennystocks,EPSN,25,0,25,-25,1,8,5,1,NASDAQ
5211,16-02-2021 22:00,24 hrs.,pennystocks,GLMD,10,10,0,10,1,2,2,1,NASDAQ
5211,16-02-2021 22:00,24 hrs.,pennystocks,GNUS,6,0,6,-6,1,1,0,1,NASDAQ
5211,16-02-2021 22:00,24 hrs.,pennystocks,GOLD,7,0,7,-7,1,1,1,1,NASDAQ
5211,16-02-2021 22:00,24 hrs.,pennystocks,GRIL,82,0,82,-82,2,31,12,1,NASDAQ
5211,16-02-2021 22:00,24 hrs.,pennystocks,KTRA,6,0,6,-6,1,1,0,1,NASDAQ
5211,16-02-2021 22:00,24 hrs.,pennystocks,LGHL,25,0,25,-25,1,8,5,1,NASDAQ
5211,16-02-2021 22:00,24 hrs.,pennystocks,LKCO,25,0,25,-25,1,8,5,1,NASDAQ
5211,16-02-2021 22:00,24 hrs.,pennystocks,LOAC,13,0,13,-13,2,2,1,1,NASDAQ
5211,16-02-2021 22:00,24 hrs.,pennystocks,NAKD,6,0,6,-6,1,1,0,1,NASDAQ
5211,16-02-2021 22:00,24 hrs.,pennystocks,NBEV,6,6,0,6,1,1,0,1,NASDAQ
5211,16-02-2021 22:00,24 hrs.,pennystocks,NEOS,82,0,82,-82,2,31,12,1,NASDAQ
5211,16-02-2021 22:00,24 hrs.,pennystocks,NNDM,19,19,0,19,1,5,5,1,NASDAQ
5211,16-02-2021 22:00,24 hrs.,pennystocks,NVCR,32,32,0,32,1,12,4,1,NASDAQ
5211,16-02-2021 22:00,24 hrs.,pennystocks,OBSV,188,0,188,-188,1,66,52,1,NASDAQ
5211,16-02-2021 22:00,24 hrs.,pennystocks,OCGN,6,6,0,6,1,1,0,1,NASDAQ
5211,16-02-2021 22:00,24 hrs.,pennystocks,OKTA,32,32,0,32,1,12,4,1,NASDAQ
5211,16-02-2021 22:00,24 hrs.,pennystocks,PANL,25,0,25,-25,1,8,5,1,NASDAQ
5211,16-02-2021 22:00,24 hrs.,pennystocks,PFMT,6,0,6,-6,1,1,0,1,NASDAQ
5211,16-02-2021 22:00,24 hrs.,pennystocks,PLUG,32,32,0,32,1,12,4,1,NASDAQ
5211,16-02-2021 22:00,24 hrs.,pennystocks,PULM,500,500,0,500,1,202,92,1,NASDAQ
5211,16-02-2021 22:00,24 hrs.,pennystocks,QCOM,32,32,0,32,1,12,4,1,NASDAQ
5211,16-02-2021 22:00,24 hrs.,pennystocks,RAVE,82,0,82,-82,2,31,12,1,NASDAQ
5211,16-02-2021 22:00,24 hrs.,pennystocks,ROKU,26,0,26,-26,1,7,8,1,NASDAQ
5211,16-02-2021 22:00,24 hrs.,pennystocks,SESN,29,29,0,29,1,7,11,1,NASDAQ
5211,16-02-2021 22:00,24 hrs.,pennystocks,SNDL,52,6,46,-40,7,10,4,6,NASDAQ
5211,16-02-2021 22:00,24 hrs.,pennystocks,SNGX,89,0,89,-89,3,32,13,2,NASDAQ
5211,16-02-2021 22:00,24 hrs.,pennystocks,SOLO,32,32,0,32,1,12,4,1,NASDAQ
5211,16-02-2021 22:00,24 hrs.,pennystocks,TLRY,233,0,233,-233,1,100,29,1,NASDAQ
5211,16-02-2021 22:00,24 hrs.,pennystocks,TRVG,82,0,82,-82,2,31,12,1,NASDAQ
5211,16-02-2021 22:00,24 hrs.,pennystocks,TTOO,6,0,6,-6,1,1,0,1,NASDAQ
5211,16-02-2021 22:00,24 hrs.,pennystocks,VBIV,4,4,0,4,1,0,0,1,NASDAQ
5211,16-02-2021 22:00,24 hrs.,pennystocks,XSPA,26,0,26,-26,2,1,16,2,NASDAQ
5211,16-02-2021 22:00,24 hrs.,pennystocks,ZYNE,15,0,15,-15,1,4,3,1,NASDAQ
5211,16-02-2021 22:00,24 hrs.,RobinHoodPennyStocks,ABWN,6,0,6,-6,1,1,0,1,OTC
5211,16-02-2021 22:00,24 hrs.,RobinHoodPennyStocks,CLSK,166,0,166,-166,1,67,28,1,NASDAQ
5211,16-02-2021 22:00,24 hrs.,RobinHoodPennyStocks,CRON,166,0,166,-166,1,67,28,1,NASDAQ
5211,16-02-2021 22:00,24 hrs.,RobinHoodPennyStocks,CTXR,6,6,0,6,1,1,0,1,NASDAQ
5211,16-02-2021 22:00,24 hrs.,RobinHoodPennyStocks,DFFN,833,695,138,557,5,312,189,5,NASDAQ
5211,16-02-2021 22:00,24 hrs.,RobinHoodPennyStocks,DZSI,166,0,166,-166,1,67,28,1,NASDAQ
5211,16-02-2021 22:00,24 hrs.,RobinHoodPennyStocks,EBON,166,0,166,-166,1,67,28,1,NASDAQ
5211,16-02-2021 22:00,24 hrs.,RobinHoodPennyStocks,EDRY,166,0,166,-166,1,67,28,1,NASDAQ
5211,16-02-2021 22:00,24 hrs.,RobinHoodPennyStocks,EOLS,19,19,0,19,1,7,1,1,NASDAQ
5211,16-02-2021 22:00,24 hrs.,RobinHoodPennyStocks,EPSN,166,0,166,-166,1,67,28,1,NASDAQ
5211,16-02-2021 22:00,24 hrs.,RobinHoodPennyStocks,EQOS,166,0,166,-166,1,67,28,1,NASDAQ
5211,16-02-2021 22:00,24 hrs.,RobinHoodPennyStocks,FAMI,166,0,166,-166,1,67,28,1,NASDAQ
5211,16-02-2021 22:00,24 hrs.,RobinHoodPennyStocks,FCEL,166,0,166,-166,1,67,28,1,NASDAQ
5211,16-02-2021 22:00,24 hrs.,RobinHoodPennyStocks,FORD,166,0,166,-166,1,67,28,1,NASDAQ
5211,16-02-2021 22:00,24 hrs.,RobinHoodPennyStocks,GTHX,166,0,166,-166,1,67,28,1,NASDAQ
5211,16-02-2021 22:00,24 hrs.,RobinHoodPennyStocks,HGEN,166,0,166,-166,1,67,28,1,NASDAQ
5211,16-02-2021 22:00,24 hrs.,RobinHoodPennyStocks,HNRG,166,0,166,-166,1,67,28,1,NASDAQ
5211,16-02-2021 22:00,24 hrs.,RobinHoodPennyStocks,IDEX,237,65,172,-107,4,95,31,4,NASDAQ
5211,16-02-2021 22:00,24 hrs.,RobinHoodPennyStocks,IMTE,166,0,166,-166,1,67,28,1,NASDAQ
5211,16-02-2021 22:00,24 hrs.,RobinHoodPennyStocks,IZEA,166,0,166,-166,1,67,28,1,NASDAQ
5211,16-02-2021 22:00,24 hrs.,RobinHoodPennyStocks,KERN,166,0,166,-166,1,67,28,1,NASDAQ
5211,16-02-2021 22:00,24 hrs.,RobinHoodPennyStocks,LIVE,6,6,0,6,1,1,0,1,NASDAQ
5211,16-02-2021 22:00,24 hrs.,RobinHoodPennyStocks,LMFA,166,0,166,-166,1,67,28,1,NASDAQ
5211,16-02-2021 22:00,24 hrs.,RobinHoodPennyStocks,MARA,166,0,166,-166,1,67,28,1,NASDAQ
5211,16-02-2021 22:00,24 hrs.,RobinHoodPennyStocks,METX,166,0,166,-166,1,67,28,1,NASDAQ
5211,16-02-2021 22:00,24 hrs.,RobinHoodPennyStocks,MNPR,166,0,166,-166,1,67,28,1,NASDAQ
5211,16-02-2021 22:00,24 hrs.,RobinHoodPennyStocks,MOGO,166,0,166,-166,1,67,28,1,NASDAQ
5211,16-02-2021 22:00,24 hrs.,RobinHoodPennyStocks,NAKD,201,0,201,-201,2,75,43,2,NASDAQ
5211,16-02-2021 22:00,24 hrs.,RobinHoodPennyStocks,NDRA,19,19,0,19,1,5,5,1,NASDAQ
5211,16-02-2021 22:00,24 hrs.,RobinHoodPennyStocks,NOVN,166,0,166,-166,1,67,28,1,NASDAQ
5211,16-02-2021 22:00,24 hrs.,RobinHoodPennyStocks,NVAX,166,0,166,-166,1,67,28,1,NASDAQ
5211,16-02-2021 22:00,24 hrs.,RobinHoodPennyStocks,NXTD,166,0,166,-166,1,67,28,1,NASDAQ
5211,16-02-2021 22:00,24 hrs.,RobinHoodPennyStocks,GME,6,6,0,6,1,1,0,1,NYSE
5211,16-02-2021 22:00,24 hrs.,RobinHoodPennyStocks,HGV,166,0,166,-166,1,67,28,1,NYSE
5211,16-02-2021 22:00,24 hrs.,RobinHoodPennyStocks,HMI,166,0,166,-166,1,67,28,1,NYSE
5211,16-02-2021 22:00,24 hrs.,RobinHoodPennyStocks,NOK,35,0,35,-35,1,8,15,1,NYSE
5211,16-02-2021 22:00,24 hrs.,RobinHoodPennyStocks,PVL,166,0,166,-166,1,67,28,1,NYSE
5211,16-02-2021 22:00,24 hrs.,RobinHoodPennyStocks,SIX,166,0,166,-166,1,67,28,1,NYSE
5211,16-02-2021 22:00,24 hrs.,RobinHoodPennyStocks,SOS,233,0,233,-233,4,75,67,3,NYSE
5211,16-02-2021 22:00,24 hrs.,RobinHoodPennyStocks,VST,166,0,166,-166,1,67,28,1,NYSE
5211,16-02-2021 22:00,24 hrs.,RobinHoodPennyStocks,ARCH,166,0,166,-166,1,67,28,1,NYSE
5211,16-02-2021 22:00,24 hrs.,RobinHoodPennyStocks,CCIV,12,0,12,-12,2,2,0,1,NYSE
5211,16-02-2021 22:00,24 hrs.,RobinHoodPennyStocks,HEXO,166,0,166,-166,1,67,28,1,NYSE
5211,16-02-2021 22:00,24 hrs.,RobinHoodPennyStocks,PLTR,12,6,6,0,2,2,0,2,NYSE
5211,16-02-2021 22:00,24 hrs.,RobinHoodPennyStocks,CGC,166,0,166,-166,1,67,28,1,NASDAQ
5211,16-02-2021 22:00,24 hrs.,RobinHoodPennyStocks,ENG,166,0,166,-166,1,67,28,1,NASDAQ
5211,16-02-2021 22:00,24 hrs.,RobinHoodPennyStocks,MGI,166,0,166,-166,1,67,28,1,NASDAQ
5211,16-02-2021 22:00,24 hrs.,RobinHoodPennyStocks,OEG,172,0,172,-172,2,68,28,2,NASDAQ
5211,16-02-2021 22:00,24 hrs.,RobinHoodPennyStocks,OGI,166,0,166,-166,1,67,28,1,NASDAQ
5211,16-02-2021 22:00,24 hrs.,RobinHoodPennyStocks,PFC,6,0,6,-6,1,1,0,1,NASDAQ
5211,16-02-2021 22:00,24 hrs.,RobinHoodPennyStocks,SPI,166,0,166,-166,1,67,28,1,NASDAQ
5211,16-02-2021 22:00,24 hrs.,RobinHoodPennyStocks,CEI,166,0,166,-166,1,67,28,1,AMEX
5211,16-02-2021 22:00,24 hrs.,RobinHoodPennyStocks,DNN,8,0,8,-8,1,2,0,1,AMEX
5211,16-02-2021 22:00,24 hrs.,RobinHoodPennyStocks,DPW,166,0,166,-166,1,67,28,1,AMEX
5211,16-02-2021 22:00,24 hrs.,RobinHoodPennyStocks,GTE,443,0,443,-443,4,176,75,3,AMEX
5211,16-02-2021 22:00,24 hrs.,RobinHoodPennyStocks,IGC,166,0,166,-166,1,67,28,1,AMEX
5211,16-02-2021 22:00,24 hrs.,RobinHoodPennyStocks,ITP,18,6,12,-6,3,3,0,2,AMEX
5211,16-02-2021 22:00,24 hrs.,RobinHoodPennyStocks,PED,166,0,166,-166,1,67,28,1,AMEX
5211,16-02-2021 22:00,24 hrs.,RobinHoodPennyStocks,REI,166,0,166,-166,1,67,28,1,AMEX
5211,16-02-2021 22:00,24 hrs.,RobinHoodPennyStocks,ZOM,213,0,213,-213,3,67,67,3,AMEX
5211,16-02-2021 22:00,24 hrs.,RobinHoodPennyStocks,ENSV,166,0,166,-166,1,67,28,1,AMEX
5211,16-02-2021 22:00,24 hrs.,RobinHoodPennyStocks,GSAT,166,0,166,-166,1,67,28,1,AMEX
5211,16-02-2021 22:00,24 hrs.,RobinHoodPennyStocks,HUSA,166,0,166,-166,1,67,28,1,AMEX
5211,16-02-2021 22:00,24 hrs.,RobinHoodPennyStocks,SNMP,166,0,166,-166,1,67,28,1,AMEX
5211,16-02-2021 22:00,24 hrs.,RobinHoodPennyStocks,TMBR,23,0,23,-23,1,6,7,1,AMEX
5211,16-02-2021 22:00,24 hrs.,RobinHoodPennyStocks,OBSV,98,0,98,-98,3,41,4,2,NASDAQ
5211,16-02-2021 22:00,24 hrs.,RobinHoodPennyStocks,OCUL,166,0,166,-166,1,67,28,1,NASDAQ
5211,16-02-2021 22:00,24 hrs.,RobinHoodPennyStocks,OPGN,6,6,0,6,1,1,0,1,NASDAQ
5211,16-02-2021 22:00,24 hrs.,RobinHoodPennyStocks,OPTT,166,0,166,-166,1,67,28,1,NASDAQ
5211,16-02-2021 22:00,24 hrs.,RobinHoodPennyStocks,PECK,166,0,166,-166,1,67,28,1,NASDAQ
5211,16-02-2021 22:00,24 hrs.,RobinHoodPennyStocks,PEIX,166,0,166,-166,1,67,28,1,NASDAQ
5211,16-02-2021 22:00,24 hrs.,RobinHoodPennyStocks,PHIO,166,0,166,-166,1,67,28,1,NASDAQ
5211,16-02-2021 22:00,24 hrs.,RobinHoodPennyStocks,PHUN,166,0,166,-166,1,67,28,1,NASDAQ
5211,16-02-2021 22:00,24 hrs.,RobinHoodPennyStocks,PLUG,166,0,166,-166,1,67,28,1,NASDAQ
5211,16-02-2021 22:00,24 hrs.,RobinHoodPennyStocks,PLYA,166,0,166,-166,1,67,28,1,NASDAQ
5211,16-02-2021 22:00,24 hrs.,RobinHoodPennyStocks,RCON,166,0,166,-166,1,67,28,1,NASDAQ
5211,16-02-2021 22:00,24 hrs.,RobinHoodPennyStocks,RIOT,166,0,166,-166,1,67,28,1,NASDAQ
5211,16-02-2021 22:00,24 hrs.,RobinHoodPennyStocks,SALM,166,0,166,-166,1,67,28,1,NASDAQ
5211,16-02-2021 22:00,24 hrs.,RobinHoodPennyStocks,SAVA,166,0,166,-166,1,67,28,1,NASDAQ
5211,16-02-2021 22:00,24 hrs.,RobinHoodPennyStocks,SHIP,166,0,166,-166,1,67,28,1,NASDAQ
5211,16-02-2021 22:00,24 hrs.,RobinHoodPennyStocks,SINO,166,0,166,-166,1,67,28,1,NASDAQ
5211,16-02-2021 22:00,24 hrs.,RobinHoodPennyStocks,SNDL,172,6,166,-160,2,68,28,2,NASDAQ
5211,16-02-2021 22:00,24 hrs.,RobinHoodPennyStocks,SNGX,166,0,166,-166,1,67,28,1,NASDAQ
5211,16-02-2021 22:00,24 hrs.,RobinHoodPennyStocks,STAY,166,0,166,-166,1,67,28,1,NASDAQ
5211,16-02-2021 22:00,24 hrs.,RobinHoodPennyStocks,SUNW,166,0,166,-166,1,67,28,1,NASDAQ
5211,16-02-2021 22:00,24 hrs.,RobinHoodPennyStocks,SYPR,166,0,166,-166,1,67,28,1,NASDAQ
5211,16-02-2021 22:00,24 hrs.,RobinHoodPennyStocks,SYTA,166,0,166,-166,1,67,28,1,NASDAQ
5211,16-02-2021 22:00,24 hrs.,RobinHoodPennyStocks,TANH,21,0,21,-21,1,5,7,1,NASDAQ
5211,16-02-2021 22:00,24 hrs.,RobinHoodPennyStocks,TLRY,172,6,166,-160,2,68,28,2,NASDAQ
5211,16-02-2021 22:00,24 hrs.,RobinHoodPennyStocks,TNXP,78,6,72,-66,4,25,12,4,NASDAQ
5211,16-02-2021 22:00,24 hrs.,RobinHoodPennyStocks,TOPS,166,0,166,-166,1,67,28,1,NASDAQ
5211,16-02-2021 22:00,24 hrs.,RobinHoodPennyStocks,TRCH,172,6,166,-160,2,68,28,2,NASDAQ
5211,16-02-2021 22:00,24 hrs.,RobinHoodPennyStocks,TSLA,6,6,0,6,1,1,0,1,NASDAQ
5211,16-02-2021 22:00,24 hrs.,RobinHoodPennyStocks,TXMD,12,6,6,0,2,2,0,2,NASDAQ
5211,16-02-2021 22:00,24 hrs.,RobinHoodPennyStocks,TYME,6,0,6,-6,1,1,0,1,NASDAQ
5211,16-02-2021 22:00,24 hrs.,RobinHoodPennyStocks,UONE,166,0,166,-166,1,67,28,1,NASDAQ
5211,16-02-2021 22:00,24 hrs.,RobinHoodPennyStocks,USEG,166,0,166,-166,1,67,28,1,NASDAQ
5211,16-02-2021 22:00,24 hrs.,RobinHoodPennyStocks,USWS,166,0,166,-166,1,67,28,1,NASDAQ
5211,16-02-2021 22:00,24 hrs.,RobinHoodPennyStocks,VBIV,11,11,0,11,1,0,7,1,NASDAQ
5211,16-02-2021 22:00,24 hrs.,RobinHoodPennyStocks,VERU,166,0,166,-166,1,67,28,1,NASDAQ
5211,16-02-2021 22:00,24 hrs.,RobinHoodPennyStocks,WATT,166,0,166,-166,1,67,28,1,NASDAQ
5211,16-02-2021 22:00,24 hrs.,RobinHoodPennyStocks,WKEY,166,0,166,-166,1,67,28,1,NASDAQ
5211,16-02-2021 22:00,24 hrs.,RobinHoodPennyStocks,MARPS,166,0,166,-166,1,67,28,1,NASDAQ
5211,16-02-2021 22:00,24 hrs.,RobinHoodPennyStocks,UONEK,166,0,166,-166,1,67,28,1,NASDAQ
5211,16-02-2021 22:00,24 hrs.,RobinHoodPennyStocks,TGA,166,0,166,-166,1,67,28,1,NASDAQ
5211,16-02-2021 22:00,24 hrs.,RobinHoodPennyStocks,WNW,166,0,166,-166,1,67,28,1,NASDAQ
5211,16-02-2021 22:00,24 hrs.,RobinHoodPennyStocks,WWR,166,0,166,-166,1,67,28,1,NASDAQ
5211,16-02-2021 22:00,24 hrs.,RobinHoodPennyStocks,AACQ,166,0,166,-166,1,67,28,1,NASDAQ
5211,16-02-2021 22:00,24 hrs.,RobinHoodPennyStocks,AAPL,166,0,166,-166,1,67,28,1,NASDAQ
5211,16-02-2021 22:00,24 hrs.,RobinHoodPennyStocks,ADXS,6,0,6,-6,1,1,0,1,NASDAQ
5211,16-02-2021 22:00,24 hrs.,RobinHoodPennyStocks,AGTC,2405,161,2244,-2083,7,1068,241,5,NASDAQ
5211,16-02-2021 22:00,24 hrs.,RobinHoodPennyStocks,AIKI,166,0,166,-166,1,67,28,1,NASDAQ
5211,16-02-2021 22:00,24 hrs.,RobinHoodPennyStocks,ALAC,166,0,166,-166,1,67,28,1,NASDAQ
5211,16-02-2021 22:00,24 hrs.,RobinHoodPennyStocks,ALJJ,166,0,166,-166,1,67,28,1,NASDAQ
5211,16-02-2021 22:00,24 hrs.,RobinHoodPennyStocks,AMTX,166,0,166,-166,1,67,28,1,NASDAQ
5211,16-02-2021 22:00,24 hrs.,RobinHoodPennyStocks,APHA,172,6,166,-160,2,68,28,2,NASDAQ
5211,16-02-2021 22:00,24 hrs.,RobinHoodPennyStocks,ARLP,166,0,166,-166,1,67,28,1,NASDAQ
5211,16-02-2021 22:00,24 hrs.,RobinHoodPennyStocks,ARTL,166,0,166,-166,1,67,28,1,NASDAQ
5211,16-02-2021 22:00,24 hrs.,RobinHoodPennyStocks,ASRT,115,0,115,-115,1,34,43,1,NASDAQ
5211,16-02-2021 22:00,24 hrs.,RobinHoodPennyStocks,ATOS,23,0,23,-23,1,6,7,1,NASDAQ
5211,16-02-2021 22:00,24 hrs.,RobinHoodPennyStocks,BEAT,19,0,19,-19,1,7,1,1,NASDAQ
5211,16-02-2021 22:00,24 hrs.,RobinHoodPennyStocks,BNGO,166,0,166,-166,1,67,28,1,NASDAQ
5211,16-02-2021 22:00,24 hrs.,RobinHoodPennyStocks,BOXL,166,0,166,-166,1,67,28,1,NASDAQ
5211,16-02-2021 22:00,24 hrs.,RobinHoodPennyStocks,BRQS,166,0,166,-166,1,67,28,1,NASDAQ
5211,16-02-2021 22:00,24 hrs.,RobinHoodPennyStocks,BYFC,166,0,166,-166,1,67,28,1,NASDAQ
5211,16-02-2021 22:00,24 hrs.,RobinHoodPennyStocks,CARV,166,0,166,-166,1,67,28,1,NASDAQ
5211,16-02-2021 22:00,24 hrs.,RobinHoodPennyStocks,CBAT,166,0,166,-166,1,67,28,1,NASDAQ
5211,16-02-2021 22:00,24 hrs.,RobinHoodPennyStocks,CCNC,166,0,166,-166,1,67,28,1,NASDAQ
5211,16-02-2021 22:00,24 hrs.,RobinHoodPennyStocks,CLEU,166,0,166,-166,1,67,28,1,NASDAQ
5164,16-02-2021 14:00,24 hrs.,wallstreetbets,AGFAF,6,6,0,6,1,1,0,1,OTC
5164,16-02-2021 14:00,24 hrs.,wallstreetbets,AMYZF,7,7,0,7,1,1,1,1,OTC
5164,16-02-2021 14:00,24 hrs.,wallstreetbets,BDRBF,7,7,0,7,1,1,1,1,OTC
5164,16-02-2021 14:00,24 hrs.,wallstreetbets,BRQSW,7,7,0,7,1,1,1,1,OTC
5164,16-02-2021 14:00,24 hrs.,wallstreetbets,BVNNF,7,0,7,-7,1,1,1,1,OTC
5164,16-02-2021 14:00,24 hrs.,wallstreetbets,CBDEF,14,14,0,14,2,2,2,1,OTC
5164,16-02-2021 14:00,24 hrs.,wallstreetbets,CIOXY,7,7,0,7,1,1,1,1,OTC
5164,16-02-2021 14:00,24 hrs.,wallstreetbets,DOFSQ,7,7,0,7,1,1,1,1,OTC
5164,16-02-2021 14:00,24 hrs.,wallstreetbets,GAYMF,7,7,0,7,1,1,1,1,OTC
5164,16-02-2021 14:00,24 hrs.,wallstreetbets,CEI,21,21,0,21,3,3,3,1,AMEX
5164,16-02-2021 14:00,24 hrs.,wallstreetbets,DNN,21,14,7,7,3,3,3,3,AMEX
5164,16-02-2021 14:00,24 hrs.,wallstreetbets,GDP,888,0,888,-888,1,374,136,1,AMEX
5164,16-02-2021 14:00,24 hrs.,wallstreetbets,GSV,22,0,22,-22,3,3,4,1,AMEX
5164,16-02-2021 14:00,24 hrs.,wallstreetbets,LEU,6,0,6,-6,1,1,0,1,AMEX
5164,16-02-2021 14:00,24 hrs.,wallstreetbets,NES,7,0,7,-7,1,1,1,1,AMEX
5164,16-02-2021 14:00,24 hrs.,wallstreetbets,PED,7,7,0,7,1,1,1,1,AMEX
5164,16-02-2021 14:00,24 hrs.,wallstreetbets,TGB,7,0,7,-7,1,1,1,1,AMEX
5164,16-02-2021 14:00,24 hrs.,wallstreetbets,ZOM,28,21,7,14,4,4,4,4,AMEX
5164,16-02-2021 14:00,24 hrs.,pennystocks,NVCN,46,0,46,-46,1,12,18,1,NASDAQ
5164,16-02-2021 14:00,24 hrs.,pennystocks,OBSV,160,0,160,-160,1,53,50,1,NASDAQ
5164,16-02-2021 14:00,24 hrs.,pennystocks,OTLK,6,0,6,-6,1,1,0,1,NASDAQ
5164,16-02-2021 14:00,24 hrs.,pennystocks,PANL,23,23,0,23,1,8,3,1,NASDAQ
5164,16-02-2021 14:00,24 hrs.,pennystocks,PFMT,6,6,0,6,1,1,0,1,NASDAQ
5164,16-02-2021 14:00,24 hrs.,pennystocks,PTON,97,0,97,-97,1,38,17,1,NASDAQ
5164,16-02-2021 14:00,24 hrs.,pennystocks,RAVE,63,63,0,63,2,22,11,1,NASDAQ
5164,16-02-2021 14:00,24 hrs.,pennystocks,RIOT,194,0,194,-194,2,57,72,2,NASDAQ
5164,16-02-2021 14:00,24 hrs.,pennystocks,ROKU,24,24,0,24,1,6,8,1,NASDAQ
5164,16-02-2021 14:00,24 hrs.,pennystocks,SHIP,50,0,50,-50,1,9,28,1,NASDAQ
5164,16-02-2021 14:00,24 hrs.,pennystocks,SNDL,53,34,19,15,7,10,5,6,NASDAQ
5164,16-02-2021 14:00,24 hrs.,pennystocks,SNGX,70,70,0,70,3,23,12,2,NASDAQ
5164,16-02-2021 14:00,24 hrs.,pennystocks,TLRY,233,0,233,-233,1,100,29,1,NASDAQ
5164,16-02-2021 14:00,24 hrs.,pennystocks,TRCH,12,0,12,-12,1,0,8,1,NASDAQ
5164,16-02-2021 14:00,24 hrs.,pennystocks,TRVG,63,63,0,63,2,22,11,1,NASDAQ
5164,16-02-2021 14:00,24 hrs.,pennystocks,TSLA,41,0,41,-41,1,15,7,1,NASDAQ
5164,16-02-2021 14:00,24 hrs.,pennystocks,TTOO,6,0,6,-6,1,1,0,1,NASDAQ
5164,16-02-2021 14:00,24 hrs.,pennystocks,TXMD,6,0,6,-6,1,1,0,1,NASDAQ
5164,16-02-2021 14:00,24 hrs.,pennystocks,VBIV,4,4,0,4,1,0,0,1,NASDAQ
5164,16-02-2021 14:00,24 hrs.,pennystocks,XSPA,386,21,365,-344,4,146,78,4,NASDAQ
5164,16-02-2021 14:00,24 hrs.,pennystocks,ZYNE,15,15,0,15,1,4,3,1,NASDAQ
5164,16-02-2021 14:00,24 hrs.,wallstreetbets,ABML,7,0,7,-7,1,1,1,1,OTC
5164,16-02-2021 14:00,24 hrs.,wallstreetbets,ALKN,13,0,13,-13,2,2,1,2,OTC
5164,16-02-2021 14:00,24 hrs.,wallstreetbets,ARST,7,0,7,-7,1,1,1,1,OTC
5164,16-02-2021 14:00,24 hrs.,wallstreetbets,ASTI,14,14,0,14,2,2,2,1,OTC
5164,16-02-2021 14:00,24 hrs.,wallstreetbets,BBRW,7,0,7,-7,1,1,1,1,OTC
5164,16-02-2021 14:00,24 hrs.,wallstreetbets,BOTY,7,0,7,-7,1,1,1,1,OTC
5164,16-02-2021 14:00,24 hrs.,wallstreetbets,BTCS,7,0,7,-7,1,1,1,1,OTC
5164,16-02-2021 14:00,24 hrs.,wallstreetbets,COMS,12,6,6,0,2,2,0,2,OTC
5164,16-02-2021 14:00,24 hrs.,wallstreetbets,CYDY,15,0,15,-15,2,2,3,1,OTC
5164,16-02-2021 14:00,24 hrs.,wallstreetbets,ECDP,7,0,7,-7,1,1,1,1,OTC
5164,16-02-2021 14:00,24 hrs.,wallstreetbets,ETFM,7,7,0,7,1,1,1,1,OTC
5164,16-02-2021 14:00,24 hrs.,wallstreetbets,FLES,14,14,0,14,2,2,2,1,OTC
5164,16-02-2021 14:00,24 hrs.,wallstreetbets,FMCC,569,237,332,-95,2,181,199,2,OTC
5164,16-02-2021 14:00,24 hrs.,wallstreetbets,FNMA,569,237,332,-95,2,181,199,2,OTC
5164,16-02-2021 14:00,24 hrs.,wallstreetbets,GARB,7,0,7,-7,1,1,1,1,OTC
5164,16-02-2021 14:00,24 hrs.,wallstreetbets,GPFT,14,0,14,-14,2,2,2,2,OTC
5164,16-02-2021 14:00,24 hrs.,wallstreetbets,GTLL,14,7,7,0,2,2,2,2,OTC
5164,16-02-2021 14:00,24 hrs.,wallstreetbets,HCMC,47,7,40,-33,7,7,5,7,OTC
5164,16-02-2021 14:00,24 hrs.,wallstreetbets,HYSR,13,0,13,-13,2,2,1,2,OTC
5164,16-02-2021 14:00,24 hrs.,wallstreetbets,JSDA,7,0,7,-7,1,1,1,1,OTC
5164,16-02-2021 14:00,24 hrs.,wallstreetbets,MCOA,7,0,7,-7,1,1,1,1,OTC
5164,16-02-2021 14:00,24 hrs.,wallstreetbets,ONCX,7,7,0,7,1,1,1,1,OTC
5164,16-02-2021 14:00,24 hrs.,wallstreetbets,OZSC,7,0,7,-7,1,1,1,1,OTC
5164,16-02-2021 14:00,24 hrs.,wallstreetbets,PAPA,7,7,0,7,1,1,1,1,OTC
5164,16-02-2021 14:00,24 hrs.,wallstreetbets,QUBT,6,0,6,-6,1,1,0,1,OTC
5164,16-02-2021 14:00,24 hrs.,wallstreetbets,RDGL,7,0,7,-7,1,1,1,1,OTC
5164,16-02-2021 14:00,24 hrs.,wallstreetbets,RNWR,6,0,6,-6,1,1,0,1,OTC
5164,16-02-2021 14:00,24 hrs.,wallstreetbets,ROTH,7,0,7,-7,1,1,1,1,OTC
5164,16-02-2021 14:00,24 hrs.,wallstreetbets,RTON,6,0,6,-6,1,1,0,1,OTC
5164,16-02-2021 14:00,24 hrs.,wallstreetbets,RXMD,6,0,6,-6,1,1,0,1,OTC
5164,16-02-2021 14:00,24 hrs.,wallstreetbets,SHMP,6,0,6,-6,1,1,0,1,OTC
5164,16-02-2021 14:00,24 hrs.,wallstreetbets,SLNG,6,6,0,6,1,1,0,1,OTC
5164,16-02-2021 14:00,24 hrs.,wallstreetbets,TLSS,7,7,0,7,1,1,1,1,OTC
5164,16-02-2021 14:00,24 hrs.,wallstreetbets,TTCM,6,0,6,-6,1,1,0,1,OTC
5164,16-02-2021 14:00,24 hrs.,wallstreetbets,RKT,902,0,902,-902,5,308,266,4,NYSE
5164,16-02-2021 14:00,24 hrs.,wallstreetbets,RRC,126,0,126,-126,1,15,92,1,NYSE
5164,16-02-2021 14:00,24 hrs.,wallstreetbets,RSI,234,0,234,-234,1,73,84,1,NYSE
5164,16-02-2021 14:00,24 hrs.,wallstreetbets,SNE,7,0,7,-7,1,1,1,1,NYSE
5164,16-02-2021 14:00,24 hrs.,wallstreetbets,SOS,28,7,21,-14,4,4,4,3,NYSE
5164,16-02-2021 14:00,24 hrs.,wallstreetbets,THO,64,64,0,64,1,18,24,1,NYSE
5164,16-02-2021 14:00,24 hrs.,wallstreetbets,TRQ,894,0,894,-894,2,375,136,2,NYSE
5164,16-02-2021 14:00,24 hrs.,wallstreetbets,TSM,272,272,0,272,2,99,66,2,NYSE
5164,16-02-2021 14:00,24 hrs.,wallstreetbets,TTI,7,7,0,7,1,1,1,1,NYSE
5164,16-02-2021 14:00,24 hrs.,wallstreetbets,WFC,7,0,7,-7,1,1,1,1,NYSE
5164,16-02-2021 14:00,24 hrs.,wallstreetbets,WPM,186,186,0,186,1,75,32,1,NYSE
5164,16-02-2021 14:00,24 hrs.,wallstreetbets,WTI,83,0,83,-83,1,15,49,1,NYSE
5164,16-02-2021 14:00,24 hrs.,wallstreetbets,WWE,7,7,0,7,1,1,1,1,NYSE
5164,16-02-2021 14:00,24 hrs.,wallstreetbets,AJAX,7,7,0,7,1,1,1,1,NYSE
5164,16-02-2021 14:00,24 hrs.,wallstreetbets,ARGO,7,7,0,7,1,1,1,1,NYSE
5164,16-02-2021 14:00,24 hrs.,wallstreetbets,BABA,6,0,6,-6,1,1,0,1,NYSE
5164,16-02-2021 14:00,24 hrs.,wallstreetbets,BBAR,6,6,0,6,1,1,0,1,NYSE
5164,16-02-2021 14:00,24 hrs.,wallstreetbets,BORR,7,0,7,-7,1,1,1,1,NYSE
5164,16-02-2021 14:00,24 hrs.,wallstreetbets,CCIV,47,14,33,-19,7,7,5,7,NYSE
5164,16-02-2021 14:00,24 hrs.,wallstreetbets,COTY,85,27,58,-31,6,24,13,4,NYSE
5164,16-02-2021 14:00,24 hrs.,wallstreetbets,CSPR,6,0,6,-6,1,1,0,1,NYSE
5164,16-02-2021 14:00,24 hrs.,wallstreetbets,DASH,14,0,14,-14,2,2,2,1,NYSE
5164,16-02-2021 14:00,24 hrs.,wallstreetbets,EVRI,6,0,6,-6,1,1,0,1,NYSE
5164,16-02-2021 14:00,24 hrs.,wallstreetbets,FINV,6,6,0,6,1,1,0,1,NYSE
5164,16-02-2021 14:00,24 hrs.,wallstreetbets,FMAC,9,0,9,-9,1,1,3,1,NYSE
5164,16-02-2021 14:00,24 hrs.,wallstreetbets,FUBO,28,14,14,0,4,4,4,3,NYSE
5164,16-02-2021 14:00,24 hrs.,wallstreetbets,HUYA,8,0,8,-8,1,1,2,1,NYSE
5164,16-02-2021 14:00,24 hrs.,wallstreetbets,IPOE,6,0,6,-6,1,1,0,1,NYSE
5164,16-02-2021 14:00,24 hrs.,wallstreetbets,LEAP,7,7,0,7,1,1,1,1,NYSE
5164,16-02-2021 14:00,24 hrs.,wallstreetbets,MSGS,6,0,6,-6,1,1,0,1,NYSE
5164,16-02-2021 14:00,24 hrs.,wallstreetbets,PINS,7,0,7,-7,1,1,1,1,NYSE
5164,16-02-2021 14:00,24 hrs.,wallstreetbets,PLTR,18365,1900,16465,-14565,44,8251,1687,35,NYSE
5164,16-02-2021 14:00,24 hrs.,wallstreetbets,VALE,888,0,888,-888,1,374,136,1,NYSE
5164,16-02-2021 14:00,24 hrs.,wallstreetbets,AMPE,7,0,7,-7,1,1,1,1,AMEX
5164,16-02-2021 14:00,24 hrs.,wallstreetbets,CANF,7,0,7,-7,1,1,1,1,AMEX
5164,16-02-2021 14:00,24 hrs.,wallstreetbets,GSAT,19,13,6,7,3,3,1,3,AMEX
5164,16-02-2021 14:00,24 hrs.,wallstreetbets,LODE,7,7,0,7,1,1,1,1,AMEX
5164,16-02-2021 14:00,24 hrs.,wallstreetbets,TRXC,13,7,6,1,2,2,1,2,AMEX
5164,16-02-2021 14:00,24 hrs.,wallstreetbets,UAMY,7,7,0,7,1,1,1,1,AMEX
5164,16-02-2021 14:00,24 hrs.,wallstreetbets,ACB,14,14,0,14,2,2,2,2,NYSE
5164,16-02-2021 14:00,24 hrs.,wallstreetbets,ADX,6,0,6,-6,1,1,0,1,NYSE
5164,16-02-2021 14:00,24 hrs.,wallstreetbets,AIR,7,0,7,-7,1,1,1,1,NYSE
5164,16-02-2021 14:00,24 hrs.,wallstreetbets,AMC,2466,793,1673,-880,84,906,318,67,NYSE
5164,16-02-2021 14:00,24 hrs.,wallstreetbets,AMP,6,0,6,-6,1,1,0,1,NYSE
5164,16-02-2021 14:00,24 hrs.,wallstreetbets,BAM,122,0,122,-122,1,49,20,1,NYSE
5164,16-02-2021 14:00,24 hrs.,wallstreetbets,BCH,13,0,13,-13,2,2,1,2,NYSE
5164,16-02-2021 14:00,24 hrs.,wallstreetbets,BIO,7,0,7,-7,1,1,1,1,NYSE
5164,16-02-2021 14:00,24 hrs.,wallstreetbets,BUD,7,0,7,-7,1,1,1,1,NYSE
5164,16-02-2021 14:00,24 hrs.,wallstreetbets,CBD,14,0,14,-14,2,3,0,2,NYSE
5164,16-02-2021 14:00,24 hrs.,wallstreetbets,CPE,14,7,7,0,2,2,2,2,NYSE
5164,16-02-2021 14:00,24 hrs.,wallstreetbets,CVS,7,7,0,7,1,1,1,1,NYSE
5164,16-02-2021 14:00,24 hrs.,wallstreetbets,CXW,7,0,7,-7,1,1,1,1,NYSE
5164,16-02-2021 14:00,24 hrs.,wallstreetbets,GPORQ,7,0,7,-7,1,1,1,1,OTC
5164,16-02-2021 14:00,24 hrs.,wallstreetbets,HITIF,15,8,7,1,2,2,3,2,OTC
5164,16-02-2021 14:00,24 hrs.,wallstreetbets,HRVSF,7,0,7,-7,1,1,1,1,OTC
5164,16-02-2021 14:00,24 hrs.,wallstreetbets,LKNCY,6,6,0,6,1,1,0,1,OTC
5164,16-02-2021 14:00,24 hrs.,wallstreetbets,LYSCF,6,6,0,6,1,1,0,1,OTC
5164,16-02-2021 14:00,24 hrs.,wallstreetbets,MYCOF,6,0,6,-6,1,1,0,1,OTC
5164,16-02-2021 14:00,24 hrs.,wallstreetbets,PLNHF,7,7,0,7,1,1,1,1,OTC
5164,16-02-2021 14:00,24 hrs.,wallstreetbets,PONGF,21,7,14,-7,3,3,3,3,OTC
5164,16-02-2021 14:00,24 hrs.,wallstreetbets,REZZF,6,0,6,-6,1,1,0,1,OTC
5164,16-02-2021 14:00,24 hrs.,wallstreetbets,RYCEY,18,12,6,6,3,3,0,2,OTC
5164,16-02-2021 14:00,24 hrs.,wallstreetbets,SPRWF,13,0,13,-13,2,2,1,2,OTC
5164,16-02-2021 14:00,24 hrs.,wallstreetbets,VYGVF,7,0,7,-7,1,1,1,1,OTC
5164,16-02-2021 14:00,24 hrs.,wallstreetbets,HCM,6,0,6,-6,1,1,0,1,NASDAQ
5164,16-02-2021 14:00,24 hrs.,wallstreetbets,INO,7,7,0,7,1,1,1,1,NASDAQ
5164,16-02-2021 14:00,24 hrs.,wallstreetbets,MWK,7,0,7,-7,1,1,1,1,NASDAQ
5164,16-02-2021 14:00,24 hrs.,wallstreetbets,OGI,20,14,6,8,3,3,2,3,NASDAQ
5164,16-02-2021 14:00,24 hrs.,wallstreetbets,OPK,7,0,7,-7,1,1,1,1,NASDAQ
5164,16-02-2021 14:00,24 hrs.,wallstreetbets,PTE,7,0,7,-7,1,1,1,1,NASDAQ
5164,16-02-2021 14:00,24 hrs.,wallstreetbets,VRA,14,7,7,0,2,2,2,2,NASDAQ
5164,16-02-2021 14:00,24 hrs.,wallstreetbets,AACQ,7,0,7,-7,1,1,1,1,NASDAQ
5164,16-02-2021 14:00,24 hrs.,wallstreetbets,AAPL,6,6,0,6,1,1,0,1,NASDAQ
5164,16-02-2021 14:00,24 hrs.,wallstreetbets,ACRX,7,0,7,-7,1,1,1,1,NASDAQ
5164,16-02-2021 14:00,24 hrs.,wallstreetbets,ACST,7,7,0,7,1,1,1,1,NASDAQ
5164,16-02-2021 14:00,24 hrs.,wallstreetbets,ADMP,8,8,0,8,1,1,2,1,NASDAQ
5164,16-02-2021 14:00,24 hrs.,wallstreetbets,AEZS,6,0,6,-6,1,1,0,1,NASDAQ
5164,16-02-2021 14:00,24 hrs.,wallstreetbets,AKAM,7,0,7,-7,1,1,1,1,NASDAQ
5164,16-02-2021 14:00,24 hrs.,wallstreetbets,AMTX,7,7,0,7,1,1,1,1,NASDAQ
5164,16-02-2021 14:00,24 hrs.,wallstreetbets,AMZN,7,0,7,-7,1,1,1,1,NASDAQ
5164,16-02-2021 14:00,24 hrs.,wallstreetbets,APHA,39,33,6,27,5,4,11,5,NASDAQ
5164,16-02-2021 14:00,24 hrs.,wallstreetbets,ARTL,6,0,6,-6,1,1,0,1,NASDAQ
5164,16-02-2021 14:00,24 hrs.,wallstreetbets,ASRT,7,0,7,-7,1,1,1,1,NASDAQ
5164,16-02-2021 14:00,24 hrs.,wallstreetbets,ATOM,7,0,7,-7,1,1,1,1,NASDAQ
5164,16-02-2021 14:00,24 hrs.,wallstreetbets,AYTU,8,8,0,8,1,1,2,1,NASDAQ
5164,16-02-2021 14:00,24 hrs.,wallstreetbets,BAND,6,0,6,-6,1,1,0,1,NASDAQ
5164,16-02-2021 14:00,24 hrs.,wallstreetbets,BIOL,7,7,0,7,1,1,1,1,NASDAQ
5164,16-02-2021 14:00,24 hrs.,wallstreetbets,BNGO,34,0,34,-34,5,5,4,5,NASDAQ
5164,16-02-2021 14:00,24 hrs.,wallstreetbets,BXRX,14,0,14,-14,2,2,2,2,NASDAQ
5164,16-02-2021 14:00,24 hrs.,wallstreetbets,CMPS,14,14,0,14,2,2,2,1,NASDAQ
5164,16-02-2021 14:00,24 hrs.,wallstreetbets,CRBP,7,7,0,7,1,1,1,1,NASDAQ
5164,16-02-2021 14:00,24 hrs.,wallstreetbets,CRIS,6,6,0,6,1,1,0,1,NASDAQ
5164,16-02-2021 14:00,24 hrs.,wallstreetbets,CRSR,20,8,12,-4,3,3,2,3,NASDAQ
5164,16-02-2021 14:00,24 hrs.,wallstreetbets,CSTR,7,0,7,-7,1,1,1,1,NASDAQ
5164,16-02-2021 14:00,24 hrs.,wallstreetbets,CTRM,17,12,5,7,3,2,1,3,NASDAQ
5164,16-02-2021 14:00,24 hrs.,wallstreetbets,XPEV,6,6,0,6,1,1,0,1,NYSE
5164,16-02-2021 14:00,24 hrs.,wallstreetbets,AAL,14,14,0,14,2,2,2,2,NASDAQ
5164,16-02-2021 14:00,24 hrs.,wallstreetbets,DCF,888,0,888,-888,1,374,136,1,NYSE
5164,16-02-2021 14:00,24 hrs.,wallstreetbets,DGX,167,167,0,167,1,66,31,1,NYSE
5164,16-02-2021 14:00,24 hrs.,wallstreetbets,DIS,6,6,0,6,1,1,0,1,NYSE
5164,16-02-2021 14:00,24 hrs.,wallstreetbets,DOW,6,0,6,-6,1,1,0,1,NYSE
5164,16-02-2021 14:00,24 hrs.,wallstreetbets,EFT,15,15,0,15,1,2,7,1,NYSE
5164,16-02-2021 14:00,24 hrs.,wallstreetbets,FCX,186,186,0,186,1,75,32,1,NYSE
5164,16-02-2021 14:00,24 hrs.,wallstreetbets,FNV,186,186,0,186,1,75,32,1,NYSE
5164,16-02-2021 14:00,24 hrs.,wallstreetbets,FSR,231,231,0,231,3,59,101,3,NYSE
5164,16-02-2021 14:00,24 hrs.,wallstreetbets,GEO,20,0,20,-20,3,3,2,1,NYSE
5164,16-02-2021 14:00,24 hrs.,wallstreetbets,GME,32641,22898,9743,13155,147,14661,2731,116,NYSE
5164,16-02-2021 14:00,24 hrs.,wallstreetbets,IAG,7,7,0,7,1,1,1,1,NYSE
5164,16-02-2021 14:00,24 hrs.,wallstreetbets,IBM,7,0,7,-7,1,1,1,1,NYSE
5164,16-02-2021 14:00,24 hrs.,wallstreetbets,IVR,10,10,0,10,1,2,2,1,NYSE
5164,16-02-2021 14:00,24 hrs.,wallstreetbets,JPM,90,0,90,-90,1,0,86,1,NYSE
5164,16-02-2021 14:00,24 hrs.,wallstreetbets,LAC,13,0,13,-13,2,2,1,2,NYSE
5164,16-02-2021 14:00,24 hrs.,wallstreetbets,LOW,6,0,6,-6,1,1,0,1,NYSE
5164,16-02-2021 14:00,24 hrs.,wallstreetbets,LTC,13,6,7,-1,2,2,1,2,NYSE
5164,16-02-2021 14:00,24 hrs.,wallstreetbets,LYV,6,0,6,-6,1,1,0,1,NYSE
5164,16-02-2021 14:00,24 hrs.,wallstreetbets,MLM,8,0,8,-8,1,2,0,1,NYSE
5164,16-02-2021 14:00,24 hrs.,wallstreetbets,MRK,6,6,0,6,1,1,0,1,NYSE
5164,16-02-2021 14:00,24 hrs.,wallstreetbets,MSM,3168,0,3168,-3168,1,1485,194,1,NYSE
5164,16-02-2021 14:00,24 hrs.,wallstreetbets,NAT,6,0,6,-6,1,1,0,1,NYSE
5164,16-02-2021 14:00,24 hrs.,wallstreetbets,NIO,241,0,241,-241,2,74,85,2,NYSE
5164,16-02-2021 14:00,24 hrs.,wallstreetbets,NOK,35,15,20,-5,5,5,5,5,NYSE
5164,16-02-2021 14:00,24 hrs.,wallstreetbets,NYC,6,6,0,6,1,1,0,1,NYSE
5164,16-02-2021 14:00,24 hrs.,wallstreetbets,PBF,7,0,7,-7,1,1,1,1,NYSE
5164,16-02-2021 14:00,24 hrs.,wallstreetbets,PFE,7,0,7,-7,1,1,1,1,NYSE
5164,16-02-2021 14:00,24 hrs.,wallstreetbets,PMO,14,14,0,14,2,2,2,1,NYSE
5164,16-02-2021 14:00,24 hrs.,wallstreetbets,PSA,7,0,7,-7,1,1,1,1,NYSE
5164,16-02-2021 14:00,24 hrs.,wallstreetbets,RBC,52,0,52,-52,1,19,10,1,NYSE
5164,16-02-2021 14:00,24 hrs.,wallstreetbets,RFP,7,0,7,-7,1,1,1,1,NYSE
5164,16-02-2021 14:00,24 hrs.,RobinHoodPennyStocks,SRMX,16,0,16,-16,1,0,12,1,OTC
5164,16-02-2021 14:00,24 hrs.,RobinHoodPennyStocks,VPER,6,0,6,-6,1,1,0,1,OTC
5164,16-02-2021 14:00,24 hrs.,RobinHoodPennyStocks,BDRBF,6,0,6,-6,1,1,0,1,OTC
5164,16-02-2021 14:00,24 hrs.,RobinHoodPennyStocks,NMGRF,6,6,0,6,1,1,0,1,OTC
5164,16-02-2021 14:00,24 hrs.,RobinHoodPennyStocks,OTIVF,6,0,6,-6,1,1,0,1,OTC
5164,16-02-2021 14:00,24 hrs.,RobinHoodPennyStocks,CEI,127,127,0,127,1,52,19,1,AMEX
5164,16-02-2021 14:00,24 hrs.,RobinHoodPennyStocks,DNN,684,0,684,-684,2,209,258,2,AMEX
5164,16-02-2021 14:00,24 hrs.,RobinHoodPennyStocks,DPW,127,127,0,127,1,52,19,1,AMEX
5164,16-02-2021 14:00,24 hrs.,RobinHoodPennyStocks,GTE,983,248,735,-487,6,323,313,5,AMEX
5164,16-02-2021 14:00,24 hrs.,RobinHoodPennyStocks,IGC,127,127,0,127,1,52,19,1,AMEX
5164,16-02-2021 14:00,24 hrs.,RobinHoodPennyStocks,ITP,12,12,0,12,2,2,0,1,AMEX
5164,16-02-2021 14:00,24 hrs.,wallstreetbets,NEPT,7,0,7,-7,1,1,1,1,NASDAQ
5164,16-02-2021 14:00,24 hrs.,wallstreetbets,DFFN,7,7,0,7,1,1,1,1,NASDAQ
5164,16-02-2021 14:00,24 hrs.,wallstreetbets,DMTK,7,7,0,7,1,1,1,1,NASDAQ
5164,16-02-2021 14:00,24 hrs.,wallstreetbets,EDIT,2613,0,2613,-2613,2,1052,501,2,NASDAQ
5164,16-02-2021 14:00,24 hrs.,wallstreetbets,ETSY,7,0,7,-7,1,1,1,1,NASDAQ
5164,16-02-2021 14:00,24 hrs.,wallstreetbets,EVER,122,0,122,-122,1,49,20,1,NASDAQ
5164,16-02-2021 14:00,24 hrs.,wallstreetbets,EVFM,6,0,6,-6,1,1,0,1,NASDAQ
5164,16-02-2021 14:00,24 hrs.,wallstreetbets,EXPI,7,7,0,7,1,1,1,1,NASDAQ
5164,16-02-2021 14:00,24 hrs.,wallstreetbets,FANG,7,0,7,-7,1,1,1,1,NASDAQ
5164,16-02-2021 14:00,24 hrs.,wallstreetbets,FARM,6,0,6,-6,1,1,0,1,NASDAQ
5164,16-02-2021 14:00,24 hrs.,wallstreetbets,FCEL,6,6,0,6,1,1,0,1,NASDAQ
5164,16-02-2021 14:00,24 hrs.,wallstreetbets,FIII,5,0,5,-5,1,0,1,1,NASDAQ
5164,16-02-2021 14:00,24 hrs.,wallstreetbets,FLDM,7,7,0,7,1,1,1,1,NASDAQ
5164,16-02-2021 14:00,24 hrs.,wallstreetbets,FORM,29665,29665,0,29665,1,13773,2115,1,NASDAQ
5164,16-02-2021 14:00,24 hrs.,wallstreetbets,GLBS,7,0,7,-7,1,1,1,1,NASDAQ
5164,16-02-2021 14:00,24 hrs.,wallstreetbets,GNUS,19,0,19,-19,3,3,1,2,NASDAQ
5164,16-02-2021 14:00,24 hrs.,wallstreetbets,GOEV,20,14,6,8,3,3,2,2,NASDAQ
5164,16-02-2021 14:00,24 hrs.,wallstreetbets,GOLD,21,7,14,-7,3,3,3,3,NASDAQ
5164,16-02-2021 14:00,24 hrs.,wallstreetbets,GOOG,7,7,0,7,1,1,1,1,NASDAQ
5164,16-02-2021 14:00,24 hrs.,wallstreetbets,GRFS,7,0,7,-7,1,1,1,1,NASDAQ
5164,16-02-2021 14:00,24 hrs.,wallstreetbets,GTHX,7,7,0,7,1,1,1,1,NASDAQ
5164,16-02-2021 14:00,24 hrs.,wallstreetbets,HDSN,6,6,0,6,1,1,0,1,NASDAQ
5164,16-02-2021 14:00,24 hrs.,wallstreetbets,HJLI,7,0,7,-7,1,1,1,1,NASDAQ
5164,16-02-2021 14:00,24 hrs.,wallstreetbets,IBKR,29665,29665,0,29665,1,13773,2115,1,NASDAQ
5164,16-02-2021 14:00,24 hrs.,wallstreetbets,IDEX,14,7,7,0,2,2,2,2,NASDAQ
5164,16-02-2021 14:00,24 hrs.,wallstreetbets,IMGN,7,0,7,-7,1,1,1,1,NASDAQ
5164,16-02-2021 14:00,24 hrs.,wallstreetbets,IMMR,14,0,14,-14,2,2,2,1,NASDAQ
5164,16-02-2021 14:00,24 hrs.,wallstreetbets,INPX,7,7,0,7,1,1,1,1,NASDAQ
5164,16-02-2021 14:00,24 hrs.,wallstreetbets,ITRM,6,0,6,-6,1,1,0,1,NASDAQ
5164,16-02-2021 14:00,24 hrs.,wallstreetbets,JACK,7,0,7,-7,1,1,1,1,NASDAQ
5164,16-02-2021 14:00,24 hrs.,wallstreetbets,JNCE,6,0,6,-6,1,1,0,1,NASDAQ
5164,16-02-2021 14:00,24 hrs.,wallstreetbets,KTOS,14,7,7,0,2,2,2,2,NASDAQ
5164,16-02-2021 14:00,24 hrs.,wallstreetbets,LKCO,6,6,0,6,1,1,0,1,NASDAQ
5164,16-02-2021 14:00,24 hrs.,wallstreetbets,LOAC,6,0,6,-6,1,1,0,1,NASDAQ
5164,16-02-2021 14:00,24 hrs.,wallstreetbets,LPCN,14,0,14,-14,2,2,2,1,NASDAQ
5164,16-02-2021 14:00,24 hrs.,wallstreetbets,MARA,33,0,33,-33,4,4,9,3,NASDAQ
5164,16-02-2021 14:00,24 hrs.,wallstreetbets,MBRX,7,0,7,-7,1,1,1,1,NASDAQ
5164,16-02-2021 14:00,24 hrs.,wallstreetbets,MRNA,13,13,0,13,2,2,1,1,NASDAQ
5164,16-02-2021 14:00,24 hrs.,wallstreetbets,MSFT,7,0,7,-7,1,1,1,1,NASDAQ
5164,16-02-2021 14:00,24 hrs.,wallstreetbets,MSTR,6,6,0,6,1,1,0,1,NASDAQ
5164,16-02-2021 14:00,24 hrs.,wallstreetbets,MTCH,7,0,7,-7,1,1,1,1,NASDAQ
5164,16-02-2021 14:00,24 hrs.,wallstreetbets,MVIS,14,7,7,0,2,2,2,2,NASDAQ
5164,16-02-2021 14:00,24 hrs.,wallstreetbets,NAKD,34,21,13,8,5,5,4,4,NASDAQ
5164,16-02-2021 14:00,24 hrs.,wallstreetbets,AEP,14,0,14,-14,2,2,2,1,NASDAQ
5164,16-02-2021 14:00,24 hrs.,wallstreetbets,AMD,677,670,7,663,4,286,89,4,NASDAQ
5164,16-02-2021 14:00,24 hrs.,wallstreetbets,APA,237,237,0,237,1,92,49,1,NASDAQ
5164,16-02-2021 14:00,24 hrs.,wallstreetbets,AVO,7,0,7,-7,1,1,1,1,NASDAQ
5164,16-02-2021 14:00,24 hrs.,wallstreetbets,AZN,21,21,0,21,3,3,3,1,NASDAQ
5164,16-02-2021 14:00,24 hrs.,wallstreetbets,CDC,41,41,0,41,1,0,37,1,NASDAQ
5164,16-02-2021 14:00,24 hrs.,wallstreetbets,CGC,13,7,6,1,2,2,1,2,NASDAQ
5164,16-02-2021 14:00,24 hrs.,wallstreetbets,DBX,7,7,0,7,1,1,1,1,NASDAQ
5164,16-02-2021 14:00,24 hrs.,wallstreetbets,GSM,13,0,13,-13,2,2,1,2,NASDAQ
5164,16-02-2021 14:00,24 hrs.,wallstreetbets,HAS,5185,0,5185,-5185,2,2284,609,2,NASDAQ
5164,16-02-2021 14:00,24 hrs.,RobinHoodPennyStocks,ENSV,127,127,0,127,1,52,19,1,AMEX
5164,16-02-2021 14:00,24 hrs.,RobinHoodPennyStocks,GSAT,127,127,0,127,1,52,19,1,AMEX
5164,16-02-2021 14:00,24 hrs.,RobinHoodPennyStocks,HUSA,127,127,0,127,1,52,19,1,AMEX
5164,16-02-2021 14:00,24 hrs.,RobinHoodPennyStocks,INUV,18,0,18,-18,3,3,0,2,AMEX
5164,16-02-2021 14:00,24 hrs.,RobinHoodPennyStocks,SNMP,127,127,0,127,1,52,19,1,AMEX
5164,16-02-2021 14:00,24 hrs.,RobinHoodPennyStocks,TMBR,23,23,0,23,1,6,7,1,AMEX
5164,16-02-2021 14:00,24 hrs.,RobinHoodPennyStocks,TRXC,6,6,0,6,1,1,0,1,AMEX
5164,16-02-2021 14:00,24 hrs.,RobinHoodPennyStocks,UAVS,6,0,6,-6,1,1,0,1,AMEX
5164,16-02-2021 14:00,24 hrs.,RobinHoodPennyStocks,ACB,127,127,0,127,1,52,19,1,NYSE
5164,16-02-2021 14:00,24 hrs.,RobinHoodPennyStocks,AMC,6,6,0,6,1,0,2,1,NYSE
5164,16-02-2021 14:00,24 hrs.,RobinHoodPennyStocks,AUY,6,0,6,-6,1,1,0,1,NYSE
5164,16-02-2021 14:00,24 hrs.,wallstreetbets,NGAC,13,13,0,13,2,2,1,1,NASDAQ
5164,16-02-2021 14:00,24 hrs.,wallstreetbets,NKLA,7,0,7,-7,1,1,1,1,NASDAQ
5164,16-02-2021 14:00,24 hrs.,wallstreetbets,NMRK,111,0,111,-111,1,33,41,1,NASDAQ
5164,16-02-2021 14:00,24 hrs.,wallstreetbets,NNDM,6,0,6,-6,1,1,0,1,NASDAQ
5164,16-02-2021 14:00,24 hrs.,wallstreetbets,NVAX,22,13,9,4,3,3,4,2,NASDAQ
5164,16-02-2021 14:00,24 hrs.,wallstreetbets,NVDA,39,0,39,-39,1,0,35,1,NASDAQ
5164,16-02-2021 14:00,24 hrs.,wallstreetbets,OCGN,48,34,14,20,7,7,6,5,NASDAQ
5164,16-02-2021 14:00,24 hrs.,wallstreetbets,OIIM,7,0,7,-7,1,1,1,1,NASDAQ
5164,16-02-2021 14:00,24 hrs.,wallstreetbets,OSTK,16,0,16,-16,2,3,2,1,NASDAQ
5164,16-02-2021 14:00,24 hrs.,wallstreetbets,PLAY,7,7,0,7,1,1,1,1,NASDAQ
5164,16-02-2021 14:00,24 hrs.,wallstreetbets,PLUG,13,6,7,-1,2,2,1,2,NASDAQ
5164,16-02-2021 14:00,24 hrs.,wallstreetbets,POWW,13,6,7,-1,2,2,1,2,NASDAQ
5164,16-02-2021 14:00,24 hrs.,wallstreetbets,PSEC,6,0,6,-6,1,1,0,1,NASDAQ
5164,16-02-2021 14:00,24 hrs.,wallstreetbets,PYPL,13,6,7,-1,2,2,1,2,NASDAQ
5164,16-02-2021 14:00,24 hrs.,wallstreetbets,QLGN,6,0,6,-6,1,1,0,1,NASDAQ
5164,16-02-2021 14:00,24 hrs.,wallstreetbets,RAVE,6,0,6,-6,1,1,0,1,NASDAQ
5164,16-02-2021 14:00,24 hrs.,wallstreetbets,RIOT,33,0,33,-33,4,4,9,3,NASDAQ
5164,16-02-2021 14:00,24 hrs.,wallstreetbets,ROOT,7,0,7,-7,1,1,1,1,NASDAQ
5164,16-02-2021 14:00,24 hrs.,wallstreetbets,SAVA,12,0,12,-12,2,2,0,1,NASDAQ
5164,16-02-2021 14:00,24 hrs.,wallstreetbets,SAVE,14,7,7,0,2,2,2,2,NASDAQ
5164,16-02-2021 14:00,24 hrs.,wallstreetbets,SESN,6,0,6,-6,1,1,0,1,NASDAQ
5164,16-02-2021 14:00,24 hrs.,wallstreetbets,SNDL,685,61,624,-563,24,142,305,21,NASDAQ
5164,16-02-2021 14:00,24 hrs.,wallstreetbets,SOLO,7,7,0,7,1,1,1,1,NASDAQ
5164,16-02-2021 14:00,24 hrs.,wallstreetbets,SONO,7,0,7,-7,1,1,1,1,NASDAQ
5164,16-02-2021 14:00,24 hrs.,wallstreetbets,SPWR,12,12,0,12,2,2,0,2,NASDAQ
5164,16-02-2021 14:00,24 hrs.,wallstreetbets,SRNE,14,0,14,-14,2,2,2,1,NASDAQ
5164,16-02-2021 14:00,24 hrs.,wallstreetbets,STLD,888,0,888,-888,1,374,136,1,NASDAQ
5164,16-02-2021 14:00,24 hrs.,wallstreetbets,SYBX,6,6,0,6,1,1,0,1,NASDAQ
5164,16-02-2021 14:00,24 hrs.,wallstreetbets,TACO,7,0,7,-7,1,1,1,1,NASDAQ
5164,16-02-2021 14:00,24 hrs.,wallstreetbets,TELL,12,0,12,-12,2,2,0,2,NASDAQ
5164,16-02-2021 14:00,24 hrs.,wallstreetbets,THCB,7,7,0,7,1,1,1,1,NASDAQ
5164,16-02-2021 14:00,24 hrs.,wallstreetbets,TLGT,7,0,7,-7,1,1,1,1,NASDAQ
5164,16-02-2021 14:00,24 hrs.,wallstreetbets,TLRY,271,250,21,229,11,82,63,10,NASDAQ
5164,16-02-2021 14:00,24 hrs.,wallstreetbets,TNXP,22,7,15,-8,3,3,4,3,NASDAQ
5164,16-02-2021 14:00,24 hrs.,wallstreetbets,TOPS,136,7,129,-122,3,51,22,3,NASDAQ
5164,16-02-2021 14:00,24 hrs.,wallstreetbets,TRIT,14,14,0,14,2,2,2,2,NASDAQ
5164,16-02-2021 14:00,24 hrs.,wallstreetbets,TRVG,14,0,14,-14,2,2,2,2,NASDAQ
5164,16-02-2021 14:00,24 hrs.,wallstreetbets,TSLA,32,5,27,-22,5,4,4,4,NASDAQ
5164,16-02-2021 14:00,24 hrs.,wallstreetbets,TTCF,7,0,7,-7,1,1,1,1,NASDAQ
5164,16-02-2021 14:00,24 hrs.,wallstreetbets,TXMD,16,9,7,2,2,3,2,2,NASDAQ
5164,16-02-2021 14:00,24 hrs.,wallstreetbets,VBIV,5,5,0,5,1,0,1,1,NASDAQ
5164,16-02-2021 14:00,24 hrs.,wallstreetbets,VKTX,7,7,0,7,1,1,1,1,NASDAQ
5164,16-02-2021 14:00,24 hrs.,wallstreetbets,VXRT,7,7,0,7,1,1,1,1,NASDAQ
5164,16-02-2021 14:00,24 hrs.,wallstreetbets,VYNE,7,7,0,7,1,1,1,1,NASDAQ
5164,16-02-2021 14:00,24 hrs.,wallstreetbets,WATT,6,0,6,-6,1,1,0,1,NASDAQ
5164,16-02-2021 14:00,24 hrs.,wallstreetbets,XNET,7,0,7,-7,1,1,1,1,NASDAQ
5164,16-02-2021 14:00,24 hrs.,wallstreetbets,XSPA,45,6,39,-33,7,7,3,5,NASDAQ
5164,16-02-2021 14:00,24 hrs.,wallstreetbets,ZYNE,14,7,7,0,2,2,2,2,NASDAQ
5164,16-02-2021 14:00,24 hrs.,wallstreetbets,GOOGL,6,6,0,6,1,1,0,1,NASDAQ
5164,16-02-2021 14:00,24 hrs.,RobinHoodPennyStocks,ABWN,6,0,6,-6,1,1,0,1,OTC
5164,16-02-2021 14:00,24 hrs.,RobinHoodPennyStocks,ALPP,12,0,12,-12,2,2,0,1,OTC
5164,16-02-2021 14:00,24 hrs.,RobinHoodPennyStocks,HCMC,6,6,0,6,1,1,0,1,OTC
5164,16-02-2021 14:00,24 hrs.,RobinHoodPennyStocks,RVBR,6,0,6,-6,1,1,0,1,OTC
5164,16-02-2021 14:00,24 hrs.,RobinHoodPennyStocks,ARTL,127,127,0,127,1,52,19,1,NASDAQ
5164,16-02-2021 14:00,24 hrs.,RobinHoodPennyStocks,ASRT,824,0,824,-824,3,251,310,3,NASDAQ
5164,16-02-2021 14:00,24 hrs.,RobinHoodPennyStocks,ASRV,60,0,60,-60,1,21,14,1,NASDAQ
5164,16-02-2021 14:00,24 hrs.,RobinHoodPennyStocks,ATOS,23,23,0,23,1,6,7,1,NASDAQ
5164,16-02-2021 14:00,24 hrs.,RobinHoodPennyStocks,BEAT,21,21,0,21,1,8,1,1,NASDAQ
5164,16-02-2021 14:00,24 hrs.,RobinHoodPennyStocks,BNGO,127,127,0,127,1,52,19,1,NASDAQ
5164,16-02-2021 14:00,24 hrs.,RobinHoodPennyStocks,BOXL,127,127,0,127,1,52,19,1,NASDAQ
5164,16-02-2021 14:00,24 hrs.,RobinHoodPennyStocks,BRQS,127,127,0,127,1,52,19,1,NASDAQ
5164,16-02-2021 14:00,24 hrs.,RobinHoodPennyStocks,BYFC,127,127,0,127,1,52,19,1,NASDAQ
5164,16-02-2021 14:00,24 hrs.,RobinHoodPennyStocks,CARV,127,127,0,127,1,52,19,1,NASDAQ
5164,16-02-2021 14:00,24 hrs.,RobinHoodPennyStocks,CBAT,127,127,0,127,1,52,19,1,NASDAQ
5164,16-02-2021 14:00,24 hrs.,RobinHoodPennyStocks,CCNC,127,127,0,127,1,52,19,1,NASDAQ
5164,16-02-2021 14:00,24 hrs.,RobinHoodPennyStocks,CIDM,676,0,676,-676,1,207,258,1,NASDAQ
5164,16-02-2021 14:00,24 hrs.,RobinHoodPennyStocks,CLEU,127,127,0,127,1,52,19,1,NASDAQ
5164,16-02-2021 14:00,24 hrs.,RobinHoodPennyStocks,CLSK,127,127,0,127,1,52,19,1,NASDAQ
5164,16-02-2021 14:00,24 hrs.,RobinHoodPennyStocks,CRBP,676,0,676,-676,1,207,258,1,NASDAQ
5164,16-02-2021 14:00,24 hrs.,RobinHoodPennyStocks,CRON,127,127,0,127,1,52,19,1,NASDAQ
5164,16-02-2021 14:00,24 hrs.,RobinHoodPennyStocks,DFFN,976,23,953,-930,4,284,392,4,NASDAQ
5164,16-02-2021 14:00,24 hrs.,RobinHoodPennyStocks,DZSI,127,127,0,127,1,52,19,1,NASDAQ
5164,16-02-2021 14:00,24 hrs.,RobinHoodPennyStocks,EBON,127,127,0,127,1,52,19,1,NASDAQ
5164,16-02-2021 14:00,24 hrs.,RobinHoodPennyStocks,EDRY,127,127,0,127,1,52,19,1,NASDAQ
5164,16-02-2021 14:00,24 hrs.,RobinHoodPennyStocks,EOLS,12,12,0,12,1,4,0,1,NASDAQ
5164,16-02-2021 14:00,24 hrs.,RobinHoodPennyStocks,EPSN,127,127,0,127,1,52,19,1,NASDAQ
5164,16-02-2021 14:00,24 hrs.,RobinHoodPennyStocks,EQOS,127,127,0,127,1,52,19,1,NASDAQ
5164,16-02-2021 14:00,24 hrs.,RobinHoodPennyStocks,FAMI,127,127,0,127,1,52,19,1,NASDAQ
5164,16-02-2021 14:00,24 hrs.,RobinHoodPennyStocks,FCEL,127,127,0,127,1,52,19,1,NASDAQ
5164,16-02-2021 14:00,24 hrs.,RobinHoodPennyStocks,FORD,127,127,0,127,1,52,19,1,NASDAQ
5164,16-02-2021 14:00,24 hrs.,RobinHoodPennyStocks,GTHX,127,127,0,127,1,52,19,1,NASDAQ
5164,16-02-2021 14:00,24 hrs.,RobinHoodPennyStocks,HGEN,127,127,0,127,1,52,19,1,NASDAQ
5164,16-02-2021 14:00,24 hrs.,RobinHoodPennyStocks,HNRG,127,127,0,127,1,52,19,1,NASDAQ
5164,16-02-2021 14:00,24 hrs.,RobinHoodPennyStocks,IDEX,139,139,0,139,3,54,19,3,NASDAQ
5164,16-02-2021 14:00,24 hrs.,RobinHoodPennyStocks,BTU,127,127,0,127,1,52,19,1,NYSE
5164,16-02-2021 14:00,24 hrs.,RobinHoodPennyStocks,DSX,127,127,0,127,1,52,19,1,NYSE
5164,16-02-2021 14:00,24 hrs.,RobinHoodPennyStocks,GGB,6,0,6,-6,1,1,0,1,NYSE
5164,16-02-2021 14:00,24 hrs.,RobinHoodPennyStocks,GME,6,6,0,6,1,1,0,1,NYSE
5164,16-02-2021 14:00,24 hrs.,RobinHoodPennyStocks,HGV,127,127,0,127,1,52,19,1,NYSE
5164,16-02-2021 14:00,24 hrs.,RobinHoodPennyStocks,HMI,127,127,0,127,1,52,19,1,NYSE
5164,16-02-2021 14:00,24 hrs.,RobinHoodPennyStocks,NOK,41,35,6,29,2,10,13,2,NYSE
5164,16-02-2021 14:00,24 hrs.,RobinHoodPennyStocks,PBR,6,0,6,-6,1,1,0,1,NYSE
5164,16-02-2021 14:00,24 hrs.,RobinHoodPennyStocks,PEG,6,0,6,-6,1,1,0,1,NYSE
5164,16-02-2021 14:00,24 hrs.,RobinHoodPennyStocks,PVL,127,127,0,127,1,52,19,1,NYSE
5164,16-02-2021 14:00,24 hrs.,RobinHoodPennyStocks,SIX,127,127,0,127,1,52,19,1,NYSE
5164,16-02-2021 14:00,24 hrs.,RobinHoodPennyStocks,SOS,222,157,65,92,6,69,60,6,NYSE
5164,16-02-2021 14:00,24 hrs.,RobinHoodPennyStocks,TSM,189,0,189,-189,1,48,89,1,NYSE
5164,16-02-2021 14:00,24 hrs.,RobinHoodPennyStocks,VHC,7,0,7,-7,1,1,1,1,NYSE
5164,16-02-2021 14:00,24 hrs.,RobinHoodPennyStocks,VST,127,127,0,127,1,52,19,1,NYSE
5164,16-02-2021 14:00,24 hrs.,RobinHoodPennyStocks,ARCH,127,127,0,127,1,52,19,1,NYSE
5164,16-02-2021 14:00,24 hrs.,RobinHoodPennyStocks,CCIV,12,12,0,12,2,2,0,1,NYSE
5164,16-02-2021 14:00,24 hrs.,RobinHoodPennyStocks,CSPR,6,0,6,-6,1,1,0,1,NYSE
5164,16-02-2021 14:00,24 hrs.,RobinHoodPennyStocks,HEXO,127,127,0,127,1,52,19,1,NYSE
5164,16-02-2021 14:00,24 hrs.,RobinHoodPennyStocks,PLTR,12,12,0,12,2,2,0,2,NYSE
5164,16-02-2021 14:00,24 hrs.,RobinHoodPennyStocks,CFO,6,0,6,-6,1,1,0,1,NASDAQ
5164,16-02-2021 14:00,24 hrs.,RobinHoodPennyStocks,CGC,127,127,0,127,1,52,19,1,NASDAQ
5164,16-02-2021 14:00,24 hrs.,RobinHoodPennyStocks,ENG,127,127,0,127,1,52,19,1,NASDAQ
5164,16-02-2021 14:00,24 hrs.,RobinHoodPennyStocks,MGI,127,127,0,127,1,52,19,1,NASDAQ
5164,16-02-2021 14:00,24 hrs.,RobinHoodPennyStocks,OEG,133,133,0,133,2,53,19,2,NASDAQ
5164,16-02-2021 14:00,24 hrs.,RobinHoodPennyStocks,OGI,127,127,0,127,1,52,19,1,NASDAQ
5164,16-02-2021 14:00,24 hrs.,RobinHoodPennyStocks,PFC,6,0,6,-6,1,1,0,1,NASDAQ
5164,16-02-2021 14:00,24 hrs.,RobinHoodPennyStocks,PXS,676,0,676,-676,1,207,258,1,NASDAQ
5164,16-02-2021 14:00,24 hrs.,RobinHoodPennyStocks,NAK,6,0,6,-6,1,1,0,1,AMEX
5164,16-02-2021 14:00,24 hrs.,RobinHoodPennyStocks,PED,127,127,0,127,1,52,19,1,AMEX
5164,16-02-2021 14:00,24 hrs.,RobinHoodPennyStocks,PTN,676,0,676,-676,1,207,258,1,AMEX
5164,16-02-2021 14:00,24 hrs.,RobinHoodPennyStocks,REI,127,127,0,127,1,52,19,1,AMEX
5164,16-02-2021 14:00,24 hrs.,RobinHoodPennyStocks,ZOM,173,35,138,-103,3,54,53,3,AMEX
5164,16-02-2021 14:00,24 hrs.,RobinHoodPennyStocks,MOGO,127,127,0,127,1,52,19,1,NASDAQ
5164,16-02-2021 14:00,24 hrs.,RobinHoodPennyStocks,NAKD,162,162,0,162,2,61,32,2,NASDAQ
5164,16-02-2021 14:00,24 hrs.,RobinHoodPennyStocks,NOVN,127,127,0,127,1,52,19,1,NASDAQ
5164,16-02-2021 14:00,24 hrs.,RobinHoodPennyStocks,NVAX,127,127,0,127,1,52,19,1,NASDAQ
5164,16-02-2021 14:00,24 hrs.,RobinHoodPennyStocks,NVIV,6,0,6,-6,1,1,0,1,NASDAQ
5164,16-02-2021 14:00,24 hrs.,RobinHoodPennyStocks,NXTD,127,127,0,127,1,52,19,1,NASDAQ
5164,16-02-2021 14:00,24 hrs.,RobinHoodPennyStocks,OBSV,80,0,80,-80,3,32,4,2,NASDAQ
5164,16-02-2021 14:00,24 hrs.,RobinHoodPennyStocks,OCUL,127,127,0,127,1,52,19,1,NASDAQ
5164,16-02-2021 14:00,24 hrs.,RobinHoodPennyStocks,OPTT,127,127,0,127,1,52,19,1,NASDAQ
5164,16-02-2021 14:00,24 hrs.,RobinHoodPennyStocks,PECK,127,127,0,127,1,52,19,1,NASDAQ
5164,16-02-2021 14:00,24 hrs.,RobinHoodPennyStocks,PEIX,127,127,0,127,1,52,19,1,NASDAQ
5164,16-02-2021 14:00,24 hrs.,RobinHoodPennyStocks,PHIO,127,127,0,127,1,52,19,1,NASDAQ
5164,16-02-2021 14:00,24 hrs.,RobinHoodPennyStocks,PHUN,127,127,0,127,1,52,19,1,NASDAQ
5164,16-02-2021 14:00,24 hrs.,RobinHoodPennyStocks,PLUG,127,127,0,127,1,52,19,1,NASDAQ
5164,16-02-2021 14:00,24 hrs.,RobinHoodPennyStocks,PLYA,127,127,0,127,1,52,19,1,NASDAQ
5164,16-02-2021 14:00,24 hrs.,RobinHoodPennyStocks,POWW,51,0,51,-51,1,19,9,1,NASDAQ
5164,16-02-2021 14:00,24 hrs.,RobinHoodPennyStocks,PULM,6,0,6,-6,1,1,0,1,NASDAQ
5164,16-02-2021 14:00,24 hrs.,RobinHoodPennyStocks,RCON,127,127,0,127,1,52,19,1,NASDAQ
5164,16-02-2021 14:00,24 hrs.,RobinHoodPennyStocks,RIOT,153,127,26,101,2,61,23,2,NASDAQ
5164,16-02-2021 14:00,24 hrs.,RobinHoodPennyStocks,SALM,127,127,0,127,1,52,19,1,NASDAQ
5164,16-02-2021 14:00,24 hrs.,RobinHoodPennyStocks,SAVA,127,127,0,127,1,52,19,1,NASDAQ
5164,16-02-2021 14:00,24 hrs.,RobinHoodPennyStocks,SHIP,139,127,12,115,3,54,19,3,NASDAQ
5164,16-02-2021 14:00,24 hrs.,RobinHoodPennyStocks,SINO,127,127,0,127,1,52,19,1,NASDAQ
5164,16-02-2021 14:00,24 hrs.,RobinHoodPennyStocks,SIRI,6,0,6,-6,1,1,0,1,NASDAQ
5164,16-02-2021 14:00,24 hrs.,RobinHoodPennyStocks,SNDL,145,133,12,121,4,55,19,4,NASDAQ
5164,16-02-2021 14:00,24 hrs.,RobinHoodPennyStocks,SNGX,127,127,0,127,1,52,19,1,NASDAQ
5164,16-02-2021 14:00,24 hrs.,RobinHoodPennyStocks,STAY,127,127,0,127,1,52,19,1,NASDAQ
5164,16-02-2021 14:00,24 hrs.,RobinHoodPennyStocks,SUNW,127,127,0,127,1,52,19,1,NASDAQ
5164,16-02-2021 14:00,24 hrs.,RobinHoodPennyStocks,SYPR,127,127,0,127,1,52,19,1,NASDAQ
5164,16-02-2021 14:00,24 hrs.,RobinHoodPennyStocks,SYTA,127,127,0,127,1,52,19,1,NASDAQ
5164,16-02-2021 14:00,24 hrs.,RobinHoodPennyStocks,TANH,21,0,21,-21,1,5,7,1,NASDAQ
5164,16-02-2021 14:00,24 hrs.,RobinHoodPennyStocks,TLRY,133,133,0,133,2,53,19,2,NASDAQ
5164,16-02-2021 14:00,24 hrs.,RobinHoodPennyStocks,TNXP,737,23,714,-691,4,225,271,4,NASDAQ
5164,16-02-2021 14:00,24 hrs.,RobinHoodPennyStocks,TOPS,127,127,0,127,1,52,19,1,NASDAQ
5164,16-02-2021 14:00,24 hrs.,RobinHoodPennyStocks,TRCH,143,127,16,111,2,52,31,2,NASDAQ
5164,16-02-2021 14:00,24 hrs.,RobinHoodPennyStocks,TSLA,6,6,0,6,1,1,0,1,NASDAQ
5164,16-02-2021 14:00,24 hrs.,RobinHoodPennyStocks,TXMD,682,0,682,-682,2,208,258,2,NASDAQ
5164,16-02-2021 14:00,24 hrs.,RobinHoodPennyStocks,TYME,6,6,0,6,1,1,0,1,NASDAQ
5164,16-02-2021 14:00,24 hrs.,RobinHoodPennyStocks,UONE,127,127,0,127,1,52,19,1,NASDAQ
5164,16-02-2021 14:00,24 hrs.,RobinHoodPennyStocks,USEG,127,127,0,127,1,52,19,1,NASDAQ
5164,16-02-2021 14:00,24 hrs.,RobinHoodPennyStocks,USWS,127,127,0,127,1,52,19,1,NASDAQ
5164,16-02-2021 14:00,24 hrs.,RobinHoodPennyStocks,VBIV,10,10,0,10,1,0,6,1,NASDAQ
5164,16-02-2021 14:00,24 hrs.,RobinHoodPennyStocks,VERU,127,127,0,127,1,52,19,1,NASDAQ
5164,16-02-2021 14:00,24 hrs.,RobinHoodPennyStocks,WATT,127,127,0,127,1,52,19,1,NASDAQ
5164,16-02-2021 14:00,24 hrs.,RobinHoodPennyStocks,WKEY,127,127,0,127,1,52,19,1,NASDAQ
5164,16-02-2021 14:00,24 hrs.,RobinHoodPennyStocks,MARPS,127,127,0,127,1,52,19,1,NASDAQ
5164,16-02-2021 14:00,24 hrs.,RobinHoodPennyStocks,UONEK,127,127,0,127,1,52,19,1,NASDAQ
5164,16-02-2021 14:00,24 hrs.,RobinHoodPennyStocks,SPI,127,127,0,127,1,52,19,1,NASDAQ
5164,16-02-2021 14:00,24 hrs.,RobinHoodPennyStocks,TGA,127,127,0,127,1,52,19,1,NASDAQ
5164,16-02-2021 14:00,24 hrs.,RobinHoodPennyStocks,WNW,127,127,0,127,1,52,19,1,NASDAQ
5164,16-02-2021 14:00,24 hrs.,RobinHoodPennyStocks,WWR,133,127,6,121,2,53,19,2,NASDAQ
5164,16-02-2021 14:00,24 hrs.,RobinHoodPennyStocks,AACQ,127,127,0,127,1,52,19,1,NASDAQ
5164,16-02-2021 14:00,24 hrs.,RobinHoodPennyStocks,AAPL,127,127,0,127,1,52,19,1,NASDAQ
5164,16-02-2021 14:00,24 hrs.,RobinHoodPennyStocks,ABEO,676,0,676,-676,1,207,258,1,NASDAQ
5164,16-02-2021 14:00,24 hrs.,RobinHoodPennyStocks,ACST,676,0,676,-676,1,207,258,1,NASDAQ
5164,16-02-2021 14:00,24 hrs.,RobinHoodPennyStocks,ADXS,6,0,6,-6,1,1,0,1,NASDAQ
5164,16-02-2021 14:00,24 hrs.,RobinHoodPennyStocks,AGTC,2226,18,2208,-2190,6,993,216,5,NASDAQ
5164,16-02-2021 14:00,24 hrs.,RobinHoodPennyStocks,AIKI,127,127,0,127,1,52,19,1,NASDAQ
5164,16-02-2021 14:00,24 hrs.,RobinHoodPennyStocks,ALAC,127,127,0,127,1,52,19,1,NASDAQ
5164,16-02-2021 14:00,24 hrs.,RobinHoodPennyStocks,ALJJ,127,127,0,127,1,52,19,1,NASDAQ
5164,16-02-2021 14:00,24 hrs.,RobinHoodPennyStocks,AMTX,127,127,0,127,1,52,19,1,NASDAQ
5164,16-02-2021 14:00,24 hrs.,RobinHoodPennyStocks,AMZN,6,0,6,-6,1,1,0,1,NASDAQ
5164,16-02-2021 14:00,24 hrs.,RobinHoodPennyStocks,APHA,133,133,0,133,2,53,19,2,NASDAQ
5164,16-02-2021 14:00,24 hrs.,RobinHoodPennyStocks,ARLP,127,127,0,127,1,52,19,1,NASDAQ
5164,16-02-2021 14:00,24 hrs.,stocks,ROTH,16,0,16,-16,1,6,0,1,OTC
5164,16-02-2021 14:00,24 hrs.,stocks,SGMD,6,0,6,-6,1,1,0,1,OTC
5164,16-02-2021 14:00,24 hrs.,stocks,USPS,139,0,139,-139,1,52,31,1,OTC
5164,16-02-2021 14:00,24 hrs.,stocks,HVBTF,6,0,6,-6,1,1,0,1,OTC
5164,16-02-2021 14:00,24 hrs.,stocks,LMRMF,6,0,6,-6,1,1,0,1,OTC
5164,16-02-2021 14:00,24 hrs.,stocks,NTDOY,29,0,29,-29,1,7,11,1,OTC
5164,16-02-2021 14:00,24 hrs.,stocks,AMS,139,0,139,-139,1,52,31,1,AMEX
5164,16-02-2021 14:00,24 hrs.,stocks,CTO,139,0,139,-139,1,52,31,1,AMEX
5164,16-02-2021 14:00,24 hrs.,stocks,NBA,70,70,0,70,1,26,14,1,AMEX
5164,16-02-2021 14:00,24 hrs.,stocks,WYY,154,0,154,-154,1,68,14,1,AMEX
5164,16-02-2021 14:00,24 hrs.,stocks,ABC,43,0,43,-43,1,11,17,1,NYSE
5164,16-02-2021 14:00,24 hrs.,stocks,AIR,139,0,139,-139,1,52,31,1,NYSE
5164,16-02-2021 14:00,24 hrs.,stocks,AMC,12,6,6,0,2,2,0,2,NYSE
5164,16-02-2021 14:00,24 hrs.,stocks,ASX,8,8,0,8,1,1,2,1,NYSE
5164,16-02-2021 14:00,24 hrs.,stocks,AVB,10,10,0,10,1,1,4,1,NYSE
5164,16-02-2021 14:00,24 hrs.,SPACs,CDIX,6,6,0,6,1,1,0,1,OTC
5164,16-02-2021 14:00,24 hrs.,SPACs,USPS,445,445,0,445,1,171,99,1,OTC
5164,16-02-2021 14:00,24 hrs.,SPACs,LVMHF,39,39,0,39,1,17,1,1,OTC
5164,16-02-2021 14:00,24 hrs.,SPACs,GSV,173,173,0,173,1,61,47,1,AMEX
5164,16-02-2021 14:00,24 hrs.,SPACs,BFT,232,232,0,232,1,12,204,1,NYSE
5164,16-02-2021 14:00,24 hrs.,SPACs,CCO,173,173,0,173,1,61,47,1,NYSE
5164,16-02-2021 14:00,24 hrs.,SPACs,DEH,232,232,0,232,1,12,204,1,NYSE
5164,16-02-2021 14:00,24 hrs.,SPACs,EQD,40,40,0,40,1,13,10,1,NYSE
5164,16-02-2021 14:00,24 hrs.,SPACs,EVA,10,0,10,-10,1,0,6,1,NYSE
5164,16-02-2021 14:00,24 hrs.,SPACs,GIK,452,452,0,452,2,172,100,2,NYSE
5164,16-02-2021 14:00,24 hrs.,SPACs,GME,349,7,342,-335,2,127,87,2,NYSE
5164,16-02-2021 14:00,24 hrs.,SPACs,HPS,173,173,0,173,1,61,47,1,NYSE
5164,16-02-2021 14:00,24 hrs.,SPACs,JWS,232,232,0,232,1,12,204,1,NYSE
5164,16-02-2021 14:00,24 hrs.,SPACs,MGM,173,173,0,173,1,61,47,1,NYSE
5164,16-02-2021 14:00,24 hrs.,SPACs,NRZ,173,173,0,173,1,61,47,1,NYSE
5164,16-02-2021 14:00,24 hrs.,SPACs,RTP,574,232,342,-110,2,138,290,2,NYSE
5164,16-02-2021 14:00,24 hrs.,SPACs,SBG,104,104,0,104,3,14,64,3,NYSE
5164,16-02-2021 14:00,24 hrs.,SPACs,ACIC,689,232,457,-225,4,165,343,4,NYSE
5164,16-02-2021 14:00,24 hrs.,SPACs,ACND,232,232,0,232,1,12,204,1,NYSE
5164,16-02-2021 14:00,24 hrs.,SPACs,BOAC,13,13,0,13,2,2,1,1,NYSE
5164,16-02-2021 14:00,24 hrs.,SPACs,CCIV,1647,566,1081,-515,6,546,531,6,NYSE
5164,16-02-2021 14:00,24 hrs.,SPACs,CTAC,8,0,8,-8,1,1,2,1,NYSE
5164,16-02-2021 14:00,24 hrs.,SPACs,DNMR,342,0,342,-342,1,126,86,1,NYSE
5164,16-02-2021 14:00,24 hrs.,SPACs,EMPW,232,232,0,232,1,12,204,1,NYSE
5164,16-02-2021 14:00,24 hrs.,SPACs,ENPC,232,232,0,232,1,12,204,1,NYSE
5164,16-02-2021 14:00,24 hrs.,SPACs,FGNA,342,0,342,-342,1,126,86,1,NYSE
5164,16-02-2021 14:00,24 hrs.,SPACs,FUSE,401,59,342,-283,2,137,119,2,NYSE
5164,16-02-2021 14:00,24 hrs.,SPACs,GSAH,232,232,0,232,1,12,204,1,NYSE
5164,16-02-2021 14:00,24 hrs.,SPACs,HZON,232,232,0,232,1,12,204,1,NYSE
5164,16-02-2021 14:00,24 hrs.,SPACs,IACA,232,232,0,232,1,12,204,1,NYSE
5164,16-02-2021 14:00,24 hrs.,SPACs,IPOD,36,0,36,-36,1,6,20,1,NYSE
5164,16-02-2021 14:00,24 hrs.,SPACs,IPOE,187,7,180,-173,3,56,63,3,NYSE
5164,16-02-2021 14:00,24 hrs.,SPACs,IPOF,43,0,43,-43,2,7,21,2,NYSE
5164,16-02-2021 14:00,24 hrs.,SPACs,PDAC,785,354,431,-77,9,217,315,6,NYSE
5164,16-02-2021 14:00,24 hrs.,SPACs,PLTR,7,7,0,7,1,1,1,1,NYSE
5164,16-02-2021 14:00,24 hrs.,SPACs,PSTH,354,0,354,-354,3,128,86,2,NYSE
5164,16-02-2021 14:00,24 hrs.,SPACs,SCVX,232,232,0,232,1,12,204,1,NYSE
5164,16-02-2021 14:00,24 hrs.,SPACs,SNPR,342,0,342,-342,1,126,86,1,NYSE
5164,16-02-2021 14:00,24 hrs.,SPACs,ADV,232,232,0,232,1,12,204,1,NASDAQ
5164,16-02-2021 14:00,24 hrs.,SPACs,CFO,173,173,0,173,1,61,47,1,NASDAQ
5164,16-02-2021 14:00,24 hrs.,SPACs,ESG,122,122,0,122,1,42,34,1,NASDAQ
5164,16-02-2021 14:00,24 hrs.,RobinHoodPennyStocks,IMTE,127,127,0,127,1,52,19,1,NASDAQ
5164,16-02-2021 14:00,24 hrs.,RobinHoodPennyStocks,IZEA,127,127,0,127,1,52,19,1,NASDAQ
5164,16-02-2021 14:00,24 hrs.,RobinHoodPennyStocks,KERN,127,127,0,127,1,52,19,1,NASDAQ
5164,16-02-2021 14:00,24 hrs.,RobinHoodPennyStocks,LIVE,6,6,0,6,1,1,0,1,NASDAQ
5164,16-02-2021 14:00,24 hrs.,RobinHoodPennyStocks,LMFA,127,127,0,127,1,52,19,1,NASDAQ
5164,16-02-2021 14:00,24 hrs.,RobinHoodPennyStocks,MARA,153,127,26,101,2,61,23,2,NASDAQ
5164,16-02-2021 14:00,24 hrs.,RobinHoodPennyStocks,METX,127,127,0,127,1,52,19,1,NASDAQ
5164,16-02-2021 14:00,24 hrs.,RobinHoodPennyStocks,MNPR,127,127,0,127,1,52,19,1,NASDAQ
5164,16-02-2021 14:00,24 hrs.,stocks,ARDX,154,0,154,-154,1,68,14,1,NASDAQ
5164,16-02-2021 14:00,24 hrs.,stocks,ARTL,6,6,0,6,1,1,0,1,NASDAQ
5164,16-02-2021 14:00,24 hrs.,stocks,ATVI,29,0,29,-29,1,7,11,1,NASDAQ
5164,16-02-2021 14:00,24 hrs.,stocks,AUPH,12,0,12,-12,1,2,4,1,NASDAQ
5164,16-02-2021 14:00,24 hrs.,stocks,BNGO,6,6,0,6,1,1,0,1,NASDAQ
5164,16-02-2021 14:00,24 hrs.,stocks,CHKP,18,6,12,-6,3,3,0,2,NASDAQ
5164,16-02-2021 14:00,24 hrs.,stocks,CMPS,6,0,6,-6,1,1,0,1,NASDAQ
5164,16-02-2021 14:00,24 hrs.,stocks,CNDT,6,0,6,-6,1,1,0,1,NASDAQ
5164,16-02-2021 14:00,24 hrs.,stocks,CRSP,6,6,0,6,1,1,0,1,NASDAQ
5164,16-02-2021 14:00,24 hrs.,stocks,CRSR,6,6,0,6,1,1,0,1,NASDAQ
5164,16-02-2021 14:00,24 hrs.,stocks,CRWD,18,6,12,-6,3,3,0,2,NASDAQ
5164,16-02-2021 14:00,24 hrs.,stocks,CTRM,6,6,0,6,1,1,0,1,NASDAQ
5164,16-02-2021 14:00,24 hrs.,stocks,DKNG,70,70,0,70,1,26,14,1,NASDAQ
5164,16-02-2021 14:00,24 hrs.,stocks,DLTR,17,0,17,-17,1,3,7,1,NASDAQ
5164,16-02-2021 14:00,24 hrs.,stocks,DRIV,139,0,139,-139,1,44,47,1,NASDAQ
5164,16-02-2021 14:00,24 hrs.,SPACs,JAN,39,0,39,-39,1,16,3,1,NASDAQ
5164,16-02-2021 14:00,24 hrs.,SPACs,VIH,151,0,151,-151,2,50,43,2,NASDAQ
5164,16-02-2021 14:00,24 hrs.,SPACs,AACQ,587,245,342,-97,3,142,291,3,NASDAQ
5164,16-02-2021 14:00,24 hrs.,SPACs,ACAM,232,232,0,232,1,12,204,1,NASDAQ
5164,16-02-2021 14:00,24 hrs.,SPACs,ACEV,232,232,0,232,1,12,204,1,NASDAQ
5164,16-02-2021 14:00,24 hrs.,SPACs,APHA,7,7,0,7,1,1,1,1,NASDAQ
5164,16-02-2021 14:00,24 hrs.,SPACs,ARYA,342,0,342,-342,1,126,86,1,NASDAQ
5164,16-02-2021 14:00,24 hrs.,SPACs,CIIC,41,0,41,-41,1,6,25,1,NASDAQ
5164,16-02-2021 14:00,24 hrs.,SPACs,CMLF,342,0,342,-342,1,126,86,1,NASDAQ
5164,16-02-2021 14:00,24 hrs.,SPACs,DCRB,342,0,342,-342,1,126,86,1,NASDAQ
5164,16-02-2021 14:00,24 hrs.,SPACs,DFHT,232,232,0,232,1,12,204,1,NASDAQ
5164,16-02-2021 14:00,24 hrs.,SPACs,DGNS,232,232,0,232,1,12,204,1,NASDAQ
5164,16-02-2021 14:00,24 hrs.,SPACs,ERES,232,232,0,232,1,12,204,1,NASDAQ
5164,16-02-2021 14:00,24 hrs.,SPACs,ETAC,7,0,7,-7,1,1,1,1,NASDAQ
5164,16-02-2021 14:00,24 hrs.,SPACs,EXPC,118,0,118,-118,2,26,58,2,NASDAQ
5164,16-02-2021 14:00,24 hrs.,SPACs,FCAC,342,0,342,-342,1,126,86,1,NASDAQ
5164,16-02-2021 14:00,24 hrs.,SPACs,FIII,7,0,7,-7,1,1,1,1,NASDAQ
5164,16-02-2021 14:00,24 hrs.,SPACs,GRNV,342,0,342,-342,1,126,86,1,NASDAQ
5164,16-02-2021 14:00,24 hrs.,SPACs,GRSV,342,0,342,-342,1,126,86,1,NASDAQ
5164,16-02-2021 14:00,24 hrs.,SPACs,INAQ,342,0,342,-342,1,126,86,1,NASDAQ
5164,16-02-2021 14:00,24 hrs.,SPACs,JCIC,173,173,0,173,1,61,47,1,NASDAQ
5164,16-02-2021 14:00,24 hrs.,SPACs,KERN,16,16,0,16,1,0,12,1,NASDAQ
5164,16-02-2021 14:00,24 hrs.,SPACs,LEGO,173,173,0,173,1,61,47,1,NASDAQ
5164,16-02-2021 14:00,24 hrs.,SPACs,LIVE,7,7,0,7,1,1,1,1,NASDAQ
5164,16-02-2021 14:00,24 hrs.,SPACs,LOAC,6,0,6,-6,1,1,0,1,NASDAQ
5164,16-02-2021 14:00,24 hrs.,SPACs,MCAC,342,0,342,-342,1,126,86,1,NASDAQ
5164,16-02-2021 14:00,24 hrs.,SPACs,NBAC,39,0,39,-39,1,16,3,1,NASDAQ
5164,16-02-2021 14:00,24 hrs.,SPACs,NGAC,356,0,356,-356,3,128,88,2,NASDAQ
5164,16-02-2021 14:00,24 hrs.,SPACs,QELL,115,0,115,-115,2,27,53,2,NASDAQ
5164,16-02-2021 14:00,24 hrs.,SPACs,ROCH,232,232,0,232,1,12,204,1,NASDAQ
5164,16-02-2021 14:00,24 hrs.,SPACs,SAII,173,173,0,173,1,61,47,1,NASDAQ
5164,16-02-2021 14:00,24 hrs.,SPACs,SNDL,7,7,0,7,1,1,1,1,NASDAQ
5164,16-02-2021 14:00,24 hrs.,SPACs,THCB,303,7,296,-289,4,97,93,2,NASDAQ
5164,16-02-2021 14:00,24 hrs.,SPACs,TLRY,7,7,0,7,1,1,1,1,NASDAQ
5164,16-02-2021 14:00,24 hrs.,SPACs,TSLA,7,7,0,7,1,1,1,1,NASDAQ
5164,16-02-2021 14:00,24 hrs.,SPACs,UNIT,173,173,0,173,1,61,47,1,NASDAQ
5164,16-02-2021 14:00,24 hrs.,SPACs,VSPR,232,232,0,232,1,12,204,1,NASDAQ
5164,16-02-2021 14:00,24 hrs.,SPACs,ETACW,232,232,0,232,1,12,204,1,NASDAQ
5164,16-02-2021 14:00,24 hrs.,SPACs,THCBU,62,0,62,-62,1,18,22,1,NASDAQ
5164,16-02-2021 14:00,24 hrs.,SPACs,VSPRW,232,232,0,232,1,12,204,1,NASDAQ
5164,16-02-2021 14:00,24 hrs.,stocks,ASTI,17,0,17,-17,1,1,11,1,OTC
5164,16-02-2021 14:00,24 hrs.,stocks,BNET,6,0,6,-6,1,1,0,1,OTC
5164,16-02-2021 14:00,24 hrs.,stocks,HEMP,6,0,6,-6,1,1,0,1,OTC
5164,16-02-2021 14:00,24 hrs.,stocks,ICCT,6,6,0,6,1,1,0,1,OTC
5164,16-02-2021 14:00,24 hrs.,stocks,INKW,6,0,6,-6,1,1,0,1,OTC
5164,16-02-2021 14:00,24 hrs.,stocks,JSDA,39,0,39,-39,1,8,19,1,OTC
5164,16-02-2021 14:00,24 hrs.,stocks,MOJO,6,6,0,6,1,1,0,1,OTC
5164,16-02-2021 14:00,24 hrs.,stocks,NWGC,7,7,0,7,1,1,1,1,OTC
5164,16-02-2021 14:00,24 hrs.,stocks,PURE,485,0,485,-485,1,171,139,1,OTC
5164,16-02-2021 14:00,24 hrs.,Daytrading,QQQ,177,177,0,177,1,84,5,1,NASDAQ
5164,16-02-2021 14:00,24 hrs.,Daytrading,AOSL,49,0,49,-49,1,16,13,1,NASDAQ
5164,16-02-2021 14:00,24 hrs.,Daytrading,APHA,49,0,49,-49,1,16,13,1,NASDAQ
5164,16-02-2021 14:00,24 hrs.,Daytrading,CASH,16,16,0,16,1,2,8,1,NASDAQ
5164,16-02-2021 14:00,24 hrs.,Daytrading,CIIC,177,177,0,177,1,84,5,1,NASDAQ
5164,16-02-2021 14:00,24 hrs.,Daytrading,CROX,49,0,49,-49,1,16,13,1,NASDAQ
5164,16-02-2021 14:00,24 hrs.,Daytrading,DKNG,49,0,49,-49,1,16,13,1,NASDAQ
5164,16-02-2021 14:00,24 hrs.,Daytrading,FORD,55,0,55,-55,1,22,7,1,NASDAQ
5164,16-02-2021 14:00,24 hrs.,Daytrading,GOGO,55,0,55,-55,1,22,7,1,NASDAQ
5164,16-02-2021 14:00,24 hrs.,Daytrading,LOAC,6,0,6,-6,1,1,0,1,NASDAQ
5164,16-02-2021 14:00,24 hrs.,Daytrading,PATI,55,0,55,-55,1,22,7,1,NASDAQ
5164,16-02-2021 14:00,24 hrs.,Daytrading,PAYS,6,6,0,6,1,1,0,1,NASDAQ
5164,16-02-2021 14:00,24 hrs.,Daytrading,PBTS,55,0,55,-55,1,22,7,1,NASDAQ
5164,16-02-2021 14:00,24 hrs.,Daytrading,SAVA,6,0,6,-6,1,1,0,1,NASDAQ
5164,16-02-2021 14:00,24 hrs.,Daytrading,SNDL,6,0,6,-6,1,1,0,1,NASDAQ
5164,16-02-2021 14:00,24 hrs.,stocks,BYD,56,0,56,-56,1,7,38,1,NYSE
5164,16-02-2021 14:00,24 hrs.,stocks,CAH,154,0,154,-154,1,68,14,1,NYSE
5164,16-02-2021 14:00,24 hrs.,stocks,CCO,383,0,383,-383,2,110,155,2,NYSE
5164,16-02-2021 14:00,24 hrs.,stocks,CHL,6,0,6,-6,1,1,0,1,NYSE
5164,16-02-2021 14:00,24 hrs.,stocks,COO,383,0,383,-383,2,110,155,2,NYSE
5164,16-02-2021 14:00,24 hrs.,stocks,CPT,10,10,0,10,1,1,4,1,NYSE
5164,16-02-2021 14:00,24 hrs.,stocks,DIS,258,0,258,-258,2,56,138,2,NYSE
5164,16-02-2021 14:00,24 hrs.,stocks,ELY,45,39,6,33,2,10,17,2,NYSE
5164,16-02-2021 14:00,24 hrs.,stocks,EMP,154,0,154,-154,1,68,14,1,NYSE
5164,16-02-2021 14:00,24 hrs.,stocks,EQR,10,10,0,10,1,1,4,1,NYSE
5164,16-02-2021 14:00,24 hrs.,stocks,ESS,10,10,0,10,1,1,4,1,NYSE
5164,16-02-2021 14:00,24 hrs.,stocks,ETN,18,18,0,18,3,3,0,1,NYSE
5164,16-02-2021 14:00,24 hrs.,stocks,FSR,139,0,139,-139,1,52,31,1,NYSE
5164,16-02-2021 14:00,24 hrs.,stocks,GIK,139,0,139,-139,1,52,31,1,NYSE
5164,16-02-2021 14:00,24 hrs.,stocks,GME,412,296,116,180,5,156,80,4,NYSE
5164,16-02-2021 14:00,24 hrs.,stocks,HBI,139,0,139,-139,1,52,31,1,NYSE
5164,16-02-2021 14:00,24 hrs.,stocks,ICE,70,0,70,-70,1,7,52,1,NYSE
5164,16-02-2021 14:00,24 hrs.,stocks,LYV,6,0,6,-6,1,1,0,1,NYSE
5164,16-02-2021 14:00,24 hrs.,stocks,MAA,10,10,0,10,1,1,4,1,NYSE
5164,16-02-2021 14:00,24 hrs.,stocks,MAS,154,0,154,-154,1,68,14,1,NYSE
5164,16-02-2021 14:00,24 hrs.,stocks,NIO,458,0,458,-458,1,177,100,1,NYSE
5164,16-02-2021 14:00,24 hrs.,stocks,PFE,12,0,12,-12,2,2,0,1,NYSE
5164,16-02-2021 14:00,24 hrs.,stocks,PGR,19,0,19,-19,1,6,3,1,NYSE
5164,16-02-2021 14:00,24 hrs.,stocks,RSI,154,0,154,-154,1,68,14,1,NYSE
5164,16-02-2021 14:00,24 hrs.,stocks,SOI,7,0,7,-7,1,1,1,1,NYSE
5164,16-02-2021 14:00,24 hrs.,stocks,TSE,18,18,0,18,3,3,0,1,NYSE
5164,16-02-2021 14:00,24 hrs.,stocks,TSM,110,110,0,110,1,36,34,1,NYSE
5164,16-02-2021 14:00,24 hrs.,stocks,UBS,139,0,139,-139,1,52,31,1,NYSE
5164,16-02-2021 14:00,24 hrs.,stocks,UPS,139,0,139,-139,1,52,31,1,NYSE
5164,16-02-2021 14:00,24 hrs.,stocks,WMT,17,0,17,-17,1,3,7,1,NYSE
5164,16-02-2021 14:00,24 hrs.,stocks,CCIV,6,6,0,6,1,1,0,1,NYSE
5164,16-02-2021 14:00,24 hrs.,stocks,CSPR,6,6,0,6,1,1,0,1,NYSE
5164,16-02-2021 14:00,24 hrs.,stocks,PLTR,105,0,105,-105,2,14,69,2,NYSE
5164,16-02-2021 14:00,24 hrs.,stocks,SNAP,485,0,485,-485,1,171,139,1,NYSE
5164,16-02-2021 14:00,24 hrs.,stocks,SPCE,226,220,6,214,3,91,32,3,NYSE
5164,16-02-2021 14:00,24 hrs.,stocks,AMD,6,0,6,-6,1,1,0,1,NASDAQ
5164,16-02-2021 14:00,24 hrs.,stocks,CDK,139,0,139,-139,1,52,31,1,NASDAQ
5164,16-02-2021 14:00,24 hrs.,stocks,CFO,163,0,163,-163,2,58,39,2,NASDAQ
5164,16-02-2021 14:00,24 hrs.,stocks,CGC,42,42,0,42,1,14,10,1,NASDAQ
5164,16-02-2021 14:00,24 hrs.,stocks,FTC,42,42,0,42,1,14,10,1,NASDAQ
5164,16-02-2021 14:00,24 hrs.,stocks,FUV,18,18,0,18,3,3,0,1,NASDAQ
5164,16-02-2021 14:00,24 hrs.,stocks,III,139,0,139,-139,1,52,31,1,NASDAQ
5164,16-02-2021 14:00,24 hrs.,stocks,SFT,6,6,0,6,1,1,0,1,NASDAQ
5164,16-02-2021 14:00,24 hrs.,stocks,AAPL,464,6,458,-452,3,133,186,3,NASDAQ
5164,16-02-2021 14:00,24 hrs.,stocks,AKTS,154,0,154,-154,1,68,14,1,NASDAQ
5164,16-02-2021 14:00,24 hrs.,stocks,ALSK,6,0,6,-6,1,1,0,1,NASDAQ
5164,16-02-2021 14:00,24 hrs.,stocks,AMCA,42,42,0,42,1,14,10,1,NASDAQ
5164,16-02-2021 14:00,24 hrs.,stocks,AMZN,225,0,225,-225,1,51,119,1,NASDAQ
5164,16-02-2021 14:00,24 hrs.,stocks,APHA,81,81,0,81,2,18,37,2,NASDAQ
5164,16-02-2021 14:00,24 hrs.,StockMarket,SGMD,6,0,6,-6,1,1,0,1,OTC
5164,16-02-2021 14:00,24 hrs.,StockMarket,MMNFF,6,0,6,-6,1,1,0,1,OTC
5164,16-02-2021 14:00,24 hrs.,StockMarket,PYRNF,6,0,6,-6,1,1,0,1,OTC
5164,16-02-2021 14:00,24 hrs.,StockMarket,RNRRF,6,6,0,6,1,1,0,1,OTC
5164,16-02-2021 14:00,24 hrs.,StockMarket,DPW,6,0,6,-6,1,1,0,1,AMEX
5164,16-02-2021 14:00,24 hrs.,StockMarket,AMC,373,10,363,-353,4,151,55,4,NYSE
5164,16-02-2021 14:00,24 hrs.,StockMarket,ASX,13,13,0,13,1,3,3,1,NYSE
5164,16-02-2021 14:00,24 hrs.,StockMarket,DHI,36,0,36,-36,1,16,0,1,NYSE
5164,16-02-2021 14:00,24 hrs.,StockMarket,GME,4874,414,4460,-4046,8,2259,324,8,NYSE
5164,16-02-2021 14:00,24 hrs.,StockMarket,GPN,36,0,36,-36,1,16,0,1,NYSE
5164,16-02-2021 14:00,24 hrs.,StockMarket,OMF,36,0,36,-36,1,16,0,1,NYSE
5164,16-02-2021 14:00,24 hrs.,StockMarket,PHI,12,12,0,12,1,3,2,1,NYSE
5164,16-02-2021 14:00,24 hrs.,StockMarket,PSX,36,0,36,-36,1,16,0,1,NYSE
5164,16-02-2021 14:00,24 hrs.,StockMarket,RSI,12,12,0,12,1,3,2,1,NYSE
5164,16-02-2021 14:00,24 hrs.,StockMarket,SOS,29,0,29,-29,1,7,11,1,NYSE
5164,16-02-2021 14:00,24 hrs.,stocks,EDIT,140,61,79,-18,2,25,82,2,NASDAQ
5164,16-02-2021 14:00,24 hrs.,stocks,ESPO,15,0,15,-15,1,3,5,1,NASDAQ
5164,16-02-2021 14:00,24 hrs.,stocks,EXPI,20,20,0,20,3,3,2,2,NASDAQ
5164,16-02-2021 14:00,24 hrs.,stocks,FATE,485,0,485,-485,1,171,139,1,NASDAQ
5164,16-02-2021 14:00,24 hrs.,stocks,FIII,151,0,151,-151,3,54,31,2,NASDAQ
5164,16-02-2021 14:00,24 hrs.,stocks,FLIR,485,0,485,-485,1,171,139,1,NASDAQ
5164,16-02-2021 14:00,24 hrs.,stocks,GILD,4,0,4,-4,1,0,0,1,NASDAQ
5164,16-02-2021 14:00,24 hrs.,stocks,GOGO,6,6,0,6,1,1,0,1,NASDAQ
5164,16-02-2021 14:00,24 hrs.,stocks,GPRO,6,0,6,-6,1,1,0,1,NASDAQ
5164,16-02-2021 14:00,24 hrs.,stocks,GTHX,60,0,60,-60,1,25,6,1,NASDAQ
5164,16-02-2021 14:00,24 hrs.,stocks,HLIT,154,0,154,-154,1,68,14,1,NASDAQ
5164,16-02-2021 14:00,24 hrs.,stocks,ICLN,6,0,6,-6,1,1,0,1,NASDAQ
5164,16-02-2021 14:00,24 hrs.,stocks,IZEA,6,6,0,6,1,1,0,1,NASDAQ
5164,16-02-2021 14:00,24 hrs.,stocks,LCAP,6,6,0,6,1,1,0,1,NASDAQ
5164,16-02-2021 14:00,24 hrs.,stocks,LOAC,6,0,6,-6,1,1,0,1,NASDAQ
5164,16-02-2021 14:00,24 hrs.,stocks,MBII,6,0,6,-6,1,1,0,1,NASDAQ
5164,16-02-2021 14:00,24 hrs.,stocks,NNDM,6,0,6,-6,1,1,0,1,NASDAQ
5164,16-02-2021 14:00,24 hrs.,stocks,OLLI,17,0,17,-17,1,3,7,1,NASDAQ
5164,16-02-2021 14:00,24 hrs.,stocks,PAVM,6,6,0,6,1,1,0,1,NASDAQ
5164,16-02-2021 14:00,24 hrs.,stocks,PENN,13,0,13,-13,1,1,7,1,NASDAQ
5164,16-02-2021 14:00,24 hrs.,stocks,PLUG,6,6,0,6,1,1,0,1,NASDAQ
5164,16-02-2021 14:00,24 hrs.,stocks,POWW,20,20,0,20,1,4,8,1,NASDAQ
5164,16-02-2021 14:00,24 hrs.,stocks,ROKU,485,0,485,-485,1,171,139,1,NASDAQ
5164,16-02-2021 14:00,24 hrs.,stocks,RRGB,15,15,0,15,1,3,5,1,NASDAQ
5164,16-02-2021 14:00,24 hrs.,stocks,SEER,6,6,0,6,1,1,0,1,NASDAQ
5164,16-02-2021 14:00,24 hrs.,stocks,SNDL,13,13,0,13,2,2,1,2,NASDAQ
5164,16-02-2021 14:00,24 hrs.,stocks,SONO,6,6,0,6,1,1,0,1,NASDAQ
5164,16-02-2021 14:00,24 hrs.,stocks,SRNE,6,6,0,6,1,1,0,1,NASDAQ
5164,16-02-2021 14:00,24 hrs.,stocks,SSPK,82,82,0,82,2,34,6,2,NASDAQ
5164,16-02-2021 14:00,24 hrs.,stocks,TLRY,42,42,0,42,1,14,10,1,NASDAQ
5164,16-02-2021 14:00,24 hrs.,stocks,TSLA,158,66,92,-26,2,37,76,2,NASDAQ
5164,16-02-2021 14:00,24 hrs.,stocks,TTCF,139,0,139,-139,1,52,31,1,NASDAQ
5164,16-02-2021 14:00,24 hrs.,stocks,TXMD,10,10,0,10,1,3,0,1,NASDAQ
5164,16-02-2021 14:00,24 hrs.,stocks,UCTT,4,0,4,-4,1,0,0,1,NASDAQ
5164,16-02-2021 14:00,24 hrs.,stocks,UHAL,10,0,10,-10,1,3,0,1,NASDAQ
5164,16-02-2021 14:00,24 hrs.,stocks,VTWO,7,0,7,-7,1,1,1,1,NASDAQ
5164,16-02-2021 14:00,24 hrs.,stocks,VXUS,16,0,16,-16,1,6,0,1,NASDAQ
5164,16-02-2021 14:00,24 hrs.,Daytrading,AMC,6,6,0,6,1,1,0,1,NYSE
5164,16-02-2021 14:00,24 hrs.,Daytrading,DHF,6,6,0,6,1,1,0,1,NYSE
5164,16-02-2021 14:00,24 hrs.,Daytrading,DIS,49,0,49,-49,1,16,13,1,NYSE
5164,16-02-2021 14:00,24 hrs.,Daytrading,PDT,2683,16,2667,-2651,2,1225,225,2,NYSE
5164,16-02-2021 14:00,24 hrs.,Daytrading,RKT,49,0,49,-49,1,16,13,1,NYSE
5164,16-02-2021 14:00,24 hrs.,Daytrading,RSI,460,177,283,-106,2,210,32,2,NYSE
5164,16-02-2021 14:00,24 hrs.,Daytrading,TDA,23,0,23,-23,1,5,9,1,NYSE
5164,16-02-2021 14:00,24 hrs.,Daytrading,WWW,6,6,0,6,1,1,0,1,NYSE
5164,16-02-2021 14:00,24 hrs.,Daytrading,FUBO,49,0,49,-49,1,16,13,1,NYSE
5164,16-02-2021 14:00,24 hrs.,Daytrading,HEXO,49,0,49,-49,1,16,13,1,NYSE
5164,16-02-2021 14:00,24 hrs.,Daytrading,PLTR,49,0,49,-49,1,16,13,1,NYSE
5164,16-02-2021 14:00,24 hrs.,Daytrading,TALO,6,0,6,-6,1,1,0,1,NYSE
5164,16-02-2021 14:00,24 hrs.,pennystocks,CCTL,6,0,6,-6,1,1,0,1,OTC
5164,16-02-2021 14:00,24 hrs.,pennystocks,CYDY,7,0,7,-7,1,1,1,1,OTC
5164,16-02-2021 14:00,24 hrs.,pennystocks,DPLS,7,0,7,-7,1,1,1,1,OTC
5164,16-02-2021 14:00,24 hrs.,pennystocks,ENZC,6,6,0,6,1,1,0,1,OTC
5164,16-02-2021 14:00,24 hrs.,pennystocks,ERBB,79,79,0,79,1,21,33,1,OTC
5164,16-02-2021 14:00,24 hrs.,pennystocks,ETFM,27,27,0,27,4,5,1,3,OTC
5164,16-02-2021 14:00,24 hrs.,pennystocks,FDMF,6,0,6,-6,1,1,0,1,OTC
5164,16-02-2021 14:00,24 hrs.,pennystocks,FLES,26,7,19,-12,2,1,16,2,OTC
5164,16-02-2021 14:00,24 hrs.,pennystocks,GARB,7,7,0,7,1,1,1,1,OTC
5164,16-02-2021 14:00,24 hrs.,pennystocks,GAXY,29,0,29,-29,1,6,13,1,OTC
5164,16-02-2021 14:00,24 hrs.,pennystocks,GPFT,6,6,0,6,1,1,0,1,OTC
5164,16-02-2021 14:00,24 hrs.,pennystocks,GRNH,79,79,0,79,1,21,33,1,OTC
5164,16-02-2021 14:00,24 hrs.,pennystocks,GTLL,7,0,7,-7,1,1,1,1,OTC
5164,16-02-2021 14:00,24 hrs.,pennystocks,GTXO,16,0,16,-16,1,3,6,1,OTC
5164,16-02-2021 14:00,24 hrs.,pennystocks,HALB,44,0,44,-44,1,16,8,1,OTC
5164,16-02-2021 14:00,24 hrs.,Daytrading,SSKN,55,0,55,-55,1,22,7,1,NASDAQ
5164,16-02-2021 14:00,24 hrs.,Daytrading,TLRY,49,0,49,-49,1,16,13,1,NASDAQ
5164,16-02-2021 14:00,24 hrs.,Daytrading,TOPS,55,0,55,-55,1,22,7,1,NASDAQ
5164,16-02-2021 14:00,24 hrs.,Daytrading,TWIN,55,0,55,-55,1,22,7,1,NASDAQ
5164,16-02-2021 14:00,24 hrs.,trakstocks,ABML,23,0,23,-23,1,5,9,1,OTC
5164,16-02-2021 14:00,24 hrs.,trakstocks,BOTH,90,90,0,90,2,34,14,2,OTC
5164,16-02-2021 14:00,24 hrs.,trakstocks,COMS,108,0,108,-108,1,32,40,1,OTC
5164,16-02-2021 14:00,24 hrs.,trakstocks,EMBI,23,23,0,23,1,9,1,1,OTC
5164,16-02-2021 14:00,24 hrs.,trakstocks,GMEV,11,11,0,11,1,3,1,1,OTC
5164,16-02-2021 14:00,24 hrs.,trakstocks,MOST,6,0,6,-6,1,1,0,1,OTC
5164,16-02-2021 14:00,24 hrs.,trakstocks,NOUV,6,0,6,-6,1,1,0,1,OTC
5164,16-02-2021 14:00,24 hrs.,trakstocks,OPTI,12,0,12,-12,1,4,0,1,OTC
5164,16-02-2021 14:00,24 hrs.,trakstocks,SNPW,33,0,33,-33,1,14,1,1,OTC
5164,16-02-2021 14:00,24 hrs.,trakstocks,SSFT,8,0,8,-8,1,0,4,1,OTC
5164,16-02-2021 14:00,24 hrs.,trakstocks,ARBKF,6,0,6,-6,1,1,0,1,OTC
5164,16-02-2021 14:00,24 hrs.,trakstocks,FUNFF,11,11,0,11,2,1,1,2,OTC
5164,16-02-2021 14:00,24 hrs.,trakstocks,MEG,14,0,14,-14,1,4,2,1,NYSE
5164,16-02-2021 14:00,24 hrs.,trakstocks,THC,23,23,0,23,1,9,1,1,NYSE
5164,16-02-2021 14:00,24 hrs.,trakstocks,ALLY,14,0,14,-14,1,4,2,1,NYSE
5164,16-02-2021 14:00,24 hrs.,trakstocks,ARGO,6,0,6,-6,1,1,0,1,NYSE
5164,16-02-2021 14:00,24 hrs.,trakstocks,SKLZ,31,0,31,-31,1,11,5,1,NYSE
5164,16-02-2021 14:00,24 hrs.,trakstocks,ATOS,60,60,0,60,1,24,8,1,NASDAQ
5164,16-02-2021 14:00,24 hrs.,trakstocks,AYRO,13,13,0,13,1,3,3,1,NASDAQ
5164,16-02-2021 14:00,24 hrs.,trakstocks,BXRX,42,0,42,-42,1,16,6,1,NASDAQ
5164,16-02-2021 14:00,24 hrs.,trakstocks,CACC,14,0,14,-14,1,4,2,1,NASDAQ
5164,16-02-2021 14:00,24 hrs.,trakstocks,CIDM,24,0,24,-24,1,8,4,1,NASDAQ
5164,16-02-2021 14:00,24 hrs.,trakstocks,EVFM,22,0,22,-22,1,7,4,1,NASDAQ
5164,16-02-2021 14:00,24 hrs.,trakstocks,EXPC,5,0,5,-5,1,0,1,1,NASDAQ
5164,16-02-2021 14:00,24 hrs.,trakstocks,FIII,59,0,59,-59,2,22,7,2,NASDAQ
5164,16-02-2021 14:00,24 hrs.,trakstocks,GMBL,12,12,0,12,1,3,2,1,NASDAQ
5164,16-02-2021 14:00,24 hrs.,trakstocks,IDEX,37,0,37,-37,2,10,9,2,NASDAQ
5164,16-02-2021 14:00,24 hrs.,trakstocks,INPX,26,26,0,26,1,9,4,1,NASDAQ
5164,16-02-2021 14:00,24 hrs.,trakstocks,KIDS,17,0,17,-17,2,1,7,2,NASDAQ
5164,16-02-2021 14:00,24 hrs.,trakstocks,LKCO,12,12,0,12,1,3,2,1,NASDAQ
5164,16-02-2021 14:00,24 hrs.,trakstocks,LOAC,7,0,7,-7,1,1,1,1,NASDAQ
5164,16-02-2021 14:00,24 hrs.,trakstocks,MVIS,17,0,17,-17,1,5,3,1,NASDAQ
5164,16-02-2021 14:00,24 hrs.,trakstocks,NEPT,10,10,0,10,1,3,0,1,NASDAQ
5164,16-02-2021 14:00,24 hrs.,trakstocks,NNDM,107,107,0,107,1,39,25,1,NASDAQ
5164,16-02-2021 14:00,24 hrs.,trakstocks,OBSV,18,0,18,-18,1,7,0,1,NASDAQ
5164,16-02-2021 14:00,24 hrs.,trakstocks,RNET,13,13,0,13,1,3,3,1,NASDAQ
5164,16-02-2021 14:00,24 hrs.,trakstocks,SELB,37,0,37,-37,1,12,9,1,NASDAQ
5164,16-02-2021 14:00,24 hrs.,trakstocks,SNDL,90,90,0,90,2,34,14,2,NASDAQ
5164,16-02-2021 14:00,24 hrs.,trakstocks,THMO,6,0,6,-6,1,0,2,1,NASDAQ
5164,16-02-2021 14:00,24 hrs.,trakstocks,TNXP,42,0,42,-42,1,16,6,1,NASDAQ
5164,16-02-2021 14:00,24 hrs.,trakstocks,TRCH,159,16,143,-127,3,48,51,3,NASDAQ
5164,16-02-2021 14:00,24 hrs.,trakstocks,TRIT,70,0,70,-70,2,23,16,2,NASDAQ
5164,16-02-2021 14:00,24 hrs.,StockMarket,BOTH,162,162,0,162,1,62,34,1,OTC
5164,16-02-2021 14:00,24 hrs.,StockMarket,PHIL,12,12,0,12,1,3,2,1,OTC
5164,16-02-2021 14:00,24 hrs.,StockMarket,RCHA,6,0,6,-6,1,1,0,1,OTC
5164,16-02-2021 14:00,24 hrs.,pennystocks,CYDVF,6,0,6,-6,1,1,0,1,OTC
5164,16-02-2021 14:00,24 hrs.,pennystocks,EPWCF,6,0,6,-6,1,1,0,1,OTC
5164,16-02-2021 14:00,24 hrs.,pennystocks,ERPNF,97,0,97,-97,1,38,17,1,OTC
5164,16-02-2021 14:00,24 hrs.,pennystocks,FUNFF,6,0,6,-6,1,1,0,1,OTC
5164,16-02-2021 14:00,24 hrs.,pennystocks,GWMGF,6,0,6,-6,1,1,0,1,OTC
5164,16-02-2021 14:00,24 hrs.,pennystocks,HITIF,57,0,57,-57,1,11,31,1,OTC
5164,16-02-2021 14:00,24 hrs.,pennystocks,HTZGQ,6,6,0,6,1,1,0,1,OTC
5164,16-02-2021 14:00,24 hrs.,pennystocks,HUTMF,43,0,43,-43,1,5,29,1,OTC
5164,16-02-2021 14:00,24 hrs.,pennystocks,HVBTF,6,0,6,-6,1,1,0,1,OTC
5164,16-02-2021 14:00,24 hrs.,pennystocks,KBEVF,9,9,0,9,1,2,1,1,OTC
5164,16-02-2021 14:00,24 hrs.,pennystocks,MLLOF,101,0,101,-101,1,43,11,1,OTC
5164,16-02-2021 14:00,24 hrs.,pennystocks,MMNFF,6,0,6,-6,1,1,0,1,OTC
5164,16-02-2021 14:00,24 hrs.,pennystocks,MMTIF,20,0,20,-20,1,2,12,1,OTC
5164,16-02-2021 14:00,24 hrs.,pennystocks,MNXXF,71,71,0,71,3,21,17,2,OTC
5164,16-02-2021 14:00,24 hrs.,pennystocks,MPXOF,10,10,0,10,1,2,2,1,OTC
5164,16-02-2021 14:00,24 hrs.,StockMarket,ALLY,36,0,36,-36,1,16,0,1,NYSE
5164,16-02-2021 14:00,24 hrs.,StockMarket,CCIV,46,19,27,-8,3,10,14,3,NYSE
5164,16-02-2021 14:00,24 hrs.,StockMarket,COTY,11,11,0,11,1,2,3,1,NYSE
5164,16-02-2021 14:00,24 hrs.,StockMarket,HUYA,6,0,6,-6,1,1,0,1,NYSE
5164,16-02-2021 14:00,24 hrs.,StockMarket,SHOP,30,0,30,-30,1,6,14,1,NYSE
5164,16-02-2021 14:00,24 hrs.,StockMarket,TALO,6,0,6,-6,1,1,0,1,NYSE
5164,16-02-2021 14:00,24 hrs.,StockMarket,TWLO,36,0,36,-36,1,16,0,1,NYSE
5164,16-02-2021 14:00,24 hrs.,StockMarket,WORK,7,0,7,-7,1,0,3,1,NYSE
5164,16-02-2021 14:00,24 hrs.,StockMarket,HAS,13,13,0,13,1,3,3,1,NASDAQ
5164,16-02-2021 14:00,24 hrs.,StockMarket,PLL,13,13,0,13,1,3,3,1,NASDAQ
5164,16-02-2021 14:00,24 hrs.,StockMarket,ADBE,36,0,36,-36,1,16,0,1,NASDAQ
5164,16-02-2021 14:00,24 hrs.,StockMarket,AMZN,36,0,36,-36,1,16,0,1,NASDAQ
5164,16-02-2021 14:00,24 hrs.,StockMarket,ANTE,8,0,8,-8,1,2,0,1,NASDAQ
5164,16-02-2021 14:00,24 hrs.,StockMarket,CRSR,55,0,55,-55,1,15,21,1,NASDAQ
5164,16-02-2021 14:00,24 hrs.,StockMarket,EXPI,33,33,0,33,1,3,23,1,NASDAQ
5164,16-02-2021 14:00,24 hrs.,StockMarket,FIII,20,0,20,-20,1,5,6,1,NASDAQ
5164,16-02-2021 14:00,24 hrs.,StockMarket,GILD,14,0,14,-14,1,1,8,1,NASDAQ
5164,16-02-2021 14:00,24 hrs.,StockMarket,GILT,6,0,6,-6,1,1,0,1,NASDAQ
5164,16-02-2021 14:00,24 hrs.,StockMarket,GTHX,86,12,74,-62,3,24,26,2,NASDAQ
5164,16-02-2021 14:00,24 hrs.,StockMarket,IMVT,36,0,36,-36,1,16,0,1,NASDAQ
5164,16-02-2021 14:00,24 hrs.,StockMarket,JACK,6,0,6,-6,1,1,0,1,NASDAQ
5164,16-02-2021 14:00,24 hrs.,StockMarket,MVIS,6,0,6,-6,1,1,0,1,NASDAQ
5164,16-02-2021 14:00,24 hrs.,StockMarket,NAKD,6,0,6,-6,1,1,0,1,NASDAQ
5164,16-02-2021 14:00,24 hrs.,StockMarket,OTLK,6,0,6,-6,1,1,0,1,NASDAQ
5164,16-02-2021 14:00,24 hrs.,StockMarket,POWW,86,0,86,-86,1,28,26,1,NASDAQ
5164,16-02-2021 14:00,24 hrs.,StockMarket,PYPL,6,0,6,-6,1,1,0,1,NASDAQ
5164,16-02-2021 14:00,24 hrs.,StockMarket,SNDL,162,162,0,162,1,62,34,1,NASDAQ
5164,16-02-2021 14:00,24 hrs.,StockMarket,SSPK,40,40,0,40,1,16,4,1,NASDAQ
5164,16-02-2021 14:00,24 hrs.,StockMarket,TSLA,13,13,0,13,1,3,3,1,NASDAQ
5164,16-02-2021 14:00,24 hrs.,pennystocks,AABB,6,0,6,-6,1,1,0,1,OTC
5164,16-02-2021 14:00,24 hrs.,pennystocks,ABML,97,0,97,-97,1,38,17,1,OTC
5164,16-02-2021 14:00,24 hrs.,pennystocks,ABQQ,27,21,6,15,2,7,5,2,OTC
5164,16-02-2021 14:00,24 hrs.,pennystocks,ABWN,7,0,7,-7,1,1,1,1,OTC
5164,16-02-2021 14:00,24 hrs.,pennystocks,AGYP,9,0,9,-9,1,2,1,1,OTC
5164,16-02-2021 14:00,24 hrs.,pennystocks,AITX,629,6,623,-617,9,235,123,7,OTC
5164,16-02-2021 14:00,24 hrs.,pennystocks,ALPP,31,0,31,-31,2,9,5,2,OTC
5164,16-02-2021 14:00,24 hrs.,pennystocks,ALYI,51,0,51,-51,1,14,19,1,OTC
5164,16-02-2021 14:00,24 hrs.,pennystocks,APYP,6,6,0,6,1,1,0,1,OTC
5164,16-02-2021 14:00,24 hrs.,pennystocks,ASTI,123,0,123,-123,4,25,57,4,OTC
5164,16-02-2021 14:00,24 hrs.,pennystocks,BBRW,79,79,0,79,1,21,33,1,OTC
5164,16-02-2021 14:00,24 hrs.,pennystocks,BCAP,6,0,6,-6,1,1,0,1,OTC
5164,16-02-2021 14:00,24 hrs.,pennystocks,BIEL,6,0,6,-6,1,1,0,1,OTC
5164,16-02-2021 14:00,24 hrs.,pennystocks,BNGI,6,6,0,6,1,1,0,1,OTC
5164,16-02-2021 14:00,24 hrs.,pennystocks,BOTH,12,12,0,12,2,2,0,1,OTC
5164,16-02-2021 14:00,24 hrs.,pennystocks,BOTY,14,0,14,-14,2,2,2,2,OTC
5164,16-02-2021 14:00,24 hrs.,pennystocks,BRRN,19,6,13,-7,3,3,1,2,OTC
5164,16-02-2021 14:00,24 hrs.,pennystocks,CBBT,211,0,211,-211,5,47,97,4,OTC
5164,16-02-2021 14:00,24 hrs.,pennystocks,CBDL,12,0,12,-12,2,2,0,2,OTC
5164,16-02-2021 14:00,24 hrs.,pennystocks,CBTC,32,32,0,32,1,9,10,1,OTC
5164,16-02-2021 14:00,24 hrs.,pennystocks,UAMY,39,0,39,-39,1,10,15,1,AMEX
5164,16-02-2021 14:00,24 hrs.,pennystocks,ACB,233,0,233,-233,1,100,29,1,NYSE
5164,16-02-2021 14:00,24 hrs.,pennystocks,AFC,6,6,0,6,1,1,0,1,NYSE
5164,16-02-2021 14:00,24 hrs.,pennystocks,AMC,6,0,6,-6,1,1,0,1,NYSE
5164,16-02-2021 14:00,24 hrs.,pennystocks,ASX,128,0,128,-128,2,50,20,2,NYSE
5164,16-02-2021 14:00,24 hrs.,pennystocks,BMO,233,0,233,-233,1,100,29,1,NYSE
5164,16-02-2021 14:00,24 hrs.,pennystocks,BYD,41,0,41,-41,1,15,7,1,NYSE
5164,16-02-2021 14:00,24 hrs.,pennystocks,CBD,239,0,239,-239,2,101,29,2,NYSE
5164,16-02-2021 14:00,24 hrs.,pennystocks,DSX,23,23,0,23,1,8,3,1,NYSE
5164,16-02-2021 14:00,24 hrs.,pennystocks,EAT,239,0,239,-239,2,101,29,2,NYSE
5164,16-02-2021 14:00,24 hrs.,pennystocks,FPL,23,23,0,23,1,8,3,1,NYSE
5164,16-02-2021 14:00,24 hrs.,pennystocks,GME,6,6,0,6,1,1,0,1,NYSE
5164,16-02-2021 14:00,24 hrs.,pennystocks,NAT,23,23,0,23,1,8,3,1,NYSE
5164,16-02-2021 14:00,24 hrs.,pennystocks,NYT,57,0,57,-57,2,9,31,1,NYSE
5164,16-02-2021 14:00,24 hrs.,pennystocks,PEG,291,0,291,-291,1,137,13,1,NYSE
5164,16-02-2021 14:00,24 hrs.,pennystocks,PEN,122,0,122,-122,1,49,20,1,NYSE
5164,16-02-2021 14:00,24 hrs.,pennystocks,SOS,27,13,14,-1,4,4,3,3,NYSE
5164,16-02-2021 14:00,24 hrs.,pennystocks,THC,239,0,239,-239,2,101,29,2,NYSE
5164,16-02-2021 14:00,24 hrs.,pennystocks,ARGO,7,7,0,7,1,0,3,1,NYSE
5164,16-02-2021 14:00,24 hrs.,pennystocks,CSPR,6,0,6,-6,1,1,0,1,NYSE
5164,16-02-2021 14:00,24 hrs.,pennystocks,FLOW,291,0,291,-291,1,137,13,1,NYSE
5164,16-02-2021 14:00,24 hrs.,pennystocks,FUBO,24,24,0,24,1,6,8,1,NYSE
5164,16-02-2021 14:00,24 hrs.,pennystocks,PLTR,19,0,19,-19,1,4,7,1,NYSE
5164,16-02-2021 14:00,24 hrs.,pennystocks,HCMC,6,6,0,6,1,1,0,1,OTC
5164,16-02-2021 14:00,24 hrs.,pennystocks,HEMP,7,0,7,-7,1,1,1,1,OTC
5164,16-02-2021 14:00,24 hrs.,pennystocks,HIPH,20,20,0,20,1,1,14,1,OTC
5164,16-02-2021 14:00,24 hrs.,pennystocks,IJJP,6,6,0,6,1,1,0,1,OTC
5164,16-02-2021 14:00,24 hrs.,pennystocks,INKW,7,0,7,-7,1,1,1,1,OTC
5164,16-02-2021 14:00,24 hrs.,pennystocks,INND,85,0,85,-85,1,27,27,1,OTC
5164,16-02-2021 14:00,24 hrs.,pennystocks,KOAN,4,0,4,-4,1,0,0,1,OTC
5164,16-02-2021 14:00,24 hrs.,pennystocks,KOSK,11,11,0,11,1,2,3,1,OTC
5164,16-02-2021 14:00,24 hrs.,pennystocks,KULR,41,0,41,-41,1,15,7,1,OTC
5164,16-02-2021 14:00,24 hrs.,pennystocks,KWBT,33,7,26,-19,2,10,5,2,OTC
5164,16-02-2021 14:00,24 hrs.,pennystocks,MCOA,79,79,0,79,1,21,33,1,OTC
5164,16-02-2021 14:00,24 hrs.,pennystocks,MJNA,21,21,0,21,3,3,3,1,OTC
5164,16-02-2021 14:00,24 hrs.,pennystocks,NOVC,12,0,12,-12,2,2,0,1,OTC
5164,16-02-2021 14:00,24 hrs.,pennystocks,OPTI,6,0,6,-6,1,1,0,1,OTC
5164,16-02-2021 14:00,24 hrs.,pennystocks,PBHG,6,0,6,-6,1,1,0,1,OTC
5164,16-02-2021 14:00,24 hrs.,pennystocks,PCTL,6,6,0,6,1,1,0,1,OTC
5164,16-02-2021 14:00,24 hrs.,pennystocks,PGAS,18,0,18,-18,3,3,0,2,OTC
5164,16-02-2021 14:00,24 hrs.,pennystocks,PHIL,6,6,0,6,1,1,0,1,OTC
5164,16-02-2021 14:00,24 hrs.,pennystocks,PUGE,53,0,53,-53,1,16,17,1,OTC
5164,16-02-2021 14:00,24 hrs.,pennystocks,PURA,16,16,0,16,1,3,6,1,OTC
5164,16-02-2021 14:00,24 hrs.,pennystocks,RNWR,6,0,6,-6,1,1,0,1,OTC
5164,16-02-2021 14:00,24 hrs.,pennystocks,SGMD,104,0,104,-104,1,13,74,1,OTC
5164,16-02-2021 14:00,24 hrs.,pennystocks,SIML,133,133,0,133,1,51,27,1,OTC
5164,16-02-2021 14:00,24 hrs.,pennystocks,SINC,6,6,0,6,1,1,0,1,OTC
5164,16-02-2021 14:00,24 hrs.,pennystocks,SNPW,119,0,119,-119,3,45,17,2,OTC
5164,16-02-2021 14:00,24 hrs.,pennystocks,SRMX,54,6,48,-42,3,16,10,3,OTC
5164,16-02-2021 14:00,24 hrs.,pennystocks,SRNA,6,6,0,6,1,1,0,1,OTC
5164,16-02-2021 14:00,24 hrs.,pennystocks,SSFT,77,6,71,-65,2,31,7,2,OTC
5164,16-02-2021 14:00,24 hrs.,pennystocks,SUGR,6,6,0,6,1,1,0,1,OTC
5164,16-02-2021 14:00,24 hrs.,pennystocks,TLSS,66,0,66,-66,1,8,46,1,OTC
5164,16-02-2021 14:00,24 hrs.,pennystocks,TSNP,6,6,0,6,1,1,0,1,OTC
5164,16-02-2021 14:00,24 hrs.,pennystocks,UNVC,7,0,7,-7,1,1,1,1,OTC
5164,16-02-2021 14:00,24 hrs.,pennystocks,UVSE,7,0,7,-7,1,1,1,1,OTC
5164,16-02-2021 14:00,24 hrs.,pennystocks,VPRB,6,6,0,6,1,1,0,1,OTC
5164,16-02-2021 14:00,24 hrs.,pennystocks,WDLF,6,0,6,-6,1,1,0,1,OTC
5164,16-02-2021 14:00,24 hrs.,pennystocks,AACTF,75,0,75,-75,2,25,17,2,OTC
5164,16-02-2021 14:00,24 hrs.,pennystocks,ABEPF,57,0,57,-57,1,11,31,1,OTC
5164,16-02-2021 14:00,24 hrs.,pennystocks,AMYZF,53,0,53,-53,1,20,9,1,OTC
5164,16-02-2021 14:00,24 hrs.,pennystocks,ARBKF,256,48,208,-160,4,74,92,4,OTC
5164,16-02-2021 14:00,24 hrs.,pennystocks,BYDDY,41,0,41,-41,1,15,7,1,OTC
5164,16-02-2021 14:00,24 hrs.,pennystocks,CANSF,233,0,233,-233,1,100,29,1,OTC
5164,16-02-2021 14:00,24 hrs.,pennystocks,SPCE,97,0,97,-97,1,38,17,1,NYSE
5164,16-02-2021 14:00,24 hrs.,pennystocks,CGC,301,0,301,-301,2,130,33,2,NASDAQ
5164,16-02-2021 14:00,24 hrs.,pennystocks,ESG,101,0,101,-101,1,43,11,1,NASDAQ
5164,16-02-2021 14:00,24 hrs.,pennystocks,MKD,182,182,0,182,1,81,16,1,NASDAQ
5164,16-02-2021 14:00,24 hrs.,pennystocks,OLB,6,0,6,-6,1,1,0,1,NASDAQ
5164,16-02-2021 14:00,24 hrs.,pennystocks,PFC,7,0,7,-7,1,1,1,1,NASDAQ
5164,16-02-2021 14:00,24 hrs.,pennystocks,PLL,34,0,34,-34,1,10,10,1,NASDAQ
5164,16-02-2021 14:00,24 hrs.,pennystocks,PXS,63,63,0,63,2,22,11,1,NASDAQ
5164,16-02-2021 14:00,24 hrs.,pennystocks,AACG,6,0,6,-6,1,1,0,1,NASDAQ
5164,16-02-2021 14:00,24 hrs.,pennystocks,ACST,6,6,0,6,1,1,0,1,NASDAQ
5164,16-02-2021 14:00,24 hrs.,pennystocks,AIKI,63,63,0,63,2,22,11,1,NASDAQ
5164,16-02-2021 14:00,24 hrs.,pennystocks,AKBA,6,0,6,-6,1,1,0,1,NASDAQ
5164,16-02-2021 14:00,24 hrs.,pennystocks,ANTE,9,0,9,-9,1,2,1,1,NASDAQ
5164,16-02-2021 14:00,24 hrs.,pennystocks,APHA,233,0,233,-233,1,100,29,1,NASDAQ
5164,16-02-2021 14:00,24 hrs.,pennystocks,AYTU,63,63,0,63,2,22,11,1,NASDAQ
5164,16-02-2021 14:00,24 hrs.,pennystocks,BEAT,24,24,0,24,1,8,4,1,NASDAQ
5164,16-02-2021 14:00,24 hrs.,pennystocks,BKEP,23,23,0,23,1,8,3,1,NASDAQ
5164,16-02-2021 14:00,24 hrs.,pennystocks,BNGO,97,0,97,-97,1,38,17,1,NASDAQ
5164,16-02-2021 14:00,24 hrs.,pennystocks,BTBT,43,0,43,-43,1,5,29,1,NASDAQ
5164,16-02-2021 14:00,24 hrs.,pennystocks,CASH,291,0,291,-291,1,137,13,1,NASDAQ
5164,16-02-2021 14:00,24 hrs.,pennystocks,CETX,63,63,0,63,2,22,11,1,NASDAQ
5164,16-02-2021 14:00,24 hrs.,pennystocks,CIDM,24,24,0,24,1,6,8,1,NASDAQ
5164,16-02-2021 14:00,24 hrs.,pennystocks,CKPT,19,19,0,19,2,3,5,1,NASDAQ
5164,16-02-2021 14:00,24 hrs.,pennystocks,CRBP,15,15,0,15,1,4,3,1,NASDAQ
5164,16-02-2021 14:00,24 hrs.,pennystocks,CRON,233,0,233,-233,1,100,29,1,NASDAQ
5164,16-02-2021 14:00,24 hrs.,pennystocks,CTRM,7,0,7,-7,1,1,1,1,NASDAQ
5164,16-02-2021 14:00,24 hrs.,pennystocks,DOGZ,23,23,0,23,1,8,3,1,NASDAQ
5164,16-02-2021 14:00,24 hrs.,pennystocks,EDIT,39,0,39,-39,1,0,35,1,NASDAQ
5164,16-02-2021 14:00,24 hrs.,pennystocks,EPSN,23,23,0,23,1,8,3,1,NASDAQ
5164,16-02-2021 14:00,24 hrs.,pennystocks,GNUS,6,6,0,6,1,1,0,1,NASDAQ
5164,16-02-2021 14:00,24 hrs.,pennystocks,GOLD,7,0,7,-7,1,1,1,1,NASDAQ
5164,16-02-2021 14:00,24 hrs.,pennystocks,GRIL,63,63,0,63,2,22,11,1,NASDAQ
5164,16-02-2021 14:00,24 hrs.,pennystocks,KTRA,6,6,0,6,1,1,0,1,NASDAQ
5164,16-02-2021 14:00,24 hrs.,pennystocks,LGHL,23,23,0,23,1,8,3,1,NASDAQ
5164,16-02-2021 14:00,24 hrs.,pennystocks,LIFE,6,0,6,-6,1,1,0,1,NASDAQ
5164,16-02-2021 14:00,24 hrs.,pennystocks,LKCO,23,23,0,23,1,8,3,1,NASDAQ
5164,16-02-2021 14:00,24 hrs.,pennystocks,LOAC,13,0,13,-13,2,2,1,1,NASDAQ
5164,16-02-2021 14:00,24 hrs.,pennystocks,MARA,194,0,194,-194,2,57,72,2,NASDAQ
5164,16-02-2021 14:00,24 hrs.,pennystocks,NAKD,6,6,0,6,1,1,0,1,NASDAQ
5164,16-02-2021 14:00,24 hrs.,pennystocks,NEOS,63,63,0,63,2,22,11,1,NASDAQ
5164,16-02-2021 14:00,24 hrs.,pennystocks,NNDM,12,12,0,12,1,2,4,1,NASDAQ
5164,16-02-2021 14:00,24 hrs.,pennystocks,MYCOF,68,0,68,-68,1,30,4,1,OTC
5164,16-02-2021 14:00,24 hrs.,pennystocks,NMGRF,103,103,0,103,1,32,35,1,OTC
5164,16-02-2021 14:00,24 hrs.,pennystocks,NMTLF,107,107,0,107,2,42,15,2,OTC
5164,16-02-2021 14:00,24 hrs.,pennystocks,OTIVF,6,0,6,-6,1,1,0,1,OTC
5164,16-02-2021 14:00,24 hrs.,pennystocks,PDDTF,34,0,34,-34,1,10,10,1,OTC
5164,16-02-2021 14:00,24 hrs.,pennystocks,POETF,6,0,6,-6,1,1,0,1,OTC
5164,16-02-2021 14:00,24 hrs.,pennystocks,PYRNF,22,0,22,-22,1,6,6,1,OTC
5164,16-02-2021 14:00,24 hrs.,pennystocks,ROCLF,7,0,7,-7,1,1,1,1,OTC
5164,16-02-2021 14:00,24 hrs.,pennystocks,TGIFF,28,0,28,-28,1,10,4,1,OTC
5164,16-02-2021 14:00,24 hrs.,pennystocks,TOBAF,6,0,6,-6,1,1,0,1,OTC
5164,16-02-2021 14:00,24 hrs.,pennystocks,TOWTF,13,0,13,-13,2,2,1,1,OTC
5164,16-02-2021 14:00,24 hrs.,pennystocks,WCEXF,41,0,41,-41,1,6,25,1,OTC
5164,16-02-2021 14:00,24 hrs.,pennystocks,WDDMF,6,0,6,-6,1,1,0,1,OTC
5164,16-02-2021 14:00,24 hrs.,pennystocks,DNN,21,21,0,21,1,7,3,1,AMEX
5164,16-02-2021 14:00,24 hrs.,pennystocks,GSV,6,0,6,-6,1,1,0,1,AMEX
5164,16-02-2021 14:00,24 hrs.,pennystocks,ISR,122,0,122,-122,1,49,20,1,AMEX
5164,16-02-2021 14:00,24 hrs.,pennystocks,NAK,7,0,7,-7,1,1,1,1,AMEX
5164,16-02-2021 14:00,24 hrs.,pennystocks,SYN,6,6,0,6,1,1,0,1,AMEX
5164,16-02-2021 14:00,24 hrs.,pennystocks,UEC,122,0,122,-122,1,49,20,1,AMEX
5164,16-02-2021 14:00,24 hrs.,pennystocks,AMPE,23,23,0,23,1,8,3,1,AMEX
5164,16-02-2021 14:00,24 hrs.,pennystocks,GSAT,6,0,6,-6,1,1,0,1,AMEX
5164,16-02-2021 14:00,24 hrs.,pennystocks,IBIO,6,6,0,6,1,1,0,1,AMEX
5164,16-02-2021 14:00,24 hrs.,pennystocks,INUV,35,0,35,-35,1,10,11,1,AMEX
5152,16-02-2021 12:00,24 hrs.,pennystocks,FDMF,6,6,0,6,1,1,0,1,OTC
5152,16-02-2021 12:00,24 hrs.,pennystocks,FLES,26,7,19,-12,2,1,16,2,OTC
5152,16-02-2021 12:00,24 hrs.,pennystocks,GARB,7,7,0,7,1,1,1,1,OTC
5152,16-02-2021 12:00,24 hrs.,pennystocks,GAXY,30,0,30,-30,1,7,12,1,OTC
5152,16-02-2021 12:00,24 hrs.,pennystocks,GPFT,6,6,0,6,1,1,0,1,OTC
5152,16-02-2021 12:00,24 hrs.,pennystocks,GRNH,74,74,0,74,1,19,32,1,OTC
5152,16-02-2021 12:00,24 hrs.,pennystocks,GTLL,7,7,0,7,1,1,1,1,OTC
5152,16-02-2021 12:00,24 hrs.,pennystocks,GTXO,16,0,16,-16,1,3,6,1,OTC
5152,16-02-2021 12:00,24 hrs.,pennystocks,HALB,46,0,46,-46,1,17,8,1,OTC
5152,16-02-2021 12:00,24 hrs.,pennystocks,HEMP,7,0,7,-7,1,1,1,1,OTC
5152,16-02-2021 12:00,24 hrs.,pennystocks,HIPH,20,20,0,20,1,1,14,1,OTC
5152,16-02-2021 12:00,24 hrs.,pennystocks,IJJP,6,6,0,6,1,1,0,1,OTC
5152,16-02-2021 12:00,24 hrs.,pennystocks,INKW,7,7,0,7,1,1,1,1,OTC
5152,16-02-2021 12:00,24 hrs.,pennystocks,NOVC,12,0,12,-12,2,2,0,1,OTC
5152,16-02-2021 12:00,24 hrs.,pennystocks,OPTI,6,0,6,-6,1,1,0,1,OTC
5152,16-02-2021 12:00,24 hrs.,pennystocks,PBHG,6,0,6,-6,1,1,0,1,OTC
5152,16-02-2021 12:00,24 hrs.,pennystocks,PCTL,6,6,0,6,1,1,0,1,OTC
5152,16-02-2021 12:00,24 hrs.,pennystocks,PGAS,18,0,18,-18,3,3,0,2,OTC
5152,16-02-2021 12:00,24 hrs.,pennystocks,PHIL,6,6,0,6,1,1,0,1,OTC
5152,16-02-2021 12:00,24 hrs.,pennystocks,PUGE,53,0,53,-53,1,16,17,1,OTC
5152,16-02-2021 12:00,24 hrs.,pennystocks,PURA,16,16,0,16,1,3,6,1,OTC
5152,16-02-2021 12:00,24 hrs.,pennystocks,RNWR,6,0,6,-6,1,1,0,1,OTC
5152,16-02-2021 12:00,24 hrs.,pennystocks,SGMD,102,0,102,-102,1,12,74,1,OTC
5152,16-02-2021 12:00,24 hrs.,pennystocks,SIML,130,130,0,130,1,51,24,1,OTC
5152,16-02-2021 12:00,24 hrs.,pennystocks,SINC,6,6,0,6,1,1,0,1,OTC
5152,16-02-2021 12:00,24 hrs.,pennystocks,SNPW,109,0,109,-109,3,40,17,2,OTC
5152,16-02-2021 12:00,24 hrs.,pennystocks,SRMX,52,46,6,40,3,15,10,3,OTC
5152,16-02-2021 12:00,24 hrs.,pennystocks,SSFT,73,6,67,-61,2,29,7,2,OTC
5152,16-02-2021 12:00,24 hrs.,pennystocks,SUGR,6,6,0,6,1,1,0,1,OTC
5152,16-02-2021 12:00,24 hrs.,pennystocks,TLSS,67,67,0,67,1,9,45,1,OTC
5152,16-02-2021 12:00,24 hrs.,pennystocks,TSNP,6,6,0,6,1,1,0,1,OTC
5152,16-02-2021 12:00,24 hrs.,pennystocks,UNVC,7,0,7,-7,1,1,1,1,OTC
5152,16-02-2021 12:00,24 hrs.,pennystocks,UVSE,7,0,7,-7,1,1,1,1,OTC
5152,16-02-2021 12:00,24 hrs.,pennystocks,VPRB,6,6,0,6,1,1,0,1,OTC
5152,16-02-2021 12:00,24 hrs.,pennystocks,WDLF,6,0,6,-6,1,1,0,1,OTC
5152,16-02-2021 12:00,24 hrs.,pennystocks,AACTF,77,0,77,-77,2,26,17,2,OTC
5152,16-02-2021 12:00,24 hrs.,pennystocks,ABEPF,57,0,57,-57,1,11,31,1,OTC
5152,16-02-2021 12:00,24 hrs.,pennystocks,AMYZF,55,55,0,55,1,21,9,1,OTC
5152,16-02-2021 12:00,24 hrs.,pennystocks,ARBKF,218,0,218,-218,3,65,76,3,OTC
5152,16-02-2021 12:00,24 hrs.,pennystocks,BYDDY,43,0,43,-43,1,16,7,1,OTC
5152,16-02-2021 12:00,24 hrs.,pennystocks,CANSF,229,229,0,229,1,98,29,1,OTC
5152,16-02-2021 12:00,24 hrs.,pennystocks,CYDVF,6,0,6,-6,1,1,0,1,OTC
5152,16-02-2021 12:00,24 hrs.,pennystocks,EFLVF,6,0,6,-6,1,1,0,1,OTC
5152,16-02-2021 12:00,24 hrs.,pennystocks,EPWCF,6,0,6,-6,1,1,0,1,OTC
5152,16-02-2021 12:00,24 hrs.,pennystocks,ERPNF,95,0,95,-95,1,38,15,1,OTC
5152,16-02-2021 12:00,24 hrs.,pennystocks,FUNFF,6,0,6,-6,1,1,0,1,OTC
5152,16-02-2021 12:00,24 hrs.,pennystocks,GWMGF,6,0,6,-6,1,1,0,1,OTC
5152,16-02-2021 12:00,24 hrs.,pennystocks,HITIF,57,0,57,-57,1,11,31,1,OTC
5152,16-02-2021 12:00,24 hrs.,pennystocks,HTZGQ,6,6,0,6,1,1,0,1,OTC
5152,16-02-2021 12:00,24 hrs.,pennystocks,HUTMF,47,0,47,-47,1,7,29,1,OTC
5152,16-02-2021 12:00,24 hrs.,pennystocks,AABB,6,0,6,-6,1,1,0,1,OTC
5152,16-02-2021 12:00,24 hrs.,pennystocks,ABML,95,0,95,-95,1,38,15,1,OTC
5152,16-02-2021 12:00,24 hrs.,pennystocks,ABQQ,27,27,0,27,2,7,5,1,OTC
5152,16-02-2021 12:00,24 hrs.,pennystocks,ABWN,7,0,7,-7,1,1,1,1,OTC
5152,16-02-2021 12:00,24 hrs.,pennystocks,AGYP,9,0,9,-9,1,2,1,1,OTC
5152,16-02-2021 12:00,24 hrs.,pennystocks,AITX,608,252,356,-104,9,225,122,8,OTC
5152,16-02-2021 12:00,24 hrs.,pennystocks,ALPP,29,0,29,-29,2,8,5,2,OTC
5152,16-02-2021 12:00,24 hrs.,pennystocks,ALYI,51,0,51,-51,1,14,19,1,OTC
5152,16-02-2021 12:00,24 hrs.,pennystocks,APYP,6,6,0,6,1,1,0,1,OTC
5152,16-02-2021 12:00,24 hrs.,pennystocks,ASTI,118,67,51,16,4,23,56,4,OTC
5152,16-02-2021 12:00,24 hrs.,pennystocks,BBRW,80,74,6,68,2,20,32,2,OTC
5152,16-02-2021 12:00,24 hrs.,pennystocks,BCAP,6,0,6,-6,1,1,0,1,OTC
5152,16-02-2021 12:00,24 hrs.,pennystocks,BIEL,6,0,6,-6,1,1,0,1,OTC
5152,16-02-2021 12:00,24 hrs.,pennystocks,BLSP,7,0,7,-7,1,1,1,1,OTC
5152,16-02-2021 12:00,24 hrs.,pennystocks,BNGI,6,6,0,6,1,1,0,1,OTC
5152,16-02-2021 12:00,24 hrs.,pennystocks,BOTH,12,12,0,12,2,2,0,1,OTC
5152,16-02-2021 12:00,24 hrs.,pennystocks,BOTY,14,7,7,0,2,2,2,2,OTC
5152,16-02-2021 12:00,24 hrs.,pennystocks,BRRN,19,19,0,19,3,3,1,2,OTC
5152,16-02-2021 12:00,24 hrs.,pennystocks,CBBT,387,12,375,-363,6,121,121,5,OTC
5152,16-02-2021 12:00,24 hrs.,pennystocks,CBDL,12,6,6,0,2,2,0,2,OTC
5152,16-02-2021 12:00,24 hrs.,pennystocks,CBTC,28,28,0,28,1,8,8,1,OTC
5152,16-02-2021 12:00,24 hrs.,pennystocks,CCTL,6,0,6,-6,1,1,0,1,OTC
5152,16-02-2021 12:00,24 hrs.,pennystocks,CYDY,7,0,7,-7,1,1,1,1,OTC
5152,16-02-2021 12:00,24 hrs.,pennystocks,DPLS,7,0,7,-7,1,1,1,1,OTC
5152,16-02-2021 12:00,24 hrs.,pennystocks,ENZC,6,6,0,6,1,1,0,1,OTC
5152,16-02-2021 12:00,24 hrs.,pennystocks,ERBB,74,74,0,74,1,19,32,1,OTC
5152,16-02-2021 12:00,24 hrs.,pennystocks,ETFM,252,27,225,-198,5,91,50,4,OTC
5152,16-02-2021 12:00,24 hrs.,pennystocks,NAK,7,7,0,7,1,1,1,1,AMEX
5152,16-02-2021 12:00,24 hrs.,pennystocks,SYN,6,6,0,6,1,1,0,1,AMEX
5152,16-02-2021 12:00,24 hrs.,pennystocks,UEC,119,119,0,119,1,48,19,1,AMEX
5152,16-02-2021 12:00,24 hrs.,pennystocks,AMPE,22,22,0,22,1,8,2,1,AMEX
5152,16-02-2021 12:00,24 hrs.,pennystocks,GSAT,6,6,0,6,1,1,0,1,AMEX
5152,16-02-2021 12:00,24 hrs.,pennystocks,IBIO,6,6,0,6,1,1,0,1,AMEX
5152,16-02-2021 12:00,24 hrs.,pennystocks,INUV,34,0,34,-34,1,10,10,1,AMEX
5152,16-02-2021 12:00,24 hrs.,pennystocks,UAMY,37,0,37,-37,1,9,15,1,AMEX
5152,16-02-2021 12:00,24 hrs.,pennystocks,ACB,229,229,0,229,1,98,29,1,NYSE
5152,16-02-2021 12:00,24 hrs.,pennystocks,AFC,6,6,0,6,1,1,0,1,NYSE
5152,16-02-2021 12:00,24 hrs.,pennystocks,AMC,6,6,0,6,1,1,0,1,NYSE
5152,16-02-2021 12:00,24 hrs.,pennystocks,ASX,131,125,6,119,3,50,19,3,NYSE
5152,16-02-2021 12:00,24 hrs.,pennystocks,BMO,229,229,0,229,1,98,29,1,NYSE
5152,16-02-2021 12:00,24 hrs.,pennystocks,BYD,43,0,43,-43,1,16,7,1,NYSE
5152,16-02-2021 12:00,24 hrs.,pennystocks,CBD,235,229,6,223,2,99,29,2,NYSE
5152,16-02-2021 12:00,24 hrs.,pennystocks,DSX,22,22,0,22,1,8,2,1,NYSE
5152,16-02-2021 12:00,24 hrs.,pennystocks,EAT,235,229,6,223,2,99,29,2,NYSE
5152,16-02-2021 12:00,24 hrs.,pennystocks,FPL,22,22,0,22,1,8,2,1,NYSE
5152,16-02-2021 12:00,24 hrs.,pennystocks,MUX,69,0,69,-69,1,16,33,1,NYSE
5152,16-02-2021 12:00,24 hrs.,pennystocks,NAT,22,22,0,22,1,8,2,1,NYSE
5152,16-02-2021 12:00,24 hrs.,pennystocks,NAV,26,0,26,-26,1,10,2,1,NYSE
5152,16-02-2021 12:00,24 hrs.,pennystocks,NYT,61,0,61,-61,2,11,31,1,NYSE
5152,16-02-2021 12:00,24 hrs.,pennystocks,PEG,256,256,0,256,1,120,12,1,NYSE
5152,16-02-2021 12:00,24 hrs.,pennystocks,PEN,119,119,0,119,1,48,19,1,NYSE
5152,16-02-2021 12:00,24 hrs.,pennystocks,PKG,183,0,183,-183,1,70,39,1,NYSE
5152,16-02-2021 12:00,24 hrs.,pennystocks,SOS,26,19,7,12,4,4,2,3,NYSE
5152,16-02-2021 12:00,24 hrs.,pennystocks,THC,235,229,6,223,2,99,29,2,NYSE
5152,16-02-2021 12:00,24 hrs.,pennystocks,CSPR,6,0,6,-6,1,1,0,1,NYSE
5152,16-02-2021 12:00,24 hrs.,pennystocks,FLOW,256,256,0,256,1,120,12,1,NYSE
5152,16-02-2021 12:00,24 hrs.,pennystocks,FUBO,24,24,0,24,1,6,8,1,NYSE
5152,16-02-2021 12:00,24 hrs.,pennystocks,PLTR,21,0,21,-21,1,5,7,1,NYSE
5152,16-02-2021 12:00,24 hrs.,pennystocks,SPCE,95,0,95,-95,1,38,15,1,NYSE
5152,16-02-2021 12:00,24 hrs.,pennystocks,CGC,297,229,68,161,2,128,33,2,NASDAQ
5152,16-02-2021 12:00,24 hrs.,pennystocks,ESG,97,0,97,-97,1,41,11,1,NASDAQ
5152,16-02-2021 12:00,24 hrs.,pennystocks,FNX,6,0,6,-6,1,1,0,1,NASDAQ
5152,16-02-2021 12:00,24 hrs.,pennystocks,OLB,6,0,6,-6,1,1,0,1,NASDAQ
5152,16-02-2021 12:00,24 hrs.,pennystocks,PFC,7,0,7,-7,1,1,1,1,NASDAQ
5152,16-02-2021 12:00,24 hrs.,pennystocks,PLL,38,0,38,-38,1,12,10,1,NASDAQ
5152,16-02-2021 12:00,24 hrs.,pennystocks,PXS,57,57,0,57,2,19,11,1,NASDAQ
5152,16-02-2021 12:00,24 hrs.,pennystocks,AACG,6,0,6,-6,1,1,0,1,NASDAQ
5152,16-02-2021 12:00,24 hrs.,pennystocks,ACST,6,6,0,6,1,1,0,1,NASDAQ
5152,16-02-2021 12:00,24 hrs.,pennystocks,AIKI,57,57,0,57,2,19,11,1,NASDAQ
5152,16-02-2021 12:00,24 hrs.,pennystocks,AKBA,6,0,6,-6,1,1,0,1,NASDAQ
5152,16-02-2021 12:00,24 hrs.,pennystocks,ANTE,9,0,9,-9,1,2,1,1,NASDAQ
5152,16-02-2021 12:00,24 hrs.,pennystocks,APHA,229,229,0,229,1,98,29,1,NASDAQ
5152,16-02-2021 12:00,24 hrs.,pennystocks,ATOS,6,0,6,-6,1,1,0,1,NASDAQ
5152,16-02-2021 12:00,24 hrs.,pennystocks,AYTU,57,57,0,57,2,19,11,1,NASDAQ
5152,16-02-2021 12:00,24 hrs.,pennystocks,BEAT,22,22,0,22,1,7,4,1,NASDAQ
5152,16-02-2021 12:00,24 hrs.,pennystocks,HVBTF,6,0,6,-6,1,1,0,1,OTC
5152,16-02-2021 12:00,24 hrs.,pennystocks,KBEVF,7,7,0,7,1,1,1,1,OTC
5152,16-02-2021 12:00,24 hrs.,pennystocks,MLLOF,97,0,97,-97,1,41,11,1,OTC
5152,16-02-2021 12:00,24 hrs.,pennystocks,MMNFF,6,0,6,-6,1,1,0,1,OTC
5152,16-02-2021 12:00,24 hrs.,pennystocks,MMTIF,22,0,22,-22,1,3,12,1,OTC
5152,16-02-2021 12:00,24 hrs.,pennystocks,MNXXF,45,45,0,45,3,9,15,2,OTC
5152,16-02-2021 12:00,24 hrs.,pennystocks,MPXOF,10,10,0,10,1,2,2,1,OTC
5152,16-02-2021 12:00,24 hrs.,pennystocks,MYCOF,68,0,68,-68,1,30,4,1,OTC
5152,16-02-2021 12:00,24 hrs.,pennystocks,INND,77,77,0,77,1,23,27,1,OTC
5152,16-02-2021 12:00,24 hrs.,pennystocks,KOAN,4,0,4,-4,1,0,0,1,OTC
5152,16-02-2021 12:00,24 hrs.,pennystocks,KOSK,11,11,0,11,1,2,3,1,OTC
5152,16-02-2021 12:00,24 hrs.,pennystocks,KULR,43,0,43,-43,1,16,7,1,OTC
5152,16-02-2021 12:00,24 hrs.,pennystocks,KWBT,20,0,20,-20,1,6,4,1,OTC
5152,16-02-2021 12:00,24 hrs.,pennystocks,LQMT,6,0,6,-6,1,1,0,1,OTC
5152,16-02-2021 12:00,24 hrs.,pennystocks,MCOA,74,74,0,74,1,19,32,1,OTC
5152,16-02-2021 12:00,24 hrs.,pennystocks,MJNA,21,21,0,21,3,3,3,1,OTC
5152,16-02-2021 12:00,24 hrs.,pennystocks,NVCN,44,0,44,-44,1,11,18,1,NASDAQ
5152,16-02-2021 12:00,24 hrs.,pennystocks,OBSV,150,0,150,-150,1,49,48,1,NASDAQ
5152,16-02-2021 12:00,24 hrs.,pennystocks,OTLK,6,0,6,-6,1,1,0,1,NASDAQ
5152,16-02-2021 12:00,24 hrs.,pennystocks,PANL,22,22,0,22,1,8,2,1,NASDAQ
5152,16-02-2021 12:00,24 hrs.,pennystocks,PFMT,6,6,0,6,1,1,0,1,NASDAQ
5152,16-02-2021 12:00,24 hrs.,pennystocks,PHAR,26,0,26,-26,1,10,2,1,NASDAQ
5152,16-02-2021 12:00,24 hrs.,pennystocks,PLUS,6,0,6,-6,1,1,0,1,NASDAQ
5152,16-02-2021 12:00,24 hrs.,pennystocks,PTON,95,0,95,-95,1,38,15,1,NASDAQ
5152,16-02-2021 12:00,24 hrs.,pennystocks,RAVE,57,57,0,57,2,19,11,1,NASDAQ
5152,16-02-2021 12:00,24 hrs.,pennystocks,RIOT,206,0,206,-206,2,63,72,2,NASDAQ
5152,16-02-2021 12:00,24 hrs.,pennystocks,ROKU,24,24,0,24,1,6,8,1,NASDAQ
5152,16-02-2021 12:00,24 hrs.,pennystocks,SHIP,50,0,50,-50,1,9,28,1,NASDAQ
5152,16-02-2021 12:00,24 hrs.,pennystocks,SNDL,51,32,19,13,7,9,5,6,NASDAQ
5152,16-02-2021 12:00,24 hrs.,pennystocks,SNGX,64,64,0,64,3,20,12,2,NASDAQ
5152,16-02-2021 12:00,24 hrs.,pennystocks,TLRY,229,229,0,229,1,98,29,1,NASDAQ
5152,16-02-2021 12:00,24 hrs.,pennystocks,TRCH,12,0,12,-12,1,0,8,1,NASDAQ
5152,16-02-2021 12:00,24 hrs.,pennystocks,TRVG,57,57,0,57,2,19,11,1,NASDAQ
5152,16-02-2021 12:00,24 hrs.,pennystocks,TSLA,43,0,43,-43,1,16,7,1,NASDAQ
5152,16-02-2021 12:00,24 hrs.,pennystocks,TTOO,6,0,6,-6,1,1,0,1,NASDAQ
5152,16-02-2021 12:00,24 hrs.,pennystocks,TXMD,6,0,6,-6,1,1,0,1,NASDAQ
5152,16-02-2021 12:00,24 hrs.,pennystocks,VBIV,6,6,0,6,1,1,0,1,NASDAQ
5152,16-02-2021 12:00,24 hrs.,pennystocks,XSPA,380,21,359,-338,4,143,78,4,NASDAQ
5152,16-02-2021 12:00,24 hrs.,pennystocks,ZYNE,13,13,0,13,1,3,3,1,NASDAQ
5152,16-02-2021 12:00,24 hrs.,pennystocks,BKEP,22,22,0,22,1,8,2,1,NASDAQ
5152,16-02-2021 12:00,24 hrs.,pennystocks,BNGO,95,0,95,-95,1,38,15,1,NASDAQ
5152,16-02-2021 12:00,24 hrs.,pennystocks,BTBT,47,0,47,-47,1,7,29,1,NASDAQ
5152,16-02-2021 12:00,24 hrs.,pennystocks,CASH,256,256,0,256,1,120,12,1,NASDAQ
5152,16-02-2021 12:00,24 hrs.,pennystocks,CETX,57,57,0,57,2,19,11,1,NASDAQ
5152,16-02-2021 12:00,24 hrs.,pennystocks,CIDM,24,24,0,24,1,6,8,1,NASDAQ
5152,16-02-2021 12:00,24 hrs.,pennystocks,CKPT,19,19,0,19,2,3,5,1,NASDAQ
5152,16-02-2021 12:00,24 hrs.,pennystocks,CRBP,13,13,0,13,1,3,3,1,NASDAQ
5152,16-02-2021 12:00,24 hrs.,pennystocks,CRON,229,229,0,229,1,98,29,1,NASDAQ
5152,16-02-2021 12:00,24 hrs.,pennystocks,CTRM,7,0,7,-7,1,1,1,1,NASDAQ
5152,16-02-2021 12:00,24 hrs.,pennystocks,DOGZ,22,22,0,22,1,8,2,1,NASDAQ
5152,16-02-2021 12:00,24 hrs.,pennystocks,EDIT,39,0,39,-39,1,0,35,1,NASDAQ
5152,16-02-2021 12:00,24 hrs.,pennystocks,EPSN,22,22,0,22,1,8,2,1,NASDAQ
5152,16-02-2021 12:00,24 hrs.,pennystocks,GNUS,6,6,0,6,1,1,0,1,NASDAQ
5152,16-02-2021 12:00,24 hrs.,pennystocks,GOLD,7,0,7,-7,1,1,1,1,NASDAQ
5152,16-02-2021 12:00,24 hrs.,pennystocks,GRIL,57,57,0,57,2,19,11,1,NASDAQ
5152,16-02-2021 12:00,24 hrs.,pennystocks,KTRA,6,6,0,6,1,1,0,1,NASDAQ
5152,16-02-2021 12:00,24 hrs.,pennystocks,LGHL,22,22,0,22,1,8,2,1,NASDAQ
5152,16-02-2021 12:00,24 hrs.,pennystocks,LIFE,6,0,6,-6,1,1,0,1,NASDAQ
5152,16-02-2021 12:00,24 hrs.,pennystocks,LKCO,22,22,0,22,1,8,2,1,NASDAQ
5152,16-02-2021 12:00,24 hrs.,pennystocks,LOAC,13,0,13,-13,2,2,1,1,NASDAQ
5152,16-02-2021 12:00,24 hrs.,pennystocks,MARA,206,0,206,-206,2,63,72,2,NASDAQ
5152,16-02-2021 12:00,24 hrs.,pennystocks,NAKD,6,6,0,6,1,1,0,1,NASDAQ
5152,16-02-2021 12:00,24 hrs.,pennystocks,NEOS,57,57,0,57,2,19,11,1,NASDAQ
5152,16-02-2021 12:00,24 hrs.,pennystocks,NNDM,12,12,0,12,1,2,4,1,NASDAQ
5152,16-02-2021 12:00,24 hrs.,pennystocks,NMGRF,65,65,0,65,1,20,21,1,OTC
5152,16-02-2021 12:00,24 hrs.,pennystocks,NMTLF,73,73,0,73,2,28,9,2,OTC
5152,16-02-2021 12:00,24 hrs.,pennystocks,OTIVF,6,0,6,-6,1,1,0,1,OTC
5152,16-02-2021 12:00,24 hrs.,pennystocks,PDDTF,38,0,38,-38,1,12,10,1,OTC
5152,16-02-2021 12:00,24 hrs.,pennystocks,POETF,6,0,6,-6,1,1,0,1,OTC
5152,16-02-2021 12:00,24 hrs.,pennystocks,PYRNF,24,0,24,-24,1,7,6,1,OTC
5152,16-02-2021 12:00,24 hrs.,pennystocks,ROCLF,7,0,7,-7,1,1,1,1,OTC
5152,16-02-2021 12:00,24 hrs.,pennystocks,TGIFF,24,0,24,-24,1,8,4,1,OTC
5152,16-02-2021 12:00,24 hrs.,pennystocks,TOBAF,6,0,6,-6,1,1,0,1,OTC
5152,16-02-2021 12:00,24 hrs.,pennystocks,TOWTF,13,0,13,-13,2,2,1,1,OTC
5152,16-02-2021 12:00,24 hrs.,pennystocks,TTTPF,7,0,7,-7,1,1,1,1,OTC
5152,16-02-2021 12:00,24 hrs.,pennystocks,WCEXF,41,0,41,-41,1,7,23,1,OTC
5152,16-02-2021 12:00,24 hrs.,pennystocks,WDDMF,6,0,6,-6,1,1,0,1,OTC
5152,16-02-2021 12:00,24 hrs.,pennystocks,DNN,25,25,0,25,1,9,3,1,AMEX
5152,16-02-2021 12:00,24 hrs.,pennystocks,GSV,6,0,6,-6,1,1,0,1,AMEX
5152,16-02-2021 12:00,24 hrs.,pennystocks,ISR,119,119,0,119,1,48,19,1,AMEX
5140,16-02-2021 10:00,24 hrs.,SPACs,CDIX,6,6,0,6,1,1,0,1,OTC
5140,16-02-2021 10:00,24 hrs.,SPACs,USPS,329,329,0,329,1,133,59,1,OTC
5140,16-02-2021 10:00,24 hrs.,SPACs,LVMHF,25,25,0,25,1,10,1,1,OTC
5140,16-02-2021 10:00,24 hrs.,SPACs,GSV,124,124,0,124,1,42,36,1,AMEX
5140,16-02-2021 10:00,24 hrs.,SPACs,CCO,124,124,0,124,1,42,36,1,NYSE
5140,16-02-2021 10:00,24 hrs.,SPACs,EQD,19,19,0,19,1,5,5,1,NYSE
5140,16-02-2021 10:00,24 hrs.,SPACs,EVA,10,0,10,-10,1,0,6,1,NYSE
5140,16-02-2021 10:00,24 hrs.,SPACs,GIK,336,336,0,336,2,134,60,2,NYSE
5140,16-02-2021 10:00,24 hrs.,SPACs,GME,328,0,328,-328,1,119,86,1,NYSE
5140,16-02-2021 10:00,24 hrs.,SPACs,HPS,124,124,0,124,1,42,36,1,NYSE
5140,16-02-2021 10:00,24 hrs.,SPACs,MGM,124,124,0,124,1,42,36,1,NYSE
5140,16-02-2021 10:00,24 hrs.,SPACs,NRZ,124,124,0,124,1,42,36,1,NYSE
5140,16-02-2021 10:00,24 hrs.,SPACs,RTP,328,0,328,-328,1,119,86,1,NYSE
5140,16-02-2021 10:00,24 hrs.,SPACs,SBG,72,72,0,72,2,8,48,2,NYSE
5140,16-02-2021 10:00,24 hrs.,SPACs,ACIC,439,0,439,-439,3,145,137,3,NYSE
5140,16-02-2021 10:00,24 hrs.,SPACs,BOAC,13,13,0,13,2,2,1,1,NYSE
5140,16-02-2021 10:00,24 hrs.,SPACs,CCIV,1291,283,1008,-725,6,473,321,6,NYSE
5140,16-02-2021 10:00,24 hrs.,SPACs,CTAC,8,0,8,-8,1,1,2,1,NYSE
5140,16-02-2021 10:00,24 hrs.,SPACs,DNMR,328,0,328,-328,1,119,86,1,NYSE
5140,16-02-2021 10:00,24 hrs.,SPACs,FGNA,328,0,328,-328,1,119,86,1,NYSE
5140,16-02-2021 10:00,24 hrs.,SPACs,FUSE,375,47,328,-281,2,126,115,2,NYSE
5140,16-02-2021 10:00,24 hrs.,SPACs,IPOD,36,0,36,-36,1,6,20,1,NYSE
5140,16-02-2021 10:00,24 hrs.,SPACs,IPOE,180,7,173,-166,3,53,62,3,NYSE
5140,16-02-2021 10:00,24 hrs.,SPACs,IPOF,43,7,36,-29,2,7,21,2,NYSE
5140,16-02-2021 10:00,24 hrs.,SPACs,PDAC,427,333,94,239,8,154,87,6,NYSE
5140,16-02-2021 10:00,24 hrs.,SPACs,PSTH,340,0,340,-340,3,121,86,2,NYSE
5140,16-02-2021 10:00,24 hrs.,SPACs,SNPR,328,0,328,-328,1,119,86,1,NYSE
5140,16-02-2021 10:00,24 hrs.,SPACs,CFO,124,124,0,124,1,42,36,1,NASDAQ
5140,16-02-2021 10:00,24 hrs.,SPACs,ESG,37,37,0,37,1,10,13,1,NASDAQ
5140,16-02-2021 10:00,24 hrs.,SPACs,JAN,37,0,37,-37,1,15,3,1,NASDAQ
5140,16-02-2021 10:00,24 hrs.,SPACs,VIH,144,0,144,-144,2,47,42,2,NASDAQ
5140,16-02-2021 10:00,24 hrs.,SPACs,AACQ,328,0,328,-328,1,119,86,1,NASDAQ
5140,16-02-2021 10:00,24 hrs.,SPACs,ARYA,328,0,328,-328,1,119,86,1,NASDAQ
5140,16-02-2021 10:00,24 hrs.,SPACs,CIIC,42,0,42,-42,1,7,24,1,NASDAQ
5140,16-02-2021 10:00,24 hrs.,SPACs,CMLF,328,0,328,-328,1,119,86,1,NASDAQ
5140,16-02-2021 10:00,24 hrs.,SPACs,DCRB,328,0,328,-328,1,119,86,1,NASDAQ
5140,16-02-2021 10:00,24 hrs.,SPACs,ETAC,7,7,0,7,1,1,1,1,NASDAQ
5140,16-02-2021 10:00,24 hrs.,SPACs,EXPC,114,0,114,-114,2,25,56,2,NASDAQ
5140,16-02-2021 10:00,24 hrs.,SPACs,FCAC,328,0,328,-328,1,119,86,1,NASDAQ
5140,16-02-2021 10:00,24 hrs.,SPACs,FIII,7,7,0,7,1,1,1,1,NASDAQ
5140,16-02-2021 10:00,24 hrs.,SPACs,GRNV,328,0,328,-328,1,119,86,1,NASDAQ
5140,16-02-2021 10:00,24 hrs.,trakstocks,MVIS,17,0,17,-17,1,5,3,1,NASDAQ
5140,16-02-2021 10:00,24 hrs.,trakstocks,NEPT,8,8,0,8,1,2,0,1,NASDAQ
5140,16-02-2021 10:00,24 hrs.,trakstocks,OBSV,14,14,0,14,1,5,0,1,NASDAQ
5140,16-02-2021 10:00,24 hrs.,trakstocks,RNET,13,13,0,13,1,3,3,1,NASDAQ
5140,16-02-2021 10:00,24 hrs.,trakstocks,SELB,37,0,37,-37,1,12,9,1,NASDAQ
5140,16-02-2021 10:00,24 hrs.,trakstocks,SNDL,66,66,0,66,2,25,8,1,NASDAQ
5140,16-02-2021 10:00,24 hrs.,trakstocks,THMO,6,6,0,6,1,0,2,1,NASDAQ
5140,16-02-2021 10:00,24 hrs.,trakstocks,TNXP,40,40,0,40,1,15,6,1,NASDAQ
5140,16-02-2021 10:00,24 hrs.,trakstocks,TRCH,143,110,33,77,3,45,41,3,NASDAQ
5140,16-02-2021 10:00,24 hrs.,trakstocks,TRIT,67,0,67,-67,2,22,15,2,NASDAQ
5140,16-02-2021 10:00,24 hrs.,trakstocks,TTOO,28,0,28,-28,1,10,4,1,NASDAQ
5140,16-02-2021 10:00,24 hrs.,StockMarket,BOTH,129,129,0,129,1,49,27,1,OTC
5140,16-02-2021 10:00,24 hrs.,StockMarket,PHIL,12,12,0,12,1,3,2,1,OTC
5140,16-02-2021 10:00,24 hrs.,StockMarket,RCHA,6,0,6,-6,1,1,0,1,OTC
5140,16-02-2021 10:00,24 hrs.,StockMarket,SGMD,6,0,6,-6,1,1,0,1,OTC
5140,16-02-2021 10:00,24 hrs.,StockMarket,MMNFF,6,0,6,-6,1,1,0,1,OTC
5140,16-02-2021 10:00,24 hrs.,StockMarket,PYRNF,6,6,0,6,1,1,0,1,OTC
5140,16-02-2021 10:00,24 hrs.,StockMarket,RNRRF,6,6,0,6,1,1,0,1,OTC
5140,16-02-2021 10:00,24 hrs.,StockMarket,DPW,6,0,6,-6,1,1,0,1,AMEX
5140,16-02-2021 10:00,24 hrs.,StockMarket,ITP,38,0,38,-38,1,14,6,1,AMEX
5140,16-02-2021 10:00,24 hrs.,StockMarket,AMC,408,27,381,-354,4,169,54,4,NYSE
5140,16-02-2021 10:00,24 hrs.,StockMarket,ASX,12,12,0,12,1,3,2,1,NYSE
5140,16-02-2021 10:00,24 hrs.,StockMarket,DHI,34,0,34,-34,1,15,0,1,NYSE
5140,16-02-2021 10:00,24 hrs.,StockMarket,GME,3857,3706,151,3555,10,1776,265,10,NYSE
5140,16-02-2021 10:00,24 hrs.,StockMarket,GPN,34,0,34,-34,1,15,0,1,NYSE
5140,16-02-2021 10:00,24 hrs.,StockMarket,ICE,38,0,38,-38,1,14,6,1,NYSE
5140,16-02-2021 10:00,24 hrs.,StockMarket,NIO,37,0,37,-37,1,14,5,1,NYSE
5140,16-02-2021 10:00,24 hrs.,StockMarket,OMF,34,0,34,-34,1,15,0,1,NYSE
5140,16-02-2021 10:00,24 hrs.,StockMarket,PHI,12,12,0,12,1,3,2,1,NYSE
5140,16-02-2021 10:00,24 hrs.,StockMarket,PSX,34,0,34,-34,1,15,0,1,NYSE
5140,16-02-2021 10:00,24 hrs.,StockMarket,RSI,12,12,0,12,1,3,2,1,NYSE
5140,16-02-2021 10:00,24 hrs.,StockMarket,SOS,23,23,0,23,1,5,9,1,NYSE
5140,16-02-2021 10:00,24 hrs.,StockMarket,ALLY,34,0,34,-34,1,15,0,1,NYSE
5140,16-02-2021 10:00,24 hrs.,StockMarket,CCIV,39,33,6,27,3,7,13,3,NYSE
5140,16-02-2021 10:00,24 hrs.,StockMarket,COTY,11,11,0,11,1,2,3,1,NYSE
5140,16-02-2021 10:00,24 hrs.,StockMarket,HUYA,6,0,6,-6,1,1,0,1,NYSE
5140,16-02-2021 10:00,24 hrs.,StockMarket,SHOP,30,30,0,30,1,6,14,1,NYSE
5140,16-02-2021 10:00,24 hrs.,StockMarket,TALO,6,6,0,6,1,1,0,1,NYSE
5140,16-02-2021 10:00,24 hrs.,StockMarket,TWLO,34,0,34,-34,1,15,0,1,NYSE
5140,16-02-2021 10:00,24 hrs.,StockMarket,WORK,7,0,7,-7,1,0,3,1,NYSE
5140,16-02-2021 10:00,24 hrs.,StockMarket,HAS,12,12,0,12,1,3,2,1,NASDAQ
5140,16-02-2021 10:00,24 hrs.,StockMarket,PLL,12,12,0,12,1,3,2,1,NASDAQ
5140,16-02-2021 10:00,24 hrs.,StockMarket,ADBE,34,0,34,-34,1,15,0,1,NASDAQ
5140,16-02-2021 10:00,24 hrs.,StockMarket,AMZN,34,0,34,-34,1,15,0,1,NASDAQ
5140,16-02-2021 10:00,24 hrs.,StockMarket,ANTE,8,0,8,-8,1,2,0,1,NASDAQ
5140,16-02-2021 10:00,24 hrs.,StockMarket,ATOS,6,0,6,-6,1,1,0,1,NASDAQ
5140,16-02-2021 10:00,24 hrs.,StockMarket,CRSR,49,49,0,49,1,12,21,1,NASDAQ
5140,16-02-2021 10:00,24 hrs.,StockMarket,EXPI,32,32,0,32,1,4,20,1,NASDAQ
5140,16-02-2021 10:00,24 hrs.,StockMarket,FIII,16,0,16,-16,1,3,6,1,NASDAQ
5140,16-02-2021 10:00,24 hrs.,StockMarket,GILD,14,0,14,-14,1,1,8,1,NASDAQ
5140,16-02-2021 10:00,24 hrs.,StockMarket,GILT,6,6,0,6,1,1,0,1,NASDAQ
5140,16-02-2021 10:00,24 hrs.,StockMarket,GTHX,90,12,78,-66,3,26,26,2,NASDAQ
5140,16-02-2021 10:00,24 hrs.,StockMarket,IMVT,34,0,34,-34,1,15,0,1,NASDAQ
5140,16-02-2021 10:00,24 hrs.,StockMarket,JACK,6,0,6,-6,1,1,0,1,NASDAQ
5140,16-02-2021 10:00,24 hrs.,StockMarket,MVIS,6,0,6,-6,1,1,0,1,NASDAQ
5140,16-02-2021 10:00,24 hrs.,StockMarket,NAKD,6,0,6,-6,1,1,0,1,NASDAQ
5140,16-02-2021 10:00,24 hrs.,StockMarket,OTLK,12,6,6,0,2,2,0,2,NASDAQ
5140,16-02-2021 10:00,24 hrs.,StockMarket,POWW,87,0,87,-87,1,30,23,1,NASDAQ
5140,16-02-2021 10:00,24 hrs.,StockMarket,PTGX,4,0,4,-4,1,0,0,1,NASDAQ
5140,16-02-2021 10:00,24 hrs.,trakstocks,COMS,95,95,0,95,1,30,31,1,OTC
5140,16-02-2021 10:00,24 hrs.,trakstocks,EMBI,14,14,0,14,1,5,0,1,OTC
5140,16-02-2021 10:00,24 hrs.,trakstocks,GMEV,11,11,0,11,1,3,1,1,OTC
5140,16-02-2021 10:00,24 hrs.,trakstocks,MOST,6,0,6,-6,1,1,0,1,OTC
5140,16-02-2021 10:00,24 hrs.,trakstocks,NOUV,6,6,0,6,1,1,0,1,OTC
5140,16-02-2021 10:00,24 hrs.,trakstocks,OPTI,10,10,0,10,1,3,0,1,OTC
5140,16-02-2021 10:00,24 hrs.,trakstocks,SNPW,23,23,0,23,1,9,1,1,OTC
5140,16-02-2021 10:00,24 hrs.,trakstocks,SSFT,8,0,8,-8,1,0,4,1,OTC
5140,16-02-2021 10:00,24 hrs.,trakstocks,ARBKF,6,0,6,-6,1,1,0,1,OTC
5140,16-02-2021 10:00,24 hrs.,trakstocks,FUNFF,10,10,0,10,2,1,0,2,OTC
5140,16-02-2021 10:00,24 hrs.,trakstocks,MEG,16,0,16,-16,1,5,2,1,NYSE
5140,16-02-2021 10:00,24 hrs.,trakstocks,THC,14,14,0,14,1,5,0,1,NYSE
5140,16-02-2021 10:00,24 hrs.,trakstocks,ALLY,16,0,16,-16,1,5,2,1,NYSE
5140,16-02-2021 10:00,24 hrs.,trakstocks,ARGO,6,0,6,-6,1,1,0,1,NYSE
5140,16-02-2021 10:00,24 hrs.,trakstocks,SKLZ,31,0,31,-31,1,11,5,1,NYSE
5140,16-02-2021 10:00,24 hrs.,trakstocks,ATOS,43,43,0,43,1,16,7,1,NASDAQ
5140,16-02-2021 10:00,24 hrs.,trakstocks,AYRO,13,13,0,13,1,3,3,1,NASDAQ
5140,16-02-2021 10:00,24 hrs.,trakstocks,BXRX,40,40,0,40,1,15,6,1,NASDAQ
5140,16-02-2021 10:00,24 hrs.,trakstocks,CACC,16,0,16,-16,1,5,2,1,NASDAQ
5140,16-02-2021 10:00,24 hrs.,trakstocks,CIDM,22,22,0,22,1,7,4,1,NASDAQ
5140,16-02-2021 10:00,24 hrs.,trakstocks,CTRM,23,0,23,-23,1,8,3,1,NASDAQ
5140,16-02-2021 10:00,24 hrs.,trakstocks,EVFM,20,0,20,-20,1,6,4,1,NASDAQ
5140,16-02-2021 10:00,24 hrs.,trakstocks,EXPC,5,0,5,-5,1,0,1,1,NASDAQ
5140,16-02-2021 10:00,24 hrs.,trakstocks,FIII,47,0,47,-47,2,17,5,2,NASDAQ
5140,16-02-2021 10:00,24 hrs.,trakstocks,GMBL,10,10,0,10,1,2,2,1,NASDAQ
5140,16-02-2021 10:00,24 hrs.,trakstocks,IDEX,39,23,16,7,2,11,9,2,NASDAQ
5140,16-02-2021 10:00,24 hrs.,trakstocks,INPX,22,22,0,22,1,8,2,1,NASDAQ
5140,16-02-2021 10:00,24 hrs.,trakstocks,KIDS,17,0,17,-17,2,1,7,2,NASDAQ
5140,16-02-2021 10:00,24 hrs.,trakstocks,LKCO,12,12,0,12,1,4,0,1,NASDAQ
5140,16-02-2021 10:00,24 hrs.,trakstocks,LOAC,9,9,0,9,1,2,1,1,NASDAQ
5140,16-02-2021 10:00,24 hrs.,Daytrading,CIIC,13,13,0,13,1,4,1,1,NASDAQ
5140,16-02-2021 10:00,24 hrs.,Daytrading,CROX,39,0,39,-39,1,11,13,1,NASDAQ
5140,16-02-2021 10:00,24 hrs.,Daytrading,DKNG,39,0,39,-39,1,11,13,1,NASDAQ
5140,16-02-2021 10:00,24 hrs.,Daytrading,FORD,46,0,46,-46,1,18,6,1,NASDAQ
5140,16-02-2021 10:00,24 hrs.,Daytrading,GOGO,46,0,46,-46,1,18,6,1,NASDAQ
5140,16-02-2021 10:00,24 hrs.,Daytrading,LOAC,6,6,0,6,1,1,0,1,NASDAQ
5140,16-02-2021 10:00,24 hrs.,Daytrading,PATI,46,0,46,-46,1,18,6,1,NASDAQ
5140,16-02-2021 10:00,24 hrs.,Daytrading,PAYS,6,6,0,6,1,1,0,1,NASDAQ
5140,16-02-2021 10:00,24 hrs.,Daytrading,PBTS,46,0,46,-46,1,18,6,1,NASDAQ
5140,16-02-2021 10:00,24 hrs.,Daytrading,SAVA,6,0,6,-6,1,1,0,1,NASDAQ
5140,16-02-2021 10:00,24 hrs.,Daytrading,SNDL,12,6,6,0,2,2,0,2,NASDAQ
5140,16-02-2021 10:00,24 hrs.,Daytrading,SSKN,46,0,46,-46,1,18,6,1,NASDAQ
5140,16-02-2021 10:00,24 hrs.,Daytrading,TLRY,39,0,39,-39,1,11,13,1,NASDAQ
5140,16-02-2021 10:00,24 hrs.,Daytrading,TOPS,46,0,46,-46,1,18,6,1,NASDAQ
5140,16-02-2021 10:00,24 hrs.,Daytrading,TWIN,46,0,46,-46,1,18,6,1,NASDAQ
5140,16-02-2021 10:00,24 hrs.,trakstocks,ABML,23,23,0,23,1,5,9,1,OTC
5140,16-02-2021 10:00,24 hrs.,trakstocks,BOTH,66,66,0,66,2,25,8,1,OTC
5140,16-02-2021 10:00,24 hrs.,stocks,CRSR,12,6,6,0,2,2,0,2,NASDAQ
5140,16-02-2021 10:00,24 hrs.,stocks,CRWD,18,18,0,18,3,3,0,1,NASDAQ
5140,16-02-2021 10:00,24 hrs.,stocks,CTRM,6,6,0,6,1,1,0,1,NASDAQ
5140,16-02-2021 10:00,24 hrs.,stocks,DKNG,52,52,0,52,1,20,8,1,NASDAQ
5140,16-02-2021 10:00,24 hrs.,stocks,DLTR,19,0,19,-19,1,4,7,1,NASDAQ
5140,16-02-2021 10:00,24 hrs.,stocks,DRIV,145,0,145,-145,1,47,47,1,NASDAQ
5140,16-02-2021 10:00,24 hrs.,stocks,EDIT,126,126,0,126,2,21,76,2,NASDAQ
5140,16-02-2021 10:00,24 hrs.,stocks,ESPO,15,0,15,-15,1,3,5,1,NASDAQ
5140,16-02-2021 10:00,24 hrs.,stocks,EXPI,13,13,0,13,2,2,1,1,NASDAQ
5140,16-02-2021 10:00,24 hrs.,stocks,FATE,456,0,456,-456,1,157,138,1,NASDAQ
5140,16-02-2021 10:00,24 hrs.,stocks,FIII,143,6,137,-131,3,50,31,2,NASDAQ
5140,16-02-2021 10:00,24 hrs.,stocks,FLIR,456,0,456,-456,1,157,138,1,NASDAQ
5140,16-02-2021 10:00,24 hrs.,stocks,GILD,4,0,4,-4,1,0,0,1,NASDAQ
5140,16-02-2021 10:00,24 hrs.,stocks,GOGO,6,6,0,6,1,1,0,1,NASDAQ
5140,16-02-2021 10:00,24 hrs.,stocks,GPRO,6,0,6,-6,1,1,0,1,NASDAQ
5140,16-02-2021 10:00,24 hrs.,stocks,GTHX,54,0,54,-54,1,22,6,1,NASDAQ
5140,16-02-2021 10:00,24 hrs.,stocks,HLIT,119,119,0,119,1,52,11,1,NASDAQ
5140,16-02-2021 10:00,24 hrs.,stocks,ICLN,6,0,6,-6,1,1,0,1,NASDAQ
5140,16-02-2021 10:00,24 hrs.,stocks,IZEA,6,6,0,6,1,1,0,1,NASDAQ
5140,16-02-2021 10:00,24 hrs.,stocks,LCAP,6,6,0,6,1,1,0,1,NASDAQ
5140,16-02-2021 10:00,24 hrs.,stocks,LOAC,6,6,0,6,1,1,0,1,NASDAQ
5140,16-02-2021 10:00,24 hrs.,stocks,MBII,6,0,6,-6,1,1,0,1,NASDAQ
5140,16-02-2021 10:00,24 hrs.,stocks,MSFT,65,0,65,-65,1,17,27,1,NASDAQ
5140,16-02-2021 10:00,24 hrs.,stocks,NNDM,6,0,6,-6,1,1,0,1,NASDAQ
5140,16-02-2021 10:00,24 hrs.,stocks,OLLI,19,0,19,-19,1,4,7,1,NASDAQ
5140,16-02-2021 10:00,24 hrs.,stocks,OTLK,6,0,6,-6,1,1,0,1,NASDAQ
5140,16-02-2021 10:00,24 hrs.,stocks,PAVM,6,6,0,6,1,1,0,1,NASDAQ
5140,16-02-2021 10:00,24 hrs.,stocks,PENN,13,0,13,-13,1,1,7,1,NASDAQ
5140,16-02-2021 10:00,24 hrs.,stocks,PLUG,6,6,0,6,1,1,0,1,NASDAQ
5140,16-02-2021 10:00,24 hrs.,stocks,POWW,14,14,0,14,1,2,6,1,NASDAQ
5140,16-02-2021 10:00,24 hrs.,stocks,PYPL,394,0,394,-394,1,112,166,1,NASDAQ
5140,16-02-2021 10:00,24 hrs.,stocks,ROKU,456,0,456,-456,1,157,138,1,NASDAQ
5140,16-02-2021 10:00,24 hrs.,stocks,RRGB,13,13,0,13,1,3,3,1,NASDAQ
5140,16-02-2021 10:00,24 hrs.,stocks,SEER,6,6,0,6,1,1,0,1,NASDAQ
5140,16-02-2021 10:00,24 hrs.,stocks,SNDL,19,13,6,7,3,3,1,3,NASDAQ
5140,16-02-2021 10:00,24 hrs.,stocks,SONO,6,6,0,6,1,1,0,1,NASDAQ
5140,16-02-2021 10:00,24 hrs.,stocks,SRNE,6,6,0,6,1,1,0,1,NASDAQ
5140,16-02-2021 10:00,24 hrs.,stocks,SSPK,57,57,0,57,2,23,3,2,NASDAQ
5140,16-02-2021 10:00,24 hrs.,stocks,SWBI,7,0,7,-7,1,1,1,1,NASDAQ
5140,16-02-2021 10:00,24 hrs.,stocks,TLRY,36,36,0,36,1,12,8,1,NASDAQ
5140,16-02-2021 10:00,24 hrs.,stocks,TSLA,495,101,394,-293,3,126,231,3,NASDAQ
5140,16-02-2021 10:00,24 hrs.,stocks,TTCF,131,0,131,-131,1,48,31,1,NASDAQ
5140,16-02-2021 10:00,24 hrs.,stocks,TXMD,10,10,0,10,1,3,0,1,NASDAQ
5140,16-02-2021 10:00,24 hrs.,stocks,UCTT,4,0,4,-4,1,0,0,1,NASDAQ
5140,16-02-2021 10:00,24 hrs.,stocks,UHAL,12,0,12,-12,1,4,0,1,NASDAQ
5140,16-02-2021 10:00,24 hrs.,stocks,VTWO,7,0,7,-7,1,1,1,1,NASDAQ
5140,16-02-2021 10:00,24 hrs.,stocks,VXUS,16,0,16,-16,1,6,0,1,NASDAQ
5140,16-02-2021 10:00,24 hrs.,stocks,GOOGL,394,0,394,-394,1,112,166,1,NASDAQ
5140,16-02-2021 10:00,24 hrs.,Daytrading,AMC,6,6,0,6,1,1,0,1,NYSE
5140,16-02-2021 10:00,24 hrs.,Daytrading,DHF,6,6,0,6,1,1,0,1,NYSE
5140,16-02-2021 10:00,24 hrs.,Daytrading,DIS,39,0,39,-39,1,11,13,1,NYSE
5140,16-02-2021 10:00,24 hrs.,Daytrading,PDT,1766,1766,0,1766,2,798,162,2,NYSE
5140,16-02-2021 10:00,24 hrs.,Daytrading,RKT,39,0,39,-39,1,11,13,1,NYSE
5140,16-02-2021 10:00,24 hrs.,Daytrading,RSI,284,13,271,-258,2,125,26,2,NYSE
5140,16-02-2021 10:00,24 hrs.,Daytrading,TDA,21,0,21,-21,1,4,9,1,NYSE
5140,16-02-2021 10:00,24 hrs.,Daytrading,WWW,6,6,0,6,1,1,0,1,NYSE
5140,16-02-2021 10:00,24 hrs.,Daytrading,FUBO,39,0,39,-39,1,11,13,1,NYSE
5140,16-02-2021 10:00,24 hrs.,Daytrading,HEXO,39,0,39,-39,1,11,13,1,NYSE
5140,16-02-2021 10:00,24 hrs.,Daytrading,PLTR,39,0,39,-39,1,11,13,1,NYSE
5140,16-02-2021 10:00,24 hrs.,Daytrading,TALO,6,6,0,6,1,1,0,1,NYSE
5140,16-02-2021 10:00,24 hrs.,Daytrading,QQQ,13,13,0,13,1,4,1,1,NASDAQ
5140,16-02-2021 10:00,24 hrs.,Daytrading,AOSL,39,0,39,-39,1,11,13,1,NASDAQ
5140,16-02-2021 10:00,24 hrs.,Daytrading,APHA,39,0,39,-39,1,11,13,1,NASDAQ
5140,16-02-2021 10:00,24 hrs.,Daytrading,CASH,14,14,0,14,1,2,6,1,NASDAQ
5140,16-02-2021 10:00,24 hrs.,stocks,ARDX,119,119,0,119,1,52,11,1,NASDAQ
5140,16-02-2021 10:00,24 hrs.,stocks,ARTL,6,6,0,6,1,1,0,1,NASDAQ
5140,16-02-2021 10:00,24 hrs.,stocks,ATVI,27,0,27,-27,1,6,11,1,NASDAQ
5140,16-02-2021 10:00,24 hrs.,stocks,AUPH,14,0,14,-14,1,3,4,1,NASDAQ
5140,16-02-2021 10:00,24 hrs.,stocks,BNGO,6,6,0,6,1,1,0,1,NASDAQ
5140,16-02-2021 10:00,24 hrs.,stocks,CHKP,18,18,0,18,3,3,0,1,NASDAQ
5140,16-02-2021 10:00,24 hrs.,stocks,CMBM,9,0,9,-9,1,2,1,1,NASDAQ
5140,16-02-2021 10:00,24 hrs.,stocks,CMPS,6,0,6,-6,1,1,0,1,NASDAQ
5140,16-02-2021 10:00,24 hrs.,stocks,CNDT,6,0,6,-6,1,1,0,1,NASDAQ
5140,16-02-2021 10:00,24 hrs.,stocks,CRSP,6,6,0,6,1,1,0,1,NASDAQ
5140,16-02-2021 10:00,24 hrs.,stocks,WYY,119,119,0,119,1,52,11,1,AMEX
5140,16-02-2021 10:00,24 hrs.,stocks,ABC,35,35,0,35,1,7,17,1,NYSE
5140,16-02-2021 10:00,24 hrs.,stocks,AIR,131,0,131,-131,1,48,31,1,NYSE
5140,16-02-2021 10:00,24 hrs.,stocks,AMC,12,6,6,0,2,2,0,2,NYSE
5140,16-02-2021 10:00,24 hrs.,stocks,AVB,8,8,0,8,1,0,4,1,NYSE
5140,16-02-2021 10:00,24 hrs.,stocks,BMY,394,0,394,-394,1,112,166,1,NYSE
5140,16-02-2021 10:00,24 hrs.,stocks,BYD,58,0,58,-58,1,8,38,1,NYSE
5140,16-02-2021 10:00,24 hrs.,stocks,CAH,119,119,0,119,1,52,11,1,NYSE
5140,16-02-2021 10:00,24 hrs.,stocks,CCO,380,0,380,-380,2,109,154,2,NYSE
5140,16-02-2021 10:00,24 hrs.,stocks,CHL,6,6,0,6,1,1,0,1,NYSE
5140,16-02-2021 10:00,24 hrs.,stocks,COO,380,0,380,-380,2,109,154,2,NYSE
5140,16-02-2021 10:00,24 hrs.,stocks,CPT,8,8,0,8,1,0,4,1,NYSE
5140,16-02-2021 10:00,24 hrs.,stocks,CVX,394,0,394,-394,1,112,166,1,NYSE
5140,16-02-2021 10:00,24 hrs.,stocks,DIS,647,0,647,-647,3,167,301,3,NYSE
5140,16-02-2021 10:00,24 hrs.,stocks,ELY,53,53,0,53,2,14,17,1,NYSE
5140,16-02-2021 10:00,24 hrs.,stocks,EMP,119,119,0,119,1,52,11,1,NYSE
5140,16-02-2021 10:00,24 hrs.,stocks,EQR,8,8,0,8,1,0,4,1,NYSE
5140,16-02-2021 10:00,24 hrs.,stocks,ESS,8,8,0,8,1,0,4,1,NYSE
5140,16-02-2021 10:00,24 hrs.,stocks,ETN,18,18,0,18,3,3,0,1,NYSE
5140,16-02-2021 10:00,24 hrs.,stocks,FSR,131,0,131,-131,1,48,31,1,NYSE
5140,16-02-2021 10:00,24 hrs.,stocks,GIK,131,0,131,-131,1,48,31,1,NYSE
5140,16-02-2021 10:00,24 hrs.,stocks,GME,507,378,129,249,7,172,135,6,NYSE
5140,16-02-2021 10:00,24 hrs.,stocks,HBI,131,0,131,-131,1,48,31,1,NYSE
5140,16-02-2021 10:00,24 hrs.,stocks,ICE,66,0,66,-66,1,5,52,1,NYSE
5140,16-02-2021 10:00,24 hrs.,stocks,JPM,394,0,394,-394,1,112,166,1,NYSE
5140,16-02-2021 10:00,24 hrs.,stocks,LYV,6,0,6,-6,1,1,0,1,NYSE
5140,16-02-2021 10:00,24 hrs.,stocks,MAA,8,8,0,8,1,0,4,1,NYSE
5140,16-02-2021 10:00,24 hrs.,stocks,MAS,119,119,0,119,1,52,11,1,NYSE
5140,16-02-2021 10:00,24 hrs.,stocks,MRK,394,0,394,-394,1,112,166,1,NYSE
5140,16-02-2021 10:00,24 hrs.,stocks,NIO,449,0,449,-449,1,173,99,1,NYSE
5140,16-02-2021 10:00,24 hrs.,stocks,PFE,12,12,0,12,2,2,0,1,NYSE
5140,16-02-2021 10:00,24 hrs.,stocks,PGR,21,0,21,-21,1,7,3,1,NYSE
5140,16-02-2021 10:00,24 hrs.,stocks,PSX,394,0,394,-394,1,112,166,1,NYSE
5140,16-02-2021 10:00,24 hrs.,stocks,RSI,119,119,0,119,1,52,11,1,NYSE
5140,16-02-2021 10:00,24 hrs.,stocks,SOI,7,0,7,-7,1,1,1,1,NYSE
5140,16-02-2021 10:00,24 hrs.,stocks,TSM,93,93,0,93,1,32,25,1,NYSE
5140,16-02-2021 10:00,24 hrs.,stocks,UBS,131,0,131,-131,1,48,31,1,NYSE
5140,16-02-2021 10:00,24 hrs.,stocks,UPS,131,0,131,-131,1,48,31,1,NYSE
5140,16-02-2021 10:00,24 hrs.,stocks,WFC,394,0,394,-394,1,112,166,1,NYSE
5140,16-02-2021 10:00,24 hrs.,stocks,WMT,19,0,19,-19,1,4,7,1,NYSE
5140,16-02-2021 10:00,24 hrs.,stocks,XOM,394,0,394,-394,1,112,166,1,NYSE
5140,16-02-2021 10:00,24 hrs.,stocks,ABBV,394,0,394,-394,1,112,166,1,NYSE
5140,16-02-2021 10:00,24 hrs.,stocks,CCIV,6,6,0,6,1,1,0,1,NYSE
5140,16-02-2021 10:00,24 hrs.,stocks,CSPR,6,6,0,6,1,1,0,1,NYSE
5140,16-02-2021 10:00,24 hrs.,stocks,PLTR,101,0,101,-101,2,12,69,2,NYSE
5140,16-02-2021 10:00,24 hrs.,stocks,SNAP,456,0,456,-456,1,157,138,1,NYSE
5140,16-02-2021 10:00,24 hrs.,stocks,SPCE,191,191,0,191,3,75,29,2,NYSE
5140,16-02-2021 10:00,24 hrs.,stocks,AMD,12,0,12,-12,2,2,0,2,NASDAQ
5140,16-02-2021 10:00,24 hrs.,stocks,CDK,131,0,131,-131,1,48,31,1,NASDAQ
5140,16-02-2021 10:00,24 hrs.,stocks,CFO,147,0,147,-147,2,50,39,2,NASDAQ
5140,16-02-2021 10:00,24 hrs.,stocks,CGC,36,36,0,36,1,12,8,1,NASDAQ
5140,16-02-2021 10:00,24 hrs.,stocks,FTC,36,36,0,36,1,12,8,1,NASDAQ
5140,16-02-2021 10:00,24 hrs.,stocks,III,131,0,131,-131,1,48,31,1,NASDAQ
5140,16-02-2021 10:00,24 hrs.,stocks,SFT,6,6,0,6,1,1,0,1,NASDAQ
5140,16-02-2021 10:00,24 hrs.,stocks,AAPL,422,204,218,-14,2,117,180,2,NASDAQ
5140,16-02-2021 10:00,24 hrs.,stocks,AKTS,119,119,0,119,1,52,11,1,NASDAQ
5140,16-02-2021 10:00,24 hrs.,stocks,ALSK,6,6,0,6,1,1,0,1,NASDAQ
5140,16-02-2021 10:00,24 hrs.,stocks,AMCA,36,36,0,36,1,12,8,1,NASDAQ
5140,16-02-2021 10:00,24 hrs.,stocks,AMZN,218,0,218,-218,1,49,116,1,NASDAQ
5140,16-02-2021 10:00,24 hrs.,stocks,APHA,70,70,0,70,2,15,32,2,NASDAQ
5140,16-02-2021 10:00,24 hrs.,SPACs,GRSV,328,0,328,-328,1,119,86,1,NASDAQ
5140,16-02-2021 10:00,24 hrs.,SPACs,INAQ,328,0,328,-328,1,119,86,1,NASDAQ
5140,16-02-2021 10:00,24 hrs.,SPACs,JCIC,124,124,0,124,1,42,36,1,NASDAQ
5140,16-02-2021 10:00,24 hrs.,SPACs,KERN,16,16,0,16,1,0,12,1,NASDAQ
5140,16-02-2021 10:00,24 hrs.,SPACs,LEGO,124,124,0,124,1,42,36,1,NASDAQ
5140,16-02-2021 10:00,24 hrs.,SPACs,LOAC,6,6,0,6,1,1,0,1,NASDAQ
5140,16-02-2021 10:00,24 hrs.,SPACs,MCAC,328,0,328,-328,1,119,86,1,NASDAQ
5140,16-02-2021 10:00,24 hrs.,SPACs,NBAC,37,0,37,-37,1,15,3,1,NASDAQ
5140,16-02-2021 10:00,24 hrs.,SPACs,NGAC,342,0,342,-342,3,121,88,2,NASDAQ
5140,16-02-2021 10:00,24 hrs.,SPACs,QELL,111,0,111,-111,2,26,51,2,NASDAQ
5140,16-02-2021 10:00,24 hrs.,SPACs,SAII,124,124,0,124,1,42,36,1,NASDAQ
5140,16-02-2021 10:00,24 hrs.,SPACs,THCB,273,7,266,-259,4,84,89,2,NASDAQ
5140,16-02-2021 10:00,24 hrs.,SPACs,UNIT,124,124,0,124,1,42,36,1,NASDAQ
5140,16-02-2021 10:00,24 hrs.,SPACs,THCBU,60,0,60,-60,1,17,22,1,NASDAQ
5140,16-02-2021 10:00,24 hrs.,stocks,ASTI,19,0,19,-19,1,2,11,1,OTC
5140,16-02-2021 10:00,24 hrs.,stocks,BNET,6,0,6,-6,1,1,0,1,OTC
5140,16-02-2021 10:00,24 hrs.,stocks,HEMP,6,6,0,6,1,1,0,1,OTC
5140,16-02-2021 10:00,24 hrs.,stocks,ICCT,6,6,0,6,1,1,0,1,OTC
5140,16-02-2021 10:00,24 hrs.,stocks,INKW,6,0,6,-6,1,1,0,1,OTC
5140,16-02-2021 10:00,24 hrs.,stocks,JSDA,36,0,36,-36,1,7,18,1,OTC
5140,16-02-2021 10:00,24 hrs.,stocks,LLBO,6,0,6,-6,1,1,0,1,OTC
5140,16-02-2021 10:00,24 hrs.,stocks,MOJO,6,6,0,6,1,1,0,1,OTC
5140,16-02-2021 10:00,24 hrs.,stocks,NWGC,7,7,0,7,1,1,1,1,OTC
5140,16-02-2021 10:00,24 hrs.,stocks,PURE,456,0,456,-456,1,157,138,1,OTC
5140,16-02-2021 10:00,24 hrs.,stocks,ROTH,16,0,16,-16,1,6,0,1,OTC
5140,16-02-2021 10:00,24 hrs.,stocks,SGMD,6,0,6,-6,1,1,0,1,OTC
5140,16-02-2021 10:00,24 hrs.,stocks,USPS,131,0,131,-131,1,48,31,1,OTC
5140,16-02-2021 10:00,24 hrs.,stocks,HVBTF,6,0,6,-6,1,1,0,1,OTC
5140,16-02-2021 10:00,24 hrs.,stocks,LMRMF,6,0,6,-6,1,1,0,1,OTC
5140,16-02-2021 10:00,24 hrs.,stocks,NTDOY,27,0,27,-27,1,6,11,1,OTC
5140,16-02-2021 10:00,24 hrs.,stocks,AMS,131,0,131,-131,1,48,31,1,AMEX
5140,16-02-2021 10:00,24 hrs.,stocks,CTO,131,0,131,-131,1,48,31,1,AMEX
5140,16-02-2021 10:00,24 hrs.,stocks,NBA,52,52,0,52,1,20,8,1,AMEX
5140,16-02-2021 10:00,24 hrs.,pennystocks,TSNP,6,6,0,6,1,1,0,1,OTC
5140,16-02-2021 10:00,24 hrs.,pennystocks,UNVC,7,0,7,-7,1,1,1,1,OTC
5140,16-02-2021 10:00,24 hrs.,pennystocks,UVSE,7,0,7,-7,1,1,1,1,OTC
5140,16-02-2021 10:00,24 hrs.,pennystocks,VPER,631,0,631,-631,1,216,195,1,OTC
5140,16-02-2021 10:00,24 hrs.,pennystocks,VPRB,6,6,0,6,1,1,0,1,OTC
5140,16-02-2021 10:00,24 hrs.,pennystocks,WARM,6,0,6,-6,1,1,0,1,OTC
5140,16-02-2021 10:00,24 hrs.,pennystocks,WDLF,6,0,6,-6,1,1,0,1,OTC
5140,16-02-2021 10:00,24 hrs.,pennystocks,AACTF,77,0,77,-77,2,26,17,2,OTC
5140,16-02-2021 10:00,24 hrs.,pennystocks,ABEPF,59,0,59,-59,1,12,31,1,OTC
5140,16-02-2021 10:00,24 hrs.,pennystocks,AMYZF,55,55,0,55,1,21,9,1,OTC
5140,16-02-2021 10:00,24 hrs.,pennystocks,ARBKF,212,0,212,-212,3,62,76,3,OTC
5140,16-02-2021 10:00,24 hrs.,pennystocks,BYDDY,37,0,37,-37,1,13,7,1,OTC
5140,16-02-2021 10:00,24 hrs.,pennystocks,CANSF,234,234,0,234,1,101,28,1,OTC
5140,16-02-2021 10:00,24 hrs.,pennystocks,CYDVF,6,0,6,-6,1,1,0,1,OTC
5140,16-02-2021 10:00,24 hrs.,pennystocks,EFLVF,6,0,6,-6,1,1,0,1,OTC
5140,16-02-2021 10:00,24 hrs.,pennystocks,EPWCF,6,0,6,-6,1,1,0,1,OTC
5140,16-02-2021 10:00,24 hrs.,pennystocks,ERPNF,94,0,94,-94,1,38,14,1,OTC
5140,16-02-2021 10:00,24 hrs.,pennystocks,FUNFF,6,0,6,-6,1,1,0,1,OTC
5140,16-02-2021 10:00,24 hrs.,pennystocks,ABWN,7,7,0,7,1,1,1,1,OTC
5140,16-02-2021 10:00,24 hrs.,pennystocks,AGYP,9,0,9,-9,1,2,1,1,OTC
5140,16-02-2021 10:00,24 hrs.,pennystocks,AITX,592,232,360,-128,9,218,120,8,OTC
5140,16-02-2021 10:00,24 hrs.,pennystocks,ALPP,33,0,33,-33,2,10,5,2,OTC
5140,16-02-2021 10:00,24 hrs.,pennystocks,ALYI,57,0,57,-57,1,17,19,1,OTC
5140,16-02-2021 10:00,24 hrs.,pennystocks,APYP,6,6,0,6,1,1,0,1,OTC
5140,16-02-2021 10:00,24 hrs.,pennystocks,ASTI,116,71,45,26,4,23,54,4,OTC
5140,16-02-2021 10:00,24 hrs.,pennystocks,BANT,6,0,6,-6,1,1,0,1,OTC
5140,16-02-2021 10:00,24 hrs.,pennystocks,BBRW,73,67,6,61,2,17,31,2,OTC
5140,16-02-2021 10:00,24 hrs.,pennystocks,BCAP,6,0,6,-6,1,1,0,1,OTC
5140,16-02-2021 10:00,24 hrs.,pennystocks,BIEL,6,0,6,-6,1,1,0,1,OTC
5140,16-02-2021 10:00,24 hrs.,pennystocks,BLSP,7,0,7,-7,1,1,1,1,OTC
5140,16-02-2021 10:00,24 hrs.,pennystocks,BNGI,6,6,0,6,1,1,0,1,OTC
5140,16-02-2021 10:00,24 hrs.,pennystocks,BOTH,12,12,0,12,2,2,0,1,OTC
5140,16-02-2021 10:00,24 hrs.,pennystocks,BOTY,14,7,7,0,2,2,2,2,OTC
5140,16-02-2021 10:00,24 hrs.,pennystocks,BRRN,19,19,0,19,3,3,1,2,OTC
5140,16-02-2021 10:00,24 hrs.,pennystocks,CBBT,992,117,875,-758,7,333,298,6,OTC
5140,16-02-2021 10:00,24 hrs.,pennystocks,CBDL,12,6,6,0,2,2,0,2,OTC
5140,16-02-2021 10:00,24 hrs.,pennystocks,CBTC,20,20,0,20,1,7,2,1,OTC
5140,16-02-2021 10:00,24 hrs.,pennystocks,CCTL,6,0,6,-6,1,1,0,1,OTC
5140,16-02-2021 10:00,24 hrs.,pennystocks,CYDY,7,0,7,-7,1,1,1,1,OTC
5140,16-02-2021 10:00,24 hrs.,pennystocks,DPLS,7,0,7,-7,1,1,1,1,OTC
5140,16-02-2021 10:00,24 hrs.,pennystocks,ENZC,6,6,0,6,1,1,0,1,OTC
5140,16-02-2021 10:00,24 hrs.,pennystocks,ERBB,67,67,0,67,1,16,31,1,OTC
5140,16-02-2021 10:00,24 hrs.,pennystocks,ETFM,254,27,227,-200,5,92,50,4,OTC
5140,16-02-2021 10:00,24 hrs.,pennystocks,FDMF,6,6,0,6,1,1,0,1,OTC
5140,16-02-2021 10:00,24 hrs.,pennystocks,FLES,26,7,19,-12,2,1,16,2,OTC
5140,16-02-2021 10:00,24 hrs.,pennystocks,GARB,7,7,0,7,1,1,1,1,OTC
5140,16-02-2021 10:00,24 hrs.,pennystocks,GAXY,26,0,26,-26,1,5,12,1,OTC
5140,16-02-2021 10:00,24 hrs.,pennystocks,GPFT,6,6,0,6,1,1,0,1,OTC
5140,16-02-2021 10:00,24 hrs.,pennystocks,GRNH,67,67,0,67,1,16,31,1,OTC
5140,16-02-2021 10:00,24 hrs.,pennystocks,GTLL,14,7,7,0,2,2,2,2,OTC
5140,16-02-2021 10:00,24 hrs.,pennystocks,GTXO,16,16,0,16,1,3,6,1,OTC
5140,16-02-2021 10:00,24 hrs.,pennystocks,HALB,50,0,50,-50,1,19,8,1,OTC
5140,16-02-2021 10:00,24 hrs.,pennystocks,HEMP,7,7,0,7,1,1,1,1,OTC
5140,16-02-2021 10:00,24 hrs.,pennystocks,HIPH,20,20,0,20,1,1,14,1,OTC
5140,16-02-2021 10:00,24 hrs.,pennystocks,IJJP,6,6,0,6,1,1,0,1,OTC
5140,16-02-2021 10:00,24 hrs.,pennystocks,INKW,7,7,0,7,1,1,1,1,OTC
5140,16-02-2021 10:00,24 hrs.,pennystocks,INND,77,77,0,77,1,23,27,1,OTC
5140,16-02-2021 10:00,24 hrs.,pennystocks,KOAN,4,0,4,-4,1,0,0,1,OTC
5140,16-02-2021 10:00,24 hrs.,pennystocks,KOSK,13,13,0,13,1,3,3,1,OTC
5140,16-02-2021 10:00,24 hrs.,pennystocks,KULR,37,0,37,-37,1,13,7,1,OTC
5140,16-02-2021 10:00,24 hrs.,pennystocks,KWBT,22,0,22,-22,1,7,4,1,OTC
5140,16-02-2021 10:00,24 hrs.,pennystocks,LLBO,7,0,7,-7,1,1,1,1,OTC
5140,16-02-2021 10:00,24 hrs.,pennystocks,LQMT,6,0,6,-6,1,1,0,1,OTC
5140,16-02-2021 10:00,24 hrs.,pennystocks,MCOA,67,67,0,67,1,16,31,1,OTC
5140,16-02-2021 10:00,24 hrs.,pennystocks,MJNA,21,21,0,21,3,3,3,1,OTC
5140,16-02-2021 10:00,24 hrs.,pennystocks,NOVC,12,12,0,12,2,2,0,1,OTC
5140,16-02-2021 10:00,24 hrs.,pennystocks,OPTI,6,0,6,-6,1,1,0,1,OTC
5140,16-02-2021 10:00,24 hrs.,pennystocks,PBHG,6,0,6,-6,1,1,0,1,OTC
5140,16-02-2021 10:00,24 hrs.,pennystocks,PCTL,6,6,0,6,1,1,0,1,OTC
5140,16-02-2021 10:00,24 hrs.,pennystocks,PGAS,18,0,18,-18,3,3,0,2,OTC
5140,16-02-2021 10:00,24 hrs.,pennystocks,PHIL,6,6,0,6,1,1,0,1,OTC
5140,16-02-2021 10:00,24 hrs.,pennystocks,PUGE,51,0,51,-51,1,15,17,1,OTC
5140,16-02-2021 10:00,24 hrs.,pennystocks,PURA,15,15,0,15,1,3,5,1,OTC
5140,16-02-2021 10:00,24 hrs.,pennystocks,RNWR,6,0,6,-6,1,1,0,1,OTC
5140,16-02-2021 10:00,24 hrs.,pennystocks,SGMD,101,0,101,-101,1,12,73,1,OTC
5140,16-02-2021 10:00,24 hrs.,pennystocks,SIML,105,105,0,105,1,39,23,1,OTC
5140,16-02-2021 10:00,24 hrs.,pennystocks,SINC,6,6,0,6,1,1,0,1,OTC
5140,16-02-2021 10:00,24 hrs.,pennystocks,SNPW,107,107,0,107,3,39,17,2,OTC
5140,16-02-2021 10:00,24 hrs.,pennystocks,SRMX,50,44,6,38,3,14,10,3,OTC
5140,16-02-2021 10:00,24 hrs.,pennystocks,SSFT,67,6,61,-55,2,26,7,2,OTC
5140,16-02-2021 10:00,24 hrs.,pennystocks,SUGR,6,6,0,6,1,1,0,1,OTC
5140,16-02-2021 10:00,24 hrs.,pennystocks,TLSS,65,65,0,65,1,9,43,1,OTC
5140,16-02-2021 10:00,24 hrs.,StockMarket,PYPL,6,6,0,6,1,1,0,1,NASDAQ
5140,16-02-2021 10:00,24 hrs.,StockMarket,SNDL,135,129,6,123,2,50,27,2,NASDAQ
5140,16-02-2021 10:00,24 hrs.,StockMarket,SRNE,4,0,4,-4,1,0,0,1,NASDAQ
5140,16-02-2021 10:00,24 hrs.,StockMarket,SSPK,24,24,0,24,1,8,4,1,NASDAQ
5140,16-02-2021 10:00,24 hrs.,StockMarket,TSLA,12,12,0,12,1,3,2,1,NASDAQ
5140,16-02-2021 10:00,24 hrs.,pennystocks,AABB,6,0,6,-6,1,1,0,1,OTC
5140,16-02-2021 10:00,24 hrs.,pennystocks,ABML,94,0,94,-94,1,38,14,1,OTC
5140,16-02-2021 10:00,24 hrs.,pennystocks,ABQQ,25,25,0,25,2,6,5,1,OTC
5140,16-02-2021 10:00,24 hrs.,RobinHoodPennyStocks,WATT,106,106,0,106,1,44,14,1,NASDAQ
5140,16-02-2021 10:00,24 hrs.,RobinHoodPennyStocks,WKEY,106,106,0,106,1,44,14,1,NASDAQ
5140,16-02-2021 10:00,24 hrs.,RobinHoodPennyStocks,MARPS,106,106,0,106,1,44,14,1,NASDAQ
5140,16-02-2021 10:00,24 hrs.,RobinHoodPennyStocks,UONEK,106,106,0,106,1,44,14,1,NASDAQ
5140,16-02-2021 10:00,24 hrs.,RobinHoodPennyStocks,VERU,106,106,0,106,1,44,14,1,NASDAQ
5140,16-02-2021 10:00,24 hrs.,RobinHoodPennyStocks,CLSK,106,106,0,106,1,44,14,1,NASDAQ
5140,16-02-2021 10:00,24 hrs.,RobinHoodPennyStocks,CRBP,628,0,628,-628,1,190,244,1,NASDAQ
5140,16-02-2021 10:00,24 hrs.,RobinHoodPennyStocks,CRON,106,106,0,106,1,44,14,1,NASDAQ
5140,16-02-2021 10:00,24 hrs.,RobinHoodPennyStocks,DFFN,905,94,811,-717,4,258,373,4,NASDAQ
5140,16-02-2021 10:00,24 hrs.,RobinHoodPennyStocks,DZSI,106,106,0,106,1,44,14,1,NASDAQ
5140,16-02-2021 10:00,24 hrs.,RobinHoodPennyStocks,EBON,106,106,0,106,1,44,14,1,NASDAQ
5140,16-02-2021 10:00,24 hrs.,RobinHoodPennyStocks,EDRY,106,106,0,106,1,44,14,1,NASDAQ
5140,16-02-2021 10:00,24 hrs.,RobinHoodPennyStocks,EPSN,106,106,0,106,1,44,14,1,NASDAQ
5140,16-02-2021 10:00,24 hrs.,RobinHoodPennyStocks,EQOS,106,106,0,106,1,44,14,1,NASDAQ
5140,16-02-2021 10:00,24 hrs.,RobinHoodPennyStocks,FAMI,106,106,0,106,1,44,14,1,NASDAQ
5140,16-02-2021 10:00,24 hrs.,RobinHoodPennyStocks,FCEL,106,106,0,106,1,44,14,1,NASDAQ
5140,16-02-2021 10:00,24 hrs.,RobinHoodPennyStocks,FORD,106,106,0,106,1,44,14,1,NASDAQ
5140,16-02-2021 10:00,24 hrs.,RobinHoodPennyStocks,GTHX,106,106,0,106,1,44,14,1,NASDAQ
5140,16-02-2021 10:00,24 hrs.,RobinHoodPennyStocks,HGEN,106,106,0,106,1,44,14,1,NASDAQ
5140,16-02-2021 10:00,24 hrs.,RobinHoodPennyStocks,HNRG,106,106,0,106,1,44,14,1,NASDAQ
5140,16-02-2021 10:00,24 hrs.,RobinHoodPennyStocks,IDEX,112,112,0,112,2,45,14,2,NASDAQ
5140,16-02-2021 10:00,24 hrs.,RobinHoodPennyStocks,IMTE,106,106,0,106,1,44,14,1,NASDAQ
5140,16-02-2021 10:00,24 hrs.,RobinHoodPennyStocks,IZEA,106,106,0,106,1,44,14,1,NASDAQ
5140,16-02-2021 10:00,24 hrs.,RobinHoodPennyStocks,KERN,106,106,0,106,1,44,14,1,NASDAQ
5140,16-02-2021 10:00,24 hrs.,RobinHoodPennyStocks,LMFA,106,106,0,106,1,44,14,1,NASDAQ
5140,16-02-2021 10:00,24 hrs.,RobinHoodPennyStocks,MARA,132,106,26,80,2,53,18,2,NASDAQ
5140,16-02-2021 10:00,24 hrs.,RobinHoodPennyStocks,METX,106,106,0,106,1,44,14,1,NASDAQ
5140,16-02-2021 10:00,24 hrs.,RobinHoodPennyStocks,MNPR,106,106,0,106,1,44,14,1,NASDAQ
5140,16-02-2021 10:00,24 hrs.,RobinHoodPennyStocks,MOGO,106,106,0,106,1,44,14,1,NASDAQ
5140,16-02-2021 10:00,24 hrs.,RobinHoodPennyStocks,MOSY,6,0,6,-6,1,1,0,1,NASDAQ
5140,16-02-2021 10:00,24 hrs.,RobinHoodPennyStocks,NAKD,130,130,0,130,2,48,26,2,NASDAQ
5140,16-02-2021 10:00,24 hrs.,RobinHoodPennyStocks,NOVN,106,106,0,106,1,44,14,1,NASDAQ
5140,16-02-2021 10:00,24 hrs.,RobinHoodPennyStocks,NVAX,106,106,0,106,1,44,14,1,NASDAQ
5140,16-02-2021 10:00,24 hrs.,RobinHoodPennyStocks,NVIV,6,0,6,-6,1,1,0,1,NASDAQ
5140,16-02-2021 10:00,24 hrs.,RobinHoodPennyStocks,NXTD,106,106,0,106,1,44,14,1,NASDAQ
5140,16-02-2021 10:00,24 hrs.,RobinHoodPennyStocks,OBSV,64,64,0,64,3,24,4,2,NASDAQ
5140,16-02-2021 10:00,24 hrs.,RobinHoodPennyStocks,OCUL,106,106,0,106,1,44,14,1,NASDAQ
5140,16-02-2021 10:00,24 hrs.,RobinHoodPennyStocks,OPTT,106,106,0,106,1,44,14,1,NASDAQ
5140,16-02-2021 10:00,24 hrs.,RobinHoodPennyStocks,PECK,106,106,0,106,1,44,14,1,NASDAQ
5140,16-02-2021 10:00,24 hrs.,RobinHoodPennyStocks,PEIX,106,106,0,106,1,44,14,1,NASDAQ
5140,16-02-2021 10:00,24 hrs.,RobinHoodPennyStocks,PHIO,106,106,0,106,1,44,14,1,NASDAQ
5140,16-02-2021 10:00,24 hrs.,RobinHoodPennyStocks,PHUN,106,106,0,106,1,44,14,1,NASDAQ
5140,16-02-2021 10:00,24 hrs.,RobinHoodPennyStocks,PLUG,106,106,0,106,1,44,14,1,NASDAQ
5140,16-02-2021 10:00,24 hrs.,RobinHoodPennyStocks,PLYA,106,106,0,106,1,44,14,1,NASDAQ
5140,16-02-2021 10:00,24 hrs.,RobinHoodPennyStocks,POWW,42,0,42,-42,1,15,8,1,NASDAQ
5140,16-02-2021 10:00,24 hrs.,RobinHoodPennyStocks,PULM,6,0,6,-6,1,1,0,1,NASDAQ
5140,16-02-2021 10:00,24 hrs.,RobinHoodPennyStocks,RCON,106,106,0,106,1,44,14,1,NASDAQ
5140,16-02-2021 10:00,24 hrs.,RobinHoodPennyStocks,RIOT,132,106,26,80,2,53,18,2,NASDAQ
5140,16-02-2021 10:00,24 hrs.,RobinHoodPennyStocks,SALM,106,106,0,106,1,44,14,1,NASDAQ
5140,16-02-2021 10:00,24 hrs.,RobinHoodPennyStocks,SAVA,106,106,0,106,1,44,14,1,NASDAQ
5140,16-02-2021 10:00,24 hrs.,RobinHoodPennyStocks,SHIP,118,106,12,94,3,46,14,3,NASDAQ
5140,16-02-2021 10:00,24 hrs.,RobinHoodPennyStocks,SINO,106,106,0,106,1,44,14,1,NASDAQ
5140,16-02-2021 10:00,24 hrs.,RobinHoodPennyStocks,SIRI,6,0,6,-6,1,1,0,1,NASDAQ
5140,16-02-2021 10:00,24 hrs.,RobinHoodPennyStocks,SNDL,118,106,12,94,3,46,14,3,NASDAQ
5140,16-02-2021 10:00,24 hrs.,RobinHoodPennyStocks,SNGX,106,106,0,106,1,44,14,1,NASDAQ
5140,16-02-2021 10:00,24 hrs.,RobinHoodPennyStocks,STAY,106,106,0,106,1,44,14,1,NASDAQ
5140,16-02-2021 10:00,24 hrs.,RobinHoodPennyStocks,SUNW,106,106,0,106,1,44,14,1,NASDAQ
5140,16-02-2021 10:00,24 hrs.,RobinHoodPennyStocks,SYPR,106,106,0,106,1,44,14,1,NASDAQ
5140,16-02-2021 10:00,24 hrs.,RobinHoodPennyStocks,SYTA,106,106,0,106,1,44,14,1,NASDAQ
5140,16-02-2021 10:00,24 hrs.,RobinHoodPennyStocks,TANH,20,20,0,20,1,5,6,1,NASDAQ
5140,16-02-2021 10:00,24 hrs.,RobinHoodPennyStocks,TLRY,106,106,0,106,1,44,14,1,NASDAQ
5140,16-02-2021 10:00,24 hrs.,RobinHoodPennyStocks,TNXP,683,55,628,-573,4,206,255,4,NASDAQ
5140,16-02-2021 10:00,24 hrs.,RobinHoodPennyStocks,TOPS,106,106,0,106,1,44,14,1,NASDAQ
5140,16-02-2021 10:00,24 hrs.,RobinHoodPennyStocks,TRCH,122,106,16,90,2,44,26,2,NASDAQ
5140,16-02-2021 10:00,24 hrs.,RobinHoodPennyStocks,TXMD,640,6,634,-628,3,192,244,3,NASDAQ
5140,16-02-2021 10:00,24 hrs.,RobinHoodPennyStocks,TYME,6,6,0,6,1,1,0,1,NASDAQ
5140,16-02-2021 10:00,24 hrs.,RobinHoodPennyStocks,UONE,106,106,0,106,1,44,14,1,NASDAQ
5140,16-02-2021 10:00,24 hrs.,RobinHoodPennyStocks,USEG,106,106,0,106,1,44,14,1,NASDAQ
5140,16-02-2021 10:00,24 hrs.,RobinHoodPennyStocks,USWS,106,106,0,106,1,44,14,1,NASDAQ
5140,16-02-2021 10:00,24 hrs.,RobinHoodPennyStocks,BEAT,8,8,0,8,1,2,0,1,NASDAQ
5140,16-02-2021 10:00,24 hrs.,RobinHoodPennyStocks,BNGO,106,106,0,106,1,44,14,1,NASDAQ
5140,16-02-2021 10:00,24 hrs.,RobinHoodPennyStocks,BOXL,106,106,0,106,1,44,14,1,NASDAQ
5140,16-02-2021 10:00,24 hrs.,RobinHoodPennyStocks,BRQS,106,106,0,106,1,44,14,1,NASDAQ
5140,16-02-2021 10:00,24 hrs.,RobinHoodPennyStocks,BYFC,106,106,0,106,1,44,14,1,NASDAQ
5140,16-02-2021 10:00,24 hrs.,RobinHoodPennyStocks,CARV,106,106,0,106,1,44,14,1,NASDAQ
5140,16-02-2021 10:00,24 hrs.,RobinHoodPennyStocks,CBAT,106,106,0,106,1,44,14,1,NASDAQ
5140,16-02-2021 10:00,24 hrs.,RobinHoodPennyStocks,CCNC,106,106,0,106,1,44,14,1,NASDAQ
5140,16-02-2021 10:00,24 hrs.,RobinHoodPennyStocks,CIDM,628,0,628,-628,1,190,244,1,NASDAQ
5140,16-02-2021 10:00,24 hrs.,RobinHoodPennyStocks,CLEU,106,106,0,106,1,44,14,1,NASDAQ
5140,16-02-2021 10:00,24 hrs.,RobinHoodPennyStocks,PLTR,6,6,0,6,1,1,0,1,NYSE
5140,16-02-2021 10:00,24 hrs.,RobinHoodPennyStocks,CFO,6,0,6,-6,1,1,0,1,NASDAQ
5140,16-02-2021 10:00,24 hrs.,RobinHoodPennyStocks,CGC,106,106,0,106,1,44,14,1,NASDAQ
5140,16-02-2021 10:00,24 hrs.,RobinHoodPennyStocks,ENG,106,106,0,106,1,44,14,1,NASDAQ
5140,16-02-2021 10:00,24 hrs.,RobinHoodPennyStocks,MGI,106,106,0,106,1,44,14,1,NASDAQ
5140,16-02-2021 10:00,24 hrs.,RobinHoodPennyStocks,OEG,112,112,0,112,2,45,14,2,NASDAQ
5140,16-02-2021 10:00,24 hrs.,RobinHoodPennyStocks,OGI,106,106,0,106,1,44,14,1,NASDAQ
5140,16-02-2021 10:00,24 hrs.,RobinHoodPennyStocks,PFC,6,6,0,6,1,1,0,1,NASDAQ
5140,16-02-2021 10:00,24 hrs.,RobinHoodPennyStocks,PXS,628,0,628,-628,1,190,244,1,NASDAQ
5140,16-02-2021 10:00,24 hrs.,RobinHoodPennyStocks,SPI,106,106,0,106,1,44,14,1,NASDAQ
5140,16-02-2021 10:00,24 hrs.,RobinHoodPennyStocks,TGA,106,106,0,106,1,44,14,1,NASDAQ
5140,16-02-2021 10:00,24 hrs.,RobinHoodPennyStocks,WNW,106,106,0,106,1,44,14,1,NASDAQ
5140,16-02-2021 10:00,24 hrs.,RobinHoodPennyStocks,WWR,112,106,6,100,2,45,14,2,NASDAQ
5140,16-02-2021 10:00,24 hrs.,RobinHoodPennyStocks,AACQ,106,106,0,106,1,44,14,1,NASDAQ
5140,16-02-2021 10:00,24 hrs.,RobinHoodPennyStocks,AAPL,106,106,0,106,1,44,14,1,NASDAQ
5140,16-02-2021 10:00,24 hrs.,RobinHoodPennyStocks,ABEO,628,0,628,-628,1,190,244,1,NASDAQ
5140,16-02-2021 10:00,24 hrs.,RobinHoodPennyStocks,ACST,628,0,628,-628,1,190,244,1,NASDAQ
5140,16-02-2021 10:00,24 hrs.,RobinHoodPennyStocks,ADXS,6,6,0,6,1,1,0,1,NASDAQ
5140,16-02-2021 10:00,24 hrs.,RobinHoodPennyStocks,AGTC,2056,2050,6,2044,6,919,194,5,NASDAQ
5140,16-02-2021 10:00,24 hrs.,RobinHoodPennyStocks,AIKI,106,106,0,106,1,44,14,1,NASDAQ
5140,16-02-2021 10:00,24 hrs.,RobinHoodPennyStocks,ALAC,106,106,0,106,1,44,14,1,NASDAQ
5140,16-02-2021 10:00,24 hrs.,RobinHoodPennyStocks,ALJJ,106,106,0,106,1,44,14,1,NASDAQ
5140,16-02-2021 10:00,24 hrs.,RobinHoodPennyStocks,AMTX,106,106,0,106,1,44,14,1,NASDAQ
5140,16-02-2021 10:00,24 hrs.,RobinHoodPennyStocks,AMZN,6,0,6,-6,1,1,0,1,NASDAQ
5140,16-02-2021 10:00,24 hrs.,RobinHoodPennyStocks,APHA,106,106,0,106,1,44,14,1,NASDAQ
5140,16-02-2021 10:00,24 hrs.,RobinHoodPennyStocks,ARLP,106,106,0,106,1,44,14,1,NASDAQ
5140,16-02-2021 10:00,24 hrs.,RobinHoodPennyStocks,ARTL,106,106,0,106,1,44,14,1,NASDAQ
5140,16-02-2021 10:00,24 hrs.,RobinHoodPennyStocks,ASRT,755,73,682,-609,3,225,293,3,NASDAQ
5140,16-02-2021 10:00,24 hrs.,RobinHoodPennyStocks,ASRV,54,0,54,-54,1,18,14,1,NASDAQ
5140,16-02-2021 10:00,24 hrs.,RobinHoodPennyStocks,ATOS,21,21,0,21,1,6,5,1,NASDAQ
5140,16-02-2021 10:00,24 hrs.,RobinHoodPennyStocks,RVBR,6,0,6,-6,1,1,0,1,OTC
5140,16-02-2021 10:00,24 hrs.,RobinHoodPennyStocks,SRMX,16,0,16,-16,1,0,12,1,OTC
5140,16-02-2021 10:00,24 hrs.,RobinHoodPennyStocks,VPER,6,0,6,-6,1,1,0,1,OTC
5140,16-02-2021 10:00,24 hrs.,RobinHoodPennyStocks,BDRBF,6,0,6,-6,1,1,0,1,OTC
5140,16-02-2021 10:00,24 hrs.,RobinHoodPennyStocks,NMGRF,6,6,0,6,1,1,0,1,OTC
5140,16-02-2021 10:00,24 hrs.,RobinHoodPennyStocks,OTIVF,6,0,6,-6,1,1,0,1,OTC
5140,16-02-2021 10:00,24 hrs.,RobinHoodPennyStocks,RNRRF,6,0,6,-6,1,1,0,1,OTC
5140,16-02-2021 10:00,24 hrs.,RobinHoodPennyStocks,CEI,106,106,0,106,1,44,14,1,AMEX
5140,16-02-2021 10:00,24 hrs.,RobinHoodPennyStocks,DNN,636,8,628,-620,2,192,244,2,AMEX
5140,16-02-2021 10:00,24 hrs.,RobinHoodPennyStocks,DPW,106,106,0,106,1,44,14,1,AMEX
5140,16-02-2021 10:00,24 hrs.,RobinHoodPennyStocks,GTE,821,187,634,-447,6,255,287,5,AMEX
5140,16-02-2021 10:00,24 hrs.,RobinHoodPennyStocks,IGC,106,106,0,106,1,44,14,1,AMEX
5140,16-02-2021 10:00,24 hrs.,RobinHoodPennyStocks,ITP,12,12,0,12,2,2,0,1,AMEX
5140,16-02-2021 10:00,24 hrs.,RobinHoodPennyStocks,NAK,6,0,6,-6,1,1,0,1,AMEX
5140,16-02-2021 10:00,24 hrs.,RobinHoodPennyStocks,PED,106,106,0,106,1,44,14,1,AMEX
5140,16-02-2021 10:00,24 hrs.,RobinHoodPennyStocks,PTN,628,0,628,-628,1,190,244,1,AMEX
5140,16-02-2021 10:00,24 hrs.,RobinHoodPennyStocks,REI,106,106,0,106,1,44,14,1,AMEX
5140,16-02-2021 10:00,24 hrs.,RobinHoodPennyStocks,ZOM,139,139,0,139,3,41,45,3,AMEX
5140,16-02-2021 10:00,24 hrs.,RobinHoodPennyStocks,ENSV,106,106,0,106,1,44,14,1,AMEX
5140,16-02-2021 10:00,24 hrs.,RobinHoodPennyStocks,GSAT,106,106,0,106,1,44,14,1,AMEX
5140,16-02-2021 10:00,24 hrs.,RobinHoodPennyStocks,HUSA,106,106,0,106,1,44,14,1,AMEX
5140,16-02-2021 10:00,24 hrs.,RobinHoodPennyStocks,INUV,18,0,18,-18,3,3,0,2,AMEX
5140,16-02-2021 10:00,24 hrs.,RobinHoodPennyStocks,SNMP,106,106,0,106,1,44,14,1,AMEX
5140,16-02-2021 10:00,24 hrs.,RobinHoodPennyStocks,TMBR,21,21,0,21,1,6,5,1,AMEX
5140,16-02-2021 10:00,24 hrs.,RobinHoodPennyStocks,TRXC,6,6,0,6,1,1,0,1,AMEX
5140,16-02-2021 10:00,24 hrs.,RobinHoodPennyStocks,UAVS,6,0,6,-6,1,1,0,1,AMEX
5140,16-02-2021 10:00,24 hrs.,RobinHoodPennyStocks,ACB,106,106,0,106,1,44,14,1,NYSE
5140,16-02-2021 10:00,24 hrs.,RobinHoodPennyStocks,AMC,6,6,0,6,1,0,2,1,NYSE
5140,16-02-2021 10:00,24 hrs.,RobinHoodPennyStocks,AUY,6,0,6,-6,1,1,0,1,NYSE
5140,16-02-2021 10:00,24 hrs.,RobinHoodPennyStocks,BTU,106,106,0,106,1,44,14,1,NYSE
5140,16-02-2021 10:00,24 hrs.,RobinHoodPennyStocks,DSX,106,106,0,106,1,44,14,1,NYSE
5140,16-02-2021 10:00,24 hrs.,RobinHoodPennyStocks,GGB,6,0,6,-6,1,1,0,1,NYSE
5140,16-02-2021 10:00,24 hrs.,RobinHoodPennyStocks,HGV,106,106,0,106,1,44,14,1,NYSE
5140,16-02-2021 10:00,24 hrs.,RobinHoodPennyStocks,HMI,106,106,0,106,1,44,14,1,NYSE
5140,16-02-2021 10:00,24 hrs.,RobinHoodPennyStocks,NOK,30,24,6,18,2,5,12,2,NYSE
5140,16-02-2021 10:00,24 hrs.,RobinHoodPennyStocks,PBR,6,0,6,-6,1,1,0,1,NYSE
5140,16-02-2021 10:00,24 hrs.,RobinHoodPennyStocks,PEG,6,0,6,-6,1,1,0,1,NYSE
5140,16-02-2021 10:00,24 hrs.,RobinHoodPennyStocks,PVL,106,106,0,106,1,44,14,1,NYSE
5140,16-02-2021 10:00,24 hrs.,RobinHoodPennyStocks,SIX,106,106,0,106,1,44,14,1,NYSE
5140,16-02-2021 10:00,24 hrs.,RobinHoodPennyStocks,SOS,193,161,32,129,6,59,51,5,NYSE
5140,16-02-2021 10:00,24 hrs.,RobinHoodPennyStocks,TSM,183,0,183,-183,1,45,89,1,NYSE
5140,16-02-2021 10:00,24 hrs.,RobinHoodPennyStocks,VHC,7,0,7,-7,1,1,1,1,NYSE
5140,16-02-2021 10:00,24 hrs.,RobinHoodPennyStocks,VST,106,106,0,106,1,44,14,1,NYSE
5140,16-02-2021 10:00,24 hrs.,RobinHoodPennyStocks,ARCH,106,106,0,106,1,44,14,1,NYSE
5140,16-02-2021 10:00,24 hrs.,RobinHoodPennyStocks,CCIV,12,12,0,12,2,2,0,1,NYSE
5140,16-02-2021 10:00,24 hrs.,RobinHoodPennyStocks,CSPR,6,0,6,-6,1,1,0,1,NYSE
5140,16-02-2021 10:00,24 hrs.,RobinHoodPennyStocks,HEXO,106,106,0,106,1,44,14,1,NYSE
5140,16-02-2021 10:00,24 hrs.,RobinHoodPennyStocks,ALPP,12,6,6,0,2,2,0,2,OTC
5140,16-02-2021 10:00,24 hrs.,RobinHoodPennyStocks,HCMC,6,6,0,6,1,1,0,1,OTC
5140,16-02-2021 10:00,24 hrs.,wallstreetbets,KTOS,14,14,0,14,2,2,2,2,NASDAQ
5140,16-02-2021 10:00,24 hrs.,wallstreetbets,LKCO,6,6,0,6,1,1,0,1,NASDAQ
5140,16-02-2021 10:00,24 hrs.,wallstreetbets,LOAC,6,6,0,6,1,1,0,1,NASDAQ
5140,16-02-2021 10:00,24 hrs.,wallstreetbets,LPCN,14,0,14,-14,2,2,2,1,NASDAQ
5140,16-02-2021 10:00,24 hrs.,wallstreetbets,MARA,33,19,14,5,4,4,9,3,NASDAQ
5140,16-02-2021 10:00,24 hrs.,wallstreetbets,MBRX,7,0,7,-7,1,1,1,1,NASDAQ
5140,16-02-2021 10:00,24 hrs.,wallstreetbets,MRNA,13,13,0,13,2,2,1,1,NASDAQ
5140,16-02-2021 10:00,24 hrs.,wallstreetbets,MSFT,7,0,7,-7,1,1,1,1,NASDAQ
5140,16-02-2021 10:00,24 hrs.,wallstreetbets,MTCH,7,0,7,-7,1,1,1,1,NASDAQ
5140,16-02-2021 10:00,24 hrs.,wallstreetbets,MVIS,14,7,7,0,2,2,2,2,NASDAQ
5140,16-02-2021 10:00,24 hrs.,wallstreetbets,NAKD,20,13,7,6,3,3,2,3,NASDAQ
5140,16-02-2021 10:00,24 hrs.,wallstreetbets,NEPT,7,0,7,-7,1,1,1,1,NASDAQ
5140,16-02-2021 10:00,24 hrs.,wallstreetbets,NGAC,13,13,0,13,2,2,1,1,NASDAQ
5140,16-02-2021 10:00,24 hrs.,wallstreetbets,NKLA,7,0,7,-7,1,1,1,1,NASDAQ
5140,16-02-2021 10:00,24 hrs.,wallstreetbets,NMRK,102,102,0,102,1,29,40,1,NASDAQ
5140,16-02-2021 10:00,24 hrs.,wallstreetbets,NNDM,6,6,0,6,1,1,0,1,NASDAQ
5140,16-02-2021 10:00,24 hrs.,wallstreetbets,NVAX,22,22,0,22,3,3,4,2,NASDAQ
5140,16-02-2021 10:00,24 hrs.,wallstreetbets,NVDA,37,0,37,-37,1,0,33,1,NASDAQ
5140,16-02-2021 10:00,24 hrs.,wallstreetbets,OCGN,48,34,14,20,7,7,6,5,NASDAQ
5140,16-02-2021 10:00,24 hrs.,wallstreetbets,OIIM,7,0,7,-7,1,1,1,1,NASDAQ
5140,16-02-2021 10:00,24 hrs.,wallstreetbets,OLED,5,0,5,-5,1,0,1,1,NASDAQ
5140,16-02-2021 10:00,24 hrs.,wallstreetbets,OSTK,16,16,0,16,2,3,2,1,NASDAQ
5140,16-02-2021 10:00,24 hrs.,wallstreetbets,OTLK,6,0,6,-6,1,1,0,1,NASDAQ
5140,16-02-2021 10:00,24 hrs.,wallstreetbets,PLAY,7,7,0,7,1,1,1,1,NASDAQ
5140,16-02-2021 10:00,24 hrs.,wallstreetbets,PLUG,13,13,0,13,2,2,1,2,NASDAQ
5140,16-02-2021 10:00,24 hrs.,wallstreetbets,POWW,13,6,7,-1,2,2,1,2,NASDAQ
5140,16-02-2021 10:00,24 hrs.,wallstreetbets,PSEC,6,0,6,-6,1,1,0,1,NASDAQ
5140,16-02-2021 10:00,24 hrs.,wallstreetbets,PYPL,13,6,7,-1,2,2,1,2,NASDAQ
5140,16-02-2021 10:00,24 hrs.,wallstreetbets,QLGN,6,0,6,-6,1,1,0,1,NASDAQ
5140,16-02-2021 10:00,24 hrs.,wallstreetbets,RAVE,6,6,0,6,1,1,0,1,NASDAQ
5140,16-02-2021 10:00,24 hrs.,wallstreetbets,RIOT,33,19,14,5,4,4,9,3,NASDAQ
5140,16-02-2021 10:00,24 hrs.,wallstreetbets,ROOT,7,0,7,-7,1,1,1,1,NASDAQ
5140,16-02-2021 10:00,24 hrs.,wallstreetbets,SAVA,12,0,12,-12,2,2,0,1,NASDAQ
5140,16-02-2021 10:00,24 hrs.,wallstreetbets,SAVE,14,7,7,0,2,2,2,2,NASDAQ
5140,16-02-2021 10:00,24 hrs.,wallstreetbets,SESN,6,0,6,-6,1,1,0,1,NASDAQ
5140,16-02-2021 10:00,24 hrs.,wallstreetbets,SNDL,799,107,692,-585,27,164,363,24,NASDAQ
5140,16-02-2021 10:00,24 hrs.,wallstreetbets,SOLO,7,7,0,7,1,1,1,1,NASDAQ
5140,16-02-2021 10:00,24 hrs.,wallstreetbets,SONO,7,0,7,-7,1,1,1,1,NASDAQ
5140,16-02-2021 10:00,24 hrs.,wallstreetbets,SPWR,12,12,0,12,2,2,0,2,NASDAQ
5140,16-02-2021 10:00,24 hrs.,wallstreetbets,SRNE,21,0,21,-21,3,3,3,1,NASDAQ
5140,16-02-2021 10:00,24 hrs.,wallstreetbets,STLD,634,634,0,634,1,264,102,1,NASDAQ
5140,16-02-2021 10:00,24 hrs.,wallstreetbets,SYBX,6,6,0,6,1,1,0,1,NASDAQ
5140,16-02-2021 10:00,24 hrs.,wallstreetbets,TACO,7,7,0,7,1,1,1,1,NASDAQ
5140,16-02-2021 10:00,24 hrs.,wallstreetbets,TELL,12,6,6,0,2,2,0,2,NASDAQ
5140,16-02-2021 10:00,24 hrs.,wallstreetbets,THCB,7,7,0,7,1,1,1,1,NASDAQ
5140,16-02-2021 10:00,24 hrs.,wallstreetbets,TLGT,7,0,7,-7,1,1,1,1,NASDAQ
5140,16-02-2021 10:00,24 hrs.,wallstreetbets,TLRY,69,49,20,29,10,10,9,9,NASDAQ
5140,16-02-2021 10:00,24 hrs.,wallstreetbets,TNXP,22,15,7,8,3,3,4,3,NASDAQ
5140,16-02-2021 10:00,24 hrs.,wallstreetbets,TOPS,122,7,115,-108,3,44,22,3,NASDAQ
5140,16-02-2021 10:00,24 hrs.,wallstreetbets,TRIT,20,14,6,8,3,3,2,3,NASDAQ
5140,16-02-2021 10:00,24 hrs.,wallstreetbets,TRVG,14,0,14,-14,2,2,2,2,NASDAQ
5140,16-02-2021 10:00,24 hrs.,wallstreetbets,TSLA,101,80,21,59,6,18,41,5,NASDAQ
5140,16-02-2021 10:00,24 hrs.,wallstreetbets,TTCF,7,0,7,-7,1,1,1,1,NASDAQ
5140,16-02-2021 10:00,24 hrs.,wallstreetbets,TXMD,22,16,6,10,3,4,2,3,NASDAQ
5140,16-02-2021 10:00,24 hrs.,wallstreetbets,VKTX,7,7,0,7,1,1,1,1,NASDAQ
5140,16-02-2021 10:00,24 hrs.,wallstreetbets,VXRT,7,7,0,7,1,1,1,1,NASDAQ
5140,16-02-2021 10:00,24 hrs.,wallstreetbets,VYNE,7,7,0,7,1,1,1,1,NASDAQ
5140,16-02-2021 10:00,24 hrs.,wallstreetbets,WATT,6,6,0,6,1,1,0,1,NASDAQ
5140,16-02-2021 10:00,24 hrs.,wallstreetbets,XNET,7,7,0,7,1,1,1,1,NASDAQ
5140,16-02-2021 10:00,24 hrs.,wallstreetbets,XSPA,39,7,32,-25,6,6,3,4,NASDAQ
5140,16-02-2021 10:00,24 hrs.,wallstreetbets,ZNGA,7,0,7,-7,1,1,1,1,NASDAQ
5140,16-02-2021 10:00,24 hrs.,wallstreetbets,ZYNE,14,7,7,0,2,2,2,2,NASDAQ
5140,16-02-2021 10:00,24 hrs.,wallstreetbets,GOOGL,6,6,0,6,1,1,0,1,NASDAQ
5140,16-02-2021 10:00,24 hrs.,RobinHoodPennyStocks,ABWN,6,6,0,6,1,1,0,1,OTC
5140,16-02-2021 10:00,24 hrs.,wallstreetbets,GOEV,20,14,6,8,3,3,2,2,NASDAQ
5140,16-02-2021 10:00,24 hrs.,wallstreetbets,GOLD,21,14,7,7,3,3,3,3,NASDAQ
5140,16-02-2021 10:00,24 hrs.,wallstreetbets,GRFS,7,0,7,-7,1,1,1,1,NASDAQ
5140,16-02-2021 10:00,24 hrs.,wallstreetbets,GTHX,7,7,0,7,1,1,1,1,NASDAQ
5140,16-02-2021 10:00,24 hrs.,wallstreetbets,HDSN,6,6,0,6,1,1,0,1,NASDAQ
5140,16-02-2021 10:00,24 hrs.,wallstreetbets,HJLI,7,7,0,7,1,1,1,1,NASDAQ
5140,16-02-2021 10:00,24 hrs.,wallstreetbets,HOFV,7,0,7,-7,1,1,1,1,NASDAQ
5140,16-02-2021 10:00,24 hrs.,wallstreetbets,HTGM,7,0,7,-7,1,1,1,1,NASDAQ
5140,16-02-2021 10:00,24 hrs.,wallstreetbets,IBKR,351,351,0,351,1,108,131,1,NASDAQ
5140,16-02-2021 10:00,24 hrs.,wallstreetbets,IDEX,7,7,0,7,1,1,1,1,NASDAQ
5140,16-02-2021 10:00,24 hrs.,wallstreetbets,IMGN,7,7,0,7,1,1,1,1,NASDAQ
5140,16-02-2021 10:00,24 hrs.,wallstreetbets,IMMR,14,0,14,-14,2,2,2,1,NASDAQ
5140,16-02-2021 10:00,24 hrs.,wallstreetbets,INFO,1442,0,1442,-1442,1,464,510,1,NASDAQ
5140,16-02-2021 10:00,24 hrs.,wallstreetbets,ITRM,6,6,0,6,1,1,0,1,NASDAQ
5140,16-02-2021 10:00,24 hrs.,wallstreetbets,JACK,7,0,7,-7,1,1,1,1,NASDAQ
5140,16-02-2021 10:00,24 hrs.,wallstreetbets,JNCE,6,0,6,-6,1,1,0,1,NASDAQ
5140,16-02-2021 10:00,24 hrs.,wallstreetbets,AEZS,6,6,0,6,1,1,0,1,NASDAQ
5140,16-02-2021 10:00,24 hrs.,wallstreetbets,AGEN,6,0,6,-6,1,1,0,1,NASDAQ
5140,16-02-2021 10:00,24 hrs.,wallstreetbets,AKAM,7,0,7,-7,1,1,1,1,NASDAQ
5140,16-02-2021 10:00,24 hrs.,wallstreetbets,AMTX,7,7,0,7,1,1,1,1,NASDAQ
5140,16-02-2021 10:00,24 hrs.,wallstreetbets,AMZN,7,7,0,7,1,1,1,1,NASDAQ
5140,16-02-2021 10:00,24 hrs.,wallstreetbets,APHA,32,32,0,32,4,3,10,4,NASDAQ
5140,16-02-2021 10:00,24 hrs.,wallstreetbets,ARTL,6,0,6,-6,1,1,0,1,NASDAQ
5140,16-02-2021 10:00,24 hrs.,wallstreetbets,ASRT,7,7,0,7,1,1,1,1,NASDAQ
5140,16-02-2021 10:00,24 hrs.,wallstreetbets,ATOM,7,7,0,7,1,1,1,1,NASDAQ
5140,16-02-2021 10:00,24 hrs.,wallstreetbets,ATOS,7,0,7,-7,1,1,1,1,NASDAQ
5140,16-02-2021 10:00,24 hrs.,wallstreetbets,AYTU,8,8,0,8,1,1,2,1,NASDAQ
5140,16-02-2021 10:00,24 hrs.,wallstreetbets,BAND,6,0,6,-6,1,1,0,1,NASDAQ
5140,16-02-2021 10:00,24 hrs.,wallstreetbets,BIOL,7,7,0,7,1,1,1,1,NASDAQ
5140,16-02-2021 10:00,24 hrs.,wallstreetbets,BNGO,34,13,21,-8,5,5,4,5,NASDAQ
5140,16-02-2021 10:00,24 hrs.,wallstreetbets,BXRX,14,0,14,-14,2,2,2,2,NASDAQ
5140,16-02-2021 10:00,24 hrs.,wallstreetbets,CRBP,7,7,0,7,1,1,1,1,NASDAQ
5140,16-02-2021 10:00,24 hrs.,wallstreetbets,CRIS,6,6,0,6,1,1,0,1,NASDAQ
5140,16-02-2021 10:00,24 hrs.,wallstreetbets,CRSR,20,14,6,8,3,3,2,3,NASDAQ
5140,16-02-2021 10:00,24 hrs.,wallstreetbets,CSTR,7,0,7,-7,1,1,1,1,NASDAQ
5140,16-02-2021 10:00,24 hrs.,wallstreetbets,CTRM,25,11,14,-3,4,3,3,4,NASDAQ
5140,16-02-2021 10:00,24 hrs.,wallstreetbets,DFFN,7,7,0,7,1,1,1,1,NASDAQ
5140,16-02-2021 10:00,24 hrs.,wallstreetbets,DMTK,7,7,0,7,1,1,1,1,NASDAQ
5140,16-02-2021 10:00,24 hrs.,wallstreetbets,EDIT,2141,2141,0,2141,2,850,433,2,NASDAQ
5140,16-02-2021 10:00,24 hrs.,wallstreetbets,ETSY,7,7,0,7,1,1,1,1,NASDAQ
5140,16-02-2021 10:00,24 hrs.,wallstreetbets,EVER,108,0,108,-108,1,42,20,1,NASDAQ
5140,16-02-2021 10:00,24 hrs.,wallstreetbets,EVFM,6,0,6,-6,1,1,0,1,NASDAQ
5140,16-02-2021 10:00,24 hrs.,wallstreetbets,EXPI,7,7,0,7,1,1,1,1,NASDAQ
5140,16-02-2021 10:00,24 hrs.,wallstreetbets,FANG,7,0,7,-7,1,1,1,1,NASDAQ
5140,16-02-2021 10:00,24 hrs.,wallstreetbets,FARM,6,0,6,-6,1,1,0,1,NASDAQ
5140,16-02-2021 10:00,24 hrs.,wallstreetbets,FCEL,6,6,0,6,1,1,0,1,NASDAQ
5140,16-02-2021 10:00,24 hrs.,wallstreetbets,FIII,5,0,5,-5,1,0,1,1,NASDAQ
5140,16-02-2021 10:00,24 hrs.,wallstreetbets,FORM,351,351,0,351,1,108,131,1,NASDAQ
5140,16-02-2021 10:00,24 hrs.,wallstreetbets,FUTU,180,0,180,-180,2,51,70,2,NASDAQ
5140,16-02-2021 10:00,24 hrs.,wallstreetbets,GAIN,6,0,6,-6,1,1,0,1,NASDAQ
5140,16-02-2021 10:00,24 hrs.,wallstreetbets,GLBS,7,0,7,-7,1,1,1,1,NASDAQ
5140,16-02-2021 10:00,24 hrs.,wallstreetbets,GNUS,19,0,19,-19,3,3,1,2,NASDAQ
5140,16-02-2021 10:00,24 hrs.,wallstreetbets,WFC,7,0,7,-7,1,1,1,1,NYSE
5140,16-02-2021 10:00,24 hrs.,wallstreetbets,WPM,69,69,0,69,1,25,15,1,NYSE
5140,16-02-2021 10:00,24 hrs.,wallstreetbets,WTI,85,85,0,85,1,16,49,1,NYSE
5140,16-02-2021 10:00,24 hrs.,wallstreetbets,WWE,7,7,0,7,1,1,1,1,NYSE
5140,16-02-2021 10:00,24 hrs.,wallstreetbets,AJAX,7,7,0,7,1,1,1,1,NYSE
5140,16-02-2021 10:00,24 hrs.,wallstreetbets,BABA,6,6,0,6,1,1,0,1,NYSE
5140,16-02-2021 10:00,24 hrs.,wallstreetbets,BBAR,6,6,0,6,1,1,0,1,NYSE
5140,16-02-2021 10:00,24 hrs.,wallstreetbets,BORR,7,0,7,-7,1,1,1,1,NYSE
5140,16-02-2021 10:00,24 hrs.,wallstreetbets,CCIV,47,28,19,9,7,7,5,7,NYSE
5140,16-02-2021 10:00,24 hrs.,wallstreetbets,COTY,89,27,62,-35,6,26,13,4,NYSE
5140,16-02-2021 10:00,24 hrs.,wallstreetbets,CSPR,6,0,6,-6,1,1,0,1,NYSE
5140,16-02-2021 10:00,24 hrs.,wallstreetbets,DASH,14,14,0,14,2,2,2,1,NYSE
5140,16-02-2021 10:00,24 hrs.,wallstreetbets,EVRI,6,0,6,-6,1,1,0,1,NYSE
5140,16-02-2021 10:00,24 hrs.,wallstreetbets,FINV,6,6,0,6,1,1,0,1,NYSE
5140,16-02-2021 10:00,24 hrs.,wallstreetbets,FMAC,9,0,9,-9,1,1,3,1,NYSE
5140,16-02-2021 10:00,24 hrs.,wallstreetbets,FUBO,28,14,14,0,4,4,4,3,NYSE
5140,16-02-2021 10:00,24 hrs.,wallstreetbets,HUYA,38,0,38,-38,2,9,12,2,NYSE
5140,16-02-2021 10:00,24 hrs.,wallstreetbets,IPOE,6,6,0,6,1,1,0,1,NYSE
5140,16-02-2021 10:00,24 hrs.,wallstreetbets,LEAP,7,7,0,7,1,1,1,1,NYSE
5140,16-02-2021 10:00,24 hrs.,wallstreetbets,MSGS,6,0,6,-6,1,1,0,1,NYSE
5140,16-02-2021 10:00,24 hrs.,wallstreetbets,PINS,7,7,0,7,1,1,1,1,NYSE
5140,16-02-2021 10:00,24 hrs.,wallstreetbets,PLTR,18659,5764,12895,-7131,43,8354,1779,37,NYSE
5140,16-02-2021 10:00,24 hrs.,wallstreetbets,PSTH,8,0,8,-8,1,2,0,1,NYSE
5140,16-02-2021 10:00,24 hrs.,wallstreetbets,VALE,634,634,0,634,1,264,102,1,NYSE
5140,16-02-2021 10:00,24 hrs.,wallstreetbets,XPEV,6,6,0,6,1,1,0,1,NYSE
5140,16-02-2021 10:00,24 hrs.,wallstreetbets,AAL,19,14,5,9,3,2,3,3,NASDAQ
5140,16-02-2021 10:00,24 hrs.,wallstreetbets,AEP,14,14,0,14,2,2,2,1,NASDAQ
5140,16-02-2021 10:00,24 hrs.,wallstreetbets,AMD,439,439,0,439,3,183,61,3,NASDAQ
5140,16-02-2021 10:00,24 hrs.,wallstreetbets,APA,172,172,0,172,1,64,40,1,NASDAQ
5140,16-02-2021 10:00,24 hrs.,wallstreetbets,AVO,7,0,7,-7,1,1,1,1,NASDAQ
5140,16-02-2021 10:00,24 hrs.,wallstreetbets,AZN,21,21,0,21,3,3,3,1,NASDAQ
5140,16-02-2021 10:00,24 hrs.,wallstreetbets,CDC,41,41,0,41,1,0,37,1,NASDAQ
5140,16-02-2021 10:00,24 hrs.,wallstreetbets,CGC,13,7,6,1,2,2,1,2,NASDAQ
5140,16-02-2021 10:00,24 hrs.,wallstreetbets,DBX,15,7,8,-1,2,2,3,2,NASDAQ
5140,16-02-2021 10:00,24 hrs.,wallstreetbets,GSM,13,7,6,1,2,2,1,2,NASDAQ
5140,16-02-2021 10:00,24 hrs.,wallstreetbets,HAS,4767,0,4767,-4767,2,2084,591,2,NASDAQ
5140,16-02-2021 10:00,24 hrs.,wallstreetbets,HCM,6,0,6,-6,1,1,0,1,NASDAQ
5140,16-02-2021 10:00,24 hrs.,wallstreetbets,INO,19,7,12,-5,3,3,1,2,NASDAQ
5140,16-02-2021 10:00,24 hrs.,wallstreetbets,MWK,7,0,7,-7,1,1,1,1,NASDAQ
5140,16-02-2021 10:00,24 hrs.,wallstreetbets,OGI,20,20,0,20,3,3,2,3,NASDAQ
5140,16-02-2021 10:00,24 hrs.,wallstreetbets,OPK,7,7,0,7,1,1,1,1,NASDAQ
5140,16-02-2021 10:00,24 hrs.,wallstreetbets,PTE,7,0,7,-7,1,1,1,1,NASDAQ
5140,16-02-2021 10:00,24 hrs.,wallstreetbets,REG,7,0,7,-7,1,1,1,1,NASDAQ
5140,16-02-2021 10:00,24 hrs.,wallstreetbets,VRA,7,0,7,-7,1,1,1,1,NASDAQ
5140,16-02-2021 10:00,24 hrs.,wallstreetbets,AACQ,7,0,7,-7,1,1,1,1,NASDAQ
5140,16-02-2021 10:00,24 hrs.,wallstreetbets,AAPL,6,6,0,6,1,1,0,1,NASDAQ
5140,16-02-2021 10:00,24 hrs.,wallstreetbets,ACRX,7,7,0,7,1,1,1,1,NASDAQ
5140,16-02-2021 10:00,24 hrs.,wallstreetbets,ACST,7,7,0,7,1,1,1,1,NASDAQ
5140,16-02-2021 10:00,24 hrs.,wallstreetbets,AMPE,7,7,0,7,1,1,1,1,AMEX
5140,16-02-2021 10:00,24 hrs.,wallstreetbets,CANF,7,0,7,-7,1,1,1,1,AMEX
5140,16-02-2021 10:00,24 hrs.,wallstreetbets,GSAT,19,13,6,7,3,3,1,3,AMEX
5140,16-02-2021 10:00,24 hrs.,wallstreetbets,LODE,7,7,0,7,1,1,1,1,AMEX
5140,16-02-2021 10:00,24 hrs.,wallstreetbets,TRXC,13,7,6,1,2,2,1,2,AMEX
5140,16-02-2021 10:00,24 hrs.,wallstreetbets,UAMY,7,7,0,7,1,1,1,1,AMEX
5140,16-02-2021 10:00,24 hrs.,wallstreetbets,ACB,14,14,0,14,2,2,2,2,NYSE
5140,16-02-2021 10:00,24 hrs.,wallstreetbets,ADX,6,6,0,6,1,1,0,1,NYSE
5140,16-02-2021 10:00,24 hrs.,wallstreetbets,AIR,7,0,7,-7,1,1,1,1,NYSE
5140,16-02-2021 10:00,24 hrs.,wallstreetbets,AMC,1910,1115,795,320,81,658,270,64,NYSE
5140,16-02-2021 10:00,24 hrs.,wallstreetbets,AMP,6,0,6,-6,1,1,0,1,NYSE
5140,16-02-2021 10:00,24 hrs.,wallstreetbets,AVD,7,0,7,-7,1,1,1,1,NYSE
5140,16-02-2021 10:00,24 hrs.,wallstreetbets,BAM,108,0,108,-108,1,42,20,1,NYSE
5140,16-02-2021 10:00,24 hrs.,wallstreetbets,BCH,13,0,13,-13,2,2,1,2,NYSE
5140,16-02-2021 10:00,24 hrs.,wallstreetbets,BFT,7,0,7,-7,1,1,1,1,NYSE
5140,16-02-2021 10:00,24 hrs.,wallstreetbets,BIO,7,0,7,-7,1,1,1,1,NYSE
5140,16-02-2021 10:00,24 hrs.,wallstreetbets,BUD,7,7,0,7,1,1,1,1,NYSE
5140,16-02-2021 10:00,24 hrs.,wallstreetbets,CBD,14,6,8,-2,2,3,0,2,NYSE
5140,16-02-2021 10:00,24 hrs.,wallstreetbets,CNS,7,0,7,-7,1,1,1,1,NYSE
5140,16-02-2021 10:00,24 hrs.,wallstreetbets,CPE,14,14,0,14,2,2,2,2,NYSE
5140,16-02-2021 10:00,24 hrs.,wallstreetbets,CVS,7,7,0,7,1,1,1,1,NYSE
5140,16-02-2021 10:00,24 hrs.,wallstreetbets,CXW,7,0,7,-7,1,1,1,1,NYSE
5140,16-02-2021 10:00,24 hrs.,wallstreetbets,DAC,6,0,6,-6,1,1,0,1,NYSE
5140,16-02-2021 10:00,24 hrs.,wallstreetbets,DCF,634,634,0,634,1,264,102,1,NYSE
5140,16-02-2021 10:00,24 hrs.,wallstreetbets,DGX,146,146,0,146,1,56,30,1,NYSE
5140,16-02-2021 10:00,24 hrs.,wallstreetbets,DIS,6,6,0,6,1,1,0,1,NYSE
5140,16-02-2021 10:00,24 hrs.,wallstreetbets,DOW,6,6,0,6,1,1,0,1,NYSE
5140,16-02-2021 10:00,24 hrs.,wallstreetbets,EFT,15,15,0,15,1,2,7,1,NYSE
5140,16-02-2021 10:00,24 hrs.,wallstreetbets,FCX,69,69,0,69,1,25,15,1,NYSE
5140,16-02-2021 10:00,24 hrs.,wallstreetbets,FNV,69,69,0,69,1,25,15,1,NYSE
5140,16-02-2021 10:00,24 hrs.,wallstreetbets,FSR,206,206,0,206,2,54,90,2,NYSE
5140,16-02-2021 10:00,24 hrs.,wallstreetbets,GEO,20,0,20,-20,3,3,2,1,NYSE
5140,16-02-2021 10:00,24 hrs.,wallstreetbets,GME,32032,25425,6607,18818,149,14372,2692,120,NYSE
5140,16-02-2021 10:00,24 hrs.,wallstreetbets,IAG,7,7,0,7,1,1,1,1,NYSE
5140,16-02-2021 10:00,24 hrs.,wallstreetbets,IBM,7,7,0,7,1,1,1,1,NYSE
5140,16-02-2021 10:00,24 hrs.,wallstreetbets,JPM,85,85,0,85,1,0,81,1,NYSE
5140,16-02-2021 10:00,24 hrs.,wallstreetbets,LAC,13,6,7,-1,2,2,1,2,NYSE
5140,16-02-2021 10:00,24 hrs.,wallstreetbets,LOW,6,0,6,-6,1,1,0,1,NYSE
5140,16-02-2021 10:00,24 hrs.,wallstreetbets,LTC,13,6,7,-1,2,2,1,2,NYSE
5140,16-02-2021 10:00,24 hrs.,wallstreetbets,LYV,6,0,6,-6,1,1,0,1,NYSE
5140,16-02-2021 10:00,24 hrs.,wallstreetbets,MIN,7,0,7,-7,1,1,1,1,NYSE
5140,16-02-2021 10:00,24 hrs.,wallstreetbets,MLM,8,0,8,-8,1,2,0,1,NYSE
5140,16-02-2021 10:00,24 hrs.,wallstreetbets,MRK,6,6,0,6,1,1,0,1,NYSE
5140,16-02-2021 10:00,24 hrs.,wallstreetbets,MSM,2990,0,2990,-2990,1,1399,188,1,NYSE
5140,16-02-2021 10:00,24 hrs.,wallstreetbets,NAT,6,0,6,-6,1,1,0,1,NYSE
5140,16-02-2021 10:00,24 hrs.,wallstreetbets,NIO,222,0,222,-222,3,64,82,3,NYSE
5140,16-02-2021 10:00,24 hrs.,wallstreetbets,NOK,34,14,20,-6,5,5,4,5,NYSE
5140,16-02-2021 10:00,24 hrs.,wallstreetbets,NYC,6,6,0,6,1,1,0,1,NYSE
5140,16-02-2021 10:00,24 hrs.,wallstreetbets,PBF,7,7,0,7,1,1,1,1,NYSE
5140,16-02-2021 10:00,24 hrs.,wallstreetbets,PFE,14,0,14,-14,2,2,2,2,NYSE
5140,16-02-2021 10:00,24 hrs.,wallstreetbets,PMO,14,14,0,14,2,2,2,1,NYSE
5140,16-02-2021 10:00,24 hrs.,wallstreetbets,PSA,7,7,0,7,1,1,1,1,NYSE
5140,16-02-2021 10:00,24 hrs.,wallstreetbets,RBC,56,0,56,-56,1,21,10,1,NYSE
5140,16-02-2021 10:00,24 hrs.,wallstreetbets,RFP,7,0,7,-7,1,1,1,1,NYSE
5140,16-02-2021 10:00,24 hrs.,wallstreetbets,RKT,833,814,19,795,6,279,251,5,NYSE
5140,16-02-2021 10:00,24 hrs.,wallstreetbets,RRC,111,111,0,111,1,9,89,1,NYSE
5140,16-02-2021 10:00,24 hrs.,wallstreetbets,RSI,209,0,209,-209,1,62,81,1,NYSE
5140,16-02-2021 10:00,24 hrs.,wallstreetbets,SNE,7,0,7,-7,1,1,1,1,NYSE
5140,16-02-2021 10:00,24 hrs.,wallstreetbets,SOS,34,7,27,-20,5,5,4,4,NYSE
5140,16-02-2021 10:00,24 hrs.,wallstreetbets,THO,41,41,0,41,1,9,19,1,NYSE
5140,16-02-2021 10:00,24 hrs.,wallstreetbets,TRQ,640,640,0,640,2,265,102,2,NYSE
5140,16-02-2021 10:00,24 hrs.,wallstreetbets,TSM,203,203,0,203,2,69,57,2,NYSE
5140,16-02-2021 10:00,24 hrs.,wallstreetbets,TTI,7,7,0,7,1,1,1,1,NYSE
5140,16-02-2021 10:00,24 hrs.,wallstreetbets,GTBAF,9,0,9,-9,1,1,3,1,OTC
5140,16-02-2021 10:00,24 hrs.,wallstreetbets,HITIF,15,15,0,15,2,2,3,2,OTC
5140,16-02-2021 10:00,24 hrs.,wallstreetbets,HRVSF,7,0,7,-7,1,1,1,1,OTC
5140,16-02-2021 10:00,24 hrs.,wallstreetbets,LKNCY,6,6,0,6,1,1,0,1,OTC
5140,16-02-2021 10:00,24 hrs.,wallstreetbets,MYCOF,6,0,6,-6,1,1,0,1,OTC
5140,16-02-2021 10:00,24 hrs.,wallstreetbets,NXTTF,6,0,6,-6,1,1,0,1,OTC
5140,16-02-2021 10:00,24 hrs.,wallstreetbets,PLNHF,7,7,0,7,1,1,1,1,OTC
5140,16-02-2021 10:00,24 hrs.,wallstreetbets,PONGF,21,7,14,-7,3,3,3,3,OTC
5140,16-02-2021 10:00,24 hrs.,wallstreetbets,REZZF,12,6,6,0,2,2,0,2,OTC
5140,16-02-2021 10:00,24 hrs.,wallstreetbets,RYCEY,18,12,6,6,3,3,0,2,OTC
5140,16-02-2021 10:00,24 hrs.,wallstreetbets,SPRWF,13,0,13,-13,2,2,1,2,OTC
5140,16-02-2021 10:00,24 hrs.,wallstreetbets,VYGVF,7,7,0,7,1,1,1,1,OTC
5140,16-02-2021 10:00,24 hrs.,wallstreetbets,CEI,21,21,0,21,3,3,3,1,AMEX
5140,16-02-2021 10:00,24 hrs.,wallstreetbets,DNN,21,21,0,21,3,3,3,2,AMEX
5140,16-02-2021 10:00,24 hrs.,wallstreetbets,GDP,634,634,0,634,1,264,102,1,AMEX
5140,16-02-2021 10:00,24 hrs.,wallstreetbets,GSV,22,0,22,-22,3,3,4,1,AMEX
5140,16-02-2021 10:00,24 hrs.,wallstreetbets,LEU,6,0,6,-6,1,1,0,1,AMEX
5140,16-02-2021 10:00,24 hrs.,wallstreetbets,MXC,7,0,7,-7,1,1,1,1,AMEX
5140,16-02-2021 10:00,24 hrs.,wallstreetbets,NES,7,0,7,-7,1,1,1,1,AMEX
5140,16-02-2021 10:00,24 hrs.,wallstreetbets,PED,7,7,0,7,1,1,1,1,AMEX
5140,16-02-2021 10:00,24 hrs.,wallstreetbets,TGB,7,0,7,-7,1,1,1,1,AMEX
5140,16-02-2021 10:00,24 hrs.,wallstreetbets,ZOM,28,21,7,14,4,4,4,4,AMEX
5140,16-02-2021 10:00,24 hrs.,wallstreetbets,MJNA,7,0,7,-7,1,1,1,1,OTC
5140,16-02-2021 10:00,24 hrs.,wallstreetbets,ONCX,7,7,0,7,1,1,1,1,OTC
5140,16-02-2021 10:00,24 hrs.,wallstreetbets,OZSC,14,0,14,-14,2,2,2,2,OTC
5140,16-02-2021 10:00,24 hrs.,wallstreetbets,QUBT,6,6,0,6,1,1,0,1,OTC
5140,16-02-2021 10:00,24 hrs.,wallstreetbets,RDGL,7,7,0,7,1,1,1,1,OTC
5140,16-02-2021 10:00,24 hrs.,wallstreetbets,RNWR,6,0,6,-6,1,1,0,1,OTC
5140,16-02-2021 10:00,24 hrs.,wallstreetbets,ROTH,7,0,7,-7,1,1,1,1,OTC
5140,16-02-2021 10:00,24 hrs.,wallstreetbets,RTON,6,6,0,6,1,1,0,1,OTC
5140,16-02-2021 10:00,24 hrs.,wallstreetbets,RXMD,6,0,6,-6,1,1,0,1,OTC
5140,16-02-2021 10:00,24 hrs.,wallstreetbets,SHMP,6,0,6,-6,1,1,0,1,OTC
5140,16-02-2021 10:00,24 hrs.,wallstreetbets,SLNG,6,6,0,6,1,1,0,1,OTC
5140,16-02-2021 10:00,24 hrs.,wallstreetbets,TLSS,7,7,0,7,1,1,1,1,OTC
5140,16-02-2021 10:00,24 hrs.,wallstreetbets,TTCM,6,0,6,-6,1,1,0,1,OTC
5140,16-02-2021 10:00,24 hrs.,wallstreetbets,UEEC,7,0,7,-7,1,1,1,1,OTC
5140,16-02-2021 10:00,24 hrs.,wallstreetbets,USPS,7,0,7,-7,1,1,1,1,OTC
5140,16-02-2021 10:00,24 hrs.,wallstreetbets,AGFAF,6,6,0,6,1,1,0,1,OTC
5140,16-02-2021 10:00,24 hrs.,wallstreetbets,AMYZF,7,7,0,7,1,1,1,1,OTC
5140,16-02-2021 10:00,24 hrs.,wallstreetbets,BRQSW,7,7,0,7,1,1,1,1,OTC
5140,16-02-2021 10:00,24 hrs.,wallstreetbets,BVNNF,7,0,7,-7,1,1,1,1,OTC
5140,16-02-2021 10:00,24 hrs.,wallstreetbets,CIOXY,7,7,0,7,1,1,1,1,OTC
5140,16-02-2021 10:00,24 hrs.,wallstreetbets,DOFSQ,7,7,0,7,1,1,1,1,OTC
5140,16-02-2021 10:00,24 hrs.,wallstreetbets,GAYMF,7,7,0,7,1,1,1,1,OTC
5140,16-02-2021 10:00,24 hrs.,wallstreetbets,GPORQ,7,0,7,-7,1,1,1,1,OTC
5140,16-02-2021 10:00,24 hrs.,pennystocks,CRON,234,234,0,234,1,101,28,1,NASDAQ
5140,16-02-2021 10:00,24 hrs.,pennystocks,CTRM,7,7,0,7,1,1,1,1,NASDAQ
5140,16-02-2021 10:00,24 hrs.,pennystocks,DOGZ,12,12,0,12,1,3,2,1,NASDAQ
5140,16-02-2021 10:00,24 hrs.,pennystocks,EDIT,833,39,794,-755,2,363,99,2,NASDAQ
5140,16-02-2021 10:00,24 hrs.,pennystocks,EPSN,12,12,0,12,1,3,2,1,NASDAQ
5140,16-02-2021 10:00,24 hrs.,pennystocks,GNUS,6,6,0,6,1,1,0,1,NASDAQ
5140,16-02-2021 10:00,24 hrs.,pennystocks,GOLD,7,7,0,7,1,1,1,1,NASDAQ
5140,16-02-2021 10:00,24 hrs.,pennystocks,GRIL,53,53,0,53,2,17,11,1,NASDAQ
5140,16-02-2021 10:00,24 hrs.,pennystocks,KTRA,6,6,0,6,1,1,0,1,NASDAQ
5140,16-02-2021 10:00,24 hrs.,pennystocks,LGHL,12,12,0,12,1,3,2,1,NASDAQ
5140,16-02-2021 10:00,24 hrs.,pennystocks,LIFE,6,0,6,-6,1,1,0,1,NASDAQ
5140,16-02-2021 10:00,24 hrs.,pennystocks,LKCO,12,12,0,12,1,3,2,1,NASDAQ
5140,16-02-2021 10:00,24 hrs.,pennystocks,LOAC,13,13,0,13,2,2,1,1,NASDAQ
5140,16-02-2021 10:00,24 hrs.,pennystocks,MARA,200,0,200,-200,2,60,72,2,NASDAQ
5140,16-02-2021 10:00,24 hrs.,pennystocks,NAKD,6,6,0,6,1,1,0,1,NASDAQ
5140,16-02-2021 10:00,24 hrs.,pennystocks,NEOS,53,53,0,53,2,17,11,1,NASDAQ
5140,16-02-2021 10:00,24 hrs.,pennystocks,NVCN,42,0,42,-42,1,10,18,1,NASDAQ
5140,16-02-2021 10:00,24 hrs.,pennystocks,OBSV,149,149,0,149,1,50,45,1,NASDAQ
5140,16-02-2021 10:00,24 hrs.,pennystocks,OTLK,6,0,6,-6,1,1,0,1,NASDAQ
5140,16-02-2021 10:00,24 hrs.,pennystocks,PANL,12,12,0,12,1,3,2,1,NASDAQ
5140,16-02-2021 10:00,24 hrs.,pennystocks,PFMT,6,6,0,6,1,1,0,1,NASDAQ
5140,16-02-2021 10:00,24 hrs.,pennystocks,PHAR,26,0,26,-26,1,10,2,1,NASDAQ
5140,16-02-2021 10:00,24 hrs.,pennystocks,PLUS,6,0,6,-6,1,1,0,1,NASDAQ
5140,16-02-2021 10:00,24 hrs.,pennystocks,PTON,94,0,94,-94,1,38,14,1,NASDAQ
5140,16-02-2021 10:00,24 hrs.,pennystocks,RAVE,53,53,0,53,2,17,11,1,NASDAQ
5140,16-02-2021 10:00,24 hrs.,pennystocks,RIOT,200,0,200,-200,2,60,72,2,NASDAQ
5140,16-02-2021 10:00,24 hrs.,pennystocks,ROKU,21,21,0,21,1,5,7,1,NASDAQ
5140,16-02-2021 10:00,24 hrs.,pennystocks,SHIP,50,0,50,-50,1,9,28,1,NASDAQ
5140,16-02-2021 10:00,24 hrs.,pennystocks,SNDL,51,44,7,37,7,9,5,6,NASDAQ
5140,16-02-2021 10:00,24 hrs.,pennystocks,SNGX,60,60,0,60,3,18,12,2,NASDAQ
5140,16-02-2021 10:00,24 hrs.,pennystocks,TLRY,234,234,0,234,1,101,28,1,NASDAQ
5140,16-02-2021 10:00,24 hrs.,pennystocks,TRCH,12,0,12,-12,1,0,8,1,NASDAQ
5140,16-02-2021 10:00,24 hrs.,pennystocks,TRVG,53,53,0,53,2,17,11,1,NASDAQ
5140,16-02-2021 10:00,24 hrs.,pennystocks,TSLA,37,0,37,-37,1,13,7,1,NASDAQ
5140,16-02-2021 10:00,24 hrs.,pennystocks,TTOO,6,6,0,6,1,1,0,1,NASDAQ
5140,16-02-2021 10:00,24 hrs.,pennystocks,TXMD,6,0,6,-6,1,1,0,1,NASDAQ
5140,16-02-2021 10:00,24 hrs.,pennystocks,XSPA,377,21,356,-335,4,142,77,4,NASDAQ
5140,16-02-2021 10:00,24 hrs.,pennystocks,ZYNE,13,13,0,13,1,3,3,1,NASDAQ
5140,16-02-2021 10:00,24 hrs.,wallstreetbets,ABML,7,0,7,-7,1,1,1,1,OTC
5140,16-02-2021 10:00,24 hrs.,wallstreetbets,AITX,7,0,7,-7,1,1,1,1,OTC
5140,16-02-2021 10:00,24 hrs.,wallstreetbets,ALKN,13,13,0,13,2,2,1,2,OTC
5140,16-02-2021 10:00,24 hrs.,wallstreetbets,ARST,7,7,0,7,1,1,1,1,OTC
5140,16-02-2021 10:00,24 hrs.,wallstreetbets,ASTI,14,14,0,14,2,2,2,1,OTC
5140,16-02-2021 10:00,24 hrs.,wallstreetbets,BBRW,7,7,0,7,1,1,1,1,OTC
5140,16-02-2021 10:00,24 hrs.,wallstreetbets,BOTH,1442,0,1442,-1442,1,464,510,1,OTC
5140,16-02-2021 10:00,24 hrs.,wallstreetbets,BOTY,7,0,7,-7,1,1,1,1,OTC
5140,16-02-2021 10:00,24 hrs.,wallstreetbets,BTCS,14,7,7,0,2,2,2,2,OTC
5140,16-02-2021 10:00,24 hrs.,wallstreetbets,COMS,12,12,0,12,2,2,0,1,OTC
5140,16-02-2021 10:00,24 hrs.,wallstreetbets,CYDY,15,15,0,15,2,2,3,1,OTC
5140,16-02-2021 10:00,24 hrs.,wallstreetbets,ECDP,7,0,7,-7,1,1,1,1,OTC
5140,16-02-2021 10:00,24 hrs.,wallstreetbets,ETFM,7,7,0,7,1,1,1,1,OTC
5140,16-02-2021 10:00,24 hrs.,wallstreetbets,FLES,14,14,0,14,2,2,2,1,OTC
5140,16-02-2021 10:00,24 hrs.,wallstreetbets,FMCC,495,172,323,-151,2,152,183,2,OTC
5140,16-02-2021 10:00,24 hrs.,wallstreetbets,FNMA,495,172,323,-151,2,152,183,2,OTC
5140,16-02-2021 10:00,24 hrs.,wallstreetbets,GARB,7,7,0,7,1,1,1,1,OTC
5140,16-02-2021 10:00,24 hrs.,wallstreetbets,GPFT,14,0,14,-14,2,2,2,2,OTC
5140,16-02-2021 10:00,24 hrs.,wallstreetbets,GTLL,14,14,0,14,2,2,2,2,OTC
5140,16-02-2021 10:00,24 hrs.,wallstreetbets,HCMC,54,14,40,-26,8,8,6,8,OTC
5140,16-02-2021 10:00,24 hrs.,wallstreetbets,HYSR,13,0,13,-13,2,2,1,2,OTC
5140,16-02-2021 10:00,24 hrs.,wallstreetbets,JSDA,7,0,7,-7,1,1,1,1,OTC
5140,16-02-2021 10:00,24 hrs.,wallstreetbets,LAAB,7,0,7,-7,1,1,1,1,OTC
5140,16-02-2021 10:00,24 hrs.,wallstreetbets,MCOA,21,0,21,-21,3,3,3,2,OTC
5140,16-02-2021 10:00,24 hrs.,pennystocks,CSV,794,0,794,-794,1,363,64,1,NYSE
5140,16-02-2021 10:00,24 hrs.,pennystocks,DSX,12,12,0,12,1,3,2,1,NYSE
5140,16-02-2021 10:00,24 hrs.,pennystocks,EAT,240,240,0,240,2,102,28,2,NYSE
5140,16-02-2021 10:00,24 hrs.,pennystocks,FPL,12,12,0,12,1,3,2,1,NYSE
5140,16-02-2021 10:00,24 hrs.,pennystocks,MUX,67,0,67,-67,1,15,33,1,NYSE
5140,16-02-2021 10:00,24 hrs.,pennystocks,NAT,12,12,0,12,1,3,2,1,NYSE
5140,16-02-2021 10:00,24 hrs.,pennystocks,NAV,26,0,26,-26,1,10,2,1,NYSE
5140,16-02-2021 10:00,24 hrs.,pennystocks,NYT,57,49,8,41,2,9,31,2,NYSE
5140,16-02-2021 10:00,24 hrs.,pennystocks,PEG,217,217,0,217,1,101,11,1,NYSE
5140,16-02-2021 10:00,24 hrs.,pennystocks,PEN,116,116,0,116,1,48,16,1,NYSE
5140,16-02-2021 10:00,24 hrs.,pennystocks,PKG,181,0,181,-181,1,69,39,1,NYSE
5140,16-02-2021 10:00,24 hrs.,pennystocks,SOS,26,19,7,12,4,4,2,3,NYSE
5140,16-02-2021 10:00,24 hrs.,pennystocks,THC,240,234,6,228,2,102,28,2,NYSE
5140,16-02-2021 10:00,24 hrs.,pennystocks,CSPR,6,0,6,-6,1,1,0,1,NYSE
5140,16-02-2021 10:00,24 hrs.,pennystocks,FLOW,217,217,0,217,1,101,11,1,NYSE
5140,16-02-2021 10:00,24 hrs.,pennystocks,FUBO,21,21,0,21,1,5,7,1,NYSE
5140,16-02-2021 10:00,24 hrs.,pennystocks,PLTR,19,19,0,19,1,4,7,1,NYSE
5140,16-02-2021 10:00,24 hrs.,pennystocks,SPCE,94,0,94,-94,1,38,14,1,NYSE
5140,16-02-2021 10:00,24 hrs.,pennystocks,API,794,0,794,-794,1,363,64,1,NASDAQ
5140,16-02-2021 10:00,24 hrs.,pennystocks,CGC,300,234,66,168,2,130,32,2,NASDAQ
5140,16-02-2021 10:00,24 hrs.,pennystocks,ESG,94,94,0,94,1,40,10,1,NASDAQ
5140,16-02-2021 10:00,24 hrs.,pennystocks,FNX,6,0,6,-6,1,1,0,1,NASDAQ
5140,16-02-2021 10:00,24 hrs.,pennystocks,III,6,0,6,-6,1,1,0,1,NASDAQ
5140,16-02-2021 10:00,24 hrs.,pennystocks,OLB,6,0,6,-6,1,1,0,1,NASDAQ
5140,16-02-2021 10:00,24 hrs.,pennystocks,PFC,7,7,0,7,1,1,1,1,NASDAQ
5140,16-02-2021 10:00,24 hrs.,pennystocks,PLL,32,0,32,-32,1,9,10,1,NASDAQ
5140,16-02-2021 10:00,24 hrs.,pennystocks,PXS,53,53,0,53,2,17,11,1,NASDAQ
5140,16-02-2021 10:00,24 hrs.,pennystocks,AACG,6,0,6,-6,1,1,0,1,NASDAQ
5140,16-02-2021 10:00,24 hrs.,pennystocks,ACST,6,6,0,6,1,1,0,1,NASDAQ
5140,16-02-2021 10:00,24 hrs.,pennystocks,AIKI,53,53,0,53,2,17,11,1,NASDAQ
5140,16-02-2021 10:00,24 hrs.,pennystocks,AKBA,6,6,0,6,1,1,0,1,NASDAQ
5140,16-02-2021 10:00,24 hrs.,pennystocks,ANTE,9,0,9,-9,1,2,1,1,NASDAQ
5140,16-02-2021 10:00,24 hrs.,pennystocks,APHA,234,234,0,234,1,101,28,1,NASDAQ
5140,16-02-2021 10:00,24 hrs.,pennystocks,ATOS,6,0,6,-6,1,1,0,1,NASDAQ
5140,16-02-2021 10:00,24 hrs.,pennystocks,AYTU,53,53,0,53,2,17,11,1,NASDAQ
5140,16-02-2021 10:00,24 hrs.,pennystocks,BEAT,18,18,0,18,1,5,4,1,NASDAQ
5140,16-02-2021 10:00,24 hrs.,pennystocks,BIOL,6,0,6,-6,1,1,0,1,NASDAQ
5140,16-02-2021 10:00,24 hrs.,pennystocks,BKEP,12,12,0,12,1,3,2,1,NASDAQ
5140,16-02-2021 10:00,24 hrs.,pennystocks,BNGO,94,0,94,-94,1,38,14,1,NASDAQ
5140,16-02-2021 10:00,24 hrs.,pennystocks,BTBT,43,0,43,-43,1,5,29,1,NASDAQ
5140,16-02-2021 10:00,24 hrs.,pennystocks,CASH,217,217,0,217,1,101,11,1,NASDAQ
5140,16-02-2021 10:00,24 hrs.,pennystocks,CETX,53,53,0,53,2,17,11,1,NASDAQ
5140,16-02-2021 10:00,24 hrs.,pennystocks,CIDM,21,21,0,21,1,5,7,1,NASDAQ
5140,16-02-2021 10:00,24 hrs.,pennystocks,CKPT,6,6,0,6,1,1,0,1,NASDAQ
5140,16-02-2021 10:00,24 hrs.,pennystocks,CRBP,13,13,0,13,1,3,3,1,NASDAQ
5140,16-02-2021 10:00,24 hrs.,pennystocks,GWMGF,6,6,0,6,1,1,0,1,OTC
5140,16-02-2021 10:00,24 hrs.,pennystocks,HITIF,59,0,59,-59,1,12,31,1,OTC
5140,16-02-2021 10:00,24 hrs.,pennystocks,HTZGQ,6,6,0,6,1,1,0,1,OTC
5140,16-02-2021 10:00,24 hrs.,pennystocks,HUTMF,43,0,43,-43,1,5,29,1,OTC
5140,16-02-2021 10:00,24 hrs.,pennystocks,HVBTF,6,0,6,-6,1,1,0,1,OTC
5140,16-02-2021 10:00,24 hrs.,pennystocks,LKNCY,6,0,6,-6,1,1,0,1,OTC
5140,16-02-2021 10:00,24 hrs.,pennystocks,MLLOF,94,94,0,94,1,40,10,1,OTC
5140,16-02-2021 10:00,24 hrs.,pennystocks,MMNFF,6,0,6,-6,1,1,0,1,OTC
5140,16-02-2021 10:00,24 hrs.,pennystocks,MMTIF,26,0,26,-26,1,5,12,1,OTC
5140,16-02-2021 10:00,24 hrs.,pennystocks,MNXXF,7,7,0,7,1,1,1,1,OTC
5140,16-02-2021 10:00,24 hrs.,pennystocks,MPXOF,10,10,0,10,1,2,2,1,OTC
5140,16-02-2021 10:00,24 hrs.,pennystocks,MYCOF,66,0,66,-66,1,29,4,1,OTC
5140,16-02-2021 10:00,24 hrs.,pennystocks,NMGRF,23,23,0,23,1,4,11,1,OTC
5140,16-02-2021 10:00,24 hrs.,pennystocks,NMTLF,68,68,0,68,2,26,8,2,OTC
5140,16-02-2021 10:00,24 hrs.,pennystocks,OTIVF,6,0,6,-6,1,1,0,1,OTC
5140,16-02-2021 10:00,24 hrs.,pennystocks,PDDTF,32,0,32,-32,1,9,10,1,OTC
5140,16-02-2021 10:00,24 hrs.,pennystocks,POETF,6,0,6,-6,1,1,0,1,OTC
5140,16-02-2021 10:00,24 hrs.,pennystocks,PYRNF,24,24,0,24,1,7,6,1,OTC
5140,16-02-2021 10:00,24 hrs.,pennystocks,ROCLF,7,0,7,-7,1,1,1,1,OTC
5140,16-02-2021 10:00,24 hrs.,pennystocks,TAKOF,6,0,6,-6,1,1,0,1,OTC
5140,16-02-2021 10:00,24 hrs.,pennystocks,TGIFF,22,0,22,-22,1,7,4,1,OTC
5140,16-02-2021 10:00,24 hrs.,pennystocks,TOBAF,6,0,6,-6,1,1,0,1,OTC
5140,16-02-2021 10:00,24 hrs.,pennystocks,TOWTF,13,0,13,-13,2,2,1,1,OTC
5140,16-02-2021 10:00,24 hrs.,pennystocks,TTTPF,7,0,7,-7,1,1,1,1,OTC
5140,16-02-2021 10:00,24 hrs.,pennystocks,WCEXF,39,0,39,-39,1,6,23,1,OTC
5140,16-02-2021 10:00,24 hrs.,pennystocks,WDDMF,6,0,6,-6,1,1,0,1,OTC
5140,16-02-2021 10:00,24 hrs.,pennystocks,DNN,25,25,0,25,1,9,3,1,AMEX
5140,16-02-2021 10:00,24 hrs.,pennystocks,GSV,6,0,6,-6,1,1,0,1,AMEX
5140,16-02-2021 10:00,24 hrs.,pennystocks,ISR,116,116,0,116,1,48,16,1,AMEX
5140,16-02-2021 10:00,24 hrs.,pennystocks,NAK,7,7,0,7,1,1,1,1,AMEX
5140,16-02-2021 10:00,24 hrs.,pennystocks,UEC,116,116,0,116,1,48,16,1,AMEX
5140,16-02-2021 10:00,24 hrs.,pennystocks,AMPE,12,12,0,12,1,3,2,1,AMEX
5140,16-02-2021 10:00,24 hrs.,pennystocks,GSAT,6,6,0,6,1,1,0,1,AMEX
5140,16-02-2021 10:00,24 hrs.,pennystocks,INUV,40,0,40,-40,2,11,10,2,AMEX
5140,16-02-2021 10:00,24 hrs.,pennystocks,SENS,6,0,6,-6,1,1,0,1,AMEX
5140,16-02-2021 10:00,24 hrs.,pennystocks,UAMY,35,35,0,35,1,9,13,1,AMEX
5140,16-02-2021 10:00,24 hrs.,pennystocks,ACB,234,234,0,234,1,101,28,1,NYSE
5140,16-02-2021 10:00,24 hrs.,pennystocks,AFC,6,6,0,6,1,1,0,1,NYSE
5140,16-02-2021 10:00,24 hrs.,pennystocks,AMC,6,6,0,6,1,1,0,1,NYSE
5140,16-02-2021 10:00,24 hrs.,pennystocks,ASX,128,122,6,116,3,50,16,3,NYSE
5140,16-02-2021 10:00,24 hrs.,pennystocks,BMO,234,234,0,234,1,101,28,1,NYSE
5140,16-02-2021 10:00,24 hrs.,pennystocks,BYD,37,0,37,-37,1,13,7,1,NYSE
5140,16-02-2021 10:00,24 hrs.,pennystocks,CBD,240,234,6,228,2,102,28,2,NYSE
5128,16-02-2021 08:00,24 hrs.,pennystocks,CINGF,39,39,0,39,1,7,21,1,OTC
5128,16-02-2021 08:00,24 hrs.,pennystocks,CYDVF,6,0,6,-6,1,1,0,1,OTC
5128,16-02-2021 08:00,24 hrs.,pennystocks,EFLVF,6,0,6,-6,1,1,0,1,OTC
5128,16-02-2021 08:00,24 hrs.,pennystocks,EPWCF,6,0,6,-6,1,1,0,1,OTC
5128,16-02-2021 08:00,24 hrs.,pennystocks,ERPNF,99,0,99,-99,2,33,25,2,OTC
5128,16-02-2021 08:00,24 hrs.,pennystocks,FUNFF,6,0,6,-6,1,1,0,1,OTC
5128,16-02-2021 08:00,24 hrs.,pennystocks,GWMGF,6,6,0,6,1,1,0,1,OTC
5128,16-02-2021 08:00,24 hrs.,pennystocks,HITIF,59,0,59,-59,1,12,31,1,OTC
5128,16-02-2021 08:00,24 hrs.,pennystocks,HTZGQ,6,6,0,6,1,1,0,1,OTC
5128,16-02-2021 08:00,24 hrs.,pennystocks,HUTMF,43,0,43,-43,1,5,29,1,OTC
5128,16-02-2021 08:00,24 hrs.,pennystocks,HVBTF,12,12,0,12,2,2,0,2,OTC
5128,16-02-2021 08:00,24 hrs.,pennystocks,LIACF,27,0,27,-27,1,10,3,1,OTC
5128,16-02-2021 08:00,24 hrs.,pennystocks,LKNCY,6,0,6,-6,1,1,0,1,OTC
5128,16-02-2021 08:00,24 hrs.,pennystocks,MLLOF,102,102,0,102,1,44,10,1,OTC
5128,16-02-2021 08:00,24 hrs.,pennystocks,MMNFF,6,0,6,-6,1,1,0,1,OTC
5128,16-02-2021 08:00,24 hrs.,pennystocks,MMTIF,26,0,26,-26,1,5,12,1,OTC
5128,16-02-2021 08:00,24 hrs.,pennystocks,MNXXF,149,51,98,-47,4,51,31,4,OTC
5128,16-02-2021 08:00,24 hrs.,pennystocks,MPUCF,6,6,0,6,1,1,0,1,OTC
5128,16-02-2021 08:00,24 hrs.,pennystocks,MPXOF,10,10,0,10,1,2,2,1,OTC
5128,16-02-2021 08:00,24 hrs.,pennystocks,MSNVF,571,571,0,571,1,232,103,1,OTC
5128,16-02-2021 08:00,24 hrs.,pennystocks,MYCOF,62,0,62,-62,1,27,4,1,OTC
5128,16-02-2021 08:00,24 hrs.,pennystocks,NMHLY,12,6,6,0,2,2,0,2,OTC
5128,16-02-2021 08:00,24 hrs.,pennystocks,NMTLF,48,48,0,48,2,18,4,2,OTC
5128,16-02-2021 08:00,24 hrs.,pennystocks,OTIVF,6,0,6,-6,1,1,0,1,OTC
5128,16-02-2021 08:00,24 hrs.,pennystocks,PDDTF,38,0,38,-38,1,12,10,1,OTC
5128,16-02-2021 08:00,24 hrs.,pennystocks,PLUUF,27,0,27,-27,1,10,3,1,OTC
5128,16-02-2021 08:00,24 hrs.,pennystocks,POETF,12,0,12,-12,2,2,0,1,OTC
5128,16-02-2021 08:00,24 hrs.,pennystocks,PYRNF,24,24,0,24,1,7,6,1,OTC
5128,16-02-2021 08:00,24 hrs.,pennystocks,REGRF,39,39,0,39,1,7,21,1,OTC
5128,16-02-2021 08:00,24 hrs.,pennystocks,ROCLF,7,0,7,-7,1,1,1,1,OTC
5128,16-02-2021 08:00,24 hrs.,pennystocks,TAKOF,6,0,6,-6,1,1,0,1,OTC
5128,16-02-2021 08:00,24 hrs.,pennystocks,TGIFF,22,0,22,-22,1,7,4,1,OTC
5128,16-02-2021 08:00,24 hrs.,pennystocks,TOBAF,6,0,6,-6,1,1,0,1,OTC
5128,16-02-2021 08:00,24 hrs.,pennystocks,TOWTF,13,0,13,-13,2,2,1,1,OTC
5128,16-02-2021 08:00,24 hrs.,pennystocks,TTTPF,7,0,7,-7,1,1,1,1,OTC
5128,16-02-2021 08:00,24 hrs.,pennystocks,WCEXF,38,0,38,-38,1,7,20,1,OTC
5128,16-02-2021 08:00,24 hrs.,pennystocks,WDDMF,6,0,6,-6,1,1,0,1,OTC
5128,16-02-2021 08:00,24 hrs.,pennystocks,AIM,16,16,0,16,1,5,2,1,AMEX
5128,16-02-2021 08:00,24 hrs.,pennystocks,TRVG,38,38,0,38,2,10,10,1,NASDAQ
5128,16-02-2021 08:00,24 hrs.,pennystocks,PKG,181,0,181,-181,1,69,39,1,NYSE
5128,16-02-2021 08:00,24 hrs.,pennystocks,SOS,84,70,14,56,8,12,28,5,NYSE
5128,16-02-2021 08:00,24 hrs.,pennystocks,THC,239,233,6,227,2,102,27,2,NYSE
5128,16-02-2021 08:00,24 hrs.,pennystocks,CSPR,6,0,6,-6,1,1,0,1,NYSE
5128,16-02-2021 08:00,24 hrs.,pennystocks,FLOW,188,188,0,188,1,88,8,1,NYSE
5128,16-02-2021 08:00,24 hrs.,pennystocks,FUBO,20,20,0,20,1,5,6,1,NYSE
5128,16-02-2021 08:00,24 hrs.,pennystocks,PLTR,21,21,0,21,1,5,7,1,NYSE
5128,16-02-2021 08:00,24 hrs.,pennystocks,SPCE,84,0,84,-84,1,33,14,1,NYSE
5128,16-02-2021 08:00,24 hrs.,pennystocks,SPOT,6,0,6,-6,1,1,0,1,NYSE
5128,16-02-2021 08:00,24 hrs.,pennystocks,API,809,0,809,-809,2,368,65,2,NASDAQ
5128,16-02-2021 08:00,24 hrs.,pennystocks,CGC,295,233,62,171,2,128,31,2,NASDAQ
5128,16-02-2021 08:00,24 hrs.,pennystocks,ESG,102,102,0,102,1,44,10,1,NASDAQ
5128,16-02-2021 08:00,24 hrs.,pennystocks,CTO,168,0,168,-168,1,53,58,1,AMEX
5128,16-02-2021 08:00,24 hrs.,pennystocks,DNN,21,21,0,21,1,7,3,1,AMEX
5128,16-02-2021 08:00,24 hrs.,pennystocks,GSV,6,6,0,6,1,1,0,1,AMEX
5128,16-02-2021 08:00,24 hrs.,pennystocks,ISR,96,96,0,96,1,39,14,1,AMEX
5128,16-02-2021 08:00,24 hrs.,pennystocks,NAK,7,7,0,7,1,1,1,1,AMEX
5128,16-02-2021 08:00,24 hrs.,pennystocks,UEC,96,96,0,96,1,39,14,1,AMEX
5128,16-02-2021 08:00,24 hrs.,pennystocks,GSAT,6,6,0,6,1,1,0,1,AMEX
5128,16-02-2021 08:00,24 hrs.,pennystocks,INUV,40,34,6,28,2,11,10,2,AMEX
5128,16-02-2021 08:00,24 hrs.,pennystocks,SENS,6,0,6,-6,1,1,0,1,AMEX
5128,16-02-2021 08:00,24 hrs.,pennystocks,UAMY,33,33,0,33,1,8,13,1,AMEX
5128,16-02-2021 08:00,24 hrs.,pennystocks,ACB,233,233,0,233,1,101,27,1,NYSE
5128,16-02-2021 08:00,24 hrs.,pennystocks,AMC,6,6,0,6,1,1,0,1,NYSE
5128,16-02-2021 08:00,24 hrs.,pennystocks,ASX,128,122,6,116,4,46,20,4,NYSE
5128,16-02-2021 08:00,24 hrs.,pennystocks,BCH,11,0,11,-11,1,2,3,1,NYSE
5128,16-02-2021 08:00,24 hrs.,pennystocks,BMO,233,233,0,233,1,101,27,1,NYSE
5128,16-02-2021 08:00,24 hrs.,pennystocks,BYD,35,0,35,-35,1,12,7,1,NYSE
5128,16-02-2021 08:00,24 hrs.,pennystocks,CBD,239,233,6,227,2,102,27,2,NYSE
5128,16-02-2021 08:00,24 hrs.,pennystocks,CCO,12,0,12,-12,1,2,4,1,NYSE
5128,16-02-2021 08:00,24 hrs.,pennystocks,COO,12,0,12,-12,1,2,4,1,NYSE
5128,16-02-2021 08:00,24 hrs.,pennystocks,CSV,796,0,796,-796,1,364,64,1,NYSE
5128,16-02-2021 08:00,24 hrs.,pennystocks,EAT,239,239,0,239,2,102,27,2,NYSE
5128,16-02-2021 08:00,24 hrs.,pennystocks,ETH,17,6,11,-5,2,3,3,2,NYSE
5128,16-02-2021 08:00,24 hrs.,pennystocks,MUX,69,0,69,-69,1,16,33,1,NYSE
5128,16-02-2021 08:00,24 hrs.,pennystocks,NAV,22,0,22,-22,1,8,2,1,NYSE
5128,16-02-2021 08:00,24 hrs.,pennystocks,NYT,57,57,0,57,2,9,31,1,NYSE
5128,16-02-2021 08:00,24 hrs.,pennystocks,PEG,188,188,0,188,1,88,8,1,NYSE
5128,16-02-2021 08:00,24 hrs.,pennystocks,PEN,96,96,0,96,1,39,14,1,NYSE
5128,16-02-2021 08:00,24 hrs.,pennystocks,PURA,17,17,0,17,1,4,5,1,OTC
5128,16-02-2021 08:00,24 hrs.,pennystocks,RNWR,6,6,0,6,1,1,0,1,OTC
5128,16-02-2021 08:00,24 hrs.,pennystocks,SGMD,122,107,15,92,3,16,78,3,OTC
5128,16-02-2021 08:00,24 hrs.,pennystocks,SIML,95,95,0,95,1,38,15,1,OTC
5128,16-02-2021 08:00,24 hrs.,pennystocks,SINC,6,6,0,6,1,1,0,1,OTC
5128,16-02-2021 08:00,24 hrs.,pennystocks,SIRC,37,37,0,37,1,5,23,1,OTC
5128,16-02-2021 08:00,24 hrs.,pennystocks,SNPW,109,109,0,109,3,40,17,2,OTC
5128,16-02-2021 08:00,24 hrs.,pennystocks,SRMX,50,44,6,38,3,14,10,3,OTC
5128,16-02-2021 08:00,24 hrs.,pennystocks,SSFT,492,6,486,-480,3,176,128,3,OTC
5128,16-02-2021 08:00,24 hrs.,pennystocks,SUGR,6,6,0,6,1,1,0,1,OTC
5128,16-02-2021 08:00,24 hrs.,pennystocks,TLSS,68,68,0,68,2,9,42,2,OTC
5128,16-02-2021 08:00,24 hrs.,pennystocks,UNVC,7,7,0,7,1,1,1,1,OTC
5128,16-02-2021 08:00,24 hrs.,pennystocks,UVSE,7,7,0,7,1,1,1,1,OTC
5128,16-02-2021 08:00,24 hrs.,pennystocks,VPER,992,0,992,-992,2,316,352,2,OTC
5128,16-02-2021 08:00,24 hrs.,pennystocks,VPRB,6,6,0,6,1,1,0,1,OTC
5128,16-02-2021 08:00,24 hrs.,pennystocks,WARM,12,0,12,-12,2,2,0,1,OTC
5128,16-02-2021 08:00,24 hrs.,pennystocks,WDLF,6,0,6,-6,1,1,0,1,OTC
5128,16-02-2021 08:00,24 hrs.,pennystocks,WGNR,8,8,0,8,1,1,2,1,OTC
5128,16-02-2021 08:00,24 hrs.,pennystocks,AACTF,77,0,77,-77,2,26,17,2,OTC
5128,16-02-2021 08:00,24 hrs.,pennystocks,ABEPF,59,0,59,-59,1,12,31,1,OTC
5128,16-02-2021 08:00,24 hrs.,pennystocks,AMYZF,53,53,0,53,1,20,9,1,OTC
5128,16-02-2021 08:00,24 hrs.,pennystocks,ARBKF,204,0,204,-204,3,58,76,3,OTC
5128,16-02-2021 08:00,24 hrs.,pennystocks,BYDDY,35,0,35,-35,1,12,7,1,OTC
5128,16-02-2021 08:00,24 hrs.,pennystocks,CANSF,233,233,0,233,1,101,27,1,OTC
5128,16-02-2021 08:00,24 hrs.,wallstreetbets,ARST,7,7,0,7,1,1,1,1,OTC
5128,16-02-2021 08:00,24 hrs.,pennystocks,FNX,6,0,6,-6,1,1,0,1,NASDAQ
5128,16-02-2021 08:00,24 hrs.,pennystocks,III,12,0,12,-12,2,2,0,1,NASDAQ
5128,16-02-2021 08:00,24 hrs.,pennystocks,KOD,87,0,87,-87,1,25,33,1,NASDAQ
5128,16-02-2021 08:00,24 hrs.,pennystocks,OGI,7,7,0,7,1,1,1,1,NASDAQ
5128,16-02-2021 08:00,24 hrs.,pennystocks,OLB,6,0,6,-6,1,1,0,1,NASDAQ
5128,16-02-2021 08:00,24 hrs.,pennystocks,PFC,13,13,0,13,2,2,1,2,NASDAQ
5128,16-02-2021 08:00,24 hrs.,pennystocks,PLL,38,0,38,-38,1,12,10,1,NASDAQ
5128,16-02-2021 08:00,24 hrs.,pennystocks,PXS,38,38,0,38,2,10,10,1,NASDAQ
5128,16-02-2021 08:00,24 hrs.,pennystocks,AACG,6,0,6,-6,1,1,0,1,NASDAQ
5128,16-02-2021 08:00,24 hrs.,pennystocks,ACST,6,6,0,6,1,1,0,1,NASDAQ
5128,16-02-2021 08:00,24 hrs.,pennystocks,AIKI,38,38,0,38,2,10,10,1,NASDAQ
5128,16-02-2021 08:00,24 hrs.,pennystocks,AKBA,6,6,0,6,1,1,0,1,NASDAQ
5128,16-02-2021 08:00,24 hrs.,pennystocks,AMZN,8,8,0,8,1,1,2,1,NASDAQ
5128,16-02-2021 08:00,24 hrs.,pennystocks,ANTE,9,0,9,-9,1,2,1,1,NASDAQ
5128,16-02-2021 08:00,24 hrs.,pennystocks,APHA,233,233,0,233,1,101,27,1,NASDAQ
5128,16-02-2021 08:00,24 hrs.,pennystocks,ASRT,1851,0,1851,-1851,10,797,217,3,NASDAQ
5128,16-02-2021 08:00,24 hrs.,pennystocks,ASRV,41,0,41,-41,1,11,15,1,NASDAQ
5128,16-02-2021 08:00,24 hrs.,pennystocks,ATOS,6,0,6,-6,1,1,0,1,NASDAQ
5128,16-02-2021 08:00,24 hrs.,pennystocks,AYTU,38,38,0,38,2,10,10,1,NASDAQ
5128,16-02-2021 08:00,24 hrs.,pennystocks,BCRX,6,0,6,-6,1,1,0,1,NASDAQ
5128,16-02-2021 08:00,24 hrs.,pennystocks,BEAT,7,7,0,7,1,0,3,1,NASDAQ
5128,16-02-2021 08:00,24 hrs.,pennystocks,BIOL,6,0,6,-6,1,1,0,1,NASDAQ
5128,16-02-2021 08:00,24 hrs.,pennystocks,BNGO,84,0,84,-84,1,33,14,1,NASDAQ
5128,16-02-2021 08:00,24 hrs.,pennystocks,BTBT,43,0,43,-43,1,5,29,1,NASDAQ
5128,16-02-2021 08:00,24 hrs.,pennystocks,CASH,188,188,0,188,1,88,8,1,NASDAQ
5128,16-02-2021 08:00,24 hrs.,pennystocks,CETX,38,38,0,38,2,10,10,1,NASDAQ
5128,16-02-2021 08:00,24 hrs.,pennystocks,CIDM,57,57,0,57,2,10,29,2,NASDAQ
5128,16-02-2021 08:00,24 hrs.,pennystocks,CKPT,6,6,0,6,1,1,0,1,NASDAQ
5128,16-02-2021 08:00,24 hrs.,pennystocks,CRBP,10,10,0,10,1,2,2,1,NASDAQ
5128,16-02-2021 08:00,24 hrs.,pennystocks,CRON,233,233,0,233,1,101,27,1,NASDAQ
5128,16-02-2021 08:00,24 hrs.,pennystocks,CTRM,7,7,0,7,1,1,1,1,NASDAQ
5128,16-02-2021 08:00,24 hrs.,pennystocks,EDIT,835,39,796,-757,2,364,99,2,NASDAQ
5128,16-02-2021 08:00,24 hrs.,pennystocks,GNUS,6,6,0,6,1,1,0,1,NASDAQ
5128,16-02-2021 08:00,24 hrs.,pennystocks,GOEV,7,0,7,-7,1,1,1,1,NASDAQ
5128,16-02-2021 08:00,24 hrs.,pennystocks,GOLD,7,7,0,7,1,1,1,1,NASDAQ
5128,16-02-2021 08:00,24 hrs.,pennystocks,GRIL,38,38,0,38,2,10,10,1,NASDAQ
5128,16-02-2021 08:00,24 hrs.,pennystocks,INPX,54,0,54,-54,1,20,10,1,NASDAQ
5128,16-02-2021 08:00,24 hrs.,pennystocks,INVO,6,6,0,6,1,1,0,1,NASDAQ
5128,16-02-2021 08:00,24 hrs.,pennystocks,KTRA,6,6,0,6,1,1,0,1,NASDAQ
5128,16-02-2021 08:00,24 hrs.,pennystocks,LIFE,12,0,12,-12,2,2,0,1,NASDAQ
5128,16-02-2021 08:00,24 hrs.,pennystocks,LOAC,13,13,0,13,2,2,1,1,NASDAQ
5128,16-02-2021 08:00,24 hrs.,pennystocks,MARA,192,0,192,-192,2,56,72,2,NASDAQ
5128,16-02-2021 08:00,24 hrs.,pennystocks,NAKD,6,6,0,6,1,1,0,1,NASDAQ
5128,16-02-2021 08:00,24 hrs.,pennystocks,NEOS,38,38,0,38,2,10,10,1,NASDAQ
5128,16-02-2021 08:00,24 hrs.,pennystocks,NVCN,44,0,44,-44,1,11,18,1,NASDAQ
5128,16-02-2021 08:00,24 hrs.,pennystocks,OBSV,142,142,0,142,1,48,42,1,NASDAQ
5128,16-02-2021 08:00,24 hrs.,pennystocks,OPTT,6,0,6,-6,1,1,0,1,NASDAQ
5128,16-02-2021 08:00,24 hrs.,pennystocks,OTLK,6,0,6,-6,1,1,0,1,NASDAQ
5128,16-02-2021 08:00,24 hrs.,pennystocks,PFMT,6,6,0,6,1,1,0,1,NASDAQ
5128,16-02-2021 08:00,24 hrs.,pennystocks,PHAR,22,0,22,-22,1,8,2,1,NASDAQ
5128,16-02-2021 08:00,24 hrs.,pennystocks,PLUS,122,0,122,-122,2,36,42,2,NASDAQ
5128,16-02-2021 08:00,24 hrs.,pennystocks,PTON,84,0,84,-84,1,33,14,1,NASDAQ
5128,16-02-2021 08:00,24 hrs.,pennystocks,RAVE,38,38,0,38,2,10,10,1,NASDAQ
5128,16-02-2021 08:00,24 hrs.,pennystocks,RIOT,198,6,192,-186,3,57,72,3,NASDAQ
5128,16-02-2021 08:00,24 hrs.,pennystocks,ROKU,20,20,0,20,1,5,6,1,NASDAQ
5128,16-02-2021 08:00,24 hrs.,pennystocks,SHIP,46,46,0,46,1,7,28,1,NASDAQ
5128,16-02-2021 08:00,24 hrs.,pennystocks,SNDL,54,54,0,54,8,9,4,7,NASDAQ
5128,16-02-2021 08:00,24 hrs.,pennystocks,SNGX,69,69,0,69,4,19,15,3,NASDAQ
5128,16-02-2021 08:00,24 hrs.,pennystocks,TBLT,6,0,6,-6,1,1,0,1,NASDAQ
5128,16-02-2021 08:00,24 hrs.,pennystocks,TLRY,233,233,0,233,1,101,27,1,NASDAQ
5128,16-02-2021 08:00,24 hrs.,pennystocks,TMDI,6,0,6,-6,1,1,0,1,NASDAQ
5128,16-02-2021 08:00,24 hrs.,pennystocks,TNXP,282,0,282,-282,2,117,40,2,NASDAQ
5128,16-02-2021 08:00,24 hrs.,pennystocks,TRCH,18,12,6,6,2,1,8,2,NASDAQ
5128,16-02-2021 08:00,24 hrs.,wallstreetbets,PONGF,21,7,14,-7,3,3,3,3,OTC
5128,16-02-2021 08:00,24 hrs.,wallstreetbets,PYRNF,7,7,0,7,1,1,1,1,OTC
5128,16-02-2021 08:00,24 hrs.,wallstreetbets,REZZF,19,13,6,7,3,3,1,2,OTC
5128,16-02-2021 08:00,24 hrs.,wallstreetbets,RYCEY,18,12,6,6,3,3,0,2,OTC
5128,16-02-2021 08:00,24 hrs.,wallstreetbets,SPRWF,19,6,13,-7,3,3,1,3,OTC
5128,16-02-2021 08:00,24 hrs.,wallstreetbets,TUIFF,6,0,6,-6,1,1,0,1,OTC
5128,16-02-2021 08:00,24 hrs.,wallstreetbets,VYGVF,7,7,0,7,1,1,1,1,OTC
5128,16-02-2021 08:00,24 hrs.,wallstreetbets,CEI,28,28,0,28,4,4,4,1,AMEX
5128,16-02-2021 08:00,24 hrs.,wallstreetbets,DNN,28,28,0,28,4,4,4,2,AMEX
5128,16-02-2021 08:00,24 hrs.,wallstreetbets,GDP,526,526,0,526,1,213,96,1,AMEX
5128,16-02-2021 08:00,24 hrs.,wallstreetbets,GSV,29,7,22,-15,4,4,5,2,AMEX
5128,16-02-2021 08:00,24 hrs.,wallstreetbets,LEU,6,0,6,-6,1,1,0,1,AMEX
5128,16-02-2021 08:00,24 hrs.,wallstreetbets,MXC,7,0,7,-7,1,1,1,1,AMEX
5128,16-02-2021 08:00,24 hrs.,wallstreetbets,NBA,86,86,0,86,1,29,24,1,AMEX
5128,16-02-2021 08:00,24 hrs.,wallstreetbets,NES,7,7,0,7,1,1,1,1,AMEX
5128,16-02-2021 08:00,24 hrs.,wallstreetbets,TGB,7,7,0,7,1,1,1,1,AMEX
5128,16-02-2021 08:00,24 hrs.,wallstreetbets,ZOM,35,28,7,21,5,5,5,4,AMEX
5128,16-02-2021 08:00,24 hrs.,wallstreetbets,AMPE,14,14,0,14,2,2,2,1,AMEX
5128,16-02-2021 08:00,24 hrs.,wallstreetbets,CANF,7,0,7,-7,1,1,1,1,AMEX
5128,16-02-2021 08:00,24 hrs.,wallstreetbets,GSAT,26,20,6,14,4,4,2,3,AMEX
5128,16-02-2021 08:00,24 hrs.,wallstreetbets,LODE,7,7,0,7,1,1,1,1,AMEX
5128,16-02-2021 08:00,24 hrs.,wallstreetbets,SENS,7,7,0,7,1,1,1,1,AMEX
5128,16-02-2021 08:00,24 hrs.,wallstreetbets,TRXC,6,6,0,6,1,1,0,1,AMEX
5128,16-02-2021 08:00,24 hrs.,wallstreetbets,UAMY,7,7,0,7,1,1,1,1,AMEX
5128,16-02-2021 08:00,24 hrs.,wallstreetbets,XXII,12,0,12,-12,2,2,0,1,AMEX
5128,16-02-2021 08:00,24 hrs.,wallstreetbets,ACB,14,14,0,14,2,2,2,2,NYSE
5128,16-02-2021 08:00,24 hrs.,wallstreetbets,ASTI,20,14,6,8,3,3,2,2,OTC
5128,16-02-2021 08:00,24 hrs.,wallstreetbets,BBRW,7,7,0,7,1,1,1,1,OTC
5128,16-02-2021 08:00,24 hrs.,wallstreetbets,BOTH,1420,0,1420,-1420,1,455,506,1,OTC
5128,16-02-2021 08:00,24 hrs.,wallstreetbets,BOTY,14,7,7,0,2,2,2,2,OTC
5128,16-02-2021 08:00,24 hrs.,wallstreetbets,BTCS,14,7,7,0,2,2,2,2,OTC
5128,16-02-2021 08:00,24 hrs.,wallstreetbets,CLWD,7,0,7,-7,1,1,1,1,OTC
5128,16-02-2021 08:00,24 hrs.,wallstreetbets,COMS,6,6,0,6,1,1,0,1,OTC
5128,16-02-2021 08:00,24 hrs.,wallstreetbets,CYDY,29,29,0,29,4,4,5,1,OTC
5128,16-02-2021 08:00,24 hrs.,wallstreetbets,ECDP,7,0,7,-7,1,1,1,1,OTC
5128,16-02-2021 08:00,24 hrs.,wallstreetbets,ETFM,7,7,0,7,1,1,1,1,OTC
5128,16-02-2021 08:00,24 hrs.,wallstreetbets,FLES,14,14,0,14,2,2,2,1,OTC
5128,16-02-2021 08:00,24 hrs.,wallstreetbets,FMCC,478,478,0,478,2,144,182,2,OTC
5128,16-02-2021 08:00,24 hrs.,wallstreetbets,FNMA,478,478,0,478,2,144,182,2,OTC
5128,16-02-2021 08:00,24 hrs.,wallstreetbets,GARB,7,7,0,7,1,1,1,1,OTC
5128,16-02-2021 08:00,24 hrs.,wallstreetbets,GPFT,21,14,7,7,3,3,3,3,OTC
5128,16-02-2021 08:00,24 hrs.,wallstreetbets,GTLL,28,28,0,28,4,4,4,2,OTC
5128,16-02-2021 08:00,24 hrs.,wallstreetbets,HCMC,81,40,41,-1,12,12,9,12,OTC
5128,16-02-2021 08:00,24 hrs.,wallstreetbets,HYSR,21,0,21,-21,3,3,3,2,OTC
5128,16-02-2021 08:00,24 hrs.,wallstreetbets,ILUS,7,0,7,-7,1,1,1,1,OTC
5128,16-02-2021 08:00,24 hrs.,wallstreetbets,JSDA,7,0,7,-7,1,1,1,1,OTC
5128,16-02-2021 08:00,24 hrs.,wallstreetbets,LAAB,7,0,7,-7,1,1,1,1,OTC
5128,16-02-2021 08:00,24 hrs.,wallstreetbets,MCOA,21,0,21,-21,3,3,3,2,OTC
5128,16-02-2021 08:00,24 hrs.,wallstreetbets,MJNA,14,0,14,-14,2,2,2,2,OTC
5128,16-02-2021 08:00,24 hrs.,wallstreetbets,MOST,6,0,6,-6,1,1,0,1,OTC
5128,16-02-2021 08:00,24 hrs.,wallstreetbets,OZSC,14,0,14,-14,2,2,2,2,OTC
5128,16-02-2021 08:00,24 hrs.,wallstreetbets,QUBT,6,6,0,6,1,1,0,1,OTC
5128,16-02-2021 08:00,24 hrs.,wallstreetbets,RBNW,8,0,8,-8,1,2,0,1,OTC
5128,16-02-2021 08:00,24 hrs.,wallstreetbets,RDGL,7,7,0,7,1,1,1,1,OTC
5128,16-02-2021 08:00,24 hrs.,pennystocks,TSLA,41,0,41,-41,2,13,7,2,NASDAQ
5128,16-02-2021 08:00,24 hrs.,pennystocks,TTOO,6,6,0,6,1,1,0,1,NASDAQ
5128,16-02-2021 08:00,24 hrs.,pennystocks,TXMD,6,0,6,-6,1,1,0,1,NASDAQ
5128,16-02-2021 08:00,24 hrs.,pennystocks,VTNR,6,0,6,-6,1,1,0,1,NASDAQ
5128,16-02-2021 08:00,24 hrs.,pennystocks,XSPA,380,21,359,-338,5,142,76,5,NASDAQ
5128,16-02-2021 08:00,24 hrs.,pennystocks,ZYNE,10,10,0,10,1,2,2,1,NASDAQ
5128,16-02-2021 08:00,24 hrs.,wallstreetbets,ABML,7,7,0,7,1,1,1,1,OTC
5128,16-02-2021 08:00,24 hrs.,wallstreetbets,AITX,7,0,7,-7,1,1,1,1,OTC
5128,16-02-2021 08:00,24 hrs.,wallstreetbets,ALKN,13,13,0,13,2,2,1,2,OTC
5128,16-02-2021 08:00,24 hrs.,wallstreetbets,ALPP,7,0,7,-7,1,1,1,1,OTC
5128,16-02-2021 08:00,24 hrs.,wallstreetbets,CHS,14,0,14,-14,2,2,2,1,NYSE
5128,16-02-2021 08:00,24 hrs.,wallstreetbets,CNS,7,0,7,-7,1,1,1,1,NYSE
5128,16-02-2021 08:00,24 hrs.,wallstreetbets,CPE,14,14,0,14,2,2,2,2,NYSE
5128,16-02-2021 08:00,24 hrs.,wallstreetbets,CPS,6,0,6,-6,1,1,0,1,NYSE
5128,16-02-2021 08:00,24 hrs.,wallstreetbets,CVS,7,7,0,7,1,1,1,1,NYSE
5128,16-02-2021 08:00,24 hrs.,wallstreetbets,CXW,7,7,0,7,1,1,1,1,NYSE
5128,16-02-2021 08:00,24 hrs.,wallstreetbets,DAC,6,0,6,-6,1,1,0,1,NYSE
5128,16-02-2021 08:00,24 hrs.,wallstreetbets,DCF,526,526,0,526,1,213,96,1,NYSE
5128,16-02-2021 08:00,24 hrs.,wallstreetbets,DGX,137,137,0,137,1,52,29,1,NYSE
5128,16-02-2021 08:00,24 hrs.,wallstreetbets,DIS,6,6,0,6,1,1,0,1,NYSE
5128,16-02-2021 08:00,24 hrs.,wallstreetbets,DOW,660,660,0,660,3,265,118,2,NYSE
5128,16-02-2021 08:00,24 hrs.,wallstreetbets,EAT,7,7,0,7,1,1,1,1,NYSE
5128,16-02-2021 08:00,24 hrs.,wallstreetbets,EFT,22,22,0,22,2,3,8,1,NYSE
5128,16-02-2021 08:00,24 hrs.,wallstreetbets,FLO,11,0,11,-11,1,2,3,1,NYSE
5128,16-02-2021 08:00,24 hrs.,wallstreetbets,FLT,7,0,7,-7,1,1,1,1,NYSE
5128,16-02-2021 08:00,24 hrs.,wallstreetbets,FMS,6,0,6,-6,1,1,0,1,NYSE
5128,16-02-2021 08:00,24 hrs.,wallstreetbets,FSR,168,168,0,168,2,39,82,2,NYSE
5128,16-02-2021 08:00,24 hrs.,wallstreetbets,GEO,20,20,0,20,3,3,2,1,NYSE
5128,16-02-2021 08:00,24 hrs.,wallstreetbets,GME,34313,25968,8345,17623,213,15211,3039,163,NYSE
5128,16-02-2021 08:00,24 hrs.,wallstreetbets,IAG,7,0,7,-7,1,1,1,1,NYSE
5128,16-02-2021 08:00,24 hrs.,wallstreetbets,IBM,7,7,0,7,1,1,1,1,NYSE
5128,16-02-2021 08:00,24 hrs.,wallstreetbets,JPM,82,82,0,82,1,0,78,1,NYSE
5128,16-02-2021 08:00,24 hrs.,wallstreetbets,JWN,157,157,0,157,1,49,55,1,NYSE
5128,16-02-2021 08:00,24 hrs.,wallstreetbets,KSS,157,157,0,157,1,49,55,1,NYSE
5128,16-02-2021 08:00,24 hrs.,wallstreetbets,LAC,20,20,0,20,3,3,2,3,NYSE
5128,16-02-2021 08:00,24 hrs.,wallstreetbets,LOW,6,6,0,6,1,1,0,1,NYSE
5128,16-02-2021 08:00,24 hrs.,wallstreetbets,LTC,25,25,0,25,4,4,1,3,NYSE
5128,16-02-2021 08:00,24 hrs.,wallstreetbets,LYV,6,6,0,6,1,1,0,1,NYSE
5128,16-02-2021 08:00,24 hrs.,wallstreetbets,MAC,6,0,6,-6,1,1,0,1,NYSE
5128,16-02-2021 08:00,24 hrs.,wallstreetbets,MFT,7,7,0,7,1,1,1,1,NYSE
5128,16-02-2021 08:00,24 hrs.,wallstreetbets,MIN,7,0,7,-7,1,1,1,1,NYSE
5128,16-02-2021 08:00,24 hrs.,wallstreetbets,MLM,8,0,8,-8,1,2,0,1,NYSE
5128,16-02-2021 08:00,24 hrs.,wallstreetbets,RNWR,6,6,0,6,1,1,0,1,OTC
5128,16-02-2021 08:00,24 hrs.,wallstreetbets,ROTH,7,7,0,7,1,1,1,1,OTC
5128,16-02-2021 08:00,24 hrs.,wallstreetbets,RTON,6,6,0,6,1,1,0,1,OTC
5128,16-02-2021 08:00,24 hrs.,wallstreetbets,RXMD,6,0,6,-6,1,1,0,1,OTC
5128,16-02-2021 08:00,24 hrs.,wallstreetbets,SHMP,6,0,6,-6,1,1,0,1,OTC
5128,16-02-2021 08:00,24 hrs.,wallstreetbets,SLNG,6,6,0,6,1,1,0,1,OTC
5128,16-02-2021 08:00,24 hrs.,wallstreetbets,SRMX,6,0,6,-6,1,1,0,1,OTC
5128,16-02-2021 08:00,24 hrs.,wallstreetbets,TLSS,14,14,0,14,2,2,2,1,OTC
5128,16-02-2021 08:00,24 hrs.,wallstreetbets,TTCM,6,0,6,-6,1,1,0,1,OTC
5128,16-02-2021 08:00,24 hrs.,wallstreetbets,UAPC,7,0,7,-7,1,1,1,1,OTC
5128,16-02-2021 08:00,24 hrs.,wallstreetbets,UEEC,13,0,13,-13,2,2,1,1,OTC
5128,16-02-2021 08:00,24 hrs.,wallstreetbets,USPS,7,0,7,-7,1,1,1,1,OTC
5128,16-02-2021 08:00,24 hrs.,wallstreetbets,VPRB,6,6,0,6,1,1,0,1,OTC
5128,16-02-2021 08:00,24 hrs.,wallstreetbets,WHEN,7,0,7,-7,1,1,1,1,OTC
5128,16-02-2021 08:00,24 hrs.,wallstreetbets,AMYZF,7,7,0,7,1,1,1,1,OTC
5128,16-02-2021 08:00,24 hrs.,wallstreetbets,BRQSW,7,7,0,7,1,1,1,1,OTC
5128,16-02-2021 08:00,24 hrs.,wallstreetbets,BVNNF,7,0,7,-7,1,1,1,1,OTC
5128,16-02-2021 08:00,24 hrs.,wallstreetbets,CIOXY,7,7,0,7,1,1,1,1,OTC
5128,16-02-2021 08:00,24 hrs.,wallstreetbets,DIGAF,7,7,0,7,1,1,1,1,OTC
5128,16-02-2021 08:00,24 hrs.,wallstreetbets,DOFSQ,7,7,0,7,1,1,1,1,OTC
5128,16-02-2021 08:00,24 hrs.,wallstreetbets,GAYMF,7,7,0,7,1,1,1,1,OTC
5128,16-02-2021 08:00,24 hrs.,wallstreetbets,GPORQ,7,0,7,-7,1,1,1,1,OTC
5128,16-02-2021 08:00,24 hrs.,wallstreetbets,GTBAF,9,0,9,-9,1,1,3,1,OTC
5128,16-02-2021 08:00,24 hrs.,wallstreetbets,HITIF,15,15,0,15,2,2,3,2,OTC
5128,16-02-2021 08:00,24 hrs.,wallstreetbets,HRVSF,7,0,7,-7,1,1,1,1,OTC
5128,16-02-2021 08:00,24 hrs.,wallstreetbets,HVBTF,6,6,0,6,1,1,0,1,OTC
5128,16-02-2021 08:00,24 hrs.,wallstreetbets,LKNCY,6,6,0,6,1,1,0,1,OTC
5128,16-02-2021 08:00,24 hrs.,wallstreetbets,LTMCF,34,34,0,34,1,0,30,1,OTC
5128,16-02-2021 08:00,24 hrs.,wallstreetbets,MSNVF,7,7,0,7,1,1,1,1,OTC
5128,16-02-2021 08:00,24 hrs.,wallstreetbets,MYCOF,6,0,6,-6,1,1,0,1,OTC
5128,16-02-2021 08:00,24 hrs.,wallstreetbets,NXTTF,6,0,6,-6,1,1,0,1,OTC
5128,16-02-2021 08:00,24 hrs.,wallstreetbets,PLNHF,7,7,0,7,1,1,1,1,OTC
5128,16-02-2021 08:00,24 hrs.,RobinHoodPennyStocks,KTRA,7,7,0,7,1,1,1,1,NASDAQ
5128,16-02-2021 08:00,24 hrs.,RobinHoodPennyStocks,LKCO,125,0,125,-125,1,35,51,1,NASDAQ
5128,16-02-2021 08:00,24 hrs.,RobinHoodPennyStocks,LMFA,90,90,0,90,1,37,12,1,NASDAQ
5128,16-02-2021 08:00,24 hrs.,RobinHoodPennyStocks,LOAC,6,6,0,6,1,1,0,1,NASDAQ
5128,16-02-2021 08:00,24 hrs.,RobinHoodPennyStocks,MARA,118,118,0,118,2,47,16,2,NASDAQ
5128,16-02-2021 08:00,24 hrs.,RobinHoodPennyStocks,METX,90,90,0,90,1,37,12,1,NASDAQ
5128,16-02-2021 08:00,24 hrs.,RobinHoodPennyStocks,MNPR,90,90,0,90,1,37,12,1,NASDAQ
5128,16-02-2021 08:00,24 hrs.,RobinHoodPennyStocks,OGI,90,90,0,90,1,37,12,1,NASDAQ
5128,16-02-2021 08:00,24 hrs.,RobinHoodPennyStocks,PFC,6,6,0,6,1,1,0,1,NASDAQ
5128,16-02-2021 08:00,24 hrs.,RobinHoodPennyStocks,PTE,7,7,0,7,1,1,1,1,NASDAQ
5128,16-02-2021 08:00,24 hrs.,wallstreetbets,MSM,2874,0,2874,-2874,1,1344,182,1,NYSE
5128,16-02-2021 08:00,24 hrs.,wallstreetbets,NAT,6,6,0,6,1,1,0,1,NYSE
5128,16-02-2021 08:00,24 hrs.,wallstreetbets,NIO,221,7,214,-207,3,65,79,3,NYSE
5128,16-02-2021 08:00,24 hrs.,wallstreetbets,NOK,240,185,55,130,13,61,66,12,NYSE
5128,16-02-2021 08:00,24 hrs.,wallstreetbets,NYC,6,6,0,6,1,1,0,1,NYSE
5128,16-02-2021 08:00,24 hrs.,wallstreetbets,PBF,7,7,0,7,1,1,1,1,NYSE
5128,16-02-2021 08:00,24 hrs.,wallstreetbets,PFE,119,105,14,91,4,21,61,4,NYSE
5128,16-02-2021 08:00,24 hrs.,wallstreetbets,PSA,7,7,0,7,1,1,1,1,NYSE
5128,16-02-2021 08:00,24 hrs.,wallstreetbets,RBC,56,0,56,-56,1,21,10,1,NYSE
5128,16-02-2021 08:00,24 hrs.,wallstreetbets,RFP,7,0,7,-7,1,1,1,1,NYSE
5128,16-02-2021 08:00,24 hrs.,wallstreetbets,RKT,793,780,13,767,6,263,243,5,NYSE
5128,16-02-2021 08:00,24 hrs.,wallstreetbets,RMO,6,6,0,6,1,1,0,1,NYSE
5128,16-02-2021 08:00,24 hrs.,wallstreetbets,RRC,110,110,0,110,1,10,86,1,NYSE
5128,16-02-2021 08:00,24 hrs.,wallstreetbets,RSI,208,0,208,-208,1,63,78,1,NYSE
5128,16-02-2021 08:00,24 hrs.,wallstreetbets,SNE,7,0,7,-7,1,1,1,1,NYSE
5128,16-02-2021 08:00,24 hrs.,wallstreetbets,SOS,39,6,33,-27,6,6,3,5,NYSE
5128,16-02-2021 08:00,24 hrs.,wallstreetbets,THO,34,34,0,34,1,8,14,1,NYSE
5128,16-02-2021 08:00,24 hrs.,wallstreetbets,TRQ,532,532,0,532,2,214,96,2,NYSE
5128,16-02-2021 08:00,24 hrs.,wallstreetbets,TSM,185,185,0,185,2,64,49,2,NYSE
5128,16-02-2021 08:00,24 hrs.,wallstreetbets,TTI,7,7,0,7,1,1,1,1,NYSE
5128,16-02-2021 08:00,24 hrs.,wallstreetbets,UMC,7,0,7,-7,1,1,1,1,NYSE
5128,16-02-2021 08:00,24 hrs.,wallstreetbets,WFC,7,0,7,-7,1,1,1,1,NYSE
5128,16-02-2021 08:00,24 hrs.,wallstreetbets,WMT,7,7,0,7,1,1,1,1,NYSE
5128,16-02-2021 08:00,24 hrs.,wallstreetbets,WTI,81,81,0,81,1,14,49,1,NYSE
5128,16-02-2021 08:00,24 hrs.,wallstreetbets,AJAX,7,7,0,7,1,1,1,1,NYSE
5128,16-02-2021 08:00,24 hrs.,wallstreetbets,AMWL,646,0,646,-646,1,229,184,1,NYSE
5128,16-02-2021 08:00,24 hrs.,wallstreetbets,BABA,6,6,0,6,1,1,0,1,NYSE
5128,16-02-2021 08:00,24 hrs.,wallstreetbets,BBAR,6,6,0,6,1,1,0,1,NYSE
5128,16-02-2021 08:00,24 hrs.,wallstreetbets,BORR,7,7,0,7,1,1,1,1,NYSE
5128,16-02-2021 08:00,24 hrs.,wallstreetbets,CCIV,61,35,26,9,9,9,7,8,NYSE
5128,16-02-2021 08:00,24 hrs.,wallstreetbets,COTY,94,26,68,-42,7,27,12,4,NYSE
5128,16-02-2021 08:00,24 hrs.,wallstreetbets,CSPR,6,0,6,-6,1,1,0,1,NYSE
5128,16-02-2021 08:00,24 hrs.,wallstreetbets,DASH,14,14,0,14,2,2,2,1,NYSE
5128,16-02-2021 08:00,24 hrs.,wallstreetbets,EVRI,6,0,6,-6,1,1,0,1,NYSE
5128,16-02-2021 08:00,24 hrs.,wallstreetbets,FINV,12,12,0,12,2,2,0,1,NYSE
5128,16-02-2021 08:00,24 hrs.,wallstreetbets,FMAC,9,9,0,9,1,1,3,1,NYSE
5128,16-02-2021 08:00,24 hrs.,wallstreetbets,FSLY,157,157,0,157,1,49,55,1,NYSE
5128,16-02-2021 08:00,24 hrs.,wallstreetbets,FUBO,49,42,7,35,7,7,7,4,NYSE
5128,16-02-2021 08:00,24 hrs.,wallstreetbets,FVRR,8,8,0,8,1,1,2,1,NYSE
5128,16-02-2021 08:00,24 hrs.,wallstreetbets,ADX,6,6,0,6,1,1,0,1,NYSE
5128,16-02-2021 08:00,24 hrs.,wallstreetbets,AIR,7,7,0,7,1,1,1,1,NYSE
5128,16-02-2021 08:00,24 hrs.,wallstreetbets,AIV,7,0,7,-7,1,1,1,1,NYSE
5128,16-02-2021 08:00,24 hrs.,wallstreetbets,AMC,3334,2369,965,1404,104,1222,474,79,NYSE
5128,16-02-2021 08:00,24 hrs.,wallstreetbets,AMP,14,6,8,-2,2,3,0,2,NYSE
5128,16-02-2021 08:00,24 hrs.,wallstreetbets,ASX,7,0,7,-7,1,1,1,1,NYSE
5128,16-02-2021 08:00,24 hrs.,wallstreetbets,AVD,7,0,7,-7,1,1,1,1,NYSE
5128,16-02-2021 08:00,24 hrs.,wallstreetbets,BAM,116,0,116,-116,1,46,20,1,NYSE
5128,16-02-2021 08:00,24 hrs.,wallstreetbets,BCH,13,7,6,1,2,2,1,2,NYSE
5128,16-02-2021 08:00,24 hrs.,wallstreetbets,BFT,7,0,7,-7,1,1,1,1,NYSE
5128,16-02-2021 08:00,24 hrs.,wallstreetbets,BIO,7,0,7,-7,1,1,1,1,NYSE
5128,16-02-2021 08:00,24 hrs.,wallstreetbets,BME,7,0,7,-7,1,1,1,1,NYSE
5128,16-02-2021 08:00,24 hrs.,wallstreetbets,BUD,7,7,0,7,1,1,1,1,NYSE
5128,16-02-2021 08:00,24 hrs.,wallstreetbets,CBD,14,6,8,-2,2,3,0,2,NYSE
5128,16-02-2021 08:00,24 hrs.,wallstreetbets,CCL,157,157,0,157,1,49,55,1,NYSE
5128,16-02-2021 08:00,24 hrs.,RobinHoodPennyStocks,NOVN,215,90,125,-35,2,72,63,2,NASDAQ
5128,16-02-2021 08:00,24 hrs.,RobinHoodPennyStocks,NVAX,90,90,0,90,1,37,12,1,NASDAQ
5128,16-02-2021 08:00,24 hrs.,RobinHoodPennyStocks,NVIV,6,0,6,-6,1,1,0,1,NASDAQ
5128,16-02-2021 08:00,24 hrs.,RobinHoodPennyStocks,NXTD,90,90,0,90,1,37,12,1,NASDAQ
5128,16-02-2021 08:00,24 hrs.,RobinHoodPennyStocks,OBSV,66,66,0,66,4,23,4,2,NASDAQ
5128,16-02-2021 08:00,24 hrs.,RobinHoodPennyStocks,OCUL,90,90,0,90,1,37,12,1,NASDAQ
5128,16-02-2021 08:00,24 hrs.,RobinHoodPennyStocks,ONTX,125,0,125,-125,1,35,51,1,NASDAQ
5128,16-02-2021 08:00,24 hrs.,RobinHoodPennyStocks,PXS,626,0,626,-626,1,191,240,1,NASDAQ
5128,16-02-2021 08:00,24 hrs.,RobinHoodPennyStocks,SPI,90,90,0,90,1,37,12,1,NASDAQ
5128,16-02-2021 08:00,24 hrs.,RobinHoodPennyStocks,TGA,90,90,0,90,1,37,12,1,NASDAQ
5128,16-02-2021 08:00,24 hrs.,RobinHoodPennyStocks,WNW,90,90,0,90,1,37,12,1,NASDAQ
5128,16-02-2021 08:00,24 hrs.,RobinHoodPennyStocks,WWR,102,90,12,78,3,39,12,2,NASDAQ
5128,16-02-2021 08:00,24 hrs.,RobinHoodPennyStocks,AACQ,90,90,0,90,1,37,12,1,NASDAQ
5128,16-02-2021 08:00,24 hrs.,RobinHoodPennyStocks,AAPL,90,90,0,90,1,37,12,1,NASDAQ
5128,16-02-2021 08:00,24 hrs.,RobinHoodPennyStocks,ABEO,626,0,626,-626,1,191,240,1,NASDAQ
5128,16-02-2021 08:00,24 hrs.,RobinHoodPennyStocks,ACST,626,0,626,-626,1,191,240,1,NASDAQ
5128,16-02-2021 08:00,24 hrs.,RobinHoodPennyStocks,ADXS,6,6,0,6,1,1,0,1,NASDAQ
5128,16-02-2021 08:00,24 hrs.,RobinHoodPennyStocks,AGTC,2889,2758,131,2627,10,1254,341,9,NASDAQ
5128,16-02-2021 08:00,24 hrs.,RobinHoodPennyStocks,AIKI,90,90,0,90,1,37,12,1,NASDAQ
5128,16-02-2021 08:00,24 hrs.,RobinHoodPennyStocks,ALAC,90,90,0,90,1,37,12,1,NASDAQ
5128,16-02-2021 08:00,24 hrs.,RobinHoodPennyStocks,ALJJ,90,90,0,90,1,37,12,1,NASDAQ
5128,16-02-2021 08:00,24 hrs.,RobinHoodPennyStocks,AMTX,90,90,0,90,1,37,12,1,NASDAQ
5128,16-02-2021 08:00,24 hrs.,RobinHoodPennyStocks,AMZN,6,0,6,-6,1,1,0,1,NASDAQ
5128,16-02-2021 08:00,24 hrs.,RobinHoodPennyStocks,APHA,90,90,0,90,1,37,12,1,NASDAQ
5128,16-02-2021 08:00,24 hrs.,RobinHoodPennyStocks,ARLP,90,90,0,90,1,37,12,1,NASDAQ
5128,16-02-2021 08:00,24 hrs.,RobinHoodPennyStocks,ARTL,90,90,0,90,1,37,12,1,NASDAQ
5128,16-02-2021 08:00,24 hrs.,RobinHoodPennyStocks,ASRT,866,63,803,-740,4,256,338,4,NASDAQ
5128,16-02-2021 08:00,24 hrs.,RobinHoodPennyStocks,ASRV,52,0,52,-52,1,17,14,1,NASDAQ
5128,16-02-2021 08:00,24 hrs.,RobinHoodPennyStocks,ATOS,21,21,0,21,1,6,5,1,NASDAQ
5128,16-02-2021 08:00,24 hrs.,RobinHoodPennyStocks,AZRX,7,7,0,7,1,1,1,1,NASDAQ
5128,16-02-2021 08:00,24 hrs.,RobinHoodPennyStocks,BEAT,4,4,0,4,1,0,0,1,NASDAQ
5128,16-02-2021 08:00,24 hrs.,RobinHoodPennyStocks,BNGO,90,90,0,90,1,37,12,1,NASDAQ
5128,16-02-2021 08:00,24 hrs.,RobinHoodPennyStocks,BOXL,90,90,0,90,1,37,12,1,NASDAQ
5128,16-02-2021 08:00,24 hrs.,RobinHoodPennyStocks,BRQS,221,96,125,-29,3,73,63,3,NASDAQ
5128,16-02-2021 08:00,24 hrs.,RobinHoodPennyStocks,BYFC,90,90,0,90,1,37,12,1,NASDAQ
5128,16-02-2021 08:00,24 hrs.,RobinHoodPennyStocks,CARV,90,90,0,90,1,37,12,1,NASDAQ
5128,16-02-2021 08:00,24 hrs.,RobinHoodPennyStocks,CBAT,90,90,0,90,1,37,12,1,NASDAQ
5128,16-02-2021 08:00,24 hrs.,RobinHoodPennyStocks,CCNC,90,90,0,90,1,37,12,1,NASDAQ
5128,16-02-2021 08:00,24 hrs.,RobinHoodPennyStocks,CDTX,7,7,0,7,1,1,1,1,NASDAQ
5128,16-02-2021 08:00,24 hrs.,RobinHoodPennyStocks,CIDM,626,0,626,-626,1,191,240,1,NASDAQ
5128,16-02-2021 08:00,24 hrs.,RobinHoodPennyStocks,CLEU,90,90,0,90,1,37,12,1,NASDAQ
5128,16-02-2021 08:00,24 hrs.,RobinHoodPennyStocks,CLSK,90,90,0,90,1,37,12,1,NASDAQ
5128,16-02-2021 08:00,24 hrs.,RobinHoodPennyStocks,CRBP,1685,934,751,183,3,638,397,3,NASDAQ
5128,16-02-2021 08:00,24 hrs.,RobinHoodPennyStocks,CRON,90,90,0,90,1,37,12,1,NASDAQ
5128,16-02-2021 08:00,24 hrs.,RobinHoodPennyStocks,CTRM,12,12,0,12,2,2,0,2,NASDAQ
5128,16-02-2021 08:00,24 hrs.,RobinHoodPennyStocks,CTXR,7,7,0,7,1,1,1,1,NASDAQ
5128,16-02-2021 08:00,24 hrs.,RobinHoodPennyStocks,DFFN,889,84,805,-721,4,253,367,4,NASDAQ
5128,16-02-2021 08:00,24 hrs.,RobinHoodPennyStocks,DZSI,90,90,0,90,1,37,12,1,NASDAQ
5128,16-02-2021 08:00,24 hrs.,RobinHoodPennyStocks,EAST,125,0,125,-125,1,35,51,1,NASDAQ
5128,16-02-2021 08:00,24 hrs.,RobinHoodPennyStocks,EBON,90,90,0,90,1,37,12,1,NASDAQ
5128,16-02-2021 08:00,24 hrs.,RobinHoodPennyStocks,EDRY,90,90,0,90,1,37,12,1,NASDAQ
5128,16-02-2021 08:00,24 hrs.,RobinHoodPennyStocks,EPSN,90,90,0,90,1,37,12,1,NASDAQ
5128,16-02-2021 08:00,24 hrs.,RobinHoodPennyStocks,EQOS,90,90,0,90,1,37,12,1,NASDAQ
5128,16-02-2021 08:00,24 hrs.,RobinHoodPennyStocks,FAMI,90,90,0,90,1,37,12,1,NASDAQ
5128,16-02-2021 08:00,24 hrs.,RobinHoodPennyStocks,FCEL,90,90,0,90,1,37,12,1,NASDAQ
5128,16-02-2021 08:00,24 hrs.,RobinHoodPennyStocks,FORD,90,90,0,90,1,37,12,1,NASDAQ
5128,16-02-2021 08:00,24 hrs.,RobinHoodPennyStocks,GTHX,90,90,0,90,1,37,12,1,NASDAQ
5128,16-02-2021 08:00,24 hrs.,RobinHoodPennyStocks,HGEN,90,90,0,90,1,37,12,1,NASDAQ
5128,16-02-2021 08:00,24 hrs.,RobinHoodPennyStocks,HNRG,90,90,0,90,1,37,12,1,NASDAQ
5128,16-02-2021 08:00,24 hrs.,RobinHoodPennyStocks,IDEX,96,96,0,96,2,38,12,2,NASDAQ
5128,16-02-2021 08:00,24 hrs.,RobinHoodPennyStocks,IMTE,90,90,0,90,1,37,12,1,NASDAQ
5128,16-02-2021 08:00,24 hrs.,RobinHoodPennyStocks,IZEA,90,90,0,90,1,37,12,1,NASDAQ
5128,16-02-2021 08:00,24 hrs.,RobinHoodPennyStocks,JAGX,934,934,0,934,1,412,106,1,NASDAQ
5128,16-02-2021 08:00,24 hrs.,RobinHoodPennyStocks,KERN,90,90,0,90,1,37,12,1,NASDAQ
5128,16-02-2021 08:00,24 hrs.,wallstreetbets,SNDL,1182,470,712,-242,40,261,500,36,NASDAQ
5128,16-02-2021 08:00,24 hrs.,wallstreetbets,SOLO,7,7,0,7,1,1,1,1,NASDAQ
5128,16-02-2021 08:00,24 hrs.,wallstreetbets,SONO,7,0,7,-7,1,1,1,1,NASDAQ
5128,16-02-2021 08:00,24 hrs.,wallstreetbets,SPWR,12,12,0,12,2,2,0,2,NASDAQ
5128,16-02-2021 08:00,24 hrs.,wallstreetbets,SRNE,140,98,42,56,7,24,64,3,NASDAQ
5128,16-02-2021 08:00,24 hrs.,wallstreetbets,STLD,526,526,0,526,1,213,96,1,NASDAQ
5128,16-02-2021 08:00,24 hrs.,wallstreetbets,SYBX,6,6,0,6,1,1,0,1,NASDAQ
5128,16-02-2021 08:00,24 hrs.,wallstreetbets,TACO,7,7,0,7,1,1,1,1,NASDAQ
5128,16-02-2021 08:00,24 hrs.,wallstreetbets,TELL,12,6,6,0,2,2,0,2,NASDAQ
5128,16-02-2021 08:00,24 hrs.,wallstreetbets,TGTX,98,98,0,98,1,18,58,1,NASDAQ
5128,16-02-2021 08:00,24 hrs.,wallstreetbets,THCB,7,7,0,7,1,1,1,1,NASDAQ
5128,16-02-2021 08:00,24 hrs.,wallstreetbets,TLGT,7,0,7,-7,1,1,1,1,NASDAQ
5128,16-02-2021 08:00,24 hrs.,wallstreetbets,TLRY,81,68,13,55,12,12,9,10,NASDAQ
5128,16-02-2021 08:00,24 hrs.,wallstreetbets,FUTU,190,0,190,-190,3,52,74,2,NASDAQ
5128,16-02-2021 08:00,24 hrs.,wallstreetbets,GAIN,6,0,6,-6,1,1,0,1,NASDAQ
5128,16-02-2021 08:00,24 hrs.,wallstreetbets,GEVO,7,0,7,-7,1,1,1,1,NASDAQ
5128,16-02-2021 08:00,24 hrs.,wallstreetbets,GILD,6,0,6,-6,1,1,0,1,NASDAQ
5128,16-02-2021 08:00,24 hrs.,wallstreetbets,GLBS,7,7,0,7,1,1,1,1,NASDAQ
5128,16-02-2021 08:00,24 hrs.,wallstreetbets,GNUS,19,7,12,-5,3,3,1,2,NASDAQ
5128,16-02-2021 08:00,24 hrs.,wallstreetbets,GOEV,28,14,14,0,4,4,4,3,NASDAQ
5128,16-02-2021 08:00,24 hrs.,wallstreetbets,GOGO,12,6,6,0,2,2,0,2,NASDAQ
5128,16-02-2021 08:00,24 hrs.,wallstreetbets,GOLD,21,14,7,7,3,3,3,3,NASDAQ
5128,16-02-2021 08:00,24 hrs.,wallstreetbets,GRFS,7,7,0,7,1,1,1,1,NASDAQ
5128,16-02-2021 08:00,24 hrs.,wallstreetbets,GTHX,7,7,0,7,1,1,1,1,NASDAQ
5128,16-02-2021 08:00,24 hrs.,wallstreetbets,HDSN,6,6,0,6,1,1,0,1,NASDAQ
5128,16-02-2021 08:00,24 hrs.,wallstreetbets,HERD,98,98,0,98,1,18,58,1,NASDAQ
5128,16-02-2021 08:00,24 hrs.,wallstreetbets,HJLI,7,7,0,7,1,1,1,1,NASDAQ
5128,16-02-2021 08:00,24 hrs.,wallstreetbets,HOFV,7,0,7,-7,1,1,1,1,NASDAQ
5128,16-02-2021 08:00,24 hrs.,wallstreetbets,HTGM,13,0,13,-13,2,2,1,1,NASDAQ
5128,16-02-2021 08:00,24 hrs.,wallstreetbets,IDEX,7,7,0,7,1,1,1,1,NASDAQ
5128,16-02-2021 08:00,24 hrs.,wallstreetbets,IMGN,13,13,0,13,2,2,1,1,NASDAQ
5128,16-02-2021 08:00,24 hrs.,wallstreetbets,IMMR,14,0,14,-14,2,2,2,1,NASDAQ
5128,16-02-2021 08:00,24 hrs.,wallstreetbets,INFO,1420,0,1420,-1420,1,455,506,1,NASDAQ
5128,16-02-2021 08:00,24 hrs.,wallstreetbets,INPX,7,0,7,-7,1,1,1,1,NASDAQ
5128,16-02-2021 08:00,24 hrs.,wallstreetbets,INTC,144,0,144,-144,2,45,46,2,NASDAQ
5128,16-02-2021 08:00,24 hrs.,wallstreetbets,ITRM,6,6,0,6,1,1,0,1,NASDAQ
5128,16-02-2021 08:00,24 hrs.,wallstreetbets,JACK,14,7,7,0,2,2,2,2,NASDAQ
5128,16-02-2021 08:00,24 hrs.,wallstreetbets,JNCE,6,0,6,-6,1,1,0,1,NASDAQ
5128,16-02-2021 08:00,24 hrs.,wallstreetbets,KRMD,7,0,7,-7,1,1,1,1,NASDAQ
5128,16-02-2021 08:00,24 hrs.,wallstreetbets,KTOS,137,137,0,137,3,45,35,2,NASDAQ
5128,16-02-2021 08:00,24 hrs.,wallstreetbets,LCAP,7,7,0,7,1,1,1,1,NASDAQ
5128,16-02-2021 08:00,24 hrs.,wallstreetbets,LKCO,6,6,0,6,1,1,0,1,NASDAQ
5128,16-02-2021 08:00,24 hrs.,wallstreetbets,LOAC,6,6,0,6,1,1,0,1,NASDAQ
5128,16-02-2021 08:00,24 hrs.,wallstreetbets,LOAN,6,6,0,6,1,1,0,1,NASDAQ
5128,16-02-2021 08:00,24 hrs.,wallstreetbets,LPCN,14,0,14,-14,2,2,2,1,NASDAQ
5128,16-02-2021 08:00,24 hrs.,wallstreetbets,MARA,40,26,14,12,5,5,10,4,NASDAQ
5128,16-02-2021 08:00,24 hrs.,wallstreetbets,MBRX,7,0,7,-7,1,1,1,1,NASDAQ
5128,16-02-2021 08:00,24 hrs.,wallstreetbets,MRNA,118,118,0,118,4,21,60,3,NASDAQ
5128,16-02-2021 08:00,24 hrs.,wallstreetbets,MSFT,7,0,7,-7,1,1,1,1,NASDAQ
5128,16-02-2021 08:00,24 hrs.,wallstreetbets,MTCH,7,0,7,-7,1,1,1,1,NASDAQ
5128,16-02-2021 08:00,24 hrs.,wallstreetbets,MVIS,20,13,7,6,3,3,2,3,NASDAQ
5128,16-02-2021 08:00,24 hrs.,wallstreetbets,NAKD,20,13,7,6,3,3,2,3,NASDAQ
5128,16-02-2021 08:00,24 hrs.,wallstreetbets,NCLH,157,157,0,157,1,49,55,1,NASDAQ
5128,16-02-2021 08:00,24 hrs.,wallstreetbets,NEPT,7,0,7,-7,1,1,1,1,NASDAQ
5128,16-02-2021 08:00,24 hrs.,wallstreetbets,NGAC,13,13,0,13,2,2,1,1,NASDAQ
5128,16-02-2021 08:00,24 hrs.,wallstreetbets,NKLA,7,0,7,-7,1,1,1,1,NASDAQ
5128,16-02-2021 08:00,24 hrs.,wallstreetbets,NMRK,109,109,0,109,1,33,39,1,NASDAQ
5128,16-02-2021 08:00,24 hrs.,wallstreetbets,NMTR,6,0,6,-6,1,1,0,1,NASDAQ
5128,16-02-2021 08:00,24 hrs.,wallstreetbets,NNDM,6,6,0,6,1,1,0,1,NASDAQ
5128,16-02-2021 08:00,24 hrs.,wallstreetbets,NVAX,127,127,0,127,5,22,63,4,NASDAQ
5128,16-02-2021 08:00,24 hrs.,wallstreetbets,NVDA,37,0,37,-37,1,0,33,1,NASDAQ
5128,16-02-2021 08:00,24 hrs.,RobinHoodPennyStocks,MOGO,90,90,0,90,1,37,12,1,NASDAQ
5128,16-02-2021 08:00,24 hrs.,RobinHoodPennyStocks,MOSY,6,0,6,-6,1,1,0,1,NASDAQ
5128,16-02-2021 08:00,24 hrs.,RobinHoodPennyStocks,NAKD,107,107,0,107,2,39,21,2,NASDAQ
5128,16-02-2021 08:00,24 hrs.,wallstreetbets,WATT,6,6,0,6,1,1,0,1,NASDAQ
5128,16-02-2021 08:00,24 hrs.,wallstreetbets,XNET,7,7,0,7,1,1,1,1,NASDAQ
5128,16-02-2021 08:00,24 hrs.,wallstreetbets,XSPA,45,7,38,-31,7,7,3,4,NASDAQ
5128,16-02-2021 08:00,24 hrs.,wallstreetbets,ZNGA,7,0,7,-7,1,1,1,1,NASDAQ
5128,16-02-2021 08:00,24 hrs.,wallstreetbets,ZYNE,14,7,7,0,2,2,2,2,NASDAQ
5128,16-02-2021 08:00,24 hrs.,wallstreetbets,GOOGL,6,6,0,6,1,1,0,1,NASDAQ
5128,16-02-2021 08:00,24 hrs.,RobinHoodPennyStocks,ABWN,13,13,0,13,2,2,1,1,OTC
5128,16-02-2021 08:00,24 hrs.,RobinHoodPennyStocks,ALPP,18,18,0,18,3,3,0,1,OTC
5128,16-02-2021 08:00,24 hrs.,RobinHoodPennyStocks,GAXY,8,0,8,-8,1,2,0,1,OTC
5128,16-02-2021 08:00,24 hrs.,RobinHoodPennyStocks,PHIL,6,6,0,6,1,1,0,1,OTC
5128,16-02-2021 08:00,24 hrs.,RobinHoodPennyStocks,RVBR,6,0,6,-6,1,1,0,1,OTC
5128,16-02-2021 08:00,24 hrs.,RobinHoodPennyStocks,SRMX,16,0,16,-16,1,0,12,1,OTC
5128,16-02-2021 08:00,24 hrs.,RobinHoodPennyStocks,VPER,6,0,6,-6,1,1,0,1,OTC
5128,16-02-2021 08:00,24 hrs.,RobinHoodPennyStocks,BDRBF,6,0,6,-6,1,1,0,1,OTC
5128,16-02-2021 08:00,24 hrs.,RobinHoodPennyStocks,OTIVF,6,0,6,-6,1,1,0,1,OTC
5128,16-02-2021 08:00,24 hrs.,RobinHoodPennyStocks,RNRRF,6,0,6,-6,1,1,0,1,OTC
5128,16-02-2021 08:00,24 hrs.,RobinHoodPennyStocks,CEI,90,90,0,90,1,37,12,1,AMEX
5128,16-02-2021 08:00,24 hrs.,RobinHoodPennyStocks,DNN,634,8,626,-618,2,193,240,2,AMEX
5128,16-02-2021 08:00,24 hrs.,RobinHoodPennyStocks,DPW,90,90,0,90,1,37,12,1,AMEX
5128,16-02-2021 08:00,24 hrs.,RobinHoodPennyStocks,GTE,890,139,751,-612,6,270,326,5,AMEX
5128,16-02-2021 08:00,24 hrs.,RobinHoodPennyStocks,IGC,90,90,0,90,1,37,12,1,AMEX
5128,16-02-2021 08:00,24 hrs.,RobinHoodPennyStocks,NAK,6,6,0,6,1,1,0,1,AMEX
5128,16-02-2021 08:00,24 hrs.,RobinHoodPennyStocks,PED,90,90,0,90,1,37,12,1,AMEX
5128,16-02-2021 08:00,24 hrs.,RobinHoodPennyStocks,PTN,678,0,678,-678,2,208,254,2,AMEX
5128,16-02-2021 08:00,24 hrs.,RobinHoodPennyStocks,REI,90,90,0,90,1,37,12,1,AMEX
5128,16-02-2021 08:00,24 hrs.,RobinHoodPennyStocks,SYN,125,0,125,-125,1,35,51,1,AMEX
5128,16-02-2021 08:00,24 hrs.,RobinHoodPennyStocks,ZOM,247,122,125,-3,4,70,91,4,AMEX
5128,16-02-2021 08:00,24 hrs.,RobinHoodPennyStocks,ENSV,90,90,0,90,1,37,12,1,AMEX
5128,16-02-2021 08:00,24 hrs.,RobinHoodPennyStocks,GSAT,90,90,0,90,1,37,12,1,AMEX
5128,16-02-2021 08:00,24 hrs.,RobinHoodPennyStocks,HUSA,90,90,0,90,1,37,12,1,AMEX
5128,16-02-2021 08:00,24 hrs.,RobinHoodPennyStocks,INUV,18,12,6,6,3,3,0,3,AMEX
5128,16-02-2021 08:00,24 hrs.,RobinHoodPennyStocks,SNMP,90,90,0,90,1,37,12,1,AMEX
5128,16-02-2021 08:00,24 hrs.,RobinHoodPennyStocks,TMBR,21,21,0,21,1,6,5,1,AMEX
5128,16-02-2021 08:00,24 hrs.,RobinHoodPennyStocks,TRXC,6,6,0,6,1,1,0,1,AMEX
5128,16-02-2021 08:00,24 hrs.,RobinHoodPennyStocks,UAMY,6,0,6,-6,1,1,0,1,AMEX
5128,16-02-2021 08:00,24 hrs.,RobinHoodPennyStocks,UAVS,6,0,6,-6,1,1,0,1,AMEX
5128,16-02-2021 08:00,24 hrs.,RobinHoodPennyStocks,ACB,90,90,0,90,1,37,12,1,NYSE
5128,16-02-2021 08:00,24 hrs.,RobinHoodPennyStocks,AMC,6,6,0,6,1,0,2,1,NYSE
5128,16-02-2021 08:00,24 hrs.,RobinHoodPennyStocks,AUY,6,0,6,-6,1,1,0,1,NYSE
5128,16-02-2021 08:00,24 hrs.,RobinHoodPennyStocks,BTU,90,90,0,90,1,37,12,1,NYSE
5128,16-02-2021 08:00,24 hrs.,RobinHoodPennyStocks,CNS,934,934,0,934,1,412,106,1,NYSE
5128,16-02-2021 08:00,24 hrs.,RobinHoodPennyStocks,DSX,90,90,0,90,1,37,12,1,NYSE
5128,16-02-2021 08:00,24 hrs.,wallstreetbets,NVIV,6,0,6,-6,1,1,0,1,NASDAQ
5128,16-02-2021 08:00,24 hrs.,wallstreetbets,OCGN,62,49,13,36,9,9,8,7,NASDAQ
5128,16-02-2021 08:00,24 hrs.,wallstreetbets,OIIM,7,7,0,7,1,1,1,1,NASDAQ
5128,16-02-2021 08:00,24 hrs.,wallstreetbets,OLED,5,0,5,-5,1,0,1,1,NASDAQ
5128,16-02-2021 08:00,24 hrs.,wallstreetbets,ONTX,8,8,0,8,1,1,2,1,NASDAQ
5128,16-02-2021 08:00,24 hrs.,wallstreetbets,OSTK,16,16,0,16,2,3,2,1,NASDAQ
5128,16-02-2021 08:00,24 hrs.,wallstreetbets,OTLK,6,0,6,-6,1,1,0,1,NASDAQ
5128,16-02-2021 08:00,24 hrs.,wallstreetbets,PGEN,6,0,6,-6,1,1,0,1,NASDAQ
5128,16-02-2021 08:00,24 hrs.,wallstreetbets,PLAY,7,7,0,7,1,1,1,1,NASDAQ
5128,16-02-2021 08:00,24 hrs.,wallstreetbets,PLUG,358,358,0,358,3,130,86,3,NASDAQ
5128,16-02-2021 08:00,24 hrs.,wallstreetbets,POWW,13,6,7,-1,2,2,1,2,NASDAQ
5128,16-02-2021 08:00,24 hrs.,wallstreetbets,PSEC,6,0,6,-6,1,1,0,1,NASDAQ
5128,16-02-2021 08:00,24 hrs.,wallstreetbets,PYPL,13,6,7,-1,2,2,1,2,NASDAQ
5128,16-02-2021 08:00,24 hrs.,wallstreetbets,QLGN,6,0,6,-6,1,1,0,1,NASDAQ
5128,16-02-2021 08:00,24 hrs.,wallstreetbets,RAVE,6,6,0,6,1,1,0,1,NASDAQ
5128,16-02-2021 08:00,24 hrs.,wallstreetbets,REAL,6,0,6,-6,1,1,0,1,NASDAQ
5128,16-02-2021 08:00,24 hrs.,wallstreetbets,RIOT,53,39,14,25,7,7,11,6,NASDAQ
5128,16-02-2021 08:00,24 hrs.,wallstreetbets,RNWK,7,7,0,7,1,1,1,1,NASDAQ
5128,16-02-2021 08:00,24 hrs.,wallstreetbets,ROOT,7,0,7,-7,1,1,1,1,NASDAQ
5128,16-02-2021 08:00,24 hrs.,wallstreetbets,SAVA,12,0,12,-12,2,2,0,1,NASDAQ
5128,16-02-2021 08:00,24 hrs.,wallstreetbets,SAVE,14,14,0,14,2,2,2,2,NASDAQ
5128,16-02-2021 08:00,24 hrs.,wallstreetbets,SESN,6,0,6,-6,1,1,0,1,NASDAQ
5128,16-02-2021 08:00,24 hrs.,SPACs,GME,639,319,320,-1,2,254,123,2,NYSE
5128,16-02-2021 08:00,24 hrs.,SPACs,HPS,99,99,0,99,1,32,31,1,NYSE
5128,16-02-2021 08:00,24 hrs.,SPACs,MGM,99,99,0,99,1,32,31,1,NYSE
5128,16-02-2021 08:00,24 hrs.,SPACs,NAV,326,319,7,312,2,140,38,2,NYSE
5128,16-02-2021 08:00,24 hrs.,SPACs,NOC,63,0,63,-63,1,23,13,1,NYSE
5128,16-02-2021 08:00,24 hrs.,RobinHoodPennyStocks,OPGN,6,6,0,6,1,1,0,1,NASDAQ
5128,16-02-2021 08:00,24 hrs.,RobinHoodPennyStocks,OPTT,90,90,0,90,1,37,12,1,NASDAQ
5128,16-02-2021 08:00,24 hrs.,RobinHoodPennyStocks,PECK,90,90,0,90,1,37,12,1,NASDAQ
5128,16-02-2021 08:00,24 hrs.,RobinHoodPennyStocks,PEIX,90,90,0,90,1,37,12,1,NASDAQ
5128,16-02-2021 08:00,24 hrs.,RobinHoodPennyStocks,PHIO,90,90,0,90,1,37,12,1,NASDAQ
5128,16-02-2021 08:00,24 hrs.,RobinHoodPennyStocks,PHUN,90,90,0,90,1,37,12,1,NASDAQ
5128,16-02-2021 08:00,24 hrs.,RobinHoodPennyStocks,PLUG,90,90,0,90,1,37,12,1,NASDAQ
5128,16-02-2021 08:00,24 hrs.,RobinHoodPennyStocks,PLYA,90,90,0,90,1,37,12,1,NASDAQ
5128,16-02-2021 08:00,24 hrs.,RobinHoodPennyStocks,POWW,46,0,46,-46,1,17,8,1,NASDAQ
5128,16-02-2021 08:00,24 hrs.,RobinHoodPennyStocks,PULM,12,6,6,0,2,2,0,2,NASDAQ
5128,16-02-2021 08:00,24 hrs.,RobinHoodPennyStocks,RCON,90,90,0,90,1,37,12,1,NASDAQ
5128,16-02-2021 08:00,24 hrs.,RobinHoodPennyStocks,RGLS,7,7,0,7,1,1,1,1,NASDAQ
5128,16-02-2021 08:00,24 hrs.,RobinHoodPennyStocks,RIOT,118,118,0,118,2,47,16,2,NASDAQ
5128,16-02-2021 08:00,24 hrs.,RobinHoodPennyStocks,SALM,90,90,0,90,1,37,12,1,NASDAQ
5128,16-02-2021 08:00,24 hrs.,RobinHoodPennyStocks,SAVA,215,90,125,-35,2,72,63,2,NASDAQ
5128,16-02-2021 08:00,24 hrs.,RobinHoodPennyStocks,SHIP,102,90,12,78,3,39,12,3,NASDAQ
5128,16-02-2021 08:00,24 hrs.,RobinHoodPennyStocks,SINO,90,90,0,90,1,37,12,1,NASDAQ
5128,16-02-2021 08:00,24 hrs.,RobinHoodPennyStocks,SIRI,6,6,0,6,1,1,0,1,NASDAQ
5128,16-02-2021 08:00,24 hrs.,RobinHoodPennyStocks,SLRX,7,7,0,7,1,1,1,1,NASDAQ
5128,16-02-2021 08:00,24 hrs.,RobinHoodPennyStocks,SNCA,125,0,125,-125,1,35,51,1,NASDAQ
5128,16-02-2021 08:00,24 hrs.,RobinHoodPennyStocks,SNDL,115,108,7,101,5,41,13,5,NASDAQ
5128,16-02-2021 08:00,24 hrs.,RobinHoodPennyStocks,GGB,6,0,6,-6,1,1,0,1,NYSE
5128,16-02-2021 08:00,24 hrs.,RobinHoodPennyStocks,HGV,90,90,0,90,1,37,12,1,NYSE
5128,16-02-2021 08:00,24 hrs.,RobinHoodPennyStocks,HMI,90,90,0,90,1,37,12,1,NYSE
5128,16-02-2021 08:00,24 hrs.,RobinHoodPennyStocks,NIO,6,0,6,-6,1,1,0,1,NYSE
5128,16-02-2021 08:00,24 hrs.,RobinHoodPennyStocks,NOK,23,23,0,23,2,3,9,2,NYSE
5128,16-02-2021 08:00,24 hrs.,RobinHoodPennyStocks,PBR,6,0,6,-6,1,1,0,1,NYSE
5128,16-02-2021 08:00,24 hrs.,RobinHoodPennyStocks,PEG,6,0,6,-6,1,1,0,1,NYSE
5128,16-02-2021 08:00,24 hrs.,RobinHoodPennyStocks,PHI,6,6,0,6,1,1,0,1,NYSE
5128,16-02-2021 08:00,24 hrs.,RobinHoodPennyStocks,PVL,90,90,0,90,1,37,12,1,NYSE
5128,16-02-2021 08:00,24 hrs.,RobinHoodPennyStocks,RSI,6,6,0,6,1,1,0,1,NYSE
5128,16-02-2021 08:00,24 hrs.,RobinHoodPennyStocks,SIX,90,90,0,90,1,37,12,1,NYSE
5128,16-02-2021 08:00,24 hrs.,RobinHoodPennyStocks,SOS,305,174,131,43,8,88,97,7,NYSE
5128,16-02-2021 08:00,24 hrs.,RobinHoodPennyStocks,THC,934,934,0,934,1,412,106,1,NYSE
5128,16-02-2021 08:00,24 hrs.,RobinHoodPennyStocks,TSM,179,0,179,-179,1,43,89,1,NYSE
5128,16-02-2021 08:00,24 hrs.,RobinHoodPennyStocks,VHC,7,7,0,7,1,1,1,1,NYSE
5128,16-02-2021 08:00,24 hrs.,RobinHoodPennyStocks,VST,90,90,0,90,1,37,12,1,NYSE
5128,16-02-2021 08:00,24 hrs.,RobinHoodPennyStocks,ARCH,90,90,0,90,1,37,12,1,NYSE
5128,16-02-2021 08:00,24 hrs.,RobinHoodPennyStocks,CCIV,12,12,0,12,2,2,0,1,NYSE
5128,16-02-2021 08:00,24 hrs.,RobinHoodPennyStocks,CSPR,6,0,6,-6,1,1,0,1,NYSE
5128,16-02-2021 08:00,24 hrs.,RobinHoodPennyStocks,HEXO,90,90,0,90,1,37,12,1,NYSE
5128,16-02-2021 08:00,24 hrs.,RobinHoodPennyStocks,CFO,6,0,6,-6,1,1,0,1,NASDAQ
5128,16-02-2021 08:00,24 hrs.,RobinHoodPennyStocks,CGC,90,90,0,90,1,37,12,1,NASDAQ
5128,16-02-2021 08:00,24 hrs.,RobinHoodPennyStocks,ENG,90,90,0,90,1,37,12,1,NASDAQ
5128,16-02-2021 08:00,24 hrs.,RobinHoodPennyStocks,MGI,90,90,0,90,1,37,12,1,NASDAQ
5128,16-02-2021 08:00,24 hrs.,RobinHoodPennyStocks,OEG,96,96,0,96,2,38,12,2,NASDAQ
5128,16-02-2021 08:00,24 hrs.,wallstreetbets,TNXP,29,29,0,29,4,4,5,4,NASDAQ
5128,16-02-2021 08:00,24 hrs.,wallstreetbets,TOPS,144,15,129,-114,5,50,24,5,NASDAQ
5128,16-02-2021 08:00,24 hrs.,wallstreetbets,TRCH,7,7,0,7,1,1,1,1,NASDAQ
5128,16-02-2021 08:00,24 hrs.,wallstreetbets,TRIT,26,14,12,2,4,4,2,4,NASDAQ
5128,16-02-2021 08:00,24 hrs.,wallstreetbets,TRVG,14,0,14,-14,2,2,2,2,NASDAQ
5128,16-02-2021 08:00,24 hrs.,wallstreetbets,TSLA,156,149,7,142,9,50,20,8,NASDAQ
5128,16-02-2021 08:00,24 hrs.,wallstreetbets,TTCF,7,7,0,7,1,1,1,1,NASDAQ
5128,16-02-2021 08:00,24 hrs.,wallstreetbets,TURN,9,0,9,-9,1,2,1,1,NASDAQ
5128,16-02-2021 08:00,24 hrs.,wallstreetbets,TXMD,28,22,6,16,4,5,2,3,NASDAQ
5128,16-02-2021 08:00,24 hrs.,wallstreetbets,UCTT,35,0,35,-35,1,5,21,1,NASDAQ
5128,16-02-2021 08:00,24 hrs.,wallstreetbets,VKTX,7,7,0,7,1,1,1,1,NASDAQ
5128,16-02-2021 08:00,24 hrs.,wallstreetbets,VXRT,105,105,0,105,2,19,59,2,NASDAQ
5128,16-02-2021 08:00,24 hrs.,wallstreetbets,VYNE,7,7,0,7,1,1,1,1,NASDAQ
5128,16-02-2021 08:00,24 hrs.,SPACs,LOAC,6,6,0,6,1,1,0,1,NASDAQ
5128,16-02-2021 08:00,24 hrs.,SPACs,MCAC,320,0,320,-320,1,115,86,1,NASDAQ
5128,16-02-2021 08:00,24 hrs.,SPACs,NBAC,37,0,37,-37,1,15,3,1,NASDAQ
5128,16-02-2021 08:00,24 hrs.,SPACs,NGAC,334,0,334,-334,3,117,88,2,NASDAQ
5128,16-02-2021 08:00,24 hrs.,SPACs,QELL,118,0,118,-118,2,30,50,2,NASDAQ
5128,16-02-2021 08:00,24 hrs.,SPACs,SAII,99,99,0,99,1,32,31,1,NASDAQ
5128,16-02-2021 08:00,24 hrs.,SPACs,THBR,7,0,7,-7,1,1,1,1,NASDAQ
5128,16-02-2021 08:00,24 hrs.,SPACs,THCB,265,265,0,265,4,81,87,2,NASDAQ
5128,16-02-2021 08:00,24 hrs.,SPACs,THRY,319,319,0,319,1,139,37,1,NASDAQ
5128,16-02-2021 08:00,24 hrs.,SPACs,UNIT,99,99,0,99,1,32,31,1,NASDAQ
5128,16-02-2021 08:00,24 hrs.,SPACs,THCBU,62,0,62,-62,1,18,22,1,NASDAQ
5128,16-02-2021 08:00,24 hrs.,stocks,ALPP,6,0,6,-6,1,1,0,1,OTC
5128,16-02-2021 08:00,24 hrs.,stocks,ASTI,19,0,19,-19,1,2,11,1,OTC
5128,16-02-2021 08:00,24 hrs.,stocks,BNET,6,0,6,-6,1,1,0,1,OTC
5128,16-02-2021 08:00,24 hrs.,stocks,HEMP,6,6,0,6,1,1,0,1,OTC
5128,16-02-2021 08:00,24 hrs.,stocks,ICCT,6,6,0,6,1,1,0,1,OTC
5128,16-02-2021 08:00,24 hrs.,stocks,INKW,6,0,6,-6,1,1,0,1,OTC
5128,16-02-2021 08:00,24 hrs.,stocks,JSDA,36,36,0,36,1,7,18,1,OTC
5128,16-02-2021 08:00,24 hrs.,stocks,LLBO,12,0,12,-12,2,2,0,1,OTC
5128,16-02-2021 08:00,24 hrs.,stocks,MOJO,6,6,0,6,1,1,0,1,OTC
5128,16-02-2021 08:00,24 hrs.,stocks,NWGC,7,7,0,7,1,1,1,1,OTC
5128,16-02-2021 08:00,24 hrs.,stocks,PURE,436,0,436,-436,1,149,134,1,OTC
5128,16-02-2021 08:00,24 hrs.,stocks,ROTH,14,14,0,14,1,5,0,1,OTC
5128,16-02-2021 08:00,24 hrs.,RobinHoodPennyStocks,SNGX,90,90,0,90,1,37,12,1,NASDAQ
5128,16-02-2021 08:00,24 hrs.,RobinHoodPennyStocks,SRGA,125,0,125,-125,1,35,51,1,NASDAQ
5128,16-02-2021 08:00,24 hrs.,RobinHoodPennyStocks,STAY,90,90,0,90,1,37,12,1,NASDAQ
5128,16-02-2021 08:00,24 hrs.,RobinHoodPennyStocks,SUNW,90,90,0,90,1,37,12,1,NASDAQ
5128,16-02-2021 08:00,24 hrs.,RobinHoodPennyStocks,SYPR,90,90,0,90,1,37,12,1,NASDAQ
5128,16-02-2021 08:00,24 hrs.,RobinHoodPennyStocks,SYTA,90,90,0,90,1,37,12,1,NASDAQ
5128,16-02-2021 08:00,24 hrs.,RobinHoodPennyStocks,TANH,20,20,0,20,1,5,6,1,NASDAQ
5128,16-02-2021 08:00,24 hrs.,RobinHoodPennyStocks,TLRY,90,90,0,90,1,37,12,1,NASDAQ
5128,16-02-2021 08:00,24 hrs.,RobinHoodPennyStocks,TNXP,1753,989,764,225,6,677,375,6,NASDAQ
5128,16-02-2021 08:00,24 hrs.,RobinHoodPennyStocks,TOPS,90,90,0,90,1,37,12,1,NASDAQ
5128,16-02-2021 08:00,24 hrs.,RobinHoodPennyStocks,TRCH,231,90,141,-51,3,72,75,3,NASDAQ
5128,16-02-2021 08:00,24 hrs.,RobinHoodPennyStocks,TXMD,1572,940,632,308,4,605,346,4,NASDAQ
5128,16-02-2021 08:00,24 hrs.,RobinHoodPennyStocks,TYME,6,6,0,6,1,1,0,1,NASDAQ
5128,16-02-2021 08:00,24 hrs.,RobinHoodPennyStocks,UONE,90,90,0,90,1,37,12,1,NASDAQ
5128,16-02-2021 08:00,24 hrs.,RobinHoodPennyStocks,USEG,90,90,0,90,1,37,12,1,NASDAQ
5128,16-02-2021 08:00,24 hrs.,RobinHoodPennyStocks,USWS,90,90,0,90,1,37,12,1,NASDAQ
5128,16-02-2021 08:00,24 hrs.,RobinHoodPennyStocks,VERU,90,90,0,90,1,37,12,1,NASDAQ
5128,16-02-2021 08:00,24 hrs.,RobinHoodPennyStocks,VYNE,6,6,0,6,1,1,0,1,NASDAQ
5128,16-02-2021 08:00,24 hrs.,RobinHoodPennyStocks,WATT,90,90,0,90,1,37,12,1,NASDAQ
5128,16-02-2021 08:00,24 hrs.,RobinHoodPennyStocks,WKEY,90,90,0,90,1,37,12,1,NASDAQ
5128,16-02-2021 08:00,24 hrs.,RobinHoodPennyStocks,MARPS,90,90,0,90,1,37,12,1,NASDAQ
5128,16-02-2021 08:00,24 hrs.,RobinHoodPennyStocks,UONEK,90,90,0,90,1,37,12,1,NASDAQ
5128,16-02-2021 08:00,24 hrs.,SPACs,NRZ,99,99,0,99,1,32,31,1,NYSE
5128,16-02-2021 08:00,24 hrs.,SPACs,CAGR,319,319,0,319,1,139,37,1,OTC
5128,16-02-2021 08:00,24 hrs.,SPACs,CDIX,6,6,0,6,1,1,0,1,OTC
5128,16-02-2021 08:00,24 hrs.,SPACs,USPS,276,276,0,276,1,108,56,1,OTC
5128,16-02-2021 08:00,24 hrs.,SPACs,BAESY,63,0,63,-63,1,23,13,1,OTC
5128,16-02-2021 08:00,24 hrs.,SPACs,EADSY,63,0,63,-63,1,23,13,1,OTC
5128,16-02-2021 08:00,24 hrs.,SPACs,LVMHF,19,19,0,19,1,7,1,1,OTC
5128,16-02-2021 08:00,24 hrs.,SPACs,CTO,63,0,63,-63,1,23,13,1,AMEX
5128,16-02-2021 08:00,24 hrs.,SPACs,GSV,99,99,0,99,1,32,31,1,AMEX
5128,16-02-2021 08:00,24 hrs.,SPACs,AMC,319,319,0,319,1,139,37,1,NYSE
5128,16-02-2021 08:00,24 hrs.,SPACs,APO,199,0,199,-199,1,79,37,1,NYSE
5128,16-02-2021 08:00,24 hrs.,SPACs,BLK,199,0,199,-199,1,79,37,1,NYSE
5128,16-02-2021 08:00,24 hrs.,SPACs,CAE,63,0,63,-63,1,23,13,1,NYSE
5128,16-02-2021 08:00,24 hrs.,SPACs,CCO,99,99,0,99,1,32,31,1,NYSE
5128,16-02-2021 08:00,24 hrs.,SPACs,COO,63,0,63,-63,1,23,13,1,NYSE
5128,16-02-2021 08:00,24 hrs.,SPACs,EVA,10,0,10,-10,1,0,6,1,NYSE
5128,16-02-2021 08:00,24 hrs.,SPACs,FCN,319,319,0,319,1,139,37,1,NYSE
5128,16-02-2021 08:00,24 hrs.,SPACs,FTI,319,319,0,319,1,139,37,1,NYSE
5128,16-02-2021 08:00,24 hrs.,SPACs,GIK,538,538,0,538,3,221,84,3,NYSE
5128,16-02-2021 08:00,24 hrs.,wallstreetbets,XPEV,6,6,0,6,1,1,0,1,NYSE
5128,16-02-2021 08:00,24 hrs.,wallstreetbets,AAL,26,14,12,2,4,3,4,3,NASDAQ
5128,16-02-2021 08:00,24 hrs.,wallstreetbets,AEP,14,14,0,14,2,2,2,1,NASDAQ
5128,16-02-2021 08:00,24 hrs.,wallstreetbets,ALT,98,98,0,98,1,18,58,1,NASDAQ
5128,16-02-2021 08:00,24 hrs.,wallstreetbets,AMD,378,352,26,326,7,147,56,6,NASDAQ
5128,16-02-2021 08:00,24 hrs.,wallstreetbets,APA,157,157,0,157,1,57,39,1,NASDAQ
5128,16-02-2021 08:00,24 hrs.,wallstreetbets,API,6,0,6,-6,1,1,0,1,NASDAQ
5128,16-02-2021 08:00,24 hrs.,wallstreetbets,AVO,7,0,7,-7,1,1,1,1,NASDAQ
5128,16-02-2021 08:00,24 hrs.,wallstreetbets,BFI,7,0,7,-7,1,1,1,1,NASDAQ
5128,16-02-2021 08:00,24 hrs.,wallstreetbets,CDC,38,38,0,38,1,0,34,1,NASDAQ
5128,16-02-2021 08:00,24 hrs.,wallstreetbets,CGC,13,7,6,1,2,2,1,2,NASDAQ
5128,16-02-2021 08:00,24 hrs.,wallstreetbets,DBX,8,0,8,-8,1,1,2,1,NASDAQ
5128,16-02-2021 08:00,24 hrs.,wallstreetbets,GSM,27,7,20,-13,4,4,3,3,NASDAQ
5128,16-02-2021 08:00,24 hrs.,wallstreetbets,HAS,4610,2511,2099,412,4,2005,584,3,NASDAQ
5128,16-02-2021 08:00,24 hrs.,wallstreetbets,HCM,6,6,0,6,1,1,0,1,NASDAQ
5128,16-02-2021 08:00,24 hrs.,wallstreetbets,INO,19,7,12,-5,3,3,1,2,NASDAQ
5128,16-02-2021 08:00,24 hrs.,wallstreetbets,MGI,14,0,14,-14,2,2,2,1,NASDAQ
5128,16-02-2021 08:00,24 hrs.,wallstreetbets,MWK,7,0,7,-7,1,1,1,1,NASDAQ
5128,16-02-2021 08:00,24 hrs.,wallstreetbets,OGI,20,20,0,20,3,3,2,3,NASDAQ
5128,16-02-2021 08:00,24 hrs.,wallstreetbets,OPK,21,14,7,7,3,3,3,2,NASDAQ
5128,16-02-2021 08:00,24 hrs.,wallstreetbets,PTE,14,0,14,-14,2,2,2,1,NASDAQ
5128,16-02-2021 08:00,24 hrs.,wallstreetbets,REG,7,0,7,-7,1,1,1,1,NASDAQ
5128,16-02-2021 08:00,24 hrs.,wallstreetbets,SDC,7,0,7,-7,1,1,1,1,NASDAQ
5128,16-02-2021 08:00,24 hrs.,SPACs,RTP,320,0,320,-320,1,115,86,1,NYSE
5128,16-02-2021 08:00,24 hrs.,SPACs,SBG,82,82,0,82,4,10,46,4,NYSE
5128,16-02-2021 08:00,24 hrs.,SPACs,UBS,319,319,0,319,1,139,37,1,NYSE
5128,16-02-2021 08:00,24 hrs.,SPACs,ACIC,438,0,438,-438,3,145,136,3,NYSE
5128,16-02-2021 08:00,24 hrs.,SPACs,APSG,199,0,199,-199,1,79,37,1,NYSE
5128,16-02-2021 08:00,24 hrs.,SPACs,BOAC,13,13,0,13,2,2,1,1,NYSE
5128,16-02-2021 08:00,24 hrs.,SPACs,CCIV,1422,1095,327,768,12,497,380,11,NYSE
5128,16-02-2021 08:00,24 hrs.,SPACs,CTAC,8,0,8,-8,1,1,2,1,NYSE
5128,16-02-2021 08:00,24 hrs.,SPACs,DNMR,320,0,320,-320,1,115,86,1,NYSE
5128,16-02-2021 08:00,24 hrs.,SPACs,FGNA,320,0,320,-320,1,115,86,1,NYSE
5128,16-02-2021 08:00,24 hrs.,SPACs,FUSE,366,46,320,-274,2,123,112,2,NYSE
5128,16-02-2021 08:00,24 hrs.,SPACs,IPOD,33,33,0,33,1,5,19,1,NYSE
5128,16-02-2021 08:00,24 hrs.,SPACs,IPOE,230,165,65,100,5,58,94,5,NYSE
5128,16-02-2021 08:00,24 hrs.,SPACs,IPOF,40,40,0,40,2,6,20,2,NYSE
5128,16-02-2021 08:00,24 hrs.,SPACs,LGVW,7,7,0,7,1,1,1,1,NYSE
5128,16-02-2021 08:00,24 hrs.,SPACs,LXFR,319,319,0,319,1,139,37,1,NYSE
5128,16-02-2021 08:00,24 hrs.,SPACs,PDAC,620,620,0,620,10,234,112,7,NYSE
5128,16-02-2021 08:00,24 hrs.,SPACs,PSTH,339,6,333,-327,4,118,87,4,NYSE
5128,16-02-2021 08:00,24 hrs.,SPACs,SNPR,320,0,320,-320,1,115,86,1,NYSE
5128,16-02-2021 08:00,24 hrs.,SPACs,UBER,63,0,63,-63,1,23,13,1,NYSE
5128,16-02-2021 08:00,24 hrs.,SPACs,CFO,99,99,0,99,1,32,31,1,NASDAQ
5128,16-02-2021 08:00,24 hrs.,SPACs,III,199,0,199,-199,1,79,37,1,NASDAQ
5128,16-02-2021 08:00,24 hrs.,SPACs,JAN,37,0,37,-37,1,15,3,1,NASDAQ
5128,16-02-2021 08:00,24 hrs.,SPACs,VIH,132,125,7,118,2,42,40,2,NASDAQ
5128,16-02-2021 08:00,24 hrs.,SPACs,AACQ,320,0,320,-320,1,115,86,1,NASDAQ
5128,16-02-2021 08:00,24 hrs.,SPACs,ARYA,320,0,320,-320,1,115,86,1,NASDAQ
5128,16-02-2021 08:00,24 hrs.,SPACs,BTWN,47,47,0,47,1,13,17,1,NASDAQ
5128,16-02-2021 08:00,24 hrs.,SPACs,CIIC,48,0,48,-48,1,10,24,1,NASDAQ
5128,16-02-2021 08:00,24 hrs.,SPACs,CMLF,320,0,320,-320,1,115,86,1,NASDAQ
5128,16-02-2021 08:00,24 hrs.,SPACs,DCRB,320,0,320,-320,1,115,86,1,NASDAQ
5128,16-02-2021 08:00,24 hrs.,SPACs,ETAC,7,7,0,7,1,1,1,1,NASDAQ
5128,16-02-2021 08:00,24 hrs.,SPACs,EXPC,121,0,121,-121,2,29,55,2,NASDAQ
5128,16-02-2021 08:00,24 hrs.,SPACs,FCAC,320,0,320,-320,1,115,86,1,NASDAQ
5128,16-02-2021 08:00,24 hrs.,SPACs,FIII,7,7,0,7,1,1,1,1,NASDAQ
5128,16-02-2021 08:00,24 hrs.,SPACs,GRNV,320,0,320,-320,1,115,86,1,NASDAQ
5128,16-02-2021 08:00,24 hrs.,SPACs,GRSV,320,0,320,-320,1,115,86,1,NASDAQ
5128,16-02-2021 08:00,24 hrs.,SPACs,HYMC,319,319,0,319,1,139,37,1,NASDAQ
5128,16-02-2021 08:00,24 hrs.,SPACs,INAQ,320,0,320,-320,1,115,86,1,NASDAQ
5128,16-02-2021 08:00,24 hrs.,SPACs,JCIC,99,99,0,99,1,32,31,1,NASDAQ
5128,16-02-2021 08:00,24 hrs.,SPACs,KERN,15,15,0,15,1,0,11,1,NASDAQ
5128,16-02-2021 08:00,24 hrs.,SPACs,LEGO,99,99,0,99,1,32,31,1,NASDAQ
5128,16-02-2021 08:00,24 hrs.,wallstreetbets,EVFM,6,0,6,-6,1,1,0,1,NASDAQ
5128,16-02-2021 08:00,24 hrs.,wallstreetbets,EXPI,7,7,0,7,1,1,1,1,NASDAQ
5128,16-02-2021 08:00,24 hrs.,wallstreetbets,FANG,7,0,7,-7,1,1,1,1,NASDAQ
5128,16-02-2021 08:00,24 hrs.,wallstreetbets,FARM,6,6,0,6,1,1,0,1,NASDAQ
5128,16-02-2021 08:00,24 hrs.,wallstreetbets,FCEL,6,6,0,6,1,1,0,1,NASDAQ
5128,16-02-2021 08:00,24 hrs.,wallstreetbets,FIII,5,5,0,5,1,0,1,1,NASDAQ
5128,16-02-2021 08:00,24 hrs.,stocks,EQR,8,8,0,8,1,0,4,1,NYSE
5128,16-02-2021 08:00,24 hrs.,stocks,ESS,8,8,0,8,1,0,4,1,NYSE
5128,16-02-2021 08:00,24 hrs.,stocks,ETN,24,24,0,24,4,4,0,1,NYSE
5128,16-02-2021 08:00,24 hrs.,stocks,FSR,133,0,133,-133,1,49,31,1,NYSE
5128,16-02-2021 08:00,24 hrs.,stocks,GIK,133,0,133,-133,1,49,31,1,NYSE
5128,16-02-2021 08:00,24 hrs.,stocks,GME,376,259,117,142,7,105,138,6,NYSE
5128,16-02-2021 08:00,24 hrs.,stocks,HBI,133,0,133,-133,1,49,31,1,NYSE
5128,16-02-2021 08:00,24 hrs.,stocks,ICE,64,0,64,-64,1,4,52,1,NYSE
5128,16-02-2021 08:00,24 hrs.,stocks,JPM,396,0,396,-396,1,114,164,1,NYSE
5128,16-02-2021 08:00,24 hrs.,stocks,LAC,6,6,0,6,1,1,0,1,NYSE
5128,16-02-2021 08:00,24 hrs.,stocks,LYV,6,6,0,6,1,1,0,1,NYSE
5128,16-02-2021 08:00,24 hrs.,stocks,MAA,8,8,0,8,1,0,4,1,NYSE
5128,16-02-2021 08:00,24 hrs.,stocks,MAS,118,118,0,118,1,53,8,1,NYSE
5128,16-02-2021 08:00,24 hrs.,stocks,MLM,6,0,6,-6,1,1,0,1,NYSE
5128,16-02-2021 08:00,24 hrs.,stocks,MRK,396,0,396,-396,1,114,164,1,NYSE
5128,16-02-2021 08:00,24 hrs.,stocks,NIO,426,0,426,-426,1,164,94,1,NYSE
5128,16-02-2021 08:00,24 hrs.,stocks,NOK,71,71,0,71,1,19,29,1,NYSE
5128,16-02-2021 08:00,24 hrs.,stocks,SGMD,6,0,6,-6,1,1,0,1,OTC
5128,16-02-2021 08:00,24 hrs.,stocks,USPS,133,0,133,-133,1,49,31,1,OTC
5128,16-02-2021 08:00,24 hrs.,stocks,VITX,6,0,6,-6,1,1,0,1,OTC
5128,16-02-2021 08:00,24 hrs.,stocks,HVBTF,6,6,0,6,1,1,0,1,OTC
5128,16-02-2021 08:00,24 hrs.,stocks,LMRMF,6,6,0,6,1,1,0,1,OTC
5128,16-02-2021 08:00,24 hrs.,stocks,NTDOY,29,0,29,-29,1,7,11,1,OTC
5128,16-02-2021 08:00,24 hrs.,stocks,RYCEY,10,0,10,-10,1,1,4,1,OTC
5128,16-02-2021 08:00,24 hrs.,stocks,AMS,133,0,133,-133,1,49,31,1,AMEX
5128,16-02-2021 08:00,24 hrs.,stocks,CTO,133,0,133,-133,1,49,31,1,AMEX
5128,16-02-2021 08:00,24 hrs.,stocks,NBA,48,48,0,48,1,18,8,1,AMEX
5128,16-02-2021 08:00,24 hrs.,stocks,WYY,118,118,0,118,1,53,8,1,AMEX
5128,16-02-2021 08:00,24 hrs.,stocks,XXII,6,6,0,6,1,1,0,1,AMEX
5128,16-02-2021 08:00,24 hrs.,stocks,ABC,31,31,0,31,1,5,17,1,NYSE
5128,16-02-2021 08:00,24 hrs.,stocks,AIR,133,0,133,-133,1,49,31,1,NYSE
5128,16-02-2021 08:00,24 hrs.,stocks,AMC,6,0,6,-6,1,1,0,1,NYSE
5128,16-02-2021 08:00,24 hrs.,stocks,AVB,8,8,0,8,1,0,4,1,NYSE
5128,16-02-2021 08:00,24 hrs.,stocks,BMY,396,0,396,-396,1,114,164,1,NYSE
5128,16-02-2021 08:00,24 hrs.,stocks,BYD,54,0,54,-54,1,6,38,1,NYSE
5128,16-02-2021 08:00,24 hrs.,stocks,CAH,118,118,0,118,1,53,8,1,NYSE
5128,16-02-2021 08:00,24 hrs.,stocks,CCO,386,0,386,-386,2,114,150,2,NYSE
5128,16-02-2021 08:00,24 hrs.,stocks,CHL,6,6,0,6,1,1,0,1,NYSE
5128,16-02-2021 08:00,24 hrs.,stocks,COO,386,0,386,-386,2,114,150,2,NYSE
5128,16-02-2021 08:00,24 hrs.,stocks,CPT,8,8,0,8,1,0,4,1,NYSE
5128,16-02-2021 08:00,24 hrs.,stocks,CVX,396,0,396,-396,1,114,164,1,NYSE
5128,16-02-2021 08:00,24 hrs.,stocks,DIS,639,35,604,-569,3,166,295,3,NYSE
5128,16-02-2021 08:00,24 hrs.,stocks,EAT,6,6,0,6,1,1,0,1,NYSE
5128,16-02-2021 08:00,24 hrs.,stocks,ELY,49,49,0,49,2,12,17,1,NYSE
5128,16-02-2021 08:00,24 hrs.,stocks,EMP,118,118,0,118,1,53,8,1,NYSE
5128,16-02-2021 08:00,24 hrs.,wallstreetbets,HUYA,44,0,44,-44,3,9,14,2,NYSE
5128,16-02-2021 08:00,24 hrs.,wallstreetbets,IPOE,6,6,0,6,1,1,0,1,NYSE
5128,16-02-2021 08:00,24 hrs.,wallstreetbets,KODK,6,0,6,-6,1,1,0,1,NYSE
5128,16-02-2021 08:00,24 hrs.,wallstreetbets,LEAP,7,7,0,7,1,1,1,1,NYSE
5128,16-02-2021 08:00,24 hrs.,wallstreetbets,MSGS,6,0,6,-6,1,1,0,1,NYSE
5128,16-02-2021 08:00,24 hrs.,wallstreetbets,PDAC,7,7,0,7,1,1,1,1,NYSE
5128,16-02-2021 08:00,24 hrs.,wallstreetbets,PINS,7,7,0,7,1,1,1,1,NYSE
5128,16-02-2021 08:00,24 hrs.,wallstreetbets,PLTR,35427,25010,10417,14593,53,15960,3295,41,NYSE
5128,16-02-2021 08:00,24 hrs.,wallstreetbets,PSTH,14,0,14,-14,2,3,0,2,NYSE
5128,16-02-2021 08:00,24 hrs.,wallstreetbets,SNPR,6,6,0,6,1,1,0,1,NYSE
5128,16-02-2021 08:00,24 hrs.,wallstreetbets,SPCE,13,0,13,-13,2,2,1,2,NYSE
5128,16-02-2021 08:00,24 hrs.,wallstreetbets,TDOC,653,0,653,-653,2,230,185,2,NYSE
5128,16-02-2021 08:00,24 hrs.,wallstreetbets,VALE,526,526,0,526,1,213,96,1,NYSE
5128,16-02-2021 08:00,24 hrs.,stocks,CMBM,9,0,9,-9,1,2,1,1,NASDAQ
5128,16-02-2021 08:00,24 hrs.,stocks,CMPS,12,0,12,-12,2,2,0,1,NASDAQ
5128,16-02-2021 08:00,24 hrs.,stocks,CNDT,6,0,6,-6,1,1,0,1,NASDAQ
5128,16-02-2021 08:00,24 hrs.,stocks,CRSP,6,6,0,6,1,1,0,1,NASDAQ
5128,16-02-2021 08:00,24 hrs.,stocks,CRSR,108,102,6,96,3,28,40,3,NASDAQ
5128,16-02-2021 08:00,24 hrs.,stocks,CRWD,12,12,0,12,2,2,0,1,NASDAQ
5128,16-02-2021 08:00,24 hrs.,stocks,CTRM,6,6,0,6,1,1,0,1,NASDAQ
5128,16-02-2021 08:00,24 hrs.,stocks,DKNG,48,48,0,48,1,18,8,1,NASDAQ
5128,16-02-2021 08:00,24 hrs.,stocks,DLTR,21,21,0,21,1,5,7,1,NASDAQ
5128,16-02-2021 08:00,24 hrs.,stocks,DRIV,212,71,141,-70,2,64,76,2,NASDAQ
5128,16-02-2021 08:00,24 hrs.,stocks,EDIT,358,118,240,-122,3,100,146,3,NASDAQ
5128,16-02-2021 08:00,24 hrs.,stocks,ESPO,15,0,15,-15,1,3,5,1,NASDAQ
5128,16-02-2021 08:00,24 hrs.,stocks,FATE,436,0,436,-436,1,149,134,1,NASDAQ
5128,16-02-2021 08:00,24 hrs.,stocks,FIII,151,6,145,-139,4,52,31,2,NASDAQ
5128,16-02-2021 08:00,24 hrs.,stocks,FLIR,436,0,436,-436,1,149,134,1,NASDAQ
5128,16-02-2021 08:00,24 hrs.,stocks,GILD,4,0,4,-4,1,0,0,1,NASDAQ
5128,16-02-2021 08:00,24 hrs.,stocks,GOGO,6,6,0,6,1,1,0,1,NASDAQ
5128,16-02-2021 08:00,24 hrs.,stocks,GPRO,6,0,6,-6,1,1,0,1,NASDAQ
5128,16-02-2021 08:00,24 hrs.,stocks,GTHX,54,0,54,-54,1,22,6,1,NASDAQ
5128,16-02-2021 08:00,24 hrs.,stocks,HLIT,118,118,0,118,1,53,8,1,NASDAQ
5128,16-02-2021 08:00,24 hrs.,stocks,ICLN,77,71,6,65,2,20,29,2,NASDAQ
5128,16-02-2021 08:00,24 hrs.,stocks,IZEA,6,6,0,6,1,1,0,1,NASDAQ
5128,16-02-2021 08:00,24 hrs.,stocks,LCAP,6,6,0,6,1,1,0,1,NASDAQ
5128,16-02-2021 08:00,24 hrs.,wallstreetbets,SFT,7,7,0,7,1,1,1,1,NASDAQ
5128,16-02-2021 08:00,24 hrs.,wallstreetbets,VFF,6,6,0,6,1,1,0,1,NASDAQ
5128,16-02-2021 08:00,24 hrs.,wallstreetbets,VRA,7,7,0,7,1,1,1,1,NASDAQ
5128,16-02-2021 08:00,24 hrs.,wallstreetbets,AACQ,7,7,0,7,1,1,1,1,NASDAQ
5128,16-02-2021 08:00,24 hrs.,wallstreetbets,AAPL,6,6,0,6,1,1,0,1,NASDAQ
5128,16-02-2021 08:00,24 hrs.,wallstreetbets,ABNB,7,7,0,7,1,1,1,1,NASDAQ
5128,16-02-2021 08:00,24 hrs.,wallstreetbets,ACRX,7,7,0,7,1,1,1,1,NASDAQ
5128,16-02-2021 08:00,24 hrs.,wallstreetbets,ACST,14,14,0,14,2,2,2,2,NASDAQ
5128,16-02-2021 08:00,24 hrs.,wallstreetbets,ADMA,7,0,7,-7,1,1,1,1,NASDAQ
5128,16-02-2021 08:00,24 hrs.,wallstreetbets,ADMP,6,6,0,6,1,1,0,1,NASDAQ
5128,16-02-2021 08:00,24 hrs.,wallstreetbets,AEZS,6,6,0,6,1,1,0,1,NASDAQ
5128,16-02-2021 08:00,24 hrs.,wallstreetbets,AGEN,6,0,6,-6,1,1,0,1,NASDAQ
5128,16-02-2021 08:00,24 hrs.,wallstreetbets,AKAM,7,0,7,-7,1,1,1,1,NASDAQ
5128,16-02-2021 08:00,24 hrs.,wallstreetbets,AMZN,7,7,0,7,1,1,1,1,NASDAQ
5128,16-02-2021 08:00,24 hrs.,wallstreetbets,APHA,32,32,0,32,4,3,10,4,NASDAQ
5128,16-02-2021 08:00,24 hrs.,wallstreetbets,AREC,7,7,0,7,1,1,1,1,NASDAQ
5128,16-02-2021 08:00,24 hrs.,wallstreetbets,ARTL,6,0,6,-6,1,1,0,1,NASDAQ
5128,16-02-2021 08:00,24 hrs.,wallstreetbets,ASRT,7,7,0,7,1,1,1,1,NASDAQ
5128,16-02-2021 08:00,24 hrs.,wallstreetbets,ATOM,7,7,0,7,1,1,1,1,NASDAQ
5128,16-02-2021 08:00,24 hrs.,wallstreetbets,ATOS,7,0,7,-7,1,1,1,1,NASDAQ
5128,16-02-2021 08:00,24 hrs.,wallstreetbets,AYTU,8,8,0,8,1,1,2,1,NASDAQ
5128,16-02-2021 08:00,24 hrs.,wallstreetbets,BAND,6,6,0,6,1,1,0,1,NASDAQ
5128,16-02-2021 08:00,24 hrs.,wallstreetbets,BCRX,14,0,14,-14,2,2,2,1,NASDAQ
5128,16-02-2021 08:00,24 hrs.,wallstreetbets,BNGO,34,13,21,-8,5,5,4,5,NASDAQ
5128,16-02-2021 08:00,24 hrs.,wallstreetbets,BNTX,7,0,7,-7,1,1,1,1,NASDAQ
5128,16-02-2021 08:00,24 hrs.,wallstreetbets,BXRX,14,0,14,-14,2,2,2,2,NASDAQ
5128,16-02-2021 08:00,24 hrs.,wallstreetbets,CHKP,95,0,95,-95,1,20,51,1,NASDAQ
5128,16-02-2021 08:00,24 hrs.,wallstreetbets,CLVS,7,0,7,-7,1,1,1,1,NASDAQ
5128,16-02-2021 08:00,24 hrs.,wallstreetbets,CMBM,7,0,7,-7,1,1,1,1,NASDAQ
5128,16-02-2021 08:00,24 hrs.,wallstreetbets,CMPS,7,0,7,-7,1,1,1,1,NASDAQ
5128,16-02-2021 08:00,24 hrs.,wallstreetbets,CRIS,6,6,0,6,1,1,0,1,NASDAQ
5128,16-02-2021 08:00,24 hrs.,wallstreetbets,CRSR,26,20,6,14,4,4,2,4,NASDAQ
5128,16-02-2021 08:00,24 hrs.,wallstreetbets,CSTR,7,0,7,-7,1,1,1,1,NASDAQ
5128,16-02-2021 08:00,24 hrs.,wallstreetbets,CTRM,45,11,34,-23,7,6,5,6,NASDAQ
5128,16-02-2021 08:00,24 hrs.,wallstreetbets,DFFN,14,14,0,14,2,2,2,1,NASDAQ
5128,16-02-2021 08:00,24 hrs.,wallstreetbets,DKNG,86,86,0,86,1,29,24,1,NASDAQ
5128,16-02-2021 08:00,24 hrs.,wallstreetbets,DMTK,7,7,0,7,1,1,1,1,NASDAQ
5128,16-02-2021 08:00,24 hrs.,wallstreetbets,EDIT,2006,2006,0,2006,3,760,474,3,NASDAQ
5128,16-02-2021 08:00,24 hrs.,wallstreetbets,ESPR,6,6,0,6,1,1,0,1,NASDAQ
5128,16-02-2021 08:00,24 hrs.,wallstreetbets,ETSY,7,7,0,7,1,1,1,1,NASDAQ
5128,16-02-2021 08:00,24 hrs.,wallstreetbets,EVER,116,0,116,-116,1,46,20,1,NASDAQ
5128,16-02-2021 08:00,24 hrs.,stocks,SSPK,39,39,0,39,2,15,1,2,NASDAQ
5128,16-02-2021 08:00,24 hrs.,stocks,SURF,12,12,0,12,2,2,0,1,NASDAQ
5128,16-02-2021 08:00,24 hrs.,stocks,SWBI,7,0,7,-7,1,1,1,1,NASDAQ
5128,16-02-2021 08:00,24 hrs.,stocks,TLRY,30,30,0,30,1,10,6,1,NASDAQ
5128,16-02-2021 08:00,24 hrs.,stocks,TNXP,6,0,6,-6,1,1,0,1,NASDAQ
5128,16-02-2021 08:00,24 hrs.,stocks,TSLA,573,177,396,-219,3,163,235,3,NASDAQ
5128,16-02-2021 08:00,24 hrs.,stocks,TTCF,133,0,133,-133,1,49,31,1,NASDAQ
5128,16-02-2021 08:00,24 hrs.,stocks,TXMD,10,10,0,10,1,3,0,1,NASDAQ
5128,16-02-2021 08:00,24 hrs.,stocks,UCTT,4,0,4,-4,1,0,0,1,NASDAQ
5128,16-02-2021 08:00,24 hrs.,stocks,UHAL,12,12,0,12,1,4,0,1,NASDAQ
5128,16-02-2021 08:00,24 hrs.,stocks,VLDR,9,9,0,9,1,0,5,1,NASDAQ
5128,16-02-2021 08:00,24 hrs.,stocks,VTWO,7,0,7,-7,1,1,1,1,NASDAQ
5128,16-02-2021 08:00,24 hrs.,stocks,VXUS,14,14,0,14,1,5,0,1,NASDAQ
5128,16-02-2021 08:00,24 hrs.,stocks,WKHS,86,0,86,-86,1,26,30,1,NASDAQ
5128,16-02-2021 08:00,24 hrs.,stocks,GOOGL,396,0,396,-396,1,114,164,1,NASDAQ
5128,16-02-2021 08:00,24 hrs.,Daytrading,FLES,6,6,0,6,1,1,0,1,OTC
5128,16-02-2021 08:00,24 hrs.,Daytrading,GBTC,6,6,0,6,1,1,0,1,OTC
5128,16-02-2021 08:00,24 hrs.,Daytrading,DHF,6,6,0,6,1,1,0,1,NYSE
5128,16-02-2021 08:00,24 hrs.,Daytrading,DIS,47,0,47,-47,1,15,13,1,NYSE
5128,16-02-2021 08:00,24 hrs.,Daytrading,ETH,6,0,6,-6,1,1,0,1,NYSE
5128,16-02-2021 08:00,24 hrs.,Daytrading,PDT,1427,1427,0,1427,2,634,151,2,NYSE
5128,16-02-2021 08:00,24 hrs.,Daytrading,RKT,47,0,47,-47,1,15,13,1,NYSE
5128,16-02-2021 08:00,24 hrs.,Daytrading,RSI,276,0,276,-276,2,118,32,2,NYSE
5128,16-02-2021 08:00,24 hrs.,stocks,PFE,12,12,0,12,2,2,0,1,NYSE
5128,16-02-2021 08:00,24 hrs.,stocks,PGR,19,19,0,19,1,6,3,1,NYSE
5128,16-02-2021 08:00,24 hrs.,stocks,PSX,396,0,396,-396,1,114,164,1,NYSE
5128,16-02-2021 08:00,24 hrs.,stocks,RSI,118,118,0,118,1,53,8,1,NYSE
5128,16-02-2021 08:00,24 hrs.,stocks,SOI,7,0,7,-7,1,1,1,1,NYSE
5128,16-02-2021 08:00,24 hrs.,stocks,TSM,62,62,0,62,1,20,18,1,NYSE
5128,16-02-2021 08:00,24 hrs.,stocks,UBS,133,0,133,-133,1,49,31,1,NYSE
5128,16-02-2021 08:00,24 hrs.,stocks,UPS,133,0,133,-133,1,49,31,1,NYSE
5128,16-02-2021 08:00,24 hrs.,stocks,WFC,396,0,396,-396,1,114,164,1,NYSE
5128,16-02-2021 08:00,24 hrs.,stocks,WMT,21,21,0,21,1,5,7,1,NYSE
5128,16-02-2021 08:00,24 hrs.,stocks,XOM,396,0,396,-396,1,114,164,1,NYSE
5128,16-02-2021 08:00,24 hrs.,stocks,ABBV,396,0,396,-396,1,114,164,1,NYSE
5128,16-02-2021 08:00,24 hrs.,stocks,CSPR,6,6,0,6,1,1,0,1,NYSE
5128,16-02-2021 08:00,24 hrs.,stocks,DASH,68,0,68,-68,1,3,58,1,NYSE
5128,16-02-2021 08:00,24 hrs.,stocks,PLTR,103,0,103,-103,3,11,69,3,NYSE
5128,16-02-2021 08:00,24 hrs.,stocks,SNAP,436,0,436,-436,1,149,134,1,NYSE
5128,16-02-2021 08:00,24 hrs.,stocks,SPCE,153,153,0,153,3,58,25,2,NYSE
5128,16-02-2021 08:00,24 hrs.,stocks,AMD,12,0,12,-12,2,2,0,2,NASDAQ
5128,16-02-2021 08:00,24 hrs.,stocks,CDK,133,0,133,-133,1,49,31,1,NASDAQ
5128,16-02-2021 08:00,24 hrs.,stocks,CFO,155,0,155,-155,2,54,39,2,NASDAQ
5128,16-02-2021 08:00,24 hrs.,stocks,CGC,30,30,0,30,1,10,6,1,NASDAQ
5128,16-02-2021 08:00,24 hrs.,stocks,ESG,17,17,0,17,1,5,3,1,NASDAQ
5128,16-02-2021 08:00,24 hrs.,stocks,FTC,30,30,0,30,1,10,6,1,NASDAQ
5128,16-02-2021 08:00,24 hrs.,stocks,HAS,6,6,0,6,1,1,0,1,NASDAQ
5128,16-02-2021 08:00,24 hrs.,stocks,III,133,0,133,-133,1,49,31,1,NASDAQ
5128,16-02-2021 08:00,24 hrs.,stocks,QQQ,38,38,0,38,1,6,22,1,NASDAQ
5128,16-02-2021 08:00,24 hrs.,stocks,SFT,6,6,0,6,1,1,0,1,NASDAQ
5128,16-02-2021 08:00,24 hrs.,stocks,AAPL,429,221,208,13,3,115,187,3,NASDAQ
5128,16-02-2021 08:00,24 hrs.,stocks,ABNB,68,0,68,-68,1,3,58,1,NASDAQ
5128,16-02-2021 08:00,24 hrs.,stocks,AKTS,118,118,0,118,1,53,8,1,NASDAQ
5128,16-02-2021 08:00,24 hrs.,stocks,ALSK,6,6,0,6,1,1,0,1,NASDAQ
5128,16-02-2021 08:00,24 hrs.,stocks,AMCA,30,30,0,30,1,10,6,1,NASDAQ
5128,16-02-2021 08:00,24 hrs.,stocks,AMZN,208,0,208,-208,1,46,112,1,NASDAQ
5128,16-02-2021 08:00,24 hrs.,stocks,APHA,63,63,0,63,2,13,29,2,NASDAQ
5128,16-02-2021 08:00,24 hrs.,stocks,ARDX,118,118,0,118,1,53,8,1,NASDAQ
5128,16-02-2021 08:00,24 hrs.,stocks,ARTL,6,6,0,6,1,1,0,1,NASDAQ
5128,16-02-2021 08:00,24 hrs.,stocks,ATVI,29,0,29,-29,1,7,11,1,NASDAQ
5128,16-02-2021 08:00,24 hrs.,stocks,AUPH,14,0,14,-14,1,3,4,1,NASDAQ
5128,16-02-2021 08:00,24 hrs.,stocks,BNGO,6,6,0,6,1,1,0,1,NASDAQ
5128,16-02-2021 08:00,24 hrs.,stocks,CHKP,12,12,0,12,2,2,0,1,NASDAQ
5128,16-02-2021 08:00,24 hrs.,stocks,CIBR,71,71,0,71,1,19,29,1,NASDAQ
5128,16-02-2021 08:00,24 hrs.,Daytrading,GOGO,42,0,42,-42,1,16,6,1,NASDAQ
5128,16-02-2021 08:00,24 hrs.,Daytrading,IBKR,21,0,21,-21,1,3,11,1,NASDAQ
5128,16-02-2021 08:00,24 hrs.,Daytrading,LOAC,6,6,0,6,1,1,0,1,NASDAQ
5128,16-02-2021 08:00,24 hrs.,Daytrading,MARA,6,6,0,6,1,1,0,1,NASDAQ
5128,16-02-2021 08:00,24 hrs.,Daytrading,PATI,42,0,42,-42,1,16,6,1,NASDAQ
5128,16-02-2021 08:00,24 hrs.,Daytrading,PAYS,6,6,0,6,1,1,0,1,NASDAQ
5128,16-02-2021 08:00,24 hrs.,Daytrading,PBTS,42,0,42,-42,1,16,6,1,NASDAQ
5128,16-02-2021 08:00,24 hrs.,Daytrading,RIOT,6,6,0,6,1,1,0,1,NASDAQ
5128,16-02-2021 08:00,24 hrs.,Daytrading,SAVA,6,0,6,-6,1,1,0,1,NASDAQ
5128,16-02-2021 08:00,24 hrs.,Daytrading,SNDL,12,6,6,0,2,2,0,2,NASDAQ
5128,16-02-2021 08:00,24 hrs.,Daytrading,SSKN,42,0,42,-42,1,16,6,1,NASDAQ
5128,16-02-2021 08:00,24 hrs.,Daytrading,TLRY,47,0,47,-47,1,15,13,1,NASDAQ
5128,16-02-2021 08:00,24 hrs.,Daytrading,TNXP,72,0,72,-72,1,30,8,1,NASDAQ
5128,16-02-2021 08:00,24 hrs.,Daytrading,TOPS,42,0,42,-42,1,16,6,1,NASDAQ
5128,16-02-2021 08:00,24 hrs.,Daytrading,TWIN,42,0,42,-42,1,16,6,1,NASDAQ
5128,16-02-2021 08:00,24 hrs.,trakstocks,ABML,22,22,0,22,1,5,8,1,OTC
5128,16-02-2021 08:00,24 hrs.,trakstocks,BOTH,54,54,0,54,2,20,6,1,OTC
5128,16-02-2021 08:00,24 hrs.,trakstocks,COMS,86,86,0,86,1,27,28,1,OTC
5128,16-02-2021 08:00,24 hrs.,trakstocks,EMBI,8,8,0,8,1,2,0,1,OTC
5128,16-02-2021 08:00,24 hrs.,trakstocks,GMEV,14,14,0,14,1,5,0,1,OTC
5128,16-02-2021 08:00,24 hrs.,trakstocks,MOST,6,6,0,6,1,1,0,1,OTC
5128,16-02-2021 08:00,24 hrs.,trakstocks,NOUV,6,6,0,6,1,1,0,1,OTC
5128,16-02-2021 08:00,24 hrs.,trakstocks,OPTI,14,14,0,14,1,5,0,1,OTC
5128,16-02-2021 08:00,24 hrs.,trakstocks,SNPW,25,25,0,25,1,10,1,1,OTC
5128,16-02-2021 08:00,24 hrs.,trakstocks,SSFT,8,0,8,-8,1,0,4,1,OTC
5128,16-02-2021 08:00,24 hrs.,trakstocks,ARBKF,6,6,0,6,1,1,0,1,OTC
5128,16-02-2021 08:00,24 hrs.,trakstocks,FUNFF,12,12,0,12,2,2,0,2,OTC
5128,16-02-2021 08:00,24 hrs.,trakstocks,SENS,200,0,200,-200,1,82,32,1,AMEX
5128,16-02-2021 08:00,24 hrs.,trakstocks,MEG,18,0,18,-18,1,6,2,1,NYSE
5128,16-02-2021 08:00,24 hrs.,trakstocks,THC,8,8,0,8,1,2,0,1,NYSE
5128,16-02-2021 08:00,24 hrs.,trakstocks,ALLY,18,0,18,-18,1,6,2,1,NYSE
5128,16-02-2021 08:00,24 hrs.,trakstocks,ARGO,6,6,0,6,1,1,0,1,NYSE
5128,16-02-2021 08:00,24 hrs.,trakstocks,CSPR,21,0,21,-21,1,6,5,1,NYSE
5128,16-02-2021 08:00,24 hrs.,trakstocks,SKLZ,33,0,33,-33,1,12,5,1,NYSE
5128,16-02-2021 08:00,24 hrs.,trakstocks,AGNC,14,0,14,-14,1,1,8,1,NASDAQ
5128,16-02-2021 08:00,24 hrs.,trakstocks,ALOT,6,0,6,-6,1,1,0,1,NASDAQ
5128,16-02-2021 08:00,24 hrs.,trakstocks,ASRT,125,0,125,-125,1,58,5,1,NASDAQ
5128,16-02-2021 08:00,24 hrs.,trakstocks,ATOS,32,32,0,32,1,11,6,1,NASDAQ
5128,16-02-2021 08:00,24 hrs.,trakstocks,AYRO,12,12,0,12,1,3,2,1,NASDAQ
5128,16-02-2021 08:00,24 hrs.,trakstocks,BXRX,33,33,0,33,1,13,3,1,NASDAQ
5128,16-02-2021 08:00,24 hrs.,trakstocks,CACC,18,0,18,-18,1,6,2,1,NASDAQ
5128,16-02-2021 08:00,24 hrs.,trakstocks,CGIX,10,0,10,-10,1,2,2,1,NASDAQ
5128,16-02-2021 08:00,24 hrs.,trakstocks,CIDM,18,18,0,18,1,5,4,1,NASDAQ
5128,16-02-2021 08:00,24 hrs.,trakstocks,CTRM,29,0,29,-29,1,11,3,1,NASDAQ
5128,16-02-2021 08:00,24 hrs.,stocks,LOAC,6,6,0,6,1,1,0,1,NASDAQ
5128,16-02-2021 08:00,24 hrs.,stocks,MBII,6,0,6,-6,1,1,0,1,NASDAQ
5128,16-02-2021 08:00,24 hrs.,stocks,MSFT,59,0,59,-59,1,14,27,1,NASDAQ
5128,16-02-2021 08:00,24 hrs.,stocks,NDAQ,17,17,0,17,1,5,3,1,NASDAQ
5128,16-02-2021 08:00,24 hrs.,stocks,NNDM,12,0,12,-12,2,2,0,2,NASDAQ
5128,16-02-2021 08:00,24 hrs.,stocks,OLLI,21,21,0,21,1,5,7,1,NASDAQ
5128,16-02-2021 08:00,24 hrs.,stocks,OTLK,6,0,6,-6,1,1,0,1,NASDAQ
5128,16-02-2021 08:00,24 hrs.,stocks,PAVM,6,6,0,6,1,1,0,1,NASDAQ
5128,16-02-2021 08:00,24 hrs.,stocks,PENN,13,0,13,-13,1,1,7,1,NASDAQ
5128,16-02-2021 08:00,24 hrs.,stocks,PERI,6,6,0,6,1,1,0,1,NASDAQ
5128,16-02-2021 08:00,24 hrs.,stocks,PLUG,6,6,0,6,1,1,0,1,NASDAQ
5128,16-02-2021 08:00,24 hrs.,stocks,PYPL,464,0,464,-464,2,117,222,2,NASDAQ
5128,16-02-2021 08:00,24 hrs.,stocks,QQQM,38,38,0,38,1,6,22,1,NASDAQ
5128,16-02-2021 08:00,24 hrs.,stocks,RIDE,7,0,7,-7,1,1,1,1,NASDAQ
5128,16-02-2021 08:00,24 hrs.,stocks,ROKU,436,0,436,-436,1,149,134,1,NASDAQ
5128,16-02-2021 08:00,24 hrs.,stocks,RRGB,10,10,0,10,1,2,2,1,NASDAQ
5128,16-02-2021 08:00,24 hrs.,stocks,SEER,6,6,0,6,1,1,0,1,NASDAQ
5128,16-02-2021 08:00,24 hrs.,stocks,SNDL,18,12,6,6,3,3,0,3,NASDAQ
5128,16-02-2021 08:00,24 hrs.,stocks,SONO,6,6,0,6,1,1,0,1,NASDAQ
5128,16-02-2021 08:00,24 hrs.,stocks,SRNE,6,6,0,6,1,1,0,1,NASDAQ
5128,16-02-2021 08:00,24 hrs.,StockMarket,ADBE,32,0,32,-32,1,14,0,1,NASDAQ
5128,16-02-2021 08:00,24 hrs.,StockMarket,AMZN,32,0,32,-32,1,14,0,1,NASDAQ
5128,16-02-2021 08:00,24 hrs.,StockMarket,ANTE,8,0,8,-8,1,2,0,1,NASDAQ
5128,16-02-2021 08:00,24 hrs.,StockMarket,ATOS,6,0,6,-6,1,1,0,1,NASDAQ
5128,16-02-2021 08:00,24 hrs.,StockMarket,BNGO,6,6,0,6,1,1,0,1,NASDAQ
5128,16-02-2021 08:00,24 hrs.,StockMarket,CMPS,6,0,6,-6,1,1,0,1,NASDAQ
5128,16-02-2021 08:00,24 hrs.,StockMarket,CRSR,45,45,0,45,1,10,21,1,NASDAQ
5128,16-02-2021 08:00,24 hrs.,StockMarket,CTRM,7,7,0,7,1,1,1,1,NASDAQ
5128,16-02-2021 08:00,24 hrs.,StockMarket,EXPI,31,31,0,31,1,4,19,1,NASDAQ
5128,16-02-2021 08:00,24 hrs.,trakstocks,EVFM,20,20,0,20,1,6,4,1,NASDAQ
5128,16-02-2021 08:00,24 hrs.,trakstocks,EXPC,5,5,0,5,1,0,1,1,NASDAQ
5128,16-02-2021 08:00,24 hrs.,trakstocks,FIII,53,47,6,41,2,20,5,2,NASDAQ
5128,16-02-2021 08:00,24 hrs.,trakstocks,GMBL,7,7,0,7,1,1,1,1,NASDAQ
5128,16-02-2021 08:00,24 hrs.,trakstocks,IDEX,41,23,18,5,2,12,9,2,NASDAQ
5128,16-02-2021 08:00,24 hrs.,trakstocks,INPX,18,18,0,18,1,6,2,1,NASDAQ
5128,16-02-2021 08:00,24 hrs.,trakstocks,KIDS,17,17,0,17,2,1,7,2,NASDAQ
5128,16-02-2021 08:00,24 hrs.,trakstocks,LOAC,9,9,0,9,1,2,1,1,NASDAQ
5128,16-02-2021 08:00,24 hrs.,trakstocks,MARA,6,0,6,-6,1,1,0,1,NASDAQ
5128,16-02-2021 08:00,24 hrs.,trakstocks,MVIS,148,131,17,114,2,61,18,2,NASDAQ
5128,16-02-2021 08:00,24 hrs.,trakstocks,OBSV,12,12,0,12,1,4,0,1,NASDAQ
5128,16-02-2021 08:00,24 hrs.,trakstocks,RNET,12,12,0,12,1,3,2,1,NASDAQ
5128,16-02-2021 08:00,24 hrs.,trakstocks,SELB,37,0,37,-37,1,12,9,1,NASDAQ
5128,16-02-2021 08:00,24 hrs.,trakstocks,SNDL,69,69,0,69,3,24,9,2,NASDAQ
5128,16-02-2021 08:00,24 hrs.,trakstocks,THMO,6,6,0,6,1,0,2,1,NASDAQ
5128,16-02-2021 08:00,24 hrs.,trakstocks,TNXP,33,33,0,33,1,13,3,1,NASDAQ
5128,16-02-2021 08:00,24 hrs.,trakstocks,TRCH,144,144,0,144,4,45,38,4,NASDAQ
5128,16-02-2021 08:00,24 hrs.,trakstocks,TRIT,68,0,68,-68,2,23,14,2,NASDAQ
5128,16-02-2021 08:00,24 hrs.,trakstocks,TTOO,32,0,32,-32,1,12,4,1,NASDAQ
5128,16-02-2021 08:00,24 hrs.,StockMarket,ALYI,7,7,0,7,1,1,1,1,OTC
5128,16-02-2021 08:00,24 hrs.,StockMarket,BOTH,109,109,0,109,1,40,25,1,OTC
5128,16-02-2021 08:00,24 hrs.,StockMarket,GMEV,6,6,0,6,1,1,0,1,OTC
5128,16-02-2021 08:00,24 hrs.,StockMarket,HCMC,6,0,6,-6,1,1,0,1,OTC
5128,16-02-2021 08:00,24 hrs.,StockMarket,PHIL,12,12,0,12,1,3,2,1,OTC
5128,16-02-2021 08:00,24 hrs.,StockMarket,RCHA,6,0,6,-6,1,1,0,1,OTC
5128,16-02-2021 08:00,24 hrs.,StockMarket,SGMD,6,0,6,-6,1,1,0,1,OTC
5128,16-02-2021 08:00,24 hrs.,StockMarket,TGGI,17,0,17,-17,1,3,7,1,OTC
5128,16-02-2021 08:00,24 hrs.,StockMarket,HVBTF,6,6,0,6,1,1,0,1,OTC
5128,16-02-2021 08:00,24 hrs.,StockMarket,LUKOY,18,18,0,18,1,4,6,1,OTC
5128,16-02-2021 08:00,24 hrs.,StockMarket,MMNFF,6,6,0,6,1,1,0,1,OTC
5128,16-02-2021 08:00,24 hrs.,StockMarket,NILSY,18,18,0,18,1,4,6,1,OTC
5128,16-02-2021 08:00,24 hrs.,StockMarket,NXTTF,10,0,10,-10,1,1,4,1,OTC
5128,16-02-2021 08:00,24 hrs.,StockMarket,OGZPY,18,18,0,18,1,4,6,1,OTC
5128,16-02-2021 08:00,24 hrs.,StockMarket,PYRNF,6,6,0,6,1,1,0,1,OTC
5128,16-02-2021 08:00,24 hrs.,StockMarket,DNN,18,18,0,18,1,4,6,1,AMEX
5128,16-02-2021 08:00,24 hrs.,StockMarket,DPW,6,0,6,-6,1,1,0,1,AMEX
5128,16-02-2021 08:00,24 hrs.,StockMarket,ITP,40,0,40,-40,1,15,6,1,AMEX
5128,16-02-2021 08:00,24 hrs.,StockMarket,MAG,18,18,0,18,1,4,6,1,AMEX
5128,16-02-2021 08:00,24 hrs.,StockMarket,URG,18,18,0,18,1,4,6,1,AMEX
5128,16-02-2021 08:00,24 hrs.,StockMarket,UUUU,18,18,0,18,1,4,6,1,AMEX
5128,16-02-2021 08:00,24 hrs.,StockMarket,AMC,404,290,114,176,4,167,54,4,NYSE
5128,16-02-2021 08:00,24 hrs.,Daytrading,SOS,6,6,0,6,1,1,0,1,NYSE
5128,16-02-2021 08:00,24 hrs.,Daytrading,TDA,23,0,23,-23,1,5,9,1,NYSE
5128,16-02-2021 08:00,24 hrs.,Daytrading,WWW,6,6,0,6,1,1,0,1,NYSE
5128,16-02-2021 08:00,24 hrs.,Daytrading,FUBO,47,0,47,-47,1,15,13,1,NYSE
5128,16-02-2021 08:00,24 hrs.,Daytrading,HEXO,47,0,47,-47,1,15,13,1,NYSE
5128,16-02-2021 08:00,24 hrs.,Daytrading,PLTR,47,0,47,-47,1,15,13,1,NYSE
5128,16-02-2021 08:00,24 hrs.,Daytrading,TALO,6,6,0,6,1,1,0,1,NYSE
5128,16-02-2021 08:00,24 hrs.,Daytrading,API,11,0,11,-11,1,3,1,1,NASDAQ
5128,16-02-2021 08:00,24 hrs.,Daytrading,AOSL,47,0,47,-47,1,15,13,1,NASDAQ
5128,16-02-2021 08:00,24 hrs.,Daytrading,APHA,47,0,47,-47,1,15,13,1,NASDAQ
5128,16-02-2021 08:00,24 hrs.,Daytrading,CASH,16,16,0,16,1,3,6,1,NASDAQ
5128,16-02-2021 08:00,24 hrs.,Daytrading,CROX,47,0,47,-47,1,15,13,1,NASDAQ
5128,16-02-2021 08:00,24 hrs.,Daytrading,DKNG,47,0,47,-47,1,15,13,1,NASDAQ
5128,16-02-2021 08:00,24 hrs.,Daytrading,FORD,42,0,42,-42,1,16,6,1,NASDAQ
5128,16-02-2021 08:00,24 hrs.,pennystocks,ABQQ,25,25,0,25,2,6,5,1,OTC
5128,16-02-2021 08:00,24 hrs.,pennystocks,ABWN,7,7,0,7,1,1,1,1,OTC
5128,16-02-2021 08:00,24 hrs.,pennystocks,AGYP,9,0,9,-9,1,2,1,1,OTC
5128,16-02-2021 08:00,24 hrs.,pennystocks,AITX,592,232,360,-128,11,220,108,9,OTC
5128,16-02-2021 08:00,24 hrs.,pennystocks,ALPP,31,0,31,-31,2,9,5,2,OTC
5128,16-02-2021 08:00,24 hrs.,pennystocks,ALYI,85,38,47,-9,2,20,37,2,OTC
5128,16-02-2021 08:00,24 hrs.,pennystocks,APYP,19,19,0,19,3,3,1,1,OTC
5128,16-02-2021 08:00,24 hrs.,pennystocks,ASTI,113,68,45,23,4,22,53,4,OTC
5128,16-02-2021 08:00,24 hrs.,pennystocks,BANT,6,0,6,-6,1,1,0,1,OTC
5128,16-02-2021 08:00,24 hrs.,pennystocks,BBRW,68,62,6,56,2,15,30,2,OTC
5128,16-02-2021 08:00,24 hrs.,pennystocks,BCAP,12,0,12,-12,2,2,0,1,OTC
5128,16-02-2021 08:00,24 hrs.,pennystocks,BIEL,6,0,6,-6,1,1,0,1,OTC
5128,16-02-2021 08:00,24 hrs.,pennystocks,BLSP,7,0,7,-7,1,1,1,1,OTC
5128,16-02-2021 08:00,24 hrs.,pennystocks,BNGI,6,6,0,6,1,1,0,1,OTC
5128,16-02-2021 08:00,24 hrs.,pennystocks,BOTH,18,18,0,18,3,3,0,2,OTC
5128,16-02-2021 08:00,24 hrs.,pennystocks,BOTY,14,7,7,0,2,2,2,2,OTC
5128,16-02-2021 08:00,24 hrs.,pennystocks,BRRN,19,19,0,19,3,3,1,2,OTC
5128,16-02-2021 08:00,24 hrs.,pennystocks,BYOC,20,0,20,-20,1,4,8,1,OTC
5128,16-02-2021 08:00,24 hrs.,pennystocks,CBBT,998,123,875,-752,7,338,294,6,OTC
5128,16-02-2021 08:00,24 hrs.,pennystocks,CBDL,12,6,6,0,2,2,0,2,OTC
5128,16-02-2021 08:00,24 hrs.,pennystocks,CCTL,6,0,6,-6,1,1,0,1,OTC
5128,16-02-2021 08:00,24 hrs.,pennystocks,CEOS,363,0,363,-363,1,101,157,1,OTC
5128,16-02-2021 08:00,24 hrs.,pennystocks,CYDY,7,0,7,-7,1,1,1,1,OTC
5128,16-02-2021 08:00,24 hrs.,pennystocks,DPLS,7,0,7,-7,1,1,1,1,OTC
5128,16-02-2021 08:00,24 hrs.,pennystocks,ECEZ,363,0,363,-363,1,101,157,1,OTC
5128,16-02-2021 08:00,24 hrs.,StockMarket,ASX,11,11,0,11,1,3,1,1,NYSE
5128,16-02-2021 08:00,24 hrs.,StockMarket,AZZ,18,18,0,18,1,4,6,1,NYSE
5128,16-02-2021 08:00,24 hrs.,StockMarket,BDJ,17,0,17,-17,1,5,3,1,NYSE
5128,16-02-2021 08:00,24 hrs.,StockMarket,BOE,18,18,0,18,1,4,6,1,NYSE
5128,16-02-2021 08:00,24 hrs.,StockMarket,BTU,18,18,0,18,1,4,6,1,NYSE
5128,16-02-2021 08:00,24 hrs.,StockMarket,CCO,18,18,0,18,1,4,6,1,NYSE
5128,16-02-2021 08:00,24 hrs.,StockMarket,DHI,32,0,32,-32,1,14,0,1,NYSE
5128,16-02-2021 08:00,24 hrs.,StockMarket,ELY,32,32,0,32,1,11,6,1,NYSE
5128,16-02-2021 08:00,24 hrs.,StockMarket,EXK,18,18,0,18,1,4,6,1,NYSE
5128,16-02-2021 08:00,24 hrs.,StockMarket,GME,3190,3069,121,2948,9,1463,228,9,NYSE
5128,16-02-2021 08:00,24 hrs.,StockMarket,GPN,32,0,32,-32,1,14,0,1,NYSE
5128,16-02-2021 08:00,24 hrs.,StockMarket,HCC,18,18,0,18,1,4,6,1,NYSE
5128,16-02-2021 08:00,24 hrs.,StockMarket,ICE,58,18,40,-22,2,19,12,2,NYSE
5128,16-02-2021 08:00,24 hrs.,StockMarket,MAC,6,0,6,-6,1,1,0,1,NYSE
5128,16-02-2021 08:00,24 hrs.,StockMarket,NIO,43,0,43,-43,1,17,5,1,NYSE
5128,16-02-2021 08:00,24 hrs.,StockMarket,OMF,32,0,32,-32,1,14,0,1,NYSE
5128,16-02-2021 08:00,24 hrs.,StockMarket,PHI,12,12,0,12,1,3,2,1,NYSE
5128,16-02-2021 08:00,24 hrs.,StockMarket,PSX,32,0,32,-32,1,14,0,1,NYSE
5128,16-02-2021 08:00,24 hrs.,StockMarket,RSI,12,12,0,12,1,3,2,1,NYSE
5128,16-02-2021 08:00,24 hrs.,StockMarket,SLB,18,18,0,18,1,4,6,1,NYSE
5128,16-02-2021 08:00,24 hrs.,StockMarket,SOS,27,21,6,15,2,5,9,2,NYSE
5128,16-02-2021 08:00,24 hrs.,StockMarket,ALLY,32,0,32,-32,1,14,0,1,NYSE
5128,16-02-2021 08:00,24 hrs.,StockMarket,CCIV,51,39,12,27,4,11,13,4,NYSE
5128,16-02-2021 08:00,24 hrs.,StockMarket,COTY,18,6,12,-6,3,3,0,3,NYSE
5128,16-02-2021 08:00,24 hrs.,StockMarket,HUYA,6,0,6,-6,1,1,0,1,NYSE
5128,16-02-2021 08:00,24 hrs.,StockMarket,MSCI,10,0,10,-10,1,0,6,1,NYSE
5128,16-02-2021 08:00,24 hrs.,StockMarket,PGRE,12,12,0,12,1,2,4,1,NYSE
5128,16-02-2021 08:00,24 hrs.,StockMarket,SHOP,31,31,0,31,1,7,13,1,NYSE
5128,16-02-2021 08:00,24 hrs.,StockMarket,TALO,6,6,0,6,1,1,0,1,NYSE
5128,16-02-2021 08:00,24 hrs.,StockMarket,TECK,18,18,0,18,1,4,6,1,NYSE
5128,16-02-2021 08:00,24 hrs.,StockMarket,TWLO,32,0,32,-32,1,14,0,1,NYSE
5128,16-02-2021 08:00,24 hrs.,StockMarket,VALE,18,18,0,18,1,4,6,1,NYSE
5128,16-02-2021 08:00,24 hrs.,StockMarket,WORK,7,0,7,-7,1,0,3,1,NYSE
5128,16-02-2021 08:00,24 hrs.,StockMarket,ALT,6,6,0,6,1,1,0,1,NASDAQ
5128,16-02-2021 08:00,24 hrs.,StockMarket,API,18,18,0,18,1,4,6,1,NASDAQ
5128,16-02-2021 08:00,24 hrs.,StockMarket,ESG,18,18,0,18,1,4,6,1,NASDAQ
5128,16-02-2021 08:00,24 hrs.,StockMarket,FAT,12,0,12,-12,2,2,0,2,NASDAQ
5128,16-02-2021 08:00,24 hrs.,StockMarket,HAS,11,11,0,11,1,3,1,1,NASDAQ
5128,16-02-2021 08:00,24 hrs.,StockMarket,PLL,11,11,0,11,1,3,1,1,NASDAQ
5128,16-02-2021 08:00,24 hrs.,pennystocks,ENZC,6,6,0,6,1,1,0,1,OTC
5128,16-02-2021 08:00,24 hrs.,pennystocks,ERBB,62,62,0,62,1,14,30,1,OTC
5128,16-02-2021 08:00,24 hrs.,pennystocks,ETFM,483,189,294,-105,8,175,101,5,OTC
5128,16-02-2021 08:00,24 hrs.,pennystocks,FDMF,6,6,0,6,1,1,0,1,OTC
5128,16-02-2021 08:00,24 hrs.,pennystocks,FLES,26,26,0,26,2,1,16,2,OTC
5128,16-02-2021 08:00,24 hrs.,pennystocks,GAHC,39,39,0,39,1,7,21,1,OTC
5128,16-02-2021 08:00,24 hrs.,pennystocks,GARB,7,7,0,7,1,1,1,1,OTC
5128,16-02-2021 08:00,24 hrs.,pennystocks,GAXY,25,25,0,25,1,5,11,1,OTC
5128,16-02-2021 08:00,24 hrs.,pennystocks,GCEH,65,65,0,65,1,25,11,1,OTC
5128,16-02-2021 08:00,24 hrs.,pennystocks,GPFT,6,6,0,6,1,1,0,1,OTC
5128,16-02-2021 08:00,24 hrs.,pennystocks,GRNH,62,62,0,62,1,14,30,1,OTC
5128,16-02-2021 08:00,24 hrs.,pennystocks,GTLL,58,51,7,44,3,19,8,3,OTC
5128,16-02-2021 08:00,24 hrs.,pennystocks,GTXO,16,16,0,16,1,3,6,1,OTC
5128,16-02-2021 08:00,24 hrs.,pennystocks,HALB,40,40,0,40,1,14,8,1,OTC
5128,16-02-2021 08:00,24 hrs.,pennystocks,HCMC,12,6,6,0,2,2,0,2,OTC
5128,16-02-2021 08:00,24 hrs.,pennystocks,HEMP,7,7,0,7,1,1,1,1,OTC
5128,16-02-2021 08:00,24 hrs.,pennystocks,HPNN,7,7,0,7,1,1,1,1,OTC
5128,16-02-2021 08:00,24 hrs.,pennystocks,HQGE,7,0,7,-7,1,1,1,1,OTC
5128,16-02-2021 08:00,24 hrs.,pennystocks,IJJP,13,13,0,13,2,2,1,1,OTC
5128,16-02-2021 08:00,24 hrs.,pennystocks,INKW,7,7,0,7,1,1,1,1,OTC
5128,16-02-2021 08:00,24 hrs.,pennystocks,INND,113,113,0,113,2,28,49,2,OTC
5128,16-02-2021 08:00,24 hrs.,pennystocks,IQST,47,47,0,47,1,10,23,1,OTC
5128,16-02-2021 08:00,24 hrs.,pennystocks,KOAN,4,0,4,-4,1,0,0,1,OTC
5128,16-02-2021 08:00,24 hrs.,pennystocks,KOSK,15,15,0,15,1,4,3,1,OTC
5128,16-02-2021 08:00,24 hrs.,pennystocks,KULR,35,0,35,-35,1,12,7,1,OTC
5128,16-02-2021 08:00,24 hrs.,pennystocks,KWBT,24,0,24,-24,1,8,4,1,OTC
5128,16-02-2021 08:00,24 hrs.,pennystocks,LLBO,13,0,13,-13,2,2,1,1,OTC
5128,16-02-2021 08:00,24 hrs.,pennystocks,LQMT,6,0,6,-6,1,1,0,1,OTC
5128,16-02-2021 08:00,24 hrs.,pennystocks,MCOA,62,62,0,62,1,14,30,1,OTC
5128,16-02-2021 08:00,24 hrs.,pennystocks,MJNA,21,21,0,21,3,3,3,1,OTC
5128,16-02-2021 08:00,24 hrs.,pennystocks,MMEX,37,37,0,37,1,5,23,1,OTC
5128,16-02-2021 08:00,24 hrs.,pennystocks,NOVC,72,72,0,72,5,24,4,2,OTC
5128,16-02-2021 08:00,24 hrs.,pennystocks,OPTI,6,0,6,-6,1,1,0,1,OTC
5128,16-02-2021 08:00,24 hrs.,pennystocks,OZSC,7,7,0,7,1,1,1,1,OTC
5128,16-02-2021 08:00,24 hrs.,pennystocks,PBHG,6,6,0,6,1,1,0,1,OTC
5128,16-02-2021 08:00,24 hrs.,pennystocks,PGAS,18,0,18,-18,3,3,0,2,OTC
5128,16-02-2021 08:00,24 hrs.,pennystocks,PHIL,6,6,0,6,1,1,0,1,OTC
5128,16-02-2021 08:00,24 hrs.,pennystocks,PUGE,51,0,51,-51,1,15,17,1,OTC
5128,16-02-2021 08:00,24 hrs.,StockMarket,FIII,18,18,0,18,1,4,6,1,NASDAQ
5128,16-02-2021 08:00,24 hrs.,StockMarket,FSLR,18,18,0,18,1,4,6,1,NASDAQ
5128,16-02-2021 08:00,24 hrs.,StockMarket,GILD,14,0,14,-14,1,1,8,1,NASDAQ
5128,16-02-2021 08:00,24 hrs.,StockMarket,GILT,6,6,0,6,1,1,0,1,NASDAQ
5128,16-02-2021 08:00,24 hrs.,StockMarket,GTHX,86,12,74,-62,3,24,26,2,NASDAQ
5128,16-02-2021 08:00,24 hrs.,StockMarket,IMVT,32,0,32,-32,1,14,0,1,NASDAQ
5128,16-02-2021 08:00,24 hrs.,StockMarket,INVE,6,0,6,-6,1,1,0,1,NASDAQ
5128,16-02-2021 08:00,24 hrs.,StockMarket,JACK,6,0,6,-6,1,1,0,1,NASDAQ
5128,16-02-2021 08:00,24 hrs.,StockMarket,LOAC,6,6,0,6,1,1,0,1,NASDAQ
5128,16-02-2021 08:00,24 hrs.,StockMarket,MVIS,65,59,6,53,2,23,11,2,NASDAQ
5128,16-02-2021 08:00,24 hrs.,StockMarket,NAKD,6,0,6,-6,1,1,0,1,NASDAQ
5128,16-02-2021 08:00,24 hrs.,StockMarket,OTLK,12,6,6,0,2,2,0,2,NASDAQ
5128,16-02-2021 08:00,24 hrs.,StockMarket,PAAS,18,18,0,18,1,4,6,1,NASDAQ
5128,16-02-2021 08:00,24 hrs.,StockMarket,PLUG,6,6,0,6,1,1,0,1,NASDAQ
5128,16-02-2021 08:00,24 hrs.,StockMarket,POWW,80,0,80,-80,1,27,22,1,NASDAQ
5128,16-02-2021 08:00,24 hrs.,StockMarket,PTGX,4,0,4,-4,1,0,0,1,NASDAQ
5128,16-02-2021 08:00,24 hrs.,StockMarket,PYPL,6,6,0,6,1,1,0,1,NASDAQ
5128,16-02-2021 08:00,24 hrs.,StockMarket,SNDL,115,109,6,103,2,41,25,2,NASDAQ
5128,16-02-2021 08:00,24 hrs.,StockMarket,SRNE,4,0,4,-4,1,0,0,1,NASDAQ
5128,16-02-2021 08:00,24 hrs.,StockMarket,SSPK,22,22,0,22,1,7,4,1,NASDAQ
5128,16-02-2021 08:00,24 hrs.,StockMarket,THMO,17,17,0,17,1,0,13,1,NASDAQ
5128,16-02-2021 08:00,24 hrs.,StockMarket,TNXP,57,0,57,-57,1,21,11,1,NASDAQ
5128,16-02-2021 08:00,24 hrs.,StockMarket,TSLA,29,29,0,29,2,7,7,2,NASDAQ
5128,16-02-2021 08:00,24 hrs.,StockMarket,VIAC,12,12,0,12,1,2,4,1,NASDAQ
5128,16-02-2021 08:00,24 hrs.,pennystocks,AABB,6,0,6,-6,1,1,0,1,OTC
5128,16-02-2021 08:00,24 hrs.,pennystocks,ABML,84,0,84,-84,1,33,14,1,OTC
5116,16-02-2021 06:00,24 hrs.,StockMarket,DHI,34,0,34,-34,1,15,0,1,NYSE
5116,16-02-2021 06:00,24 hrs.,StockMarket,ELY,30,30,0,30,1,10,6,1,NYSE
5116,16-02-2021 06:00,24 hrs.,StockMarket,EXK,19,19,0,19,1,6,3,1,NYSE
5116,16-02-2021 06:00,24 hrs.,StockMarket,GME,2367,2236,131,2105,9,1067,197,9,NYSE
5116,16-02-2021 06:00,24 hrs.,StockMarket,GPN,34,0,34,-34,1,15,0,1,NYSE
5116,16-02-2021 06:00,24 hrs.,StockMarket,HCC,19,19,0,19,1,6,3,1,NYSE
5116,16-02-2021 06:00,24 hrs.,StockMarket,ICE,61,19,42,-23,2,22,9,2,NYSE
5116,16-02-2021 06:00,24 hrs.,StockMarket,MAC,6,0,6,-6,1,1,0,1,NYSE
5116,16-02-2021 06:00,24 hrs.,StockMarket,NIO,41,0,41,-41,1,16,5,1,NYSE
5116,16-02-2021 06:00,24 hrs.,StockMarket,OMF,34,0,34,-34,1,15,0,1,NYSE
5116,16-02-2021 06:00,24 hrs.,StockMarket,PHI,31,12,19,-7,2,3,17,2,NYSE
5116,16-02-2021 06:00,24 hrs.,StockMarket,PSX,34,0,34,-34,1,15,0,1,NYSE
5116,16-02-2021 06:00,24 hrs.,StockMarket,RSI,12,12,0,12,1,3,2,1,NYSE
5116,16-02-2021 06:00,24 hrs.,StockMarket,SLB,19,19,0,19,1,6,3,1,NYSE
5116,16-02-2021 06:00,24 hrs.,StockMarket,SOS,27,27,0,27,2,5,9,2,NYSE
5116,16-02-2021 06:00,24 hrs.,StockMarket,ALLY,34,0,34,-34,1,15,0,1,NYSE
5116,16-02-2021 06:00,24 hrs.,StockMarket,CCIV,47,35,12,23,4,10,11,4,NYSE
5116,16-02-2021 06:00,24 hrs.,StockMarket,COTY,21,0,21,-21,3,2,5,2,NYSE
5116,16-02-2021 06:00,24 hrs.,StockMarket,HUYA,6,0,6,-6,1,1,0,1,NYSE
5116,16-02-2021 06:00,24 hrs.,StockMarket,MSCI,10,0,10,-10,1,0,6,1,NYSE
5116,16-02-2021 06:00,24 hrs.,StockMarket,PGRE,12,12,0,12,1,2,4,1,NYSE
5116,16-02-2021 06:00,24 hrs.,StockMarket,SHOP,29,29,0,29,1,6,13,1,NYSE
5116,16-02-2021 06:00,24 hrs.,StockMarket,TALO,6,6,0,6,1,1,0,1,NYSE
5116,16-02-2021 06:00,24 hrs.,StockMarket,TECK,19,19,0,19,1,6,3,1,NYSE
5116,16-02-2021 06:00,24 hrs.,StockMarket,TWLO,34,0,34,-34,1,15,0,1,NYSE
5116,16-02-2021 06:00,24 hrs.,StockMarket,VALE,19,19,0,19,1,6,3,1,NYSE
5116,16-02-2021 06:00,24 hrs.,StockMarket,WORK,7,0,7,-7,1,0,3,1,NYSE
5116,16-02-2021 06:00,24 hrs.,StockMarket,ALT,6,6,0,6,1,1,0,1,NASDAQ
5116,16-02-2021 06:00,24 hrs.,StockMarket,API,19,19,0,19,1,6,3,1,NASDAQ
5116,16-02-2021 06:00,24 hrs.,StockMarket,ESG,19,19,0,19,1,6,3,1,NASDAQ
5116,16-02-2021 06:00,24 hrs.,StockMarket,FAT,12,0,12,-12,2,2,0,2,NASDAQ
5116,16-02-2021 06:00,24 hrs.,StockMarket,HAS,6,6,0,6,1,1,0,1,NASDAQ
5116,16-02-2021 06:00,24 hrs.,trakstocks,AYRO,10,10,0,10,1,2,2,1,NASDAQ
5116,16-02-2021 06:00,24 hrs.,trakstocks,BXRX,25,25,0,25,1,9,3,1,NASDAQ
5116,16-02-2021 06:00,24 hrs.,trakstocks,CACC,18,18,0,18,1,6,2,1,NASDAQ
5116,16-02-2021 06:00,24 hrs.,trakstocks,CGIX,10,0,10,-10,1,2,2,1,NASDAQ
5116,16-02-2021 06:00,24 hrs.,trakstocks,CIDM,20,20,0,20,1,6,4,1,NASDAQ
5116,16-02-2021 06:00,24 hrs.,trakstocks,CTRM,27,0,27,-27,1,10,3,1,NASDAQ
5116,16-02-2021 06:00,24 hrs.,trakstocks,EVFM,22,22,0,22,1,7,4,1,NASDAQ
5116,16-02-2021 06:00,24 hrs.,trakstocks,EXPC,5,5,0,5,1,0,1,1,NASDAQ
5116,16-02-2021 06:00,24 hrs.,trakstocks,FIII,46,40,6,34,2,17,4,2,NASDAQ
5116,16-02-2021 06:00,24 hrs.,trakstocks,GMBL,7,7,0,7,1,1,1,1,NASDAQ
5116,16-02-2021 06:00,24 hrs.,trakstocks,IDEX,42,42,0,42,2,13,8,2,NASDAQ
5116,16-02-2021 06:00,24 hrs.,trakstocks,INPX,11,11,0,11,1,3,1,1,NASDAQ
5116,16-02-2021 06:00,24 hrs.,trakstocks,KIDS,17,17,0,17,2,1,7,2,NASDAQ
5116,16-02-2021 06:00,24 hrs.,trakstocks,LOAC,9,9,0,9,1,2,1,1,NASDAQ
5116,16-02-2021 06:00,24 hrs.,trakstocks,MARA,6,0,6,-6,1,1,0,1,NASDAQ
5116,16-02-2021 06:00,24 hrs.,trakstocks,MSFT,38,0,38,-38,1,8,18,1,NASDAQ
5116,16-02-2021 06:00,24 hrs.,trakstocks,MVIS,130,111,19,92,2,53,16,2,NASDAQ
5116,16-02-2021 06:00,24 hrs.,trakstocks,OBSV,12,12,0,12,1,4,0,1,NASDAQ
5116,16-02-2021 06:00,24 hrs.,trakstocks,RNET,10,10,0,10,1,2,2,1,NASDAQ
5116,16-02-2021 06:00,24 hrs.,trakstocks,SELB,33,0,33,-33,1,10,9,1,NASDAQ
5116,16-02-2021 06:00,24 hrs.,trakstocks,SNDL,62,62,0,62,3,21,8,2,NASDAQ
5116,16-02-2021 06:00,24 hrs.,trakstocks,THMO,6,6,0,6,1,0,2,1,NASDAQ
5116,16-02-2021 06:00,24 hrs.,trakstocks,TMUS,38,0,38,-38,1,8,18,1,NASDAQ
5116,16-02-2021 06:00,24 hrs.,StockMarket,EXPI,16,16,0,16,1,2,8,1,NASDAQ
5116,16-02-2021 06:00,24 hrs.,StockMarket,FIII,14,14,0,14,1,2,6,1,NASDAQ
5116,16-02-2021 06:00,24 hrs.,StockMarket,FSLR,19,19,0,19,1,6,3,1,NASDAQ
5116,16-02-2021 06:00,24 hrs.,StockMarket,GILD,13,13,0,13,1,1,7,1,NASDAQ
5116,16-02-2021 06:00,24 hrs.,StockMarket,GILT,6,6,0,6,1,1,0,1,NASDAQ
5116,16-02-2021 06:00,24 hrs.,StockMarket,GTHX,88,12,76,-64,3,25,26,2,NASDAQ
5116,16-02-2021 06:00,24 hrs.,StockMarket,IMVT,34,0,34,-34,1,15,0,1,NASDAQ
5116,16-02-2021 06:00,24 hrs.,StockMarket,INVE,6,0,6,-6,1,1,0,1,NASDAQ
5116,16-02-2021 06:00,24 hrs.,StockMarket,JACK,6,6,0,6,1,1,0,1,NASDAQ
5116,16-02-2021 06:00,24 hrs.,StockMarket,LOAC,6,6,0,6,1,1,0,1,NASDAQ
5116,16-02-2021 06:00,24 hrs.,StockMarket,MVIS,52,46,6,40,2,17,10,2,NASDAQ
5116,16-02-2021 06:00,24 hrs.,StockMarket,NAKD,6,0,6,-6,1,1,0,1,NASDAQ
5116,16-02-2021 06:00,24 hrs.,StockMarket,OTLK,12,6,6,0,2,2,0,2,NASDAQ
5116,16-02-2021 06:00,24 hrs.,StockMarket,PAAS,19,19,0,19,1,6,3,1,NASDAQ
5116,16-02-2021 06:00,24 hrs.,StockMarket,PLUG,6,6,0,6,1,1,0,1,NASDAQ
5116,16-02-2021 06:00,24 hrs.,StockMarket,POWW,84,0,84,-84,1,29,22,1,NASDAQ
5116,16-02-2021 06:00,24 hrs.,StockMarket,PTGX,4,0,4,-4,1,0,0,1,NASDAQ
5116,16-02-2021 06:00,24 hrs.,StockMarket,PYPL,6,6,0,6,1,1,0,1,NASDAQ
5116,16-02-2021 06:00,24 hrs.,StockMarket,SNDL,99,93,6,87,2,35,21,2,NASDAQ
5116,16-02-2021 06:00,24 hrs.,StockMarket,SRNE,4,0,4,-4,1,0,0,1,NASDAQ
5116,16-02-2021 06:00,24 hrs.,StockMarket,SSPK,16,16,0,16,1,6,0,1,NASDAQ
5116,16-02-2021 06:00,24 hrs.,StockMarket,THMO,17,17,0,17,1,0,13,1,NASDAQ
5116,16-02-2021 06:00,24 hrs.,StockMarket,TNXP,59,0,59,-59,1,22,11,1,NASDAQ
5116,16-02-2021 06:00,24 hrs.,StockMarket,TSLA,25,25,0,25,2,7,3,2,NASDAQ
5116,16-02-2021 06:00,24 hrs.,StockMarket,VIAC,12,12,0,12,1,2,4,1,NASDAQ
5116,16-02-2021 06:00,24 hrs.,pennystocks,AABB,6,0,6,-6,1,1,0,1,OTC
5116,16-02-2021 06:00,24 hrs.,pennystocks,ABML,101,83,18,65,4,36,13,2,OTC
5116,16-02-2021 06:00,24 hrs.,pennystocks,ABQQ,25,25,0,25,2,6,5,1,OTC
5116,16-02-2021 06:00,24 hrs.,pennystocks,ABWN,7,7,0,7,1,1,1,1,OTC
5116,16-02-2021 06:00,24 hrs.,pennystocks,AGYP,9,9,0,9,1,2,1,1,OTC
5116,16-02-2021 06:00,24 hrs.,StockMarket,PLL,6,6,0,6,1,1,0,1,NASDAQ
5116,16-02-2021 06:00,24 hrs.,StockMarket,ADBE,34,0,34,-34,1,15,0,1,NASDAQ
5116,16-02-2021 06:00,24 hrs.,trakstocks,TNXP,25,25,0,25,1,9,3,1,NASDAQ
5116,16-02-2021 06:00,24 hrs.,trakstocks,TRCH,134,134,0,134,4,40,38,4,NASDAQ
5116,16-02-2021 06:00,24 hrs.,trakstocks,TRIT,70,33,37,-4,2,24,14,2,NASDAQ
5116,16-02-2021 06:00,24 hrs.,trakstocks,TTOO,26,0,26,-26,1,9,4,1,NASDAQ
5116,16-02-2021 06:00,24 hrs.,StockMarket,ALYI,7,7,0,7,1,1,1,1,OTC
5116,16-02-2021 06:00,24 hrs.,StockMarket,BOTH,93,93,0,93,1,34,21,1,OTC
5116,16-02-2021 06:00,24 hrs.,StockMarket,GMEV,6,6,0,6,1,1,0,1,OTC
5116,16-02-2021 06:00,24 hrs.,StockMarket,HCMC,25,6,19,-13,2,1,15,2,OTC
5116,16-02-2021 06:00,24 hrs.,StockMarket,PHIL,31,12,19,-7,2,3,17,2,OTC
5116,16-02-2021 06:00,24 hrs.,StockMarket,RCHA,6,0,6,-6,1,1,0,1,OTC
5116,16-02-2021 06:00,24 hrs.,StockMarket,SGMD,6,0,6,-6,1,1,0,1,OTC
5116,16-02-2021 06:00,24 hrs.,StockMarket,TGGI,17,17,0,17,1,3,7,1,OTC
5116,16-02-2021 06:00,24 hrs.,StockMarket,HVBTF,6,6,0,6,1,1,0,1,OTC
5116,16-02-2021 06:00,24 hrs.,StockMarket,LUKOY,19,19,0,19,1,6,3,1,OTC
5116,16-02-2021 06:00,24 hrs.,StockMarket,MMNFF,6,6,0,6,1,1,0,1,OTC
5116,16-02-2021 06:00,24 hrs.,StockMarket,NILSY,19,19,0,19,1,6,3,1,OTC
5116,16-02-2021 06:00,24 hrs.,StockMarket,NXTTF,10,0,10,-10,1,1,4,1,OTC
5116,16-02-2021 06:00,24 hrs.,StockMarket,OGZPY,19,19,0,19,1,6,3,1,OTC
5116,16-02-2021 06:00,24 hrs.,StockMarket,PYRNF,6,6,0,6,1,1,0,1,OTC
5116,16-02-2021 06:00,24 hrs.,StockMarket,DNN,19,19,0,19,1,6,3,1,AMEX
5116,16-02-2021 06:00,24 hrs.,StockMarket,DPW,6,0,6,-6,1,1,0,1,AMEX
5116,16-02-2021 06:00,24 hrs.,StockMarket,ITP,42,0,42,-42,1,16,6,1,AMEX
5116,16-02-2021 06:00,24 hrs.,StockMarket,MAG,19,19,0,19,1,6,3,1,AMEX
5116,16-02-2021 06:00,24 hrs.,StockMarket,URG,19,19,0,19,1,6,3,1,AMEX
5116,16-02-2021 06:00,24 hrs.,StockMarket,UUUU,19,19,0,19,1,6,3,1,AMEX
5116,16-02-2021 06:00,24 hrs.,StockMarket,AMC,416,298,118,180,4,173,54,4,NYSE
5116,16-02-2021 06:00,24 hrs.,StockMarket,ASX,6,6,0,6,1,1,0,1,NYSE
5116,16-02-2021 06:00,24 hrs.,StockMarket,AZZ,19,19,0,19,1,6,3,1,NYSE
5116,16-02-2021 06:00,24 hrs.,StockMarket,BDJ,17,0,17,-17,1,5,3,1,NYSE
5116,16-02-2021 06:00,24 hrs.,StockMarket,BOE,19,19,0,19,1,6,3,1,NYSE
5116,16-02-2021 06:00,24 hrs.,StockMarket,BTU,19,19,0,19,1,6,3,1,NYSE
5116,16-02-2021 06:00,24 hrs.,StockMarket,CCO,19,19,0,19,1,6,3,1,NYSE
5116,16-02-2021 06:00,24 hrs.,pennystocks,MPXOF,8,8,0,8,1,1,2,1,OTC
5116,16-02-2021 06:00,24 hrs.,pennystocks,MSNVF,495,495,0,495,1,198,95,1,OTC
5116,16-02-2021 06:00,24 hrs.,pennystocks,MYCOF,65,65,0,65,1,29,3,1,OTC
5116,16-02-2021 06:00,24 hrs.,pennystocks,NMHLY,12,12,0,12,2,2,0,2,OTC
5116,16-02-2021 06:00,24 hrs.,pennystocks,NMTLF,7,7,0,7,1,1,1,1,OTC
5116,16-02-2021 06:00,24 hrs.,pennystocks,AITX,529,517,12,505,11,195,95,8,OTC
5116,16-02-2021 06:00,24 hrs.,pennystocks,ALPP,27,27,0,27,2,7,5,2,OTC
5116,16-02-2021 06:00,24 hrs.,pennystocks,ALYI,88,88,0,88,2,22,36,2,OTC
5116,16-02-2021 06:00,24 hrs.,pennystocks,APYP,19,19,0,19,3,3,1,1,OTC
5116,16-02-2021 06:00,24 hrs.,pennystocks,ASTI,112,65,47,18,4,22,52,4,OTC
5116,16-02-2021 06:00,24 hrs.,pennystocks,BANT,6,0,6,-6,1,1,0,1,OTC
5116,16-02-2021 06:00,24 hrs.,pennystocks,BBRW,62,56,6,50,2,14,26,2,OTC
5116,16-02-2021 06:00,24 hrs.,pennystocks,BCAP,12,12,0,12,2,2,0,1,OTC
5116,16-02-2021 06:00,24 hrs.,pennystocks,BIEL,6,0,6,-6,1,1,0,1,OTC
5116,16-02-2021 06:00,24 hrs.,pennystocks,BLSP,13,0,13,-13,2,2,1,2,OTC
5116,16-02-2021 06:00,24 hrs.,pennystocks,BNGI,6,6,0,6,1,1,0,1,OTC
5116,16-02-2021 06:00,24 hrs.,pennystocks,BOTH,18,18,0,18,3,3,0,2,OTC
5116,16-02-2021 06:00,24 hrs.,pennystocks,BOTY,14,7,7,0,2,2,2,2,OTC
5116,16-02-2021 06:00,24 hrs.,pennystocks,BRRN,19,19,0,19,3,3,1,2,OTC
5116,16-02-2021 06:00,24 hrs.,pennystocks,BYOC,16,0,16,-16,1,2,8,1,OTC
5116,16-02-2021 06:00,24 hrs.,pennystocks,CBBT,966,117,849,-732,7,322,294,6,OTC
5116,16-02-2021 06:00,24 hrs.,pennystocks,CBDL,12,12,0,12,2,2,0,2,OTC
5116,16-02-2021 06:00,24 hrs.,pennystocks,CCTL,6,6,0,6,1,1,0,1,OTC
5116,16-02-2021 06:00,24 hrs.,pennystocks,CEOS,361,361,0,361,1,103,151,1,OTC
5116,16-02-2021 06:00,24 hrs.,pennystocks,CYDY,7,7,0,7,1,1,1,1,OTC
5116,16-02-2021 06:00,24 hrs.,pennystocks,DPLS,7,0,7,-7,1,1,1,1,OTC
5116,16-02-2021 06:00,24 hrs.,pennystocks,ECEZ,361,361,0,361,1,103,151,1,OTC
5116,16-02-2021 06:00,24 hrs.,pennystocks,ENZC,6,6,0,6,1,1,0,1,OTC
5116,16-02-2021 06:00,24 hrs.,pennystocks,ERBB,56,56,0,56,1,13,26,1,OTC
5116,16-02-2021 06:00,24 hrs.,pennystocks,ETFM,443,148,295,-147,7,166,83,4,OTC
5116,16-02-2021 06:00,24 hrs.,pennystocks,FDMF,6,6,0,6,1,1,0,1,OTC
5116,16-02-2021 06:00,24 hrs.,pennystocks,FLES,19,19,0,19,1,0,15,1,OTC
5116,16-02-2021 06:00,24 hrs.,pennystocks,GAHC,36,36,0,36,1,7,18,1,OTC
5116,16-02-2021 06:00,24 hrs.,pennystocks,GAXY,23,23,0,23,1,4,11,1,OTC
5116,16-02-2021 06:00,24 hrs.,pennystocks,GCEH,54,54,0,54,1,20,10,1,OTC
5116,16-02-2021 06:00,24 hrs.,pennystocks,GNPT,6,0,6,-6,1,1,0,1,OTC
5116,16-02-2021 06:00,24 hrs.,pennystocks,GPFT,6,6,0,6,1,1,0,1,OTC
5116,16-02-2021 06:00,24 hrs.,pennystocks,GRNH,56,56,0,56,1,13,26,1,OTC
5116,16-02-2021 06:00,24 hrs.,pennystocks,GTEH,50,0,50,-50,1,14,18,1,OTC
5116,16-02-2021 06:00,24 hrs.,pennystocks,GTLL,58,51,7,44,3,19,8,3,OTC
5116,16-02-2021 06:00,24 hrs.,pennystocks,GTXO,16,16,0,16,1,3,6,1,OTC
5116,16-02-2021 06:00,24 hrs.,pennystocks,HALB,42,42,0,42,1,15,8,1,OTC
5116,16-02-2021 06:00,24 hrs.,pennystocks,HCMC,12,12,0,12,2,2,0,2,OTC
5116,16-02-2021 06:00,24 hrs.,pennystocks,HEMP,7,7,0,7,1,1,1,1,OTC
5116,16-02-2021 06:00,24 hrs.,pennystocks,HPNN,7,7,0,7,1,1,1,1,OTC
5116,16-02-2021 06:00,24 hrs.,pennystocks,HQGE,7,0,7,-7,1,1,1,1,OTC
5116,16-02-2021 06:00,24 hrs.,pennystocks,INKW,7,7,0,7,1,1,1,1,OTC
5116,16-02-2021 06:00,24 hrs.,pennystocks,INND,60,60,0,60,1,18,20,1,OTC
5116,16-02-2021 06:00,24 hrs.,pennystocks,IQST,36,36,0,36,1,8,16,1,OTC
5116,16-02-2021 06:00,24 hrs.,pennystocks,KOAN,4,0,4,-4,1,0,0,1,OTC
5116,16-02-2021 06:00,24 hrs.,pennystocks,KOSK,9,9,0,9,1,1,3,1,OTC
5116,16-02-2021 06:00,24 hrs.,pennystocks,KULR,35,0,35,-35,1,12,7,1,OTC
5116,16-02-2021 06:00,24 hrs.,pennystocks,KWBT,24,24,0,24,1,8,4,1,OTC
5116,16-02-2021 06:00,24 hrs.,pennystocks,LLBO,13,0,13,-13,2,2,1,1,OTC
5116,16-02-2021 06:00,24 hrs.,pennystocks,LQMT,6,0,6,-6,1,1,0,1,OTC
5116,16-02-2021 06:00,24 hrs.,pennystocks,MCOA,56,56,0,56,1,13,26,1,OTC
5116,16-02-2021 06:00,24 hrs.,pennystocks,MJNA,21,21,0,21,3,3,3,1,OTC
5116,16-02-2021 06:00,24 hrs.,StockMarket,AMZN,34,0,34,-34,1,15,0,1,NASDAQ
5116,16-02-2021 06:00,24 hrs.,StockMarket,ANTE,8,8,0,8,1,2,0,1,NASDAQ
5116,16-02-2021 06:00,24 hrs.,StockMarket,ATOS,6,0,6,-6,1,1,0,1,NASDAQ
5116,16-02-2021 06:00,24 hrs.,StockMarket,BNGO,6,6,0,6,1,1,0,1,NASDAQ
5116,16-02-2021 06:00,24 hrs.,StockMarket,CMPS,6,0,6,-6,1,1,0,1,NASDAQ
5116,16-02-2021 06:00,24 hrs.,StockMarket,CRSR,47,47,0,47,1,11,21,1,NASDAQ
5116,16-02-2021 06:00,24 hrs.,StockMarket,CTRM,7,7,0,7,1,1,1,1,NASDAQ
5116,16-02-2021 06:00,24 hrs.,pennystocks,UEC,80,80,0,80,1,31,14,1,AMEX
5116,16-02-2021 06:00,24 hrs.,pennystocks,GSAT,6,6,0,6,1,1,0,1,AMEX
5116,16-02-2021 06:00,24 hrs.,pennystocks,INUV,36,30,6,24,2,9,10,2,AMEX
5116,16-02-2021 06:00,24 hrs.,pennystocks,SENS,6,0,6,-6,1,1,0,1,AMEX
5116,16-02-2021 06:00,24 hrs.,pennystocks,UAMY,33,33,0,33,1,8,13,1,AMEX
5116,16-02-2021 06:00,24 hrs.,pennystocks,ACB,216,216,0,216,1,96,20,1,NYSE
5116,16-02-2021 06:00,24 hrs.,pennystocks,ADC,6,0,6,-6,1,1,0,1,NYSE
5116,16-02-2021 06:00,24 hrs.,pennystocks,AMC,12,6,6,0,2,2,0,2,NYSE
5116,16-02-2021 06:00,24 hrs.,pennystocks,ASX,112,106,6,100,4,38,20,4,NYSE
5116,16-02-2021 06:00,24 hrs.,pennystocks,BCH,11,0,11,-11,1,2,3,1,NYSE
5116,16-02-2021 06:00,24 hrs.,pennystocks,BMO,216,216,0,216,1,96,20,1,NYSE
5116,16-02-2021 06:00,24 hrs.,pennystocks,BYD,35,0,35,-35,1,12,7,1,NYSE
5116,16-02-2021 06:00,24 hrs.,pennystocks,CBD,222,216,6,210,2,97,20,2,NYSE
5116,16-02-2021 06:00,24 hrs.,pennystocks,CCO,12,12,0,12,1,2,4,1,NYSE
5116,16-02-2021 06:00,24 hrs.,pennystocks,COO,12,12,0,12,1,2,4,1,NYSE
5116,16-02-2021 06:00,24 hrs.,pennystocks,CSV,780,0,780,-780,1,356,64,1,NYSE
5116,16-02-2021 06:00,24 hrs.,pennystocks,NOVC,62,62,0,62,5,19,4,2,OTC
5116,16-02-2021 06:00,24 hrs.,pennystocks,OPTI,6,6,0,6,1,1,0,1,OTC
5116,16-02-2021 06:00,24 hrs.,pennystocks,PBHG,6,6,0,6,1,1,0,1,OTC
5116,16-02-2021 06:00,24 hrs.,pennystocks,PGAS,18,18,0,18,3,3,0,2,OTC
5116,16-02-2021 06:00,24 hrs.,pennystocks,PHCG,6,0,6,-6,1,1,0,1,OTC
5116,16-02-2021 06:00,24 hrs.,pennystocks,PHIL,6,6,0,6,1,1,0,1,OTC
5116,16-02-2021 06:00,24 hrs.,pennystocks,PUGE,48,48,0,48,1,14,16,1,OTC
5116,16-02-2021 06:00,24 hrs.,pennystocks,PURA,15,15,0,15,1,3,5,1,OTC
5116,16-02-2021 06:00,24 hrs.,pennystocks,RNWR,6,6,0,6,1,1,0,1,OTC
5116,16-02-2021 06:00,24 hrs.,pennystocks,SGMD,120,105,15,90,3,15,78,3,OTC
5116,16-02-2021 06:00,24 hrs.,pennystocks,SIML,59,59,0,59,1,21,13,1,OTC
5116,16-02-2021 06:00,24 hrs.,pennystocks,SNPW,95,95,0,95,3,33,17,2,OTC
5116,16-02-2021 06:00,24 hrs.,pennystocks,SRMX,46,40,6,34,3,12,10,3,OTC
5116,16-02-2021 06:00,24 hrs.,pennystocks,SSFT,473,6,467,-461,3,167,127,3,OTC
5116,16-02-2021 06:00,24 hrs.,pennystocks,STHC,30,0,30,-30,1,10,6,1,OTC
5116,16-02-2021 06:00,24 hrs.,pennystocks,SUGR,6,6,0,6,1,1,0,1,OTC
5116,16-02-2021 06:00,24 hrs.,pennystocks,TLSS,65,65,0,65,2,8,41,2,OTC
5116,16-02-2021 06:00,24 hrs.,pennystocks,TSNP,22,0,22,-22,1,6,6,1,OTC
5116,16-02-2021 06:00,24 hrs.,pennystocks,UNVC,7,7,0,7,1,1,1,1,OTC
5116,16-02-2021 06:00,24 hrs.,pennystocks,UVSE,7,7,0,7,1,1,1,1,OTC
5116,16-02-2021 06:00,24 hrs.,pennystocks,VPER,970,361,609,-248,2,308,346,2,OTC
5116,16-02-2021 06:00,24 hrs.,pennystocks,VPRB,6,6,0,6,1,1,0,1,OTC
5116,16-02-2021 06:00,24 hrs.,pennystocks,WARM,12,0,12,-12,2,2,0,1,OTC
5116,16-02-2021 06:00,24 hrs.,pennystocks,WDLF,6,6,0,6,1,1,0,1,OTC
5116,16-02-2021 06:00,24 hrs.,pennystocks,WGNR,8,8,0,8,1,1,2,1,OTC
5116,16-02-2021 06:00,24 hrs.,pennystocks,AACTF,79,0,79,-79,2,27,17,2,OTC
5116,16-02-2021 06:00,24 hrs.,pennystocks,ABEPF,59,0,59,-59,1,12,31,1,OTC
5116,16-02-2021 06:00,24 hrs.,pennystocks,AMYZF,51,51,0,51,1,19,9,1,OTC
5116,16-02-2021 06:00,24 hrs.,pennystocks,ARBKF,235,12,223,-211,4,65,89,4,OTC
5116,16-02-2021 06:00,24 hrs.,pennystocks,BYDDY,35,0,35,-35,1,12,7,1,OTC
5116,16-02-2021 06:00,24 hrs.,pennystocks,CANSF,216,216,0,216,1,96,20,1,OTC
5116,16-02-2021 06:00,24 hrs.,pennystocks,CINGF,36,36,0,36,1,7,18,1,OTC
5116,16-02-2021 06:00,24 hrs.,pennystocks,CYDVF,6,6,0,6,1,1,0,1,OTC
5116,16-02-2021 06:00,24 hrs.,pennystocks,EFLVF,6,0,6,-6,1,1,0,1,OTC
5116,16-02-2021 06:00,24 hrs.,pennystocks,EPWCF,6,6,0,6,1,1,0,1,OTC
5116,16-02-2021 06:00,24 hrs.,pennystocks,ERPNF,98,98,0,98,2,33,24,2,OTC
5116,16-02-2021 06:00,24 hrs.,pennystocks,FUNFF,6,6,0,6,1,1,0,1,OTC
5116,16-02-2021 06:00,24 hrs.,pennystocks,GWMGF,6,6,0,6,1,1,0,1,OTC
5116,16-02-2021 06:00,24 hrs.,pennystocks,HITIF,59,0,59,-59,1,12,31,1,OTC
5116,16-02-2021 06:00,24 hrs.,pennystocks,HUTMF,44,0,44,-44,1,6,28,1,OTC
5116,16-02-2021 06:00,24 hrs.,pennystocks,HVBTF,12,12,0,12,2,2,0,2,OTC
5116,16-02-2021 06:00,24 hrs.,pennystocks,LIACF,25,0,25,-25,1,9,3,1,OTC
5116,16-02-2021 06:00,24 hrs.,pennystocks,LKNCY,18,0,18,-18,3,3,0,1,OTC
5116,16-02-2021 06:00,24 hrs.,pennystocks,MLLOF,84,84,0,84,1,36,8,1,OTC
5116,16-02-2021 06:00,24 hrs.,pennystocks,MMNFF,6,0,6,-6,1,1,0,1,OTC
5116,16-02-2021 06:00,24 hrs.,pennystocks,MMTIF,24,24,0,24,1,4,12,1,OTC
5116,16-02-2021 06:00,24 hrs.,pennystocks,MNXXF,134,40,94,-54,2,48,30,2,OTC
5116,16-02-2021 06:00,24 hrs.,pennystocks,MPUCF,6,6,0,6,1,1,0,1,OTC
5116,16-02-2021 06:00,24 hrs.,pennystocks,AIKI,20,20,0,20,2,5,2,1,NASDAQ
5116,16-02-2021 06:00,24 hrs.,pennystocks,AKBA,6,6,0,6,1,1,0,1,NASDAQ
5116,16-02-2021 06:00,24 hrs.,pennystocks,AMZN,8,8,0,8,1,1,2,1,NASDAQ
5116,16-02-2021 06:00,24 hrs.,pennystocks,ANTE,9,9,0,9,1,2,1,1,NASDAQ
5116,16-02-2021 06:00,24 hrs.,pennystocks,APHA,216,216,0,216,1,96,20,1,NASDAQ
5116,16-02-2021 06:00,24 hrs.,pennystocks,ASRT,1836,0,1836,-1836,10,791,214,3,NASDAQ
5116,16-02-2021 06:00,24 hrs.,pennystocks,ASRV,41,0,41,-41,1,11,15,1,NASDAQ
5116,16-02-2021 06:00,24 hrs.,pennystocks,ATOS,6,0,6,-6,1,1,0,1,NASDAQ
5116,16-02-2021 06:00,24 hrs.,pennystocks,AYTU,20,20,0,20,2,5,2,1,NASDAQ
5116,16-02-2021 06:00,24 hrs.,pennystocks,BCRX,6,0,6,-6,1,1,0,1,NASDAQ
5116,16-02-2021 06:00,24 hrs.,pennystocks,BIOL,6,0,6,-6,1,1,0,1,NASDAQ
5116,16-02-2021 06:00,24 hrs.,pennystocks,BNGO,83,83,0,83,1,33,13,1,NASDAQ
5116,16-02-2021 06:00,24 hrs.,pennystocks,BTBT,44,0,44,-44,1,6,28,1,NASDAQ
5116,16-02-2021 06:00,24 hrs.,pennystocks,CASH,137,137,0,137,1,64,5,1,NASDAQ
5116,16-02-2021 06:00,24 hrs.,pennystocks,CETX,20,20,0,20,2,5,2,1,NASDAQ
5116,16-02-2021 06:00,24 hrs.,pennystocks,CIDM,20,20,0,20,1,5,6,1,NASDAQ
5116,16-02-2021 06:00,24 hrs.,pennystocks,CKPT,6,6,0,6,1,1,0,1,NASDAQ
5116,16-02-2021 06:00,24 hrs.,pennystocks,CRBP,11,11,0,11,1,3,1,1,NASDAQ
5116,16-02-2021 06:00,24 hrs.,pennystocks,CRON,216,216,0,216,1,96,20,1,NASDAQ
5116,16-02-2021 06:00,24 hrs.,pennystocks,CTRM,7,7,0,7,1,1,1,1,NASDAQ
5116,16-02-2021 06:00,24 hrs.,pennystocks,EDIT,819,39,780,-741,2,356,99,2,NASDAQ
5116,16-02-2021 06:00,24 hrs.,pennystocks,GNUS,6,6,0,6,1,1,0,1,NASDAQ
5116,16-02-2021 06:00,24 hrs.,pennystocks,GOEV,7,0,7,-7,1,1,1,1,NASDAQ
5116,16-02-2021 06:00,24 hrs.,pennystocks,GOLD,7,7,0,7,1,1,1,1,NASDAQ
5116,16-02-2021 06:00,24 hrs.,pennystocks,GRIL,20,20,0,20,2,5,2,1,NASDAQ
5116,16-02-2021 06:00,24 hrs.,pennystocks,INPX,58,0,58,-58,1,22,10,1,NASDAQ
5116,16-02-2021 06:00,24 hrs.,pennystocks,INVO,6,6,0,6,1,1,0,1,NASDAQ
5116,16-02-2021 06:00,24 hrs.,pennystocks,KTRA,6,6,0,6,1,1,0,1,NASDAQ
5116,16-02-2021 06:00,24 hrs.,pennystocks,LIFE,12,0,12,-12,2,2,0,1,NASDAQ
5116,16-02-2021 06:00,24 hrs.,pennystocks,LOAC,13,13,0,13,2,2,1,1,NASDAQ
5116,16-02-2021 06:00,24 hrs.,pennystocks,MARA,191,0,191,-191,2,56,71,2,NASDAQ
5116,16-02-2021 06:00,24 hrs.,pennystocks,NAKD,6,6,0,6,1,1,0,1,NASDAQ
5116,16-02-2021 06:00,24 hrs.,pennystocks,NEOS,20,20,0,20,2,5,2,1,NASDAQ
5116,16-02-2021 06:00,24 hrs.,pennystocks,NVCN,40,40,0,40,1,9,18,1,NASDAQ
5116,16-02-2021 06:00,24 hrs.,pennystocks,OBSV,123,123,0,123,1,39,41,1,NASDAQ
5116,16-02-2021 06:00,24 hrs.,pennystocks,OPTT,6,6,0,6,1,1,0,1,NASDAQ
5116,16-02-2021 06:00,24 hrs.,pennystocks,OTLK,6,0,6,-6,1,1,0,1,NASDAQ
5116,16-02-2021 06:00,24 hrs.,pennystocks,PFMT,6,6,0,6,1,1,0,1,NASDAQ
5116,16-02-2021 06:00,24 hrs.,pennystocks,EAT,222,222,0,222,2,97,20,2,NYSE
5116,16-02-2021 06:00,24 hrs.,pennystocks,ETH,17,6,11,-5,2,3,3,2,NYSE
5116,16-02-2021 06:00,24 hrs.,pennystocks,MUX,65,0,65,-65,1,14,33,1,NYSE
5116,16-02-2021 06:00,24 hrs.,pennystocks,NAV,28,0,28,-28,1,11,2,1,NYSE
5116,16-02-2021 06:00,24 hrs.,pennystocks,NYT,60,60,0,60,2,11,30,1,NYSE
5116,16-02-2021 06:00,24 hrs.,pennystocks,PDT,6,0,6,-6,1,1,0,1,NYSE
5116,16-02-2021 06:00,24 hrs.,pennystocks,OTIVF,6,0,6,-6,1,1,0,1,OTC
5116,16-02-2021 06:00,24 hrs.,pennystocks,PDDTF,36,0,36,-36,1,11,10,1,OTC
5116,16-02-2021 06:00,24 hrs.,pennystocks,PLUUF,25,0,25,-25,1,9,3,1,OTC
5116,16-02-2021 06:00,24 hrs.,pennystocks,POETF,12,0,12,-12,2,2,0,1,OTC
5116,16-02-2021 06:00,24 hrs.,pennystocks,PYRNF,26,26,0,26,1,8,6,1,OTC
5116,16-02-2021 06:00,24 hrs.,pennystocks,REGRF,36,36,0,36,1,7,18,1,OTC
5116,16-02-2021 06:00,24 hrs.,pennystocks,ROCLF,7,0,7,-7,1,1,1,1,OTC
5116,16-02-2021 06:00,24 hrs.,pennystocks,TAKOF,6,0,6,-6,1,1,0,1,OTC
5116,16-02-2021 06:00,24 hrs.,pennystocks,TGIFF,22,22,0,22,1,7,4,1,OTC
5116,16-02-2021 06:00,24 hrs.,pennystocks,TOBAF,6,6,0,6,1,1,0,1,OTC
5116,16-02-2021 06:00,24 hrs.,pennystocks,TOWTF,13,0,13,-13,2,2,1,1,OTC
5116,16-02-2021 06:00,24 hrs.,pennystocks,TTTPF,7,0,7,-7,1,1,1,1,OTC
5116,16-02-2021 06:00,24 hrs.,pennystocks,WCEXF,35,0,35,-35,1,6,19,1,OTC
5116,16-02-2021 06:00,24 hrs.,pennystocks,WDDMF,6,6,0,6,1,1,0,1,OTC
5116,16-02-2021 06:00,24 hrs.,pennystocks,CTO,172,0,172,-172,1,55,58,1,AMEX
5116,16-02-2021 06:00,24 hrs.,pennystocks,DNN,23,23,0,23,1,8,3,1,AMEX
5116,16-02-2021 06:00,24 hrs.,pennystocks,GPL,50,0,50,-50,1,14,18,1,AMEX
5116,16-02-2021 06:00,24 hrs.,pennystocks,GSV,6,6,0,6,1,1,0,1,AMEX
5116,16-02-2021 06:00,24 hrs.,pennystocks,ISR,80,80,0,80,1,31,14,1,AMEX
5116,16-02-2021 06:00,24 hrs.,pennystocks,NAK,7,7,0,7,1,1,1,1,AMEX
5116,16-02-2021 06:00,24 hrs.,pennystocks,XSPA,365,20,345,-325,5,135,75,5,NASDAQ
5116,16-02-2021 06:00,24 hrs.,pennystocks,ZYNE,11,11,0,11,1,3,1,1,NASDAQ
5116,16-02-2021 06:00,24 hrs.,wallstreetbets,ABML,7,7,0,7,1,1,1,1,OTC
5116,16-02-2021 06:00,24 hrs.,wallstreetbets,ABVG,7,0,7,-7,1,1,1,1,OTC
5116,16-02-2021 06:00,24 hrs.,wallstreetbets,AITX,7,0,7,-7,1,1,1,1,OTC
5116,16-02-2021 06:00,24 hrs.,wallstreetbets,ALKN,13,13,0,13,2,2,1,2,OTC
5116,16-02-2021 06:00,24 hrs.,wallstreetbets,ALPP,7,0,7,-7,1,1,1,1,OTC
5116,16-02-2021 06:00,24 hrs.,wallstreetbets,ARST,7,7,0,7,1,1,1,1,OTC
5116,16-02-2021 06:00,24 hrs.,wallstreetbets,ASTI,20,14,6,8,3,3,2,2,OTC
5116,16-02-2021 06:00,24 hrs.,wallstreetbets,BBRW,7,7,0,7,1,1,1,1,OTC
5116,16-02-2021 06:00,24 hrs.,wallstreetbets,BOTH,1389,0,1389,-1389,1,444,497,1,OTC
5116,16-02-2021 06:00,24 hrs.,wallstreetbets,BOTY,14,7,7,0,2,2,2,2,OTC
5116,16-02-2021 06:00,24 hrs.,wallstreetbets,BTCS,14,7,7,0,2,2,2,2,OTC
5116,16-02-2021 06:00,24 hrs.,wallstreetbets,CLWD,7,0,7,-7,1,1,1,1,OTC
5116,16-02-2021 06:00,24 hrs.,wallstreetbets,COMS,6,6,0,6,1,1,0,1,OTC
5116,16-02-2021 06:00,24 hrs.,wallstreetbets,CYDY,29,29,0,29,4,4,5,1,OTC
5116,16-02-2021 06:00,24 hrs.,wallstreetbets,ECDP,7,7,0,7,1,1,1,1,OTC
5116,16-02-2021 06:00,24 hrs.,wallstreetbets,ETFM,7,7,0,7,1,1,1,1,OTC
5116,16-02-2021 06:00,24 hrs.,wallstreetbets,FMCC,399,399,0,399,2,117,157,2,OTC
5116,16-02-2021 06:00,24 hrs.,wallstreetbets,FNMA,399,399,0,399,2,117,157,2,OTC
5116,16-02-2021 06:00,24 hrs.,wallstreetbets,GARB,7,7,0,7,1,1,1,1,OTC
5116,16-02-2021 06:00,24 hrs.,pennystocks,PHAR,28,0,28,-28,1,11,2,1,NASDAQ
5116,16-02-2021 06:00,24 hrs.,pennystocks,PLUS,121,0,121,-121,2,36,41,2,NASDAQ
5116,16-02-2021 06:00,24 hrs.,pennystocks,PTON,83,83,0,83,1,33,13,1,NASDAQ
5116,16-02-2021 06:00,24 hrs.,pennystocks,RAVE,20,20,0,20,2,5,2,1,NASDAQ
5116,16-02-2021 06:00,24 hrs.,pennystocks,RIOT,197,6,191,-185,3,57,71,3,NASDAQ
5116,16-02-2021 06:00,24 hrs.,pennystocks,ROKU,20,20,0,20,1,5,6,1,NASDAQ
5116,16-02-2021 06:00,24 hrs.,pennystocks,SHIP,47,47,0,47,1,8,27,1,NASDAQ
5116,16-02-2021 06:00,24 hrs.,pennystocks,SNDL,55,55,0,55,8,10,3,7,NASDAQ
5116,16-02-2021 06:00,24 hrs.,pennystocks,SNGX,51,51,0,51,4,14,7,3,NASDAQ
5116,16-02-2021 06:00,24 hrs.,pennystocks,TBLT,6,0,6,-6,1,1,0,1,NASDAQ
5116,16-02-2021 06:00,24 hrs.,pennystocks,TECH,6,0,6,-6,1,1,0,1,NASDAQ
5116,16-02-2021 06:00,24 hrs.,pennystocks,TLRY,216,216,0,216,1,96,20,1,NASDAQ
5116,16-02-2021 06:00,24 hrs.,pennystocks,TMDI,6,0,6,-6,1,1,0,1,NASDAQ
5116,16-02-2021 06:00,24 hrs.,pennystocks,TNXP,278,0,278,-278,2,116,38,2,NASDAQ
5116,16-02-2021 06:00,24 hrs.,pennystocks,TRCH,22,16,6,10,2,3,8,2,NASDAQ
5116,16-02-2021 06:00,24 hrs.,pennystocks,TRIB,6,0,6,-6,1,1,0,1,NASDAQ
5116,16-02-2021 06:00,24 hrs.,pennystocks,TRVG,20,20,0,20,2,5,2,1,NASDAQ
5116,16-02-2021 06:00,24 hrs.,pennystocks,PEG,137,137,0,137,1,64,5,1,NYSE
5116,16-02-2021 06:00,24 hrs.,pennystocks,PEN,80,80,0,80,1,31,14,1,NYSE
5116,16-02-2021 06:00,24 hrs.,pennystocks,PKG,177,0,177,-177,1,67,39,1,NYSE
5116,16-02-2021 06:00,24 hrs.,pennystocks,PSA,6,0,6,-6,1,1,0,1,NYSE
5116,16-02-2021 06:00,24 hrs.,pennystocks,SOS,47,33,14,19,7,7,5,4,NYSE
5116,16-02-2021 06:00,24 hrs.,pennystocks,THC,222,216,6,210,2,97,20,2,NYSE
5116,16-02-2021 06:00,24 hrs.,pennystocks,TWI,6,0,6,-6,1,1,0,1,NYSE
5116,16-02-2021 06:00,24 hrs.,pennystocks,CSPR,6,0,6,-6,1,1,0,1,NYSE
5116,16-02-2021 06:00,24 hrs.,pennystocks,FLOW,137,137,0,137,1,64,5,1,NYSE
5116,16-02-2021 06:00,24 hrs.,pennystocks,FUBO,20,20,0,20,1,5,6,1,NYSE
5116,16-02-2021 06:00,24 hrs.,pennystocks,PLTR,21,21,0,21,1,5,7,1,NYSE
5116,16-02-2021 06:00,24 hrs.,pennystocks,SPCE,83,83,0,83,1,33,13,1,NYSE
5116,16-02-2021 06:00,24 hrs.,pennystocks,SPOT,6,0,6,-6,1,1,0,1,NYSE
5116,16-02-2021 06:00,24 hrs.,pennystocks,API,791,0,791,-791,2,359,65,2,NASDAQ
5116,16-02-2021 06:00,24 hrs.,pennystocks,CGC,281,281,0,281,2,125,23,2,NASDAQ
5116,16-02-2021 06:00,24 hrs.,pennystocks,ESG,84,84,0,84,1,36,8,1,NASDAQ
5116,16-02-2021 06:00,24 hrs.,pennystocks,FNX,6,0,6,-6,1,1,0,1,NASDAQ
5116,16-02-2021 06:00,24 hrs.,pennystocks,III,12,0,12,-12,2,2,0,1,NASDAQ
5116,16-02-2021 06:00,24 hrs.,pennystocks,KOD,89,0,89,-89,1,26,33,1,NASDAQ
5116,16-02-2021 06:00,24 hrs.,pennystocks,OGI,7,7,0,7,1,1,1,1,NASDAQ
5116,16-02-2021 06:00,24 hrs.,pennystocks,OLB,6,0,6,-6,1,1,0,1,NASDAQ
5116,16-02-2021 06:00,24 hrs.,pennystocks,PFC,13,13,0,13,2,2,1,2,NASDAQ
5116,16-02-2021 06:00,24 hrs.,pennystocks,PLL,36,0,36,-36,1,11,10,1,NASDAQ
5116,16-02-2021 06:00,24 hrs.,pennystocks,PXS,20,20,0,20,2,5,2,1,NASDAQ
5116,16-02-2021 06:00,24 hrs.,pennystocks,AACG,6,6,0,6,1,1,0,1,NASDAQ
5116,16-02-2021 06:00,24 hrs.,pennystocks,ACST,6,6,0,6,1,1,0,1,NASDAQ
5116,16-02-2021 06:00,24 hrs.,wallstreetbets,GTLL,28,28,0,28,4,4,4,2,OTC
5116,16-02-2021 06:00,24 hrs.,wallstreetbets,HCMC,88,33,55,-22,13,13,10,13,OTC
5116,16-02-2021 06:00,24 hrs.,wallstreetbets,HYSR,21,0,21,-21,3,3,3,2,OTC
5116,16-02-2021 06:00,24 hrs.,wallstreetbets,ILUS,7,7,0,7,1,1,1,1,OTC
5116,16-02-2021 06:00,24 hrs.,wallstreetbets,INKW,7,0,7,-7,1,1,1,1,OTC
5116,16-02-2021 06:00,24 hrs.,wallstreetbets,JSDA,7,0,7,-7,1,1,1,1,OTC
5116,16-02-2021 06:00,24 hrs.,wallstreetbets,LAAB,7,0,7,-7,1,1,1,1,OTC
5116,16-02-2021 06:00,24 hrs.,wallstreetbets,MCOA,21,7,14,-7,3,3,3,2,OTC
5116,16-02-2021 06:00,24 hrs.,wallstreetbets,MJNA,14,0,14,-14,2,2,2,2,OTC
5116,16-02-2021 06:00,24 hrs.,wallstreetbets,MKTY,6,0,6,-6,1,1,0,1,OTC
5116,16-02-2021 06:00,24 hrs.,wallstreetbets,MOST,6,0,6,-6,1,1,0,1,OTC
5116,16-02-2021 06:00,24 hrs.,wallstreetbets,OZSC,14,0,14,-14,2,2,2,2,OTC
5116,16-02-2021 06:00,24 hrs.,wallstreetbets,QUBT,6,6,0,6,1,1,0,1,OTC
5116,16-02-2021 06:00,24 hrs.,wallstreetbets,RBNW,8,0,8,-8,1,2,0,1,OTC
5116,16-02-2021 06:00,24 hrs.,wallstreetbets,RDGL,7,7,0,7,1,1,1,1,OTC
5116,16-02-2021 06:00,24 hrs.,wallstreetbets,RNWR,6,6,0,6,1,1,0,1,OTC
5116,16-02-2021 06:00,24 hrs.,wallstreetbets,ROTH,7,7,0,7,1,1,1,1,OTC
5116,16-02-2021 06:00,24 hrs.,wallstreetbets,RTON,6,6,0,6,1,1,0,1,OTC
5116,16-02-2021 06:00,24 hrs.,wallstreetbets,RXMD,6,0,6,-6,1,1,0,1,OTC
5116,16-02-2021 06:00,24 hrs.,wallstreetbets,SHMP,6,0,6,-6,1,1,0,1,OTC
5116,16-02-2021 06:00,24 hrs.,wallstreetbets,SLNG,6,6,0,6,1,1,0,1,OTC
5116,16-02-2021 06:00,24 hrs.,wallstreetbets,SPIN,129,0,129,-129,1,0,125,1,OTC
5116,16-02-2021 06:00,24 hrs.,wallstreetbets,SRMX,6,6,0,6,1,1,0,1,OTC
5116,16-02-2021 06:00,24 hrs.,wallstreetbets,TLSS,14,14,0,14,2,2,2,1,OTC
5116,16-02-2021 06:00,24 hrs.,wallstreetbets,TSNP,7,0,7,-7,1,1,1,1,OTC
5116,16-02-2021 06:00,24 hrs.,wallstreetbets,TTCM,6,0,6,-6,1,1,0,1,OTC
5116,16-02-2021 06:00,24 hrs.,wallstreetbets,UAPC,13,0,13,-13,2,2,1,1,OTC
5116,16-02-2021 06:00,24 hrs.,wallstreetbets,UEEC,13,0,13,-13,2,2,1,1,OTC
5116,16-02-2021 06:00,24 hrs.,wallstreetbets,USPS,136,0,136,-136,2,1,126,2,OTC
5116,16-02-2021 06:00,24 hrs.,wallstreetbets,VPRB,6,6,0,6,1,1,0,1,OTC
5116,16-02-2021 06:00,24 hrs.,wallstreetbets,WHEN,7,0,7,-7,1,1,1,1,OTC
5116,16-02-2021 06:00,24 hrs.,wallstreetbets,AMYZF,7,7,0,7,1,1,1,1,OTC
5116,16-02-2021 06:00,24 hrs.,wallstreetbets,BRQSW,7,7,0,7,1,1,1,1,OTC
5116,16-02-2021 06:00,24 hrs.,wallstreetbets,BVNNF,7,7,0,7,1,1,1,1,OTC
5116,16-02-2021 06:00,24 hrs.,wallstreetbets,DIGAF,7,7,0,7,1,1,1,1,OTC
5116,16-02-2021 06:00,24 hrs.,wallstreetbets,GAYMF,7,7,0,7,1,1,1,1,OTC
5116,16-02-2021 06:00,24 hrs.,wallstreetbets,GPORQ,7,7,0,7,1,1,1,1,OTC
5116,16-02-2021 06:00,24 hrs.,wallstreetbets,GTBAF,9,0,9,-9,1,1,3,1,OTC
5116,16-02-2021 06:00,24 hrs.,wallstreetbets,HITIF,15,15,0,15,2,2,3,2,OTC
5116,16-02-2021 06:00,24 hrs.,wallstreetbets,HRVSF,7,0,7,-7,1,1,1,1,OTC
5116,16-02-2021 06:00,24 hrs.,wallstreetbets,HVBTF,6,6,0,6,1,1,0,1,OTC
5116,16-02-2021 06:00,24 hrs.,wallstreetbets,LKNCY,6,0,6,-6,1,1,0,1,OTC
5116,16-02-2021 06:00,24 hrs.,wallstreetbets,LTMCF,34,34,0,34,1,0,30,1,OTC
5116,16-02-2021 06:00,24 hrs.,wallstreetbets,MSNVF,7,7,0,7,1,1,1,1,OTC
5116,16-02-2021 06:00,24 hrs.,wallstreetbets,MYCOF,6,6,0,6,1,1,0,1,OTC
5116,16-02-2021 06:00,24 hrs.,wallstreetbets,NXTTF,6,0,6,-6,1,1,0,1,OTC
5116,16-02-2021 06:00,24 hrs.,wallstreetbets,PLNHF,7,7,0,7,1,1,1,1,OTC
5116,16-02-2021 06:00,24 hrs.,wallstreetbets,PONGF,21,21,0,21,3,3,3,3,OTC
5116,16-02-2021 06:00,24 hrs.,wallstreetbets,PYRNF,7,7,0,7,1,1,1,1,OTC
5116,16-02-2021 06:00,24 hrs.,wallstreetbets,REZZF,19,13,6,7,3,3,1,2,OTC
5116,16-02-2021 06:00,24 hrs.,wallstreetbets,RYCEY,20,0,20,-20,3,3,2,2,OTC
5116,16-02-2021 06:00,24 hrs.,wallstreetbets,SPRWF,13,13,0,13,2,2,1,2,OTC
5116,16-02-2021 06:00,24 hrs.,wallstreetbets,TUIFF,6,6,0,6,1,1,0,1,OTC
5116,16-02-2021 06:00,24 hrs.,wallstreetbets,VYGVF,7,7,0,7,1,1,1,1,OTC
5116,16-02-2021 06:00,24 hrs.,wallstreetbets,DNN,21,21,0,21,3,3,3,1,AMEX
5116,16-02-2021 06:00,24 hrs.,wallstreetbets,GDP,363,363,0,363,1,138,83,1,AMEX
5116,16-02-2021 06:00,24 hrs.,wallstreetbets,GSV,22,0,22,-22,3,3,4,1,AMEX
5116,16-02-2021 06:00,24 hrs.,wallstreetbets,LEU,6,6,0,6,1,1,0,1,AMEX
5116,16-02-2021 06:00,24 hrs.,wallstreetbets,MXC,7,0,7,-7,1,1,1,1,AMEX
5116,16-02-2021 06:00,24 hrs.,wallstreetbets,NAK,6,0,6,-6,1,1,0,1,AMEX
5116,16-02-2021 06:00,24 hrs.,pennystocks,TSLA,41,0,41,-41,2,13,7,2,NASDAQ
5116,16-02-2021 06:00,24 hrs.,pennystocks,TTOO,6,6,0,6,1,1,0,1,NASDAQ
5116,16-02-2021 06:00,24 hrs.,pennystocks,TXMD,6,6,0,6,1,1,0,1,NASDAQ
5116,16-02-2021 06:00,24 hrs.,pennystocks,VTNR,6,6,0,6,1,1,0,1,NASDAQ
5116,16-02-2021 06:00,24 hrs.,wallstreetbets,THO,14,14,0,14,1,3,4,1,NYSE
5116,16-02-2021 06:00,24 hrs.,wallstreetbets,TRQ,369,369,0,369,2,139,83,2,NYSE
5116,16-02-2021 06:00,24 hrs.,wallstreetbets,TSM,133,127,6,121,3,43,35,3,NYSE
5116,16-02-2021 06:00,24 hrs.,wallstreetbets,UMC,7,7,0,7,1,1,1,1,NYSE
5116,16-02-2021 06:00,24 hrs.,wallstreetbets,WFC,7,0,7,-7,1,1,1,1,NYSE
5116,16-02-2021 06:00,24 hrs.,wallstreetbets,WTI,83,83,0,83,1,15,49,1,NYSE
5116,16-02-2021 06:00,24 hrs.,wallstreetbets,WWE,9,0,9,-9,1,2,1,1,NYSE
5116,16-02-2021 06:00,24 hrs.,wallstreetbets,AJAX,7,7,0,7,1,1,1,1,NYSE
5116,16-02-2021 06:00,24 hrs.,wallstreetbets,AMWL,625,0,625,-625,1,221,179,1,NYSE
5116,16-02-2021 06:00,24 hrs.,wallstreetbets,NBA,67,67,0,67,1,20,23,1,AMEX
5116,16-02-2021 06:00,24 hrs.,wallstreetbets,NES,7,7,0,7,1,1,1,1,AMEX
5116,16-02-2021 06:00,24 hrs.,wallstreetbets,TGB,7,7,0,7,1,1,1,1,AMEX
5116,16-02-2021 06:00,24 hrs.,wallstreetbets,ZOM,28,14,14,0,4,4,4,4,AMEX
5116,16-02-2021 06:00,24 hrs.,wallstreetbets,AMPE,14,14,0,14,2,2,2,1,AMEX
5116,16-02-2021 06:00,24 hrs.,wallstreetbets,CANF,7,0,7,-7,1,1,1,1,AMEX
5116,16-02-2021 06:00,24 hrs.,wallstreetbets,GSAT,26,26,0,26,4,4,2,3,AMEX
5116,16-02-2021 06:00,24 hrs.,wallstreetbets,LODE,7,7,0,7,1,1,1,1,AMEX
5116,16-02-2021 06:00,24 hrs.,wallstreetbets,SENS,7,7,0,7,1,1,1,1,AMEX
5116,16-02-2021 06:00,24 hrs.,wallstreetbets,TRXC,6,6,0,6,1,1,0,1,AMEX
5116,16-02-2021 06:00,24 hrs.,wallstreetbets,UAMY,7,7,0,7,1,1,1,1,AMEX
5116,16-02-2021 06:00,24 hrs.,wallstreetbets,XXII,12,0,12,-12,2,2,0,1,AMEX
5116,16-02-2021 06:00,24 hrs.,wallstreetbets,ACB,7,7,0,7,1,1,1,1,NYSE
5116,16-02-2021 06:00,24 hrs.,wallstreetbets,ADX,6,6,0,6,1,1,0,1,NYSE
5116,16-02-2021 06:00,24 hrs.,wallstreetbets,AIR,7,7,0,7,1,1,1,1,NYSE
5116,16-02-2021 06:00,24 hrs.,wallstreetbets,AIV,7,7,0,7,1,1,1,1,NYSE
5116,16-02-2021 06:00,24 hrs.,wallstreetbets,AMC,3232,2570,662,1908,106,1171,466,84,NYSE
5116,16-02-2021 06:00,24 hrs.,wallstreetbets,AMP,14,6,8,-2,2,3,0,2,NYSE
5116,16-02-2021 06:00,24 hrs.,wallstreetbets,ASX,14,0,14,-14,2,2,2,2,NYSE
5116,16-02-2021 06:00,24 hrs.,wallstreetbets,AVD,7,0,7,-7,1,1,1,1,NYSE
5116,16-02-2021 06:00,24 hrs.,wallstreetbets,BAM,114,0,114,-114,1,45,20,1,NYSE
5116,16-02-2021 06:00,24 hrs.,wallstreetbets,BCH,13,7,6,1,2,2,1,2,NYSE
5116,16-02-2021 06:00,24 hrs.,wallstreetbets,BFT,7,0,7,-7,1,1,1,1,NYSE
5116,16-02-2021 06:00,24 hrs.,wallstreetbets,BIO,7,0,7,-7,1,1,1,1,NYSE
5116,16-02-2021 06:00,24 hrs.,wallstreetbets,BME,7,7,0,7,1,1,1,1,NYSE
5116,16-02-2021 06:00,24 hrs.,wallstreetbets,BUD,7,7,0,7,1,1,1,1,NYSE
5116,16-02-2021 06:00,24 hrs.,wallstreetbets,CBD,14,6,8,-2,2,3,0,2,NYSE
5116,16-02-2021 06:00,24 hrs.,wallstreetbets,CCL,101,101,0,101,1,27,43,1,NYSE
5116,16-02-2021 06:00,24 hrs.,wallstreetbets,CHS,14,0,14,-14,2,2,2,1,NYSE
5116,16-02-2021 06:00,24 hrs.,wallstreetbets,CNS,7,0,7,-7,1,1,1,1,NYSE
5116,16-02-2021 06:00,24 hrs.,wallstreetbets,CPE,14,14,0,14,2,2,2,2,NYSE
5116,16-02-2021 06:00,24 hrs.,wallstreetbets,CPS,6,0,6,-6,1,1,0,1,NYSE
5116,16-02-2021 06:00,24 hrs.,wallstreetbets,CVS,7,7,0,7,1,1,1,1,NYSE
5116,16-02-2021 06:00,24 hrs.,wallstreetbets,CXW,7,7,0,7,1,1,1,1,NYSE
5116,16-02-2021 06:00,24 hrs.,wallstreetbets,DAC,6,0,6,-6,1,1,0,1,NYSE
5116,16-02-2021 06:00,24 hrs.,wallstreetbets,DCF,363,363,0,363,1,138,83,1,NYSE
5116,16-02-2021 06:00,24 hrs.,wallstreetbets,DGX,112,112,0,112,1,41,26,1,NYSE
5116,16-02-2021 06:00,24 hrs.,wallstreetbets,DIS,6,6,0,6,1,1,0,1,NYSE
5116,16-02-2021 06:00,24 hrs.,wallstreetbets,DOW,543,543,0,543,3,210,111,2,NYSE
5116,16-02-2021 06:00,24 hrs.,wallstreetbets,EAT,7,7,0,7,1,1,1,1,NYSE
5116,16-02-2021 06:00,24 hrs.,wallstreetbets,FLO,13,0,13,-13,1,3,3,1,NYSE
5116,16-02-2021 06:00,24 hrs.,wallstreetbets,FLT,7,7,0,7,1,1,1,1,NYSE
5116,16-02-2021 06:00,24 hrs.,wallstreetbets,FMS,6,0,6,-6,1,1,0,1,NYSE
5116,16-02-2021 06:00,24 hrs.,wallstreetbets,FSR,141,141,0,141,2,32,69,2,NYSE
5116,16-02-2021 06:00,24 hrs.,wallstreetbets,GEO,20,20,0,20,3,3,2,1,NYSE
5116,16-02-2021 06:00,24 hrs.,wallstreetbets,GME,28389,19477,8912,10565,212,12375,2791,159,NYSE
5116,16-02-2021 06:00,24 hrs.,wallstreetbets,IAG,7,7,0,7,1,1,1,1,NYSE
5116,16-02-2021 06:00,24 hrs.,wallstreetbets,IBM,7,7,0,7,1,1,1,1,NYSE
5116,16-02-2021 06:00,24 hrs.,wallstreetbets,ICE,129,0,129,-129,1,0,125,1,NYSE
5116,16-02-2021 06:00,24 hrs.,wallstreetbets,JNJ,6,0,6,-6,1,1,0,1,NYSE
5116,16-02-2021 06:00,24 hrs.,wallstreetbets,JPM,80,80,0,80,1,0,76,1,NYSE
5116,16-02-2021 06:00,24 hrs.,wallstreetbets,JWN,101,101,0,101,1,27,43,1,NYSE
5116,16-02-2021 06:00,24 hrs.,wallstreetbets,KSS,101,101,0,101,1,27,43,1,NYSE
5116,16-02-2021 06:00,24 hrs.,wallstreetbets,LAC,13,13,0,13,2,2,1,2,NYSE
5116,16-02-2021 06:00,24 hrs.,wallstreetbets,GPFT,21,21,0,21,3,3,3,3,OTC
5116,16-02-2021 06:00,24 hrs.,wallstreetbets,AMD,255,229,26,203,7,91,45,6,NASDAQ
5116,16-02-2021 06:00,24 hrs.,wallstreetbets,APA,94,94,0,94,1,32,26,1,NASDAQ
5116,16-02-2021 06:00,24 hrs.,wallstreetbets,API,6,0,6,-6,1,1,0,1,NASDAQ
5116,16-02-2021 06:00,24 hrs.,wallstreetbets,AVO,7,0,7,-7,1,1,1,1,NASDAQ
5116,16-02-2021 06:00,24 hrs.,wallstreetbets,BFI,7,0,7,-7,1,1,1,1,NASDAQ
5116,16-02-2021 06:00,24 hrs.,wallstreetbets,CDC,33,33,0,33,1,0,29,1,NASDAQ
5116,16-02-2021 06:00,24 hrs.,wallstreetbets,CGC,6,6,0,6,1,1,0,1,NASDAQ
5116,16-02-2021 06:00,24 hrs.,wallstreetbets,DBX,8,0,8,-8,1,1,2,1,NASDAQ
5116,16-02-2021 06:00,24 hrs.,wallstreetbets,GSM,27,7,20,-13,4,4,3,3,NASDAQ
5116,16-02-2021 06:00,24 hrs.,wallstreetbets,HAS,4284,2270,2014,256,5,1848,568,3,NASDAQ
5116,16-02-2021 06:00,24 hrs.,wallstreetbets,HCM,6,6,0,6,1,1,0,1,NASDAQ
5116,16-02-2021 06:00,24 hrs.,wallstreetbets,INO,19,7,12,-5,3,3,1,2,NASDAQ
5116,16-02-2021 06:00,24 hrs.,wallstreetbets,KIN,7,0,7,-7,1,1,1,1,NASDAQ
5116,16-02-2021 06:00,24 hrs.,wallstreetbets,MGI,14,0,14,-14,2,2,2,1,NASDAQ
5116,16-02-2021 06:00,24 hrs.,wallstreetbets,MWK,7,0,7,-7,1,1,1,1,NASDAQ
5116,16-02-2021 06:00,24 hrs.,wallstreetbets,OGI,13,13,0,13,2,2,1,2,NASDAQ
5116,16-02-2021 06:00,24 hrs.,wallstreetbets,OPK,21,14,7,7,3,3,3,2,NASDAQ
5116,16-02-2021 06:00,24 hrs.,wallstreetbets,PDD,6,0,6,-6,1,1,0,1,NASDAQ
5116,16-02-2021 06:00,24 hrs.,wallstreetbets,PTE,14,7,7,0,2,2,2,2,NASDAQ
5116,16-02-2021 06:00,24 hrs.,wallstreetbets,REG,7,0,7,-7,1,1,1,1,NASDAQ
5116,16-02-2021 06:00,24 hrs.,wallstreetbets,SDC,7,0,7,-7,1,1,1,1,NASDAQ
5116,16-02-2021 06:00,24 hrs.,wallstreetbets,VFF,6,6,0,6,1,1,0,1,NASDAQ
5116,16-02-2021 06:00,24 hrs.,wallstreetbets,VRA,7,7,0,7,1,1,1,1,NASDAQ
5116,16-02-2021 06:00,24 hrs.,wallstreetbets,AACQ,7,7,0,7,1,1,1,1,NASDAQ
5116,16-02-2021 06:00,24 hrs.,wallstreetbets,AAPL,13,6,7,-1,2,2,1,2,NASDAQ
5116,16-02-2021 06:00,24 hrs.,wallstreetbets,ABNB,7,7,0,7,1,1,1,1,NASDAQ
5116,16-02-2021 06:00,24 hrs.,wallstreetbets,ACRX,7,7,0,7,1,1,1,1,NASDAQ
5116,16-02-2021 06:00,24 hrs.,wallstreetbets,ACST,14,14,0,14,2,2,2,2,NASDAQ
5116,16-02-2021 06:00,24 hrs.,wallstreetbets,ADMA,7,0,7,-7,1,1,1,1,NASDAQ
5116,16-02-2021 06:00,24 hrs.,wallstreetbets,ADMP,6,6,0,6,1,1,0,1,NASDAQ
5116,16-02-2021 06:00,24 hrs.,wallstreetbets,AEZS,6,6,0,6,1,1,0,1,NASDAQ
5116,16-02-2021 06:00,24 hrs.,wallstreetbets,AGEN,6,0,6,-6,1,1,0,1,NASDAQ
5116,16-02-2021 06:00,24 hrs.,wallstreetbets,AKAM,7,7,0,7,1,1,1,1,NASDAQ
5116,16-02-2021 06:00,24 hrs.,wallstreetbets,AMZN,7,7,0,7,1,1,1,1,NASDAQ
5116,16-02-2021 06:00,24 hrs.,wallstreetbets,APHA,18,18,0,18,3,3,0,3,NASDAQ
5116,16-02-2021 06:00,24 hrs.,wallstreetbets,AREC,7,7,0,7,1,1,1,1,NASDAQ
5116,16-02-2021 06:00,24 hrs.,wallstreetbets,ARTL,6,0,6,-6,1,1,0,1,NASDAQ
5116,16-02-2021 06:00,24 hrs.,wallstreetbets,ASRT,7,7,0,7,1,1,1,1,NASDAQ
5116,16-02-2021 06:00,24 hrs.,wallstreetbets,BABA,6,6,0,6,1,1,0,1,NYSE
5116,16-02-2021 06:00,24 hrs.,wallstreetbets,BBAR,6,6,0,6,1,1,0,1,NYSE
5116,16-02-2021 06:00,24 hrs.,wallstreetbets,BORR,7,7,0,7,1,1,1,1,NYSE
5116,16-02-2021 06:00,24 hrs.,wallstreetbets,CCIV,61,41,20,21,9,9,7,8,NYSE
5116,16-02-2021 06:00,24 hrs.,wallstreetbets,LOW,6,6,0,6,1,1,0,1,NYSE
5116,16-02-2021 06:00,24 hrs.,wallstreetbets,LTC,19,19,0,19,3,3,1,2,NYSE
5116,16-02-2021 06:00,24 hrs.,wallstreetbets,LYV,6,6,0,6,1,1,0,1,NYSE
5116,16-02-2021 06:00,24 hrs.,wallstreetbets,MAC,6,0,6,-6,1,1,0,1,NYSE
5116,16-02-2021 06:00,24 hrs.,wallstreetbets,MFT,7,7,0,7,1,1,1,1,NYSE
5116,16-02-2021 06:00,24 hrs.,wallstreetbets,MIN,7,0,7,-7,1,1,1,1,NYSE
5116,16-02-2021 06:00,24 hrs.,wallstreetbets,MLM,8,0,8,-8,1,2,0,1,NYSE
5116,16-02-2021 06:00,24 hrs.,wallstreetbets,MSM,2762,2762,0,2762,1,1291,176,1,NYSE
5116,16-02-2021 06:00,24 hrs.,wallstreetbets,NAT,6,6,0,6,1,1,0,1,NYSE
5116,16-02-2021 06:00,24 hrs.,wallstreetbets,NIO,204,7,197,-190,3,57,78,3,NYSE
5116,16-02-2021 06:00,24 hrs.,wallstreetbets,NOK,190,129,61,68,14,40,54,13,NYSE
5116,16-02-2021 06:00,24 hrs.,wallstreetbets,PBF,7,7,0,7,1,1,1,1,NYSE
5116,16-02-2021 06:00,24 hrs.,wallstreetbets,PFE,69,62,7,55,4,9,35,4,NYSE
5116,16-02-2021 06:00,24 hrs.,wallstreetbets,PSA,7,7,0,7,1,1,1,1,NYSE
5116,16-02-2021 06:00,24 hrs.,wallstreetbets,RBC,54,0,54,-54,1,20,10,1,NYSE
5116,16-02-2021 06:00,24 hrs.,wallstreetbets,RFP,7,0,7,-7,1,1,1,1,NYSE
5116,16-02-2021 06:00,24 hrs.,wallstreetbets,RKT,700,687,13,674,6,223,230,5,NYSE
5116,16-02-2021 06:00,24 hrs.,wallstreetbets,RMO,6,6,0,6,1,1,0,1,NYSE
5116,16-02-2021 06:00,24 hrs.,wallstreetbets,RRC,102,102,0,102,1,9,80,1,NYSE
5116,16-02-2021 06:00,24 hrs.,wallstreetbets,RSI,191,0,191,-191,1,55,77,1,NYSE
5116,16-02-2021 06:00,24 hrs.,wallstreetbets,SNE,7,7,0,7,1,1,1,1,NYSE
5116,16-02-2021 06:00,24 hrs.,wallstreetbets,SOS,46,7,39,-32,7,7,4,5,NYSE
5116,16-02-2021 06:00,24 hrs.,wallstreetbets,EVER,114,0,114,-114,1,45,20,1,NASDAQ
5116,16-02-2021 06:00,24 hrs.,wallstreetbets,EVFM,6,0,6,-6,1,1,0,1,NASDAQ
5116,16-02-2021 06:00,24 hrs.,wallstreetbets,FANG,7,0,7,-7,1,1,1,1,NASDAQ
5116,16-02-2021 06:00,24 hrs.,wallstreetbets,FARM,6,6,0,6,1,1,0,1,NASDAQ
5116,16-02-2021 06:00,24 hrs.,wallstreetbets,FAST,129,0,129,-129,1,0,125,1,NASDAQ
5116,16-02-2021 06:00,24 hrs.,wallstreetbets,FCEL,6,6,0,6,1,1,0,1,NASDAQ
5116,16-02-2021 06:00,24 hrs.,wallstreetbets,FIII,5,5,0,5,1,0,1,1,NASDAQ
5116,16-02-2021 06:00,24 hrs.,wallstreetbets,FORD,129,0,129,-129,1,0,125,1,NASDAQ
5116,16-02-2021 06:00,24 hrs.,wallstreetbets,FROG,6,0,6,-6,1,1,0,1,NASDAQ
5116,16-02-2021 06:00,24 hrs.,wallstreetbets,FUTU,184,0,184,-184,3,49,74,2,NASDAQ
5116,16-02-2021 06:00,24 hrs.,wallstreetbets,GAIN,6,0,6,-6,1,1,0,1,NASDAQ
5116,16-02-2021 06:00,24 hrs.,wallstreetbets,GEVO,7,0,7,-7,1,1,1,1,NASDAQ
5116,16-02-2021 06:00,24 hrs.,wallstreetbets,GILD,6,0,6,-6,1,1,0,1,NASDAQ
5116,16-02-2021 06:00,24 hrs.,wallstreetbets,GLBS,7,7,0,7,1,1,1,1,NASDAQ
5116,16-02-2021 06:00,24 hrs.,wallstreetbets,GNUS,19,19,0,19,3,3,1,2,NASDAQ
5116,16-02-2021 06:00,24 hrs.,wallstreetbets,GOEV,28,22,6,16,4,4,4,3,NASDAQ
5116,16-02-2021 06:00,24 hrs.,wallstreetbets,GOGO,12,6,6,0,2,2,0,2,NASDAQ
5116,16-02-2021 06:00,24 hrs.,wallstreetbets,GOLD,21,14,7,7,3,3,3,3,NASDAQ
5116,16-02-2021 06:00,24 hrs.,wallstreetbets,GRFS,7,7,0,7,1,1,1,1,NASDAQ
5116,16-02-2021 06:00,24 hrs.,wallstreetbets,GTHX,7,7,0,7,1,1,1,1,NASDAQ
5116,16-02-2021 06:00,24 hrs.,wallstreetbets,HDSN,6,6,0,6,1,1,0,1,NASDAQ
5116,16-02-2021 06:00,24 hrs.,wallstreetbets,HEAR,7,0,7,-7,1,1,1,1,NASDAQ
5116,16-02-2021 06:00,24 hrs.,wallstreetbets,ATOM,7,7,0,7,1,1,1,1,NASDAQ
5116,16-02-2021 06:00,24 hrs.,wallstreetbets,ATOS,7,0,7,-7,1,1,1,1,NASDAQ
5116,16-02-2021 06:00,24 hrs.,wallstreetbets,AYTU,8,8,0,8,1,1,2,1,NASDAQ
5116,16-02-2021 06:00,24 hrs.,wallstreetbets,BAND,6,6,0,6,1,1,0,1,NASDAQ
5116,16-02-2021 06:00,24 hrs.,wallstreetbets,BCRX,14,0,14,-14,2,2,2,1,NASDAQ
5116,16-02-2021 06:00,24 hrs.,wallstreetbets,BNGO,34,13,21,-8,5,5,4,5,NASDAQ
5116,16-02-2021 06:00,24 hrs.,wallstreetbets,BNTX,7,7,0,7,1,1,1,1,NASDAQ
5116,16-02-2021 06:00,24 hrs.,wallstreetbets,BXRX,14,0,14,-14,2,2,2,2,NASDAQ
5116,16-02-2021 06:00,24 hrs.,wallstreetbets,CGIX,7,0,7,-7,1,1,1,1,NASDAQ
5116,16-02-2021 06:00,24 hrs.,wallstreetbets,CHKP,103,0,103,-103,1,24,51,1,NASDAQ
5116,16-02-2021 06:00,24 hrs.,wallstreetbets,CLVS,7,0,7,-7,1,1,1,1,NASDAQ
5116,16-02-2021 06:00,24 hrs.,wallstreetbets,CMBM,7,0,7,-7,1,1,1,1,NASDAQ
5116,16-02-2021 06:00,24 hrs.,wallstreetbets,CMPS,7,0,7,-7,1,1,1,1,NASDAQ
5116,16-02-2021 06:00,24 hrs.,wallstreetbets,CRIS,6,6,0,6,1,1,0,1,NASDAQ
5116,16-02-2021 06:00,24 hrs.,wallstreetbets,CRSR,26,26,0,26,4,4,2,4,NASDAQ
5116,16-02-2021 06:00,24 hrs.,wallstreetbets,CSTR,7,7,0,7,1,1,1,1,NASDAQ
5116,16-02-2021 06:00,24 hrs.,wallstreetbets,COTY,92,26,66,-40,7,26,12,4,NYSE
5116,16-02-2021 06:00,24 hrs.,wallstreetbets,CSPR,6,0,6,-6,1,1,0,1,NYSE
5116,16-02-2021 06:00,24 hrs.,wallstreetbets,DASH,14,14,0,14,2,2,2,1,NYSE
5116,16-02-2021 06:00,24 hrs.,wallstreetbets,EVRI,6,6,0,6,1,1,0,1,NYSE
5116,16-02-2021 06:00,24 hrs.,wallstreetbets,FINV,12,12,0,12,2,2,0,1,NYSE
5116,16-02-2021 06:00,24 hrs.,wallstreetbets,FMAC,9,9,0,9,1,1,3,1,NYSE
5116,16-02-2021 06:00,24 hrs.,wallstreetbets,FSLY,101,101,0,101,1,27,43,1,NYSE
5116,16-02-2021 06:00,24 hrs.,wallstreetbets,FUBO,49,49,0,49,7,7,7,4,NYSE
5116,16-02-2021 06:00,24 hrs.,wallstreetbets,FVRR,8,8,0,8,1,1,2,1,NYSE
5116,16-02-2021 06:00,24 hrs.,wallstreetbets,HEXO,9,0,9,-9,1,2,1,1,NYSE
5116,16-02-2021 06:00,24 hrs.,wallstreetbets,HUYA,44,0,44,-44,3,9,14,2,NYSE
5116,16-02-2021 06:00,24 hrs.,wallstreetbets,IPOE,6,6,0,6,1,1,0,1,NYSE
5116,16-02-2021 06:00,24 hrs.,wallstreetbets,KODK,6,0,6,-6,1,1,0,1,NYSE
5116,16-02-2021 06:00,24 hrs.,wallstreetbets,LEAP,7,7,0,7,1,1,1,1,NYSE
5116,16-02-2021 06:00,24 hrs.,wallstreetbets,MSGS,6,6,0,6,1,1,0,1,NYSE
5116,16-02-2021 06:00,24 hrs.,wallstreetbets,PDAC,7,7,0,7,1,1,1,1,NYSE
5116,16-02-2021 06:00,24 hrs.,wallstreetbets,PINS,7,7,0,7,1,1,1,1,NYSE
5116,16-02-2021 06:00,24 hrs.,wallstreetbets,PLTR,32623,21986,10637,11349,54,14597,3213,40,NYSE
5116,16-02-2021 06:00,24 hrs.,wallstreetbets,PSTH,14,0,14,-14,2,3,0,2,NYSE
5116,16-02-2021 06:00,24 hrs.,wallstreetbets,SNPR,6,6,0,6,1,1,0,1,NYSE
5116,16-02-2021 06:00,24 hrs.,wallstreetbets,SPCE,13,7,6,1,2,2,1,2,NYSE
5116,16-02-2021 06:00,24 hrs.,wallstreetbets,TDOC,632,7,625,-618,2,222,180,2,NYSE
5116,16-02-2021 06:00,24 hrs.,wallstreetbets,VALE,363,363,0,363,1,138,83,1,NYSE
5116,16-02-2021 06:00,24 hrs.,wallstreetbets,AAL,26,14,12,2,4,3,4,3,NASDAQ
5116,16-02-2021 06:00,24 hrs.,wallstreetbets,AEP,14,14,0,14,2,2,2,1,NASDAQ
5116,16-02-2021 06:00,24 hrs.,wallstreetbets,ALT,48,48,0,48,1,6,32,1,NASDAQ
5116,16-02-2021 06:00,24 hrs.,RobinHoodPennyStocks,DNN,601,8,593,-585,2,182,229,2,AMEX
5116,16-02-2021 06:00,24 hrs.,RobinHoodPennyStocks,DPW,67,67,0,67,1,29,5,1,AMEX
5116,16-02-2021 06:00,24 hrs.,RobinHoodPennyStocks,GTE,834,115,719,-604,6,252,306,5,AMEX
5116,16-02-2021 06:00,24 hrs.,wallstreetbets,HERD,48,48,0,48,1,6,32,1,NASDAQ
5116,16-02-2021 06:00,24 hrs.,wallstreetbets,HJLI,7,7,0,7,1,1,1,1,NASDAQ
5116,16-02-2021 06:00,24 hrs.,wallstreetbets,HOFV,7,0,7,-7,1,1,1,1,NASDAQ
5116,16-02-2021 06:00,24 hrs.,wallstreetbets,HTGM,13,0,13,-13,2,2,1,1,NASDAQ
5116,16-02-2021 06:00,24 hrs.,wallstreetbets,IDEX,7,7,0,7,1,1,1,1,NASDAQ
5116,16-02-2021 06:00,24 hrs.,wallstreetbets,IMGN,13,13,0,13,2,2,1,1,NASDAQ
5116,16-02-2021 06:00,24 hrs.,wallstreetbets,IMMR,14,7,7,0,2,2,2,2,NASDAQ
5116,16-02-2021 06:00,24 hrs.,wallstreetbets,INFO,1389,0,1389,-1389,1,444,497,1,NASDAQ
5116,16-02-2021 06:00,24 hrs.,wallstreetbets,INPX,7,0,7,-7,1,1,1,1,NASDAQ
5116,16-02-2021 06:00,24 hrs.,wallstreetbets,INTC,188,139,49,90,3,45,86,3,NASDAQ
5116,16-02-2021 06:00,24 hrs.,wallstreetbets,ITRM,6,6,0,6,1,1,0,1,NASDAQ
5116,16-02-2021 06:00,24 hrs.,wallstreetbets,JACK,14,14,0,14,2,2,2,2,NASDAQ
5116,16-02-2021 06:00,24 hrs.,wallstreetbets,JNCE,6,0,6,-6,1,1,0,1,NASDAQ
5116,16-02-2021 06:00,24 hrs.,wallstreetbets,KRMD,7,0,7,-7,1,1,1,1,NASDAQ
5116,16-02-2021 06:00,24 hrs.,wallstreetbets,KTOS,134,134,0,134,3,44,34,2,NASDAQ
5116,16-02-2021 06:00,24 hrs.,wallstreetbets,LCAP,7,7,0,7,1,1,1,1,NASDAQ
5116,16-02-2021 06:00,24 hrs.,wallstreetbets,LKCO,6,6,0,6,1,1,0,1,NASDAQ
5116,16-02-2021 06:00,24 hrs.,wallstreetbets,LOAC,6,6,0,6,1,1,0,1,NASDAQ
5116,16-02-2021 06:00,24 hrs.,wallstreetbets,LOAN,6,6,0,6,1,1,0,1,NASDAQ
5116,16-02-2021 06:00,24 hrs.,wallstreetbets,LPCN,14,0,14,-14,2,2,2,1,NASDAQ
5116,16-02-2021 06:00,24 hrs.,wallstreetbets,MARA,40,40,0,40,5,5,10,4,NASDAQ
5116,16-02-2021 06:00,24 hrs.,wallstreetbets,MBRX,7,0,7,-7,1,1,1,1,NASDAQ
5116,16-02-2021 06:00,24 hrs.,wallstreetbets,MRNA,68,68,0,68,4,9,34,3,NASDAQ
5116,16-02-2021 06:00,24 hrs.,wallstreetbets,MSFT,7,0,7,-7,1,1,1,1,NASDAQ
5116,16-02-2021 06:00,24 hrs.,wallstreetbets,MTCH,7,7,0,7,1,1,1,1,NASDAQ
5116,16-02-2021 06:00,24 hrs.,wallstreetbets,MVIS,26,20,6,14,4,4,2,4,NASDAQ
5116,16-02-2021 06:00,24 hrs.,wallstreetbets,NAKD,20,20,0,20,3,3,2,3,NASDAQ
5116,16-02-2021 06:00,24 hrs.,wallstreetbets,NCLH,101,101,0,101,1,27,43,1,NASDAQ
5116,16-02-2021 06:00,24 hrs.,wallstreetbets,NEPT,7,0,7,-7,1,1,1,1,NASDAQ
5116,16-02-2021 06:00,24 hrs.,wallstreetbets,NKLA,7,7,0,7,1,1,1,1,NASDAQ
5116,16-02-2021 06:00,24 hrs.,wallstreetbets,NMRK,111,111,0,111,1,35,37,1,NASDAQ
5116,16-02-2021 06:00,24 hrs.,wallstreetbets,NMTR,6,6,0,6,1,1,0,1,NASDAQ
5116,16-02-2021 06:00,24 hrs.,wallstreetbets,NNDM,6,6,0,6,1,1,0,1,NASDAQ
5116,16-02-2021 06:00,24 hrs.,wallstreetbets,NVAX,77,77,0,77,5,10,37,4,NASDAQ
5116,16-02-2021 06:00,24 hrs.,wallstreetbets,NVDA,37,37,0,37,1,0,33,1,NASDAQ
5116,16-02-2021 06:00,24 hrs.,wallstreetbets,NVIV,6,6,0,6,1,1,0,1,NASDAQ
5116,16-02-2021 06:00,24 hrs.,wallstreetbets,OCGN,62,49,13,36,9,9,8,7,NASDAQ
5116,16-02-2021 06:00,24 hrs.,wallstreetbets,OIIM,7,7,0,7,1,1,1,1,NASDAQ
5116,16-02-2021 06:00,24 hrs.,wallstreetbets,OLED,5,0,5,-5,1,0,1,1,NASDAQ
5116,16-02-2021 06:00,24 hrs.,wallstreetbets,OSTK,22,16,6,10,3,4,2,2,NASDAQ
5116,16-02-2021 06:00,24 hrs.,wallstreetbets,OTLK,6,0,6,-6,1,1,0,1,NASDAQ
5116,16-02-2021 06:00,24 hrs.,wallstreetbets,PGEN,6,0,6,-6,1,1,0,1,NASDAQ
5116,16-02-2021 06:00,24 hrs.,wallstreetbets,PLUG,317,317,0,317,2,115,79,2,NASDAQ
5116,16-02-2021 06:00,24 hrs.,wallstreetbets,POWW,13,6,7,-1,2,2,1,2,NASDAQ
5116,16-02-2021 06:00,24 hrs.,wallstreetbets,PSEC,6,6,0,6,1,1,0,1,NASDAQ
5116,16-02-2021 06:00,24 hrs.,wallstreetbets,PYPL,13,6,7,-1,2,2,1,2,NASDAQ
5116,16-02-2021 06:00,24 hrs.,wallstreetbets,QLGN,6,0,6,-6,1,1,0,1,NASDAQ
5116,16-02-2021 06:00,24 hrs.,wallstreetbets,RAVE,6,6,0,6,1,1,0,1,NASDAQ
5116,16-02-2021 06:00,24 hrs.,wallstreetbets,REAL,6,0,6,-6,1,1,0,1,NASDAQ
5116,16-02-2021 06:00,24 hrs.,wallstreetbets,RIOT,53,46,7,39,7,7,11,6,NASDAQ
5116,16-02-2021 06:00,24 hrs.,wallstreetbets,RNWK,7,7,0,7,1,1,1,1,NASDAQ
5116,16-02-2021 06:00,24 hrs.,wallstreetbets,ROOT,7,0,7,-7,1,1,1,1,NASDAQ
5116,16-02-2021 06:00,24 hrs.,wallstreetbets,SAVA,12,0,12,-12,2,2,0,1,NASDAQ
5116,16-02-2021 06:00,24 hrs.,wallstreetbets,SAVE,14,14,0,14,2,2,2,2,NASDAQ
5116,16-02-2021 06:00,24 hrs.,wallstreetbets,CTRM,46,5,41,-36,7,6,6,6,NASDAQ
5116,16-02-2021 06:00,24 hrs.,wallstreetbets,DFFN,14,14,0,14,2,2,2,1,NASDAQ
5116,16-02-2021 06:00,24 hrs.,wallstreetbets,DKNG,67,67,0,67,1,20,23,1,NASDAQ
5116,16-02-2021 06:00,24 hrs.,wallstreetbets,DMTK,7,7,0,7,1,1,1,1,NASDAQ
5116,16-02-2021 06:00,24 hrs.,wallstreetbets,EDIT,1552,1552,0,1552,2,588,368,2,NASDAQ
5116,16-02-2021 06:00,24 hrs.,wallstreetbets,ESPR,6,6,0,6,1,1,0,1,NASDAQ
5116,16-02-2021 06:00,24 hrs.,wallstreetbets,ETSY,7,7,0,7,1,1,1,1,NASDAQ
5116,16-02-2021 06:00,24 hrs.,RobinHoodPennyStocks,UAMY,6,0,6,-6,1,1,0,1,AMEX
5116,16-02-2021 06:00,24 hrs.,RobinHoodPennyStocks,UAVS,6,6,0,6,1,1,0,1,AMEX
5116,16-02-2021 06:00,24 hrs.,RobinHoodPennyStocks,XXII,6,0,6,-6,1,1,0,1,AMEX
5116,16-02-2021 06:00,24 hrs.,RobinHoodPennyStocks,ACB,67,67,0,67,1,29,5,1,NYSE
5116,16-02-2021 06:00,24 hrs.,RobinHoodPennyStocks,AMC,6,6,0,6,1,0,2,1,NYSE
5116,16-02-2021 06:00,24 hrs.,RobinHoodPennyStocks,AMP,6,0,6,-6,1,1,0,1,NYSE
5116,16-02-2021 06:00,24 hrs.,RobinHoodPennyStocks,AUY,6,0,6,-6,1,1,0,1,NYSE
5116,16-02-2021 06:00,24 hrs.,RobinHoodPennyStocks,BTU,67,67,0,67,1,29,5,1,NYSE
5116,16-02-2021 06:00,24 hrs.,RobinHoodPennyStocks,CNS,821,821,0,821,1,357,103,1,NYSE
5116,16-02-2021 06:00,24 hrs.,RobinHoodPennyStocks,DSX,67,67,0,67,1,29,5,1,NYSE
5116,16-02-2021 06:00,24 hrs.,RobinHoodPennyStocks,GGB,6,0,6,-6,1,1,0,1,NYSE
5116,16-02-2021 06:00,24 hrs.,RobinHoodPennyStocks,HGV,67,67,0,67,1,29,5,1,NYSE
5116,16-02-2021 06:00,24 hrs.,RobinHoodPennyStocks,HMI,67,67,0,67,1,29,5,1,NYSE
5116,16-02-2021 06:00,24 hrs.,RobinHoodPennyStocks,NIO,6,0,6,-6,1,1,0,1,NYSE
5116,16-02-2021 06:00,24 hrs.,RobinHoodPennyStocks,NOK,6,6,0,6,1,1,0,1,NYSE
5116,16-02-2021 06:00,24 hrs.,RobinHoodPennyStocks,PBR,6,6,0,6,1,1,0,1,NYSE
5116,16-02-2021 06:00,24 hrs.,RobinHoodPennyStocks,PEG,6,0,6,-6,1,1,0,1,NYSE
5116,16-02-2021 06:00,24 hrs.,RobinHoodPennyStocks,PHI,12,6,6,0,2,2,0,2,NYSE
5116,16-02-2021 06:00,24 hrs.,RobinHoodPennyStocks,PVL,67,67,0,67,1,29,5,1,NYSE
5116,16-02-2021 06:00,24 hrs.,RobinHoodPennyStocks,RSI,6,6,0,6,1,1,0,1,NYSE
5116,16-02-2021 06:00,24 hrs.,wallstreetbets,SESN,6,0,6,-6,1,1,0,1,NASDAQ
5116,16-02-2021 06:00,24 hrs.,wallstreetbets,SNDL,1076,362,714,-352,38,229,466,34,NASDAQ
5116,16-02-2021 06:00,24 hrs.,wallstreetbets,SOLO,7,7,0,7,1,1,1,1,NASDAQ
5116,16-02-2021 06:00,24 hrs.,wallstreetbets,SONO,7,7,0,7,1,1,1,1,NASDAQ
5116,16-02-2021 06:00,24 hrs.,wallstreetbets,SPWR,6,6,0,6,1,1,0,1,NASDAQ
5116,16-02-2021 06:00,24 hrs.,wallstreetbets,SRNE,90,48,42,6,7,12,38,3,NASDAQ
5116,16-02-2021 06:00,24 hrs.,wallstreetbets,STLD,363,363,0,363,1,138,83,1,NASDAQ
5116,16-02-2021 06:00,24 hrs.,wallstreetbets,SYBX,6,6,0,6,1,1,0,1,NASDAQ
5116,16-02-2021 06:00,24 hrs.,wallstreetbets,TACO,7,7,0,7,1,1,1,1,NASDAQ
5116,16-02-2021 06:00,24 hrs.,wallstreetbets,TELL,12,6,6,0,2,2,0,2,NASDAQ
5116,16-02-2021 06:00,24 hrs.,wallstreetbets,TGTX,48,48,0,48,1,6,32,1,NASDAQ
5116,16-02-2021 06:00,24 hrs.,wallstreetbets,THCB,7,7,0,7,1,1,1,1,NASDAQ
5116,16-02-2021 06:00,24 hrs.,wallstreetbets,TLGT,7,0,7,-7,1,1,1,1,NASDAQ
5116,16-02-2021 06:00,24 hrs.,wallstreetbets,TLRY,33,20,13,7,5,5,3,5,NASDAQ
5116,16-02-2021 06:00,24 hrs.,wallstreetbets,TNXP,29,29,0,29,4,4,5,4,NASDAQ
5116,16-02-2021 06:00,24 hrs.,wallstreetbets,TOPS,142,15,127,-112,5,49,24,5,NASDAQ
5116,16-02-2021 06:00,24 hrs.,wallstreetbets,TRCH,7,7,0,7,1,1,1,1,NASDAQ
5116,16-02-2021 06:00,24 hrs.,wallstreetbets,TRIT,19,13,6,7,3,3,1,3,NASDAQ
5116,16-02-2021 06:00,24 hrs.,wallstreetbets,TRVG,14,7,7,0,2,2,2,2,NASDAQ
5116,16-02-2021 06:00,24 hrs.,wallstreetbets,TSLA,161,154,7,147,10,50,21,9,NASDAQ
5116,16-02-2021 06:00,24 hrs.,wallstreetbets,TTCF,7,7,0,7,1,1,1,1,NASDAQ
5116,16-02-2021 06:00,24 hrs.,wallstreetbets,TURN,9,0,9,-9,1,2,1,1,NASDAQ
5116,16-02-2021 06:00,24 hrs.,wallstreetbets,TXMD,28,22,6,16,4,5,2,3,NASDAQ
5116,16-02-2021 06:00,24 hrs.,wallstreetbets,UCTT,31,0,31,-31,1,3,21,1,NASDAQ
5116,16-02-2021 06:00,24 hrs.,wallstreetbets,VKTX,7,7,0,7,1,1,1,1,NASDAQ
5116,16-02-2021 06:00,24 hrs.,wallstreetbets,WATT,6,6,0,6,1,1,0,1,NASDAQ
5116,16-02-2021 06:00,24 hrs.,wallstreetbets,XNET,7,7,0,7,1,1,1,1,NASDAQ
5116,16-02-2021 06:00,24 hrs.,wallstreetbets,XSPA,45,20,25,-5,7,7,3,4,NASDAQ
5116,16-02-2021 06:00,24 hrs.,wallstreetbets,ZNGA,7,0,7,-7,1,1,1,1,NASDAQ
5116,16-02-2021 06:00,24 hrs.,wallstreetbets,ZYNE,14,7,7,0,2,2,2,2,NASDAQ
5116,16-02-2021 06:00,24 hrs.,wallstreetbets,GOOGL,6,6,0,6,1,1,0,1,NASDAQ
5116,16-02-2021 06:00,24 hrs.,RobinHoodPennyStocks,ABWN,13,13,0,13,2,2,1,1,OTC
5116,16-02-2021 06:00,24 hrs.,RobinHoodPennyStocks,ALPP,18,18,0,18,3,3,0,1,OTC
5116,16-02-2021 06:00,24 hrs.,RobinHoodPennyStocks,GAXY,8,8,0,8,1,2,0,1,OTC
5116,16-02-2021 06:00,24 hrs.,RobinHoodPennyStocks,HCMC,6,0,6,-6,1,1,0,1,OTC
5116,16-02-2021 06:00,24 hrs.,RobinHoodPennyStocks,PHIL,12,6,6,0,2,2,0,2,OTC
5116,16-02-2021 06:00,24 hrs.,RobinHoodPennyStocks,RVBR,6,6,0,6,1,1,0,1,OTC
5116,16-02-2021 06:00,24 hrs.,RobinHoodPennyStocks,SRMX,16,0,16,-16,1,0,12,1,OTC
5116,16-02-2021 06:00,24 hrs.,RobinHoodPennyStocks,VPER,6,0,6,-6,1,1,0,1,OTC
5116,16-02-2021 06:00,24 hrs.,RobinHoodPennyStocks,BDRBF,6,0,6,-6,1,1,0,1,OTC
5116,16-02-2021 06:00,24 hrs.,RobinHoodPennyStocks,OTIVF,6,0,6,-6,1,1,0,1,OTC
5116,16-02-2021 06:00,24 hrs.,RobinHoodPennyStocks,RNRRF,6,0,6,-6,1,1,0,1,OTC
5116,16-02-2021 06:00,24 hrs.,RobinHoodPennyStocks,RYCEY,37,0,37,-37,1,0,33,1,OTC
5116,16-02-2021 06:00,24 hrs.,RobinHoodPennyStocks,CEI,67,67,0,67,1,29,5,1,AMEX
5116,16-02-2021 06:00,24 hrs.,RobinHoodPennyStocks,WNW,67,67,0,67,1,29,5,1,NASDAQ
5116,16-02-2021 06:00,24 hrs.,RobinHoodPennyStocks,WWR,79,67,12,55,3,31,5,2,NASDAQ
5116,16-02-2021 06:00,24 hrs.,RobinHoodPennyStocks,AACQ,67,67,0,67,1,29,5,1,NASDAQ
5116,16-02-2021 06:00,24 hrs.,RobinHoodPennyStocks,AAPL,67,67,0,67,1,29,5,1,NASDAQ
5116,16-02-2021 06:00,24 hrs.,RobinHoodPennyStocks,ABEO,593,0,593,-593,1,180,229,1,NASDAQ
5116,16-02-2021 06:00,24 hrs.,RobinHoodPennyStocks,ACST,593,0,593,-593,1,180,229,1,NASDAQ
5116,16-02-2021 06:00,24 hrs.,RobinHoodPennyStocks,ADXS,6,6,0,6,1,1,0,1,NASDAQ
5116,16-02-2021 06:00,24 hrs.,RobinHoodPennyStocks,AGTC,2290,2158,132,2026,9,977,300,8,NASDAQ
5116,16-02-2021 06:00,24 hrs.,RobinHoodPennyStocks,AIKI,67,67,0,67,1,29,5,1,NASDAQ
5116,16-02-2021 06:00,24 hrs.,RobinHoodPennyStocks,ALAC,67,67,0,67,1,29,5,1,NASDAQ
5116,16-02-2021 06:00,24 hrs.,RobinHoodPennyStocks,ALJJ,67,67,0,67,1,29,5,1,NASDAQ
5116,16-02-2021 06:00,24 hrs.,RobinHoodPennyStocks,AMTX,67,67,0,67,1,29,5,1,NASDAQ
5116,16-02-2021 06:00,24 hrs.,RobinHoodPennyStocks,AMZN,6,6,0,6,1,1,0,1,NASDAQ
5116,16-02-2021 06:00,24 hrs.,RobinHoodPennyStocks,APHA,67,67,0,67,1,29,5,1,NASDAQ
5116,16-02-2021 06:00,24 hrs.,RobinHoodPennyStocks,ARLP,67,67,0,67,1,29,5,1,NASDAQ
5116,16-02-2021 06:00,24 hrs.,RobinHoodPennyStocks,ARTL,67,67,0,67,1,29,5,1,NASDAQ
5116,16-02-2021 06:00,24 hrs.,RobinHoodPennyStocks,ASRT,831,62,769,-707,4,245,325,4,NASDAQ
5116,16-02-2021 06:00,24 hrs.,RobinHoodPennyStocks,ASRV,50,0,50,-50,1,16,14,1,NASDAQ
5116,16-02-2021 06:00,24 hrs.,RobinHoodPennyStocks,ATOS,18,18,0,18,1,5,4,1,NASDAQ
5116,16-02-2021 06:00,24 hrs.,RobinHoodPennyStocks,BNGO,67,67,0,67,1,29,5,1,NASDAQ
5116,16-02-2021 06:00,24 hrs.,RobinHoodPennyStocks,BOXL,67,67,0,67,1,29,5,1,NASDAQ
5116,16-02-2021 06:00,24 hrs.,RobinHoodPennyStocks,BRQS,193,67,126,-59,2,65,55,2,NASDAQ
5116,16-02-2021 06:00,24 hrs.,RobinHoodPennyStocks,BYFC,67,67,0,67,1,29,5,1,NASDAQ
5116,16-02-2021 06:00,24 hrs.,RobinHoodPennyStocks,CARV,67,67,0,67,1,29,5,1,NASDAQ
5116,16-02-2021 06:00,24 hrs.,RobinHoodPennyStocks,CBAT,67,67,0,67,1,29,5,1,NASDAQ
5116,16-02-2021 06:00,24 hrs.,RobinHoodPennyStocks,CCNC,67,67,0,67,1,29,5,1,NASDAQ
5116,16-02-2021 06:00,24 hrs.,RobinHoodPennyStocks,CIDM,593,0,593,-593,1,180,229,1,NASDAQ
5116,16-02-2021 06:00,24 hrs.,RobinHoodPennyStocks,CLEU,67,67,0,67,1,29,5,1,NASDAQ
5116,16-02-2021 06:00,24 hrs.,RobinHoodPennyStocks,CLSK,67,67,0,67,1,29,5,1,NASDAQ
5116,16-02-2021 06:00,24 hrs.,RobinHoodPennyStocks,CRBP,1540,821,719,102,3,573,382,3,NASDAQ
5116,16-02-2021 06:00,24 hrs.,RobinHoodPennyStocks,CRON,67,67,0,67,1,29,5,1,NASDAQ
5116,16-02-2021 06:00,24 hrs.,RobinHoodPennyStocks,CSTR,12,12,0,12,1,0,8,1,NASDAQ
5116,16-02-2021 06:00,24 hrs.,RobinHoodPennyStocks,CTRM,12,12,0,12,2,2,0,2,NASDAQ
5116,16-02-2021 06:00,24 hrs.,RobinHoodPennyStocks,DFFN,855,80,775,-695,4,244,351,4,NASDAQ
5116,16-02-2021 06:00,24 hrs.,RobinHoodPennyStocks,DZSI,67,67,0,67,1,29,5,1,NASDAQ
5116,16-02-2021 06:00,24 hrs.,RobinHoodPennyStocks,EAST,126,0,126,-126,1,36,50,1,NASDAQ
5116,16-02-2021 06:00,24 hrs.,RobinHoodPennyStocks,EBON,67,67,0,67,1,29,5,1,NASDAQ
5116,16-02-2021 06:00,24 hrs.,RobinHoodPennyStocks,EDRY,67,67,0,67,1,29,5,1,NASDAQ
5116,16-02-2021 06:00,24 hrs.,RobinHoodPennyStocks,EPSN,67,67,0,67,1,29,5,1,NASDAQ
5116,16-02-2021 06:00,24 hrs.,RobinHoodPennyStocks,EQOS,67,67,0,67,1,29,5,1,NASDAQ
5116,16-02-2021 06:00,24 hrs.,RobinHoodPennyStocks,FAMI,67,67,0,67,1,29,5,1,NASDAQ
5116,16-02-2021 06:00,24 hrs.,RobinHoodPennyStocks,FCEL,67,67,0,67,1,29,5,1,NASDAQ
5116,16-02-2021 06:00,24 hrs.,RobinHoodPennyStocks,FLEX,6,0,6,-6,1,1,0,1,NASDAQ
5116,16-02-2021 06:00,24 hrs.,RobinHoodPennyStocks,FORD,67,67,0,67,1,29,5,1,NASDAQ
5116,16-02-2021 06:00,24 hrs.,RobinHoodPennyStocks,GTHX,67,67,0,67,1,29,5,1,NASDAQ
5116,16-02-2021 06:00,24 hrs.,RobinHoodPennyStocks,SIX,67,67,0,67,1,29,5,1,NYSE
5116,16-02-2021 06:00,24 hrs.,RobinHoodPennyStocks,SOS,267,141,126,15,7,77,85,6,NYSE
5116,16-02-2021 06:00,24 hrs.,RobinHoodPennyStocks,THC,821,821,0,821,1,357,103,1,NYSE
5116,16-02-2021 06:00,24 hrs.,RobinHoodPennyStocks,TSM,182,0,182,-182,1,46,86,1,NYSE
5116,16-02-2021 06:00,24 hrs.,RobinHoodPennyStocks,VHC,7,7,0,7,1,1,1,1,NYSE
5116,16-02-2021 06:00,24 hrs.,RobinHoodPennyStocks,IGC,67,67,0,67,1,29,5,1,AMEX
5116,16-02-2021 06:00,24 hrs.,RobinHoodPennyStocks,NAK,6,6,0,6,1,1,0,1,AMEX
5116,16-02-2021 06:00,24 hrs.,RobinHoodPennyStocks,PED,67,67,0,67,1,29,5,1,AMEX
5116,16-02-2021 06:00,24 hrs.,RobinHoodPennyStocks,PTN,651,0,651,-651,2,200,243,2,AMEX
5116,16-02-2021 06:00,24 hrs.,RobinHoodPennyStocks,REI,67,67,0,67,1,29,5,1,AMEX
5116,16-02-2021 06:00,24 hrs.,RobinHoodPennyStocks,SYN,126,0,126,-126,1,36,50,1,AMEX
5116,16-02-2021 06:00,24 hrs.,RobinHoodPennyStocks,ZOM,213,87,126,-39,3,61,79,3,AMEX
5116,16-02-2021 06:00,24 hrs.,RobinHoodPennyStocks,ENSV,67,67,0,67,1,29,5,1,AMEX
5116,16-02-2021 06:00,24 hrs.,RobinHoodPennyStocks,GSAT,67,67,0,67,1,29,5,1,AMEX
5116,16-02-2021 06:00,24 hrs.,RobinHoodPennyStocks,HUSA,67,67,0,67,1,29,5,1,AMEX
5116,16-02-2021 06:00,24 hrs.,RobinHoodPennyStocks,INUV,18,12,6,6,3,3,0,3,AMEX
5116,16-02-2021 06:00,24 hrs.,RobinHoodPennyStocks,SNMP,67,67,0,67,1,29,5,1,AMEX
5116,16-02-2021 06:00,24 hrs.,RobinHoodPennyStocks,TMBR,18,18,0,18,1,5,4,1,AMEX
5116,16-02-2021 06:00,24 hrs.,RobinHoodPennyStocks,TRXC,6,6,0,6,1,1,0,1,AMEX
5116,16-02-2021 06:00,24 hrs.,RobinHoodPennyStocks,METX,67,67,0,67,1,29,5,1,NASDAQ
5116,16-02-2021 06:00,24 hrs.,RobinHoodPennyStocks,MNPR,67,67,0,67,1,29,5,1,NASDAQ
5116,16-02-2021 06:00,24 hrs.,RobinHoodPennyStocks,MOGO,79,79,0,79,2,29,13,2,NASDAQ
5116,16-02-2021 06:00,24 hrs.,RobinHoodPennyStocks,MOSY,6,0,6,-6,1,1,0,1,NASDAQ
5116,16-02-2021 06:00,24 hrs.,RobinHoodPennyStocks,MYSZ,6,0,6,-6,1,1,0,1,NASDAQ
5116,16-02-2021 06:00,24 hrs.,RobinHoodPennyStocks,NAKD,67,67,0,67,1,29,5,1,NASDAQ
5116,16-02-2021 06:00,24 hrs.,RobinHoodPennyStocks,NEOS,6,0,6,-6,1,1,0,1,NASDAQ
5116,16-02-2021 06:00,24 hrs.,RobinHoodPennyStocks,NOVN,193,67,126,-59,2,65,55,2,NASDAQ
5116,16-02-2021 06:00,24 hrs.,RobinHoodPennyStocks,NVAX,67,67,0,67,1,29,5,1,NASDAQ
5116,16-02-2021 06:00,24 hrs.,RobinHoodPennyStocks,NVIV,6,6,0,6,1,1,0,1,NASDAQ
5116,16-02-2021 06:00,24 hrs.,RobinHoodPennyStocks,NXTD,67,67,0,67,1,29,5,1,NASDAQ
5116,16-02-2021 06:00,24 hrs.,RobinHoodPennyStocks,OBSV,64,64,0,64,4,22,4,2,NASDAQ
5116,16-02-2021 06:00,24 hrs.,RobinHoodPennyStocks,OCUL,67,67,0,67,1,29,5,1,NASDAQ
5116,16-02-2021 06:00,24 hrs.,RobinHoodPennyStocks,ONTX,126,0,126,-126,1,36,50,1,NASDAQ
5116,16-02-2021 06:00,24 hrs.,RobinHoodPennyStocks,OPGN,6,6,0,6,1,1,0,1,NASDAQ
5116,16-02-2021 06:00,24 hrs.,RobinHoodPennyStocks,OPTT,67,67,0,67,1,29,5,1,NASDAQ
5116,16-02-2021 06:00,24 hrs.,RobinHoodPennyStocks,PECK,67,67,0,67,1,29,5,1,NASDAQ
5116,16-02-2021 06:00,24 hrs.,RobinHoodPennyStocks,PEIX,67,67,0,67,1,29,5,1,NASDAQ
5116,16-02-2021 06:00,24 hrs.,RobinHoodPennyStocks,PHIO,67,67,0,67,1,29,5,1,NASDAQ
5116,16-02-2021 06:00,24 hrs.,RobinHoodPennyStocks,PHUN,67,67,0,67,1,29,5,1,NASDAQ
5116,16-02-2021 06:00,24 hrs.,RobinHoodPennyStocks,PLUG,67,67,0,67,1,29,5,1,NASDAQ
5116,16-02-2021 06:00,24 hrs.,RobinHoodPennyStocks,PLYA,67,67,0,67,1,29,5,1,NASDAQ
5116,16-02-2021 06:00,24 hrs.,RobinHoodPennyStocks,POWW,40,0,40,-40,1,14,8,1,NASDAQ
5116,16-02-2021 06:00,24 hrs.,RobinHoodPennyStocks,PULM,6,0,6,-6,1,1,0,1,NASDAQ
5116,16-02-2021 06:00,24 hrs.,RobinHoodPennyStocks,RCON,67,67,0,67,1,29,5,1,NASDAQ
5116,16-02-2021 06:00,24 hrs.,RobinHoodPennyStocks,RGLS,6,0,6,-6,1,1,0,1,NASDAQ
5116,16-02-2021 06:00,24 hrs.,RobinHoodPennyStocks,RIOT,105,105,0,105,3,38,17,3,NASDAQ
5116,16-02-2021 06:00,24 hrs.,RobinHoodPennyStocks,SALM,67,67,0,67,1,29,5,1,NASDAQ
5116,16-02-2021 06:00,24 hrs.,RobinHoodPennyStocks,SAVA,193,67,126,-59,2,65,55,2,NASDAQ
5116,16-02-2021 06:00,24 hrs.,RobinHoodPennyStocks,SHIP,79,67,12,55,3,31,5,3,NASDAQ
5116,16-02-2021 06:00,24 hrs.,RobinHoodPennyStocks,SINO,67,67,0,67,1,29,5,1,NASDAQ
5116,16-02-2021 06:00,24 hrs.,RobinHoodPennyStocks,SIRI,6,6,0,6,1,1,0,1,NASDAQ
5116,16-02-2021 06:00,24 hrs.,RobinHoodPennyStocks,SNCA,126,0,126,-126,1,36,50,1,NASDAQ
5116,16-02-2021 06:00,24 hrs.,RobinHoodPennyStocks,SNDL,86,79,7,72,4,32,6,4,NASDAQ
5116,16-02-2021 06:00,24 hrs.,RobinHoodPennyStocks,SNGX,67,67,0,67,1,29,5,1,NASDAQ
5116,16-02-2021 06:00,24 hrs.,RobinHoodPennyStocks,SRGA,126,0,126,-126,1,36,50,1,NASDAQ
5116,16-02-2021 06:00,24 hrs.,RobinHoodPennyStocks,HGEN,67,67,0,67,1,29,5,1,NASDAQ
5116,16-02-2021 06:00,24 hrs.,RobinHoodPennyStocks,HNRG,67,67,0,67,1,29,5,1,NASDAQ
5116,16-02-2021 06:00,24 hrs.,RobinHoodPennyStocks,HSTO,6,0,6,-6,1,1,0,1,NASDAQ
5116,16-02-2021 06:00,24 hrs.,RobinHoodPennyStocks,IDEX,73,73,0,73,2,30,5,2,NASDAQ
5116,16-02-2021 06:00,24 hrs.,RobinHoodPennyStocks,IMTE,67,67,0,67,1,29,5,1,NASDAQ
5116,16-02-2021 06:00,24 hrs.,RobinHoodPennyStocks,IZEA,67,67,0,67,1,29,5,1,NASDAQ
5116,16-02-2021 06:00,24 hrs.,RobinHoodPennyStocks,JAGX,821,821,0,821,1,357,103,1,NASDAQ
5116,16-02-2021 06:00,24 hrs.,RobinHoodPennyStocks,KERN,67,67,0,67,1,29,5,1,NASDAQ
5116,16-02-2021 06:00,24 hrs.,RobinHoodPennyStocks,LKCO,126,0,126,-126,1,36,50,1,NASDAQ
5116,16-02-2021 06:00,24 hrs.,RobinHoodPennyStocks,VST,67,67,0,67,1,29,5,1,NYSE
5116,16-02-2021 06:00,24 hrs.,RobinHoodPennyStocks,ARCH,67,67,0,67,1,29,5,1,NYSE
5116,16-02-2021 06:00,24 hrs.,RobinHoodPennyStocks,CCIV,12,12,0,12,2,2,0,1,NYSE
5116,16-02-2021 06:00,24 hrs.,RobinHoodPennyStocks,CSPR,6,6,0,6,1,1,0,1,NYSE
5116,16-02-2021 06:00,24 hrs.,RobinHoodPennyStocks,HEXO,67,67,0,67,1,29,5,1,NYSE
5116,16-02-2021 06:00,24 hrs.,RobinHoodPennyStocks,IPOE,12,12,0,12,1,0,8,1,NYSE
5116,16-02-2021 06:00,24 hrs.,RobinHoodPennyStocks,CFO,43,6,37,-31,2,1,33,2,NASDAQ
5116,16-02-2021 06:00,24 hrs.,RobinHoodPennyStocks,CGC,67,67,0,67,1,29,5,1,NASDAQ
5116,16-02-2021 06:00,24 hrs.,RobinHoodPennyStocks,ENG,67,67,0,67,1,29,5,1,NASDAQ
5116,16-02-2021 06:00,24 hrs.,RobinHoodPennyStocks,GVP,30,0,30,-30,2,6,10,2,NASDAQ
5116,16-02-2021 06:00,24 hrs.,RobinHoodPennyStocks,HAS,6,0,6,-6,1,1,0,1,NASDAQ
5116,16-02-2021 06:00,24 hrs.,RobinHoodPennyStocks,MGI,67,67,0,67,1,29,5,1,NASDAQ
5116,16-02-2021 06:00,24 hrs.,RobinHoodPennyStocks,NPA,12,12,0,12,1,0,8,1,NASDAQ
5116,16-02-2021 06:00,24 hrs.,RobinHoodPennyStocks,OEG,73,73,0,73,2,30,5,2,NASDAQ
5116,16-02-2021 06:00,24 hrs.,RobinHoodPennyStocks,OGI,67,67,0,67,1,29,5,1,NASDAQ
5116,16-02-2021 06:00,24 hrs.,RobinHoodPennyStocks,PFC,6,6,0,6,1,1,0,1,NASDAQ
5116,16-02-2021 06:00,24 hrs.,RobinHoodPennyStocks,PXS,593,0,593,-593,1,180,229,1,NASDAQ
5116,16-02-2021 06:00,24 hrs.,RobinHoodPennyStocks,SPI,67,67,0,67,1,29,5,1,NASDAQ
5116,16-02-2021 06:00,24 hrs.,RobinHoodPennyStocks,TGA,67,67,0,67,1,29,5,1,NASDAQ
5116,16-02-2021 06:00,24 hrs.,SPACs,THRY,308,308,0,308,1,134,36,1,NASDAQ
5116,16-02-2021 06:00,24 hrs.,SPACs,UNIT,51,51,0,51,1,19,9,1,NASDAQ
5116,16-02-2021 06:00,24 hrs.,SPACs,THCBU,60,0,60,-60,1,17,22,1,NASDAQ
5116,16-02-2021 06:00,24 hrs.,stocks,ALPP,6,0,6,-6,1,1,0,1,OTC
5116,16-02-2021 06:00,24 hrs.,stocks,ASTI,21,0,21,-21,1,3,11,1,OTC
5116,16-02-2021 06:00,24 hrs.,stocks,BLSP,6,0,6,-6,1,1,0,1,OTC
5116,16-02-2021 06:00,24 hrs.,stocks,BNET,6,0,6,-6,1,1,0,1,OTC
5116,16-02-2021 06:00,24 hrs.,stocks,HEMP,6,6,0,6,1,1,0,1,OTC
5116,16-02-2021 06:00,24 hrs.,stocks,ICCT,6,6,0,6,1,1,0,1,OTC
5116,16-02-2021 06:00,24 hrs.,stocks,INKW,6,0,6,-6,1,1,0,1,OTC
5116,16-02-2021 06:00,24 hrs.,stocks,JSDA,33,33,0,33,1,6,17,1,OTC
5116,16-02-2021 06:00,24 hrs.,stocks,LLBO,12,0,12,-12,2,2,0,1,OTC
5116,16-02-2021 06:00,24 hrs.,stocks,MOJO,6,6,0,6,1,1,0,1,OTC
5116,16-02-2021 06:00,24 hrs.,stocks,NWGC,7,7,0,7,1,1,1,1,OTC
5116,16-02-2021 06:00,24 hrs.,SPACs,MGM,51,51,0,51,1,19,9,1,NYSE
5116,16-02-2021 06:00,24 hrs.,SPACs,NAV,315,308,7,301,2,135,37,2,NYSE
5116,16-02-2021 06:00,24 hrs.,SPACs,NOC,58,0,58,-58,1,21,12,1,NYSE
5116,16-02-2021 06:00,24 hrs.,SPACs,NRZ,51,51,0,51,1,19,9,1,NYSE
5116,16-02-2021 06:00,24 hrs.,SPACs,RTP,309,0,309,-309,1,110,85,1,NYSE
5116,16-02-2021 06:00,24 hrs.,SPACs,SBG,80,80,0,80,4,10,44,4,NYSE
5116,16-02-2021 06:00,24 hrs.,SPACs,CAGR,308,308,0,308,1,134,36,1,OTC
5116,16-02-2021 06:00,24 hrs.,SPACs,CDIX,6,6,0,6,1,1,0,1,OTC
5116,16-02-2021 06:00,24 hrs.,SPACs,USPS,177,177,0,177,1,64,45,1,OTC
5116,16-02-2021 06:00,24 hrs.,SPACs,BAESY,58,0,58,-58,1,21,12,1,OTC
5116,16-02-2021 06:00,24 hrs.,SPACs,EADSY,58,0,58,-58,1,21,12,1,OTC
5116,16-02-2021 06:00,24 hrs.,SPACs,LVMHF,15,15,0,15,1,5,1,1,OTC
5116,16-02-2021 06:00,24 hrs.,SPACs,CTO,58,0,58,-58,1,21,12,1,AMEX
5116,16-02-2021 06:00,24 hrs.,SPACs,GSV,51,51,0,51,1,19,9,1,AMEX
5116,16-02-2021 06:00,24 hrs.,SPACs,COHN,18,0,18,-18,1,0,14,1,AMEX
5116,16-02-2021 06:00,24 hrs.,SPACs,AMC,308,308,0,308,1,134,36,1,NYSE
5116,16-02-2021 06:00,24 hrs.,SPACs,APO,188,188,0,188,1,74,36,1,NYSE
5116,16-02-2021 06:00,24 hrs.,SPACs,BLK,188,188,0,188,1,74,36,1,NYSE
5116,16-02-2021 06:00,24 hrs.,SPACs,CAE,58,0,58,-58,1,21,12,1,NYSE
5116,16-02-2021 06:00,24 hrs.,SPACs,CCO,51,51,0,51,1,19,9,1,NYSE
5116,16-02-2021 06:00,24 hrs.,SPACs,COO,58,0,58,-58,1,21,12,1,NYSE
5116,16-02-2021 06:00,24 hrs.,SPACs,EVA,10,10,0,10,1,0,6,1,NYSE
5116,16-02-2021 06:00,24 hrs.,SPACs,FCN,308,308,0,308,1,134,36,1,NYSE
5116,16-02-2021 06:00,24 hrs.,SPACs,FTI,308,308,0,308,1,134,36,1,NYSE
5116,16-02-2021 06:00,24 hrs.,SPACs,GIK,409,409,0,409,2,165,71,2,NYSE
5116,16-02-2021 06:00,24 hrs.,SPACs,GME,617,308,309,-1,2,244,121,2,NYSE
5116,16-02-2021 06:00,24 hrs.,SPACs,HPS,51,51,0,51,1,19,9,1,NYSE
5116,16-02-2021 06:00,24 hrs.,RobinHoodPennyStocks,STAY,67,67,0,67,1,29,5,1,NASDAQ
5116,16-02-2021 06:00,24 hrs.,RobinHoodPennyStocks,SUNW,67,67,0,67,1,29,5,1,NASDAQ
5116,16-02-2021 06:00,24 hrs.,RobinHoodPennyStocks,SYPR,67,67,0,67,1,29,5,1,NASDAQ
5116,16-02-2021 06:00,24 hrs.,RobinHoodPennyStocks,SYTA,67,67,0,67,1,29,5,1,NASDAQ
5116,16-02-2021 06:00,24 hrs.,RobinHoodPennyStocks,TANH,21,21,0,21,1,6,5,1,NASDAQ
5116,16-02-2021 06:00,24 hrs.,RobinHoodPennyStocks,TLRY,67,67,0,67,1,29,5,1,NASDAQ
5116,16-02-2021 06:00,24 hrs.,RobinHoodPennyStocks,TNXP,1602,869,733,136,6,609,360,6,NASDAQ
5116,16-02-2021 06:00,24 hrs.,RobinHoodPennyStocks,TOPS,67,67,0,67,1,29,5,1,NASDAQ
5116,16-02-2021 06:00,24 hrs.,RobinHoodPennyStocks,TRCH,209,67,142,-75,3,65,67,3,NASDAQ
5116,16-02-2021 06:00,24 hrs.,RobinHoodPennyStocks,TXMD,1426,827,599,228,4,539,332,4,NASDAQ
5116,16-02-2021 06:00,24 hrs.,RobinHoodPennyStocks,UONE,67,67,0,67,1,29,5,1,NASDAQ
5116,16-02-2021 06:00,24 hrs.,RobinHoodPennyStocks,USEG,67,67,0,67,1,29,5,1,NASDAQ
5116,16-02-2021 06:00,24 hrs.,RobinHoodPennyStocks,USWS,67,67,0,67,1,29,5,1,NASDAQ
5116,16-02-2021 06:00,24 hrs.,RobinHoodPennyStocks,VERU,67,67,0,67,1,29,5,1,NASDAQ
5116,16-02-2021 06:00,24 hrs.,RobinHoodPennyStocks,VYNE,6,6,0,6,1,1,0,1,NASDAQ
5116,16-02-2021 06:00,24 hrs.,RobinHoodPennyStocks,WATT,67,67,0,67,1,29,5,1,NASDAQ
5116,16-02-2021 06:00,24 hrs.,RobinHoodPennyStocks,WKEY,67,67,0,67,1,29,5,1,NASDAQ
5116,16-02-2021 06:00,24 hrs.,RobinHoodPennyStocks,ZSAN,6,0,6,-6,1,1,0,1,NASDAQ
5116,16-02-2021 06:00,24 hrs.,RobinHoodPennyStocks,MARPS,67,67,0,67,1,29,5,1,NASDAQ
5116,16-02-2021 06:00,24 hrs.,RobinHoodPennyStocks,UONEK,67,67,0,67,1,29,5,1,NASDAQ
5116,16-02-2021 06:00,24 hrs.,RobinHoodPennyStocks,LMFA,67,67,0,67,1,29,5,1,NASDAQ
5116,16-02-2021 06:00,24 hrs.,RobinHoodPennyStocks,LOAC,6,6,0,6,1,1,0,1,NASDAQ
5116,16-02-2021 06:00,24 hrs.,RobinHoodPennyStocks,MARA,105,105,0,105,3,38,17,3,NASDAQ
5116,16-02-2021 06:00,24 hrs.,stocks,AMS,122,122,0,122,1,44,30,1,AMEX
5116,16-02-2021 06:00,24 hrs.,stocks,CTO,122,122,0,122,1,44,30,1,AMEX
5116,16-02-2021 06:00,24 hrs.,stocks,NBA,42,42,0,42,1,15,8,1,AMEX
5116,16-02-2021 06:00,24 hrs.,stocks,WYY,98,98,0,98,1,44,6,1,AMEX
5116,16-02-2021 06:00,24 hrs.,stocks,XXII,6,6,0,6,1,1,0,1,AMEX
5116,16-02-2021 06:00,24 hrs.,stocks,ABC,33,33,0,33,1,6,17,1,NYSE
5116,16-02-2021 06:00,24 hrs.,stocks,AIR,122,122,0,122,1,44,30,1,NYSE
5116,16-02-2021 06:00,24 hrs.,stocks,AMC,104,0,104,-104,3,22,48,2,NYSE
5116,16-02-2021 06:00,24 hrs.,stocks,AVB,10,10,0,10,1,1,4,1,NYSE
5116,16-02-2021 06:00,24 hrs.,stocks,BMY,380,0,380,-380,1,107,162,1,NYSE
5116,16-02-2021 06:00,24 hrs.,stocks,BYD,59,59,0,59,1,9,37,1,NYSE
5116,16-02-2021 06:00,24 hrs.,stocks,CAH,98,98,0,98,1,44,6,1,NYSE
5116,16-02-2021 06:00,24 hrs.,stocks,CCO,355,355,0,355,2,101,145,2,NYSE
5116,16-02-2021 06:00,24 hrs.,stocks,CHL,6,6,0,6,1,1,0,1,NYSE
5116,16-02-2021 06:00,24 hrs.,SPACs,UBS,308,308,0,308,1,134,36,1,NYSE
5116,16-02-2021 06:00,24 hrs.,SPACs,ACIC,415,0,415,-415,3,134,135,3,NYSE
5116,16-02-2021 06:00,24 hrs.,SPACs,APSG,188,188,0,188,1,74,36,1,NYSE
5116,16-02-2021 06:00,24 hrs.,SPACs,BOAC,6,6,0,6,1,1,0,1,NYSE
5116,16-02-2021 06:00,24 hrs.,SPACs,CCIV,1223,907,316,591,10,439,305,10,NYSE
5116,16-02-2021 06:00,24 hrs.,SPACs,CTAC,8,8,0,8,1,1,2,1,NYSE
5116,16-02-2021 06:00,24 hrs.,SPACs,DNMR,309,0,309,-309,1,110,85,1,NYSE
5116,16-02-2021 06:00,24 hrs.,SPACs,FGNA,309,0,309,-309,1,110,85,1,NYSE
5116,16-02-2021 06:00,24 hrs.,SPACs,FUSE,349,40,309,-269,2,118,105,2,NYSE
5116,16-02-2021 06:00,24 hrs.,SPACs,IPOD,30,30,0,30,1,4,18,1,NYSE
5116,16-02-2021 06:00,24 hrs.,SPACs,IPOE,325,147,178,-31,6,71,159,6,NYSE
5116,16-02-2021 06:00,24 hrs.,SPACs,IPOF,37,37,0,37,2,5,19,2,NYSE
5116,16-02-2021 06:00,24 hrs.,SPACs,LXFR,308,308,0,308,1,134,36,1,NYSE
5116,16-02-2021 06:00,24 hrs.,SPACs,PDAC,596,596,0,596,10,222,112,7,NYSE
5116,16-02-2021 06:00,24 hrs.,SPACs,PSTH,328,12,316,-304,4,113,86,3,NYSE
5116,16-02-2021 06:00,24 hrs.,SPACs,SNPR,309,0,309,-309,1,110,85,1,NYSE
5116,16-02-2021 06:00,24 hrs.,SPACs,UBER,58,0,58,-58,1,21,12,1,NYSE
5116,16-02-2021 06:00,24 hrs.,SPACs,CFO,51,51,0,51,1,19,9,1,NASDAQ
5116,16-02-2021 06:00,24 hrs.,SPACs,III,188,188,0,188,1,74,36,1,NASDAQ
5116,16-02-2021 06:00,24 hrs.,SPACs,JAN,39,0,39,-39,1,16,3,1,NASDAQ
5116,16-02-2021 06:00,24 hrs.,SPACs,VIH,117,117,0,117,2,35,39,2,NASDAQ
5116,16-02-2021 06:00,24 hrs.,SPACs,AACQ,309,0,309,-309,1,110,85,1,NASDAQ
5116,16-02-2021 06:00,24 hrs.,SPACs,ARYA,309,0,309,-309,1,110,85,1,NASDAQ
5116,16-02-2021 06:00,24 hrs.,SPACs,BTWN,40,40,0,40,1,11,14,1,NASDAQ
5116,16-02-2021 06:00,24 hrs.,SPACs,CIIC,46,0,46,-46,1,9,24,1,NASDAQ
5116,16-02-2021 06:00,24 hrs.,SPACs,CMLF,309,0,309,-309,1,110,85,1,NASDAQ
5116,16-02-2021 06:00,24 hrs.,SPACs,DCRB,309,0,309,-309,1,110,85,1,NASDAQ
5116,16-02-2021 06:00,24 hrs.,SPACs,ETAC,7,7,0,7,1,1,1,1,NASDAQ
5116,16-02-2021 06:00,24 hrs.,SPACs,EXPC,109,10,99,-89,2,23,55,2,NASDAQ
5116,16-02-2021 06:00,24 hrs.,SPACs,FCAC,309,0,309,-309,1,110,85,1,NASDAQ
5116,16-02-2021 06:00,24 hrs.,SPACs,FCEL,15,0,15,-15,1,4,3,1,NASDAQ
5116,16-02-2021 06:00,24 hrs.,SPACs,FIII,7,7,0,7,1,1,1,1,NASDAQ
5116,16-02-2021 06:00,24 hrs.,SPACs,GRNV,309,0,309,-309,1,110,85,1,NASDAQ
5116,16-02-2021 06:00,24 hrs.,SPACs,GRSV,309,0,309,-309,1,110,85,1,NASDAQ
5116,16-02-2021 06:00,24 hrs.,SPACs,HTOO,15,0,15,-15,1,4,3,1,NASDAQ
5116,16-02-2021 06:00,24 hrs.,SPACs,HYMC,308,308,0,308,1,134,36,1,NASDAQ
5116,16-02-2021 06:00,24 hrs.,SPACs,INAQ,309,0,309,-309,1,110,85,1,NASDAQ
5116,16-02-2021 06:00,24 hrs.,SPACs,JCIC,51,51,0,51,1,19,9,1,NASDAQ
5116,16-02-2021 06:00,24 hrs.,SPACs,KERN,14,14,0,14,1,0,10,1,NASDAQ
5116,16-02-2021 06:00,24 hrs.,SPACs,LEGO,51,51,0,51,1,19,9,1,NASDAQ
5116,16-02-2021 06:00,24 hrs.,SPACs,LOAC,6,6,0,6,1,1,0,1,NASDAQ
5116,16-02-2021 06:00,24 hrs.,SPACs,MCAC,309,0,309,-309,1,110,85,1,NASDAQ
5116,16-02-2021 06:00,24 hrs.,SPACs,NBAC,39,0,39,-39,1,16,3,1,NASDAQ
5116,16-02-2021 06:00,24 hrs.,SPACs,NGAC,323,0,323,-323,3,112,87,2,NASDAQ
5116,16-02-2021 06:00,24 hrs.,SPACs,NKLA,15,0,15,-15,1,4,3,1,NASDAQ
5116,16-02-2021 06:00,24 hrs.,SPACs,PLUG,15,0,15,-15,1,4,3,1,NASDAQ
5116,16-02-2021 06:00,24 hrs.,SPACs,QELL,106,0,106,-106,2,24,50,2,NASDAQ
5116,16-02-2021 06:00,24 hrs.,SPACs,SAII,51,51,0,51,1,19,9,1,NASDAQ
5116,16-02-2021 06:00,24 hrs.,SPACs,THBR,7,7,0,7,1,1,1,1,NASDAQ
5116,16-02-2021 06:00,24 hrs.,SPACs,THCB,251,251,0,251,4,75,85,2,NASDAQ
5116,16-02-2021 06:00,24 hrs.,stocks,CDK,122,122,0,122,1,44,30,1,NASDAQ
5116,16-02-2021 06:00,24 hrs.,stocks,CFO,144,122,22,100,2,49,38,2,NASDAQ
5116,16-02-2021 06:00,24 hrs.,stocks,ESG,15,15,0,15,1,4,3,1,NASDAQ
5116,16-02-2021 06:00,24 hrs.,stocks,HAS,6,6,0,6,1,1,0,1,NASDAQ
5116,16-02-2021 06:00,24 hrs.,stocks,III,122,122,0,122,1,44,30,1,NASDAQ
5116,16-02-2021 06:00,24 hrs.,stocks,QQQ,40,40,0,40,1,7,22,1,NASDAQ
5116,16-02-2021 06:00,24 hrs.,stocks,AAPL,354,173,181,-8,3,89,164,3,NASDAQ
5116,16-02-2021 06:00,24 hrs.,stocks,ABNB,62,0,62,-62,1,0,58,1,NASDAQ
5116,16-02-2021 06:00,24 hrs.,stocks,AKTS,98,98,0,98,1,44,6,1,NASDAQ
5116,16-02-2021 06:00,24 hrs.,stocks,ALSK,6,6,0,6,1,1,0,1,NASDAQ
5116,16-02-2021 06:00,24 hrs.,stocks,AMZN,181,0,181,-181,1,40,97,1,NASDAQ
5116,16-02-2021 06:00,24 hrs.,stocks,APHA,32,32,0,32,1,4,20,1,NASDAQ
5116,16-02-2021 06:00,24 hrs.,stocks,ARDX,98,98,0,98,1,44,6,1,NASDAQ
5116,16-02-2021 06:00,24 hrs.,stocks,ARTL,6,6,0,6,1,1,0,1,NASDAQ
5116,16-02-2021 06:00,24 hrs.,stocks,ATVI,27,27,0,27,1,6,11,1,NASDAQ
5116,16-02-2021 06:00,24 hrs.,stocks,AUPH,12,0,12,-12,1,2,4,1,NASDAQ
5116,16-02-2021 06:00,24 hrs.,stocks,BNGO,6,6,0,6,1,1,0,1,NASDAQ
5116,16-02-2021 06:00,24 hrs.,stocks,CHKP,12,12,0,12,2,2,0,1,NASDAQ
5116,16-02-2021 06:00,24 hrs.,stocks,CIBR,67,67,0,67,1,18,27,1,NASDAQ
5116,16-02-2021 06:00,24 hrs.,stocks,CMBM,9,0,9,-9,1,2,1,1,NASDAQ
5116,16-02-2021 06:00,24 hrs.,stocks,CMPS,12,12,0,12,2,2,0,1,NASDAQ
5116,16-02-2021 06:00,24 hrs.,stocks,CNDT,6,0,6,-6,1,1,0,1,NASDAQ
5116,16-02-2021 06:00,24 hrs.,stocks,CRSP,6,6,0,6,1,1,0,1,NASDAQ
5116,16-02-2021 06:00,24 hrs.,stocks,CRSR,103,97,6,91,3,26,39,3,NASDAQ
5116,16-02-2021 06:00,24 hrs.,stocks,CRWD,12,12,0,12,2,2,0,1,NASDAQ
5116,16-02-2021 06:00,24 hrs.,stocks,CTRM,6,6,0,6,1,1,0,1,NASDAQ
5116,16-02-2021 06:00,24 hrs.,stocks,DKNG,42,42,0,42,1,15,8,1,NASDAQ
5116,16-02-2021 06:00,24 hrs.,stocks,DLTR,19,19,0,19,1,4,7,1,NASDAQ
5116,16-02-2021 06:00,24 hrs.,stocks,DRIV,194,67,127,-60,2,57,72,2,NASDAQ
5116,16-02-2021 06:00,24 hrs.,stocks,EDIT,343,115,228,-113,3,95,141,3,NASDAQ
5116,16-02-2021 06:00,24 hrs.,stocks,ESPO,15,0,15,-15,1,3,5,1,NASDAQ
5116,16-02-2021 06:00,24 hrs.,stocks,FATE,388,388,0,388,1,130,124,1,NASDAQ
5116,16-02-2021 06:00,24 hrs.,stocks,FIII,140,140,0,140,4,47,30,2,NASDAQ
5116,16-02-2021 06:00,24 hrs.,stocks,FLIR,388,388,0,388,1,130,124,1,NASDAQ
5116,16-02-2021 06:00,24 hrs.,stocks,GILD,4,4,0,4,1,0,0,1,NASDAQ
5116,16-02-2021 06:00,24 hrs.,stocks,GOGO,6,6,0,6,1,1,0,1,NASDAQ
5116,16-02-2021 06:00,24 hrs.,stocks,GPRO,6,6,0,6,1,1,0,1,NASDAQ
5116,16-02-2021 06:00,24 hrs.,stocks,GTHX,52,0,52,-52,1,21,6,1,NASDAQ
5116,16-02-2021 06:00,24 hrs.,stocks,HLIT,98,98,0,98,1,44,6,1,NASDAQ
5116,16-02-2021 06:00,24 hrs.,stocks,COO,355,355,0,355,2,101,145,2,NYSE
5116,16-02-2021 06:00,24 hrs.,stocks,CPT,10,10,0,10,1,1,4,1,NYSE
5116,16-02-2021 06:00,24 hrs.,stocks,CVX,380,0,380,-380,1,107,162,1,NYSE
5116,16-02-2021 06:00,24 hrs.,stocks,DIS,596,35,561,-526,3,153,278,3,NYSE
5116,16-02-2021 06:00,24 hrs.,stocks,EAT,6,6,0,6,1,1,0,1,NYSE
5116,16-02-2021 06:00,24 hrs.,stocks,ELY,46,46,0,46,2,11,16,1,NYSE
5116,16-02-2021 06:00,24 hrs.,stocks,EMP,98,98,0,98,1,44,6,1,NYSE
5116,16-02-2021 06:00,24 hrs.,stocks,EQR,10,10,0,10,1,1,4,1,NYSE
5116,16-02-2021 06:00,24 hrs.,stocks,ESS,10,10,0,10,1,1,4,1,NYSE
5116,16-02-2021 06:00,24 hrs.,stocks,FSR,122,122,0,122,1,44,30,1,NYSE
5116,16-02-2021 06:00,24 hrs.,stocks,GIK,122,122,0,122,1,44,30,1,NYSE
5116,16-02-2021 06:00,24 hrs.,stocks,GME,278,161,117,44,7,66,118,6,NYSE
5116,16-02-2021 06:00,24 hrs.,stocks,HBI,122,122,0,122,1,44,30,1,NYSE
5116,16-02-2021 06:00,24 hrs.,stocks,ICE,66,0,66,-66,1,5,52,1,NYSE
5116,16-02-2021 06:00,24 hrs.,stocks,JPM,380,0,380,-380,1,107,162,1,NYSE
5116,16-02-2021 06:00,24 hrs.,stocks,LAC,6,6,0,6,1,1,0,1,NYSE
5116,16-02-2021 06:00,24 hrs.,stocks,PURE,388,388,0,388,1,130,124,1,OTC
5116,16-02-2021 06:00,24 hrs.,stocks,ROTH,16,16,0,16,1,6,0,1,OTC
5116,16-02-2021 06:00,24 hrs.,stocks,SGMD,6,0,6,-6,1,1,0,1,OTC
5116,16-02-2021 06:00,24 hrs.,stocks,USPS,122,122,0,122,1,44,30,1,OTC
5116,16-02-2021 06:00,24 hrs.,stocks,VITX,6,0,6,-6,1,1,0,1,OTC
5116,16-02-2021 06:00,24 hrs.,stocks,HVBTF,6,6,0,6,1,1,0,1,OTC
5116,16-02-2021 06:00,24 hrs.,stocks,LMRMF,6,6,0,6,1,1,0,1,OTC
5116,16-02-2021 06:00,24 hrs.,stocks,NTDOY,27,27,0,27,1,6,11,1,OTC
5116,16-02-2021 06:00,24 hrs.,stocks,RYCEY,10,0,10,-10,1,1,4,1,OTC
5116,16-02-2021 06:00,24 hrs.,stocks,PYPL,442,0,442,-442,2,107,220,2,NASDAQ
5116,16-02-2021 06:00,24 hrs.,stocks,QQQM,40,40,0,40,1,7,22,1,NASDAQ
5116,16-02-2021 06:00,24 hrs.,stocks,RIDE,7,0,7,-7,1,1,1,1,NASDAQ
5116,16-02-2021 06:00,24 hrs.,stocks,ROKU,388,388,0,388,1,130,124,1,NASDAQ
5116,16-02-2021 06:00,24 hrs.,stocks,SEER,6,6,0,6,1,1,0,1,NASDAQ
5116,16-02-2021 06:00,24 hrs.,stocks,SNDL,12,6,6,0,2,2,0,2,NASDAQ
5116,16-02-2021 06:00,24 hrs.,stocks,SONO,6,6,0,6,1,1,0,1,NASDAQ
5116,16-02-2021 06:00,24 hrs.,stocks,SRNE,6,6,0,6,1,1,0,1,NASDAQ
5116,16-02-2021 06:00,24 hrs.,stocks,SSPK,19,19,0,19,2,5,1,2,NASDAQ
5116,16-02-2021 06:00,24 hrs.,stocks,SURF,12,12,0,12,2,2,0,1,NASDAQ
5116,16-02-2021 06:00,24 hrs.,stocks,SWBI,7,0,7,-7,1,1,1,1,NASDAQ
5116,16-02-2021 06:00,24 hrs.,stocks,TNXP,6,0,6,-6,1,1,0,1,NASDAQ
5116,16-02-2021 06:00,24 hrs.,stocks,TSLA,484,104,380,-276,3,124,224,3,NASDAQ
5116,16-02-2021 06:00,24 hrs.,stocks,TTCF,122,122,0,122,1,44,30,1,NASDAQ
5116,16-02-2021 06:00,24 hrs.,stocks,TXMD,10,10,0,10,1,3,0,1,NASDAQ
5116,16-02-2021 06:00,24 hrs.,stocks,UCTT,4,0,4,-4,1,0,0,1,NASDAQ
5116,16-02-2021 06:00,24 hrs.,stocks,UHAL,10,10,0,10,1,3,0,1,NASDAQ
5116,16-02-2021 06:00,24 hrs.,stocks,VLDR,9,9,0,9,1,0,5,1,NASDAQ
5116,16-02-2021 06:00,24 hrs.,stocks,VTWO,5,0,5,-5,1,0,1,1,NASDAQ
5116,16-02-2021 06:00,24 hrs.,stocks,VXUS,16,16,0,16,1,6,0,1,NASDAQ
5116,16-02-2021 06:00,24 hrs.,stocks,WKHS,86,0,86,-86,1,26,30,1,NASDAQ
5116,16-02-2021 06:00,24 hrs.,stocks,GOOGL,380,0,380,-380,1,107,162,1,NASDAQ
5116,16-02-2021 06:00,24 hrs.,Daytrading,BLSP,6,0,6,-6,1,1,0,1,OTC
5116,16-02-2021 06:00,24 hrs.,Daytrading,COMS,94,0,94,-94,1,31,28,1,OTC
5116,16-02-2021 06:00,24 hrs.,Daytrading,DIS,41,0,41,-41,1,12,13,1,NYSE
5116,16-02-2021 06:00,24 hrs.,Daytrading,ETH,6,0,6,-6,1,1,0,1,NYSE
5116,16-02-2021 06:00,24 hrs.,stocks,ICLN,73,67,6,61,2,19,27,2,NASDAQ
5116,16-02-2021 06:00,24 hrs.,stocks,IZEA,6,6,0,6,1,1,0,1,NASDAQ
5116,16-02-2021 06:00,24 hrs.,stocks,LOAC,6,6,0,6,1,1,0,1,NASDAQ
5116,16-02-2021 06:00,24 hrs.,stocks,MBII,6,0,6,-6,1,1,0,1,NASDAQ
5116,16-02-2021 06:00,24 hrs.,stocks,MSFT,59,0,59,-59,1,14,27,1,NASDAQ
5116,16-02-2021 06:00,24 hrs.,stocks,NDAQ,15,15,0,15,1,4,3,1,NASDAQ
5116,16-02-2021 06:00,24 hrs.,stocks,NNDM,18,12,6,6,3,3,0,3,NASDAQ
5116,16-02-2021 06:00,24 hrs.,stocks,OLLI,19,19,0,19,1,4,7,1,NASDAQ
5116,16-02-2021 06:00,24 hrs.,stocks,OTLK,6,0,6,-6,1,1,0,1,NASDAQ
5116,16-02-2021 06:00,24 hrs.,stocks,PAVM,6,6,0,6,1,1,0,1,NASDAQ
5116,16-02-2021 06:00,24 hrs.,stocks,PENN,12,12,0,12,1,1,6,1,NASDAQ
5116,16-02-2021 06:00,24 hrs.,stocks,PERI,6,6,0,6,1,1,0,1,NASDAQ
5116,16-02-2021 06:00,24 hrs.,stocks,PLUG,6,6,0,6,1,1,0,1,NASDAQ
5116,16-02-2021 06:00,24 hrs.,stocks,LYV,6,6,0,6,1,1,0,1,NYSE
5116,16-02-2021 06:00,24 hrs.,stocks,MAA,10,10,0,10,1,1,4,1,NYSE
5116,16-02-2021 06:00,24 hrs.,stocks,MAS,98,98,0,98,1,44,6,1,NYSE
5116,16-02-2021 06:00,24 hrs.,stocks,MLM,6,0,6,-6,1,1,0,1,NYSE
5116,16-02-2021 06:00,24 hrs.,stocks,MRK,380,0,380,-380,1,107,162,1,NYSE
5116,16-02-2021 06:00,24 hrs.,stocks,NIO,409,0,409,-409,1,156,93,1,NYSE
5116,16-02-2021 06:00,24 hrs.,stocks,NOK,67,67,0,67,1,18,27,1,NYSE
5116,16-02-2021 06:00,24 hrs.,stocks,PFE,12,12,0,12,2,2,0,1,NYSE
5116,16-02-2021 06:00,24 hrs.,stocks,PGR,17,17,0,17,1,5,3,1,NYSE
5116,16-02-2021 06:00,24 hrs.,stocks,PSX,380,0,380,-380,1,107,162,1,NYSE
5116,16-02-2021 06:00,24 hrs.,stocks,RSI,98,98,0,98,1,44,6,1,NYSE
5116,16-02-2021 06:00,24 hrs.,stocks,SOI,7,0,7,-7,1,1,1,1,NYSE
5116,16-02-2021 06:00,24 hrs.,stocks,TSM,50,50,0,50,1,18,10,1,NYSE
5116,16-02-2021 06:00,24 hrs.,stocks,UBS,122,122,0,122,1,44,30,1,NYSE
5116,16-02-2021 06:00,24 hrs.,stocks,UPS,122,122,0,122,1,44,30,1,NYSE
5116,16-02-2021 06:00,24 hrs.,stocks,WFC,380,0,380,-380,1,107,162,1,NYSE
5116,16-02-2021 06:00,24 hrs.,stocks,WMT,19,19,0,19,1,4,7,1,NYSE
5116,16-02-2021 06:00,24 hrs.,stocks,XOM,380,0,380,-380,1,107,162,1,NYSE
5116,16-02-2021 06:00,24 hrs.,stocks,ABBV,380,0,380,-380,1,107,162,1,NYSE
5116,16-02-2021 06:00,24 hrs.,stocks,CSPR,6,6,0,6,1,1,0,1,NYSE
5116,16-02-2021 06:00,24 hrs.,stocks,DASH,62,0,62,-62,1,0,58,1,NYSE
5116,16-02-2021 06:00,24 hrs.,stocks,PLTR,101,6,95,-89,3,10,69,3,NYSE
5116,16-02-2021 06:00,24 hrs.,stocks,SNAP,388,388,0,388,1,130,124,1,NYSE
5116,16-02-2021 06:00,24 hrs.,stocks,SPCE,106,106,0,106,3,38,18,2,NYSE
5116,16-02-2021 06:00,24 hrs.,stocks,AMD,12,0,12,-12,2,2,0,2,NASDAQ
5116,16-02-2021 06:00,24 hrs.,Daytrading,PDT,1036,1036,0,1036,2,449,130,2,NYSE
5116,16-02-2021 06:00,24 hrs.,Daytrading,RKT,41,0,41,-41,1,12,13,1,NYSE
5116,16-02-2021 06:00,24 hrs.,Daytrading,RSI,270,0,270,-270,2,115,32,2,NYSE
5116,16-02-2021 06:00,24 hrs.,Daytrading,SOS,6,6,0,6,1,1,0,1,NYSE
5116,16-02-2021 06:00,24 hrs.,Daytrading,TDA,21,0,21,-21,1,4,9,1,NYSE
5116,16-02-2021 06:00,24 hrs.,Daytrading,FUBO,41,0,41,-41,1,12,13,1,NYSE
5116,16-02-2021 06:00,24 hrs.,Daytrading,HEXO,41,0,41,-41,1,12,13,1,NYSE
5116,16-02-2021 06:00,24 hrs.,Daytrading,PLTR,41,0,41,-41,1,12,13,1,NYSE
5116,16-02-2021 06:00,24 hrs.,Daytrading,TALO,6,6,0,6,1,1,0,1,NYSE
5116,16-02-2021 06:00,24 hrs.,Daytrading,API,11,0,11,-11,1,3,1,1,NASDAQ
5116,16-02-2021 06:00,24 hrs.,Daytrading,ACIU,94,0,94,-94,1,31,28,1,NASDAQ
5116,16-02-2021 06:00,24 hrs.,Daytrading,AOSL,41,0,41,-41,1,12,13,1,NASDAQ
5116,16-02-2021 06:00,24 hrs.,Daytrading,APHA,41,0,41,-41,1,12,13,1,NASDAQ
5116,16-02-2021 06:00,24 hrs.,Daytrading,CASH,16,16,0,16,1,3,6,1,NASDAQ
5116,16-02-2021 06:00,24 hrs.,Daytrading,CRBP,94,0,94,-94,1,31,28,1,NASDAQ
5116,16-02-2021 06:00,24 hrs.,Daytrading,CROX,41,0,41,-41,1,12,13,1,NASDAQ
5116,16-02-2021 06:00,24 hrs.,Daytrading,DKNG,41,0,41,-41,1,12,13,1,NASDAQ
5116,16-02-2021 06:00,24 hrs.,Daytrading,FORD,42,0,42,-42,1,16,6,1,NASDAQ
5116,16-02-2021 06:00,24 hrs.,Daytrading,GOGO,42,0,42,-42,1,16,6,1,NASDAQ
5116,16-02-2021 06:00,24 hrs.,Daytrading,IBKR,19,0,19,-19,1,2,11,1,NASDAQ
5116,16-02-2021 06:00,24 hrs.,Daytrading,LOAC,6,6,0,6,1,1,0,1,NASDAQ
5116,16-02-2021 06:00,24 hrs.,Daytrading,MARA,6,6,0,6,1,1,0,1,NASDAQ
5116,16-02-2021 06:00,24 hrs.,Daytrading,NOVN,94,0,94,-94,1,31,28,1,NASDAQ
5116,16-02-2021 06:00,24 hrs.,Daytrading,PATI,42,0,42,-42,1,16,6,1,NASDAQ
5116,16-02-2021 06:00,24 hrs.,Daytrading,PBTS,42,0,42,-42,1,16,6,1,NASDAQ
5116,16-02-2021 06:00,24 hrs.,Daytrading,PRTA,94,0,94,-94,1,31,28,1,NASDAQ
5116,16-02-2021 06:00,24 hrs.,Daytrading,RIOT,6,6,0,6,1,1,0,1,NASDAQ
5116,16-02-2021 06:00,24 hrs.,Daytrading,SAVA,6,0,6,-6,1,1,0,1,NASDAQ
5116,16-02-2021 06:00,24 hrs.,Daytrading,SNDL,12,6,6,0,2,2,0,2,NASDAQ
5116,16-02-2021 06:00,24 hrs.,Daytrading,SSKN,42,0,42,-42,1,16,6,1,NASDAQ
5116,16-02-2021 06:00,24 hrs.,Daytrading,TLRY,41,0,41,-41,1,12,13,1,NASDAQ
5116,16-02-2021 06:00,24 hrs.,Daytrading,TNXP,70,0,70,-70,1,29,8,1,NASDAQ
5116,16-02-2021 06:00,24 hrs.,Daytrading,TOPS,42,0,42,-42,1,16,6,1,NASDAQ
5116,16-02-2021 06:00,24 hrs.,Daytrading,TRCH,94,0,94,-94,1,31,28,1,NASDAQ
5116,16-02-2021 06:00,24 hrs.,Daytrading,TWIN,42,0,42,-42,1,16,6,1,NASDAQ
5116,16-02-2021 06:00,24 hrs.,Daytrading,VISL,94,0,94,-94,1,31,28,1,NASDAQ
5116,16-02-2021 06:00,24 hrs.,trakstocks,ABML,21,21,0,21,1,5,7,1,OTC
5116,16-02-2021 06:00,24 hrs.,trakstocks,BOTH,49,49,0,49,2,18,5,1,OTC
5116,16-02-2021 06:00,24 hrs.,trakstocks,COMS,85,85,0,85,1,26,29,1,OTC
5116,16-02-2021 06:00,24 hrs.,trakstocks,EMBI,6,6,0,6,1,1,0,1,OTC
5116,16-02-2021 06:00,24 hrs.,trakstocks,GMEV,10,10,0,10,1,3,0,1,OTC
5116,16-02-2021 06:00,24 hrs.,trakstocks,INND,38,0,38,-38,1,8,18,1,OTC
5116,16-02-2021 06:00,24 hrs.,trakstocks,MOST,6,6,0,6,1,1,0,1,OTC
5116,16-02-2021 06:00,24 hrs.,trakstocks,NOUV,6,6,0,6,1,1,0,1,OTC
5116,16-02-2021 06:00,24 hrs.,trakstocks,OPTI,10,10,0,10,1,3,0,1,OTC
5116,16-02-2021 06:00,24 hrs.,trakstocks,OZSC,38,0,38,-38,1,8,18,1,OTC
5116,16-02-2021 06:00,24 hrs.,trakstocks,SNPW,27,27,0,27,1,11,1,1,OTC
5116,16-02-2021 06:00,24 hrs.,trakstocks,SRMX,38,0,38,-38,1,8,18,1,OTC
5116,16-02-2021 06:00,24 hrs.,trakstocks,SSFT,8,0,8,-8,1,0,4,1,OTC
5116,16-02-2021 06:00,24 hrs.,trakstocks,ARBKF,6,6,0,6,1,1,0,1,OTC
5116,16-02-2021 06:00,24 hrs.,trakstocks,FUNFF,6,6,0,6,1,1,0,1,OTC
5116,16-02-2021 06:00,24 hrs.,trakstocks,SENS,202,0,202,-202,1,83,32,1,AMEX
5116,16-02-2021 06:00,24 hrs.,trakstocks,MEG,18,18,0,18,1,6,2,1,NYSE
5116,16-02-2021 06:00,24 hrs.,trakstocks,THC,6,6,0,6,1,1,0,1,NYSE
5116,16-02-2021 06:00,24 hrs.,trakstocks,ALLY,18,18,0,18,1,6,2,1,NYSE
5116,16-02-2021 06:00,24 hrs.,trakstocks,ARGO,6,6,0,6,1,1,0,1,NYSE
5116,16-02-2021 06:00,24 hrs.,trakstocks,CSPR,25,0,25,-25,1,8,5,1,NYSE
5116,16-02-2021 06:00,24 hrs.,trakstocks,SKLZ,31,0,31,-31,1,11,5,1,NYSE
5116,16-02-2021 06:00,24 hrs.,trakstocks,AGNC,14,0,14,-14,1,1,8,1,NASDAQ
5116,16-02-2021 06:00,24 hrs.,trakstocks,ALOT,6,0,6,-6,1,1,0,1,NASDAQ
5116,16-02-2021 06:00,24 hrs.,trakstocks,AMTX,10,0,10,-10,1,3,0,1,NASDAQ
5116,16-02-2021 06:00,24 hrs.,trakstocks,AMZN,38,0,38,-38,1,8,18,1,NASDAQ
5116,16-02-2021 06:00,24 hrs.,trakstocks,ASRT,118,118,0,118,1,55,4,1,NASDAQ
5116,16-02-2021 06:00,24 hrs.,trakstocks,ATOS,27,27,0,27,1,9,5,1,NASDAQ
5070,15-02-2021 22:00,24 hrs.,StockMarket,HVBTF,6,6,0,6,1,1,0,1,OTC
5070,15-02-2021 22:00,24 hrs.,StockMarket,MMNFF,6,6,0,6,1,1,0,1,OTC
5070,15-02-2021 22:00,24 hrs.,StockMarket,NXTTF,10,10,0,10,1,1,4,1,OTC
5070,15-02-2021 22:00,24 hrs.,StockMarket,DPW,6,6,0,6,1,1,0,1,AMEX
5070,15-02-2021 22:00,24 hrs.,StockMarket,GSV,6,0,6,-6,1,1,0,1,AMEX
5070,15-02-2021 22:00,24 hrs.,StockMarket,ITP,31,31,0,31,1,12,3,1,AMEX
5070,15-02-2021 22:00,24 hrs.,StockMarket,AMC,97,97,0,97,3,31,23,3,NYSE
5070,15-02-2021 22:00,24 hrs.,StockMarket,BDJ,17,0,17,-17,1,5,3,1,NYSE
5070,15-02-2021 22:00,24 hrs.,StockMarket,DHI,22,22,0,22,1,9,0,1,NYSE
5070,15-02-2021 22:00,24 hrs.,StockMarket,GBX,24,0,24,-24,1,6,8,1,NYSE
5070,15-02-2021 22:00,24 hrs.,StockMarket,GME,150,132,18,114,8,31,56,8,NYSE
5070,15-02-2021 22:00,24 hrs.,StockMarket,GPN,22,22,0,22,1,9,0,1,NYSE
5070,15-02-2021 22:00,24 hrs.,StockMarket,ICE,31,31,0,31,1,12,3,1,NYSE
5070,15-02-2021 22:00,24 hrs.,StockMarket,MAC,6,0,6,-6,1,1,0,1,NYSE
5070,15-02-2021 22:00,24 hrs.,StockMarket,NIO,42,36,6,30,2,15,4,2,NYSE
5070,15-02-2021 22:00,24 hrs.,pennystocks,ABML,77,59,18,41,4,26,9,2,OTC
5070,15-02-2021 22:00,24 hrs.,pennystocks,AFPW,6,0,6,-6,1,1,0,1,OTC
5070,15-02-2021 22:00,24 hrs.,pennystocks,AGYP,9,9,0,9,1,2,1,1,OTC
5070,15-02-2021 22:00,24 hrs.,StockMarket,OMF,22,22,0,22,1,9,0,1,NYSE
5070,15-02-2021 22:00,24 hrs.,StockMarket,PHI,16,0,16,-16,1,0,12,1,NYSE
5070,15-02-2021 22:00,24 hrs.,StockMarket,PSX,22,22,0,22,1,9,0,1,NYSE
5070,15-02-2021 22:00,24 hrs.,StockMarket,SIG,7,0,7,-7,1,1,1,1,NYSE
5070,15-02-2021 22:00,24 hrs.,StockMarket,SOS,6,6,0,6,1,1,0,1,NYSE
5070,15-02-2021 22:00,24 hrs.,StockMarket,TMX,9,0,9,-9,1,2,1,1,NYSE
5070,15-02-2021 22:00,24 hrs.,StockMarket,ALLY,22,22,0,22,1,9,0,1,NYSE
5070,15-02-2021 22:00,24 hrs.,StockMarket,CCIV,12,6,6,0,2,2,0,2,NYSE
5070,15-02-2021 22:00,24 hrs.,StockMarket,COTY,20,6,14,-8,3,3,2,3,NYSE
5070,15-02-2021 22:00,24 hrs.,StockMarket,HUYA,6,6,0,6,1,1,0,1,NYSE
5070,15-02-2021 22:00,24 hrs.,StockMarket,MSCI,10,10,0,10,1,0,6,1,NYSE
5070,15-02-2021 22:00,24 hrs.,StockMarket,TWLO,22,22,0,22,1,9,0,1,NYSE
5070,15-02-2021 22:00,24 hrs.,StockMarket,VALE,6,0,6,-6,1,1,0,1,NYSE
5070,15-02-2021 22:00,24 hrs.,StockMarket,WORK,28,5,23,-18,2,3,14,2,NYSE
5070,15-02-2021 22:00,24 hrs.,StockMarket,API,12,0,12,-12,1,1,6,1,NASDAQ
5070,15-02-2021 22:00,24 hrs.,StockMarket,FAT,12,6,6,0,2,2,0,2,NASDAQ
5070,15-02-2021 22:00,24 hrs.,StockMarket,NEO,4,0,4,-4,1,0,0,1,NASDAQ
5070,15-02-2021 22:00,24 hrs.,StockMarket,ADBE,22,22,0,22,1,9,0,1,NASDAQ
5070,15-02-2021 22:00,24 hrs.,Daytrading,BLSP,6,0,6,-6,1,1,0,1,OTC
5070,15-02-2021 22:00,24 hrs.,Daytrading,COMS,86,0,86,-86,1,31,20,1,OTC
5070,15-02-2021 22:00,24 hrs.,Daytrading,ATH,16,0,16,-16,1,4,4,1,NYSE
5070,15-02-2021 22:00,24 hrs.,Daytrading,DIS,34,34,0,34,1,10,10,1,NYSE
5070,15-02-2021 22:00,24 hrs.,Daytrading,ETH,6,6,0,6,1,1,0,1,NYSE
5070,15-02-2021 22:00,24 hrs.,Daytrading,FSR,13,0,13,-13,1,4,1,1,NYSE
5070,15-02-2021 22:00,24 hrs.,Daytrading,IGT,13,0,13,-13,2,2,1,1,NYSE
5070,15-02-2021 22:00,24 hrs.,Daytrading,PDT,58,0,58,-58,1,14,26,1,NYSE
5070,15-02-2021 22:00,24 hrs.,Daytrading,RKT,34,34,0,34,1,10,10,1,NYSE
5070,15-02-2021 22:00,24 hrs.,Daytrading,RSI,194,194,0,194,2,81,24,2,NYSE
5070,15-02-2021 22:00,24 hrs.,Daytrading,TDA,20,20,0,20,1,4,8,1,NYSE
5070,15-02-2021 22:00,24 hrs.,Daytrading,FUBO,34,34,0,34,1,10,10,1,NYSE
5070,15-02-2021 22:00,24 hrs.,Daytrading,HEXO,34,34,0,34,1,10,10,1,NYSE
5070,15-02-2021 22:00,24 hrs.,Daytrading,PLTR,34,34,0,34,1,10,10,1,NYSE
5070,15-02-2021 22:00,24 hrs.,Daytrading,API,11,0,11,-11,1,3,1,1,NASDAQ
5070,15-02-2021 22:00,24 hrs.,Daytrading,ACIU,86,0,86,-86,1,31,20,1,NASDAQ
5070,15-02-2021 22:00,24 hrs.,Daytrading,AOSL,34,34,0,34,1,10,10,1,NASDAQ
5070,15-02-2021 22:00,24 hrs.,Daytrading,APHA,34,34,0,34,1,10,10,1,NASDAQ
5070,15-02-2021 22:00,24 hrs.,Daytrading,CRBP,86,0,86,-86,1,31,20,1,NASDAQ
5070,15-02-2021 22:00,24 hrs.,Daytrading,CROX,34,34,0,34,1,10,10,1,NASDAQ
5070,15-02-2021 22:00,24 hrs.,Daytrading,DKNG,34,34,0,34,1,10,10,1,NASDAQ
5070,15-02-2021 22:00,24 hrs.,Daytrading,FORD,24,24,0,24,1,9,2,1,NASDAQ
5070,15-02-2021 22:00,24 hrs.,Daytrading,GOGO,24,24,0,24,1,9,2,1,NASDAQ
5070,15-02-2021 22:00,24 hrs.,Daytrading,IBKR,14,14,0,14,1,1,8,1,NASDAQ
5070,15-02-2021 22:00,24 hrs.,Daytrading,NOVN,86,0,86,-86,1,31,20,1,NASDAQ
5070,15-02-2021 22:00,24 hrs.,Daytrading,PATI,24,24,0,24,1,9,2,1,NASDAQ
5070,15-02-2021 22:00,24 hrs.,Daytrading,PBTS,24,24,0,24,1,9,2,1,NASDAQ
5070,15-02-2021 22:00,24 hrs.,Daytrading,PRTA,86,0,86,-86,1,31,20,1,NASDAQ
5070,15-02-2021 22:00,24 hrs.,Daytrading,SAVA,6,6,0,6,1,1,0,1,NASDAQ
5070,15-02-2021 22:00,24 hrs.,Daytrading,SNDL,6,6,0,6,1,1,0,1,NASDAQ
5070,15-02-2021 22:00,24 hrs.,Daytrading,SSKN,24,24,0,24,1,9,2,1,NASDAQ
5070,15-02-2021 22:00,24 hrs.,Daytrading,TLRY,34,34,0,34,1,10,10,1,NASDAQ
5070,15-02-2021 22:00,24 hrs.,Daytrading,TNXP,74,0,74,-74,1,31,8,1,NASDAQ
5070,15-02-2021 22:00,24 hrs.,Daytrading,TOPS,24,24,0,24,1,9,2,1,NASDAQ
5070,15-02-2021 22:00,24 hrs.,Daytrading,TRCH,86,0,86,-86,1,31,20,1,NASDAQ
5070,15-02-2021 22:00,24 hrs.,Daytrading,TWIN,24,24,0,24,1,9,2,1,NASDAQ
5070,15-02-2021 22:00,24 hrs.,Daytrading,VISL,86,0,86,-86,1,31,20,1,NASDAQ
5070,15-02-2021 22:00,24 hrs.,StockMarket,CAGR,10,0,10,-10,1,1,4,1,OTC
5070,15-02-2021 22:00,24 hrs.,StockMarket,HCMC,22,6,16,-10,2,1,12,2,OTC
5070,15-02-2021 22:00,24 hrs.,StockMarket,PHIL,16,0,16,-16,1,0,12,1,OTC
5070,15-02-2021 22:00,24 hrs.,StockMarket,RCHA,6,6,0,6,1,1,0,1,OTC
5070,15-02-2021 22:00,24 hrs.,StockMarket,SGMD,6,6,0,6,1,1,0,1,OTC
5070,15-02-2021 22:00,24 hrs.,StockMarket,TGGI,15,15,0,15,1,2,7,1,OTC
5070,15-02-2021 22:00,24 hrs.,pennystocks,ETFM,265,265,0,265,2,105,47,1,OTC
5070,15-02-2021 22:00,24 hrs.,pennystocks,FLES,14,14,0,14,1,2,6,1,OTC
5070,15-02-2021 22:00,24 hrs.,pennystocks,GAXY,9,9,0,9,1,1,3,1,OTC
5070,15-02-2021 22:00,24 hrs.,pennystocks,GBLX,6,0,6,-6,1,1,0,1,OTC
5070,15-02-2021 22:00,24 hrs.,pennystocks,GNPT,6,0,6,-6,1,1,0,1,OTC
5070,15-02-2021 22:00,24 hrs.,pennystocks,GPFT,12,0,12,-12,2,2,0,2,OTC
5070,15-02-2021 22:00,24 hrs.,pennystocks,GRCU,6,0,6,-6,1,1,0,1,OTC
5070,15-02-2021 22:00,24 hrs.,pennystocks,GTEH,53,0,53,-53,2,15,15,2,OTC
5070,15-02-2021 22:00,24 hrs.,pennystocks,GTLL,7,7,0,7,1,1,1,1,OTC
5070,15-02-2021 22:00,24 hrs.,pennystocks,HALB,27,27,0,27,1,8,7,1,OTC
5070,15-02-2021 22:00,24 hrs.,pennystocks,HCMC,43,12,31,-19,7,7,1,7,OTC
5070,15-02-2021 22:00,24 hrs.,pennystocks,HQGE,7,0,7,-7,1,1,1,1,OTC
5070,15-02-2021 22:00,24 hrs.,pennystocks,ICLD,13,0,13,-13,2,2,1,1,OTC
5070,15-02-2021 22:00,24 hrs.,pennystocks,INKW,6,0,6,-6,1,1,0,1,OTC
5070,15-02-2021 22:00,24 hrs.,pennystocks,INND,7,0,7,-7,1,1,1,1,OTC
5070,15-02-2021 22:00,24 hrs.,pennystocks,IPIX,121,0,121,-121,1,42,33,1,OTC
5070,15-02-2021 22:00,24 hrs.,pennystocks,IQST,6,0,6,-6,1,1,0,1,OTC
5070,15-02-2021 22:00,24 hrs.,pennystocks,KOAN,4,4,0,4,1,0,0,1,OTC
5070,15-02-2021 22:00,24 hrs.,pennystocks,KULR,32,32,0,32,1,11,6,1,OTC
5070,15-02-2021 22:00,24 hrs.,pennystocks,KWBT,13,13,0,13,1,3,3,1,OTC
5070,15-02-2021 22:00,24 hrs.,pennystocks,LLBO,13,13,0,13,2,2,1,1,OTC
5070,15-02-2021 22:00,24 hrs.,pennystocks,LQMT,6,6,0,6,1,1,0,1,OTC
5070,15-02-2021 22:00,24 hrs.,pennystocks,MEDH,6,0,6,-6,1,1,0,1,OTC
5070,15-02-2021 22:00,24 hrs.,pennystocks,MFST,6,0,6,-6,1,1,0,1,OTC
5070,15-02-2021 22:00,24 hrs.,pennystocks,MINE,72,0,72,-72,1,10,48,1,OTC
5070,15-02-2021 22:00,24 hrs.,pennystocks,MLFB,6,0,6,-6,1,1,0,1,OTC
5070,15-02-2021 22:00,24 hrs.,pennystocks,NLST,37,0,37,-37,1,9,15,1,OTC
5070,15-02-2021 22:00,24 hrs.,pennystocks,OPTI,6,6,0,6,1,1,0,1,OTC
5070,15-02-2021 22:00,24 hrs.,pennystocks,OZSC,7,0,7,-7,1,1,1,1,OTC
5070,15-02-2021 22:00,24 hrs.,pennystocks,PBHG,6,6,0,6,1,1,0,1,OTC
5070,15-02-2021 22:00,24 hrs.,pennystocks,PGAS,18,18,0,18,3,3,0,2,OTC
5070,15-02-2021 22:00,24 hrs.,pennystocks,PHBI,6,0,6,-6,1,1,0,1,OTC
5070,15-02-2021 22:00,24 hrs.,pennystocks,PHCG,6,0,6,-6,1,1,0,1,OTC
5070,15-02-2021 22:00,24 hrs.,pennystocks,PUGE,95,41,54,-13,2,24,39,2,OTC
5070,15-02-2021 22:00,24 hrs.,pennystocks,RBNW,6,0,6,-6,1,1,0,1,OTC
5070,15-02-2021 22:00,24 hrs.,pennystocks,RNWR,6,6,0,6,1,1,0,1,OTC
5070,15-02-2021 22:00,24 hrs.,pennystocks,SGMD,188,49,139,-90,5,45,78,5,OTC
5070,15-02-2021 22:00,24 hrs.,StockMarket,ALGN,10,0,10,-10,1,1,4,1,NASDAQ
5070,15-02-2021 22:00,24 hrs.,StockMarket,AMZN,22,22,0,22,1,9,0,1,NASDAQ
5070,15-02-2021 22:00,24 hrs.,StockMarket,ANTE,6,6,0,6,1,1,0,1,NASDAQ
5070,15-02-2021 22:00,24 hrs.,StockMarket,ATOS,6,6,0,6,1,1,0,1,NASDAQ
5070,15-02-2021 22:00,24 hrs.,StockMarket,BLNK,7,0,7,-7,1,1,1,1,NASDAQ
5070,15-02-2021 22:00,24 hrs.,StockMarket,CMPS,6,0,6,-6,1,1,0,1,NASDAQ
5070,15-02-2021 22:00,24 hrs.,StockMarket,FIII,8,8,0,8,1,2,0,1,NASDAQ
5070,15-02-2021 22:00,24 hrs.,StockMarket,FLGT,6,0,6,-6,1,1,0,1,NASDAQ
5070,15-02-2021 22:00,24 hrs.,StockMarket,FOLD,12,0,12,-12,2,2,0,2,NASDAQ
5070,15-02-2021 22:00,24 hrs.,StockMarket,GILD,7,7,0,7,1,0,3,1,NASDAQ
5070,15-02-2021 22:00,24 hrs.,StockMarket,GTHX,56,56,0,56,1,16,20,1,NASDAQ
5070,15-02-2021 22:00,24 hrs.,StockMarket,IMVT,22,22,0,22,1,9,0,1,NASDAQ
5070,15-02-2021 22:00,24 hrs.,StockMarket,INVE,6,6,0,6,1,1,0,1,NASDAQ
5070,15-02-2021 22:00,24 hrs.,StockMarket,JACK,6,6,0,6,1,1,0,1,NASDAQ
5070,15-02-2021 22:00,24 hrs.,StockMarket,MVIS,6,6,0,6,1,1,0,1,NASDAQ
5070,15-02-2021 22:00,24 hrs.,StockMarket,NAKD,6,6,0,6,1,1,0,1,NASDAQ
5070,15-02-2021 22:00,24 hrs.,StockMarket,OTLK,6,6,0,6,1,1,0,1,NASDAQ
5070,15-02-2021 22:00,24 hrs.,StockMarket,POWW,58,58,0,58,1,19,16,1,NASDAQ
5070,15-02-2021 22:00,24 hrs.,StockMarket,PTGX,4,4,0,4,1,0,0,1,NASDAQ
5070,15-02-2021 22:00,24 hrs.,StockMarket,SNDL,6,6,0,6,1,1,0,1,NASDAQ
5070,15-02-2021 22:00,24 hrs.,StockMarket,SRNE,4,4,0,4,1,0,0,1,NASDAQ
5070,15-02-2021 22:00,24 hrs.,StockMarket,TNXP,47,0,47,-47,1,17,9,1,NASDAQ
5070,15-02-2021 22:00,24 hrs.,StockMarket,TRCH,6,0,6,-6,1,1,0,1,NASDAQ
5070,15-02-2021 22:00,24 hrs.,StockMarket,TSLA,5,0,5,-5,1,0,1,1,NASDAQ
5070,15-02-2021 22:00,24 hrs.,StockMarket,XRAY,10,0,10,-10,1,1,4,1,NASDAQ
5070,15-02-2021 22:00,24 hrs.,pennystocks,AABB,6,6,0,6,1,1,0,1,OTC
5070,15-02-2021 22:00,24 hrs.,pennystocks,AAGH,31,0,31,-31,1,7,13,1,OTC
5070,15-02-2021 22:00,24 hrs.,pennystocks,SNPW,163,0,163,-163,8,51,29,3,OTC
5070,15-02-2021 22:00,24 hrs.,pennystocks,SRMX,6,6,0,6,1,1,0,1,OTC
5070,15-02-2021 22:00,24 hrs.,pennystocks,SSFT,595,394,201,193,3,222,139,3,OTC
5070,15-02-2021 22:00,24 hrs.,pennystocks,STHC,24,0,24,-24,1,8,4,1,OTC
5070,15-02-2021 22:00,24 hrs.,pennystocks,TSNP,89,0,89,-89,2,24,33,2,OTC
5070,15-02-2021 22:00,24 hrs.,pennystocks,UNVC,7,7,0,7,1,1,1,1,OTC
5070,15-02-2021 22:00,24 hrs.,pennystocks,UVSE,7,7,0,7,1,1,1,1,OTC
5070,15-02-2021 22:00,24 hrs.,pennystocks,VPER,742,742,0,742,2,246,242,2,OTC
5070,15-02-2021 22:00,24 hrs.,pennystocks,WARM,12,12,0,12,2,2,0,1,OTC
5070,15-02-2021 22:00,24 hrs.,pennystocks,WDLF,12,6,6,0,2,2,0,2,OTC
5070,15-02-2021 22:00,24 hrs.,pennystocks,WGNR,8,8,0,8,1,1,2,1,OTC
5070,15-02-2021 22:00,24 hrs.,pennystocks,ZHUD,6,0,6,-6,1,1,0,1,OTC
5070,15-02-2021 22:00,24 hrs.,pennystocks,AACTF,58,58,0,58,2,19,12,2,OTC
5070,15-02-2021 22:00,24 hrs.,pennystocks,ABEPF,54,54,0,54,1,11,28,1,OTC
5070,15-02-2021 22:00,24 hrs.,pennystocks,AMYZF,55,0,55,-55,1,18,15,1,OTC
5070,15-02-2021 22:00,24 hrs.,pennystocks,ARBKF,301,174,127,47,5,80,121,5,OTC
5070,15-02-2021 22:00,24 hrs.,pennystocks,BLITF,139,139,0,139,1,50,35,1,OTC
5070,15-02-2021 22:00,24 hrs.,pennystocks,BRGGF,139,139,0,139,1,50,35,1,OTC
5070,15-02-2021 22:00,24 hrs.,pennystocks,BYDDY,32,32,0,32,1,11,6,1,OTC
5070,15-02-2021 22:00,24 hrs.,pennystocks,CYDVF,124,6,118,-112,2,44,28,2,OTC
5070,15-02-2021 22:00,24 hrs.,pennystocks,DIGAF,7,0,7,-7,1,1,1,1,OTC
5070,15-02-2021 22:00,24 hrs.,pennystocks,EFLVF,6,6,0,6,1,1,0,1,OTC
5070,15-02-2021 22:00,24 hrs.,pennystocks,EPWCF,6,6,0,6,1,1,0,1,OTC
5070,15-02-2021 22:00,24 hrs.,pennystocks,ERPNF,74,74,0,74,2,23,20,2,OTC
5070,15-02-2021 22:00,24 hrs.,pennystocks,FLURF,55,0,55,-55,4,11,17,2,OTC
5070,15-02-2021 22:00,24 hrs.,pennystocks,FUNFF,145,145,0,145,2,51,35,2,OTC
5070,15-02-2021 22:00,24 hrs.,pennystocks,HITIF,54,54,0,54,1,11,28,1,OTC
5070,15-02-2021 22:00,24 hrs.,pennystocks,HUTMF,34,34,0,34,1,5,20,1,OTC
5070,15-02-2021 22:00,24 hrs.,pennystocks,HVBTF,6,6,0,6,1,1,0,1,OTC
5070,15-02-2021 22:00,24 hrs.,pennystocks,LIACF,24,0,24,-24,1,9,2,1,OTC
5070,15-02-2021 22:00,24 hrs.,pennystocks,LKNCY,18,6,12,-6,3,3,0,2,OTC
5070,15-02-2021 22:00,24 hrs.,pennystocks,MMNFF,12,6,6,0,2,2,0,2,OTC
5070,15-02-2021 22:00,24 hrs.,pennystocks,MMTIF,20,20,0,20,1,3,10,1,OTC
5070,15-02-2021 22:00,24 hrs.,pennystocks,MNXXF,81,74,7,67,2,30,13,2,OTC
5070,15-02-2021 22:00,24 hrs.,pennystocks,MPUCF,6,6,0,6,1,1,0,1,OTC
5070,15-02-2021 22:00,24 hrs.,pennystocks,MSNVF,6,0,6,-6,1,1,0,1,OTC
5070,15-02-2021 22:00,24 hrs.,pennystocks,MYCOF,40,40,0,40,1,17,2,1,OTC
5070,15-02-2021 22:00,24 hrs.,pennystocks,NMGRF,122,0,122,-122,1,18,82,1,OTC
5070,15-02-2021 22:00,24 hrs.,pennystocks,NMHLY,6,6,0,6,1,1,0,1,OTC
5070,15-02-2021 22:00,24 hrs.,pennystocks,NXTTF,8,0,8,-8,1,1,2,1,OTC
5070,15-02-2021 22:00,24 hrs.,pennystocks,OTIVF,6,6,0,6,1,1,0,1,OTC
5070,15-02-2021 22:00,24 hrs.,pennystocks,PDDTF,28,28,0,28,1,7,10,1,OTC
5070,15-02-2021 22:00,24 hrs.,pennystocks,AITX,246,158,88,70,9,81,48,7,OTC
5070,15-02-2021 22:00,24 hrs.,pennystocks,ALPP,29,29,0,29,2,8,5,2,OTC
5070,15-02-2021 22:00,24 hrs.,pennystocks,ALYI,38,38,0,38,1,10,14,1,OTC
5070,15-02-2021 22:00,24 hrs.,pennystocks,ASTI,47,41,6,35,3,12,11,3,OTC
5070,15-02-2021 22:00,24 hrs.,pennystocks,AURI,20,0,20,-20,1,5,6,1,OTC
5070,15-02-2021 22:00,24 hrs.,pennystocks,AZFL,6,0,6,-6,1,1,0,1,OTC
5070,15-02-2021 22:00,24 hrs.,pennystocks,BANT,6,6,0,6,1,1,0,1,OTC
5070,15-02-2021 22:00,24 hrs.,pennystocks,BBRW,12,6,6,0,2,2,0,2,OTC
5070,15-02-2021 22:00,24 hrs.,pennystocks,BCAP,12,12,0,12,2,2,0,1,OTC
5070,15-02-2021 22:00,24 hrs.,pennystocks,BIEL,6,6,0,6,1,1,0,1,OTC
5070,15-02-2021 22:00,24 hrs.,pennystocks,BLSP,13,7,6,1,2,2,1,2,OTC
5070,15-02-2021 22:00,24 hrs.,pennystocks,BOTY,7,7,0,7,1,1,1,1,OTC
5070,15-02-2021 22:00,24 hrs.,pennystocks,BRZL,6,0,6,-6,1,1,0,1,OTC
5070,15-02-2021 22:00,24 hrs.,pennystocks,BYOC,13,13,0,13,1,1,7,1,OTC
5070,15-02-2021 22:00,24 hrs.,pennystocks,CBBT,729,729,0,729,3,253,211,3,OTC
5070,15-02-2021 22:00,24 hrs.,pennystocks,CBDL,6,6,0,6,1,1,0,1,OTC
5070,15-02-2021 22:00,24 hrs.,pennystocks,CBTC,6,0,6,-6,1,1,0,1,OTC
5070,15-02-2021 22:00,24 hrs.,pennystocks,CCTL,6,6,0,6,1,1,0,1,OTC
5070,15-02-2021 22:00,24 hrs.,pennystocks,CEOS,223,223,0,223,1,66,87,1,OTC
5070,15-02-2021 22:00,24 hrs.,pennystocks,CYDY,7,7,0,7,1,1,1,1,OTC
5070,15-02-2021 22:00,24 hrs.,pennystocks,DPLS,7,7,0,7,1,1,1,1,OTC
5070,15-02-2021 22:00,24 hrs.,pennystocks,ECEZ,230,223,7,216,2,67,88,2,OTC
5070,15-02-2021 22:00,24 hrs.,pennystocks,OTLK,6,6,0,6,1,1,0,1,NASDAQ
5070,15-02-2021 22:00,24 hrs.,pennystocks,PENN,139,139,0,139,1,50,35,1,NASDAQ
5070,15-02-2021 22:00,24 hrs.,pennystocks,PHAR,28,28,0,28,1,11,2,1,NASDAQ
5070,15-02-2021 22:00,24 hrs.,pennystocks,PLUS,108,108,0,108,2,32,36,2,NASDAQ
5070,15-02-2021 22:00,24 hrs.,pennystocks,PTON,59,59,0,59,1,23,9,1,NASDAQ
5070,15-02-2021 22:00,24 hrs.,pennystocks,RIOT,253,162,91,71,3,68,105,3,NASDAQ
5070,15-02-2021 22:00,24 hrs.,pennystocks,RNWK,6,0,6,-6,1,1,0,1,NASDAQ
5070,15-02-2021 22:00,24 hrs.,pennystocks,SHIP,35,35,0,35,1,6,19,1,NASDAQ
5070,15-02-2021 22:00,24 hrs.,pennystocks,SNDL,14,7,7,0,2,2,2,2,NASDAQ
5070,15-02-2021 22:00,24 hrs.,pennystocks,SNGX,97,0,97,-97,1,34,25,1,NASDAQ
5070,15-02-2021 22:00,24 hrs.,pennystocks,SOLO,7,0,7,-7,1,1,1,1,NASDAQ
5070,15-02-2021 22:00,24 hrs.,pennystocks,TBLT,6,0,6,-6,1,1,0,1,NASDAQ
5070,15-02-2021 22:00,24 hrs.,pennystocks,TECH,6,0,6,-6,1,1,0,1,NASDAQ
5070,15-02-2021 22:00,24 hrs.,pennystocks,TMDI,6,0,6,-6,1,1,0,1,NASDAQ
5070,15-02-2021 22:00,24 hrs.,pennystocks,TNXP,415,0,415,-415,3,166,71,3,NASDAQ
5070,15-02-2021 22:00,24 hrs.,pennystocks,TRCH,15,15,0,15,2,1,5,2,NASDAQ
5070,15-02-2021 22:00,24 hrs.,pennystocks,TRIB,6,0,6,-6,1,1,0,1,NASDAQ
5070,15-02-2021 22:00,24 hrs.,pennystocks,PDYPY,139,139,0,139,1,50,35,1,OTC
5070,15-02-2021 22:00,24 hrs.,pennystocks,PLUUF,24,0,24,-24,1,9,2,1,OTC
5070,15-02-2021 22:00,24 hrs.,pennystocks,POETF,12,12,0,12,2,2,0,1,OTC
5070,15-02-2021 22:00,24 hrs.,pennystocks,ROCLF,7,7,0,7,1,1,1,1,OTC
5070,15-02-2021 22:00,24 hrs.,pennystocks,SHLOQ,7,0,7,-7,1,1,1,1,OTC
5070,15-02-2021 22:00,24 hrs.,pennystocks,SPRWF,41,0,41,-41,3,12,5,2,OTC
5070,15-02-2021 22:00,24 hrs.,pennystocks,TAKOF,6,6,0,6,1,1,0,1,OTC
5070,15-02-2021 22:00,24 hrs.,pennystocks,TGIFF,11,11,0,11,1,3,1,1,OTC
5070,15-02-2021 22:00,24 hrs.,pennystocks,TOBAF,6,6,0,6,1,1,0,1,OTC
5070,15-02-2021 22:00,24 hrs.,pennystocks,TOWTF,13,13,0,13,2,2,1,1,OTC
5070,15-02-2021 22:00,24 hrs.,pennystocks,TRGGF,6,0,6,-6,1,1,0,1,OTC
5070,15-02-2021 22:00,24 hrs.,pennystocks,TSCRF,139,139,0,139,1,50,35,1,OTC
5070,15-02-2021 22:00,24 hrs.,pennystocks,TTTPF,7,7,0,7,1,1,1,1,OTC
5070,15-02-2021 22:00,24 hrs.,pennystocks,WCEXF,32,32,0,32,1,5,18,1,OTC
5070,15-02-2021 22:00,24 hrs.,pennystocks,WDDMF,6,6,0,6,1,1,0,1,OTC
5070,15-02-2021 22:00,24 hrs.,pennystocks,CTO,163,0,163,-163,1,52,55,1,AMEX
5070,15-02-2021 22:00,24 hrs.,pennystocks,GPL,47,0,47,-47,1,14,15,1,AMEX
5070,15-02-2021 22:00,24 hrs.,pennystocks,GSV,13,6,7,-1,2,2,1,2,AMEX
5070,15-02-2021 22:00,24 hrs.,pennystocks,ZOM,48,0,48,-48,3,12,12,3,AMEX
5070,15-02-2021 22:00,24 hrs.,pennystocks,INUV,12,12,0,12,2,2,0,2,AMEX
5070,15-02-2021 22:00,24 hrs.,pennystocks,NSPR,36,0,36,-36,1,10,12,1,AMEX
5070,15-02-2021 22:00,24 hrs.,pennystocks,SENS,6,6,0,6,1,1,0,1,AMEX
5070,15-02-2021 22:00,24 hrs.,pennystocks,ACB,7,0,7,-7,1,1,1,1,NYSE
5070,15-02-2021 22:00,24 hrs.,pennystocks,ADC,6,0,6,-6,1,1,0,1,NYSE
5070,15-02-2021 22:00,24 hrs.,pennystocks,AMC,6,0,6,-6,1,1,0,1,NYSE
5070,15-02-2021 22:00,24 hrs.,pennystocks,ASX,24,6,18,-12,2,5,6,2,NYSE
5070,15-02-2021 22:00,24 hrs.,pennystocks,BCH,11,11,0,11,1,2,3,1,NYSE
5070,15-02-2021 22:00,24 hrs.,pennystocks,BYD,32,32,0,32,1,11,6,1,NYSE
5070,15-02-2021 22:00,24 hrs.,pennystocks,CBD,6,6,0,6,1,1,0,1,NYSE
5070,15-02-2021 22:00,24 hrs.,pennystocks,CSV,696,696,0,696,1,317,58,1,NYSE
5070,15-02-2021 22:00,24 hrs.,pennystocks,ETH,11,11,0,11,1,2,3,1,NYSE
5070,15-02-2021 22:00,24 hrs.,pennystocks,FIT,6,0,6,-6,1,1,0,1,NYSE
5070,15-02-2021 22:00,24 hrs.,pennystocks,FRA,118,0,118,-118,1,43,28,1,NYSE
5070,15-02-2021 22:00,24 hrs.,pennystocks,MUX,63,63,0,63,1,15,29,1,NYSE
5070,15-02-2021 22:00,24 hrs.,pennystocks,NAV,28,28,0,28,1,11,2,1,NYSE
5070,15-02-2021 22:00,24 hrs.,pennystocks,NIO,7,0,7,-7,1,1,1,1,NYSE
5070,15-02-2021 22:00,24 hrs.,pennystocks,NYT,8,8,0,8,1,1,2,1,NYSE
5070,15-02-2021 22:00,24 hrs.,pennystocks,PDT,6,0,6,-6,1,1,0,1,NYSE
5070,15-02-2021 22:00,24 hrs.,pennystocks,PKG,151,151,0,151,1,55,37,1,NYSE
5070,15-02-2021 22:00,24 hrs.,pennystocks,PSA,6,0,6,-6,1,1,0,1,NYSE
5070,15-02-2021 22:00,24 hrs.,pennystocks,SOS,105,14,91,-77,3,23,47,3,NYSE
5070,15-02-2021 22:00,24 hrs.,pennystocks,THC,6,6,0,6,1,1,0,1,NYSE
5070,15-02-2021 22:00,24 hrs.,pennystocks,TWI,6,0,6,-6,1,1,0,1,NYSE
5070,15-02-2021 22:00,24 hrs.,pennystocks,COLD,19,0,19,-19,1,4,7,1,NYSE
5070,15-02-2021 22:00,24 hrs.,pennystocks,CSPR,6,6,0,6,1,1,0,1,NYSE
5070,15-02-2021 22:00,24 hrs.,pennystocks,SPCE,59,59,0,59,1,23,9,1,NYSE
5070,15-02-2021 22:00,24 hrs.,pennystocks,SPOT,6,0,6,-6,1,1,0,1,NYSE
5070,15-02-2021 22:00,24 hrs.,pennystocks,WRAP,10,0,10,-10,1,1,4,1,NASDAQ
5070,15-02-2021 22:00,24 hrs.,pennystocks,XSPA,270,270,0,270,3,104,50,3,NASDAQ
5070,15-02-2021 22:00,24 hrs.,RobinHoodPennyStocks,ALPP,12,12,0,12,2,2,0,1,OTC
5070,15-02-2021 22:00,24 hrs.,RobinHoodPennyStocks,BLXX,7,0,7,-7,1,1,1,1,OTC
5070,15-02-2021 22:00,24 hrs.,RobinHoodPennyStocks,GAXY,6,6,0,6,1,1,0,1,OTC
5070,15-02-2021 22:00,24 hrs.,RobinHoodPennyStocks,HCMC,6,0,6,-6,1,1,0,1,OTC
5070,15-02-2021 22:00,24 hrs.,RobinHoodPennyStocks,PHIL,6,0,6,-6,1,1,0,1,OTC
5070,15-02-2021 22:00,24 hrs.,RobinHoodPennyStocks,RVBR,6,6,0,6,1,1,0,1,OTC
5070,15-02-2021 22:00,24 hrs.,RobinHoodPennyStocks,SRMX,16,16,0,16,1,0,12,1,OTC
5070,15-02-2021 22:00,24 hrs.,RobinHoodPennyStocks,VPER,6,6,0,6,1,1,0,1,OTC
5070,15-02-2021 22:00,24 hrs.,RobinHoodPennyStocks,ZHUD,7,0,7,-7,1,1,1,1,OTC
5070,15-02-2021 22:00,24 hrs.,RobinHoodPennyStocks,BDRBF,26,6,20,-14,2,1,16,2,OTC
5070,15-02-2021 22:00,24 hrs.,RobinHoodPennyStocks,OTIVF,6,6,0,6,1,1,0,1,OTC
5070,15-02-2021 22:00,24 hrs.,RobinHoodPennyStocks,RNRRF,6,6,0,6,1,1,0,1,OTC
5070,15-02-2021 22:00,24 hrs.,RobinHoodPennyStocks,RYCEY,35,0,35,-35,1,0,31,1,OTC
5070,15-02-2021 22:00,24 hrs.,RobinHoodPennyStocks,DNN,296,290,6,284,2,82,124,2,AMEX
5070,15-02-2021 22:00,24 hrs.,RobinHoodPennyStocks,GTE,383,383,0,383,3,108,155,3,AMEX
5070,15-02-2021 22:00,24 hrs.,RobinHoodPennyStocks,LNG,20,0,20,-20,1,7,2,1,AMEX
5070,15-02-2021 22:00,24 hrs.,RobinHoodPennyStocks,NAK,6,6,0,6,1,1,0,1,AMEX
5070,15-02-2021 22:00,24 hrs.,RobinHoodPennyStocks,PTN,335,335,0,335,2,95,137,2,AMEX
5070,15-02-2021 22:00,24 hrs.,RobinHoodPennyStocks,SYN,87,87,0,87,1,26,31,1,AMEX
5070,15-02-2021 22:00,24 hrs.,RobinHoodPennyStocks,ZOM,87,87,0,87,1,26,31,1,AMEX
5070,15-02-2021 22:00,24 hrs.,RobinHoodPennyStocks,INUV,18,18,0,18,3,3,0,2,AMEX
5070,15-02-2021 22:00,24 hrs.,RobinHoodPennyStocks,SENS,29,0,29,-29,1,1,23,1,AMEX
5070,15-02-2021 22:00,24 hrs.,RobinHoodPennyStocks,UAMY,6,6,0,6,1,1,0,1,AMEX
5070,15-02-2021 22:00,24 hrs.,RobinHoodPennyStocks,UAVS,6,6,0,6,1,1,0,1,AMEX
5070,15-02-2021 22:00,24 hrs.,RobinHoodPennyStocks,XXII,6,0,6,-6,1,1,0,1,AMEX
5070,15-02-2021 22:00,24 hrs.,RobinHoodPennyStocks,AMP,6,0,6,-6,1,1,0,1,NYSE
5070,15-02-2021 22:00,24 hrs.,RobinHoodPennyStocks,AUY,6,6,0,6,1,1,0,1,NYSE
5070,15-02-2021 22:00,24 hrs.,RobinHoodPennyStocks,CNS,74,60,14,46,2,22,22,2,NYSE
5070,15-02-2021 22:00,24 hrs.,pennystocks,API,707,696,11,685,2,320,59,2,NASDAQ
5070,15-02-2021 22:00,24 hrs.,pennystocks,CGC,40,40,0,40,1,17,2,1,NASDAQ
5070,15-02-2021 22:00,24 hrs.,pennystocks,FNX,6,6,0,6,1,1,0,1,NASDAQ
5070,15-02-2021 22:00,24 hrs.,pennystocks,III,12,12,0,12,2,2,0,1,NASDAQ
5070,15-02-2021 22:00,24 hrs.,pennystocks,KOD,84,84,0,84,1,24,32,1,NASDAQ
5070,15-02-2021 22:00,24 hrs.,pennystocks,OLB,6,6,0,6,1,1,0,1,NASDAQ
5070,15-02-2021 22:00,24 hrs.,pennystocks,PLL,28,28,0,28,1,7,10,1,NASDAQ
5070,15-02-2021 22:00,24 hrs.,pennystocks,AACG,6,6,0,6,1,1,0,1,NASDAQ
5070,15-02-2021 22:00,24 hrs.,pennystocks,ACST,7,0,7,-7,1,1,1,1,NASDAQ
5070,15-02-2021 22:00,24 hrs.,pennystocks,AGTC,124,0,124,-124,1,55,10,1,NASDAQ
5070,15-02-2021 22:00,24 hrs.,pennystocks,AMZN,8,8,0,8,1,1,2,1,NASDAQ
5070,15-02-2021 22:00,24 hrs.,pennystocks,ANTE,9,9,0,9,1,2,1,1,NASDAQ
5070,15-02-2021 22:00,24 hrs.,pennystocks,APHA,7,0,7,-7,1,1,1,1,NASDAQ
5070,15-02-2021 22:00,24 hrs.,pennystocks,ARTL,6,0,6,-6,1,1,0,1,NASDAQ
5070,15-02-2021 22:00,24 hrs.,pennystocks,ASRT,1481,229,1252,-1023,10,629,183,3,NASDAQ
5070,15-02-2021 22:00,24 hrs.,pennystocks,ASRV,39,39,0,39,1,10,15,1,NASDAQ
5070,15-02-2021 22:00,24 hrs.,pennystocks,ATOS,6,6,0,6,1,1,0,1,NASDAQ
5070,15-02-2021 22:00,24 hrs.,pennystocks,BCRX,6,0,6,-6,1,1,0,1,NASDAQ
5070,15-02-2021 22:00,24 hrs.,pennystocks,BIOL,6,6,0,6,1,1,0,1,NASDAQ
5070,15-02-2021 22:00,24 hrs.,pennystocks,BNGO,59,59,0,59,1,23,9,1,NASDAQ
5070,15-02-2021 22:00,24 hrs.,pennystocks,BTBT,34,34,0,34,1,5,20,1,NASDAQ
5070,15-02-2021 22:00,24 hrs.,pennystocks,CGIX,6,0,6,-6,1,1,0,1,NASDAQ
5070,15-02-2021 22:00,24 hrs.,pennystocks,CIDM,50,0,50,-50,1,18,10,1,NASDAQ
5070,15-02-2021 22:00,24 hrs.,pennystocks,CRBP,7,0,7,-7,1,1,1,1,NASDAQ
5070,15-02-2021 22:00,24 hrs.,pennystocks,CTRM,20,0,20,-20,3,3,2,3,NASDAQ
5070,15-02-2021 22:00,24 hrs.,pennystocks,DKNG,139,139,0,139,1,50,35,1,NASDAQ
5070,15-02-2021 22:00,24 hrs.,pennystocks,EDIT,1128,696,432,264,3,495,126,3,NASDAQ
5070,15-02-2021 22:00,24 hrs.,pennystocks,GOEV,7,7,0,7,1,1,1,1,NASDAQ
5070,15-02-2021 22:00,24 hrs.,pennystocks,INPX,60,0,60,-60,1,23,10,1,NASDAQ
5070,15-02-2021 22:00,24 hrs.,pennystocks,LIFE,12,12,0,12,2,2,0,1,NASDAQ
5070,15-02-2021 22:00,24 hrs.,pennystocks,MARA,253,162,91,71,3,68,105,3,NASDAQ
5070,15-02-2021 22:00,24 hrs.,pennystocks,NAKD,7,0,7,-7,1,1,1,1,NASDAQ
5070,15-02-2021 22:00,24 hrs.,pennystocks,NVCN,38,38,0,38,1,9,16,1,NASDAQ
5070,15-02-2021 22:00,24 hrs.,pennystocks,OPTT,6,6,0,6,1,1,0,1,NASDAQ
5070,15-02-2021 22:00,24 hrs.,RobinHoodPennyStocks,PEG,6,6,0,6,1,1,0,1,NYSE
5070,15-02-2021 22:00,24 hrs.,RobinHoodPennyStocks,PHI,6,0,6,-6,1,1,0,1,NYSE
5070,15-02-2021 22:00,24 hrs.,RobinHoodPennyStocks,SOS,111,105,6,99,4,32,31,4,NYSE
5070,15-02-2021 22:00,24 hrs.,RobinHoodPennyStocks,THC,60,60,0,60,1,22,12,1,NYSE
5070,15-02-2021 22:00,24 hrs.,RobinHoodPennyStocks,TSM,111,111,0,111,1,29,49,1,NYSE
5070,15-02-2021 22:00,24 hrs.,RobinHoodPennyStocks,VHC,7,7,0,7,1,1,1,1,NYSE
5070,15-02-2021 22:00,24 hrs.,RobinHoodPennyStocks,CSPR,6,6,0,6,1,1,0,1,NYSE
5070,15-02-2021 22:00,24 hrs.,RobinHoodPennyStocks,GLOG,20,0,20,-20,1,7,2,1,NYSE
5070,15-02-2021 22:00,24 hrs.,RobinHoodPennyStocks,CFO,41,6,35,-29,2,1,31,2,NASDAQ
5070,15-02-2021 22:00,24 hrs.,RobinHoodPennyStocks,GVP,32,0,32,-32,2,7,10,2,NASDAQ
5070,15-02-2021 22:00,24 hrs.,RobinHoodPennyStocks,HAS,6,0,6,-6,1,1,0,1,NASDAQ
5070,15-02-2021 22:00,24 hrs.,RobinHoodPennyStocks,PXS,290,290,0,290,1,81,124,1,NASDAQ
5070,15-02-2021 22:00,24 hrs.,RobinHoodPennyStocks,WWR,12,12,0,12,2,2,0,1,NASDAQ
5070,15-02-2021 22:00,24 hrs.,RobinHoodPennyStocks,ABEO,290,290,0,290,1,81,124,1,NASDAQ
5070,15-02-2021 22:00,24 hrs.,RobinHoodPennyStocks,ACRX,6,0,6,-6,1,1,0,1,NASDAQ
5070,15-02-2021 22:00,24 hrs.,RobinHoodPennyStocks,ACST,290,290,0,290,1,81,124,1,NASDAQ
5070,15-02-2021 22:00,24 hrs.,RobinHoodPennyStocks,AGTC,153,153,0,153,3,49,43,3,NASDAQ
5070,15-02-2021 22:00,24 hrs.,RobinHoodPennyStocks,AMZN,6,6,0,6,1,1,0,1,NASDAQ
5070,15-02-2021 22:00,24 hrs.,RobinHoodPennyStocks,ARTL,6,0,6,-6,1,1,0,1,NASDAQ
5070,15-02-2021 22:00,24 hrs.,RobinHoodPennyStocks,ASRT,423,423,0,423,3,123,165,3,NASDAQ
5070,15-02-2021 22:00,24 hrs.,RobinHoodPennyStocks,ASRV,46,46,0,46,1,16,10,1,NASDAQ
5070,15-02-2021 22:00,24 hrs.,RobinHoodPennyStocks,BRQS,87,87,0,87,1,26,31,1,NASDAQ
5070,15-02-2021 22:00,24 hrs.,RobinHoodPennyStocks,CIDM,290,290,0,290,1,81,124,1,NASDAQ
5070,15-02-2021 22:00,24 hrs.,RobinHoodPennyStocks,CRBP,437,437,0,437,3,129,167,3,NASDAQ
5070,15-02-2021 22:00,24 hrs.,RobinHoodPennyStocks,CTRM,29,0,29,-29,1,1,23,1,NASDAQ
5070,15-02-2021 22:00,24 hrs.,RobinHoodPennyStocks,CYCN,14,0,14,-14,1,0,10,1,NASDAQ
5070,15-02-2021 22:00,24 hrs.,RobinHoodPennyStocks,DFFN,401,401,0,401,2,110,173,2,NASDAQ
5070,15-02-2021 22:00,24 hrs.,RobinHoodPennyStocks,EAST,87,87,0,87,1,26,31,1,NASDAQ
5070,15-02-2021 22:00,24 hrs.,RobinHoodPennyStocks,FLEX,6,0,6,-6,1,1,0,1,NASDAQ
5070,15-02-2021 22:00,24 hrs.,RobinHoodPennyStocks,GNUS,33,0,33,-33,2,1,23,1,NASDAQ
5070,15-02-2021 22:00,24 hrs.,RobinHoodPennyStocks,HSTO,6,0,6,-6,1,1,0,1,NASDAQ
5070,15-02-2021 22:00,24 hrs.,RobinHoodPennyStocks,IDEX,29,0,29,-29,1,1,23,1,NASDAQ
5070,15-02-2021 22:00,24 hrs.,RobinHoodPennyStocks,JAGX,60,60,0,60,1,22,12,1,NASDAQ
5070,15-02-2021 22:00,24 hrs.,RobinHoodPennyStocks,LKCO,87,87,0,87,1,26,31,1,NASDAQ
5070,15-02-2021 22:00,24 hrs.,RobinHoodPennyStocks,LLNW,6,0,6,-6,1,1,0,1,NASDAQ
5070,15-02-2021 22:00,24 hrs.,RobinHoodPennyStocks,MARA,12,12,0,12,1,4,0,1,NASDAQ
5070,15-02-2021 22:00,24 hrs.,RobinHoodPennyStocks,MOSY,6,6,0,6,1,1,0,1,NASDAQ
5070,15-02-2021 22:00,24 hrs.,RobinHoodPennyStocks,MYSZ,6,0,6,-6,1,1,0,1,NASDAQ
5070,15-02-2021 22:00,24 hrs.,RobinHoodPennyStocks,NEOS,6,0,6,-6,1,1,0,1,NASDAQ
5070,15-02-2021 22:00,24 hrs.,RobinHoodPennyStocks,NOVN,87,87,0,87,1,26,31,1,NASDAQ
5070,15-02-2021 22:00,24 hrs.,RobinHoodPennyStocks,NVCN,4,0,4,-4,1,0,0,1,NASDAQ
5070,15-02-2021 22:00,24 hrs.,RobinHoodPennyStocks,NVIV,6,6,0,6,1,1,0,1,NASDAQ
5070,15-02-2021 22:00,24 hrs.,RobinHoodPennyStocks,ONTX,87,87,0,87,1,26,31,1,NASDAQ
5070,15-02-2021 22:00,24 hrs.,RobinHoodPennyStocks,POWW,30,30,0,30,1,9,8,1,NASDAQ
5070,15-02-2021 22:00,24 hrs.,RobinHoodPennyStocks,PULM,6,6,0,6,1,1,0,1,NASDAQ
5070,15-02-2021 22:00,24 hrs.,RobinHoodPennyStocks,RGLS,6,0,6,-6,1,1,0,1,NASDAQ
5070,15-02-2021 22:00,24 hrs.,RobinHoodPennyStocks,RIOT,12,12,0,12,1,4,0,1,NASDAQ
5070,15-02-2021 22:00,24 hrs.,RobinHoodPennyStocks,SAVA,87,87,0,87,1,26,31,1,NASDAQ
5070,15-02-2021 22:00,24 hrs.,RobinHoodPennyStocks,SHIP,12,12,0,12,2,2,0,2,NASDAQ
5070,15-02-2021 22:00,24 hrs.,RobinHoodPennyStocks,SIRI,6,6,0,6,1,1,0,1,NASDAQ
5070,15-02-2021 22:00,24 hrs.,RobinHoodPennyStocks,SNCA,87,87,0,87,1,26,31,1,NASDAQ
5070,15-02-2021 22:00,24 hrs.,RobinHoodPennyStocks,SNDL,48,19,29,-10,4,4,24,4,NASDAQ
5070,15-02-2021 22:00,24 hrs.,RobinHoodPennyStocks,SRGA,87,87,0,87,1,26,31,1,NASDAQ
5070,15-02-2021 22:00,24 hrs.,RobinHoodPennyStocks,TNXP,482,350,132,218,3,158,154,3,NASDAQ
5070,15-02-2021 22:00,24 hrs.,RobinHoodPennyStocks,TRCH,107,103,4,99,3,26,43,3,NASDAQ
5070,15-02-2021 22:00,24 hrs.,RobinHoodPennyStocks,TXMD,362,356,6,350,4,105,136,4,NASDAQ
5070,15-02-2021 22:00,24 hrs.,RobinHoodPennyStocks,ZSAN,6,0,6,-6,1,1,0,1,NASDAQ
5070,15-02-2021 22:00,24 hrs.,RobinHoodPennyStocks,GGB,6,6,0,6,1,1,0,1,NYSE
5070,15-02-2021 22:00,24 hrs.,RobinHoodPennyStocks,NIO,6,0,6,-6,1,1,0,1,NYSE
5070,15-02-2021 22:00,24 hrs.,RobinHoodPennyStocks,NOK,6,6,0,6,1,1,0,1,NYSE
5070,15-02-2021 22:00,24 hrs.,RobinHoodPennyStocks,PBR,6,6,0,6,1,1,0,1,NYSE
5070,15-02-2021 22:00,24 hrs.,pennystocks,TSLA,38,38,0,38,2,12,6,2,NASDAQ
5070,15-02-2021 22:00,24 hrs.,pennystocks,TXMD,13,6,7,-1,2,2,1,2,NASDAQ
5070,15-02-2021 22:00,24 hrs.,pennystocks,VTNR,6,6,0,6,1,1,0,1,NASDAQ
5016,15-02-2021 12:00,24 hrs.,pennystocks,CCTL,12,0,12,-12,2,2,0,2,OTC
5016,15-02-2021 12:00,24 hrs.,pennystocks,ECEZ,7,7,0,7,1,1,1,1,OTC
5016,15-02-2021 12:00,24 hrs.,pennystocks,ETFM,13,13,0,13,1,4,1,1,OTC
5016,15-02-2021 12:00,24 hrs.,pennystocks,EXMT,70,0,70,-70,1,15,36,1,OTC
5016,15-02-2021 12:00,24 hrs.,pennystocks,FCTI,24,0,24,-24,1,9,2,1,OTC
5016,15-02-2021 12:00,24 hrs.,pennystocks,GAHC,7,0,7,-7,1,1,1,1,OTC
5016,15-02-2021 12:00,24 hrs.,pennystocks,GBFH,28,0,28,-28,1,5,14,1,OTC
5016,15-02-2021 12:00,24 hrs.,pennystocks,GBLX,6,0,6,-6,1,1,0,1,OTC
5016,15-02-2021 12:00,24 hrs.,pennystocks,GGII,7,0,7,-7,1,1,1,1,OTC
5016,15-02-2021 12:00,24 hrs.,pennystocks,GNPT,6,6,0,6,1,1,0,1,OTC
5016,15-02-2021 12:00,24 hrs.,pennystocks,AAGH,33,0,33,-33,1,8,13,1,OTC
5016,15-02-2021 12:00,24 hrs.,pennystocks,ABML,18,18,0,18,3,3,0,1,OTC
5016,15-02-2021 12:00,24 hrs.,pennystocks,AFPW,6,0,6,-6,1,1,0,1,OTC
5016,15-02-2021 12:00,24 hrs.,pennystocks,AITX,1052,88,964,-876,5,435,162,4,OTC
5016,15-02-2021 12:00,24 hrs.,pennystocks,ALPP,6,0,6,-6,1,1,0,1,OTC
5016,15-02-2021 12:00,24 hrs.,pennystocks,ASCK,39,0,39,-39,1,16,3,1,OTC
5016,15-02-2021 12:00,24 hrs.,pennystocks,ASTI,12,0,12,-12,2,2,0,2,OTC
5016,15-02-2021 12:00,24 hrs.,pennystocks,AURI,30,0,30,-30,2,7,8,2,OTC
5016,15-02-2021 12:00,24 hrs.,pennystocks,AZFL,6,6,0,6,1,1,0,1,OTC
5016,15-02-2021 12:00,24 hrs.,pennystocks,BANT,6,6,0,6,1,1,0,1,OTC
5016,15-02-2021 12:00,24 hrs.,pennystocks,BBRW,6,6,0,6,1,1,0,1,OTC
5016,15-02-2021 12:00,24 hrs.,pennystocks,BFCH,6,0,6,-6,1,1,0,1,OTC
5016,15-02-2021 12:00,24 hrs.,pennystocks,BIEL,9,0,9,-9,1,1,3,1,OTC
5016,15-02-2021 12:00,24 hrs.,pennystocks,BLPG,7,0,7,-7,1,1,1,1,OTC
5016,15-02-2021 12:00,24 hrs.,pennystocks,BLSP,6,6,0,6,1,1,0,1,OTC
5016,15-02-2021 12:00,24 hrs.,pennystocks,BMIX,7,0,7,-7,1,1,1,1,OTC
5016,15-02-2021 12:00,24 hrs.,pennystocks,BNGI,13,0,13,-13,2,2,1,2,OTC
5016,15-02-2021 12:00,24 hrs.,pennystocks,BOTY,6,0,6,-6,1,1,0,1,OTC
5016,15-02-2021 12:00,24 hrs.,pennystocks,BRAV,7,0,7,-7,1,1,1,1,OTC
5016,15-02-2021 12:00,24 hrs.,pennystocks,BRRN,909,0,909,-909,1,390,125,1,OTC
5016,15-02-2021 12:00,24 hrs.,pennystocks,BRZL,6,0,6,-6,1,1,0,1,OTC
5016,15-02-2021 12:00,24 hrs.,pennystocks,BTSC,6,0,6,-6,1,1,0,1,OTC
5016,15-02-2021 12:00,24 hrs.,pennystocks,BTZI,70,0,70,-70,1,15,36,1,OTC
5016,15-02-2021 12:00,24 hrs.,pennystocks,VGLS,7,0,7,-7,1,1,1,1,OTC
5016,15-02-2021 12:00,24 hrs.,pennystocks,VPER,113,106,7,99,2,26,53,2,OTC
5016,15-02-2021 12:00,24 hrs.,pennystocks,WARM,12,12,0,12,2,2,0,1,OTC
5016,15-02-2021 12:00,24 hrs.,pennystocks,WDLF,12,6,6,0,2,2,0,2,OTC
5016,15-02-2021 12:00,24 hrs.,pennystocks,XSPT,25,25,0,25,1,2,17,1,OTC
5016,15-02-2021 12:00,24 hrs.,pennystocks,ZHUD,6,6,0,6,1,1,0,1,OTC
5016,15-02-2021 12:00,24 hrs.,pennystocks,ABEPF,451,0,451,-451,1,197,53,1,OTC
5016,15-02-2021 12:00,24 hrs.,pennystocks,AMYZF,66,48,18,30,4,18,14,2,OTC
5016,15-02-2021 12:00,24 hrs.,pennystocks,ARAFF,44,0,44,-44,1,12,16,1,OTC
5016,15-02-2021 12:00,24 hrs.,pennystocks,ARBKF,1281,32,1249,-1217,6,489,279,6,OTC
5016,15-02-2021 12:00,24 hrs.,pennystocks,BEVVF,67,0,67,-67,1,22,19,1,OTC
5016,15-02-2021 12:00,24 hrs.,pennystocks,BLOZF,39,0,39,-39,1,8,19,1,OTC
5016,15-02-2021 12:00,24 hrs.,pennystocks,BVNNF,596,0,596,-596,1,256,80,1,OTC
5016,15-02-2021 12:00,24 hrs.,pennystocks,CHOOF,6,0,6,-6,1,1,0,1,OTC
5016,15-02-2021 12:00,24 hrs.,pennystocks,CYDVF,82,82,0,82,1,33,12,1,OTC
5016,15-02-2021 12:00,24 hrs.,pennystocks,DFMTF,38,0,38,-38,1,7,20,1,OTC
5016,15-02-2021 12:00,24 hrs.,pennystocks,DIGAF,7,0,7,-7,1,1,1,1,OTC
5016,15-02-2021 12:00,24 hrs.,pennystocks,FLURF,54,0,54,-54,4,11,16,2,OTC
5016,15-02-2021 12:00,24 hrs.,pennystocks,FUNFF,55,0,55,-55,1,22,7,1,OTC
5016,15-02-2021 12:00,24 hrs.,pennystocks,GKPRF,7,0,7,-7,1,1,1,1,OTC
5016,15-02-2021 12:00,24 hrs.,pennystocks,HITIF,1007,0,1007,-1007,2,406,187,2,OTC
5016,15-02-2021 12:00,24 hrs.,pennystocks,HMSNF,31,0,31,-31,1,11,5,1,OTC
5016,15-02-2021 12:00,24 hrs.,pennystocks,ITMPF,35,0,35,-35,3,8,7,2,OTC
5016,15-02-2021 12:00,24 hrs.,pennystocks,LIACF,11,11,0,11,1,3,1,1,OTC
5016,15-02-2021 12:00,24 hrs.,pennystocks,LKNCY,18,18,0,18,3,3,0,1,OTC
5016,15-02-2021 12:00,24 hrs.,pennystocks,MMEDF,909,0,909,-909,1,390,125,1,OTC
5016,15-02-2021 12:00,24 hrs.,pennystocks,MMNFF,6,0,6,-6,1,1,0,1,OTC
5016,15-02-2021 12:00,24 hrs.,pennystocks,MNXXF,7,7,0,7,1,1,1,1,OTC
5016,15-02-2021 12:00,24 hrs.,pennystocks,MSNVF,6,6,0,6,1,1,0,1,OTC
5016,15-02-2021 12:00,24 hrs.,pennystocks,NMGRF,107,0,107,-107,1,15,73,1,OTC
5016,15-02-2021 12:00,24 hrs.,pennystocks,NOSUF,909,0,909,-909,1,390,125,1,OTC
5016,15-02-2021 12:00,24 hrs.,pennystocks,GPFT,12,6,6,0,2,2,0,2,OTC
5016,15-02-2021 12:00,24 hrs.,pennystocks,GRCU,6,6,0,6,1,1,0,1,OTC
5016,15-02-2021 12:00,24 hrs.,pennystocks,GRLT,50,0,50,-50,1,13,20,1,OTC
5016,15-02-2021 12:00,24 hrs.,pennystocks,GRST,946,0,946,-946,2,402,134,2,OTC
5016,15-02-2021 12:00,24 hrs.,pennystocks,GTEH,30,24,6,18,2,9,4,2,OTC
5016,15-02-2021 12:00,24 hrs.,pennystocks,GTLL,967,7,960,-953,3,408,139,3,OTC
5016,15-02-2021 12:00,24 hrs.,pennystocks,HCMC,50,25,25,0,8,8,2,8,OTC
5016,15-02-2021 12:00,24 hrs.,pennystocks,HESG,6,0,6,-6,1,1,0,1,OTC
5016,15-02-2021 12:00,24 hrs.,pennystocks,HMPQ,13,0,13,-13,2,2,1,1,OTC
5016,15-02-2021 12:00,24 hrs.,pennystocks,HPMM,7,0,7,-7,1,1,1,1,OTC
5016,15-02-2021 12:00,24 hrs.,pennystocks,HQGE,13,7,6,1,2,2,1,2,OTC
5016,15-02-2021 12:00,24 hrs.,pennystocks,HWKE,6,0,6,-6,1,1,0,1,OTC
5016,15-02-2021 12:00,24 hrs.,pennystocks,HYSR,18,0,18,-18,1,3,8,1,OTC
5016,15-02-2021 12:00,24 hrs.,pennystocks,ICLD,13,0,13,-13,2,2,1,1,OTC
5016,15-02-2021 12:00,24 hrs.,pennystocks,ICNM,25,25,0,25,1,2,17,1,OTC
5016,15-02-2021 12:00,24 hrs.,pennystocks,IJJP,50,0,50,-50,1,13,20,1,OTC
5016,15-02-2021 12:00,24 hrs.,pennystocks,INKW,12,0,12,-12,2,2,0,2,OTC
5016,15-02-2021 12:00,24 hrs.,pennystocks,INND,206,7,199,-192,2,84,30,2,OTC
5016,15-02-2021 12:00,24 hrs.,pennystocks,IPIX,98,98,0,98,1,34,26,1,OTC
5016,15-02-2021 12:00,24 hrs.,pennystocks,IPSI,46,0,46,-46,1,15,12,1,OTC
5016,15-02-2021 12:00,24 hrs.,pennystocks,IQST,6,0,6,-6,1,1,0,1,OTC
5016,15-02-2021 12:00,24 hrs.,pennystocks,KWBT,6,0,6,-6,1,1,0,1,OTC
5016,15-02-2021 12:00,24 hrs.,pennystocks,LBSR,7,0,7,-7,1,1,1,1,OTC
5016,15-02-2021 12:00,24 hrs.,pennystocks,LCLP,6,0,6,-6,1,1,0,1,OTC
5016,15-02-2021 12:00,24 hrs.,pennystocks,LGBS,50,0,50,-50,1,13,20,1,OTC
5016,15-02-2021 12:00,24 hrs.,pennystocks,LLBO,13,13,0,13,2,2,1,1,OTC
5016,15-02-2021 12:00,24 hrs.,pennystocks,LTNC,56,0,56,-56,2,14,20,2,OTC
5016,15-02-2021 12:00,24 hrs.,pennystocks,MAXD,6,0,6,-6,1,1,0,1,OTC
5016,15-02-2021 12:00,24 hrs.,pennystocks,MEDH,6,6,0,6,1,1,0,1,OTC
5016,15-02-2021 12:00,24 hrs.,pennystocks,CBBT,106,106,0,106,1,25,52,1,OTC
5016,15-02-2021 12:00,24 hrs.,pennystocks,CBDD,70,0,70,-70,1,15,36,1,OTC
5016,15-02-2021 12:00,24 hrs.,pennystocks,CBDL,945,0,945,-945,3,400,133,3,OTC
5016,15-02-2021 12:00,24 hrs.,pennystocks,CBTC,6,6,0,6,1,1,0,1,OTC
5016,15-02-2021 12:00,24 hrs.,pennystocks,NAK,7,0,7,-7,1,1,1,1,AMEX
5016,15-02-2021 12:00,24 hrs.,pennystocks,NBY,909,0,909,-909,1,390,125,1,AMEX
5016,15-02-2021 12:00,24 hrs.,pennystocks,SYN,7,0,7,-7,1,1,1,1,AMEX
5016,15-02-2021 12:00,24 hrs.,pennystocks,TRX,6,0,6,-6,1,1,0,1,AMEX
5016,15-02-2021 12:00,24 hrs.,pennystocks,ZOM,96,50,46,4,5,22,32,5,AMEX
5016,15-02-2021 12:00,24 hrs.,pennystocks,INUV,6,6,0,6,1,1,0,1,AMEX
5016,15-02-2021 12:00,24 hrs.,pennystocks,NSPR,38,38,0,38,1,11,12,1,AMEX
5016,15-02-2021 12:00,24 hrs.,pennystocks,SENS,6,6,0,6,1,1,0,1,AMEX
5016,15-02-2021 12:00,24 hrs.,pennystocks,ACB,7,7,0,7,1,1,1,1,NYSE
5016,15-02-2021 12:00,24 hrs.,pennystocks,ADC,6,6,0,6,1,1,0,1,NYSE
5016,15-02-2021 12:00,24 hrs.,pennystocks,AMC,6,6,0,6,1,1,0,1,NYSE
5016,15-02-2021 12:00,24 hrs.,pennystocks,ASX,62,21,41,-20,8,12,6,3,NYSE
5016,15-02-2021 12:00,24 hrs.,pennystocks,CBD,909,0,909,-909,1,390,125,1,NYSE
5016,15-02-2021 12:00,24 hrs.,pennystocks,CMC,145,0,145,-145,1,45,51,1,NYSE
5016,15-02-2021 12:00,24 hrs.,pennystocks,CSV,71,71,0,71,1,32,3,1,NYSE
5016,15-02-2021 12:00,24 hrs.,pennystocks,FIT,6,0,6,-6,1,1,0,1,NYSE
5016,15-02-2021 12:00,24 hrs.,pennystocks,FRA,82,82,0,82,1,33,12,1,NYSE
5016,15-02-2021 12:00,24 hrs.,pennystocks,GME,6,0,6,-6,1,1,0,1,NYSE
5016,15-02-2021 12:00,24 hrs.,pennystocks,HPQ,6,0,6,-6,1,1,0,1,NYSE
5016,15-02-2021 12:00,24 hrs.,pennystocks,IRS,378,0,378,-378,1,173,28,1,NYSE
5016,15-02-2021 12:00,24 hrs.,pennystocks,NAT,6,0,6,-6,1,1,0,1,NYSE
5016,15-02-2021 12:00,24 hrs.,pennystocks,NIO,7,7,0,7,1,1,1,1,NYSE
5016,15-02-2021 12:00,24 hrs.,pennystocks,PDT,6,6,0,6,1,1,0,1,NYSE
5016,15-02-2021 12:00,24 hrs.,pennystocks,PEG,910,0,910,-910,1,424,58,1,NYSE
5016,15-02-2021 12:00,24 hrs.,pennystocks,PSA,6,6,0,6,1,1,0,1,NYSE
5016,15-02-2021 12:00,24 hrs.,pennystocks,RSI,910,0,910,-910,1,424,58,1,NYSE
5016,15-02-2021 12:00,24 hrs.,pennystocks,SOS,1137,7,1130,-1123,5,449,219,4,NYSE
5016,15-02-2021 12:00,24 hrs.,pennystocks,TWI,6,6,0,6,1,1,0,1,NYSE
5016,15-02-2021 12:00,24 hrs.,pennystocks,ABBV,27,0,27,-27,1,6,11,1,NYSE
5016,15-02-2021 12:00,24 hrs.,pennystocks,ARGO,1098,0,1098,-1098,2,452,186,2,NYSE
5016,15-02-2021 12:00,24 hrs.,pennystocks,COLD,17,17,0,17,1,3,7,1,NYSE
5016,15-02-2021 12:00,24 hrs.,pennystocks,SPOT,6,6,0,6,1,1,0,1,NYSE
5016,15-02-2021 12:00,24 hrs.,pennystocks,API,11,11,0,11,1,3,1,1,NASDAQ
5016,15-02-2021 12:00,24 hrs.,pennystocks,III,12,12,0,12,2,2,0,1,NASDAQ
5016,15-02-2021 12:00,24 hrs.,pennystocks,KOD,12,0,12,-12,2,2,0,1,NASDAQ
5016,15-02-2021 12:00,24 hrs.,pennystocks,OLB,6,0,6,-6,1,1,0,1,NASDAQ
5016,15-02-2021 12:00,24 hrs.,pennystocks,MFST,6,6,0,6,1,1,0,1,OTC
5016,15-02-2021 12:00,24 hrs.,pennystocks,MINE,213,60,153,-93,2,73,59,2,OTC
5016,15-02-2021 12:00,24 hrs.,pennystocks,MJWL,50,0,50,-50,1,13,20,1,OTC
5016,15-02-2021 12:00,24 hrs.,pennystocks,MLFB,6,6,0,6,1,1,0,1,OTC
5016,15-02-2021 12:00,24 hrs.,pennystocks,MRNJ,7,0,7,-7,1,1,1,1,OTC
5016,15-02-2021 12:00,24 hrs.,pennystocks,NLST,75,33,42,-9,2,14,39,2,OTC
5016,15-02-2021 12:00,24 hrs.,pennystocks,ONPH,6,0,6,-6,1,1,0,1,OTC
5016,15-02-2021 12:00,24 hrs.,pennystocks,OZSC,7,7,0,7,1,1,1,1,OTC
5016,15-02-2021 12:00,24 hrs.,pennystocks,PHBI,6,6,0,6,1,1,0,1,OTC
5016,15-02-2021 12:00,24 hrs.,pennystocks,PHCG,6,6,0,6,1,1,0,1,OTC
5016,15-02-2021 12:00,24 hrs.,pennystocks,PLYZ,6,0,6,-6,1,1,0,1,OTC
5016,15-02-2021 12:00,24 hrs.,pennystocks,PPJE,7,0,7,-7,1,1,1,1,OTC
5016,15-02-2021 12:00,24 hrs.,pennystocks,PRMO,50,0,50,-50,1,13,20,1,OTC
5016,15-02-2021 12:00,24 hrs.,pennystocks,PUGE,114,0,114,-114,2,31,44,2,OTC
5016,15-02-2021 12:00,24 hrs.,pennystocks,PVDG,39,0,39,-39,1,8,19,1,OTC
5016,15-02-2021 12:00,24 hrs.,pennystocks,RBNW,6,6,0,6,1,1,0,1,OTC
5016,15-02-2021 12:00,24 hrs.,pennystocks,SEEK,25,25,0,25,1,2,17,1,OTC
5016,15-02-2021 12:00,24 hrs.,pennystocks,SGMD,124,0,124,-124,2,38,40,2,OTC
5016,15-02-2021 12:00,24 hrs.,pennystocks,SHMP,6,0,6,-6,1,1,0,1,OTC
5016,15-02-2021 12:00,24 hrs.,pennystocks,SING,6,0,6,-6,1,1,0,1,OTC
5016,15-02-2021 12:00,24 hrs.,pennystocks,SNPW,216,128,88,40,11,69,34,6,OTC
5016,15-02-2021 12:00,24 hrs.,pennystocks,SRMX,89,0,89,-89,2,21,39,2,OTC
5016,15-02-2021 12:00,24 hrs.,pennystocks,SSFT,168,162,6,156,2,67,26,2,OTC
5016,15-02-2021 12:00,24 hrs.,pennystocks,STHC,18,18,0,18,1,6,2,1,OTC
5016,15-02-2021 12:00,24 hrs.,pennystocks,TGGI,7,0,7,-7,1,1,1,1,OTC
5016,15-02-2021 12:00,24 hrs.,pennystocks,TLGN,909,0,909,-909,1,390,125,1,OTC
5016,15-02-2021 12:00,24 hrs.,pennystocks,TSNP,137,91,46,45,3,41,43,3,OTC
5016,15-02-2021 12:00,24 hrs.,pennystocks,UDHI,6,0,6,-6,1,1,0,1,OTC
5016,15-02-2021 12:00,24 hrs.,pennystocks,TECH,6,6,0,6,1,1,0,1,NASDAQ
5016,15-02-2021 12:00,24 hrs.,pennystocks,TMDI,6,6,0,6,1,1,0,1,NASDAQ
5016,15-02-2021 12:00,24 hrs.,pennystocks,TNXP,283,192,91,101,4,102,63,4,NASDAQ
5016,15-02-2021 12:00,24 hrs.,pennystocks,TRIB,6,6,0,6,1,1,0,1,NASDAQ
5016,15-02-2021 12:00,24 hrs.,pennystocks,TXMD,7,7,0,7,1,1,1,1,NASDAQ
5016,15-02-2021 12:00,24 hrs.,pennystocks,WRAP,10,0,10,-10,1,1,4,1,NASDAQ
5016,15-02-2021 12:00,24 hrs.,pennystocks,RNWK,6,6,0,6,1,1,0,1,NASDAQ
5016,15-02-2021 12:00,24 hrs.,pennystocks,SELF,6,0,6,-6,1,1,0,1,NASDAQ
5016,15-02-2021 12:00,24 hrs.,pennystocks,SHIP,12,0,12,-12,2,2,0,1,NASDAQ
5016,15-02-2021 12:00,24 hrs.,pennystocks,SNDL,19,7,12,-5,3,3,1,3,NASDAQ
5016,15-02-2021 12:00,24 hrs.,pennystocks,SNGX,90,0,90,-90,3,30,18,2,NASDAQ
5016,15-02-2021 12:00,24 hrs.,pennystocks,SOLO,7,7,0,7,1,1,1,1,NASDAQ
5016,15-02-2021 12:00,24 hrs.,pennystocks,TBLT,6,6,0,6,1,1,0,1,NASDAQ
5016,15-02-2021 12:00,24 hrs.,pennystocks,SND,909,0,909,-909,1,390,125,1,NASDAQ
5016,15-02-2021 12:00,24 hrs.,pennystocks,AAPL,910,0,910,-910,1,424,58,1,NASDAQ
5016,15-02-2021 12:00,24 hrs.,pennystocks,ABEO,909,0,909,-909,1,390,125,1,NASDAQ
5016,15-02-2021 12:00,24 hrs.,pennystocks,ACST,7,7,0,7,1,1,1,1,NASDAQ
5016,15-02-2021 12:00,24 hrs.,pennystocks,ADMP,7,0,7,-7,1,1,1,1,NASDAQ
5016,15-02-2021 12:00,24 hrs.,pennystocks,ADTX,27,0,27,-27,1,0,23,1,NASDAQ
5016,15-02-2021 12:00,24 hrs.,pennystocks,AGTC,124,98,26,72,2,51,14,2,NASDAQ
5016,15-02-2021 12:00,24 hrs.,pennystocks,APHA,7,7,0,7,1,1,1,1,NASDAQ
5016,15-02-2021 12:00,24 hrs.,pennystocks,ARTL,6,6,0,6,1,1,0,1,NASDAQ
5016,15-02-2021 12:00,24 hrs.,pennystocks,ASRT,173,173,0,173,9,59,19,2,NASDAQ
5016,15-02-2021 12:00,24 hrs.,pennystocks,ATOS,66,0,66,-66,2,8,42,2,NASDAQ
5016,15-02-2021 12:00,24 hrs.,pennystocks,BCRX,6,6,0,6,1,1,0,1,NASDAQ
5016,15-02-2021 12:00,24 hrs.,pennystocks,BHTG,9,0,9,-9,1,0,5,1,NASDAQ
5016,15-02-2021 12:00,24 hrs.,pennystocks,BIOL,6,6,0,6,1,1,0,1,NASDAQ
5016,15-02-2021 12:00,24 hrs.,pennystocks,BLRX,6,0,6,-6,1,1,0,1,NASDAQ
5016,15-02-2021 12:00,24 hrs.,pennystocks,CFMS,13,0,13,-13,2,2,1,1,NASDAQ
5016,15-02-2021 12:00,24 hrs.,pennystocks,CGIX,6,6,0,6,1,1,0,1,NASDAQ
5016,15-02-2021 12:00,24 hrs.,pennystocks,CHEK,6,0,6,-6,1,1,0,1,NASDAQ
5016,15-02-2021 12:00,24 hrs.,pennystocks,CIDM,139,48,91,-43,2,51,29,2,NASDAQ
5016,15-02-2021 12:00,24 hrs.,pennystocks,CLBS,932,0,932,-932,2,395,134,2,NASDAQ
5016,15-02-2021 12:00,24 hrs.,pennystocks,CLSN,6,0,6,-6,1,1,0,1,NASDAQ
5016,15-02-2021 12:00,24 hrs.,pennystocks,CRBP,13,7,6,1,2,2,1,2,NASDAQ
5016,15-02-2021 12:00,24 hrs.,pennystocks,CTMX,909,0,909,-909,1,390,125,1,NASDAQ
5016,15-02-2021 12:00,24 hrs.,pennystocks,CTRM,27,20,7,13,4,4,3,4,NASDAQ
5016,15-02-2021 12:00,24 hrs.,pennystocks,DFFN,909,0,909,-909,1,390,125,1,NASDAQ
5016,15-02-2021 12:00,24 hrs.,pennystocks,EDIT,542,374,168,206,4,228,70,4,NASDAQ
5016,15-02-2021 12:00,24 hrs.,pennystocks,GLBS,909,0,909,-909,1,390,125,1,NASDAQ
5016,15-02-2021 12:00,24 hrs.,pennystocks,GOEV,7,7,0,7,1,1,1,1,NASDAQ
5016,15-02-2021 12:00,24 hrs.,pennystocks,IBKR,29,0,29,-29,1,0,25,1,NASDAQ
5016,15-02-2021 12:00,24 hrs.,pennystocks,INPX,46,46,0,46,1,18,6,1,NASDAQ
5016,15-02-2021 12:00,24 hrs.,pennystocks,LAZY,9,0,9,-9,1,2,1,1,NASDAQ
5016,15-02-2021 12:00,24 hrs.,pennystocks,MARA,83,0,83,-83,1,17,45,1,NASDAQ
5016,15-02-2021 12:00,24 hrs.,pennystocks,NAKD,916,7,909,-902,2,391,126,2,NASDAQ
5016,15-02-2021 12:00,24 hrs.,pennystocks,NOVN,6,0,6,-6,1,1,0,1,NASDAQ
5016,15-02-2021 12:00,24 hrs.,pennystocks,NVAX,27,0,27,-27,1,0,23,1,NASDAQ
5016,15-02-2021 12:00,24 hrs.,pennystocks,PLUS,22,0,22,-22,1,4,10,1,NASDAQ
5016,15-02-2021 12:00,24 hrs.,pennystocks,PULM,6,0,6,-6,1,1,0,1,NASDAQ
5016,15-02-2021 12:00,24 hrs.,pennystocks,RIOT,83,0,83,-83,1,17,45,1,NASDAQ
5016,15-02-2021 12:00,24 hrs.,pennystocks,NXTTF,8,0,8,-8,1,1,2,1,OTC
5016,15-02-2021 12:00,24 hrs.,pennystocks,PLUUF,11,11,0,11,1,3,1,1,OTC
5016,15-02-2021 12:00,24 hrs.,pennystocks,RAREF,38,0,38,-38,1,7,20,1,OTC
5016,15-02-2021 12:00,24 hrs.,pennystocks,SHLOQ,7,0,7,-7,1,1,1,1,OTC
5016,15-02-2021 12:00,24 hrs.,pennystocks,SPRWF,41,41,0,41,3,12,5,2,OTC
5016,15-02-2021 12:00,24 hrs.,pennystocks,TAKOF,942,6,936,-930,3,392,146,3,OTC
5016,15-02-2021 12:00,24 hrs.,pennystocks,TRGGF,6,0,6,-6,1,1,0,1,OTC
5016,15-02-2021 12:00,24 hrs.,pennystocks,CTO,51,51,0,51,1,9,29,1,AMEX
5016,15-02-2021 12:00,24 hrs.,pennystocks,DNN,6,0,6,-6,1,1,0,1,AMEX
5016,15-02-2021 12:00,24 hrs.,pennystocks,DPW,909,0,909,-909,1,390,125,1,AMEX
5016,15-02-2021 12:00,24 hrs.,pennystocks,GPL,24,24,0,24,1,8,4,1,AMEX
5016,15-02-2021 12:00,24 hrs.,pennystocks,GSV,7,7,0,7,1,1,1,1,AMEX
5016,15-02-2021 12:00,24 hrs.,pennystocks,GTE,74,0,74,-74,1,23,24,1,AMEX
5005,15-02-2021 10:00,24 hrs.,pennystocks,ADTX,27,0,27,-27,1,0,23,1,NASDAQ
5005,15-02-2021 10:00,24 hrs.,pennystocks,AGTC,127,97,30,67,2,53,13,2,NASDAQ
5005,15-02-2021 10:00,24 hrs.,pennystocks,APHA,7,7,0,7,1,1,1,1,NASDAQ
5005,15-02-2021 10:00,24 hrs.,pennystocks,ARTL,6,6,0,6,1,1,0,1,NASDAQ
5005,15-02-2021 10:00,24 hrs.,pennystocks,FUNFF,59,0,59,-59,1,24,7,1,OTC
5005,15-02-2021 10:00,24 hrs.,pennystocks,GKPRF,7,0,7,-7,1,1,1,1,OTC
5005,15-02-2021 10:00,24 hrs.,pennystocks,HITIF,972,0,972,-972,2,391,182,2,OTC
5005,15-02-2021 10:00,24 hrs.,pennystocks,HMSNF,27,0,27,-27,1,9,5,1,OTC
5005,15-02-2021 10:00,24 hrs.,pennystocks,ITMPF,33,0,33,-33,3,7,7,2,OTC
5005,15-02-2021 10:00,24 hrs.,pennystocks,LIACF,9,9,0,9,1,2,1,1,OTC
5005,15-02-2021 10:00,24 hrs.,pennystocks,LKNCY,12,12,0,12,2,2,0,1,OTC
5005,15-02-2021 10:00,24 hrs.,pennystocks,MMEDF,876,0,876,-876,1,376,120,1,OTC
5005,15-02-2021 10:00,24 hrs.,pennystocks,MMNFF,6,6,0,6,1,1,0,1,OTC
5005,15-02-2021 10:00,24 hrs.,pennystocks,MNXXF,7,7,0,7,1,1,1,1,OTC
5005,15-02-2021 10:00,24 hrs.,pennystocks,MSNVF,6,6,0,6,1,1,0,1,OTC
5005,15-02-2021 10:00,24 hrs.,pennystocks,NMGRF,102,102,0,102,1,13,72,1,OTC
5005,15-02-2021 10:00,24 hrs.,pennystocks,NOSUF,876,0,876,-876,1,376,120,1,OTC
5005,15-02-2021 10:00,24 hrs.,pennystocks,NXTTF,8,8,0,8,1,1,2,1,OTC
5005,15-02-2021 10:00,24 hrs.,pennystocks,PLUUF,9,9,0,9,1,2,1,1,OTC
5005,15-02-2021 10:00,24 hrs.,pennystocks,RAREF,44,0,44,-44,1,10,20,1,OTC
5005,15-02-2021 10:00,24 hrs.,pennystocks,SHLOQ,7,7,0,7,1,1,1,1,OTC
5005,15-02-2021 10:00,24 hrs.,pennystocks,SPRWF,45,45,0,45,3,14,5,2,OTC
5005,15-02-2021 10:00,24 hrs.,pennystocks,TAKOF,901,0,901,-901,2,376,141,2,OTC
5005,15-02-2021 10:00,24 hrs.,pennystocks,TRGGF,6,6,0,6,1,1,0,1,OTC
5005,15-02-2021 10:00,24 hrs.,pennystocks,CTO,12,12,0,12,1,2,4,1,AMEX
5005,15-02-2021 10:00,24 hrs.,pennystocks,DNN,6,0,6,-6,1,1,0,1,AMEX
5005,15-02-2021 10:00,24 hrs.,pennystocks,DPW,876,0,876,-876,1,376,120,1,AMEX
5005,15-02-2021 10:00,24 hrs.,pennystocks,GPL,24,24,0,24,1,8,4,1,AMEX
5005,15-02-2021 10:00,24 hrs.,pennystocks,GSV,7,7,0,7,1,1,1,1,AMEX
5005,15-02-2021 10:00,24 hrs.,pennystocks,GTE,65,0,65,-65,1,19,23,1,AMEX
5005,15-02-2021 10:00,24 hrs.,pennystocks,NAK,7,0,7,-7,1,1,1,1,AMEX
5005,15-02-2021 10:00,24 hrs.,pennystocks,NBY,876,0,876,-876,1,376,120,1,AMEX
5005,15-02-2021 10:00,24 hrs.,pennystocks,SYN,7,0,7,-7,1,1,1,1,AMEX
5005,15-02-2021 10:00,24 hrs.,pennystocks,TRX,6,0,6,-6,1,1,0,1,AMEX
5005,15-02-2021 10:00,24 hrs.,pennystocks,ZOM,92,50,42,8,5,20,32,5,AMEX
5005,15-02-2021 10:00,24 hrs.,pennystocks,NSPR,38,38,0,38,1,11,12,1,AMEX
5005,15-02-2021 10:00,24 hrs.,pennystocks,ACB,7,7,0,7,1,1,1,1,NYSE
5005,15-02-2021 10:00,24 hrs.,pennystocks,ADC,6,6,0,6,1,1,0,1,NYSE
5005,15-02-2021 10:00,24 hrs.,pennystocks,AMC,6,6,0,6,1,1,0,1,NYSE
5005,15-02-2021 10:00,24 hrs.,pennystocks,ASX,60,19,41,-22,8,11,6,3,NYSE
5005,15-02-2021 10:00,24 hrs.,pennystocks,BKD,42,0,42,-42,1,15,8,1,NYSE
5005,15-02-2021 10:00,24 hrs.,pennystocks,CBD,876,0,876,-876,1,376,120,1,NYSE
5005,15-02-2021 10:00,24 hrs.,pennystocks,CMC,139,0,139,-139,1,43,49,1,NYSE
5005,15-02-2021 10:00,24 hrs.,pennystocks,FIT,6,6,0,6,1,1,0,1,NYSE
5005,15-02-2021 10:00,24 hrs.,pennystocks,FRA,76,76,0,76,1,30,12,1,NYSE
5005,15-02-2021 10:00,24 hrs.,pennystocks,GME,6,0,6,-6,1,1,0,1,NYSE
5005,15-02-2021 10:00,24 hrs.,pennystocks,HPQ,6,0,6,-6,1,1,0,1,NYSE
5005,15-02-2021 10:00,24 hrs.,pennystocks,IRS,372,0,372,-372,1,170,28,1,NYSE
5005,15-02-2021 10:00,24 hrs.,pennystocks,NAT,6,0,6,-6,1,1,0,1,NYSE
5005,15-02-2021 10:00,24 hrs.,pennystocks,NIO,7,7,0,7,1,1,1,1,NYSE
5005,15-02-2021 10:00,24 hrs.,pennystocks,PDT,6,6,0,6,1,1,0,1,NYSE
5005,15-02-2021 10:00,24 hrs.,pennystocks,PEG,800,0,800,-800,1,371,54,1,NYSE
5005,15-02-2021 10:00,24 hrs.,pennystocks,PSA,6,6,0,6,1,1,0,1,NYSE
5005,15-02-2021 10:00,24 hrs.,pennystocks,RSI,800,0,800,-800,1,371,54,1,NYSE
5005,15-02-2021 10:00,24 hrs.,pennystocks,SOS,1099,85,1014,-929,5,433,213,4,NYSE
5005,15-02-2021 10:00,24 hrs.,pennystocks,TWI,6,6,0,6,1,1,0,1,NYSE
5005,15-02-2021 10:00,24 hrs.,pennystocks,ABBV,23,0,23,-23,1,4,11,1,NYSE
5005,15-02-2021 10:00,24 hrs.,pennystocks,ARGO,1051,0,1051,-1051,2,432,179,2,NYSE
5005,15-02-2021 10:00,24 hrs.,pennystocks,COLD,19,19,0,19,1,4,7,1,NYSE
5005,15-02-2021 10:00,24 hrs.,pennystocks,SPOT,6,6,0,6,1,1,0,1,NYSE
5005,15-02-2021 10:00,24 hrs.,pennystocks,API,11,11,0,11,1,3,1,1,NASDAQ
5005,15-02-2021 10:00,24 hrs.,pennystocks,KOD,12,0,12,-12,2,2,0,1,NASDAQ
5005,15-02-2021 10:00,24 hrs.,pennystocks,OLB,6,0,6,-6,1,1,0,1,NASDAQ
5005,15-02-2021 10:00,24 hrs.,pennystocks,SND,876,0,876,-876,1,376,120,1,NASDAQ
5005,15-02-2021 10:00,24 hrs.,pennystocks,AAPL,800,0,800,-800,1,371,54,1,NASDAQ
5005,15-02-2021 10:00,24 hrs.,pennystocks,ABEO,876,0,876,-876,1,376,120,1,NASDAQ
5005,15-02-2021 10:00,24 hrs.,pennystocks,ACST,7,7,0,7,1,1,1,1,NASDAQ
5005,15-02-2021 10:00,24 hrs.,pennystocks,ADMP,7,0,7,-7,1,1,1,1,NASDAQ
5005,15-02-2021 10:00,24 hrs.,pennystocks,TLGN,876,0,876,-876,1,376,120,1,OTC
5005,15-02-2021 10:00,24 hrs.,pennystocks,TSNP,123,81,42,39,3,35,41,3,OTC
5005,15-02-2021 10:00,24 hrs.,pennystocks,UDHI,6,0,6,-6,1,1,0,1,OTC
5005,15-02-2021 10:00,24 hrs.,pennystocks,VGLS,7,0,7,-7,1,1,1,1,OTC
5005,15-02-2021 10:00,24 hrs.,pennystocks,VPER,7,0,7,-7,1,1,1,1,OTC
5005,15-02-2021 10:00,24 hrs.,pennystocks,WDLF,12,6,6,0,2,2,0,2,OTC
5005,15-02-2021 10:00,24 hrs.,pennystocks,XSPT,29,29,0,29,1,4,17,1,OTC
5005,15-02-2021 10:00,24 hrs.,pennystocks,ZHUD,6,6,0,6,1,1,0,1,OTC
5005,15-02-2021 10:00,24 hrs.,pennystocks,ABEPF,444,0,444,-444,1,195,50,1,OTC
5005,15-02-2021 10:00,24 hrs.,pennystocks,AMYZF,53,35,18,17,4,12,13,2,OTC
5005,15-02-2021 10:00,24 hrs.,pennystocks,ARAFF,50,0,50,-50,1,15,16,1,OTC
5005,15-02-2021 10:00,24 hrs.,pennystocks,ARBKF,1244,110,1134,-1024,7,467,282,7,OTC
5005,15-02-2021 10:00,24 hrs.,pennystocks,BEVVF,61,0,61,-61,1,19,19,1,OTC
5005,15-02-2021 10:00,24 hrs.,pennystocks,BLOZF,35,0,35,-35,1,6,19,1,OTC
5005,15-02-2021 10:00,24 hrs.,pennystocks,BVNNF,573,0,573,-573,1,245,79,1,OTC
5005,15-02-2021 10:00,24 hrs.,pennystocks,CHOOF,6,0,6,-6,1,1,0,1,OTC
5005,15-02-2021 10:00,24 hrs.,pennystocks,CYDVF,76,76,0,76,1,30,12,1,OTC
5005,15-02-2021 10:00,24 hrs.,pennystocks,DFMTF,44,0,44,-44,1,10,20,1,OTC
5005,15-02-2021 10:00,24 hrs.,pennystocks,DIGAF,7,7,0,7,1,1,1,1,OTC
5005,15-02-2021 10:00,24 hrs.,pennystocks,FLURF,54,54,0,54,4,11,16,2,OTC
5005,15-02-2021 10:00,24 hrs.,pennystocks,PUGE,112,51,61,-10,2,30,44,2,OTC
5005,15-02-2021 10:00,24 hrs.,pennystocks,PVDG,35,0,35,-35,1,6,19,1,OTC
5005,15-02-2021 10:00,24 hrs.,pennystocks,RBNW,6,6,0,6,1,1,0,1,OTC
5005,15-02-2021 10:00,24 hrs.,pennystocks,SEEK,29,29,0,29,1,4,17,1,OTC
5005,15-02-2021 10:00,24 hrs.,pennystocks,SGMD,126,126,0,126,2,39,40,2,OTC
5005,15-02-2021 10:00,24 hrs.,pennystocks,SGSI,42,0,42,-42,1,15,8,1,OTC
5005,15-02-2021 10:00,24 hrs.,pennystocks,SHMP,6,0,6,-6,1,1,0,1,OTC
5005,15-02-2021 10:00,24 hrs.,pennystocks,SING,6,0,6,-6,1,1,0,1,OTC
5005,15-02-2021 10:00,24 hrs.,pennystocks,SNPW,217,127,90,37,11,70,33,6,OTC
5005,15-02-2021 10:00,24 hrs.,pennystocks,SRMX,85,0,85,-85,2,19,39,2,OTC
5005,15-02-2021 10:00,24 hrs.,pennystocks,SSFT,156,150,6,144,2,61,26,2,OTC
5005,15-02-2021 10:00,24 hrs.,pennystocks,STHC,14,14,0,14,1,4,2,1,OTC
5005,15-02-2021 10:00,24 hrs.,pennystocks,TGGI,7,0,7,-7,1,1,1,1,OTC
5005,15-02-2021 10:00,24 hrs.,pennystocks,BLSP,6,6,0,6,1,1,0,1,OTC
5005,15-02-2021 10:00,24 hrs.,pennystocks,BMIX,7,0,7,-7,1,1,1,1,OTC
5005,15-02-2021 10:00,24 hrs.,pennystocks,BNGI,13,0,13,-13,2,2,1,2,OTC
5005,15-02-2021 10:00,24 hrs.,pennystocks,BOTY,6,0,6,-6,1,1,0,1,OTC
5005,15-02-2021 10:00,24 hrs.,pennystocks,BRAV,7,0,7,-7,1,1,1,1,OTC
5005,15-02-2021 10:00,24 hrs.,pennystocks,BRRN,876,0,876,-876,1,376,120,1,OTC
5005,15-02-2021 10:00,24 hrs.,pennystocks,BRZL,6,6,0,6,1,1,0,1,OTC
5005,15-02-2021 10:00,24 hrs.,pennystocks,BTSC,6,0,6,-6,1,1,0,1,OTC
5005,15-02-2021 10:00,24 hrs.,pennystocks,BTZI,68,0,68,-68,1,14,36,1,OTC
5005,15-02-2021 10:00,24 hrs.,pennystocks,CBDD,68,0,68,-68,1,14,36,1,OTC
5005,15-02-2021 10:00,24 hrs.,pennystocks,CBDL,912,0,912,-912,3,386,128,3,OTC
5005,15-02-2021 10:00,24 hrs.,pennystocks,CBTC,6,6,0,6,1,1,0,1,OTC
5005,15-02-2021 10:00,24 hrs.,pennystocks,CCTL,12,0,12,-12,2,2,0,2,OTC
5005,15-02-2021 10:00,24 hrs.,pennystocks,CHUC,26,0,26,-26,1,7,8,1,OTC
5005,15-02-2021 10:00,24 hrs.,pennystocks,COUV,51,0,51,-51,1,9,29,1,OTC
5005,15-02-2021 10:00,24 hrs.,pennystocks,ECEZ,7,7,0,7,1,1,1,1,OTC
5005,15-02-2021 10:00,24 hrs.,pennystocks,EXMT,68,0,68,-68,1,14,36,1,OTC
5005,15-02-2021 10:00,24 hrs.,pennystocks,FCTI,26,0,26,-26,1,10,2,1,OTC
5005,15-02-2021 10:00,24 hrs.,pennystocks,GAHC,7,0,7,-7,1,1,1,1,OTC
5005,15-02-2021 10:00,24 hrs.,pennystocks,GBFH,26,0,26,-26,1,4,14,1,OTC
5005,15-02-2021 10:00,24 hrs.,pennystocks,GBLX,6,6,0,6,1,1,0,1,OTC
5005,15-02-2021 10:00,24 hrs.,pennystocks,GGII,7,0,7,-7,1,1,1,1,OTC
5005,15-02-2021 10:00,24 hrs.,pennystocks,GNPT,6,6,0,6,1,1,0,1,OTC
5005,15-02-2021 10:00,24 hrs.,pennystocks,GPFT,12,12,0,12,2,2,0,2,OTC
5005,15-02-2021 10:00,24 hrs.,pennystocks,GRCU,6,6,0,6,1,1,0,1,OTC
5005,15-02-2021 10:00,24 hrs.,pennystocks,GRLT,50,0,50,-50,1,13,20,1,OTC
5005,15-02-2021 10:00,24 hrs.,pennystocks,GRST,913,0,913,-913,2,388,129,2,OTC
5005,15-02-2021 10:00,24 hrs.,pennystocks,GTEH,30,30,0,30,2,9,4,2,OTC
5005,15-02-2021 10:00,24 hrs.,pennystocks,GTLL,930,0,930,-930,2,395,132,2,OTC
5005,15-02-2021 10:00,24 hrs.,pennystocks,HCMC,50,31,19,12,8,8,2,8,OTC
5005,15-02-2021 10:00,24 hrs.,pennystocks,HESG,6,0,6,-6,1,1,0,1,OTC
5005,15-02-2021 10:00,24 hrs.,pennystocks,HMPQ,13,0,13,-13,2,2,1,1,OTC
5005,15-02-2021 10:00,24 hrs.,pennystocks,HPMM,7,0,7,-7,1,1,1,1,OTC
5005,15-02-2021 10:00,24 hrs.,pennystocks,HQGE,13,7,6,1,2,2,1,2,OTC
5005,15-02-2021 10:00,24 hrs.,pennystocks,HWKE,6,0,6,-6,1,1,0,1,OTC
5005,15-02-2021 10:00,24 hrs.,pennystocks,HYSR,18,0,18,-18,1,3,8,1,OTC
5005,15-02-2021 10:00,24 hrs.,pennystocks,ICLD,13,13,0,13,2,2,1,1,OTC
5005,15-02-2021 10:00,24 hrs.,pennystocks,ICNM,29,29,0,29,1,4,17,1,OTC
5005,15-02-2021 10:00,24 hrs.,pennystocks,IJJP,50,0,50,-50,1,13,20,1,OTC
5005,15-02-2021 10:00,24 hrs.,pennystocks,INKW,12,6,6,0,2,2,0,2,OTC
5005,15-02-2021 10:00,24 hrs.,pennystocks,INND,204,7,197,-190,2,83,30,2,OTC
5005,15-02-2021 10:00,24 hrs.,pennystocks,IPIX,96,96,0,96,1,34,24,1,OTC
5005,15-02-2021 10:00,24 hrs.,pennystocks,IPSI,42,0,42,-42,1,13,12,1,OTC
5005,15-02-2021 10:00,24 hrs.,pennystocks,IQST,6,6,0,6,1,1,0,1,OTC
5005,15-02-2021 10:00,24 hrs.,pennystocks,KWBT,6,0,6,-6,1,1,0,1,OTC
5005,15-02-2021 10:00,24 hrs.,pennystocks,LBSR,7,0,7,-7,1,1,1,1,OTC
5005,15-02-2021 10:00,24 hrs.,pennystocks,LCLP,6,0,6,-6,1,1,0,1,OTC
5005,15-02-2021 10:00,24 hrs.,pennystocks,LGBS,50,0,50,-50,1,13,20,1,OTC
5005,15-02-2021 10:00,24 hrs.,pennystocks,LTNC,56,0,56,-56,2,14,20,2,OTC
5005,15-02-2021 10:00,24 hrs.,pennystocks,MAXD,6,0,6,-6,1,1,0,1,OTC
5005,15-02-2021 10:00,24 hrs.,pennystocks,MEDH,6,6,0,6,1,1,0,1,OTC
5005,15-02-2021 10:00,24 hrs.,pennystocks,MFST,6,6,0,6,1,1,0,1,OTC
5005,15-02-2021 10:00,24 hrs.,pennystocks,MINE,218,58,160,-102,4,72,58,3,OTC
5005,15-02-2021 10:00,24 hrs.,pennystocks,MJWL,50,0,50,-50,1,13,20,1,OTC
5005,15-02-2021 10:00,24 hrs.,pennystocks,MLFB,172,6,166,-160,2,54,56,2,OTC
5005,15-02-2021 10:00,24 hrs.,pennystocks,MRNJ,7,0,7,-7,1,1,1,1,OTC
5005,15-02-2021 10:00,24 hrs.,pennystocks,NLST,71,31,40,-9,2,12,39,2,OTC
5005,15-02-2021 10:00,24 hrs.,pennystocks,ONPH,6,0,6,-6,1,1,0,1,OTC
5005,15-02-2021 10:00,24 hrs.,pennystocks,OZSC,7,7,0,7,1,1,1,1,OTC
5005,15-02-2021 10:00,24 hrs.,pennystocks,PHBI,6,6,0,6,1,1,0,1,OTC
5005,15-02-2021 10:00,24 hrs.,pennystocks,PHCG,6,6,0,6,1,1,0,1,OTC
5005,15-02-2021 10:00,24 hrs.,pennystocks,PLYZ,12,0,12,-12,2,2,0,2,OTC
5005,15-02-2021 10:00,24 hrs.,pennystocks,PPJE,7,0,7,-7,1,1,1,1,OTC
5005,15-02-2021 10:00,24 hrs.,pennystocks,PRMO,50,0,50,-50,1,13,20,1,OTC
5005,15-02-2021 10:00,24 hrs.,StockMarket,CMPS,6,6,0,6,1,1,0,1,NASDAQ
5005,15-02-2021 10:00,24 hrs.,StockMarket,CRBP,75,0,75,-75,1,21,29,1,NASDAQ
5005,15-02-2021 10:00,24 hrs.,StockMarket,CTRM,15,0,15,-15,1,4,3,1,NASDAQ
5005,15-02-2021 10:00,24 hrs.,StockMarket,FLGT,6,6,0,6,1,1,0,1,NASDAQ
5005,15-02-2021 10:00,24 hrs.,StockMarket,FOLD,12,12,0,12,2,2,0,2,NASDAQ
5005,15-02-2021 10:00,24 hrs.,StockMarket,GPRO,6,0,6,-6,1,1,0,1,NASDAQ
5005,15-02-2021 10:00,24 hrs.,StockMarket,KOSS,19,0,19,-19,1,1,13,1,NASDAQ
5005,15-02-2021 10:00,24 hrs.,StockMarket,SNDL,67,0,67,-67,2,9,41,2,NASDAQ
5005,15-02-2021 10:00,24 hrs.,StockMarket,SOLO,6,0,6,-6,1,1,0,1,NASDAQ
5005,15-02-2021 10:00,24 hrs.,StockMarket,TLRY,6,0,6,-6,1,1,0,1,NASDAQ
5005,15-02-2021 10:00,24 hrs.,StockMarket,TNXP,40,9,31,-22,2,14,4,2,NASDAQ
5005,15-02-2021 10:00,24 hrs.,StockMarket,TRCH,6,6,0,6,1,1,0,1,NASDAQ
5005,15-02-2021 10:00,24 hrs.,StockMarket,TRVG,87,0,87,-87,1,21,41,1,NASDAQ
5005,15-02-2021 10:00,24 hrs.,StockMarket,TSLA,5,5,0,5,1,0,1,1,NASDAQ
5005,15-02-2021 10:00,24 hrs.,StockMarket,VKTX,6,0,6,-6,1,1,0,1,NASDAQ
5005,15-02-2021 10:00,24 hrs.,StockMarket,VXRT,6,0,6,-6,1,1,0,1,NASDAQ
5005,15-02-2021 10:00,24 hrs.,StockMarket,XRAY,12,12,0,12,1,2,4,1,NASDAQ
5005,15-02-2021 10:00,24 hrs.,pennystocks,AAGH,33,33,0,33,1,8,13,1,OTC
5005,15-02-2021 10:00,24 hrs.,pennystocks,ABML,18,18,0,18,3,3,0,1,OTC
5005,15-02-2021 10:00,24 hrs.,pennystocks,AFPW,6,6,0,6,1,1,0,1,OTC
5005,15-02-2021 10:00,24 hrs.,pennystocks,AITX,1109,90,1019,-929,7,448,185,6,OTC
5005,15-02-2021 10:00,24 hrs.,pennystocks,ALPP,6,0,6,-6,1,1,0,1,OTC
5005,15-02-2021 10:00,24 hrs.,pennystocks,ASCK,35,0,35,-35,1,14,3,1,OTC
5005,15-02-2021 10:00,24 hrs.,pennystocks,ASTI,12,6,6,0,2,2,0,2,OTC
5005,15-02-2021 10:00,24 hrs.,pennystocks,AURI,30,22,8,14,2,7,8,2,OTC
5005,15-02-2021 10:00,24 hrs.,pennystocks,AZFL,6,6,0,6,1,1,0,1,OTC
5005,15-02-2021 10:00,24 hrs.,pennystocks,BANT,56,0,56,-56,1,13,26,1,OTC
5005,15-02-2021 10:00,24 hrs.,pennystocks,BBRW,6,6,0,6,1,1,0,1,OTC
5005,15-02-2021 10:00,24 hrs.,pennystocks,BFCH,6,0,6,-6,1,1,0,1,OTC
5005,15-02-2021 10:00,24 hrs.,pennystocks,BIEL,9,0,9,-9,1,1,3,1,OTC
5005,15-02-2021 10:00,24 hrs.,pennystocks,BLPG,7,0,7,-7,1,1,1,1,OTC
5005,15-02-2021 10:00,24 hrs.,trakstocks,TPGY,10,10,0,10,1,2,2,1,NYSE
5005,15-02-2021 10:00,24 hrs.,trakstocks,UBX,8,8,0,8,1,2,0,1,NASDAQ
5005,15-02-2021 10:00,24 hrs.,trakstocks,AACQ,26,0,26,-26,1,10,2,1,NASDAQ
5005,15-02-2021 10:00,24 hrs.,trakstocks,ACTC,547,0,547,-547,1,236,71,1,NASDAQ
5005,15-02-2021 10:00,24 hrs.,trakstocks,ALOT,6,6,0,6,1,1,0,1,NASDAQ
5005,15-02-2021 10:00,24 hrs.,trakstocks,AMTX,6,6,0,6,1,1,0,1,NASDAQ
5005,15-02-2021 10:00,24 hrs.,trakstocks,AMZN,23,15,8,7,2,4,7,2,NASDAQ
5005,15-02-2021 10:00,24 hrs.,trakstocks,APPS,8,0,8,-8,1,2,0,1,NASDAQ
5005,15-02-2021 10:00,24 hrs.,trakstocks,ASRT,5,5,0,5,1,0,1,1,NASDAQ
5005,15-02-2021 10:00,24 hrs.,trakstocks,BHTG,6,0,6,-6,1,1,0,1,NASDAQ
5005,15-02-2021 10:00,24 hrs.,trakstocks,BIOC,8,0,8,-8,1,2,0,1,NASDAQ
5005,15-02-2021 10:00,24 hrs.,trakstocks,BXRX,5,5,0,5,1,0,1,1,NASDAQ
5005,15-02-2021 10:00,24 hrs.,trakstocks,CIDM,34,0,34,-34,1,15,0,1,NASDAQ
5005,15-02-2021 10:00,24 hrs.,trakstocks,CTRM,30,0,30,-30,1,8,10,1,NASDAQ
5005,15-02-2021 10:00,24 hrs.,trakstocks,EDIT,135,0,135,-135,1,53,25,1,NASDAQ
5005,15-02-2021 10:00,24 hrs.,trakstocks,GILT,8,8,0,8,1,2,0,1,NASDAQ
5005,15-02-2021 10:00,24 hrs.,trakstocks,MSFT,15,15,0,15,1,2,7,1,NASDAQ
5005,15-02-2021 10:00,24 hrs.,trakstocks,MVIS,4,0,4,-4,1,0,0,1,NASDAQ
5005,15-02-2021 10:00,24 hrs.,trakstocks,NCNA,8,8,0,8,1,2,0,1,NASDAQ
5005,15-02-2021 10:00,24 hrs.,trakstocks,PLAY,8,8,0,8,1,2,0,1,NASDAQ
5005,15-02-2021 10:00,24 hrs.,trakstocks,TMUS,15,15,0,15,1,2,7,1,NASDAQ
5005,15-02-2021 10:00,24 hrs.,trakstocks,TXMD,5,5,0,5,1,0,1,1,NASDAQ
5005,15-02-2021 10:00,24 hrs.,trakstocks,VYNE,6,6,0,6,1,0,2,1,NASDAQ
5005,15-02-2021 10:00,24 hrs.,StockMarket,CAGR,12,12,0,12,1,2,4,1,OTC
5005,15-02-2021 10:00,24 hrs.,StockMarket,HCMC,6,6,0,6,1,0,2,1,OTC
5005,15-02-2021 10:00,24 hrs.,StockMarket,MJNA,4,0,4,-4,1,0,0,1,OTC
5005,15-02-2021 10:00,24 hrs.,StockMarket,PHIL,6,6,0,6,1,0,2,1,OTC
5005,15-02-2021 10:00,24 hrs.,StockMarket,GSV,6,6,0,6,1,1,0,1,AMEX
5005,15-02-2021 10:00,24 hrs.,StockMarket,AMC,470,0,470,-470,5,186,78,5,NYSE
5005,15-02-2021 10:00,24 hrs.,StockMarket,BDJ,10,10,0,10,1,3,0,1,NYSE
5005,15-02-2021 10:00,24 hrs.,StockMarket,CBD,17,0,17,-17,1,5,3,1,NYSE
5005,15-02-2021 10:00,24 hrs.,StockMarket,DSM,6,0,6,-6,1,1,0,1,NYSE
5005,15-02-2021 10:00,24 hrs.,StockMarket,GBX,24,24,0,24,1,6,8,1,NYSE
5005,15-02-2021 10:00,24 hrs.,StockMarket,GME,81,18,63,-45,9,10,25,8,NYSE
5005,15-02-2021 10:00,24 hrs.,StockMarket,MAC,6,6,0,6,1,1,0,1,NYSE
5005,15-02-2021 10:00,24 hrs.,StockMarket,MSM,6,0,6,-6,1,1,0,1,NYSE
5005,15-02-2021 10:00,24 hrs.,StockMarket,NET,17,0,17,-17,1,5,3,1,NYSE
5005,15-02-2021 10:00,24 hrs.,StockMarket,NIO,6,6,0,6,1,1,0,1,NYSE
5005,15-02-2021 10:00,24 hrs.,StockMarket,PHI,6,6,0,6,1,0,2,1,NYSE
5005,15-02-2021 10:00,24 hrs.,StockMarket,REV,6,0,6,-6,1,1,0,1,NYSE
5005,15-02-2021 10:00,24 hrs.,StockMarket,SIG,7,7,0,7,1,1,1,1,NYSE
5005,15-02-2021 10:00,24 hrs.,StockMarket,THC,17,0,17,-17,1,5,3,1,NYSE
5005,15-02-2021 10:00,24 hrs.,StockMarket,TMX,7,7,0,7,1,1,1,1,NYSE
5005,15-02-2021 10:00,24 hrs.,StockMarket,VRT,20,0,20,-20,1,8,0,1,NYSE
5005,15-02-2021 10:00,24 hrs.,StockMarket,BALY,6,0,6,-6,1,1,0,1,NYSE
5005,15-02-2021 10:00,24 hrs.,StockMarket,CCIV,6,6,0,6,1,1,0,1,NYSE
5005,15-02-2021 10:00,24 hrs.,StockMarket,COTY,27,13,14,-1,4,3,5,4,NYSE
5005,15-02-2021 10:00,24 hrs.,StockMarket,PLTR,87,0,87,-87,1,21,41,1,NYSE
5005,15-02-2021 10:00,24 hrs.,StockMarket,STPK,10,0,10,-10,1,3,0,1,NYSE
5005,15-02-2021 10:00,24 hrs.,StockMarket,VALE,6,6,0,6,1,1,0,1,NYSE
5005,15-02-2021 10:00,24 hrs.,StockMarket,WORK,23,23,0,23,1,3,13,1,NYSE
5005,15-02-2021 10:00,24 hrs.,StockMarket,API,11,11,0,11,1,1,5,1,NASDAQ
5005,15-02-2021 10:00,24 hrs.,StockMarket,FAT,6,6,0,6,1,1,0,1,NASDAQ
5005,15-02-2021 10:00,24 hrs.,StockMarket,FOX,8,0,8,-8,1,0,4,1,NASDAQ
5005,15-02-2021 10:00,24 hrs.,StockMarket,III,15,0,15,-15,1,3,5,1,NASDAQ
5005,15-02-2021 10:00,24 hrs.,StockMarket,NEO,4,4,0,4,1,0,0,1,NASDAQ
5005,15-02-2021 10:00,24 hrs.,StockMarket,RNA,15,0,15,-15,1,3,5,1,NASDAQ
5005,15-02-2021 10:00,24 hrs.,StockMarket,VFF,6,0,6,-6,1,1,0,1,NASDAQ
5005,15-02-2021 10:00,24 hrs.,StockMarket,ALGN,12,12,0,12,1,2,4,1,NASDAQ
5005,15-02-2021 10:00,24 hrs.,StockMarket,APHA,6,0,6,-6,1,1,0,1,NASDAQ
5005,15-02-2021 10:00,24 hrs.,StockMarket,ASYS,10,0,10,-10,1,3,0,1,NASDAQ
5005,15-02-2021 10:00,24 hrs.,StockMarket,BLNK,7,7,0,7,1,1,1,1,NASDAQ
5005,15-02-2021 10:00,24 hrs.,StockMarket,CLSN,21,0,21,-21,2,4,5,2,NASDAQ
5005,15-02-2021 10:00,24 hrs.,StockMarket,CMLF,6,0,6,-6,1,1,0,1,NASDAQ
5005,15-02-2021 10:00,24 hrs.,trakstocks,SBE,14,0,14,-14,1,3,4,1,NYSE
5005,15-02-2021 10:00,24 hrs.,trakstocks,ALUS,9,9,0,9,1,1,3,1,NYSE
5005,15-02-2021 10:00,24 hrs.,trakstocks,ARGO,6,6,0,6,1,1,0,1,NYSE
5005,15-02-2021 10:00,24 hrs.,trakstocks,AVYA,8,8,0,8,1,2,0,1,NYSE
5005,15-02-2021 10:00,24 hrs.,trakstocks,CSPR,7,7,0,7,1,1,1,1,NYSE
5005,15-02-2021 10:00,24 hrs.,trakstocks,HYLN,30,0,30,-30,2,9,4,2,NYSE
5005,15-02-2021 10:00,24 hrs.,trakstocks,SKLZ,13,0,13,-13,1,4,1,1,NYSE
5005,15-02-2021 10:00,24 hrs.,stocks,QRVO,43,43,0,43,1,11,17,1,NASDAQ
5005,15-02-2021 10:00,24 hrs.,stocks,REAL,6,6,0,6,1,1,0,1,NASDAQ
5005,15-02-2021 10:00,24 hrs.,stocks,REGN,27,27,0,27,1,4,15,1,NASDAQ
5005,15-02-2021 10:00,24 hrs.,stocks,RIOT,16,0,16,-16,1,4,4,1,NASDAQ
5005,15-02-2021 10:00,24 hrs.,stocks,SAVA,6,6,0,6,1,1,0,1,NASDAQ
5005,15-02-2021 10:00,24 hrs.,stocks,SEDG,94,43,51,-8,2,24,38,2,NASDAQ
5005,15-02-2021 10:00,24 hrs.,stocks,SOLO,6,0,6,-6,1,1,0,1,NASDAQ
5005,15-02-2021 10:00,24 hrs.,stocks,SRAC,103,103,0,103,1,37,25,1,NASDAQ
5005,15-02-2021 10:00,24 hrs.,stocks,SRNE,100,0,100,-100,1,37,22,1,NASDAQ
5005,15-02-2021 10:00,24 hrs.,stocks,SURF,7,7,0,7,1,1,1,1,NASDAQ
5005,15-02-2021 10:00,24 hrs.,stocks,TLRY,722,20,702,-682,4,240,226,4,NASDAQ
5005,15-02-2021 10:00,24 hrs.,stocks,TNXP,6,6,0,6,1,1,0,1,NASDAQ
5005,15-02-2021 10:00,24 hrs.,stocks,TRCH,10,0,10,-10,1,2,2,1,NASDAQ
5005,15-02-2021 10:00,24 hrs.,stocks,TSLA,566,43,523,-480,3,210,134,3,NASDAQ
5005,15-02-2021 10:00,24 hrs.,stocks,TXMD,10,10,0,10,1,0,6,1,NASDAQ
5005,15-02-2021 10:00,24 hrs.,stocks,VKTX,6,0,6,-6,1,1,0,1,NASDAQ
5005,15-02-2021 10:00,24 hrs.,stocks,VRTX,6,6,0,6,1,1,0,1,NASDAQ
5005,15-02-2021 10:00,24 hrs.,stocks,VSTA,24,24,0,24,1,5,10,1,NASDAQ
5005,15-02-2021 10:00,24 hrs.,stocks,VXUS,20,20,0,20,1,4,8,1,NASDAQ
5005,15-02-2021 10:00,24 hrs.,stocks,WISH,517,0,517,-517,1,198,117,1,NASDAQ
5005,15-02-2021 10:00,24 hrs.,stocks,WKHS,11,11,0,11,1,2,3,1,NASDAQ
5005,15-02-2021 10:00,24 hrs.,stocks,WRAP,6,6,0,6,1,1,0,1,NASDAQ
5005,15-02-2021 10:00,24 hrs.,stocks,ZNGA,16,0,16,-16,1,4,4,1,NASDAQ
5005,15-02-2021 10:00,24 hrs.,stocks,GOOGL,72,72,0,72,2,17,30,2,NASDAQ
5005,15-02-2021 10:00,24 hrs.,stocks,NOVSW,25,0,25,-25,1,7,7,1,NASDAQ
5005,15-02-2021 10:00,24 hrs.,Daytrading,BLSP,6,6,0,6,1,1,0,1,OTC
5005,15-02-2021 10:00,24 hrs.,Daytrading,CBSC,6,0,6,-6,1,1,0,1,OTC
5005,15-02-2021 10:00,24 hrs.,Daytrading,COMS,31,31,0,31,1,10,7,1,OTC
5005,15-02-2021 10:00,24 hrs.,Daytrading,AMC,12,0,12,-12,2,2,0,1,NYSE
5005,15-02-2021 10:00,24 hrs.,Daytrading,ATH,27,13,14,-1,3,5,5,2,NYSE
5005,15-02-2021 10:00,24 hrs.,Daytrading,FSR,11,11,0,11,1,3,1,1,NYSE
5005,15-02-2021 10:00,24 hrs.,Daytrading,IGT,13,13,0,13,2,2,1,1,NYSE
5005,15-02-2021 10:00,24 hrs.,Daytrading,PDT,39,39,0,39,1,9,17,1,NYSE
5005,15-02-2021 10:00,24 hrs.,Daytrading,API,9,9,0,9,1,2,1,1,NASDAQ
5005,15-02-2021 10:00,24 hrs.,Daytrading,ACIU,31,31,0,31,1,10,7,1,NASDAQ
5005,15-02-2021 10:00,24 hrs.,Daytrading,BHTG,8,0,8,-8,1,1,2,1,NASDAQ
5005,15-02-2021 10:00,24 hrs.,Daytrading,CRBP,31,31,0,31,1,10,7,1,NASDAQ
5005,15-02-2021 10:00,24 hrs.,Daytrading,FORD,26,0,26,-26,1,4,14,1,NASDAQ
5005,15-02-2021 10:00,24 hrs.,Daytrading,NOVN,31,31,0,31,1,10,7,1,NASDAQ
5005,15-02-2021 10:00,24 hrs.,Daytrading,PRTA,31,31,0,31,1,10,7,1,NASDAQ
5005,15-02-2021 10:00,24 hrs.,Daytrading,TNXP,16,16,0,16,1,5,2,1,NASDAQ
5005,15-02-2021 10:00,24 hrs.,Daytrading,TRCH,31,31,0,31,1,10,7,1,NASDAQ
5005,15-02-2021 10:00,24 hrs.,Daytrading,VETS,25,0,25,-25,1,2,17,1,NASDAQ
5005,15-02-2021 10:00,24 hrs.,Daytrading,VISL,31,31,0,31,1,10,7,1,NASDAQ
5005,15-02-2021 10:00,24 hrs.,trakstocks,HCMC,30,30,0,30,1,11,4,1,OTC
5005,15-02-2021 10:00,24 hrs.,trakstocks,INND,15,15,0,15,1,2,7,1,OTC
5005,15-02-2021 10:00,24 hrs.,trakstocks,MOST,6,6,0,6,1,1,0,1,OTC
5005,15-02-2021 10:00,24 hrs.,trakstocks,MYMX,8,8,0,8,1,2,0,1,OTC
5005,15-02-2021 10:00,24 hrs.,trakstocks,OZSC,15,15,0,15,1,2,7,1,OTC
5005,15-02-2021 10:00,24 hrs.,trakstocks,SRMX,15,15,0,15,1,2,7,1,OTC
5005,15-02-2021 10:00,24 hrs.,trakstocks,SSFT,244,14,230,-216,2,89,58,2,OTC
5005,15-02-2021 10:00,24 hrs.,trakstocks,ARBKF,6,6,0,6,1,1,0,1,OTC
5005,15-02-2021 10:00,24 hrs.,trakstocks,CNVCF,8,8,0,8,1,1,2,1,OTC
5005,15-02-2021 10:00,24 hrs.,trakstocks,DFMTF,14,14,0,14,1,5,0,1,OTC
5005,15-02-2021 10:00,24 hrs.,trakstocks,HITIF,66,0,66,-66,1,23,16,1,OTC
5005,15-02-2021 10:00,24 hrs.,trakstocks,HVBTF,6,6,0,6,1,1,0,1,OTC
5005,15-02-2021 10:00,24 hrs.,trakstocks,ZOM,10,0,10,-10,1,0,6,1,AMEX
5005,15-02-2021 10:00,24 hrs.,trakstocks,TRXC,28,28,0,28,1,9,6,1,AMEX
5005,15-02-2021 10:00,24 hrs.,trakstocks,NGA,42,0,42,-42,1,14,10,1,NYSE
5005,15-02-2021 10:00,24 hrs.,trakstocks,NVO,13,13,0,13,1,3,3,1,NYSE
5005,15-02-2021 10:00,24 hrs.,stocks,DKNG,517,0,517,-517,1,198,117,1,NASDAQ
5005,15-02-2021 10:00,24 hrs.,stocks,DOCU,43,43,0,43,1,11,17,1,NASDAQ
5005,15-02-2021 10:00,24 hrs.,stocks,EDIT,6085,175,5910,-5735,3,2841,391,3,NASDAQ
5005,15-02-2021 10:00,24 hrs.,stocks,ERIC,38,38,0,38,1,6,22,1,NASDAQ
5005,15-02-2021 10:00,24 hrs.,stocks,EVOK,6,0,6,-6,1,1,0,1,NASDAQ
5005,15-02-2021 10:00,24 hrs.,stocks,EXPI,15,0,15,-15,2,1,5,2,NASDAQ
5005,15-02-2021 10:00,24 hrs.,stocks,FCAC,12,0,12,-12,2,2,0,1,NASDAQ
5005,15-02-2021 10:00,24 hrs.,stocks,GHIV,6,0,6,-6,1,1,0,1,NASDAQ
5005,15-02-2021 10:00,24 hrs.,stocks,GNOG,6,0,6,-6,1,1,0,1,NASDAQ
5005,15-02-2021 10:00,24 hrs.,stocks,GOOG,29,29,0,29,1,6,13,1,NASDAQ
5005,15-02-2021 10:00,24 hrs.,stocks,ICLN,517,0,517,-517,1,198,117,1,NASDAQ
5005,15-02-2021 10:00,24 hrs.,stocks,ILMN,6,6,0,6,1,1,0,1,NASDAQ
5005,15-02-2021 10:00,24 hrs.,stocks,INTC,115,115,0,115,1,40,31,1,NASDAQ
5005,15-02-2021 10:00,24 hrs.,stocks,KOPN,10,10,0,10,1,0,6,1,NASDAQ
5005,15-02-2021 10:00,24 hrs.,stocks,LRCX,43,43,0,43,1,11,17,1,NASDAQ
5005,15-02-2021 10:00,24 hrs.,stocks,MARA,16,0,16,-16,1,4,4,1,NASDAQ
5005,15-02-2021 10:00,24 hrs.,stocks,MCHP,43,43,0,43,1,11,17,1,NASDAQ
5005,15-02-2021 10:00,24 hrs.,stocks,MNKD,6,6,0,6,1,1,0,1,NASDAQ
5005,15-02-2021 10:00,24 hrs.,stocks,MSFT,3899,160,3739,-3579,4,1522,839,4,NASDAQ
5005,15-02-2021 10:00,24 hrs.,stocks,MSTR,30,0,30,-30,1,11,4,1,NASDAQ
5005,15-02-2021 10:00,24 hrs.,stocks,MTCH,30,0,30,-30,1,5,16,1,NASDAQ
5005,15-02-2021 10:00,24 hrs.,stocks,NEPT,6,0,6,-6,1,1,0,1,NASDAQ
5005,15-02-2021 10:00,24 hrs.,stocks,NNDM,6,6,0,6,1,1,0,1,NASDAQ
5005,15-02-2021 10:00,24 hrs.,stocks,NNOX,6,0,6,-6,1,1,0,1,NASDAQ
5005,15-02-2021 10:00,24 hrs.,stocks,NOVS,25,0,25,-25,1,7,7,1,NASDAQ
5005,15-02-2021 10:00,24 hrs.,stocks,NTRS,38,38,0,38,1,6,22,1,NASDAQ
5005,15-02-2021 10:00,24 hrs.,stocks,NVDA,699,182,517,-335,4,254,175,4,NASDAQ
5005,15-02-2021 10:00,24 hrs.,stocks,ONVO,12,0,12,-12,2,2,0,2,NASDAQ
5005,15-02-2021 10:00,24 hrs.,stocks,PFMT,18,0,18,-18,3,3,0,2,NASDAQ
5005,15-02-2021 10:00,24 hrs.,stocks,POWW,70,70,0,70,2,18,26,2,NASDAQ
5005,15-02-2021 10:00,24 hrs.,stocks,PYPL,38,38,0,38,1,6,22,1,NASDAQ
5005,15-02-2021 10:00,24 hrs.,stocks,AMKR,43,43,0,43,1,11,17,1,NASDAQ
5005,15-02-2021 10:00,24 hrs.,stocks,AMZN,4299,43,4256,-4213,3,1697,893,3,NASDAQ
5005,15-02-2021 10:00,24 hrs.,stocks,APHA,533,0,533,-533,2,202,121,2,NASDAQ
5005,15-02-2021 10:00,24 hrs.,stocks,ATNF,6,0,6,-6,1,1,0,1,NASDAQ
5005,15-02-2021 10:00,24 hrs.,stocks,AYRO,6,0,6,-6,1,1,0,1,NASDAQ
5005,15-02-2021 10:00,24 hrs.,stocks,CLNE,24,24,0,24,1,4,12,1,NASDAQ
5005,15-02-2021 10:00,24 hrs.,stocks,CLSN,6,0,6,-6,1,1,0,1,NASDAQ
5005,15-02-2021 10:00,24 hrs.,stocks,CMLF,6,0,6,-6,1,1,0,1,NASDAQ
5005,15-02-2021 10:00,24 hrs.,stocks,CORE,5910,0,5910,-5910,1,2775,356,1,NASDAQ
5005,15-02-2021 10:00,24 hrs.,stocks,CRSR,590,43,547,-504,3,220,138,3,NASDAQ
5005,15-02-2021 10:00,24 hrs.,stocks,CSCO,38,38,0,38,1,6,22,1,NASDAQ
5005,15-02-2021 10:00,24 hrs.,stocks,CSIQ,51,0,51,-51,1,13,21,1,NASDAQ
5005,15-02-2021 10:00,24 hrs.,stocks,CTRM,6,0,6,-6,1,1,0,1,NASDAQ
5005,15-02-2021 10:00,24 hrs.,stocks,MSI,38,38,0,38,1,6,22,1,NYSE
5005,15-02-2021 10:00,24 hrs.,stocks,MSM,103,103,0,103,1,45,9,1,NYSE
5005,15-02-2021 10:00,24 hrs.,stocks,NET,43,43,0,43,1,11,17,1,NYSE
5005,15-02-2021 10:00,24 hrs.,stocks,NIO,1207,43,1164,-1121,6,369,445,6,NYSE
5005,15-02-2021 10:00,24 hrs.,stocks,NOC,38,38,0,38,1,6,22,1,NYSE
5005,15-02-2021 10:00,24 hrs.,stocks,NOK,632,64,568,-504,3,211,198,3,NYSE
5005,15-02-2021 10:00,24 hrs.,stocks,NVO,37,0,37,-37,2,12,5,2,NYSE
5005,15-02-2021 10:00,24 hrs.,stocks,ORA,192,0,192,-192,1,84,20,1,NYSE
5005,15-02-2021 10:00,24 hrs.,stocks,PAG,38,38,0,38,1,6,22,1,NYSE
5005,15-02-2021 10:00,24 hrs.,stocks,PEG,51,0,51,-51,1,13,21,1,NYSE
5005,15-02-2021 10:00,24 hrs.,stocks,PFE,7,0,7,-7,1,1,1,1,NYSE
5005,15-02-2021 10:00,24 hrs.,stocks,RKT,517,0,517,-517,1,198,117,1,NYSE
5005,15-02-2021 10:00,24 hrs.,stocks,RSI,21,21,0,21,1,0,17,1,NYSE
5005,15-02-2021 10:00,24 hrs.,stocks,RTX,43,43,0,43,1,11,17,1,NYSE
5005,15-02-2021 10:00,24 hrs.,stocks,SBE,151,0,151,-151,1,57,33,1,NYSE
5005,15-02-2021 10:00,24 hrs.,stocks,SHO,103,103,0,103,1,45,9,1,NYSE
5005,15-02-2021 10:00,24 hrs.,stocks,TDC,6,6,0,6,1,1,0,1,NYSE
5005,15-02-2021 10:00,24 hrs.,stocks,TDG,43,43,0,43,1,11,17,1,NYSE
5005,15-02-2021 10:00,24 hrs.,stocks,TGH,43,43,0,43,1,11,17,1,NYSE
5005,15-02-2021 10:00,24 hrs.,stocks,THC,21,0,21,-21,1,3,11,1,NYSE
5005,15-02-2021 10:00,24 hrs.,stocks,TSE,6,6,0,6,1,1,0,1,NYSE
5005,15-02-2021 10:00,24 hrs.,stocks,TSM,153,153,0,153,2,46,53,2,NYSE
5005,15-02-2021 10:00,24 hrs.,stocks,UMC,26,0,26,-26,1,9,4,1,NYSE
5005,15-02-2021 10:00,24 hrs.,stocks,UNP,38,38,0,38,1,6,22,1,NYSE
5005,15-02-2021 10:00,24 hrs.,stocks,UPS,38,38,0,38,1,6,22,1,NYSE
5005,15-02-2021 10:00,24 hrs.,stocks,VHC,6,0,6,-6,1,1,0,1,NYSE
5005,15-02-2021 10:00,24 hrs.,stocks,VRT,41,0,41,-41,1,13,11,1,NYSE
5005,15-02-2021 10:00,24 hrs.,stocks,ANTM,43,43,0,43,1,11,17,1,NYSE
5005,15-02-2021 10:00,24 hrs.,stocks,BNED,24,0,24,-24,1,8,4,1,NYSE
5005,15-02-2021 10:00,24 hrs.,stocks,CCIV,6,6,0,6,1,1,0,1,NYSE
5005,15-02-2021 10:00,24 hrs.,stocks,DASH,6,0,6,-6,1,1,0,1,NYSE
5005,15-02-2021 10:00,24 hrs.,stocks,EARN,6,0,6,-6,1,1,0,1,NYSE
5005,15-02-2021 10:00,24 hrs.,stocks,FSLY,43,43,0,43,1,11,17,1,NYSE
5005,15-02-2021 10:00,24 hrs.,stocks,HYLN,517,0,517,-517,1,198,117,1,NYSE
5005,15-02-2021 10:00,24 hrs.,stocks,LDOS,38,38,0,38,1,6,22,1,NYSE
5005,15-02-2021 10:00,24 hrs.,stocks,LGVW,21,0,21,-21,1,0,17,1,NYSE
5005,15-02-2021 10:00,24 hrs.,stocks,MSCI,7,0,7,-7,1,1,1,1,NYSE
5005,15-02-2021 10:00,24 hrs.,stocks,PLTR,638,49,589,-540,5,235,148,5,NYSE
5005,15-02-2021 10:00,24 hrs.,stocks,SAFE,6,0,6,-6,1,1,0,1,NYSE
5005,15-02-2021 10:00,24 hrs.,stocks,SNPR,6,0,6,-6,1,1,0,1,NYSE
5005,15-02-2021 10:00,24 hrs.,stocks,SPCE,663,146,517,-371,3,246,159,3,NYSE
5005,15-02-2021 10:00,24 hrs.,stocks,UBER,38,38,0,38,1,6,22,1,NYSE
5005,15-02-2021 10:00,24 hrs.,stocks,VALE,43,43,0,43,1,11,17,1,NYSE
5005,15-02-2021 10:00,24 hrs.,stocks,WORK,8,8,0,8,1,1,2,1,NYSE
5005,15-02-2021 10:00,24 hrs.,stocks,XPEV,573,0,573,-573,2,147,271,2,NYSE
5005,15-02-2021 10:00,24 hrs.,stocks,AMD,700,158,542,-384,4,254,176,4,NASDAQ
5005,15-02-2021 10:00,24 hrs.,stocks,API,6,6,0,6,1,1,0,1,NASDAQ
5005,15-02-2021 10:00,24 hrs.,stocks,CFO,51,0,51,-51,1,13,21,1,NASDAQ
5005,15-02-2021 10:00,24 hrs.,stocks,CGC,17,17,0,17,1,2,9,1,NASDAQ
5005,15-02-2021 10:00,24 hrs.,stocks,CSA,51,0,51,-51,1,13,21,1,NASDAQ
5005,15-02-2021 10:00,24 hrs.,stocks,HOL,103,103,0,103,1,37,25,1,NASDAQ
5005,15-02-2021 10:00,24 hrs.,stocks,NEO,6,0,6,-6,1,1,0,1,NASDAQ
5005,15-02-2021 10:00,24 hrs.,stocks,OLB,6,0,6,-6,1,1,0,1,NASDAQ
5005,15-02-2021 10:00,24 hrs.,stocks,OPK,6,0,6,-6,1,1,0,1,NASDAQ
5005,15-02-2021 10:00,24 hrs.,stocks,QQQ,100,100,0,100,3,18,52,3,NASDAQ
5005,15-02-2021 10:00,24 hrs.,stocks,SMH,17,17,0,17,1,4,5,1,NASDAQ
5005,15-02-2021 10:00,24 hrs.,stocks,TER,43,43,0,43,1,11,17,1,NASDAQ
5005,15-02-2021 10:00,24 hrs.,stocks,TXG,43,43,0,43,1,11,17,1,NASDAQ
5005,15-02-2021 10:00,24 hrs.,stocks,WWR,12,12,0,12,2,2,0,1,NASDAQ
5005,15-02-2021 10:00,24 hrs.,stocks,AAPL,4299,43,4256,-4213,3,1697,893,3,NASDAQ
5005,15-02-2021 10:00,24 hrs.,stocks,ABCL,43,43,0,43,1,11,17,1,NASDAQ
5005,15-02-2021 10:00,24 hrs.,stocks,ACAD,43,43,0,43,1,11,17,1,NASDAQ
5005,15-02-2021 10:00,24 hrs.,stocks,ALGN,15,15,0,15,1,4,3,1,NASDAQ
5005,15-02-2021 10:00,24 hrs.,stocks,AMAT,43,43,0,43,1,11,17,1,NASDAQ
5005,15-02-2021 10:00,24 hrs.,stocks,CCL,16,0,16,-16,1,4,4,1,NYSE
5005,15-02-2021 10:00,24 hrs.,stocks,CIO,51,0,51,-51,1,13,21,1,NYSE
5005,15-02-2021 10:00,24 hrs.,stocks,CMO,51,0,51,-51,1,13,21,1,NYSE
5005,15-02-2021 10:00,24 hrs.,stocks,COO,51,0,51,-51,1,13,21,1,NYSE
5005,15-02-2021 10:00,24 hrs.,stocks,CVS,16,0,16,-16,1,4,4,1,NYSE
5005,15-02-2021 10:00,24 hrs.,stocks,DIS,537,20,517,-497,2,200,129,2,NYSE
5005,15-02-2021 10:00,24 hrs.,stocks,EPD,6,6,0,6,1,1,0,1,NYSE
5005,15-02-2021 10:00,24 hrs.,stocks,FDX,38,38,0,38,1,6,22,1,NYSE
5005,15-02-2021 10:00,24 hrs.,stocks,GME,796,185,611,-426,7,253,262,7,NYSE
5005,15-02-2021 10:00,24 hrs.,stocks,HMC,6,6,0,6,1,1,0,1,NYSE
5005,15-02-2021 10:00,24 hrs.,stocks,HON,6,6,0,6,1,1,0,1,NYSE
5005,15-02-2021 10:00,24 hrs.,stocks,HUM,43,43,0,43,1,11,17,1,NYSE
5005,15-02-2021 10:00,24 hrs.,stocks,IRS,34,34,0,34,1,5,20,1,NYSE
5005,15-02-2021 10:00,24 hrs.,stocks,JPM,38,38,0,38,1,6,22,1,NYSE
5005,15-02-2021 10:00,24 hrs.,stocks,KSU,38,38,0,38,1,6,22,1,NYSE
5005,15-02-2021 10:00,24 hrs.,stocks,LMT,141,141,0,141,2,43,47,2,NYSE
5005,15-02-2021 10:00,24 hrs.,stocks,MRK,7,7,0,7,1,1,1,1,NYSE
5005,15-02-2021 10:00,24 hrs.,stocks,MJNA,4,0,4,-4,1,0,0,1,OTC
5005,15-02-2021 10:00,24 hrs.,stocks,MKTY,12,12,0,12,2,2,0,1,OTC
5005,15-02-2021 10:00,24 hrs.,stocks,NEOM,6,0,6,-6,1,1,0,1,OTC
5005,15-02-2021 10:00,24 hrs.,stocks,SNPW,12,12,0,12,1,4,0,1,OTC
5005,15-02-2021 10:00,24 hrs.,stocks,TSNP,7,0,7,-7,1,1,1,1,OTC
5005,15-02-2021 10:00,24 hrs.,stocks,AMKBF,7,7,0,7,1,1,1,1,OTC
5005,15-02-2021 10:00,24 hrs.,stocks,AMKBY,7,7,0,7,1,1,1,1,OTC
5005,15-02-2021 10:00,24 hrs.,stocks,MMEDF,12,0,12,-12,2,2,0,1,OTC
5005,15-02-2021 10:00,24 hrs.,stocks,PROSY,6,6,0,6,1,1,0,1,OTC
5005,15-02-2021 10:00,24 hrs.,stocks,RYCEY,10,10,0,10,1,1,4,1,OTC
5005,15-02-2021 10:00,24 hrs.,stocks,CTO,51,0,51,-51,1,13,21,1,AMEX
5005,15-02-2021 10:00,24 hrs.,stocks,GSAT,6,6,0,6,1,1,0,1,AMEX
5005,15-02-2021 10:00,24 hrs.,stocks,ACB,16,0,16,-16,1,4,4,1,NYSE
5005,15-02-2021 10:00,24 hrs.,stocks,AFG,11,0,11,-11,1,3,1,1,NYSE
5005,15-02-2021 10:00,24 hrs.,stocks,AMC,673,105,568,-463,6,221,207,6,NYSE
5005,15-02-2021 10:00,24 hrs.,stocks,AMT,38,38,0,38,1,6,22,1,NYSE
5005,15-02-2021 10:00,24 hrs.,stocks,BAM,73,38,35,3,3,14,33,2,NYSE
5005,15-02-2021 10:00,24 hrs.,stocks,BLK,38,38,0,38,1,6,22,1,NYSE
5005,15-02-2021 10:00,24 hrs.,stocks,BMA,10,10,0,10,2,1,0,2,NYSE
5005,15-02-2021 10:00,24 hrs.,stocks,BNY,38,38,0,38,1,6,22,1,NYSE
5005,15-02-2021 10:00,24 hrs.,stocks,BYD,67,0,67,-67,1,12,39,1,NYSE
5005,15-02-2021 10:00,24 hrs.,stocks,CCI,38,38,0,38,1,6,22,1,NYSE
5005,15-02-2021 10:00,24 hrs.,SPACs,COHN,12,12,0,12,1,0,8,1,AMEX
5005,15-02-2021 10:00,24 hrs.,SPACs,BFT,274,0,274,-274,2,71,124,2,NYSE
5005,15-02-2021 10:00,24 hrs.,SPACs,GIK,195,0,195,-195,1,74,43,1,NYSE
5005,15-02-2021 10:00,24 hrs.,SPACs,JWS,10,10,0,10,1,2,2,1,NYSE
5005,15-02-2021 10:00,24 hrs.,SPACs,NAV,29,7,22,-15,4,4,5,4,NYSE
5005,15-02-2021 10:00,24 hrs.,SPACs,NGA,138,0,138,-138,1,21,92,1,NYSE
5005,15-02-2021 10:00,24 hrs.,SPACs,NPV,31,0,31,-31,1,9,9,1,NYSE
5005,15-02-2021 10:00,24 hrs.,SPACs,OAC,562,0,562,-562,1,195,168,1,NYSE
5005,15-02-2021 10:00,24 hrs.,SPACs,OSH,10,10,0,10,1,2,2,1,NYSE
5005,15-02-2021 10:00,24 hrs.,SPACs,SBE,27,0,27,-27,1,2,19,1,NYSE
5005,15-02-2021 10:00,24 hrs.,SPACs,UBS,35,0,35,-35,1,5,21,1,NYSE
5005,15-02-2021 10:00,24 hrs.,SPACs,ACIC,562,0,562,-562,1,195,168,1,NYSE
5005,15-02-2021 10:00,24 hrs.,SPACs,AJAX,562,0,562,-562,1,195,168,1,NYSE
5005,15-02-2021 10:00,24 hrs.,SPACs,ALUS,562,0,562,-562,1,195,168,1,NYSE
5005,15-02-2021 10:00,24 hrs.,SPACs,CCIV,1874,1714,160,1554,7,834,178,6,NYSE
5005,15-02-2021 10:00,24 hrs.,SPACs,FGNA,562,0,562,-562,1,195,168,1,NYSE
5005,15-02-2021 10:00,24 hrs.,SPACs,FUSE,759,106,653,-547,3,254,239,3,NYSE
5005,15-02-2021 10:00,24 hrs.,SPACs,IPOC,562,0,562,-562,1,195,168,1,NYSE
5005,15-02-2021 10:00,24 hrs.,SPACs,IPOD,28,0,28,-28,1,3,18,1,NYSE
5005,15-02-2021 10:00,24 hrs.,SPACs,IPOE,27,27,0,27,4,4,3,4,NYSE
5005,15-02-2021 10:00,24 hrs.,SPACs,PDAC,44,44,0,44,1,3,34,1,NYSE
5005,15-02-2021 10:00,24 hrs.,SPACs,PSTH,87,73,14,59,3,2,71,3,NYSE
5005,15-02-2021 10:00,24 hrs.,SPACs,SNPR,1324,34,1290,-1256,3,498,316,3,NYSE
5005,15-02-2021 10:00,24 hrs.,SPACs,SOAC,562,0,562,-562,1,195,168,1,NYSE
5005,15-02-2021 10:00,24 hrs.,SPACs,STPK,7,0,7,-7,1,1,1,1,NYSE
5005,15-02-2021 10:00,24 hrs.,SPACs,JAN,15,0,15,-15,1,5,1,1,NASDAQ
5005,15-02-2021 10:00,24 hrs.,SPACs,VIH,562,0,562,-562,1,195,168,1,NASDAQ
5005,15-02-2021 10:00,24 hrs.,SPACs,AACQ,221,0,221,-221,3,69,71,3,NASDAQ
5005,15-02-2021 10:00,24 hrs.,SPACs,ACTC,562,0,562,-562,1,195,168,1,NASDAQ
5005,15-02-2021 10:00,24 hrs.,SPACs,AMCI,562,0,562,-562,1,195,168,1,NASDAQ
5005,15-02-2021 10:00,24 hrs.,SPACs,APXT,562,0,562,-562,1,195,168,1,NASDAQ
5005,15-02-2021 10:00,24 hrs.,SPACs,ARYA,562,0,562,-562,1,195,168,1,NASDAQ
5005,15-02-2021 10:00,24 hrs.,SPACs,BOWX,57,57,0,57,1,12,29,1,NASDAQ
5005,15-02-2021 10:00,24 hrs.,SPACs,BTAQ,562,0,562,-562,1,195,168,1,NASDAQ
5005,15-02-2021 10:00,24 hrs.,SPACs,BTWN,57,57,0,57,1,12,29,1,NASDAQ
5005,15-02-2021 10:00,24 hrs.,SPACs,CIIC,6,6,0,6,1,1,0,1,NASDAQ
5005,15-02-2021 10:00,24 hrs.,SPACs,CMLF,562,0,562,-562,1,195,168,1,NASDAQ
5005,15-02-2021 10:00,24 hrs.,SPACs,DCRB,562,0,562,-562,1,195,168,1,NASDAQ
5005,15-02-2021 10:00,24 hrs.,SPACs,EDIT,31,0,31,-31,1,9,9,1,NASDAQ
5005,15-02-2021 10:00,24 hrs.,SPACs,FCAC,586,0,586,-586,2,200,178,2,NASDAQ
5005,15-02-2021 10:00,24 hrs.,SPACs,FCEL,11,11,0,11,1,3,1,1,NASDAQ
5005,15-02-2021 10:00,24 hrs.,SPACs,FIII,167,167,0,167,1,53,57,1,NASDAQ
5005,15-02-2021 10:00,24 hrs.,SPACs,FTOC,138,0,138,-138,1,21,92,1,NASDAQ
5005,15-02-2021 10:00,24 hrs.,SPACs,GRNV,562,0,562,-562,1,195,168,1,NASDAQ
5005,15-02-2021 10:00,24 hrs.,SPACs,HOFV,562,0,562,-562,1,195,168,1,NASDAQ
5005,15-02-2021 10:00,24 hrs.,SPACs,HTOO,11,11,0,11,1,3,1,1,NASDAQ
5005,15-02-2021 10:00,24 hrs.,SPACs,NBAC,15,0,15,-15,1,5,1,1,NASDAQ
5005,15-02-2021 10:00,24 hrs.,SPACs,NGAC,86,0,86,-86,1,26,30,1,NASDAQ
5005,15-02-2021 10:00,24 hrs.,SPACs,NKLA,11,11,0,11,1,3,1,1,NASDAQ
5005,15-02-2021 10:00,24 hrs.,SPACs,PLAY,35,0,35,-35,1,5,21,1,NASDAQ
5005,15-02-2021 10:00,24 hrs.,SPACs,PLUG,11,11,0,11,1,3,1,1,NASDAQ
5005,15-02-2021 10:00,24 hrs.,SPACs,THBR,562,0,562,-562,1,195,168,1,NASDAQ
5005,15-02-2021 10:00,24 hrs.,SPACs,THCB,138,0,138,-138,1,21,92,1,NASDAQ
5005,15-02-2021 10:00,24 hrs.,SPACs,VSPR,152,152,0,152,1,59,30,1,NASDAQ
5005,15-02-2021 10:00,24 hrs.,stocks,BLSP,6,6,0,6,1,1,0,1,OTC
5005,15-02-2021 10:00,24 hrs.,stocks,CAGR,51,0,51,-51,1,13,21,1,OTC
5005,15-02-2021 10:00,24 hrs.,stocks,DKMR,6,0,6,-6,1,1,0,1,OTC
5005,15-02-2021 10:00,24 hrs.,stocks,HCMC,50,12,38,-26,3,10,18,3,OTC
5005,15-02-2021 10:00,24 hrs.,stocks,MINE,6,0,6,-6,1,1,0,1,OTC
5005,15-02-2021 10:00,24 hrs.,RobinHoodPennyStocks,SOS,640,6,634,-628,2,271,90,2,NYSE
5005,15-02-2021 10:00,24 hrs.,RobinHoodPennyStocks,WTM,6,0,6,-6,1,1,0,1,NYSE
5005,15-02-2021 10:00,24 hrs.,RobinHoodPennyStocks,GLOG,17,17,0,17,1,6,1,1,NYSE
5005,15-02-2021 10:00,24 hrs.,RobinHoodPennyStocks,CFO,16,16,0,16,1,0,12,1,NASDAQ
5005,15-02-2021 10:00,24 hrs.,RobinHoodPennyStocks,GVP,19,19,0,19,2,3,5,2,NASDAQ
5005,15-02-2021 10:00,24 hrs.,RobinHoodPennyStocks,HAS,6,6,0,6,1,1,0,1,NASDAQ
5005,15-02-2021 10:00,24 hrs.,RobinHoodPennyStocks,JAN,127,0,127,-127,1,41,41,1,NASDAQ
5005,15-02-2021 10:00,24 hrs.,RobinHoodPennyStocks,SND,634,0,634,-634,1,270,90,1,NASDAQ
5005,15-02-2021 10:00,24 hrs.,RobinHoodPennyStocks,ABEO,634,0,634,-634,1,270,90,1,NASDAQ
5005,15-02-2021 10:00,24 hrs.,RobinHoodPennyStocks,ACRX,6,6,0,6,1,1,0,1,NASDAQ
5005,15-02-2021 10:00,24 hrs.,RobinHoodPennyStocks,ARTL,12,6,6,0,2,2,0,2,NASDAQ
5005,15-02-2021 10:00,24 hrs.,RobinHoodPennyStocks,ASRT,6,0,6,-6,1,1,0,1,NASDAQ
5005,15-02-2021 10:00,24 hrs.,RobinHoodPennyStocks,BRQS,93,0,93,-93,1,37,15,1,NASDAQ
5005,15-02-2021 10:00,24 hrs.,RobinHoodPennyStocks,CLBS,634,0,634,-634,1,270,90,1,NASDAQ
5005,15-02-2021 10:00,24 hrs.,RobinHoodPennyStocks,CRBP,225,0,225,-225,2,66,85,2,NASDAQ
5005,15-02-2021 10:00,24 hrs.,RobinHoodPennyStocks,CTMX,634,0,634,-634,1,270,90,1,NASDAQ
5005,15-02-2021 10:00,24 hrs.,RobinHoodPennyStocks,CTRM,38,32,6,26,2,5,20,2,NASDAQ
5005,15-02-2021 10:00,24 hrs.,RobinHoodPennyStocks,CYCN,13,13,0,13,1,0,9,1,NASDAQ
5005,15-02-2021 10:00,24 hrs.,RobinHoodPennyStocks,DFFN,717,0,717,-717,4,297,107,4,NASDAQ
5005,15-02-2021 10:00,24 hrs.,RobinHoodPennyStocks,FLEX,6,6,0,6,1,1,0,1,NASDAQ
5005,15-02-2021 10:00,24 hrs.,RobinHoodPennyStocks,GLBS,634,0,634,-634,1,270,90,1,NASDAQ
5005,15-02-2021 10:00,24 hrs.,RobinHoodPennyStocks,GNUS,36,36,0,36,2,4,20,1,NASDAQ
5005,15-02-2021 10:00,24 hrs.,RobinHoodPennyStocks,GRPN,6,0,6,-6,1,1,0,1,NASDAQ
5005,15-02-2021 10:00,24 hrs.,RobinHoodPennyStocks,HSTO,6,6,0,6,1,1,0,1,NASDAQ
5005,15-02-2021 10:00,24 hrs.,RobinHoodPennyStocks,IDEX,125,32,93,-61,2,41,35,2,NASDAQ
5005,15-02-2021 10:00,24 hrs.,RobinHoodPennyStocks,INPX,6,0,6,-6,1,1,0,1,NASDAQ
5005,15-02-2021 10:00,24 hrs.,RobinHoodPennyStocks,LLNW,6,6,0,6,1,1,0,1,NASDAQ
5005,15-02-2021 10:00,24 hrs.,RobinHoodPennyStocks,MVIS,93,0,93,-93,1,37,15,1,NASDAQ
5005,15-02-2021 10:00,24 hrs.,RobinHoodPennyStocks,MYSZ,12,6,6,0,2,2,0,2,NASDAQ
5005,15-02-2021 10:00,24 hrs.,RobinHoodPennyStocks,NAKD,634,0,634,-634,1,270,90,1,NASDAQ
5005,15-02-2021 10:00,24 hrs.,RobinHoodPennyStocks,NEOS,6,6,0,6,1,1,0,1,NASDAQ
5005,15-02-2021 10:00,24 hrs.,RobinHoodPennyStocks,NOVN,12,0,12,-12,2,2,0,2,NASDAQ
5005,15-02-2021 10:00,24 hrs.,RobinHoodPennyStocks,NVCN,4,4,0,4,1,0,0,1,NASDAQ
5005,15-02-2021 10:00,24 hrs.,RobinHoodPennyStocks,PFMT,12,0,12,-12,2,2,0,1,NASDAQ
5005,15-02-2021 10:00,24 hrs.,RobinHoodPennyStocks,PULM,7,0,7,-7,1,1,1,1,NASDAQ
5005,15-02-2021 10:00,24 hrs.,RobinHoodPennyStocks,RGLS,6,6,0,6,1,1,0,1,NASDAQ
5005,15-02-2021 10:00,24 hrs.,RobinHoodPennyStocks,SNDL,721,32,689,-657,4,293,119,4,NASDAQ
5005,15-02-2021 10:00,24 hrs.,RobinHoodPennyStocks,TNXP,23,11,12,-1,3,5,1,2,NASDAQ
5005,15-02-2021 10:00,24 hrs.,RobinHoodPennyStocks,TRCH,4,4,0,4,1,0,0,1,NASDAQ
5005,15-02-2021 10:00,24 hrs.,RobinHoodPennyStocks,TXMD,145,6,139,-133,4,44,41,3,NASDAQ
5005,15-02-2021 10:00,24 hrs.,RobinHoodPennyStocks,ZSAN,6,6,0,6,1,1,0,1,NASDAQ
5005,15-02-2021 10:00,24 hrs.,RobinHoodPennyStocks,AMP,6,6,0,6,1,1,0,1,NYSE
5005,15-02-2021 10:00,24 hrs.,RobinHoodPennyStocks,BDN,6,0,6,-6,1,1,0,1,NYSE
5005,15-02-2021 10:00,24 hrs.,RobinHoodPennyStocks,CNS,13,13,0,13,1,0,9,1,NYSE
5005,15-02-2021 10:00,24 hrs.,RobinHoodPennyStocks,NIO,6,6,0,6,1,1,0,1,NYSE
5005,15-02-2021 10:00,24 hrs.,RobinHoodPennyStocks,PHI,6,6,0,6,1,1,0,1,NYSE
5005,15-02-2021 10:00,24 hrs.,wallstreetbets,SWBI,7,7,0,7,1,1,1,1,NASDAQ
5005,15-02-2021 10:00,24 hrs.,wallstreetbets,TECH,194,188,6,182,2,75,36,2,NASDAQ
5005,15-02-2021 10:00,24 hrs.,wallstreetbets,THBR,7,7,0,7,1,1,1,1,NASDAQ
5005,15-02-2021 10:00,24 hrs.,wallstreetbets,TLGT,12,6,6,0,2,2,0,2,NASDAQ
5005,15-02-2021 10:00,24 hrs.,wallstreetbets,TLRY,474,220,254,-34,10,173,88,7,NASDAQ
5005,15-02-2021 10:00,24 hrs.,wallstreetbets,TRCH,7,0,7,-7,1,1,1,1,NASDAQ
5005,15-02-2021 10:00,24 hrs.,wallstreetbets,TRIT,56,23,33,-10,7,12,4,3,NASDAQ
5005,15-02-2021 10:00,24 hrs.,wallstreetbets,TRVG,36,7,29,-22,5,5,6,4,NASDAQ
5005,15-02-2021 10:00,24 hrs.,wallstreetbets,TSLA,1777,202,1575,-1373,6,679,395,6,NASDAQ
5005,15-02-2021 10:00,24 hrs.,wallstreetbets,TXMD,26,26,0,26,4,4,2,3,NASDAQ
5005,15-02-2021 10:00,24 hrs.,wallstreetbets,TYME,15,0,15,-15,2,2,3,2,NASDAQ
5005,15-02-2021 10:00,24 hrs.,wallstreetbets,VBIV,7,0,7,-7,1,1,1,1,NASDAQ
5005,15-02-2021 10:00,24 hrs.,wallstreetbets,VERU,7,7,0,7,1,1,1,1,NASDAQ
5005,15-02-2021 10:00,24 hrs.,wallstreetbets,VIAC,7,0,7,-7,1,1,1,1,NASDAQ
5005,15-02-2021 10:00,24 hrs.,wallstreetbets,VXRT,7,0,7,-7,1,1,1,1,NASDAQ
5005,15-02-2021 10:00,24 hrs.,wallstreetbets,VYGR,7,0,7,-7,1,1,1,1,NASDAQ
5005,15-02-2021 10:00,24 hrs.,wallstreetbets,WKHS,6,6,0,6,1,1,0,1,NASDAQ
5005,15-02-2021 10:00,24 hrs.,wallstreetbets,ZNGA,630,630,0,630,1,253,120,1,NASDAQ
5005,15-02-2021 10:00,24 hrs.,wallstreetbets,ZYNE,6,0,6,-6,1,1,0,1,NASDAQ
5005,15-02-2021 10:00,24 hrs.,wallstreetbets,ZYXI,6,0,6,-6,1,1,0,1,NASDAQ
5005,15-02-2021 10:00,24 hrs.,RobinHoodPennyStocks,BLXX,7,7,0,7,1,1,1,1,OTC
5005,15-02-2021 10:00,24 hrs.,RobinHoodPennyStocks,HCMC,6,6,0,6,1,1,0,1,OTC
5005,15-02-2021 10:00,24 hrs.,RobinHoodPennyStocks,MJNA,12,0,12,-12,1,0,8,1,OTC
5005,15-02-2021 10:00,24 hrs.,RobinHoodPennyStocks,PHIL,6,6,0,6,1,1,0,1,OTC
5005,15-02-2021 10:00,24 hrs.,RobinHoodPennyStocks,SSFT,15,0,15,-15,1,0,11,1,OTC
5005,15-02-2021 10:00,24 hrs.,RobinHoodPennyStocks,ZHUD,7,7,0,7,1,1,1,1,OTC
5005,15-02-2021 10:00,24 hrs.,RobinHoodPennyStocks,BDRBF,16,16,0,16,1,0,12,1,OTC
5005,15-02-2021 10:00,24 hrs.,RobinHoodPennyStocks,LMNGF,8,0,8,-8,1,1,2,1,OTC
5005,15-02-2021 10:00,24 hrs.,RobinHoodPennyStocks,RYCEY,16,16,0,16,1,0,12,1,OTC
5005,15-02-2021 10:00,24 hrs.,RobinHoodPennyStocks,DNN,12,6,6,0,2,2,0,2,AMEX
5005,15-02-2021 10:00,24 hrs.,RobinHoodPennyStocks,DPW,634,0,634,-634,1,270,90,1,AMEX
5005,15-02-2021 10:00,24 hrs.,RobinHoodPennyStocks,GTE,18,0,18,-18,3,3,0,3,AMEX
5005,15-02-2021 10:00,24 hrs.,RobinHoodPennyStocks,LNG,17,17,0,17,1,6,1,1,AMEX
5005,15-02-2021 10:00,24 hrs.,RobinHoodPennyStocks,NBY,634,0,634,-634,1,270,90,1,AMEX
5005,15-02-2021 10:00,24 hrs.,RobinHoodPennyStocks,ZOM,6,0,6,-6,1,1,0,1,AMEX
5005,15-02-2021 10:00,24 hrs.,RobinHoodPennyStocks,SENS,32,32,0,32,1,4,20,1,AMEX
5005,15-02-2021 10:00,24 hrs.,RobinHoodPennyStocks,XXII,6,6,0,6,1,1,0,1,AMEX
5005,15-02-2021 10:00,24 hrs.,wallstreetbets,JBLU,246,246,0,246,1,108,26,1,NASDAQ
5005,15-02-2021 10:00,24 hrs.,wallstreetbets,JNCE,7,0,7,-7,1,1,1,1,NASDAQ
5005,15-02-2021 10:00,24 hrs.,wallstreetbets,LIFE,13,13,0,13,2,2,1,2,NASDAQ
5005,15-02-2021 10:00,24 hrs.,wallstreetbets,LIVE,7,0,7,-7,1,1,1,1,NASDAQ
5005,15-02-2021 10:00,24 hrs.,wallstreetbets,LIVX,6,0,6,-6,1,1,0,1,NASDAQ
5005,15-02-2021 10:00,24 hrs.,wallstreetbets,LLNW,6,6,0,6,1,1,0,1,NASDAQ
5005,15-02-2021 10:00,24 hrs.,wallstreetbets,MARA,7,0,7,-7,1,1,1,1,NASDAQ
5005,15-02-2021 10:00,24 hrs.,wallstreetbets,MARK,6,0,6,-6,1,1,0,1,NASDAQ
5005,15-02-2021 10:00,24 hrs.,wallstreetbets,MBRX,7,0,7,-7,1,1,1,1,NASDAQ
5005,15-02-2021 10:00,24 hrs.,wallstreetbets,MCHP,7,7,0,7,1,1,1,1,NASDAQ
5005,15-02-2021 10:00,24 hrs.,wallstreetbets,MGIC,9,9,0,9,1,2,1,1,NASDAQ
5005,15-02-2021 10:00,24 hrs.,wallstreetbets,MSFT,125,125,0,125,1,39,43,1,NASDAQ
5005,15-02-2021 10:00,24 hrs.,wallstreetbets,MSTR,6,0,6,-6,1,1,0,1,NASDAQ
5005,15-02-2021 10:00,24 hrs.,wallstreetbets,MVIS,12,6,6,0,2,2,0,2,NASDAQ
5005,15-02-2021 10:00,24 hrs.,wallstreetbets,NAKD,14,0,14,-14,2,2,2,2,NASDAQ
5005,15-02-2021 10:00,24 hrs.,wallstreetbets,NCLH,252,246,6,240,2,109,26,2,NASDAQ
5005,15-02-2021 10:00,24 hrs.,wallstreetbets,NNDM,7,0,7,-7,1,1,1,1,NASDAQ
5005,15-02-2021 10:00,24 hrs.,wallstreetbets,NNOX,7,0,7,-7,1,1,1,1,NASDAQ
5005,15-02-2021 10:00,24 hrs.,wallstreetbets,NTEC,7,0,7,-7,1,1,1,1,NASDAQ
5005,15-02-2021 10:00,24 hrs.,wallstreetbets,NTRS,125,125,0,125,1,39,43,1,NASDAQ
5005,15-02-2021 10:00,24 hrs.,wallstreetbets,OCGN,36,21,15,6,5,5,6,5,NASDAQ
5005,15-02-2021 10:00,24 hrs.,wallstreetbets,ONTX,7,0,7,-7,1,1,1,1,NASDAQ
5005,15-02-2021 10:00,24 hrs.,wallstreetbets,OSTK,4772,6,4766,-4760,2,2087,590,2,NASDAQ
5005,15-02-2021 10:00,24 hrs.,wallstreetbets,PLAY,7,0,7,-7,1,1,1,1,NASDAQ
5005,15-02-2021 10:00,24 hrs.,wallstreetbets,PRTA,6,0,6,-6,1,1,0,1,NASDAQ
5005,15-02-2021 10:00,24 hrs.,wallstreetbets,PRTS,7,0,7,-7,1,1,1,1,NASDAQ
5005,15-02-2021 10:00,24 hrs.,wallstreetbets,PTON,246,246,0,246,1,108,26,1,NASDAQ
5005,15-02-2021 10:00,24 hrs.,wallstreetbets,PYPL,125,125,0,125,1,39,43,1,NASDAQ
5005,15-02-2021 10:00,24 hrs.,wallstreetbets,QLGN,6,6,0,6,1,1,0,1,NASDAQ
5005,15-02-2021 10:00,24 hrs.,wallstreetbets,REAL,166,13,153,-140,4,54,42,4,NASDAQ
5005,15-02-2021 10:00,24 hrs.,wallstreetbets,RIOT,14,7,7,0,2,2,2,2,NASDAQ
5005,15-02-2021 10:00,24 hrs.,wallstreetbets,RNWK,21,21,0,21,3,3,3,1,NASDAQ
5005,15-02-2021 10:00,24 hrs.,wallstreetbets,SBBP,6,6,0,6,1,1,0,1,NASDAQ
5005,15-02-2021 10:00,24 hrs.,wallstreetbets,SELF,558,0,558,-558,1,169,216,1,NASDAQ
5005,15-02-2021 10:00,24 hrs.,wallstreetbets,SESN,7,0,7,-7,1,1,1,1,NASDAQ
5005,15-02-2021 10:00,24 hrs.,wallstreetbets,SHIP,13,6,7,-1,2,2,1,2,NASDAQ
5005,15-02-2021 10:00,24 hrs.,wallstreetbets,SNDL,957,270,687,-417,34,275,271,28,NASDAQ
5005,15-02-2021 10:00,24 hrs.,wallstreetbets,SNGX,7,0,7,-7,1,1,1,1,NASDAQ
5005,15-02-2021 10:00,24 hrs.,wallstreetbets,SOLO,1010,0,1010,-1010,1,433,140,1,NASDAQ
5005,15-02-2021 10:00,24 hrs.,wallstreetbets,SPWR,14,0,14,-14,2,2,2,1,NASDAQ
5005,15-02-2021 10:00,24 hrs.,wallstreetbets,SQQQ,780,8,772,-764,2,248,276,2,NASDAQ
5005,15-02-2021 10:00,24 hrs.,wallstreetbets,SRAC,7,0,7,-7,1,1,1,1,NASDAQ
5005,15-02-2021 10:00,24 hrs.,wallstreetbets,SRNE,47,27,20,7,6,5,13,4,NASDAQ
5005,15-02-2021 10:00,24 hrs.,wallstreetbets,STAY,7,0,7,-7,1,1,1,1,NASDAQ
5005,15-02-2021 10:00,24 hrs.,wallstreetbets,STNE,7,0,7,-7,1,1,1,1,NASDAQ
5005,15-02-2021 10:00,24 hrs.,wallstreetbets,AAPL,7,7,0,7,1,1,1,1,NASDAQ
5005,15-02-2021 10:00,24 hrs.,wallstreetbets,ABIO,7,0,7,-7,1,1,1,1,NASDAQ
5005,15-02-2021 10:00,24 hrs.,wallstreetbets,ADMP,7,0,7,-7,1,1,1,1,NASDAQ
5005,15-02-2021 10:00,24 hrs.,wallstreetbets,ALGN,26,26,0,26,3,5,4,1,NASDAQ
5005,15-02-2021 10:00,24 hrs.,wallstreetbets,APDN,7,7,0,7,1,1,1,1,NASDAQ
5005,15-02-2021 10:00,24 hrs.,wallstreetbets,APHA,261,7,254,-247,5,95,51,3,NASDAQ
5005,15-02-2021 10:00,24 hrs.,wallstreetbets,ARTL,40,27,13,14,6,6,4,4,NASDAQ
5005,15-02-2021 10:00,24 hrs.,wallstreetbets,ASML,7,0,7,-7,1,1,1,1,NASDAQ
5005,15-02-2021 10:00,24 hrs.,wallstreetbets,ASRT,21,7,14,-7,3,3,3,2,NASDAQ
5005,15-02-2021 10:00,24 hrs.,wallstreetbets,ATNI,7,0,7,-7,1,1,1,1,NASDAQ
5005,15-02-2021 10:00,24 hrs.,wallstreetbets,ATOM,7,0,7,-7,1,1,1,1,NASDAQ
5005,15-02-2021 10:00,24 hrs.,wallstreetbets,AVGO,7,7,0,7,1,1,1,1,NASDAQ
5005,15-02-2021 10:00,24 hrs.,wallstreetbets,AYRO,7,0,7,-7,1,1,1,1,NASDAQ
5005,15-02-2021 10:00,24 hrs.,wallstreetbets,BCRX,14,14,0,14,2,2,2,1,NASDAQ
5005,15-02-2021 10:00,24 hrs.,wallstreetbets,BGFV,7,0,7,-7,1,1,1,1,NASDAQ
5005,15-02-2021 10:00,24 hrs.,wallstreetbets,BIGC,16,16,0,16,1,0,12,1,NASDAQ
5005,15-02-2021 10:00,24 hrs.,wallstreetbets,BLNK,8,8,0,8,1,1,2,1,NASDAQ
5005,15-02-2021 10:00,24 hrs.,wallstreetbets,BLUE,188,188,0,188,1,74,36,1,NASDAQ
5005,15-02-2021 10:00,24 hrs.,wallstreetbets,BNGO,19,0,19,-19,3,3,1,2,NASDAQ
5005,15-02-2021 10:00,24 hrs.,wallstreetbets,BNTX,47,0,47,-47,1,0,43,1,NASDAQ
5005,15-02-2021 10:00,24 hrs.,wallstreetbets,BSQR,7,0,7,-7,1,1,1,1,NASDAQ
5005,15-02-2021 10:00,24 hrs.,wallstreetbets,BXRX,7,7,0,7,1,1,1,1,NASDAQ
5005,15-02-2021 10:00,24 hrs.,wallstreetbets,CARE,146,0,146,-146,1,51,40,1,NASDAQ
5005,15-02-2021 10:00,24 hrs.,wallstreetbets,CASH,6,6,0,6,1,1,0,1,NASDAQ
5005,15-02-2021 10:00,24 hrs.,wallstreetbets,CGIX,47,47,0,47,7,7,5,2,NASDAQ
5005,15-02-2021 10:00,24 hrs.,wallstreetbets,CHKP,19,19,0,19,1,3,9,1,NASDAQ
5005,15-02-2021 10:00,24 hrs.,wallstreetbets,CLVS,30,7,23,-16,4,5,4,3,NASDAQ
5005,15-02-2021 10:00,24 hrs.,wallstreetbets,CMPS,14,7,7,0,2,2,2,2,NASDAQ
5005,15-02-2021 10:00,24 hrs.,wallstreetbets,CRBP,7,0,7,-7,1,1,1,1,NASDAQ
5005,15-02-2021 10:00,24 hrs.,wallstreetbets,CRSR,1166,246,920,-674,3,461,232,3,NASDAQ
5005,15-02-2021 10:00,24 hrs.,wallstreetbets,CSCO,125,125,0,125,1,39,43,1,NASDAQ
5005,15-02-2021 10:00,24 hrs.,wallstreetbets,CTRM,67,33,34,-1,10,10,7,9,NASDAQ
5005,15-02-2021 10:00,24 hrs.,wallstreetbets,CYCN,9,0,9,-9,1,2,1,1,NASDAQ
5005,15-02-2021 10:00,24 hrs.,wallstreetbets,DFFN,7,7,0,7,1,1,1,1,NASDAQ
5005,15-02-2021 10:00,24 hrs.,wallstreetbets,DKNG,1010,0,1010,-1010,1,433,140,1,NASDAQ
5005,15-02-2021 10:00,24 hrs.,wallstreetbets,EBON,7,0,7,-7,1,1,1,1,NASDAQ
5005,15-02-2021 10:00,24 hrs.,wallstreetbets,EDIT,4104,0,4104,-4104,2,1490,1116,2,NASDAQ
5005,15-02-2021 10:00,24 hrs.,wallstreetbets,EOLS,7,0,7,-7,1,1,1,1,NASDAQ
5005,15-02-2021 10:00,24 hrs.,wallstreetbets,ERIC,125,125,0,125,1,39,43,1,NASDAQ
5005,15-02-2021 10:00,24 hrs.,wallstreetbets,EVER,1072,0,1072,-1072,1,499,70,1,NASDAQ
5005,15-02-2021 10:00,24 hrs.,wallstreetbets,EVFM,6,0,6,-6,1,1,0,1,NASDAQ
5005,15-02-2021 10:00,24 hrs.,wallstreetbets,FAST,89,89,0,89,1,0,85,1,NASDAQ
5005,15-02-2021 10:00,24 hrs.,wallstreetbets,FCAC,7,0,7,-7,1,1,1,1,NASDAQ
5005,15-02-2021 10:00,24 hrs.,wallstreetbets,FCEL,7,0,7,-7,1,1,1,1,NASDAQ
5005,15-02-2021 10:00,24 hrs.,wallstreetbets,FEYE,7,7,0,7,1,1,1,1,NASDAQ
5005,15-02-2021 10:00,24 hrs.,wallstreetbets,FLGT,13,13,0,13,2,2,1,1,NASDAQ
5005,15-02-2021 10:00,24 hrs.,wallstreetbets,FLWS,6,0,6,-6,1,1,0,1,NASDAQ
5005,15-02-2021 10:00,24 hrs.,wallstreetbets,FORD,89,89,0,89,1,0,85,1,NASDAQ
5005,15-02-2021 10:00,24 hrs.,wallstreetbets,FROG,12,6,6,0,2,2,0,2,NASDAQ
5005,15-02-2021 10:00,24 hrs.,wallstreetbets,FTFT,7,7,0,7,1,1,1,1,NASDAQ
5005,15-02-2021 10:00,24 hrs.,wallstreetbets,GNUS,7,7,0,7,1,1,1,1,NASDAQ
5005,15-02-2021 10:00,24 hrs.,wallstreetbets,GOGO,141,6,135,-129,7,30,53,5,NASDAQ
5005,15-02-2021 10:00,24 hrs.,wallstreetbets,GOLD,7,7,0,7,1,1,1,1,NASDAQ
5005,15-02-2021 10:00,24 hrs.,wallstreetbets,GSMG,12,0,12,-12,2,2,0,1,NASDAQ
5005,15-02-2021 10:00,24 hrs.,wallstreetbets,HEAR,7,7,0,7,1,1,1,1,NASDAQ
5005,15-02-2021 10:00,24 hrs.,wallstreetbets,INFI,7,0,7,-7,1,1,1,1,NASDAQ
5005,15-02-2021 10:00,24 hrs.,wallstreetbets,INPX,21,7,14,-7,3,3,3,2,NASDAQ
5005,15-02-2021 10:00,24 hrs.,wallstreetbets,INTC,450,285,165,120,3,134,170,3,NASDAQ
5005,15-02-2021 10:00,24 hrs.,wallstreetbets,ITRM,27,7,20,-13,4,4,3,3,NASDAQ
5005,15-02-2021 10:00,24 hrs.,wallstreetbets,JBHT,6,0,6,-6,1,1,0,1,NASDAQ
5005,15-02-2021 10:00,24 hrs.,wallstreetbets,XPEV,1640,246,1394,-1148,4,629,366,3,NYSE
5005,15-02-2021 10:00,24 hrs.,wallstreetbets,AAL,6,0,6,-6,1,1,0,1,NASDAQ
5005,15-02-2021 10:00,24 hrs.,wallstreetbets,AMD,4285,279,4006,-3727,8,1797,659,7,NASDAQ
5005,15-02-2021 10:00,24 hrs.,wallstreetbets,AQB,6,0,6,-6,1,1,0,1,NASDAQ
5005,15-02-2021 10:00,24 hrs.,wallstreetbets,BBC,7,7,0,7,1,1,1,1,NASDAQ
5005,15-02-2021 10:00,24 hrs.,wallstreetbets,BUG,6,6,0,6,1,1,0,1,NASDAQ
5005,15-02-2021 10:00,24 hrs.,wallstreetbets,CFO,7,7,0,7,1,1,1,1,NASDAQ
5005,15-02-2021 10:00,24 hrs.,wallstreetbets,FUV,6,0,6,-6,1,1,0,1,NASDAQ
5005,15-02-2021 10:00,24 hrs.,wallstreetbets,GSM,21,14,7,7,3,3,3,2,NASDAQ
5005,15-02-2021 10:00,24 hrs.,wallstreetbets,HAS,35,21,14,7,5,5,5,4,NASDAQ
5005,15-02-2021 10:00,24 hrs.,wallstreetbets,KIN,7,7,0,7,1,1,1,1,NASDAQ
5005,15-02-2021 10:00,24 hrs.,wallstreetbets,MGI,14,14,0,14,2,2,2,1,NASDAQ
5005,15-02-2021 10:00,24 hrs.,wallstreetbets,NEO,21,21,0,21,3,3,3,1,NASDAQ
5005,15-02-2021 10:00,24 hrs.,wallstreetbets,OPK,7,0,7,-7,1,1,1,1,NASDAQ
5005,15-02-2021 10:00,24 hrs.,wallstreetbets,PDD,6,6,0,6,1,1,0,1,NASDAQ
5005,15-02-2021 10:00,24 hrs.,wallstreetbets,QTT,7,0,7,-7,1,1,1,1,NASDAQ
5005,15-02-2021 10:00,24 hrs.,wallstreetbets,RXT,7,0,7,-7,1,1,1,1,NASDAQ
5005,15-02-2021 10:00,24 hrs.,wallstreetbets,SDC,7,7,0,7,1,1,1,1,NASDAQ
5005,15-02-2021 10:00,24 hrs.,wallstreetbets,TGA,7,0,7,-7,1,1,1,1,NASDAQ
5005,15-02-2021 10:00,24 hrs.,wallstreetbets,TXN,7,7,0,7,1,1,1,1,NASDAQ
5005,15-02-2021 10:00,24 hrs.,wallstreetbets,UAL,252,252,0,252,2,109,26,2,NASDAQ
5005,15-02-2021 10:00,24 hrs.,wallstreetbets,WBA,7,7,0,7,1,1,1,1,NASDAQ
5005,15-02-2021 10:00,24 hrs.,wallstreetbets,WNW,7,0,7,-7,1,1,1,1,NASDAQ
5005,15-02-2021 10:00,24 hrs.,wallstreetbets,GNRC,91,0,91,-91,2,23,37,2,NYSE
5005,15-02-2021 10:00,24 hrs.,wallstreetbets,HEXO,13,7,6,1,2,2,1,2,NYSE
5005,15-02-2021 10:00,24 hrs.,wallstreetbets,HYLN,34,14,20,-6,5,5,4,4,NYSE
5005,15-02-2021 10:00,24 hrs.,wallstreetbets,IPOE,30,0,30,-30,1,0,26,1,NYSE
5005,15-02-2021 10:00,24 hrs.,wallstreetbets,LDOS,125,125,0,125,1,39,43,1,NYSE
5005,15-02-2021 10:00,24 hrs.,wallstreetbets,LUMN,6,0,6,-6,1,1,0,1,NYSE
5005,15-02-2021 10:00,24 hrs.,wallstreetbets,MITT,7,0,7,-7,1,1,1,1,NYSE
5005,15-02-2021 10:00,24 hrs.,wallstreetbets,PLTR,3696,466,3230,-2764,16,1512,608,12,NYSE
5005,15-02-2021 10:00,24 hrs.,wallstreetbets,PSTH,24,6,18,-12,4,4,0,4,NYSE
5005,15-02-2021 10:00,24 hrs.,wallstreetbets,RCUS,7,7,0,7,1,1,1,1,NYSE
5005,15-02-2021 10:00,24 hrs.,wallstreetbets,SHOP,7,0,7,-7,1,1,1,1,NYSE
5005,15-02-2021 10:00,24 hrs.,wallstreetbets,SLCA,6,6,0,6,1,1,0,1,NYSE
5005,15-02-2021 10:00,24 hrs.,wallstreetbets,SNPR,13,13,0,13,2,2,1,1,NYSE
5005,15-02-2021 10:00,24 hrs.,wallstreetbets,SPCE,4300,6,4294,-4288,5,2017,246,4,NYSE
5005,15-02-2021 10:00,24 hrs.,wallstreetbets,STPK,14,0,14,-14,2,2,2,2,NYSE
5005,15-02-2021 10:00,24 hrs.,wallstreetbets,UBER,125,125,0,125,1,39,43,1,NYSE
5005,15-02-2021 10:00,24 hrs.,wallstreetbets,GIS,98,98,0,98,2,25,40,2,NYSE
5005,15-02-2021 10:00,24 hrs.,wallstreetbets,GME,14168,6367,7801,-1434,189,5458,2496,145,NYSE
5005,15-02-2021 10:00,24 hrs.,wallstreetbets,GMS,7,0,7,-7,1,1,1,1,NYSE
5005,15-02-2021 10:00,24 hrs.,wallstreetbets,GNW,7,0,7,-7,1,1,1,1,NYSE
5005,15-02-2021 10:00,24 hrs.,wallstreetbets,ICE,89,89,0,89,1,0,85,1,NYSE
5005,15-02-2021 10:00,24 hrs.,wallstreetbets,IGT,7,7,0,7,1,1,1,1,NYSE
5005,15-02-2021 10:00,24 hrs.,wallstreetbets,IVR,243,243,0,243,1,113,13,1,NYSE
5005,15-02-2021 10:00,24 hrs.,wallstreetbets,JNJ,12,6,6,0,2,2,0,2,NYSE
5005,15-02-2021 10:00,24 hrs.,wallstreetbets,JPM,125,125,0,125,1,39,43,1,NYSE
5005,15-02-2021 10:00,24 hrs.,wallstreetbets,KEY,6,0,6,-6,1,1,0,1,NYSE
5005,15-02-2021 10:00,24 hrs.,wallstreetbets,KSU,125,125,0,125,1,39,43,1,NYSE
5005,15-02-2021 10:00,24 hrs.,wallstreetbets,LMT,125,125,0,125,1,39,43,1,NYSE
5005,15-02-2021 10:00,24 hrs.,wallstreetbets,LOW,51,45,6,39,2,8,27,2,NYSE
5005,15-02-2021 10:00,24 hrs.,wallstreetbets,LTC,7,7,0,7,1,1,1,1,NYSE
5005,15-02-2021 10:00,24 hrs.,wallstreetbets,LVS,6,6,0,6,1,1,0,1,NYSE
5005,15-02-2021 10:00,24 hrs.,wallstreetbets,MAC,24,6,18,-12,4,4,0,4,NYSE
5005,15-02-2021 10:00,24 hrs.,wallstreetbets,MGM,7,7,0,7,1,1,1,1,NYSE
5005,15-02-2021 10:00,24 hrs.,wallstreetbets,MMC,6,0,6,-6,1,1,0,1,NYSE
5005,15-02-2021 10:00,24 hrs.,wallstreetbets,MRO,7,0,7,-7,1,1,1,1,NYSE
5005,15-02-2021 10:00,24 hrs.,wallstreetbets,MSI,125,125,0,125,1,39,43,1,NYSE
5005,15-02-2021 10:00,24 hrs.,wallstreetbets,MTG,64,64,0,64,2,15,26,2,NYSE
5005,15-02-2021 10:00,24 hrs.,wallstreetbets,NAV,6,0,6,-6,1,1,0,1,NYSE
5005,15-02-2021 10:00,24 hrs.,wallstreetbets,NET,146,0,146,-146,1,51,40,1,NYSE
5005,15-02-2021 10:00,24 hrs.,wallstreetbets,NIO,1408,0,1408,-1408,5,523,342,4,NYSE
5005,15-02-2021 10:00,24 hrs.,wallstreetbets,NOC,125,125,0,125,1,39,43,1,NYSE
5005,15-02-2021 10:00,24 hrs.,wallstreetbets,NOK,295,249,46,203,17,90,47,15,NYSE
5005,15-02-2021 10:00,24 hrs.,wallstreetbets,NOV,6,6,0,6,1,1,0,1,NYSE
5005,15-02-2021 10:00,24 hrs.,wallstreetbets,PAG,125,125,0,125,1,39,43,1,NYSE
5005,15-02-2021 10:00,24 hrs.,wallstreetbets,PFE,7,0,7,-7,1,1,1,1,NYSE
5005,15-02-2021 10:00,24 hrs.,wallstreetbets,PSA,42,0,42,-42,2,12,10,2,NYSE
5005,15-02-2021 10:00,24 hrs.,wallstreetbets,PSX,188,188,0,188,1,74,36,1,NYSE
5005,15-02-2021 10:00,24 hrs.,wallstreetbets,RGR,7,7,0,7,1,1,1,1,NYSE
5005,15-02-2021 10:00,24 hrs.,wallstreetbets,RKT,36,6,30,-24,5,6,4,4,NYSE
5005,15-02-2021 10:00,24 hrs.,wallstreetbets,RMO,7,0,7,-7,1,1,1,1,NYSE
5005,15-02-2021 10:00,24 hrs.,wallstreetbets,RSI,813,0,813,-813,2,261,283,2,NYSE
5005,15-02-2021 10:00,24 hrs.,wallstreetbets,RTX,133,0,133,-133,1,26,77,1,NYSE
5005,15-02-2021 10:00,24 hrs.,wallstreetbets,SBE,23,0,23,-23,1,7,5,1,NYSE
5005,15-02-2021 10:00,24 hrs.,wallstreetbets,SKT,12,0,12,-12,2,2,0,2,NYSE
5005,15-02-2021 10:00,24 hrs.,wallstreetbets,SOS,26,13,13,0,4,4,2,4,NYSE
5005,15-02-2021 10:00,24 hrs.,wallstreetbets,STC,15,7,8,-1,2,2,3,2,NYSE
5005,15-02-2021 10:00,24 hrs.,wallstreetbets,SWN,7,0,7,-7,1,1,1,1,NYSE
5005,15-02-2021 10:00,24 hrs.,wallstreetbets,TAP,7,0,7,-7,1,1,1,1,NYSE
5005,15-02-2021 10:00,24 hrs.,wallstreetbets,TSM,131,131,0,131,2,40,43,2,NYSE
5005,15-02-2021 10:00,24 hrs.,wallstreetbets,UNP,125,125,0,125,1,39,43,1,NYSE
5005,15-02-2021 10:00,24 hrs.,wallstreetbets,UPS,683,125,558,-433,2,208,259,2,NYSE
5005,15-02-2021 10:00,24 hrs.,wallstreetbets,VET,7,7,0,7,1,1,1,1,NYSE
5005,15-02-2021 10:00,24 hrs.,wallstreetbets,VHC,7,0,7,-7,1,1,1,1,NYSE
5005,15-02-2021 10:00,24 hrs.,wallstreetbets,VRT,39,0,39,-39,3,11,5,1,NYSE
5005,15-02-2021 10:00,24 hrs.,wallstreetbets,WBS,7,0,7,-7,1,1,1,1,NYSE
5005,15-02-2021 10:00,24 hrs.,wallstreetbets,WMT,7,0,7,-7,1,1,1,1,NYSE
5005,15-02-2021 10:00,24 hrs.,wallstreetbets,WWE,27,27,0,27,4,4,3,2,NYSE
5005,15-02-2021 10:00,24 hrs.,wallstreetbets,XOM,717,717,0,717,1,221,271,1,NYSE
5005,15-02-2021 10:00,24 hrs.,wallstreetbets,ARGO,7,0,7,-7,1,1,1,1,NYSE
5005,15-02-2021 10:00,24 hrs.,wallstreetbets,BABA,1010,0,1010,-1010,1,433,140,1,NYSE
5005,15-02-2021 10:00,24 hrs.,wallstreetbets,BALY,113,0,113,-113,1,41,27,1,NYSE
5005,15-02-2021 10:00,24 hrs.,wallstreetbets,BBAR,6,6,0,6,1,1,0,1,NYSE
5005,15-02-2021 10:00,24 hrs.,wallstreetbets,CCIV,33,0,33,-33,5,5,3,5,NYSE
5005,15-02-2021 10:00,24 hrs.,wallstreetbets,CLII,8,8,0,8,1,1,2,1,NYSE
5005,15-02-2021 10:00,24 hrs.,wallstreetbets,COLD,7,7,0,7,1,1,1,1,NYSE
5005,15-02-2021 10:00,24 hrs.,wallstreetbets,COTY,400,394,6,388,3,78,232,3,NYSE
5005,15-02-2021 10:00,24 hrs.,wallstreetbets,DASH,13,0,13,-13,2,2,1,1,NYSE
5005,15-02-2021 10:00,24 hrs.,wallstreetbets,DECK,6,6,0,6,1,1,0,1,NYSE
5005,15-02-2021 10:00,24 hrs.,wallstreetbets,FVRR,7,0,7,-7,1,0,3,1,NYSE
5005,15-02-2021 10:00,24 hrs.,wallstreetbets,GLOB,7,7,0,7,1,1,1,1,NYSE
5005,15-02-2021 10:00,24 hrs.,wallstreetbets,ETN,12,12,0,12,2,2,0,2,NYSE
5005,15-02-2021 10:00,24 hrs.,wallstreetbets,EXP,64,64,0,64,2,15,26,2,NYSE
5005,15-02-2021 10:00,24 hrs.,wallstreetbets,FDX,139,132,7,125,3,41,45,3,NYSE
5005,15-02-2021 10:00,24 hrs.,wallstreetbets,FLT,7,7,0,7,1,1,1,1,NYSE
5005,15-02-2021 10:00,24 hrs.,wallstreetbets,FSR,1034,0,1034,-1034,4,437,144,4,NYSE
5005,15-02-2021 10:00,24 hrs.,wallstreetbets,TRX,7,0,7,-7,1,1,1,1,AMEX
5005,15-02-2021 10:00,24 hrs.,wallstreetbets,UEC,7,0,7,-7,1,1,1,1,AMEX
5005,15-02-2021 10:00,24 hrs.,wallstreetbets,ZOM,68,40,28,12,10,10,8,10,AMEX
5005,15-02-2021 10:00,24 hrs.,wallstreetbets,GOED,14,0,14,-14,2,2,2,1,AMEX
5005,15-02-2021 10:00,24 hrs.,wallstreetbets,GSAT,21,7,14,-7,3,3,3,3,AMEX
5005,15-02-2021 10:00,24 hrs.,wallstreetbets,TRXC,7,7,0,7,1,1,1,1,AMEX
5005,15-02-2021 10:00,24 hrs.,wallstreetbets,UAVS,7,0,7,-7,1,1,1,1,AMEX
5005,15-02-2021 10:00,24 hrs.,wallstreetbets,XXII,12,12,0,12,2,2,0,1,AMEX
5005,15-02-2021 10:00,24 hrs.,wallstreetbets,ACB,13,0,13,-13,2,2,1,2,NYSE
5005,15-02-2021 10:00,24 hrs.,wallstreetbets,AIV,7,7,0,7,1,1,1,1,NYSE
5005,15-02-2021 10:00,24 hrs.,wallstreetbets,AJX,7,0,7,-7,1,1,1,1,NYSE
5005,15-02-2021 10:00,24 hrs.,wallstreetbets,AMC,3246,2853,393,2460,97,1183,492,78,NYSE
5005,15-02-2021 10:00,24 hrs.,wallstreetbets,AMP,6,6,0,6,1,1,0,1,NYSE
5005,15-02-2021 10:00,24 hrs.,wallstreetbets,AMT,125,125,0,125,1,39,43,1,NYSE
5005,15-02-2021 10:00,24 hrs.,wallstreetbets,ASX,21,14,7,7,3,3,3,3,NYSE
5005,15-02-2021 10:00,24 hrs.,wallstreetbets,ATH,139,0,139,-139,2,27,77,2,NYSE
5005,15-02-2021 10:00,24 hrs.,wallstreetbets,BAM,125,125,0,125,1,39,43,1,NYSE
5005,15-02-2021 10:00,24 hrs.,wallstreetbets,BIO,6,0,6,-6,1,1,0,1,NYSE
5005,15-02-2021 10:00,24 hrs.,wallstreetbets,BLK,125,125,0,125,1,39,43,1,NYSE
5005,15-02-2021 10:00,24 hrs.,wallstreetbets,BMA,51,45,6,39,2,8,27,2,NYSE
5005,15-02-2021 10:00,24 hrs.,wallstreetbets,BMY,6,0,6,-6,1,1,0,1,NYSE
5005,15-02-2021 10:00,24 hrs.,wallstreetbets,BTT,15,0,15,-15,2,2,3,2,NYSE
5005,15-02-2021 10:00,24 hrs.,wallstreetbets,CCI,125,125,0,125,1,39,43,1,NYSE
5005,15-02-2021 10:00,24 hrs.,wallstreetbets,CCL,6,0,6,-6,1,1,0,1,NYSE
5005,15-02-2021 10:00,24 hrs.,wallstreetbets,CHS,14,14,0,14,2,2,2,1,NYSE
5005,15-02-2021 10:00,24 hrs.,wallstreetbets,CLF,7,7,0,7,1,1,1,1,NYSE
5005,15-02-2021 10:00,24 hrs.,wallstreetbets,CNS,9,0,9,-9,1,2,1,1,NYSE
5005,15-02-2021 10:00,24 hrs.,wallstreetbets,CRY,8,0,8,-8,1,1,2,1,NYSE
5005,15-02-2021 10:00,24 hrs.,wallstreetbets,CTK,6,6,0,6,1,1,0,1,NYSE
5005,15-02-2021 10:00,24 hrs.,wallstreetbets,DAL,246,246,0,246,1,108,26,1,NYSE
5005,15-02-2021 10:00,24 hrs.,wallstreetbets,DAO,7,7,0,7,1,1,1,1,NYSE
5005,15-02-2021 10:00,24 hrs.,wallstreetbets,DEA,6,6,0,6,1,1,0,1,NYSE
5005,15-02-2021 10:00,24 hrs.,wallstreetbets,DMS,14,0,14,-14,2,2,2,2,NYSE
5005,15-02-2021 10:00,24 hrs.,wallstreetbets,EAT,7,0,7,-7,1,1,1,1,NYSE
5005,15-02-2021 10:00,24 hrs.,wallstreetbets,MKTY,6,6,0,6,1,1,0,1,OTC
5005,15-02-2021 10:00,24 hrs.,wallstreetbets,MOST,188,188,0,188,1,74,36,1,OTC
5005,15-02-2021 10:00,24 hrs.,wallstreetbets,MRMD,7,0,7,-7,1,1,1,1,OTC
5005,15-02-2021 10:00,24 hrs.,wallstreetbets,NMTC,65,65,0,65,1,19,23,1,OTC
5005,15-02-2021 10:00,24 hrs.,wallstreetbets,OZSC,7,0,7,-7,1,1,1,1,OTC
5005,15-02-2021 10:00,24 hrs.,wallstreetbets,PHOT,6,0,6,-6,1,1,0,1,OTC
5005,15-02-2021 10:00,24 hrs.,wallstreetbets,PNAT,7,0,7,-7,1,1,1,1,OTC
5005,15-02-2021 10:00,24 hrs.,wallstreetbets,RBNW,13,0,13,-13,2,2,1,2,OTC
5005,15-02-2021 10:00,24 hrs.,wallstreetbets,RTON,6,6,0,6,1,1,0,1,OTC
5005,15-02-2021 10:00,24 hrs.,wallstreetbets,SGMD,6,6,0,6,1,1,0,1,OTC
5005,15-02-2021 10:00,24 hrs.,wallstreetbets,SING,14,14,0,14,2,2,2,2,OTC
5005,15-02-2021 10:00,24 hrs.,wallstreetbets,SORT,146,0,146,-146,1,51,40,1,OTC
5005,15-02-2021 10:00,24 hrs.,wallstreetbets,SPIN,89,89,0,89,1,0,85,1,OTC
5005,15-02-2021 10:00,24 hrs.,wallstreetbets,TIDE,7,7,0,7,1,1,1,1,OTC
5005,15-02-2021 10:00,24 hrs.,wallstreetbets,TSNP,7,7,0,7,1,1,1,1,OTC
5005,15-02-2021 10:00,24 hrs.,wallstreetbets,UAPC,13,13,0,13,2,2,1,1,OTC
5005,15-02-2021 10:00,24 hrs.,wallstreetbets,UDHI,7,0,7,-7,1,1,1,1,OTC
5005,15-02-2021 10:00,24 hrs.,wallstreetbets,USPS,89,89,0,89,1,0,85,1,OTC
5005,15-02-2021 10:00,24 hrs.,wallstreetbets,VPER,7,0,7,-7,1,1,1,1,OTC
5005,15-02-2021 10:00,24 hrs.,wallstreetbets,WDLF,7,0,7,-7,1,1,1,1,OTC
5005,15-02-2021 10:00,24 hrs.,wallstreetbets,WHEN,6,0,6,-6,1,1,0,1,OTC
5005,15-02-2021 10:00,24 hrs.,wallstreetbets,WNDW,6,6,0,6,1,1,0,1,OTC
5005,15-02-2021 10:00,24 hrs.,wallstreetbets,ALBKY,7,7,0,7,1,1,1,1,OTC
5005,15-02-2021 10:00,24 hrs.,wallstreetbets,AMYZF,6,0,6,-6,1,1,0,1,OTC
5005,15-02-2021 10:00,24 hrs.,wallstreetbets,ARBKF,14,14,0,14,2,2,2,2,OTC
5005,15-02-2021 10:00,24 hrs.,wallstreetbets,BLITF,7,0,7,-7,1,1,1,1,OTC
5005,15-02-2021 10:00,24 hrs.,wallstreetbets,BVNNF,6,6,0,6,1,1,0,1,OTC
5005,15-02-2021 10:00,24 hrs.,wallstreetbets,ENGMF,7,0,7,-7,1,1,1,1,OTC
5005,15-02-2021 10:00,24 hrs.,wallstreetbets,FNNZF,7,0,7,-7,1,1,1,1,OTC
5005,15-02-2021 10:00,24 hrs.,wallstreetbets,GPORQ,14,14,0,14,2,2,2,1,OTC
5005,15-02-2021 10:00,24 hrs.,wallstreetbets,GTBAF,13,13,0,13,2,2,1,1,OTC
5005,15-02-2021 10:00,24 hrs.,wallstreetbets,HTZGQ,7,0,7,-7,1,1,1,1,OTC
5005,15-02-2021 10:00,24 hrs.,wallstreetbets,JRVMF,6,0,6,-6,1,1,0,1,OTC
5005,15-02-2021 10:00,24 hrs.,wallstreetbets,LKNCY,6,6,0,6,1,1,0,1,OTC
5005,15-02-2021 10:00,24 hrs.,wallstreetbets,MMEDF,7,7,0,7,1,1,1,1,OTC
5005,15-02-2021 10:00,24 hrs.,wallstreetbets,PLNHF,7,0,7,-7,1,1,1,1,OTC
5005,15-02-2021 10:00,24 hrs.,wallstreetbets,PROSY,6,6,0,6,1,1,0,1,OTC
5005,15-02-2021 10:00,24 hrs.,wallstreetbets,RLLCF,6,6,0,6,1,1,0,1,OTC
5005,15-02-2021 10:00,24 hrs.,wallstreetbets,RWBYF,7,0,7,-7,1,1,1,1,OTC
5005,15-02-2021 10:00,24 hrs.,wallstreetbets,RYCEY,21,21,0,21,3,3,3,2,OTC
5005,15-02-2021 10:00,24 hrs.,wallstreetbets,SPLIF,6,6,0,6,1,1,0,1,OTC
5005,15-02-2021 10:00,24 hrs.,wallstreetbets,TSCRF,6,0,6,-6,1,1,0,1,OTC
5005,15-02-2021 10:00,24 hrs.,wallstreetbets,TTTSF,6,6,0,6,1,1,0,1,OTC
5005,15-02-2021 10:00,24 hrs.,wallstreetbets,ZBISF,7,0,7,-7,1,1,1,1,OTC
5005,15-02-2021 10:00,24 hrs.,wallstreetbets,AIM,8,0,8,-8,1,1,2,1,AMEX
5005,15-02-2021 10:00,24 hrs.,wallstreetbets,BTG,6,0,6,-6,1,1,0,1,AMEX
5005,15-02-2021 10:00,24 hrs.,wallstreetbets,DNN,13,0,13,-13,2,2,1,2,AMEX
5005,15-02-2021 10:00,24 hrs.,wallstreetbets,DPW,8,8,0,8,1,1,2,1,AMEX
5005,15-02-2021 10:00,24 hrs.,wallstreetbets,GDP,1113,0,1113,-1113,2,341,423,2,AMEX
5005,15-02-2021 10:00,24 hrs.,wallstreetbets,GTE,14,7,7,0,2,2,2,2,AMEX
5005,15-02-2021 10:00,24 hrs.,wallstreetbets,MXC,8,0,8,-8,1,1,2,1,AMEX
5005,15-02-2021 10:00,24 hrs.,wallstreetbets,NAK,6,6,0,6,1,1,0,1,AMEX
5005,15-02-2021 10:00,24 hrs.,pennystocks,SHIP,12,0,12,-12,2,2,0,1,NASDAQ
5005,15-02-2021 10:00,24 hrs.,pennystocks,SNDL,19,7,12,-5,3,3,1,3,NASDAQ
5005,15-02-2021 10:00,24 hrs.,pennystocks,SNGX,86,74,12,62,3,29,16,2,NASDAQ
5005,15-02-2021 10:00,24 hrs.,pennystocks,SOLO,7,7,0,7,1,1,1,1,NASDAQ
5005,15-02-2021 10:00,24 hrs.,pennystocks,TBLT,6,6,0,6,1,1,0,1,NASDAQ
5005,15-02-2021 10:00,24 hrs.,pennystocks,TECH,6,6,0,6,1,1,0,1,NASDAQ
5005,15-02-2021 10:00,24 hrs.,pennystocks,TMDI,6,6,0,6,1,1,0,1,NASDAQ
5005,15-02-2021 10:00,24 hrs.,pennystocks,TNXP,249,160,89,71,4,87,59,4,NASDAQ
5005,15-02-2021 10:00,24 hrs.,pennystocks,TRIB,6,6,0,6,1,1,0,1,NASDAQ
5005,15-02-2021 10:00,24 hrs.,pennystocks,TXMD,7,7,0,7,1,1,1,1,NASDAQ
5005,15-02-2021 10:00,24 hrs.,pennystocks,WRAP,10,10,0,10,1,1,4,1,NASDAQ
5005,15-02-2021 10:00,24 hrs.,wallstreetbets,ABMC,7,7,0,7,1,1,1,1,OTC
5005,15-02-2021 10:00,24 hrs.,wallstreetbets,ABVG,7,7,0,7,1,1,1,1,OTC
5005,15-02-2021 10:00,24 hrs.,wallstreetbets,AITX,20,20,0,20,3,3,2,2,OTC
5005,15-02-2021 10:00,24 hrs.,wallstreetbets,ALKM,14,0,14,-14,2,2,2,1,OTC
5005,15-02-2021 10:00,24 hrs.,wallstreetbets,ALPP,7,7,0,7,1,1,1,1,OTC
5005,15-02-2021 10:00,24 hrs.,wallstreetbets,ANTI,7,7,0,7,1,1,1,1,OTC
5005,15-02-2021 10:00,24 hrs.,wallstreetbets,ASTI,26,6,20,-14,2,1,16,2,OTC
5005,15-02-2021 10:00,24 hrs.,wallstreetbets,BBRW,13,6,7,-1,2,2,1,2,OTC
5005,15-02-2021 10:00,24 hrs.,wallstreetbets,BEES,146,0,146,-146,1,51,40,1,OTC
5005,15-02-2021 10:00,24 hrs.,wallstreetbets,BLSP,7,0,7,-7,1,1,1,1,OTC
5005,15-02-2021 10:00,24 hrs.,wallstreetbets,BNGI,7,0,7,-7,1,1,1,1,OTC
5005,15-02-2021 10:00,24 hrs.,wallstreetbets,BTZI,20,14,6,8,3,3,2,2,OTC
5005,15-02-2021 10:00,24 hrs.,wallstreetbets,CATV,7,0,7,-7,1,1,1,1,OTC
5005,15-02-2021 10:00,24 hrs.,wallstreetbets,CLWD,7,7,0,7,1,1,1,1,OTC
5005,15-02-2021 10:00,24 hrs.,wallstreetbets,COWI,7,0,7,-7,1,1,1,1,OTC
5005,15-02-2021 10:00,24 hrs.,wallstreetbets,CYDY,7,0,7,-7,1,1,1,1,OTC
5005,15-02-2021 10:00,24 hrs.,wallstreetbets,DKMR,6,0,6,-6,1,1,0,1,OTC
5005,15-02-2021 10:00,24 hrs.,wallstreetbets,DTSL,7,7,0,7,1,1,1,1,OTC
5005,15-02-2021 10:00,24 hrs.,wallstreetbets,EFIR,6,0,6,-6,1,1,0,1,OTC
5005,15-02-2021 10:00,24 hrs.,wallstreetbets,ETCC,7,7,0,7,1,1,1,1,OTC
5005,15-02-2021 10:00,24 hrs.,wallstreetbets,FLEW,3546,0,3546,-3546,1,1321,900,1,OTC
5005,15-02-2021 10:00,24 hrs.,wallstreetbets,GAHC,7,0,7,-7,1,1,1,1,OTC
5005,15-02-2021 10:00,24 hrs.,wallstreetbets,GAXY,7,0,7,-7,1,1,1,1,OTC
5005,15-02-2021 10:00,24 hrs.,wallstreetbets,GTBP,8,8,0,8,1,1,2,1,OTC
5005,15-02-2021 10:00,24 hrs.,wallstreetbets,GTLL,14,0,14,-14,2,2,2,1,OTC
5005,15-02-2021 10:00,24 hrs.,wallstreetbets,HCMC,122,42,80,-38,18,17,16,16,OTC
5005,15-02-2021 10:00,24 hrs.,wallstreetbets,HGLC,14,14,0,14,2,2,2,1,OTC
5005,15-02-2021 10:00,24 hrs.,wallstreetbets,HQGE,6,0,6,-6,1,1,0,1,OTC
5005,15-02-2021 10:00,24 hrs.,wallstreetbets,HRBR,6,0,6,-6,1,1,0,1,OTC
5005,15-02-2021 10:00,24 hrs.,wallstreetbets,HWKE,7,0,7,-7,1,1,1,1,OTC
5005,15-02-2021 10:00,24 hrs.,wallstreetbets,HYSR,13,0,13,-13,2,2,1,2,OTC
5005,15-02-2021 10:00,24 hrs.,wallstreetbets,INCT,6,0,6,-6,1,1,0,1,OTC
5005,15-02-2021 10:00,24 hrs.,wallstreetbets,INKW,21,14,7,7,3,3,3,3,OTC
5005,15-02-2021 10:00,24 hrs.,wallstreetbets,INQD,7,0,7,-7,1,1,1,1,OTC
5005,15-02-2021 10:00,24 hrs.,wallstreetbets,IPLY,13,13,0,13,2,2,1,1,OTC
5005,15-02-2021 10:00,24 hrs.,wallstreetbets,MAXD,19,0,19,-19,3,3,1,2,OTC
5005,15-02-2021 10:00,24 hrs.,wallstreetbets,MCOA,7,0,7,-7,1,1,1,1,OTC
5005,15-02-2021 10:00,24 hrs.,wallstreetbets,MINE,7,7,0,7,1,1,1,1,OTC
5005,15-02-2021 10:00,24 hrs.,wallstreetbets,MJLB,7,0,7,-7,1,1,1,1,OTC
5005,15-02-2021 10:00,24 hrs.,pennystocks,ASRT,84,84,0,84,9,20,8,2,NASDAQ
5005,15-02-2021 10:00,24 hrs.,pennystocks,ATOS,62,0,62,-62,2,6,42,2,NASDAQ
5005,15-02-2021 10:00,24 hrs.,pennystocks,BCRX,6,6,0,6,1,1,0,1,NASDAQ
5005,15-02-2021 10:00,24 hrs.,pennystocks,BHTG,9,0,9,-9,1,0,5,1,NASDAQ
5005,15-02-2021 10:00,24 hrs.,pennystocks,BLRX,6,0,6,-6,1,1,0,1,NASDAQ
5005,15-02-2021 10:00,24 hrs.,pennystocks,CFMS,13,0,13,-13,2,2,1,1,NASDAQ
5005,15-02-2021 10:00,24 hrs.,pennystocks,CGIX,6,6,0,6,1,1,0,1,NASDAQ
5005,15-02-2021 10:00,24 hrs.,pennystocks,CHEK,6,0,6,-6,1,1,0,1,NASDAQ
5005,15-02-2021 10:00,24 hrs.,pennystocks,CIDM,139,50,89,-39,2,51,29,2,NASDAQ
5005,15-02-2021 10:00,24 hrs.,pennystocks,CLBS,893,0,893,-893,2,378,129,2,NASDAQ
5005,15-02-2021 10:00,24 hrs.,pennystocks,CLSN,6,0,6,-6,1,1,0,1,NASDAQ
5005,15-02-2021 10:00,24 hrs.,pennystocks,COCP,26,0,26,-26,1,7,8,1,NASDAQ
5005,15-02-2021 10:00,24 hrs.,pennystocks,CRBP,13,7,6,1,2,2,1,2,NASDAQ
5005,15-02-2021 10:00,24 hrs.,pennystocks,CTMX,876,0,876,-876,1,376,120,1,NASDAQ
5005,15-02-2021 10:00,24 hrs.,pennystocks,CTRM,27,20,7,13,4,4,3,4,NASDAQ
5005,15-02-2021 10:00,24 hrs.,pennystocks,DFFN,876,0,876,-876,1,376,120,1,NASDAQ
5005,15-02-2021 10:00,24 hrs.,pennystocks,ECOR,37,0,37,-37,1,10,13,1,NASDAQ
5005,15-02-2021 10:00,24 hrs.,pennystocks,EDIT,442,270,172,98,3,183,64,3,NASDAQ
5005,15-02-2021 10:00,24 hrs.,pennystocks,FTFT,7,0,7,-7,1,1,1,1,NASDAQ
5005,15-02-2021 10:00,24 hrs.,pennystocks,GLBS,876,0,876,-876,1,376,120,1,NASDAQ
5005,15-02-2021 10:00,24 hrs.,pennystocks,IBKR,29,0,29,-29,1,0,25,1,NASDAQ
5005,15-02-2021 10:00,24 hrs.,pennystocks,INPX,33,33,0,33,1,13,3,1,NASDAQ
5005,15-02-2021 10:00,24 hrs.,pennystocks,KTRA,37,0,37,-37,1,10,13,1,NASDAQ
5005,15-02-2021 10:00,24 hrs.,pennystocks,LAZY,9,0,9,-9,1,2,1,1,NASDAQ
5005,15-02-2021 10:00,24 hrs.,pennystocks,MARA,85,85,0,85,1,18,45,1,NASDAQ
5005,15-02-2021 10:00,24 hrs.,pennystocks,NAKD,883,7,876,-869,2,377,121,2,NASDAQ
5005,15-02-2021 10:00,24 hrs.,pennystocks,NOVN,12,0,12,-12,2,2,0,1,NASDAQ
5005,15-02-2021 10:00,24 hrs.,pennystocks,NVAX,27,0,27,-27,1,0,23,1,NASDAQ
5005,15-02-2021 10:00,24 hrs.,pennystocks,NVCN,26,0,26,-26,1,7,8,1,NASDAQ
5005,15-02-2021 10:00,24 hrs.,pennystocks,PLAY,6,0,6,-6,1,1,0,1,NASDAQ
5005,15-02-2021 10:00,24 hrs.,pennystocks,PLUS,24,0,24,-24,1,5,10,1,NASDAQ
5005,15-02-2021 10:00,24 hrs.,pennystocks,PULM,6,0,6,-6,1,1,0,1,NASDAQ
5005,15-02-2021 10:00,24 hrs.,pennystocks,RIOT,85,85,0,85,1,18,45,1,NASDAQ
5005,15-02-2021 10:00,24 hrs.,pennystocks,RNWK,6,6,0,6,1,1,0,1,NASDAQ
5005,15-02-2021 10:00,24 hrs.,pennystocks,SELF,6,0,6,-6,1,1,0,1,NASDAQ
5005,15-02-2021 10:00,24 hrs.,pennystocks,SESN,37,0,37,-37,1,10,13,1,NASDAQ
4993,15-02-2021 08:00,24 hrs.,stocks,CSA,51,0,51,-51,1,13,21,1,NASDAQ
4993,15-02-2021 08:00,24 hrs.,stocks,HAS,6,0,6,-6,1,1,0,1,NASDAQ
4993,15-02-2021 08:00,24 hrs.,stocks,HOL,109,109,0,109,1,40,25,1,NASDAQ
4993,15-02-2021 08:00,24 hrs.,stocks,NEO,6,6,0,6,1,1,0,1,NASDAQ
4993,15-02-2021 08:00,24 hrs.,stocks,OLB,6,6,0,6,1,1,0,1,NASDAQ
4993,15-02-2021 08:00,24 hrs.,stocks,OPK,6,0,6,-6,1,1,0,1,NASDAQ
4993,15-02-2021 08:00,24 hrs.,stocks,QQQ,133,100,33,67,4,21,75,4,NASDAQ
4993,15-02-2021 08:00,24 hrs.,stocks,SDC,6,0,6,-6,1,1,0,1,NASDAQ
4993,15-02-2021 08:00,24 hrs.,stocks,SMH,19,19,0,19,1,5,5,1,NASDAQ
4993,15-02-2021 08:00,24 hrs.,stocks,TER,41,41,0,41,1,10,17,1,NASDAQ
4993,15-02-2021 08:00,24 hrs.,stocks,TXG,41,41,0,41,1,10,17,1,NASDAQ
4993,15-02-2021 08:00,24 hrs.,stocks,WWR,12,12,0,12,2,2,0,1,NASDAQ
4993,15-02-2021 08:00,24 hrs.,stocks,AAPL,4171,41,4130,-4089,3,1645,869,3,NASDAQ
4993,15-02-2021 08:00,24 hrs.,stocks,ABCL,41,41,0,41,1,10,17,1,NASDAQ
4993,15-02-2021 08:00,24 hrs.,stocks,ACAD,41,41,0,41,1,10,17,1,NASDAQ
4993,15-02-2021 08:00,24 hrs.,stocks,ALGN,15,15,0,15,1,4,3,1,NASDAQ
4993,15-02-2021 08:00,24 hrs.,stocks,AMAT,41,41,0,41,1,10,17,1,NASDAQ
4993,15-02-2021 08:00,24 hrs.,stocks,AMKR,41,41,0,41,1,10,17,1,NASDAQ
4993,15-02-2021 08:00,24 hrs.,stocks,AMZN,4171,41,4130,-4089,3,1645,869,3,NASDAQ
4993,15-02-2021 08:00,24 hrs.,stocks,APHA,519,16,503,-487,2,195,121,2,NASDAQ
4993,15-02-2021 08:00,24 hrs.,stocks,ATNF,6,0,6,-6,1,1,0,1,NASDAQ
4993,15-02-2021 08:00,24 hrs.,stocks,AYRO,6,0,6,-6,1,1,0,1,NASDAQ
4993,15-02-2021 08:00,24 hrs.,stocks,CLNE,24,24,0,24,1,4,12,1,NASDAQ
4993,15-02-2021 08:00,24 hrs.,stocks,CLSN,6,6,0,6,1,1,0,1,NASDAQ
4993,15-02-2021 08:00,24 hrs.,stocks,CMLF,6,0,6,-6,1,1,0,1,NASDAQ
4993,15-02-2021 08:00,24 hrs.,stocks,CORE,5780,0,5780,-5780,1,2715,346,1,NASDAQ
4993,15-02-2021 08:00,24 hrs.,stocks,CRSR,578,41,537,-496,3,214,138,3,NASDAQ
4993,15-02-2021 08:00,24 hrs.,stocks,CSCO,32,32,0,32,1,4,20,1,NASDAQ
4993,15-02-2021 08:00,24 hrs.,stocks,CSIQ,51,0,51,-51,1,13,21,1,NASDAQ
4993,15-02-2021 08:00,24 hrs.,stocks,CTRM,6,6,0,6,1,1,0,1,NASDAQ
4993,15-02-2021 08:00,24 hrs.,stocks,DKNG,503,0,503,-503,1,191,117,1,NASDAQ
4993,15-02-2021 08:00,24 hrs.,stocks,DOCU,41,41,0,41,1,10,17,1,NASDAQ
4993,15-02-2021 08:00,24 hrs.,stocks,EDIT,5937,157,5780,-5623,3,2773,379,3,NASDAQ
4993,15-02-2021 08:00,24 hrs.,stocks,ERIC,32,32,0,32,1,4,20,1,NASDAQ
4993,15-02-2021 08:00,24 hrs.,stocks,EVOK,6,0,6,-6,1,1,0,1,NASDAQ
4993,15-02-2021 08:00,24 hrs.,stocks,EXPI,19,13,6,7,2,3,5,2,NASDAQ
4993,15-02-2021 08:00,24 hrs.,stocks,FCAC,12,0,12,-12,2,2,0,1,NASDAQ
4993,15-02-2021 08:00,24 hrs.,stocks,GHIV,6,6,0,6,1,1,0,1,NASDAQ
4993,15-02-2021 08:00,24 hrs.,stocks,GNOG,6,0,6,-6,1,1,0,1,NASDAQ
4993,15-02-2021 08:00,24 hrs.,stocks,GOOG,25,25,0,25,1,4,13,1,NASDAQ
4993,15-02-2021 08:00,24 hrs.,stocks,ICLN,503,0,503,-503,1,191,117,1,NASDAQ
4993,15-02-2021 08:00,24 hrs.,stocks,ILMN,6,6,0,6,1,1,0,1,NASDAQ
4993,15-02-2021 08:00,24 hrs.,stocks,INTC,87,87,0,87,1,30,23,1,NASDAQ
4993,15-02-2021 08:00,24 hrs.,trakstocks,TXMD,4,4,0,4,1,0,0,1,NASDAQ
4993,15-02-2021 08:00,24 hrs.,stocks,SOLO,6,0,6,-6,1,1,0,1,NASDAQ
4993,15-02-2021 08:00,24 hrs.,stocks,SRAC,109,109,0,109,1,40,25,1,NASDAQ
4993,15-02-2021 08:00,24 hrs.,stocks,SRNE,100,0,100,-100,1,37,22,1,NASDAQ
4993,15-02-2021 08:00,24 hrs.,stocks,SURF,7,7,0,7,1,1,1,1,NASDAQ
4993,15-02-2021 08:00,24 hrs.,stocks,TLRY,708,205,503,-298,4,233,226,4,NASDAQ
4993,15-02-2021 08:00,24 hrs.,stocks,TQQQ,14,0,14,-14,1,0,10,1,NASDAQ
4993,15-02-2021 08:00,24 hrs.,stocks,TRCH,10,10,0,10,1,2,2,1,NASDAQ
4993,15-02-2021 08:00,24 hrs.,stocks,TSLA,550,41,509,-468,3,202,134,3,NASDAQ
4993,15-02-2021 08:00,24 hrs.,stocks,TXMD,10,10,0,10,1,0,6,1,NASDAQ
4993,15-02-2021 08:00,24 hrs.,stocks,VKTX,6,6,0,6,1,1,0,1,NASDAQ
4993,15-02-2021 08:00,24 hrs.,stocks,VRTX,6,6,0,6,1,1,0,1,NASDAQ
4993,15-02-2021 08:00,24 hrs.,stocks,VSTA,26,26,0,26,1,6,10,1,NASDAQ
4993,15-02-2021 08:00,24 hrs.,stocks,VXUS,28,28,0,28,1,8,8,1,NASDAQ
4993,15-02-2021 08:00,24 hrs.,stocks,WISH,503,0,503,-503,1,191,117,1,NASDAQ
4993,15-02-2021 08:00,24 hrs.,stocks,KOPN,10,10,0,10,1,0,6,1,NASDAQ
4993,15-02-2021 08:00,24 hrs.,stocks,LRCX,41,41,0,41,1,10,17,1,NASDAQ
4993,15-02-2021 08:00,24 hrs.,stocks,MARA,16,16,0,16,1,4,4,1,NASDAQ
4993,15-02-2021 08:00,24 hrs.,stocks,MCHP,41,41,0,41,1,10,17,1,NASDAQ
4993,15-02-2021 08:00,24 hrs.,stocks,MNKD,6,6,0,6,1,1,0,1,NASDAQ
4993,15-02-2021 08:00,24 hrs.,stocks,MSFT,3776,149,3627,-3478,4,1475,810,4,NASDAQ
4993,15-02-2021 08:00,24 hrs.,stocks,MSTR,34,0,34,-34,1,13,4,1,NASDAQ
4993,15-02-2021 08:00,24 hrs.,stocks,MTCH,32,32,0,32,1,6,16,1,NASDAQ
4993,15-02-2021 08:00,24 hrs.,stocks,NAKD,6,0,6,-6,1,1,0,1,NASDAQ
4993,15-02-2021 08:00,24 hrs.,stocks,NEPT,6,0,6,-6,1,1,0,1,NASDAQ
4993,15-02-2021 08:00,24 hrs.,stocks,NNDM,6,6,0,6,1,1,0,1,NASDAQ
4993,15-02-2021 08:00,24 hrs.,stocks,NNOX,6,0,6,-6,1,1,0,1,NASDAQ
4993,15-02-2021 08:00,24 hrs.,stocks,NOVN,6,0,6,-6,1,1,0,1,NASDAQ
4993,15-02-2021 08:00,24 hrs.,stocks,NOVS,21,0,21,-21,1,5,7,1,NASDAQ
4993,15-02-2021 08:00,24 hrs.,stocks,NTRS,32,32,0,32,1,4,20,1,NASDAQ
4993,15-02-2021 08:00,24 hrs.,stocks,NVDA,655,152,503,-351,4,236,167,4,NASDAQ
4993,15-02-2021 08:00,24 hrs.,stocks,ONVO,12,0,12,-12,2,2,0,2,NASDAQ
4993,15-02-2021 08:00,24 hrs.,stocks,PAAS,17,0,17,-17,1,4,5,1,NASDAQ
4993,15-02-2021 08:00,24 hrs.,stocks,PFMT,18,0,18,-18,3,3,0,2,NASDAQ
4993,15-02-2021 08:00,24 hrs.,stocks,POWW,69,69,0,69,2,19,23,2,NASDAQ
4993,15-02-2021 08:00,24 hrs.,stocks,PRTK,6,0,6,-6,1,1,0,1,NASDAQ
4993,15-02-2021 08:00,24 hrs.,stocks,PYPL,32,32,0,32,1,4,20,1,NASDAQ
4993,15-02-2021 08:00,24 hrs.,stocks,QRVO,41,41,0,41,1,10,17,1,NASDAQ
4993,15-02-2021 08:00,24 hrs.,stocks,REAL,6,6,0,6,1,1,0,1,NASDAQ
4993,15-02-2021 08:00,24 hrs.,stocks,REGN,25,25,0,25,1,3,15,1,NASDAQ
4993,15-02-2021 08:00,24 hrs.,stocks,RIOT,16,16,0,16,1,4,4,1,NASDAQ
4993,15-02-2021 08:00,24 hrs.,stocks,SAVA,6,6,0,6,1,1,0,1,NASDAQ
4993,15-02-2021 08:00,24 hrs.,stocks,SEDG,92,41,51,-10,2,23,38,2,NASDAQ
4993,15-02-2021 08:00,24 hrs.,stocks,BNED,18,18,0,18,1,5,4,1,NYSE
4993,15-02-2021 08:00,24 hrs.,stocks,CCIV,6,6,0,6,1,1,0,1,NYSE
4993,15-02-2021 08:00,24 hrs.,stocks,DASH,6,0,6,-6,1,1,0,1,NYSE
4993,15-02-2021 08:00,24 hrs.,stocks,EARN,6,0,6,-6,1,1,0,1,NYSE
4993,15-02-2021 08:00,24 hrs.,stocks,FSLY,41,41,0,41,1,10,17,1,NYSE
4993,15-02-2021 08:00,24 hrs.,stocks,HYLN,503,0,503,-503,1,191,117,1,NYSE
4993,15-02-2021 08:00,24 hrs.,stocks,LDOS,32,32,0,32,1,4,20,1,NYSE
4993,15-02-2021 08:00,24 hrs.,stocks,LGVW,21,0,21,-21,1,0,17,1,NYSE
4993,15-02-2021 08:00,24 hrs.,stocks,MSCI,7,0,7,-7,1,1,1,1,NYSE
4993,15-02-2021 08:00,24 hrs.,stocks,PLTR,623,63,560,-497,5,228,147,5,NYSE
4993,15-02-2021 08:00,24 hrs.,stocks,SAFE,6,0,6,-6,1,1,0,1,NYSE
4993,15-02-2021 08:00,24 hrs.,stocks,SNPR,6,6,0,6,1,1,0,1,NYSE
4993,15-02-2021 08:00,24 hrs.,stocks,SPCE,653,150,503,-353,3,241,159,3,NYSE
4993,15-02-2021 08:00,24 hrs.,stocks,UBER,32,32,0,32,1,4,20,1,NYSE
4993,15-02-2021 08:00,24 hrs.,stocks,VALE,41,41,0,41,1,10,17,1,NYSE
4993,15-02-2021 08:00,24 hrs.,stocks,WORK,8,8,0,8,1,1,2,1,NYSE
4993,15-02-2021 08:00,24 hrs.,stocks,XPEV,555,7,548,-541,2,143,261,2,NYSE
4993,15-02-2021 08:00,24 hrs.,stocks,AMD,656,128,528,-400,4,236,168,4,NASDAQ
4993,15-02-2021 08:00,24 hrs.,stocks,API,6,6,0,6,1,1,0,1,NASDAQ
4993,15-02-2021 08:00,24 hrs.,stocks,CFO,51,0,51,-51,1,13,21,1,NASDAQ
4993,15-02-2021 08:00,24 hrs.,stocks,CGC,23,23,0,23,1,5,9,1,NASDAQ
4993,15-02-2021 08:00,24 hrs.,StockMarket,MSM,6,6,0,6,1,1,0,1,NYSE
4993,15-02-2021 08:00,24 hrs.,stocks,WRAP,6,6,0,6,1,1,0,1,NASDAQ
4993,15-02-2021 08:00,24 hrs.,stocks,ZNGA,16,16,0,16,1,4,4,1,NASDAQ
4993,15-02-2021 08:00,24 hrs.,stocks,GOOGL,66,66,0,66,2,14,30,2,NASDAQ
4993,15-02-2021 08:00,24 hrs.,stocks,NOVSW,21,0,21,-21,1,5,7,1,NASDAQ
4993,15-02-2021 08:00,24 hrs.,Daytrading,BLSP,6,6,0,6,1,1,0,1,OTC
4993,15-02-2021 08:00,24 hrs.,Daytrading,CBSC,6,0,6,-6,1,1,0,1,OTC
4993,15-02-2021 08:00,24 hrs.,Daytrading,COMS,24,24,0,24,1,7,6,1,OTC
4993,15-02-2021 08:00,24 hrs.,Daytrading,AMC,12,6,6,0,2,2,0,2,NYSE
4993,15-02-2021 08:00,24 hrs.,Daytrading,ATH,25,11,14,-3,3,4,5,2,NYSE
4993,15-02-2021 08:00,24 hrs.,Daytrading,FSR,11,11,0,11,1,3,1,1,NYSE
4993,15-02-2021 08:00,24 hrs.,Daytrading,IGT,13,13,0,13,2,2,1,1,NYSE
4993,15-02-2021 08:00,24 hrs.,Daytrading,PDT,35,35,0,35,1,8,15,1,NYSE
4993,15-02-2021 08:00,24 hrs.,Daytrading,ACIU,24,24,0,24,1,7,6,1,NASDAQ
4993,15-02-2021 08:00,24 hrs.,Daytrading,BHTG,8,0,8,-8,1,1,2,1,NASDAQ
4993,15-02-2021 08:00,24 hrs.,Daytrading,CRBP,24,24,0,24,1,7,6,1,NASDAQ
4993,15-02-2021 08:00,24 hrs.,Daytrading,FORD,26,0,26,-26,1,4,14,1,NASDAQ
4993,15-02-2021 08:00,24 hrs.,Daytrading,NOVN,24,24,0,24,1,7,6,1,NASDAQ
4993,15-02-2021 08:00,24 hrs.,Daytrading,PRTA,24,24,0,24,1,7,6,1,NASDAQ
4993,15-02-2021 08:00,24 hrs.,Daytrading,TRCH,24,24,0,24,1,7,6,1,NASDAQ
4993,15-02-2021 08:00,24 hrs.,Daytrading,VETS,25,0,25,-25,1,2,17,1,NASDAQ
4993,15-02-2021 08:00,24 hrs.,Daytrading,VISL,24,24,0,24,1,7,6,1,NASDAQ
4993,15-02-2021 08:00,24 hrs.,trakstocks,HCMC,29,29,0,29,1,11,3,1,OTC
4993,15-02-2021 08:00,24 hrs.,trakstocks,INND,6,6,0,6,1,0,2,1,OTC
4993,15-02-2021 08:00,24 hrs.,trakstocks,MOST,6,6,0,6,1,1,0,1,OTC
4993,15-02-2021 08:00,24 hrs.,trakstocks,MYMX,8,8,0,8,1,2,0,1,OTC
4993,15-02-2021 08:00,24 hrs.,trakstocks,OZSC,6,6,0,6,1,0,2,1,OTC
4993,15-02-2021 08:00,24 hrs.,trakstocks,SRMX,6,6,0,6,1,0,2,1,OTC
4993,15-02-2021 08:00,24 hrs.,trakstocks,SSFT,236,14,222,-208,2,88,52,2,OTC
4993,15-02-2021 08:00,24 hrs.,trakstocks,ARBKF,6,6,0,6,1,1,0,1,OTC
4993,15-02-2021 08:00,24 hrs.,trakstocks,CNVCF,8,8,0,8,1,1,2,1,OTC
4993,15-02-2021 08:00,24 hrs.,trakstocks,DFMTF,14,14,0,14,1,5,0,1,OTC
4993,15-02-2021 08:00,24 hrs.,trakstocks,HITIF,61,61,0,61,1,21,15,1,OTC
4993,15-02-2021 08:00,24 hrs.,trakstocks,HVBTF,6,6,0,6,1,1,0,1,OTC
4993,15-02-2021 08:00,24 hrs.,trakstocks,ZOM,10,0,10,-10,1,0,6,1,AMEX
4993,15-02-2021 08:00,24 hrs.,trakstocks,TRXC,13,13,0,13,1,3,3,1,AMEX
4993,15-02-2021 08:00,24 hrs.,trakstocks,NGA,40,40,0,40,1,13,10,1,NYSE
4993,15-02-2021 08:00,24 hrs.,trakstocks,NVO,12,12,0,12,1,3,2,1,NYSE
4993,15-02-2021 08:00,24 hrs.,trakstocks,SBE,14,14,0,14,1,3,4,1,NYSE
4993,15-02-2021 08:00,24 hrs.,trakstocks,ALUS,9,9,0,9,1,1,3,1,NYSE
4993,15-02-2021 08:00,24 hrs.,trakstocks,ARGO,6,6,0,6,1,1,0,1,NYSE
4993,15-02-2021 08:00,24 hrs.,trakstocks,AVYA,8,8,0,8,1,2,0,1,NYSE
4993,15-02-2021 08:00,24 hrs.,trakstocks,HYLN,28,0,28,-28,2,8,4,2,NYSE
4993,15-02-2021 08:00,24 hrs.,trakstocks,SKLZ,15,15,0,15,1,5,1,1,NYSE
4993,15-02-2021 08:00,24 hrs.,trakstocks,TPGY,10,10,0,10,1,2,2,1,NYSE
4993,15-02-2021 08:00,24 hrs.,trakstocks,UBX,8,8,0,8,1,2,0,1,NASDAQ
4993,15-02-2021 08:00,24 hrs.,trakstocks,AACQ,22,0,22,-22,1,8,2,1,NASDAQ
4993,15-02-2021 08:00,24 hrs.,trakstocks,ACTC,498,498,0,498,1,214,66,1,NASDAQ
4993,15-02-2021 08:00,24 hrs.,trakstocks,AMTX,6,6,0,6,1,1,0,1,NASDAQ
4993,15-02-2021 08:00,24 hrs.,trakstocks,AMZN,14,6,8,-2,2,2,2,2,NASDAQ
4993,15-02-2021 08:00,24 hrs.,trakstocks,APPS,8,0,8,-8,1,2,0,1,NASDAQ
4993,15-02-2021 08:00,24 hrs.,trakstocks,ASRT,4,4,0,4,1,0,0,1,NASDAQ
4993,15-02-2021 08:00,24 hrs.,trakstocks,BHTG,6,0,6,-6,1,1,0,1,NASDAQ
4993,15-02-2021 08:00,24 hrs.,trakstocks,BIOC,8,0,8,-8,1,2,0,1,NASDAQ
4993,15-02-2021 08:00,24 hrs.,trakstocks,BXRX,4,4,0,4,1,0,0,1,NASDAQ
4993,15-02-2021 08:00,24 hrs.,trakstocks,CIDM,30,0,30,-30,1,13,0,1,NASDAQ
4993,15-02-2021 08:00,24 hrs.,trakstocks,CTRM,35,35,0,35,1,11,9,1,NASDAQ
4993,15-02-2021 08:00,24 hrs.,trakstocks,EDIT,133,0,133,-133,1,52,25,1,NASDAQ
4993,15-02-2021 08:00,24 hrs.,trakstocks,GILT,8,8,0,8,1,2,0,1,NASDAQ
4993,15-02-2021 08:00,24 hrs.,trakstocks,MSFT,6,6,0,6,1,0,2,1,NASDAQ
4993,15-02-2021 08:00,24 hrs.,trakstocks,MVIS,4,0,4,-4,1,0,0,1,NASDAQ
4993,15-02-2021 08:00,24 hrs.,trakstocks,NCNA,8,8,0,8,1,2,0,1,NASDAQ
4993,15-02-2021 08:00,24 hrs.,trakstocks,PLAY,8,8,0,8,1,2,0,1,NASDAQ
4993,15-02-2021 08:00,24 hrs.,trakstocks,TMUS,6,6,0,6,1,0,2,1,NASDAQ
4993,15-02-2021 08:00,24 hrs.,pennystocks,BTZI,62,0,62,-62,1,12,34,1,OTC
4993,15-02-2021 08:00,24 hrs.,pennystocks,CBDD,62,0,62,-62,1,12,34,1,OTC
4993,15-02-2021 08:00,24 hrs.,pennystocks,CBDL,892,6,886,-880,3,379,122,3,OTC
4993,15-02-2021 08:00,24 hrs.,pennystocks,CBTC,6,6,0,6,1,1,0,1,OTC
4993,15-02-2021 08:00,24 hrs.,pennystocks,CCTL,12,6,6,0,2,2,0,2,OTC
4993,15-02-2021 08:00,24 hrs.,pennystocks,CHUC,26,0,26,-26,1,7,8,1,OTC
4993,15-02-2021 08:00,24 hrs.,pennystocks,COUV,49,0,49,-49,1,8,29,1,OTC
4993,15-02-2021 08:00,24 hrs.,pennystocks,ECEZ,7,7,0,7,1,1,1,1,OTC
4993,15-02-2021 08:00,24 hrs.,pennystocks,EXMT,62,0,62,-62,1,12,34,1,OTC
4993,15-02-2021 08:00,24 hrs.,pennystocks,FCTI,22,22,0,22,1,8,2,1,OTC
4993,15-02-2021 08:00,24 hrs.,pennystocks,GAHC,7,0,7,-7,1,1,1,1,OTC
4993,15-02-2021 08:00,24 hrs.,pennystocks,GBFH,28,0,28,-28,1,5,14,1,OTC
4993,15-02-2021 08:00,24 hrs.,pennystocks,GBLX,6,6,0,6,1,1,0,1,OTC
4993,15-02-2021 08:00,24 hrs.,pennystocks,GGII,7,0,7,-7,1,1,1,1,OTC
4993,15-02-2021 08:00,24 hrs.,pennystocks,GNPT,6,6,0,6,1,1,0,1,OTC
4993,15-02-2021 08:00,24 hrs.,pennystocks,GPFT,12,12,0,12,2,2,0,2,OTC
4993,15-02-2021 08:00,24 hrs.,pennystocks,GRCU,6,6,0,6,1,1,0,1,OTC
4993,15-02-2021 08:00,24 hrs.,pennystocks,GRLT,48,0,48,-48,1,12,20,1,OTC
4993,15-02-2021 08:00,24 hrs.,pennystocks,GRST,893,0,893,-893,2,381,123,2,OTC
4993,15-02-2021 08:00,24 hrs.,pennystocks,GTEH,22,22,0,22,2,6,2,2,OTC
4993,15-02-2021 08:00,24 hrs.,pennystocks,GTLL,914,0,914,-914,2,390,126,2,OTC
4993,15-02-2021 08:00,24 hrs.,pennystocks,HCMC,69,31,38,-7,10,13,3,10,OTC
4993,15-02-2021 08:00,24 hrs.,pennystocks,HESG,6,0,6,-6,1,1,0,1,OTC
4993,15-02-2021 08:00,24 hrs.,StockMarket,NET,21,0,21,-21,1,7,3,1,NYSE
4993,15-02-2021 08:00,24 hrs.,StockMarket,NIO,6,6,0,6,1,1,0,1,NYSE
4993,15-02-2021 08:00,24 hrs.,StockMarket,PHI,4,4,0,4,1,0,0,1,NYSE
4993,15-02-2021 08:00,24 hrs.,StockMarket,REV,6,0,6,-6,1,1,0,1,NYSE
4993,15-02-2021 08:00,24 hrs.,StockMarket,SIG,7,7,0,7,1,1,1,1,NYSE
4993,15-02-2021 08:00,24 hrs.,StockMarket,THC,21,0,21,-21,1,7,3,1,NYSE
4993,15-02-2021 08:00,24 hrs.,StockMarket,TMX,7,7,0,7,1,1,1,1,NYSE
4993,15-02-2021 08:00,24 hrs.,StockMarket,VRT,20,0,20,-20,1,8,0,1,NYSE
4993,15-02-2021 08:00,24 hrs.,StockMarket,BALY,6,6,0,6,1,1,0,1,NYSE
4993,15-02-2021 08:00,24 hrs.,StockMarket,COTY,24,4,20,-16,4,2,4,3,NYSE
4993,15-02-2021 08:00,24 hrs.,StockMarket,PLTR,72,0,72,-72,1,14,40,1,NYSE
4993,15-02-2021 08:00,24 hrs.,StockMarket,STPK,10,0,10,-10,1,3,0,1,NYSE
4993,15-02-2021 08:00,24 hrs.,StockMarket,VALE,6,6,0,6,1,1,0,1,NYSE
4993,15-02-2021 08:00,24 hrs.,StockMarket,WORK,22,22,0,22,1,3,12,1,NYSE
4993,15-02-2021 08:00,24 hrs.,StockMarket,API,10,10,0,10,1,1,4,1,NASDAQ
4993,15-02-2021 08:00,24 hrs.,StockMarket,FOX,8,0,8,-8,1,0,4,1,NASDAQ
4993,15-02-2021 08:00,24 hrs.,StockMarket,III,13,13,0,13,1,2,5,1,NASDAQ
4993,15-02-2021 08:00,24 hrs.,StockMarket,NEO,4,4,0,4,1,0,0,1,NASDAQ
4993,15-02-2021 08:00,24 hrs.,StockMarket,RNA,13,13,0,13,1,2,5,1,NASDAQ
4993,15-02-2021 08:00,24 hrs.,StockMarket,VFF,6,6,0,6,1,1,0,1,NASDAQ
4993,15-02-2021 08:00,24 hrs.,StockMarket,ALGN,10,10,0,10,1,2,2,1,NASDAQ
4993,15-02-2021 08:00,24 hrs.,StockMarket,APHA,6,0,6,-6,1,1,0,1,NASDAQ
4993,15-02-2021 08:00,24 hrs.,StockMarket,ASYS,10,0,10,-10,1,3,0,1,NASDAQ
4993,15-02-2021 08:00,24 hrs.,StockMarket,BLNK,7,7,0,7,1,1,1,1,NASDAQ
4993,15-02-2021 08:00,24 hrs.,StockMarket,CLSN,19,19,0,19,2,3,5,2,NASDAQ
4993,15-02-2021 08:00,24 hrs.,StockMarket,CMLF,6,0,6,-6,1,1,0,1,NASDAQ
4993,15-02-2021 08:00,24 hrs.,StockMarket,CRBP,67,0,67,-67,1,18,27,1,NASDAQ
4993,15-02-2021 08:00,24 hrs.,StockMarket,CTRM,15,0,15,-15,1,4,3,1,NASDAQ
4993,15-02-2021 08:00,24 hrs.,StockMarket,EDIT,81,0,81,-81,1,10,57,1,NASDAQ
4993,15-02-2021 08:00,24 hrs.,StockMarket,FLGT,6,6,0,6,1,1,0,1,NASDAQ
4993,15-02-2021 08:00,24 hrs.,trakstocks,VYNE,8,8,0,8,1,1,2,1,NASDAQ
4993,15-02-2021 08:00,24 hrs.,StockMarket,CAGR,10,10,0,10,1,2,2,1,OTC
4993,15-02-2021 08:00,24 hrs.,StockMarket,HCMC,4,4,0,4,1,0,0,1,OTC
4993,15-02-2021 08:00,24 hrs.,StockMarket,MJNA,4,0,4,-4,1,0,0,1,OTC
4993,15-02-2021 08:00,24 hrs.,StockMarket,PHIL,4,4,0,4,1,0,0,1,OTC
4993,15-02-2021 08:00,24 hrs.,StockMarket,GSV,6,6,0,6,1,1,0,1,AMEX
4993,15-02-2021 08:00,24 hrs.,StockMarket,AMC,446,21,425,-404,5,175,76,5,NYSE
4993,15-02-2021 08:00,24 hrs.,StockMarket,CBD,21,0,21,-21,1,7,3,1,NYSE
4993,15-02-2021 08:00,24 hrs.,StockMarket,DSM,6,0,6,-6,1,1,0,1,NYSE
4993,15-02-2021 08:00,24 hrs.,StockMarket,GBX,24,24,0,24,1,6,8,1,NYSE
4993,15-02-2021 08:00,24 hrs.,StockMarket,GME,79,39,40,-1,9,9,25,8,NYSE
4993,15-02-2021 08:00,24 hrs.,pennystocks,MFST,6,6,0,6,1,1,0,1,OTC
4993,15-02-2021 08:00,24 hrs.,pennystocks,MINE,210,50,160,-110,4,70,54,3,OTC
4993,15-02-2021 08:00,24 hrs.,pennystocks,MJWL,48,0,48,-48,1,12,20,1,OTC
4993,15-02-2021 08:00,24 hrs.,pennystocks,MLFB,167,6,161,-155,2,52,55,2,OTC
4993,15-02-2021 08:00,24 hrs.,pennystocks,MRNJ,7,0,7,-7,1,1,1,1,OTC
4993,15-02-2021 08:00,24 hrs.,pennystocks,NLST,66,66,0,66,2,10,38,2,OTC
4993,15-02-2021 08:00,24 hrs.,pennystocks,ONPH,6,6,0,6,1,1,0,1,OTC
4993,15-02-2021 08:00,24 hrs.,pennystocks,OZSC,7,7,0,7,1,1,1,1,OTC
4993,15-02-2021 08:00,24 hrs.,pennystocks,PHBI,6,6,0,6,1,1,0,1,OTC
4993,15-02-2021 08:00,24 hrs.,pennystocks,PHCG,6,6,0,6,1,1,0,1,OTC
4993,15-02-2021 08:00,24 hrs.,pennystocks,PLYZ,12,0,12,-12,2,2,0,2,OTC
4993,15-02-2021 08:00,24 hrs.,pennystocks,PPJE,7,0,7,-7,1,1,1,1,OTC
4993,15-02-2021 08:00,24 hrs.,pennystocks,PRMO,48,0,48,-48,1,12,20,1,OTC
4993,15-02-2021 08:00,24 hrs.,pennystocks,PUGE,113,50,63,-13,2,31,43,2,OTC
4993,15-02-2021 08:00,24 hrs.,pennystocks,PVDG,37,0,37,-37,1,7,19,1,OTC
4993,15-02-2021 08:00,24 hrs.,pennystocks,RBNW,6,6,0,6,1,1,0,1,OTC
4993,15-02-2021 08:00,24 hrs.,pennystocks,SEEK,25,25,0,25,1,2,17,1,OTC
4993,15-02-2021 08:00,24 hrs.,pennystocks,SGMD,122,122,0,122,2,37,40,2,OTC
4993,15-02-2021 08:00,24 hrs.,pennystocks,SGSI,40,0,40,-40,1,14,8,1,OTC
4993,15-02-2021 08:00,24 hrs.,pennystocks,SHMP,6,0,6,-6,1,1,0,1,OTC
4993,15-02-2021 08:00,24 hrs.,pennystocks,SING,6,0,6,-6,1,1,0,1,OTC
4993,15-02-2021 08:00,24 hrs.,pennystocks,SNPW,203,203,0,203,11,63,33,4,OTC
4993,15-02-2021 08:00,24 hrs.,pennystocks,SRMX,85,0,85,-85,2,19,39,2,OTC
4993,15-02-2021 08:00,24 hrs.,pennystocks,SSFT,162,156,6,150,2,64,26,2,OTC
4993,15-02-2021 08:00,24 hrs.,pennystocks,STHC,8,8,0,8,1,1,2,1,OTC
4993,15-02-2021 08:00,24 hrs.,pennystocks,TGGI,7,0,7,-7,1,1,1,1,OTC
4993,15-02-2021 08:00,24 hrs.,pennystocks,TLGN,858,0,858,-858,1,370,114,1,OTC
4993,15-02-2021 08:00,24 hrs.,pennystocks,TSNP,121,80,41,39,3,35,39,3,OTC
4993,15-02-2021 08:00,24 hrs.,StockMarket,FOLD,12,12,0,12,2,2,0,2,NASDAQ
4993,15-02-2021 08:00,24 hrs.,StockMarket,GPRO,6,0,6,-6,1,1,0,1,NASDAQ
4993,15-02-2021 08:00,24 hrs.,StockMarket,INVE,6,0,6,-6,1,0,2,1,NASDAQ
4993,15-02-2021 08:00,24 hrs.,StockMarket,KOSS,21,21,0,21,1,2,13,1,NASDAQ
4993,15-02-2021 08:00,24 hrs.,StockMarket,SNDL,82,0,82,-82,3,12,46,3,NASDAQ
4993,15-02-2021 08:00,24 hrs.,StockMarket,SOLO,6,0,6,-6,1,1,0,1,NASDAQ
4993,15-02-2021 08:00,24 hrs.,StockMarket,TLRY,6,0,6,-6,1,1,0,1,NASDAQ
4993,15-02-2021 08:00,24 hrs.,StockMarket,TNXP,22,0,22,-22,1,9,0,1,NASDAQ
4993,15-02-2021 08:00,24 hrs.,StockMarket,TRCH,6,6,0,6,1,1,0,1,NASDAQ
4993,15-02-2021 08:00,24 hrs.,StockMarket,TRVG,72,0,72,-72,1,14,40,1,NASDAQ
4993,15-02-2021 08:00,24 hrs.,StockMarket,TSLA,5,5,0,5,1,0,1,1,NASDAQ
4993,15-02-2021 08:00,24 hrs.,StockMarket,VKTX,6,6,0,6,1,1,0,1,NASDAQ
4993,15-02-2021 08:00,24 hrs.,StockMarket,VXRT,6,0,6,-6,1,1,0,1,NASDAQ
4993,15-02-2021 08:00,24 hrs.,StockMarket,XRAY,10,10,0,10,1,2,2,1,NASDAQ
4993,15-02-2021 08:00,24 hrs.,pennystocks,AAGH,37,37,0,37,1,10,13,1,OTC
4993,15-02-2021 08:00,24 hrs.,pennystocks,ABML,18,18,0,18,3,3,0,1,OTC
4993,15-02-2021 08:00,24 hrs.,pennystocks,AFPW,6,6,0,6,1,1,0,1,OTC
4993,15-02-2021 08:00,24 hrs.,pennystocks,AITX,1085,86,999,-913,7,439,179,6,OTC
4993,15-02-2021 08:00,24 hrs.,pennystocks,ALPP,6,0,6,-6,1,1,0,1,OTC
4993,15-02-2021 08:00,24 hrs.,pennystocks,ASCK,33,0,33,-33,1,13,3,1,OTC
4993,15-02-2021 08:00,24 hrs.,pennystocks,ASTI,12,6,6,0,2,2,0,2,OTC
4993,15-02-2021 08:00,24 hrs.,pennystocks,AURI,24,24,0,24,2,4,8,2,OTC
4993,15-02-2021 08:00,24 hrs.,pennystocks,AZFL,6,6,0,6,1,1,0,1,OTC
4993,15-02-2021 08:00,24 hrs.,pennystocks,BANT,52,0,52,-52,1,11,26,1,OTC
4993,15-02-2021 08:00,24 hrs.,pennystocks,BBRW,6,6,0,6,1,1,0,1,OTC
4993,15-02-2021 08:00,24 hrs.,pennystocks,BFCH,6,6,0,6,1,1,0,1,OTC
4993,15-02-2021 08:00,24 hrs.,pennystocks,BIEL,9,0,9,-9,1,1,3,1,OTC
4993,15-02-2021 08:00,24 hrs.,pennystocks,BLPG,7,0,7,-7,1,1,1,1,OTC
4993,15-02-2021 08:00,24 hrs.,pennystocks,BLSP,6,6,0,6,1,1,0,1,OTC
4993,15-02-2021 08:00,24 hrs.,pennystocks,BMIX,7,0,7,-7,1,1,1,1,OTC
4993,15-02-2021 08:00,24 hrs.,pennystocks,BNGI,13,0,13,-13,2,2,1,2,OTC
4993,15-02-2021 08:00,24 hrs.,pennystocks,BOTY,6,0,6,-6,1,1,0,1,OTC
4993,15-02-2021 08:00,24 hrs.,pennystocks,BRAV,7,0,7,-7,1,1,1,1,OTC
4993,15-02-2021 08:00,24 hrs.,pennystocks,BRRN,858,0,858,-858,1,370,114,1,OTC
4993,15-02-2021 08:00,24 hrs.,pennystocks,BRZL,6,6,0,6,1,1,0,1,OTC
4993,15-02-2021 08:00,24 hrs.,pennystocks,BTSC,6,0,6,-6,1,1,0,1,OTC
4993,15-02-2021 08:00,24 hrs.,pennystocks,DPW,858,0,858,-858,1,370,114,1,AMEX
4993,15-02-2021 08:00,24 hrs.,pennystocks,GPL,16,16,0,16,1,5,2,1,AMEX
4993,15-02-2021 08:00,24 hrs.,pennystocks,GSV,7,7,0,7,1,1,1,1,AMEX
4993,15-02-2021 08:00,24 hrs.,pennystocks,UDHI,6,0,6,-6,1,1,0,1,OTC
4993,15-02-2021 08:00,24 hrs.,pennystocks,VGLS,7,0,7,-7,1,1,1,1,OTC
4993,15-02-2021 08:00,24 hrs.,pennystocks,VPER,7,0,7,-7,1,1,1,1,OTC
4993,15-02-2021 08:00,24 hrs.,pennystocks,WDLF,12,12,0,12,2,2,0,1,OTC
4993,15-02-2021 08:00,24 hrs.,pennystocks,XSPT,25,25,0,25,1,2,17,1,OTC
4993,15-02-2021 08:00,24 hrs.,pennystocks,ZHUD,6,6,0,6,1,1,0,1,OTC
4993,15-02-2021 08:00,24 hrs.,pennystocks,ABEPF,439,439,0,439,1,193,49,1,OTC
4993,15-02-2021 08:00,24 hrs.,pennystocks,AMYZF,52,52,0,52,4,12,12,2,OTC
4993,15-02-2021 08:00,24 hrs.,pennystocks,ARAFF,40,40,0,40,1,10,16,1,OTC
4993,15-02-2021 08:00,24 hrs.,pennystocks,ARBKF,1198,96,1102,-1006,7,454,262,7,OTC
4993,15-02-2021 08:00,24 hrs.,pennystocks,BEVVF,65,0,65,-65,1,21,19,1,OTC
4993,15-02-2021 08:00,24 hrs.,pennystocks,BKTPF,41,0,41,-41,1,12,13,1,OTC
4993,15-02-2021 08:00,24 hrs.,pennystocks,BLOZF,37,0,37,-37,1,7,19,1,OTC
4993,15-02-2021 08:00,24 hrs.,pennystocks,BVNNF,548,0,548,-548,1,234,76,1,OTC
4993,15-02-2021 08:00,24 hrs.,pennystocks,CHOOF,6,0,6,-6,1,1,0,1,OTC
4993,15-02-2021 08:00,24 hrs.,pennystocks,CYDVF,64,64,0,64,1,24,12,1,OTC
4993,15-02-2021 08:00,24 hrs.,pennystocks,DFMTF,42,0,42,-42,1,9,20,1,OTC
4993,15-02-2021 08:00,24 hrs.,pennystocks,DIGAF,7,7,0,7,1,1,1,1,OTC
4993,15-02-2021 08:00,24 hrs.,pennystocks,FLURF,50,50,0,50,4,9,16,2,OTC
4993,15-02-2021 08:00,24 hrs.,pennystocks,FUNFF,51,0,51,-51,1,20,7,1,OTC
4993,15-02-2021 08:00,24 hrs.,pennystocks,GKPRF,7,0,7,-7,1,1,1,1,OTC
4993,15-02-2021 08:00,24 hrs.,pennystocks,HITIF,952,0,952,-952,2,384,176,2,OTC
4993,15-02-2021 08:00,24 hrs.,pennystocks,HMSNF,27,0,27,-27,1,9,5,1,OTC
4993,15-02-2021 08:00,24 hrs.,pennystocks,ITMPF,37,0,37,-37,3,9,7,2,OTC
4993,15-02-2021 08:00,24 hrs.,pennystocks,LIACF,41,0,41,-41,1,12,13,1,OTC
4993,15-02-2021 08:00,24 hrs.,pennystocks,LKNCY,12,12,0,12,2,2,0,1,OTC
4993,15-02-2021 08:00,24 hrs.,pennystocks,MMEDF,858,0,858,-858,1,370,114,1,OTC
4993,15-02-2021 08:00,24 hrs.,pennystocks,MMNFF,6,6,0,6,1,1,0,1,OTC
4993,15-02-2021 08:00,24 hrs.,pennystocks,MNXXF,7,7,0,7,1,1,1,1,OTC
4993,15-02-2021 08:00,24 hrs.,pennystocks,MSNVF,6,6,0,6,1,1,0,1,OTC
4993,15-02-2021 08:00,24 hrs.,pennystocks,NMGRF,102,102,0,102,1,13,72,1,OTC
4993,15-02-2021 08:00,24 hrs.,pennystocks,NOSUF,858,0,858,-858,1,370,114,1,OTC
4993,15-02-2021 08:00,24 hrs.,pennystocks,NXTTF,8,8,0,8,1,1,2,1,OTC
4993,15-02-2021 08:00,24 hrs.,pennystocks,PEMIF,41,0,41,-41,1,12,13,1,OTC
4993,15-02-2021 08:00,24 hrs.,pennystocks,RAREF,42,0,42,-42,1,9,20,1,OTC
4993,15-02-2021 08:00,24 hrs.,pennystocks,SHLOQ,7,7,0,7,1,1,1,1,OTC
4993,15-02-2021 08:00,24 hrs.,pennystocks,SNNAF,41,0,41,-41,1,12,13,1,OTC
4993,15-02-2021 08:00,24 hrs.,pennystocks,SPMTF,41,0,41,-41,1,12,13,1,OTC
4993,15-02-2021 08:00,24 hrs.,pennystocks,SPRWF,45,45,0,45,3,14,5,2,OTC
4993,15-02-2021 08:00,24 hrs.,pennystocks,TAKOF,887,0,887,-887,2,372,135,2,OTC
4993,15-02-2021 08:00,24 hrs.,pennystocks,TRGGF,6,6,0,6,1,1,0,1,OTC
4993,15-02-2021 08:00,24 hrs.,pennystocks,HMPQ,13,0,13,-13,2,2,1,1,OTC
4993,15-02-2021 08:00,24 hrs.,pennystocks,HPMM,13,0,13,-13,2,2,1,2,OTC
4993,15-02-2021 08:00,24 hrs.,pennystocks,HQGE,6,6,0,6,1,1,0,1,OTC
4993,15-02-2021 08:00,24 hrs.,pennystocks,HWKE,6,0,6,-6,1,1,0,1,OTC
4993,15-02-2021 08:00,24 hrs.,pennystocks,HYSR,18,0,18,-18,1,3,8,1,OTC
4993,15-02-2021 08:00,24 hrs.,pennystocks,ICLD,13,13,0,13,2,2,1,1,OTC
4993,15-02-2021 08:00,24 hrs.,pennystocks,ICNM,25,25,0,25,1,2,17,1,OTC
4993,15-02-2021 08:00,24 hrs.,pennystocks,IJJP,48,0,48,-48,1,12,20,1,OTC
4993,15-02-2021 08:00,24 hrs.,pennystocks,INKW,12,12,0,12,2,2,0,2,OTC
4993,15-02-2021 08:00,24 hrs.,pennystocks,INND,199,7,192,-185,2,81,29,2,OTC
4993,15-02-2021 08:00,24 hrs.,pennystocks,IPIX,85,85,0,85,1,30,21,1,OTC
4993,15-02-2021 08:00,24 hrs.,pennystocks,IPSI,41,0,41,-41,1,13,11,1,OTC
4993,15-02-2021 08:00,24 hrs.,pennystocks,IQST,6,6,0,6,1,1,0,1,OTC
4993,15-02-2021 08:00,24 hrs.,pennystocks,KWBT,6,0,6,-6,1,1,0,1,OTC
4993,15-02-2021 08:00,24 hrs.,pennystocks,LBSR,7,0,7,-7,1,1,1,1,OTC
4993,15-02-2021 08:00,24 hrs.,pennystocks,LCLP,6,0,6,-6,1,1,0,1,OTC
4993,15-02-2021 08:00,24 hrs.,pennystocks,LGBS,48,0,48,-48,1,12,20,1,OTC
4993,15-02-2021 08:00,24 hrs.,pennystocks,LTNC,54,0,54,-54,2,13,20,2,OTC
4993,15-02-2021 08:00,24 hrs.,pennystocks,MAXD,6,0,6,-6,1,1,0,1,OTC
4993,15-02-2021 08:00,24 hrs.,pennystocks,MEDH,6,6,0,6,1,1,0,1,OTC
4993,15-02-2021 08:00,24 hrs.,pennystocks,NAK,7,7,0,7,1,1,1,1,AMEX
4993,15-02-2021 08:00,24 hrs.,pennystocks,NBY,858,0,858,-858,1,370,114,1,AMEX
4993,15-02-2021 08:00,24 hrs.,pennystocks,SYN,7,7,0,7,1,1,1,1,AMEX
4993,15-02-2021 08:00,24 hrs.,pennystocks,TRX,6,0,6,-6,1,1,0,1,AMEX
4993,15-02-2021 08:00,24 hrs.,pennystocks,ZOM,96,52,44,8,5,22,32,5,AMEX
4993,15-02-2021 08:00,24 hrs.,pennystocks,NSPR,40,40,0,40,1,12,12,1,AMEX
4993,15-02-2021 08:00,24 hrs.,pennystocks,ACB,7,7,0,7,1,1,1,1,NYSE
4993,15-02-2021 08:00,24 hrs.,pennystocks,ADC,6,6,0,6,1,1,0,1,NYSE
4993,15-02-2021 08:00,24 hrs.,pennystocks,ALB,41,0,41,-41,1,12,13,1,NYSE
4993,15-02-2021 08:00,24 hrs.,pennystocks,AMC,6,6,0,6,1,1,0,1,NYSE
4993,15-02-2021 08:00,24 hrs.,pennystocks,ASX,55,14,41,-27,8,9,5,3,NYSE
4993,15-02-2021 08:00,24 hrs.,pennystocks,BKD,40,0,40,-40,1,14,8,1,NYSE
4993,15-02-2021 08:00,24 hrs.,pennystocks,CBD,858,0,858,-858,1,370,114,1,NYSE
4993,15-02-2021 08:00,24 hrs.,pennystocks,CMC,131,0,131,-131,1,39,49,1,NYSE
4993,15-02-2021 08:00,24 hrs.,pennystocks,CVE,41,0,41,-41,1,12,13,1,NYSE
4993,15-02-2021 08:00,24 hrs.,pennystocks,FIT,6,6,0,6,1,1,0,1,NYSE
4993,15-02-2021 08:00,24 hrs.,pennystocks,FRA,64,64,0,64,1,24,12,1,NYSE
4993,15-02-2021 08:00,24 hrs.,pennystocks,GME,6,0,6,-6,1,1,0,1,NYSE
4993,15-02-2021 08:00,24 hrs.,pennystocks,HPQ,6,0,6,-6,1,1,0,1,NYSE
4993,15-02-2021 08:00,24 hrs.,pennystocks,IRS,366,0,366,-366,1,167,28,1,NYSE
4993,15-02-2021 08:00,24 hrs.,pennystocks,NAT,6,0,6,-6,1,1,0,1,NYSE
4993,15-02-2021 08:00,24 hrs.,pennystocks,NIO,7,7,0,7,1,1,1,1,NYSE
4993,15-02-2021 08:00,24 hrs.,pennystocks,PDT,6,6,0,6,1,1,0,1,NYSE
4993,15-02-2021 08:00,24 hrs.,pennystocks,PEG,721,0,721,-721,1,334,49,1,NYSE
4993,15-02-2021 08:00,24 hrs.,pennystocks,PSA,6,6,0,6,1,1,0,1,NYSE
4993,15-02-2021 08:00,24 hrs.,pennystocks,RSI,721,0,721,-721,1,334,49,1,NYSE
4993,15-02-2021 08:00,24 hrs.,pennystocks,SLB,41,0,41,-41,1,12,13,1,NYSE
4993,15-02-2021 08:00,24 hrs.,pennystocks,SOS,1083,80,1003,-923,5,429,205,4,NYSE
4993,15-02-2021 08:00,24 hrs.,pennystocks,TWI,6,6,0,6,1,1,0,1,NYSE
4993,15-02-2021 08:00,24 hrs.,pennystocks,ABBV,27,0,27,-27,1,6,11,1,NYSE
4993,15-02-2021 08:00,24 hrs.,pennystocks,ARGO,1026,0,1026,-1026,2,423,172,2,NYSE
4993,15-02-2021 08:00,24 hrs.,pennystocks,COLD,21,21,0,21,1,5,7,1,NYSE
4993,15-02-2021 08:00,24 hrs.,pennystocks,KOD,12,12,0,12,2,2,0,1,NASDAQ
4993,15-02-2021 08:00,24 hrs.,pennystocks,OLB,6,0,6,-6,1,1,0,1,NASDAQ
4993,15-02-2021 08:00,24 hrs.,pennystocks,SND,858,0,858,-858,1,370,114,1,NASDAQ
4993,15-02-2021 08:00,24 hrs.,pennystocks,TLC,41,0,41,-41,1,12,13,1,NASDAQ
4993,15-02-2021 08:00,24 hrs.,pennystocks,AAPL,721,0,721,-721,1,334,49,1,NASDAQ
4993,15-02-2021 08:00,24 hrs.,pennystocks,ABEO,858,0,858,-858,1,370,114,1,NASDAQ
4993,15-02-2021 08:00,24 hrs.,pennystocks,ACST,7,7,0,7,1,1,1,1,NASDAQ
4993,15-02-2021 08:00,24 hrs.,pennystocks,ADMP,7,0,7,-7,1,1,1,1,NASDAQ
4993,15-02-2021 08:00,24 hrs.,pennystocks,ADTX,27,0,27,-27,1,0,23,1,NASDAQ
4993,15-02-2021 08:00,24 hrs.,pennystocks,AGTC,112,88,24,64,2,46,12,2,NASDAQ
4993,15-02-2021 08:00,24 hrs.,pennystocks,APHA,7,7,0,7,1,1,1,1,NASDAQ
4993,15-02-2021 08:00,24 hrs.,pennystocks,ARTL,135,6,129,-123,2,49,29,2,NASDAQ
4993,15-02-2021 08:00,24 hrs.,pennystocks,ATOS,64,0,64,-64,2,7,42,2,NASDAQ
4993,15-02-2021 08:00,24 hrs.,pennystocks,BHTG,9,0,9,-9,1,0,5,1,NASDAQ
4993,15-02-2021 08:00,24 hrs.,pennystocks,BLRX,6,6,0,6,1,1,0,1,NASDAQ
4993,15-02-2021 08:00,24 hrs.,pennystocks,CFMS,13,0,13,-13,2,2,1,1,NASDAQ
4993,15-02-2021 08:00,24 hrs.,pennystocks,CGIX,6,6,0,6,1,1,0,1,NASDAQ
4993,15-02-2021 08:00,24 hrs.,pennystocks,CHEK,6,0,6,-6,1,1,0,1,NASDAQ
4993,15-02-2021 08:00,24 hrs.,pennystocks,CIDM,135,46,89,-43,2,49,29,2,NASDAQ
4993,15-02-2021 08:00,24 hrs.,pennystocks,CLBS,881,0,881,-881,2,375,123,2,NASDAQ
4993,15-02-2021 08:00,24 hrs.,pennystocks,CLSN,6,6,0,6,1,1,0,1,NASDAQ
4993,15-02-2021 08:00,24 hrs.,pennystocks,COCP,28,0,28,-28,1,8,8,1,NASDAQ
4993,15-02-2021 08:00,24 hrs.,pennystocks,CRBP,142,7,135,-128,3,50,30,3,NASDAQ
4993,15-02-2021 08:00,24 hrs.,pennystocks,CREX,129,0,129,-129,1,48,29,1,NASDAQ
4993,15-02-2021 08:00,24 hrs.,pennystocks,CTMX,858,0,858,-858,1,370,114,1,NASDAQ
4993,15-02-2021 08:00,24 hrs.,pennystocks,CTRM,156,20,136,-116,5,52,32,5,NASDAQ
4993,15-02-2021 08:00,24 hrs.,pennystocks,DFFN,858,0,858,-858,1,370,114,1,NASDAQ
4993,15-02-2021 08:00,24 hrs.,pennystocks,ECOR,35,0,35,-35,1,9,13,1,NASDAQ
4993,15-02-2021 08:00,24 hrs.,pennystocks,EDIT,422,254,168,86,3,174,62,3,NASDAQ
4993,15-02-2021 08:00,24 hrs.,pennystocks,FTFT,7,0,7,-7,1,1,1,1,NASDAQ
4993,15-02-2021 08:00,24 hrs.,pennystocks,GLBS,858,0,858,-858,1,370,114,1,NASDAQ
4993,15-02-2021 08:00,24 hrs.,pennystocks,DNN,6,0,6,-6,1,1,0,1,AMEX
4993,15-02-2021 08:00,24 hrs.,wallstreetbets,BLITF,7,0,7,-7,1,1,1,1,OTC
4993,15-02-2021 08:00,24 hrs.,wallstreetbets,BVNNF,6,6,0,6,1,1,0,1,OTC
4993,15-02-2021 08:00,24 hrs.,wallstreetbets,ENGMF,7,7,0,7,1,1,1,1,OTC
4993,15-02-2021 08:00,24 hrs.,wallstreetbets,FNNZF,7,7,0,7,1,1,1,1,OTC
4993,15-02-2021 08:00,24 hrs.,wallstreetbets,GPORQ,14,14,0,14,2,2,2,1,OTC
4993,15-02-2021 08:00,24 hrs.,wallstreetbets,GTBAF,13,13,0,13,2,2,1,1,OTC
4993,15-02-2021 08:00,24 hrs.,wallstreetbets,HTZGQ,7,0,7,-7,1,1,1,1,OTC
4993,15-02-2021 08:00,24 hrs.,wallstreetbets,JRVMF,6,6,0,6,1,1,0,1,OTC
4993,15-02-2021 08:00,24 hrs.,wallstreetbets,LKNCY,6,6,0,6,1,1,0,1,OTC
4993,15-02-2021 08:00,24 hrs.,wallstreetbets,MMEDF,7,7,0,7,1,1,1,1,OTC
4993,15-02-2021 08:00,24 hrs.,wallstreetbets,PLNHF,7,0,7,-7,1,1,1,1,OTC
4993,15-02-2021 08:00,24 hrs.,wallstreetbets,PROSY,6,6,0,6,1,1,0,1,OTC
4993,15-02-2021 08:00,24 hrs.,wallstreetbets,RLLCF,6,6,0,6,1,1,0,1,OTC
4993,15-02-2021 08:00,24 hrs.,wallstreetbets,RWBYF,7,0,7,-7,1,1,1,1,OTC
4993,15-02-2021 08:00,24 hrs.,wallstreetbets,RYCEY,21,21,0,21,3,3,3,2,OTC
4993,15-02-2021 08:00,24 hrs.,wallstreetbets,SPLIF,6,6,0,6,1,1,0,1,OTC
4993,15-02-2021 08:00,24 hrs.,wallstreetbets,TSCRF,27,0,27,-27,4,4,3,2,OTC
4993,15-02-2021 08:00,24 hrs.,pennystocks,SOLO,7,7,0,7,1,1,1,1,NASDAQ
4993,15-02-2021 08:00,24 hrs.,pennystocks,TECH,6,6,0,6,1,1,0,1,NASDAQ
4993,15-02-2021 08:00,24 hrs.,pennystocks,TNXP,191,102,89,13,2,67,49,2,NASDAQ
4993,15-02-2021 08:00,24 hrs.,pennystocks,TRIB,6,6,0,6,1,1,0,1,NASDAQ
4993,15-02-2021 08:00,24 hrs.,pennystocks,TXMD,7,7,0,7,1,1,1,1,NASDAQ
4993,15-02-2021 08:00,24 hrs.,pennystocks,WRAP,10,10,0,10,1,1,4,1,NASDAQ
4993,15-02-2021 08:00,24 hrs.,wallstreetbets,ABMC,7,7,0,7,1,1,1,1,OTC
4993,15-02-2021 08:00,24 hrs.,wallstreetbets,ABVG,7,7,0,7,1,1,1,1,OTC
4993,15-02-2021 08:00,24 hrs.,wallstreetbets,AITX,20,20,0,20,3,3,2,2,OTC
4993,15-02-2021 08:00,24 hrs.,wallstreetbets,ALKM,14,0,14,-14,2,2,2,1,OTC
4993,15-02-2021 08:00,24 hrs.,wallstreetbets,ANTI,7,7,0,7,1,1,1,1,OTC
4993,15-02-2021 08:00,24 hrs.,wallstreetbets,ASTI,19,19,0,19,1,0,15,1,OTC
4993,15-02-2021 08:00,24 hrs.,wallstreetbets,BBRW,13,6,7,-1,2,2,1,2,OTC
4993,15-02-2021 08:00,24 hrs.,wallstreetbets,BEES,143,143,0,143,1,50,39,1,OTC
4993,15-02-2021 08:00,24 hrs.,wallstreetbets,BLSP,7,0,7,-7,1,1,1,1,OTC
4993,15-02-2021 08:00,24 hrs.,wallstreetbets,BNGI,7,0,7,-7,1,1,1,1,OTC
4993,15-02-2021 08:00,24 hrs.,wallstreetbets,BTZI,20,14,6,8,3,3,2,2,OTC
4993,15-02-2021 08:00,24 hrs.,wallstreetbets,CATV,7,0,7,-7,1,1,1,1,OTC
4993,15-02-2021 08:00,24 hrs.,wallstreetbets,COWI,7,0,7,-7,1,1,1,1,OTC
4993,15-02-2021 08:00,24 hrs.,wallstreetbets,CYDY,7,0,7,-7,1,1,1,1,OTC
4993,15-02-2021 08:00,24 hrs.,wallstreetbets,DKMR,6,0,6,-6,1,1,0,1,OTC
4993,15-02-2021 08:00,24 hrs.,wallstreetbets,DPLS,7,0,7,-7,1,1,1,1,OTC
4993,15-02-2021 08:00,24 hrs.,wallstreetbets,DTSL,7,7,0,7,1,1,1,1,OTC
4993,15-02-2021 08:00,24 hrs.,wallstreetbets,EFIR,6,0,6,-6,1,1,0,1,OTC
4993,15-02-2021 08:00,24 hrs.,wallstreetbets,ETCC,7,7,0,7,1,1,1,1,OTC
4993,15-02-2021 08:00,24 hrs.,wallstreetbets,FLEW,3331,0,3331,-3331,1,1228,871,1,OTC
4993,15-02-2021 08:00,24 hrs.,wallstreetbets,GAHC,7,0,7,-7,1,1,1,1,OTC
4993,15-02-2021 08:00,24 hrs.,pennystocks,IBKR,29,29,0,29,1,0,25,1,NASDAQ
4993,15-02-2021 08:00,24 hrs.,pennystocks,JFIN,129,0,129,-129,1,48,29,1,NASDAQ
4993,15-02-2021 08:00,24 hrs.,pennystocks,KTRA,35,0,35,-35,1,9,13,1,NASDAQ
4993,15-02-2021 08:00,24 hrs.,pennystocks,LAZY,9,0,9,-9,1,2,1,1,NASDAQ
4993,15-02-2021 08:00,24 hrs.,pennystocks,MARA,80,80,0,80,1,16,44,1,NASDAQ
4993,15-02-2021 08:00,24 hrs.,pennystocks,NAKD,865,7,858,-851,2,371,115,2,NASDAQ
4993,15-02-2021 08:00,24 hrs.,pennystocks,NOVN,12,0,12,-12,2,2,0,1,NASDAQ
4993,15-02-2021 08:00,24 hrs.,pennystocks,NVAX,27,0,27,-27,1,0,23,1,NASDAQ
4993,15-02-2021 08:00,24 hrs.,pennystocks,NVCN,28,0,28,-28,1,8,8,1,NASDAQ
4993,15-02-2021 08:00,24 hrs.,pennystocks,PLAY,6,0,6,-6,1,1,0,1,NASDAQ
4993,15-02-2021 08:00,24 hrs.,pennystocks,PLUS,24,24,0,24,1,5,10,1,NASDAQ
4993,15-02-2021 08:00,24 hrs.,pennystocks,PULM,6,0,6,-6,1,1,0,1,NASDAQ
4993,15-02-2021 08:00,24 hrs.,pennystocks,RIOT,80,80,0,80,1,16,44,1,NASDAQ
4993,15-02-2021 08:00,24 hrs.,pennystocks,RNWK,6,6,0,6,1,1,0,1,NASDAQ
4993,15-02-2021 08:00,24 hrs.,pennystocks,SELF,6,0,6,-6,1,1,0,1,NASDAQ
4993,15-02-2021 08:00,24 hrs.,pennystocks,SESN,35,0,35,-35,1,9,13,1,NASDAQ
4993,15-02-2021 08:00,24 hrs.,pennystocks,SHIP,141,0,141,-141,3,50,29,2,NASDAQ
4993,15-02-2021 08:00,24 hrs.,pennystocks,SNDL,19,13,6,7,3,3,1,3,NASDAQ
4993,15-02-2021 08:00,24 hrs.,pennystocks,SNGX,77,77,0,77,3,25,15,2,NASDAQ
4993,15-02-2021 08:00,24 hrs.,pennystocks,GTE,69,0,69,-69,1,21,23,1,AMEX
4993,15-02-2021 08:00,24 hrs.,wallstreetbets,BLK,113,113,0,113,1,36,37,1,NYSE
4993,15-02-2021 08:00,24 hrs.,wallstreetbets,BMA,49,49,0,49,2,7,27,2,NYSE
4993,15-02-2021 08:00,24 hrs.,wallstreetbets,BMY,6,0,6,-6,1,1,0,1,NYSE
4993,15-02-2021 08:00,24 hrs.,wallstreetbets,BTT,15,0,15,-15,2,2,3,2,NYSE
4993,15-02-2021 08:00,24 hrs.,wallstreetbets,CCI,113,113,0,113,1,36,37,1,NYSE
4993,15-02-2021 08:00,24 hrs.,wallstreetbets,CCL,6,6,0,6,1,1,0,1,NYSE
4993,15-02-2021 08:00,24 hrs.,wallstreetbets,CHS,7,7,0,7,1,1,1,1,NYSE
4993,15-02-2021 08:00,24 hrs.,wallstreetbets,CLF,7,7,0,7,1,1,1,1,NYSE
4993,15-02-2021 08:00,24 hrs.,wallstreetbets,CNS,9,9,0,9,1,2,1,1,NYSE
4993,15-02-2021 08:00,24 hrs.,wallstreetbets,CRY,8,0,8,-8,1,1,2,1,NYSE
4993,15-02-2021 08:00,24 hrs.,wallstreetbets,CTK,6,6,0,6,1,1,0,1,NYSE
4993,15-02-2021 08:00,24 hrs.,wallstreetbets,DAL,232,232,0,232,1,101,26,1,NYSE
4993,15-02-2021 08:00,24 hrs.,wallstreetbets,DAO,7,7,0,7,1,1,1,1,NYSE
4993,15-02-2021 08:00,24 hrs.,wallstreetbets,DEA,6,6,0,6,1,1,0,1,NYSE
4993,15-02-2021 08:00,24 hrs.,wallstreetbets,DMS,14,0,14,-14,2,2,2,2,NYSE
4993,15-02-2021 08:00,24 hrs.,wallstreetbets,EAT,7,0,7,-7,1,1,1,1,NYSE
4993,15-02-2021 08:00,24 hrs.,wallstreetbets,ETN,12,12,0,12,2,2,0,2,NYSE
4993,15-02-2021 08:00,24 hrs.,wallstreetbets,EXP,57,57,0,57,2,13,23,2,NYSE
4993,15-02-2021 08:00,24 hrs.,wallstreetbets,FCF,89,0,89,-89,1,21,43,1,NYSE
4993,15-02-2021 08:00,24 hrs.,wallstreetbets,FDX,127,120,7,113,3,38,39,3,NYSE
4993,15-02-2021 08:00,24 hrs.,wallstreetbets,FLT,7,7,0,7,1,1,1,1,NYSE
4993,15-02-2021 08:00,24 hrs.,wallstreetbets,FSR,1011,0,1011,-1011,4,427,141,4,NYSE
4993,15-02-2021 08:00,24 hrs.,wallstreetbets,GAXY,7,0,7,-7,1,1,1,1,OTC
4993,15-02-2021 08:00,24 hrs.,wallstreetbets,GTBP,8,8,0,8,1,1,2,1,OTC
4993,15-02-2021 08:00,24 hrs.,wallstreetbets,GTLL,14,0,14,-14,2,2,2,1,OTC
4993,15-02-2021 08:00,24 hrs.,wallstreetbets,HCMC,129,49,80,-31,19,18,17,17,OTC
4993,15-02-2021 08:00,24 hrs.,wallstreetbets,HGLC,14,14,0,14,2,2,2,1,OTC
4993,15-02-2021 08:00,24 hrs.,wallstreetbets,HQGE,6,6,0,6,1,1,0,1,OTC
4993,15-02-2021 08:00,24 hrs.,wallstreetbets,HRBR,6,6,0,6,1,1,0,1,OTC
4993,15-02-2021 08:00,24 hrs.,wallstreetbets,HWKE,7,0,7,-7,1,1,1,1,OTC
4993,15-02-2021 08:00,24 hrs.,wallstreetbets,HYSR,13,0,13,-13,2,2,1,2,OTC
4993,15-02-2021 08:00,24 hrs.,wallstreetbets,INCT,6,0,6,-6,1,1,0,1,OTC
4993,15-02-2021 08:00,24 hrs.,wallstreetbets,INKW,21,21,0,21,3,3,3,3,OTC
4993,15-02-2021 08:00,24 hrs.,wallstreetbets,INQD,7,0,7,-7,1,1,1,1,OTC
4993,15-02-2021 08:00,24 hrs.,wallstreetbets,IPLY,13,13,0,13,2,2,1,1,OTC
4993,15-02-2021 08:00,24 hrs.,wallstreetbets,MAXD,19,12,7,5,3,3,1,2,OTC
4993,15-02-2021 08:00,24 hrs.,wallstreetbets,MCOA,7,0,7,-7,1,1,1,1,OTC
4993,15-02-2021 08:00,24 hrs.,wallstreetbets,MINE,7,7,0,7,1,1,1,1,OTC
4993,15-02-2021 08:00,24 hrs.,wallstreetbets,MJLB,7,0,7,-7,1,1,1,1,OTC
4993,15-02-2021 08:00,24 hrs.,wallstreetbets,MKTY,6,6,0,6,1,1,0,1,OTC
4993,15-02-2021 08:00,24 hrs.,wallstreetbets,MOST,170,170,0,170,1,66,34,1,OTC
4993,15-02-2021 08:00,24 hrs.,wallstreetbets,MRMD,7,0,7,-7,1,1,1,1,OTC
4993,15-02-2021 08:00,24 hrs.,wallstreetbets,NMTC,65,65,0,65,1,19,23,1,OTC
4993,15-02-2021 08:00,24 hrs.,wallstreetbets,OZSC,7,0,7,-7,1,1,1,1,OTC
4993,15-02-2021 08:00,24 hrs.,wallstreetbets,PHOT,6,6,0,6,1,1,0,1,OTC
4993,15-02-2021 08:00,24 hrs.,wallstreetbets,PNAT,7,7,0,7,1,1,1,1,OTC
4993,15-02-2021 08:00,24 hrs.,wallstreetbets,RBNW,13,0,13,-13,2,2,1,2,OTC
4993,15-02-2021 08:00,24 hrs.,wallstreetbets,RTON,6,6,0,6,1,1,0,1,OTC
4993,15-02-2021 08:00,24 hrs.,wallstreetbets,SGMD,20,6,14,-8,3,3,2,2,OTC
4993,15-02-2021 08:00,24 hrs.,wallstreetbets,SING,14,14,0,14,2,2,2,2,OTC
4993,15-02-2021 08:00,24 hrs.,wallstreetbets,SORT,143,143,0,143,1,50,39,1,OTC
4993,15-02-2021 08:00,24 hrs.,wallstreetbets,SPIN,80,80,0,80,1,0,76,1,OTC
4993,15-02-2021 08:00,24 hrs.,wallstreetbets,TIDE,7,7,0,7,1,1,1,1,OTC
4993,15-02-2021 08:00,24 hrs.,wallstreetbets,TSNP,7,7,0,7,1,1,1,1,OTC
4993,15-02-2021 08:00,24 hrs.,wallstreetbets,UAPC,6,6,0,6,1,1,0,1,OTC
4993,15-02-2021 08:00,24 hrs.,wallstreetbets,UDHI,7,0,7,-7,1,1,1,1,OTC
4993,15-02-2021 08:00,24 hrs.,wallstreetbets,USPS,80,80,0,80,1,0,76,1,OTC
4993,15-02-2021 08:00,24 hrs.,wallstreetbets,VPER,7,0,7,-7,1,1,1,1,OTC
4993,15-02-2021 08:00,24 hrs.,wallstreetbets,WDLF,7,0,7,-7,1,1,1,1,OTC
4993,15-02-2021 08:00,24 hrs.,wallstreetbets,WHEN,6,0,6,-6,1,1,0,1,OTC
4993,15-02-2021 08:00,24 hrs.,wallstreetbets,WNDW,6,6,0,6,1,1,0,1,OTC
4993,15-02-2021 08:00,24 hrs.,wallstreetbets,ALBKY,7,7,0,7,1,1,1,1,OTC
4993,15-02-2021 08:00,24 hrs.,wallstreetbets,AMYZF,6,0,6,-6,1,1,0,1,OTC
4993,15-02-2021 08:00,24 hrs.,wallstreetbets,ARBKF,14,14,0,14,2,2,2,2,OTC
4993,15-02-2021 08:00,24 hrs.,wallstreetbets,SOS,26,19,7,12,4,4,2,4,NYSE
4993,15-02-2021 08:00,24 hrs.,wallstreetbets,GIS,73,73,0,73,2,13,39,2,NYSE
4993,15-02-2021 08:00,24 hrs.,wallstreetbets,GLW,31,0,31,-31,1,1,25,1,NYSE
4993,15-02-2021 08:00,24 hrs.,wallstreetbets,GME,16706,5276,11430,-6154,182,6268,3442,143,NYSE
4993,15-02-2021 08:00,24 hrs.,wallstreetbets,GMS,7,0,7,-7,1,1,1,1,NYSE
4993,15-02-2021 08:00,24 hrs.,wallstreetbets,GNW,7,7,0,7,1,1,1,1,NYSE
4993,15-02-2021 08:00,24 hrs.,wallstreetbets,ICE,169,80,89,-9,2,21,119,2,NYSE
4993,15-02-2021 08:00,24 hrs.,wallstreetbets,IGT,7,7,0,7,1,1,1,1,NYSE
4993,15-02-2021 08:00,24 hrs.,wallstreetbets,IVR,127,127,0,127,1,58,7,1,NYSE
4993,15-02-2021 08:00,24 hrs.,wallstreetbets,JNJ,12,12,0,12,2,2,0,2,NYSE
4993,15-02-2021 08:00,24 hrs.,wallstreetbets,JPM,113,113,0,113,1,36,37,1,NYSE
4993,15-02-2021 08:00,24 hrs.,wallstreetbets,KEY,6,0,6,-6,1,1,0,1,NYSE
4993,15-02-2021 08:00,24 hrs.,wallstreetbets,KSU,113,113,0,113,1,36,37,1,NYSE
4993,15-02-2021 08:00,24 hrs.,wallstreetbets,LMT,113,113,0,113,1,36,37,1,NYSE
4993,15-02-2021 08:00,24 hrs.,wallstreetbets,LOW,49,49,0,49,2,7,27,2,NYSE
4993,15-02-2021 08:00,24 hrs.,wallstreetbets,LTC,7,7,0,7,1,1,1,1,NYSE
4993,15-02-2021 08:00,24 hrs.,wallstreetbets,LVS,6,6,0,6,1,1,0,1,NYSE
4993,15-02-2021 08:00,24 hrs.,wallstreetbets,MAC,18,0,18,-18,3,3,0,3,NYSE
4993,15-02-2021 08:00,24 hrs.,wallstreetbets,MGM,7,7,0,7,1,1,1,1,NYSE
4993,15-02-2021 08:00,24 hrs.,wallstreetbets,MMC,6,0,6,-6,1,1,0,1,NYSE
4993,15-02-2021 08:00,24 hrs.,wallstreetbets,MRO,7,0,7,-7,1,1,1,1,NYSE
4993,15-02-2021 08:00,24 hrs.,wallstreetbets,MSI,113,113,0,113,1,36,37,1,NYSE
4993,15-02-2021 08:00,24 hrs.,wallstreetbets,MTG,57,57,0,57,2,13,23,2,NYSE
4993,15-02-2021 08:00,24 hrs.,wallstreetbets,NAV,6,0,6,-6,1,1,0,1,NYSE
4993,15-02-2021 08:00,24 hrs.,wallstreetbets,NET,143,143,0,143,1,50,39,1,NYSE
4993,15-02-2021 08:00,24 hrs.,wallstreetbets,NIO,1375,381,994,-613,5,513,329,4,NYSE
4993,15-02-2021 08:00,24 hrs.,wallstreetbets,NOC,113,113,0,113,1,36,37,1,NYSE
4993,15-02-2021 08:00,24 hrs.,wallstreetbets,NOK,256,210,46,164,14,79,42,12,NYSE
4993,15-02-2021 08:00,24 hrs.,wallstreetbets,NOV,6,6,0,6,1,1,0,1,NYSE
4993,15-02-2021 08:00,24 hrs.,wallstreetbets,PAG,113,113,0,113,1,36,37,1,NYSE
4993,15-02-2021 08:00,24 hrs.,wallstreetbets,PFE,7,0,7,-7,1,1,1,1,NYSE
4993,15-02-2021 08:00,24 hrs.,wallstreetbets,PSA,42,0,42,-42,2,12,10,2,NYSE
4993,15-02-2021 08:00,24 hrs.,wallstreetbets,PSX,170,170,0,170,1,66,34,1,NYSE
4993,15-02-2021 08:00,24 hrs.,wallstreetbets,RGR,7,7,0,7,1,1,1,1,NYSE
4993,15-02-2021 08:00,24 hrs.,wallstreetbets,RKT,42,13,29,-16,6,7,4,5,NYSE
4993,15-02-2021 08:00,24 hrs.,wallstreetbets,RMO,7,0,7,-7,1,1,1,1,NYSE
4993,15-02-2021 08:00,24 hrs.,wallstreetbets,TTTSF,6,6,0,6,1,1,0,1,OTC
4993,15-02-2021 08:00,24 hrs.,wallstreetbets,ZBISF,7,7,0,7,1,1,1,1,OTC
4993,15-02-2021 08:00,24 hrs.,wallstreetbets,AIM,8,0,8,-8,1,1,2,1,AMEX
4993,15-02-2021 08:00,24 hrs.,wallstreetbets,BTG,6,0,6,-6,1,1,0,1,AMEX
4993,15-02-2021 08:00,24 hrs.,wallstreetbets,DNN,13,7,6,1,2,2,1,2,AMEX
4993,15-02-2021 08:00,24 hrs.,wallstreetbets,DPW,8,8,0,8,1,1,2,1,AMEX
4993,15-02-2021 08:00,24 hrs.,wallstreetbets,GDP,1177,0,1177,-1177,4,353,455,4,AMEX
4993,15-02-2021 08:00,24 hrs.,wallstreetbets,GTE,14,7,7,0,2,2,2,2,AMEX
4993,15-02-2021 08:00,24 hrs.,wallstreetbets,MXC,8,0,8,-8,1,1,2,1,AMEX
4993,15-02-2021 08:00,24 hrs.,wallstreetbets,NAK,6,6,0,6,1,1,0,1,AMEX
4993,15-02-2021 08:00,24 hrs.,wallstreetbets,TRX,7,7,0,7,1,1,1,1,AMEX
4993,15-02-2021 08:00,24 hrs.,wallstreetbets,UEC,7,0,7,-7,1,1,1,1,AMEX
4993,15-02-2021 08:00,24 hrs.,wallstreetbets,ZOM,68,40,28,12,10,10,8,10,AMEX
4993,15-02-2021 08:00,24 hrs.,wallstreetbets,GOED,14,0,14,-14,2,2,2,1,AMEX
4993,15-02-2021 08:00,24 hrs.,wallstreetbets,GSAT,21,7,14,-7,3,3,3,3,AMEX
4993,15-02-2021 08:00,24 hrs.,wallstreetbets,TRXC,7,7,0,7,1,1,1,1,AMEX
4993,15-02-2021 08:00,24 hrs.,wallstreetbets,UAVS,7,7,0,7,1,1,1,1,AMEX
4993,15-02-2021 08:00,24 hrs.,wallstreetbets,ACB,20,0,20,-20,3,3,2,3,NYSE
4993,15-02-2021 08:00,24 hrs.,wallstreetbets,ACH,34,34,0,34,1,9,12,1,NYSE
4993,15-02-2021 08:00,24 hrs.,wallstreetbets,AIV,7,7,0,7,1,1,1,1,NYSE
4993,15-02-2021 08:00,24 hrs.,wallstreetbets,AJX,7,7,0,7,1,1,1,1,NYSE
4993,15-02-2021 08:00,24 hrs.,wallstreetbets,AMC,2772,2414,358,2056,91,988,432,74,NYSE
4993,15-02-2021 08:00,24 hrs.,wallstreetbets,AMT,113,113,0,113,1,36,37,1,NYSE
4993,15-02-2021 08:00,24 hrs.,wallstreetbets,ASX,21,21,0,21,3,3,3,3,NYSE
4993,15-02-2021 08:00,24 hrs.,wallstreetbets,ATH,224,6,218,-212,3,47,118,3,NYSE
4993,15-02-2021 08:00,24 hrs.,wallstreetbets,BAM,113,113,0,113,1,36,37,1,NYSE
4993,15-02-2021 08:00,24 hrs.,wallstreetbets,BCH,7,0,7,-7,1,1,1,1,NYSE
4993,15-02-2021 08:00,24 hrs.,wallstreetbets,BIO,6,0,6,-6,1,1,0,1,NYSE
4993,15-02-2021 08:00,24 hrs.,wallstreetbets,UNP,113,113,0,113,1,36,37,1,NYSE
4993,15-02-2021 08:00,24 hrs.,wallstreetbets,UPS,657,113,544,-431,2,201,247,2,NYSE
4993,15-02-2021 08:00,24 hrs.,wallstreetbets,VET,7,7,0,7,1,1,1,1,NYSE
4993,15-02-2021 08:00,24 hrs.,wallstreetbets,VHC,7,7,0,7,1,1,1,1,NYSE
4993,15-02-2021 08:00,24 hrs.,wallstreetbets,VRT,43,0,43,-43,3,13,5,1,NYSE
4993,15-02-2021 08:00,24 hrs.,wallstreetbets,WBS,7,0,7,-7,1,1,1,1,NYSE
4993,15-02-2021 08:00,24 hrs.,wallstreetbets,WMT,7,0,7,-7,1,1,1,1,NYSE
4993,15-02-2021 08:00,24 hrs.,wallstreetbets,WWE,27,27,0,27,4,4,3,2,NYSE
4993,15-02-2021 08:00,24 hrs.,wallstreetbets,XOM,628,628,0,628,1,191,242,1,NYSE
4993,15-02-2021 08:00,24 hrs.,wallstreetbets,ARGO,7,0,7,-7,1,1,1,1,NYSE
4993,15-02-2021 08:00,24 hrs.,wallstreetbets,BABA,987,0,987,-987,1,423,137,1,NYSE
4993,15-02-2021 08:00,24 hrs.,wallstreetbets,BALY,103,103,0,103,1,36,27,1,NYSE
4993,15-02-2021 08:00,24 hrs.,wallstreetbets,CCIV,33,7,26,-19,5,5,3,5,NYSE
4993,15-02-2021 08:00,24 hrs.,wallstreetbets,CLII,8,8,0,8,1,1,2,1,NYSE
4993,15-02-2021 08:00,24 hrs.,wallstreetbets,COLD,7,7,0,7,1,1,1,1,NYSE
4993,15-02-2021 08:00,24 hrs.,wallstreetbets,COTY,405,399,6,393,3,92,209,3,NYSE
4993,15-02-2021 08:00,24 hrs.,wallstreetbets,DASH,13,0,13,-13,2,2,1,1,NYSE
4993,15-02-2021 08:00,24 hrs.,wallstreetbets,DECK,6,6,0,6,1,1,0,1,NYSE
4993,15-02-2021 08:00,24 hrs.,wallstreetbets,FUSE,7,0,7,-7,1,1,1,1,NYSE
4993,15-02-2021 08:00,24 hrs.,wallstreetbets,FVRR,7,0,7,-7,1,0,3,1,NYSE
4993,15-02-2021 08:00,24 hrs.,wallstreetbets,GLOB,7,7,0,7,1,1,1,1,NYSE
4993,15-02-2021 08:00,24 hrs.,wallstreetbets,GNRC,90,0,90,-90,2,23,36,2,NYSE
4993,15-02-2021 08:00,24 hrs.,wallstreetbets,HEXO,13,7,6,1,2,2,1,2,NYSE
4993,15-02-2021 08:00,24 hrs.,wallstreetbets,HYLN,34,21,13,8,5,5,4,4,NYSE
4993,15-02-2021 08:00,24 hrs.,wallstreetbets,IPOE,29,0,29,-29,1,0,25,1,NYSE
4993,15-02-2021 08:00,24 hrs.,wallstreetbets,LDOS,113,113,0,113,1,36,37,1,NYSE
4993,15-02-2021 08:00,24 hrs.,wallstreetbets,LUMN,6,0,6,-6,1,1,0,1,NYSE
4993,15-02-2021 08:00,24 hrs.,wallstreetbets,MITT,7,0,7,-7,1,1,1,1,NYSE
4993,15-02-2021 08:00,24 hrs.,wallstreetbets,PLTR,3360,267,3093,-2826,16,1363,570,12,NYSE
4993,15-02-2021 08:00,24 hrs.,wallstreetbets,PSTH,18,6,12,-6,3,3,0,3,NYSE
4993,15-02-2021 08:00,24 hrs.,wallstreetbets,RCUS,7,7,0,7,1,1,1,1,NYSE
4993,15-02-2021 08:00,24 hrs.,wallstreetbets,SHOP,7,0,7,-7,1,1,1,1,NYSE
4993,15-02-2021 08:00,24 hrs.,wallstreetbets,SLCA,6,6,0,6,1,1,0,1,NYSE
4993,15-02-2021 08:00,24 hrs.,wallstreetbets,SNPR,13,13,0,13,2,2,1,1,NYSE
4993,15-02-2021 08:00,24 hrs.,wallstreetbets,SPCE,4106,0,4106,-4106,4,1925,240,3,NYSE
4993,15-02-2021 08:00,24 hrs.,wallstreetbets,STPK,14,14,0,14,2,2,2,2,NYSE
4993,15-02-2021 08:00,24 hrs.,wallstreetbets,UBER,113,113,0,113,1,36,37,1,NYSE
4993,15-02-2021 08:00,24 hrs.,wallstreetbets,XPEV,1593,606,987,-381,4,612,353,3,NYSE
4993,15-02-2021 08:00,24 hrs.,wallstreetbets,AAL,6,0,6,-6,1,1,0,1,NASDAQ
4993,15-02-2021 08:00,24 hrs.,wallstreetbets,AMD,4147,239,3908,-3669,4,1745,641,4,NASDAQ
4993,15-02-2021 08:00,24 hrs.,wallstreetbets,AQB,6,0,6,-6,1,1,0,1,NASDAQ
4993,15-02-2021 08:00,24 hrs.,wallstreetbets,BBC,7,7,0,7,1,1,1,1,NASDAQ
4993,15-02-2021 08:00,24 hrs.,wallstreetbets,BUG,6,6,0,6,1,1,0,1,NASDAQ
4993,15-02-2021 08:00,24 hrs.,wallstreetbets,CFO,7,7,0,7,1,1,1,1,NASDAQ
4993,15-02-2021 08:00,24 hrs.,wallstreetbets,FUV,6,6,0,6,1,1,0,1,NASDAQ
4993,15-02-2021 08:00,24 hrs.,wallstreetbets,GSM,14,7,7,0,2,2,2,2,NASDAQ
4993,15-02-2021 08:00,24 hrs.,wallstreetbets,HAS,21,7,14,-7,3,3,3,3,NASDAQ
4993,15-02-2021 08:00,24 hrs.,wallstreetbets,KIN,7,7,0,7,1,1,1,1,NASDAQ
4993,15-02-2021 08:00,24 hrs.,wallstreetbets,NEO,21,21,0,21,3,3,3,1,NASDAQ
4993,15-02-2021 08:00,24 hrs.,wallstreetbets,OPK,7,0,7,-7,1,1,1,1,NASDAQ
4993,15-02-2021 08:00,24 hrs.,wallstreetbets,PDD,6,6,0,6,1,1,0,1,NASDAQ
4993,15-02-2021 08:00,24 hrs.,wallstreetbets,QQQ,179,0,179,-179,1,38,99,1,NASDAQ
4993,15-02-2021 08:00,24 hrs.,wallstreetbets,QTT,7,0,7,-7,1,1,1,1,NASDAQ
4993,15-02-2021 08:00,24 hrs.,wallstreetbets,RXT,7,0,7,-7,1,1,1,1,NASDAQ
4993,15-02-2021 08:00,24 hrs.,wallstreetbets,TGA,7,0,7,-7,1,1,1,1,NASDAQ
4993,15-02-2021 08:00,24 hrs.,wallstreetbets,TXN,7,7,0,7,1,1,1,1,NASDAQ
4993,15-02-2021 08:00,24 hrs.,wallstreetbets,UAL,238,238,0,238,2,102,26,2,NASDAQ
4993,15-02-2021 08:00,24 hrs.,wallstreetbets,VTC,6,0,6,-6,1,1,0,1,NASDAQ
4993,15-02-2021 08:00,24 hrs.,wallstreetbets,WBA,7,7,0,7,1,1,1,1,NASDAQ
4993,15-02-2021 08:00,24 hrs.,wallstreetbets,WNW,7,0,7,-7,1,1,1,1,NASDAQ
4993,15-02-2021 08:00,24 hrs.,wallstreetbets,RSI,780,0,780,-780,2,248,276,2,NYSE
4993,15-02-2021 08:00,24 hrs.,wallstreetbets,RTX,129,0,129,-129,1,25,75,1,NYSE
4993,15-02-2021 08:00,24 hrs.,wallstreetbets,SBE,21,0,21,-21,1,6,5,1,NYSE
4993,15-02-2021 08:00,24 hrs.,wallstreetbets,SKT,12,0,12,-12,2,2,0,2,NYSE
4993,15-02-2021 08:00,24 hrs.,wallstreetbets,NTEC,7,0,7,-7,1,1,1,1,NASDAQ
4993,15-02-2021 08:00,24 hrs.,wallstreetbets,NTRS,113,113,0,113,1,36,37,1,NASDAQ
4993,15-02-2021 08:00,24 hrs.,wallstreetbets,OCGN,36,21,15,6,5,5,6,5,NASDAQ
4993,15-02-2021 08:00,24 hrs.,wallstreetbets,ONTX,7,0,7,-7,1,1,1,1,NASDAQ
4993,15-02-2021 08:00,24 hrs.,wallstreetbets,OSTK,4560,6,4554,-4548,2,1988,576,2,NASDAQ
4993,15-02-2021 08:00,24 hrs.,wallstreetbets,PLAY,7,7,0,7,1,1,1,1,NASDAQ
4993,15-02-2021 08:00,24 hrs.,wallstreetbets,PRTA,6,0,6,-6,1,1,0,1,NASDAQ
4993,15-02-2021 08:00,24 hrs.,wallstreetbets,PRTS,7,0,7,-7,1,1,1,1,NASDAQ
4993,15-02-2021 08:00,24 hrs.,wallstreetbets,PTON,232,232,0,232,1,101,26,1,NASDAQ
4993,15-02-2021 08:00,24 hrs.,wallstreetbets,PYPL,113,113,0,113,1,36,37,1,NASDAQ
4993,15-02-2021 08:00,24 hrs.,wallstreetbets,QLGN,6,6,0,6,1,1,0,1,NASDAQ
4993,15-02-2021 08:00,24 hrs.,wallstreetbets,REAL,157,150,7,143,3,52,41,3,NASDAQ
4993,15-02-2021 08:00,24 hrs.,wallstreetbets,RIOT,14,7,7,0,2,2,2,2,NASDAQ
4993,15-02-2021 08:00,24 hrs.,wallstreetbets,RNWK,21,21,0,21,3,3,3,1,NASDAQ
4993,15-02-2021 08:00,24 hrs.,wallstreetbets,SBBP,6,6,0,6,1,1,0,1,NASDAQ
4993,15-02-2021 08:00,24 hrs.,wallstreetbets,SELF,544,0,544,-544,1,165,210,1,NASDAQ
4993,15-02-2021 08:00,24 hrs.,wallstreetbets,SESN,7,0,7,-7,1,1,1,1,NASDAQ
4993,15-02-2021 08:00,24 hrs.,wallstreetbets,SHIP,13,6,7,-1,2,2,1,2,NASDAQ
4993,15-02-2021 08:00,24 hrs.,wallstreetbets,SNDL,954,279,675,-396,38,267,268,32,NASDAQ
4993,15-02-2021 08:00,24 hrs.,wallstreetbets,BGFV,7,0,7,-7,1,1,1,1,NASDAQ
4993,15-02-2021 08:00,24 hrs.,wallstreetbets,BIGC,16,16,0,16,1,0,12,1,NASDAQ
4993,15-02-2021 08:00,24 hrs.,wallstreetbets,BLNK,8,8,0,8,1,1,2,1,NASDAQ
4993,15-02-2021 08:00,24 hrs.,wallstreetbets,BLUE,170,170,0,170,1,66,34,1,NASDAQ
4993,15-02-2021 08:00,24 hrs.,wallstreetbets,BNGO,19,7,12,-5,3,3,1,2,NASDAQ
4993,15-02-2021 08:00,24 hrs.,wallstreetbets,BNTX,46,0,46,-46,1,0,42,1,NASDAQ
4993,15-02-2021 08:00,24 hrs.,wallstreetbets,BSQR,7,0,7,-7,1,1,1,1,NASDAQ
4993,15-02-2021 08:00,24 hrs.,wallstreetbets,BXRX,7,7,0,7,1,1,1,1,NASDAQ
4993,15-02-2021 08:00,24 hrs.,wallstreetbets,CARE,143,143,0,143,1,50,39,1,NASDAQ
4993,15-02-2021 08:00,24 hrs.,wallstreetbets,CASH,6,6,0,6,1,1,0,1,NASDAQ
4993,15-02-2021 08:00,24 hrs.,wallstreetbets,CGIX,47,47,0,47,7,7,5,2,NASDAQ
4993,15-02-2021 08:00,24 hrs.,wallstreetbets,CLVS,23,7,16,-9,3,4,3,3,NASDAQ
4993,15-02-2021 08:00,24 hrs.,wallstreetbets,CMPS,14,7,7,0,2,2,2,2,NASDAQ
4993,15-02-2021 08:00,24 hrs.,wallstreetbets,CRBP,7,0,7,-7,1,1,1,1,NASDAQ
4993,15-02-2021 08:00,24 hrs.,wallstreetbets,CRSR,1124,232,892,-660,3,441,230,3,NASDAQ
4993,15-02-2021 08:00,24 hrs.,wallstreetbets,CSCO,113,113,0,113,1,36,37,1,NASDAQ
4993,15-02-2021 08:00,24 hrs.,wallstreetbets,CTRM,87,61,26,35,13,13,9,12,NASDAQ
4993,15-02-2021 08:00,24 hrs.,wallstreetbets,CYCN,9,9,0,9,1,2,1,1,NASDAQ
4993,15-02-2021 08:00,24 hrs.,wallstreetbets,DFFN,7,7,0,7,1,1,1,1,NASDAQ
4993,15-02-2021 08:00,24 hrs.,wallstreetbets,DKNG,987,0,987,-987,1,423,137,1,NASDAQ
4993,15-02-2021 08:00,24 hrs.,wallstreetbets,EBON,7,0,7,-7,1,1,1,1,NASDAQ
4993,15-02-2021 08:00,24 hrs.,wallstreetbets,EDIT,3875,0,3875,-3875,2,1393,1081,2,NASDAQ
4993,15-02-2021 08:00,24 hrs.,wallstreetbets,EOLS,7,0,7,-7,1,1,1,1,NASDAQ
4993,15-02-2021 08:00,24 hrs.,wallstreetbets,ERIC,113,113,0,113,1,36,37,1,NASDAQ
4993,15-02-2021 08:00,24 hrs.,wallstreetbets,EVER,1052,0,1052,-1052,1,489,70,1,NASDAQ
4993,15-02-2021 08:00,24 hrs.,wallstreetbets,EVFM,6,0,6,-6,1,1,0,1,NASDAQ
4993,15-02-2021 08:00,24 hrs.,wallstreetbets,AAPL,193,7,186,-179,3,40,101,3,NASDAQ
4993,15-02-2021 08:00,24 hrs.,wallstreetbets,ABIO,7,7,0,7,1,1,1,1,NASDAQ
4993,15-02-2021 08:00,24 hrs.,wallstreetbets,ADMP,7,0,7,-7,1,1,1,1,NASDAQ
4993,15-02-2021 08:00,24 hrs.,wallstreetbets,AGTC,7,0,7,-7,1,1,1,1,NASDAQ
4993,15-02-2021 08:00,24 hrs.,wallstreetbets,ALGN,28,28,0,28,3,6,4,1,NASDAQ
4993,15-02-2021 08:00,24 hrs.,wallstreetbets,APDN,7,7,0,7,1,1,1,1,NASDAQ
4993,15-02-2021 08:00,24 hrs.,wallstreetbets,APHA,264,264,0,264,5,97,50,3,NASDAQ
4993,15-02-2021 08:00,24 hrs.,wallstreetbets,ARTL,40,27,13,14,6,6,4,4,NASDAQ
4993,15-02-2021 08:00,24 hrs.,wallstreetbets,ASML,7,0,7,-7,1,1,1,1,NASDAQ
4993,15-02-2021 08:00,24 hrs.,wallstreetbets,ASRT,21,7,14,-7,3,3,3,2,NASDAQ
4993,15-02-2021 08:00,24 hrs.,wallstreetbets,ATNI,7,0,7,-7,1,1,1,1,NASDAQ
4993,15-02-2021 08:00,24 hrs.,wallstreetbets,ATOM,7,0,7,-7,1,1,1,1,NASDAQ
4993,15-02-2021 08:00,24 hrs.,wallstreetbets,AVGO,7,7,0,7,1,1,1,1,NASDAQ
4993,15-02-2021 08:00,24 hrs.,wallstreetbets,AYRO,7,0,7,-7,1,1,1,1,NASDAQ
4993,15-02-2021 08:00,24 hrs.,wallstreetbets,BCRX,14,14,0,14,2,2,2,1,NASDAQ
4993,15-02-2021 08:00,24 hrs.,wallstreetbets,STC,15,7,8,-1,2,2,3,2,NYSE
4993,15-02-2021 08:00,24 hrs.,wallstreetbets,SWN,7,7,0,7,1,1,1,1,NYSE
4993,15-02-2021 08:00,24 hrs.,wallstreetbets,TAP,7,0,7,-7,1,1,1,1,NYSE
4993,15-02-2021 08:00,24 hrs.,wallstreetbets,TSM,119,119,0,119,2,37,37,2,NYSE
4993,15-02-2021 08:00,24 hrs.,wallstreetbets,VERU,7,7,0,7,1,1,1,1,NASDAQ
4993,15-02-2021 08:00,24 hrs.,wallstreetbets,VIAC,7,0,7,-7,1,1,1,1,NASDAQ
4993,15-02-2021 08:00,24 hrs.,wallstreetbets,VXRT,7,7,0,7,1,1,1,1,NASDAQ
4993,15-02-2021 08:00,24 hrs.,wallstreetbets,VYGR,7,0,7,-7,1,1,1,1,NASDAQ
4993,15-02-2021 08:00,24 hrs.,wallstreetbets,WKHS,6,6,0,6,1,1,0,1,NASDAQ
4993,15-02-2021 08:00,24 hrs.,wallstreetbets,ZNGA,606,606,0,606,1,243,116,1,NASDAQ
4993,15-02-2021 08:00,24 hrs.,wallstreetbets,ZYNE,6,0,6,-6,1,1,0,1,NASDAQ
4993,15-02-2021 08:00,24 hrs.,wallstreetbets,ZYXI,6,0,6,-6,1,1,0,1,NASDAQ
4993,15-02-2021 08:00,24 hrs.,RobinHoodPennyStocks,BLXX,7,7,0,7,1,1,1,1,OTC
4993,15-02-2021 08:00,24 hrs.,RobinHoodPennyStocks,HCMC,6,6,0,6,1,1,0,1,OTC
4993,15-02-2021 08:00,24 hrs.,RobinHoodPennyStocks,MJNA,12,0,12,-12,1,0,8,1,OTC
4993,15-02-2021 08:00,24 hrs.,RobinHoodPennyStocks,PHIL,6,6,0,6,1,1,0,1,OTC
4993,15-02-2021 08:00,24 hrs.,RobinHoodPennyStocks,SSFT,15,0,15,-15,1,0,11,1,OTC
4993,15-02-2021 08:00,24 hrs.,RobinHoodPennyStocks,ZHUD,7,7,0,7,1,1,1,1,OTC
4993,15-02-2021 08:00,24 hrs.,RobinHoodPennyStocks,BDRBF,16,16,0,16,1,0,12,1,OTC
4993,15-02-2021 08:00,24 hrs.,RobinHoodPennyStocks,LMNGF,8,0,8,-8,1,1,2,1,OTC
4993,15-02-2021 08:00,24 hrs.,RobinHoodPennyStocks,RYCEY,10,10,0,10,1,1,4,1,OTC
4993,15-02-2021 08:00,24 hrs.,RobinHoodPennyStocks,DNN,18,6,12,-6,3,3,0,3,AMEX
4993,15-02-2021 08:00,24 hrs.,RobinHoodPennyStocks,DPW,587,0,587,-587,1,249,85,1,AMEX
4993,15-02-2021 08:00,24 hrs.,RobinHoodPennyStocks,GTE,18,0,18,-18,3,3,0,3,AMEX
4993,15-02-2021 08:00,24 hrs.,RobinHoodPennyStocks,LNG,13,13,0,13,1,4,1,1,AMEX
4993,15-02-2021 08:00,24 hrs.,RobinHoodPennyStocks,NBY,587,0,587,-587,1,249,85,1,AMEX
4993,15-02-2021 08:00,24 hrs.,RobinHoodPennyStocks,ZOM,6,0,6,-6,1,1,0,1,AMEX
4993,15-02-2021 08:00,24 hrs.,RobinHoodPennyStocks,SENS,32,32,0,32,1,4,20,1,AMEX
4993,15-02-2021 08:00,24 hrs.,RobinHoodPennyStocks,XXII,6,6,0,6,1,1,0,1,AMEX
4993,15-02-2021 08:00,24 hrs.,RobinHoodPennyStocks,AMP,6,6,0,6,1,1,0,1,NYSE
4993,15-02-2021 08:00,24 hrs.,wallstreetbets,FAST,80,80,0,80,1,0,76,1,NASDAQ
4993,15-02-2021 08:00,24 hrs.,wallstreetbets,FCAC,7,0,7,-7,1,1,1,1,NASDAQ
4993,15-02-2021 08:00,24 hrs.,wallstreetbets,FCEL,7,7,0,7,1,1,1,1,NASDAQ
4993,15-02-2021 08:00,24 hrs.,wallstreetbets,FEYE,7,7,0,7,1,1,1,1,NASDAQ
4993,15-02-2021 08:00,24 hrs.,wallstreetbets,FLGT,13,13,0,13,2,2,1,1,NASDAQ
4993,15-02-2021 08:00,24 hrs.,wallstreetbets,FLWS,6,6,0,6,1,1,0,1,NASDAQ
4993,15-02-2021 08:00,24 hrs.,wallstreetbets,FORD,80,80,0,80,1,0,76,1,NASDAQ
4993,15-02-2021 08:00,24 hrs.,wallstreetbets,FROG,12,6,6,0,2,2,0,2,NASDAQ
4993,15-02-2021 08:00,24 hrs.,wallstreetbets,FTFT,7,7,0,7,1,1,1,1,NASDAQ
4993,15-02-2021 08:00,24 hrs.,wallstreetbets,GNUS,7,7,0,7,1,1,1,1,NASDAQ
4993,15-02-2021 08:00,24 hrs.,wallstreetbets,GOGO,143,118,25,93,7,31,53,5,NASDAQ
4993,15-02-2021 08:00,24 hrs.,wallstreetbets,GOLD,7,7,0,7,1,1,1,1,NASDAQ
4993,15-02-2021 08:00,24 hrs.,wallstreetbets,GSMG,12,0,12,-12,2,2,0,1,NASDAQ
4993,15-02-2021 08:00,24 hrs.,wallstreetbets,HEAR,7,7,0,7,1,1,1,1,NASDAQ
4993,15-02-2021 08:00,24 hrs.,wallstreetbets,INFI,7,0,7,-7,1,1,1,1,NASDAQ
4993,15-02-2021 08:00,24 hrs.,wallstreetbets,INPX,14,0,14,-14,2,2,2,1,NASDAQ
4993,15-02-2021 08:00,24 hrs.,wallstreetbets,INTC,310,310,0,310,3,72,154,3,NASDAQ
4993,15-02-2021 08:00,24 hrs.,wallstreetbets,ITRM,27,7,20,-13,4,4,3,3,NASDAQ
4993,15-02-2021 08:00,24 hrs.,wallstreetbets,JBHT,6,0,6,-6,1,1,0,1,NASDAQ
4993,15-02-2021 08:00,24 hrs.,wallstreetbets,JBLU,232,232,0,232,1,101,26,1,NASDAQ
4993,15-02-2021 08:00,24 hrs.,wallstreetbets,JNCE,7,0,7,-7,1,1,1,1,NASDAQ
4993,15-02-2021 08:00,24 hrs.,wallstreetbets,KNSA,7,0,7,-7,1,1,1,1,NASDAQ
4993,15-02-2021 08:00,24 hrs.,wallstreetbets,LIFE,13,13,0,13,2,2,1,2,NASDAQ
4993,15-02-2021 08:00,24 hrs.,wallstreetbets,LIVE,7,0,7,-7,1,1,1,1,NASDAQ
4993,15-02-2021 08:00,24 hrs.,wallstreetbets,LIVX,6,0,6,-6,1,1,0,1,NASDAQ
4993,15-02-2021 08:00,24 hrs.,wallstreetbets,LLNW,6,6,0,6,1,1,0,1,NASDAQ
4993,15-02-2021 08:00,24 hrs.,wallstreetbets,MARA,7,0,7,-7,1,1,1,1,NASDAQ
4993,15-02-2021 08:00,24 hrs.,wallstreetbets,MARK,6,6,0,6,1,1,0,1,NASDAQ
4993,15-02-2021 08:00,24 hrs.,wallstreetbets,MBRX,7,0,7,-7,1,1,1,1,NASDAQ
4993,15-02-2021 08:00,24 hrs.,wallstreetbets,MCHP,7,7,0,7,1,1,1,1,NASDAQ
4993,15-02-2021 08:00,24 hrs.,wallstreetbets,MGIC,9,9,0,9,1,2,1,1,NASDAQ
4993,15-02-2021 08:00,24 hrs.,wallstreetbets,MSFT,113,113,0,113,1,36,37,1,NASDAQ
4993,15-02-2021 08:00,24 hrs.,wallstreetbets,MSTR,6,6,0,6,1,1,0,1,NASDAQ
4993,15-02-2021 08:00,24 hrs.,wallstreetbets,MVIS,12,6,6,0,2,2,0,2,NASDAQ
4993,15-02-2021 08:00,24 hrs.,wallstreetbets,NAKD,14,7,7,0,2,2,2,2,NASDAQ
4993,15-02-2021 08:00,24 hrs.,wallstreetbets,NCLH,238,238,0,238,2,102,26,2,NASDAQ
4993,15-02-2021 08:00,24 hrs.,wallstreetbets,NNDM,7,0,7,-7,1,1,1,1,NASDAQ
4993,15-02-2021 08:00,24 hrs.,wallstreetbets,NNOX,7,0,7,-7,1,1,1,1,NASDAQ
4993,15-02-2021 08:00,24 hrs.,RobinHoodPennyStocks,SNDL,692,32,660,-628,5,279,114,4,NASDAQ
4993,15-02-2021 08:00,24 hrs.,RobinHoodPennyStocks,TNXP,12,0,12,-12,2,2,0,1,NASDAQ
4993,15-02-2021 08:00,24 hrs.,RobinHoodPennyStocks,TRCH,4,4,0,4,1,0,0,1,NASDAQ
4993,15-02-2021 08:00,24 hrs.,RobinHoodPennyStocks,TXMD,143,143,0,143,4,43,41,2,NASDAQ
4993,15-02-2021 08:00,24 hrs.,RobinHoodPennyStocks,ZSAN,6,6,0,6,1,1,0,1,NASDAQ
4993,15-02-2021 08:00,24 hrs.,RobinHoodPennyStocks,NOVN,12,0,12,-12,2,2,0,2,NASDAQ
4993,15-02-2021 08:00,24 hrs.,RobinHoodPennyStocks,NVCN,4,4,0,4,1,0,0,1,NASDAQ
4993,15-02-2021 08:00,24 hrs.,RobinHoodPennyStocks,PFMT,12,0,12,-12,2,2,0,1,NASDAQ
4993,15-02-2021 08:00,24 hrs.,RobinHoodPennyStocks,PULM,7,0,7,-7,1,1,1,1,NASDAQ
4993,15-02-2021 08:00,24 hrs.,RobinHoodPennyStocks,RGLS,6,6,0,6,1,1,0,1,NASDAQ
4993,15-02-2021 08:00,24 hrs.,RobinHoodPennyStocks,BDN,6,0,6,-6,1,1,0,1,NYSE
4993,15-02-2021 08:00,24 hrs.,RobinHoodPennyStocks,CNS,17,17,0,17,1,2,9,1,NYSE
4993,15-02-2021 08:00,24 hrs.,RobinHoodPennyStocks,PHI,6,6,0,6,1,1,0,1,NYSE
4993,15-02-2021 08:00,24 hrs.,RobinHoodPennyStocks,SOS,593,6,587,-581,2,250,85,2,NYSE
4993,15-02-2021 08:00,24 hrs.,RobinHoodPennyStocks,WTM,6,0,6,-6,1,1,0,1,NYSE
4993,15-02-2021 08:00,24 hrs.,RobinHoodPennyStocks,GLOG,13,13,0,13,1,4,1,1,NYSE
4993,15-02-2021 08:00,24 hrs.,RobinHoodPennyStocks,CFO,10,10,0,10,1,1,4,1,NASDAQ
4993,15-02-2021 08:00,24 hrs.,RobinHoodPennyStocks,GVP,14,14,0,14,2,2,2,2,NASDAQ
4993,15-02-2021 08:00,24 hrs.,RobinHoodPennyStocks,HAS,6,6,0,6,1,1,0,1,NASDAQ
4993,15-02-2021 08:00,24 hrs.,RobinHoodPennyStocks,JAN,125,125,0,125,1,40,41,1,NASDAQ
4993,15-02-2021 08:00,24 hrs.,RobinHoodPennyStocks,SND,587,0,587,-587,1,249,85,1,NASDAQ
4993,15-02-2021 08:00,24 hrs.,RobinHoodPennyStocks,ABEO,587,0,587,-587,1,249,85,1,NASDAQ
4993,15-02-2021 08:00,24 hrs.,RobinHoodPennyStocks,ACRX,6,6,0,6,1,1,0,1,NASDAQ
4993,15-02-2021 08:00,24 hrs.,RobinHoodPennyStocks,ARTL,12,6,6,0,2,2,0,2,NASDAQ
4993,15-02-2021 08:00,24 hrs.,RobinHoodPennyStocks,ASRT,6,0,6,-6,1,1,0,1,NASDAQ
4993,15-02-2021 08:00,24 hrs.,RobinHoodPennyStocks,BRQS,77,0,77,-77,1,29,15,1,NASDAQ
4993,15-02-2021 08:00,24 hrs.,RobinHoodPennyStocks,CLBS,587,0,587,-587,1,249,85,1,NASDAQ
4993,15-02-2021 08:00,24 hrs.,RobinHoodPennyStocks,CRBP,225,0,225,-225,2,67,83,2,NASDAQ
4993,15-02-2021 08:00,24 hrs.,RobinHoodPennyStocks,CTMX,587,0,587,-587,1,249,85,1,NASDAQ
4993,15-02-2021 08:00,24 hrs.,RobinHoodPennyStocks,CTRM,38,32,6,26,2,5,20,2,NASDAQ
4993,15-02-2021 08:00,24 hrs.,RobinHoodPennyStocks,CYCN,17,17,0,17,1,2,9,1,NASDAQ
4993,15-02-2021 08:00,24 hrs.,RobinHoodPennyStocks,DFFN,668,0,668,-668,4,275,102,4,NASDAQ
4993,15-02-2021 08:00,24 hrs.,RobinHoodPennyStocks,FLEX,6,6,0,6,1,1,0,1,NASDAQ
4993,15-02-2021 08:00,24 hrs.,RobinHoodPennyStocks,GLBS,587,0,587,-587,1,249,85,1,NASDAQ
4993,15-02-2021 08:00,24 hrs.,RobinHoodPennyStocks,GNUS,36,36,0,36,2,4,20,1,NASDAQ
4993,15-02-2021 08:00,24 hrs.,RobinHoodPennyStocks,GRPN,6,0,6,-6,1,1,0,1,NASDAQ
4993,15-02-2021 08:00,24 hrs.,RobinHoodPennyStocks,HSTO,6,6,0,6,1,1,0,1,NASDAQ
4993,15-02-2021 08:00,24 hrs.,RobinHoodPennyStocks,IDEX,109,32,77,-45,2,33,35,2,NASDAQ
4993,15-02-2021 08:00,24 hrs.,RobinHoodPennyStocks,INPX,6,0,6,-6,1,1,0,1,NASDAQ
4993,15-02-2021 08:00,24 hrs.,RobinHoodPennyStocks,LLNW,6,6,0,6,1,1,0,1,NASDAQ
4993,15-02-2021 08:00,24 hrs.,RobinHoodPennyStocks,MVIS,77,0,77,-77,1,29,15,1,NASDAQ
4993,15-02-2021 08:00,24 hrs.,RobinHoodPennyStocks,MYSZ,12,6,6,0,2,2,0,2,NASDAQ
4993,15-02-2021 08:00,24 hrs.,RobinHoodPennyStocks,NAKD,587,0,587,-587,1,249,85,1,NASDAQ
4993,15-02-2021 08:00,24 hrs.,RobinHoodPennyStocks,NEOS,6,6,0,6,1,1,0,1,NASDAQ
4993,15-02-2021 08:00,24 hrs.,wallstreetbets,SNGX,7,7,0,7,1,1,1,1,NASDAQ
4993,15-02-2021 08:00,24 hrs.,wallstreetbets,SOLO,987,0,987,-987,1,423,137,1,NASDAQ
4993,15-02-2021 08:00,24 hrs.,wallstreetbets,SPWR,14,14,0,14,2,2,2,1,NASDAQ
4993,15-02-2021 08:00,24 hrs.,wallstreetbets,SQQQ,746,8,738,-730,2,234,270,2,NASDAQ
4993,15-02-2021 08:00,24 hrs.,wallstreetbets,SRAC,7,0,7,-7,1,1,1,1,NASDAQ
4993,15-02-2021 08:00,24 hrs.,wallstreetbets,SRNE,26,6,20,-14,3,2,10,3,NASDAQ
4993,15-02-2021 08:00,24 hrs.,wallstreetbets,STAY,7,7,0,7,1,1,1,1,NASDAQ
4993,15-02-2021 08:00,24 hrs.,wallstreetbets,STNE,7,0,7,-7,1,1,1,1,NASDAQ
4993,15-02-2021 08:00,24 hrs.,wallstreetbets,SWBI,7,7,0,7,1,1,1,1,NASDAQ
4993,15-02-2021 08:00,24 hrs.,wallstreetbets,TECH,176,170,6,164,2,67,34,2,NASDAQ
4993,15-02-2021 08:00,24 hrs.,wallstreetbets,THBR,7,7,0,7,1,1,1,1,NASDAQ
4993,15-02-2021 08:00,24 hrs.,wallstreetbets,TLGT,12,12,0,12,2,2,0,1,NASDAQ
4993,15-02-2021 08:00,24 hrs.,wallstreetbets,TLRY,466,459,7,452,11,168,86,8,NASDAQ
4993,15-02-2021 08:00,24 hrs.,wallstreetbets,TRCH,7,7,0,7,1,1,1,1,NASDAQ
4993,15-02-2021 08:00,24 hrs.,wallstreetbets,TRIT,56,31,25,6,7,12,4,3,NASDAQ
4993,15-02-2021 08:00,24 hrs.,wallstreetbets,TRVG,36,14,22,-8,5,5,6,5,NASDAQ
4993,15-02-2021 08:00,24 hrs.,wallstreetbets,TSLA,1990,191,1799,-1608,8,716,526,8,NASDAQ
4993,15-02-2021 08:00,24 hrs.,wallstreetbets,TXMD,26,26,0,26,4,4,2,3,NASDAQ
4993,15-02-2021 08:00,24 hrs.,wallstreetbets,TYME,15,0,15,-15,2,2,3,2,NASDAQ
4993,15-02-2021 08:00,24 hrs.,wallstreetbets,VBIV,7,0,7,-7,1,1,1,1,NASDAQ
4993,15-02-2021 08:00,24 hrs.,SPACs,VSPR,132,132,0,132,1,49,30,1,NASDAQ
4993,15-02-2021 08:00,24 hrs.,stocks,BLSP,6,6,0,6,1,1,0,1,OTC
4993,15-02-2021 08:00,24 hrs.,stocks,CAGR,51,0,51,-51,1,13,21,1,OTC
4993,15-02-2021 08:00,24 hrs.,stocks,DKMR,6,0,6,-6,1,1,0,1,OTC
4993,15-02-2021 08:00,24 hrs.,stocks,HCMC,54,12,42,-30,3,12,18,3,OTC
4993,15-02-2021 08:00,24 hrs.,stocks,MINE,6,0,6,-6,1,1,0,1,OTC
4993,15-02-2021 08:00,24 hrs.,stocks,MJNA,4,0,4,-4,1,0,0,1,OTC
4993,15-02-2021 08:00,24 hrs.,stocks,MKTY,12,12,0,12,2,2,0,1,OTC
4993,15-02-2021 08:00,24 hrs.,stocks,NEOM,6,0,6,-6,1,1,0,1,OTC
4993,15-02-2021 08:00,24 hrs.,stocks,SNPW,12,12,0,12,1,4,0,1,OTC
4993,15-02-2021 08:00,24 hrs.,stocks,TSNP,7,0,7,-7,1,1,1,1,OTC
4993,15-02-2021 08:00,24 hrs.,stocks,AMKBF,7,7,0,7,1,1,1,1,OTC
4993,15-02-2021 08:00,24 hrs.,stocks,AMKBY,7,7,0,7,1,1,1,1,OTC
4993,15-02-2021 08:00,24 hrs.,stocks,MMEDF,12,0,12,-12,2,2,0,1,OTC
4993,15-02-2021 08:00,24 hrs.,stocks,PROSY,6,6,0,6,1,1,0,1,OTC
4993,15-02-2021 08:00,24 hrs.,stocks,CTO,51,0,51,-51,1,13,21,1,AMEX
4993,15-02-2021 08:00,24 hrs.,stocks,GSAT,6,6,0,6,1,1,0,1,AMEX
4993,15-02-2021 08:00,24 hrs.,stocks,ACB,16,16,0,16,1,4,4,1,NYSE
4993,15-02-2021 08:00,24 hrs.,stocks,AFG,11,11,0,11,1,3,1,1,NYSE
4993,15-02-2021 08:00,24 hrs.,stocks,AMC,644,90,554,-464,6,211,198,6,NYSE
4993,15-02-2021 08:00,24 hrs.,stocks,AMT,32,32,0,32,1,4,20,1,NYSE
4993,15-02-2021 08:00,24 hrs.,stocks,BAM,71,32,39,-7,3,14,31,2,NYSE
4993,15-02-2021 08:00,24 hrs.,stocks,BCH,6,0,6,-6,1,1,0,1,NYSE
4993,15-02-2021 08:00,24 hrs.,stocks,BLK,32,32,0,32,1,4,20,1,NYSE
4993,15-02-2021 08:00,24 hrs.,stocks,BMA,10,10,0,10,2,1,0,2,NYSE
4993,15-02-2021 08:00,24 hrs.,stocks,BNY,32,32,0,32,1,4,20,1,NYSE
4993,15-02-2021 08:00,24 hrs.,stocks,BYD,73,0,73,-73,1,15,39,1,NYSE
4993,15-02-2021 08:00,24 hrs.,stocks,CCI,32,32,0,32,1,4,20,1,NYSE
4993,15-02-2021 08:00,24 hrs.,stocks,CCL,16,16,0,16,1,4,4,1,NYSE
4993,15-02-2021 08:00,24 hrs.,stocks,CIO,51,0,51,-51,1,13,21,1,NYSE
4993,15-02-2021 08:00,24 hrs.,stocks,CMO,51,0,51,-51,1,13,21,1,NYSE
4993,15-02-2021 08:00,24 hrs.,SPACs,COHN,14,14,0,14,1,3,4,1,AMEX
4993,15-02-2021 08:00,24 hrs.,SPACs,BFT,262,134,128,6,2,66,122,2,NYSE
4993,15-02-2021 08:00,24 hrs.,SPACs,GIK,193,0,193,-193,1,73,43,1,NYSE
4993,15-02-2021 08:00,24 hrs.,SPACs,JWS,10,10,0,10,1,2,2,1,NYSE
4993,15-02-2021 08:00,24 hrs.,SPACs,NAV,29,22,7,15,4,4,5,3,NYSE
4993,15-02-2021 08:00,24 hrs.,SPACs,NGA,134,134,0,134,1,20,90,1,NYSE
4993,15-02-2021 08:00,24 hrs.,SPACs,NPV,33,0,33,-33,1,10,9,1,NYSE
4993,15-02-2021 08:00,24 hrs.,SPACs,OAC,538,0,538,-538,1,189,156,1,NYSE
4993,15-02-2021 08:00,24 hrs.,SPACs,OSH,10,10,0,10,1,2,2,1,NYSE
4993,15-02-2021 08:00,24 hrs.,SPACs,SBE,23,0,23,-23,1,1,17,1,NYSE
4993,15-02-2021 08:00,24 hrs.,SPACs,UBS,37,37,0,37,1,6,21,1,NYSE
4993,15-02-2021 08:00,24 hrs.,SPACs,ACIC,538,0,538,-538,1,189,156,1,NYSE
4993,15-02-2021 08:00,24 hrs.,SPACs,AJAX,538,0,538,-538,1,189,156,1,NYSE
4993,15-02-2021 08:00,24 hrs.,SPACs,ALUS,538,0,538,-538,1,189,156,1,NYSE
4993,15-02-2021 08:00,24 hrs.,SPACs,CCIV,1561,1539,22,1517,6,683,171,5,NYSE
4993,15-02-2021 08:00,24 hrs.,SPACs,FGNA,538,0,538,-538,1,189,156,1,NYSE
4993,15-02-2021 08:00,24 hrs.,SPACs,FUSE,734,98,636,-538,4,245,228,4,NYSE
4993,15-02-2021 08:00,24 hrs.,SPACs,IPOC,538,0,538,-538,1,189,156,1,NYSE
4993,15-02-2021 08:00,24 hrs.,SPACs,IPOD,28,0,28,-28,1,3,18,1,NYSE
4993,15-02-2021 08:00,24 hrs.,SPACs,IPOE,13,13,0,13,2,2,1,2,NYSE
4993,15-02-2021 08:00,24 hrs.,SPACs,PDAC,42,42,0,42,1,2,34,1,NYSE
4993,15-02-2021 08:00,24 hrs.,SPACs,PSTH,87,73,14,59,3,2,71,3,NYSE
4993,15-02-2021 08:00,24 hrs.,SPACs,SNPR,1281,30,1251,-1221,3,484,301,3,NYSE
4993,15-02-2021 08:00,24 hrs.,SPACs,SOAC,538,0,538,-538,1,189,156,1,NYSE
4993,15-02-2021 08:00,24 hrs.,SPACs,STPK,7,0,7,-7,1,1,1,1,NYSE
4993,15-02-2021 08:00,24 hrs.,SPACs,JAN,15,0,15,-15,1,5,1,1,NASDAQ
4993,15-02-2021 08:00,24 hrs.,SPACs,VIH,538,0,538,-538,1,189,156,1,NASDAQ
4993,15-02-2021 08:00,24 hrs.,SPACs,AACQ,221,0,221,-221,3,69,71,3,NASDAQ
4993,15-02-2021 08:00,24 hrs.,SPACs,ACTC,538,0,538,-538,1,189,156,1,NASDAQ
4993,15-02-2021 08:00,24 hrs.,SPACs,AMCI,538,0,538,-538,1,189,156,1,NASDAQ
4993,15-02-2021 08:00,24 hrs.,SPACs,APXT,538,0,538,-538,1,189,156,1,NASDAQ
4993,15-02-2021 08:00,24 hrs.,SPACs,ARYA,538,0,538,-538,1,189,156,1,NASDAQ
4993,15-02-2021 08:00,24 hrs.,SPACs,BOWX,59,59,0,59,1,13,29,1,NASDAQ
4993,15-02-2021 08:00,24 hrs.,stocks,COO,51,0,51,-51,1,13,21,1,NYSE
4993,15-02-2021 08:00,24 hrs.,stocks,CVS,16,16,0,16,1,4,4,1,NYSE
4993,15-02-2021 08:00,24 hrs.,stocks,DIS,525,22,503,-481,2,194,129,2,NYSE
4993,15-02-2021 08:00,24 hrs.,stocks,EPD,6,6,0,6,1,1,0,1,NYSE
4993,15-02-2021 08:00,24 hrs.,stocks,FDX,32,32,0,32,1,4,20,1,NYSE
4993,15-02-2021 08:00,24 hrs.,stocks,GLW,41,0,41,-41,1,12,13,1,NYSE
4993,15-02-2021 08:00,24 hrs.,stocks,GME,752,161,591,-430,7,236,252,7,NYSE
4993,15-02-2021 08:00,24 hrs.,stocks,GSK,6,0,6,-6,1,1,0,1,NYSE
4993,15-02-2021 08:00,24 hrs.,stocks,HMC,6,6,0,6,1,1,0,1,NYSE
4993,15-02-2021 08:00,24 hrs.,stocks,HON,6,6,0,6,1,1,0,1,NYSE
4993,15-02-2021 08:00,24 hrs.,stocks,HUM,41,41,0,41,1,10,17,1,NYSE
4993,15-02-2021 08:00,24 hrs.,stocks,IRS,33,33,0,33,1,5,19,1,NYSE
4993,15-02-2021 08:00,24 hrs.,stocks,JPM,32,32,0,32,1,4,20,1,NYSE
4993,15-02-2021 08:00,24 hrs.,stocks,KSU,32,32,0,32,1,4,20,1,NYSE
4993,15-02-2021 08:00,24 hrs.,stocks,LMT,141,141,0,141,2,44,45,2,NYSE
4993,15-02-2021 08:00,24 hrs.,stocks,MRK,7,7,0,7,1,1,1,1,NYSE
4993,15-02-2021 08:00,24 hrs.,stocks,MSI,32,32,0,32,1,4,20,1,NYSE
4993,15-02-2021 08:00,24 hrs.,stocks,MSM,66,66,0,66,1,28,6,1,NYSE
4993,15-02-2021 08:00,24 hrs.,stocks,NET,41,41,0,41,1,10,17,1,NYSE
4993,15-02-2021 08:00,24 hrs.,stocks,NIO,1179,48,1131,-1083,6,360,435,6,NYSE
4993,15-02-2021 08:00,24 hrs.,stocks,NOC,32,32,0,32,1,4,20,1,NYSE
4993,15-02-2021 08:00,24 hrs.,stocks,NOK,616,62,554,-492,3,204,196,3,NYSE
4993,15-02-2021 08:00,24 hrs.,stocks,NVO,37,31,6,25,2,12,5,2,NYSE
4993,15-02-2021 08:00,24 hrs.,stocks,ORA,186,0,186,-186,1,81,20,1,NYSE
4993,15-02-2021 08:00,24 hrs.,stocks,PAG,32,32,0,32,1,4,20,1,NYSE
4993,15-02-2021 08:00,24 hrs.,stocks,PEG,51,0,51,-51,1,13,21,1,NYSE
4993,15-02-2021 08:00,24 hrs.,stocks,PFE,7,0,7,-7,1,1,1,1,NYSE
4993,15-02-2021 08:00,24 hrs.,stocks,RKT,503,0,503,-503,1,191,117,1,NYSE
4993,15-02-2021 08:00,24 hrs.,stocks,RSI,21,21,0,21,1,0,17,1,NYSE
4993,15-02-2021 08:00,24 hrs.,stocks,RTX,41,41,0,41,1,10,17,1,NYSE
4993,15-02-2021 08:00,24 hrs.,stocks,SBE,153,0,153,-153,1,58,33,1,NYSE
4993,15-02-2021 08:00,24 hrs.,stocks,SHO,66,66,0,66,1,28,6,1,NYSE
4993,15-02-2021 08:00,24 hrs.,stocks,TDC,6,6,0,6,1,1,0,1,NYSE
4993,15-02-2021 08:00,24 hrs.,stocks,TDG,41,41,0,41,1,10,17,1,NYSE
4993,15-02-2021 08:00,24 hrs.,stocks,TGH,41,41,0,41,1,10,17,1,NYSE
4993,15-02-2021 08:00,24 hrs.,stocks,THC,25,0,25,-25,1,5,11,1,NYSE
4993,15-02-2021 08:00,24 hrs.,stocks,TSE,6,6,0,6,1,1,0,1,NYSE
4993,15-02-2021 08:00,24 hrs.,stocks,TSM,119,119,0,119,2,34,43,2,NYSE
4993,15-02-2021 08:00,24 hrs.,stocks,UMC,22,0,22,-22,1,7,4,1,NYSE
4993,15-02-2021 08:00,24 hrs.,stocks,UNP,32,32,0,32,1,4,20,1,NYSE
4993,15-02-2021 08:00,24 hrs.,stocks,UPS,32,32,0,32,1,4,20,1,NYSE
4993,15-02-2021 08:00,24 hrs.,stocks,VHC,6,6,0,6,1,1,0,1,NYSE
4993,15-02-2021 08:00,24 hrs.,stocks,VRT,43,0,43,-43,1,14,11,1,NYSE
4993,15-02-2021 08:00,24 hrs.,stocks,ANTM,41,41,0,41,1,10,17,1,NYSE
4993,15-02-2021 08:00,24 hrs.,SPACs,BTAQ,538,0,538,-538,1,189,156,1,NASDAQ
4993,15-02-2021 08:00,24 hrs.,SPACs,BTWN,59,59,0,59,1,13,29,1,NASDAQ
4993,15-02-2021 08:00,24 hrs.,SPACs,CIIC,6,6,0,6,1,1,0,1,NASDAQ
4993,15-02-2021 08:00,24 hrs.,SPACs,CMLF,538,0,538,-538,1,189,156,1,NASDAQ
4993,15-02-2021 08:00,24 hrs.,SPACs,DCRB,538,0,538,-538,1,189,156,1,NASDAQ
4993,15-02-2021 08:00,24 hrs.,SPACs,EDIT,33,0,33,-33,1,10,9,1,NASDAQ
4993,15-02-2021 08:00,24 hrs.,SPACs,FCAC,562,0,562,-562,2,194,166,2,NASDAQ
4993,15-02-2021 08:00,24 hrs.,SPACs,FCEL,11,11,0,11,1,3,1,1,NASDAQ
4993,15-02-2021 08:00,24 hrs.,SPACs,FIII,156,156,0,156,1,51,50,1,NASDAQ
4993,15-02-2021 08:00,24 hrs.,SPACs,FTOC,134,134,0,134,1,20,90,1,NASDAQ
4993,15-02-2021 08:00,24 hrs.,SPACs,GRNV,538,0,538,-538,1,189,156,1,NASDAQ
4993,15-02-2021 08:00,24 hrs.,SPACs,HOFV,538,0,538,-538,1,189,156,1,NASDAQ
4993,15-02-2021 08:00,24 hrs.,SPACs,HTOO,11,11,0,11,1,3,1,1,NASDAQ
4993,15-02-2021 08:00,24 hrs.,SPACs,NBAC,15,0,15,-15,1,5,1,1,NASDAQ
4993,15-02-2021 08:00,24 hrs.,SPACs,NGAC,82,0,82,-82,1,24,30,1,NASDAQ
4993,15-02-2021 08:00,24 hrs.,SPACs,NKLA,11,11,0,11,1,3,1,1,NASDAQ
4993,15-02-2021 08:00,24 hrs.,SPACs,PLAY,37,37,0,37,1,6,21,1,NASDAQ
4993,15-02-2021 08:00,24 hrs.,SPACs,PLUG,11,11,0,11,1,3,1,1,NASDAQ
4993,15-02-2021 08:00,24 hrs.,SPACs,THBR,538,0,538,-538,1,189,156,1,NASDAQ
4993,15-02-2021 08:00,24 hrs.,SPACs,THCB,134,134,0,134,1,20,90,1,NASDAQ
4924,14-02-2021 20:00,24 hrs.,pennystocks,CCTL,12,6,6,0,2,2,0,2,OTC
4924,14-02-2021 20:00,24 hrs.,pennystocks,CHUC,24,24,0,24,1,6,8,1,OTC
4924,14-02-2021 20:00,24 hrs.,pennystocks,COUV,53,53,0,53,1,10,29,1,OTC
4924,14-02-2021 20:00,24 hrs.,pennystocks,DRNK,6,0,6,-6,1,1,0,1,OTC
4924,14-02-2021 20:00,24 hrs.,pennystocks,DXLG,41,0,41,-41,1,17,3,1,OTC
4924,14-02-2021 20:00,24 hrs.,pennystocks,ECOX,7,0,7,-7,1,1,1,1,OTC
4924,14-02-2021 20:00,24 hrs.,pennystocks,EMED,12,0,12,-12,2,2,0,1,OTC
4924,14-02-2021 20:00,24 hrs.,pennystocks,EWLL,7,0,7,-7,1,1,1,1,OTC
4924,14-02-2021 20:00,24 hrs.,pennystocks,EXMT,49,49,0,49,1,7,31,1,OTC
4924,14-02-2021 20:00,24 hrs.,pennystocks,GAHC,7,7,0,7,1,1,1,1,OTC
4924,14-02-2021 20:00,24 hrs.,pennystocks,GBFH,24,24,0,24,1,3,14,1,OTC
4924,14-02-2021 20:00,24 hrs.,pennystocks,GGII,7,7,0,7,1,1,1,1,OTC
4924,14-02-2021 20:00,24 hrs.,pennystocks,GLFH,28,0,28,-28,1,5,14,1,OTC
4924,14-02-2021 20:00,24 hrs.,pennystocks,GRLT,25,25,0,25,1,3,15,1,OTC
4924,14-02-2021 20:00,24 hrs.,pennystocks,GRST,187,187,0,187,2,66,47,2,OTC
4924,14-02-2021 20:00,24 hrs.,pennystocks,GTLL,191,191,0,191,2,68,47,2,OTC
4924,14-02-2021 20:00,24 hrs.,pennystocks,HCMC,73,38,35,3,11,13,3,11,OTC
4924,14-02-2021 20:00,24 hrs.,pennystocks,HESG,6,6,0,6,1,1,0,1,OTC
4924,14-02-2021 20:00,24 hrs.,pennystocks,HMPQ,13,13,0,13,2,2,1,1,OTC
4924,14-02-2021 20:00,24 hrs.,pennystocks,HPIL,13,0,13,-13,2,2,1,1,OTC
4924,14-02-2021 20:00,24 hrs.,pennystocks,HPMM,13,13,0,13,2,2,1,2,OTC
4924,14-02-2021 20:00,24 hrs.,pennystocks,HQGE,6,0,6,-6,1,1,0,1,OTC
4924,14-02-2021 20:00,24 hrs.,pennystocks,HWKE,6,6,0,6,1,1,0,1,OTC
4924,14-02-2021 20:00,24 hrs.,pennystocks,HYSR,18,18,0,18,1,3,8,1,OTC
4924,14-02-2021 20:00,24 hrs.,pennystocks,IJJP,25,25,0,25,1,3,15,1,OTC
4924,14-02-2021 20:00,24 hrs.,pennystocks,ILUS,91,0,91,-91,1,31,25,1,OTC
4924,14-02-2021 20:00,24 hrs.,pennystocks,INND,105,80,25,55,2,34,29,2,OTC
4924,14-02-2021 20:00,24 hrs.,pennystocks,IPSI,27,27,0,27,1,9,5,1,OTC
4924,14-02-2021 20:00,24 hrs.,pennystocks,KGET,6,0,6,-6,1,1,0,1,OTC
4924,14-02-2021 20:00,24 hrs.,pennystocks,KULR,49,0,49,-49,1,12,21,1,OTC
4924,14-02-2021 20:00,24 hrs.,pennystocks,KWBT,6,6,0,6,1,1,0,1,OTC
4924,14-02-2021 20:00,24 hrs.,pennystocks,KYNC,6,0,6,-6,1,1,0,1,OTC
4924,14-02-2021 20:00,24 hrs.,pennystocks,LBSR,7,7,0,7,1,1,1,1,OTC
4924,14-02-2021 20:00,24 hrs.,pennystocks,LCLP,6,6,0,6,1,1,0,1,OTC
4924,14-02-2021 20:00,24 hrs.,pennystocks,LGBS,25,25,0,25,1,3,15,1,OTC
4924,14-02-2021 20:00,24 hrs.,pennystocks,LTNC,73,31,42,-11,3,4,53,3,OTC
4924,14-02-2021 20:00,24 hrs.,pennystocks,MAXD,6,6,0,6,1,1,0,1,OTC
4924,14-02-2021 20:00,24 hrs.,pennystocks,MINE,33,33,0,33,3,8,5,2,OTC
4924,14-02-2021 20:00,24 hrs.,pennystocks,MJWL,25,25,0,25,1,3,15,1,OTC
4924,14-02-2021 20:00,24 hrs.,pennystocks,MLFB,142,125,17,108,2,46,42,2,OTC
4924,14-02-2021 20:00,24 hrs.,pennystocks,MRNJ,7,7,0,7,1,1,1,1,OTC
4924,14-02-2021 20:00,24 hrs.,pennystocks,NTRR,6,0,6,-6,1,1,0,1,OTC
4924,14-02-2021 20:00,24 hrs.,pennystocks,OPTI,63,0,63,-63,2,15,25,2,OTC
4924,14-02-2021 20:00,24 hrs.,pennystocks,OZSC,7,0,7,-7,1,1,1,1,OTC
4924,14-02-2021 20:00,24 hrs.,pennystocks,PLYZ,12,12,0,12,2,2,0,2,OTC
4924,14-02-2021 20:00,24 hrs.,pennystocks,PPJE,7,7,0,7,1,1,1,1,OTC
4924,14-02-2021 20:00,24 hrs.,pennystocks,PRMO,25,25,0,25,1,3,15,1,OTC
4924,14-02-2021 20:00,24 hrs.,pennystocks,PUGE,7,7,0,7,1,1,1,1,OTC
4924,14-02-2021 20:00,24 hrs.,pennystocks,PVDG,26,26,0,26,1,6,10,1,OTC
4924,14-02-2021 20:00,24 hrs.,pennystocks,QBAN,9,0,9,-9,1,0,5,1,OTC
4924,14-02-2021 20:00,24 hrs.,pennystocks,ACRL,66,0,66,-66,3,19,16,3,OTC
4924,14-02-2021 20:00,24 hrs.,pennystocks,AITX,386,285,101,184,6,136,90,5,OTC
4924,14-02-2021 20:00,24 hrs.,pennystocks,ALPP,6,6,0,6,1,1,0,1,OTC
4924,14-02-2021 20:00,24 hrs.,pennystocks,ALYI,13,0,13,-13,2,2,1,1,OTC
4924,14-02-2021 20:00,24 hrs.,pennystocks,AMNE,13,0,13,-13,2,2,1,1,OTC
4924,14-02-2021 20:00,24 hrs.,pennystocks,ASCK,23,23,0,23,1,8,3,1,OTC
4924,14-02-2021 20:00,24 hrs.,pennystocks,ASTI,231,6,225,-219,3,85,49,3,OTC
4924,14-02-2021 20:00,24 hrs.,pennystocks,ATVK,49,0,49,-49,1,12,21,1,OTC
4924,14-02-2021 20:00,24 hrs.,pennystocks,BANT,60,54,6,48,2,13,26,2,OTC
4924,14-02-2021 20:00,24 hrs.,pennystocks,BIEL,15,9,6,3,2,2,3,2,OTC
4924,14-02-2021 20:00,24 hrs.,pennystocks,BLPG,7,7,0,7,1,1,1,1,OTC
4924,14-02-2021 20:00,24 hrs.,pennystocks,BMIX,7,7,0,7,1,1,1,1,OTC
4924,14-02-2021 20:00,24 hrs.,pennystocks,BNGI,19,13,6,7,3,3,1,3,OTC
4924,14-02-2021 20:00,24 hrs.,pennystocks,SING,92,6,86,-80,3,22,36,3,OTC
4924,14-02-2021 20:00,24 hrs.,pennystocks,SNNC,6,0,6,-6,1,1,0,1,OTC
4924,14-02-2021 20:00,24 hrs.,pennystocks,SNPW,6,0,6,-6,1,1,0,1,OTC
4924,14-02-2021 20:00,24 hrs.,pennystocks,SRMX,51,51,0,51,2,9,25,2,OTC
4924,14-02-2021 20:00,24 hrs.,pennystocks,SSFT,55,6,49,-43,2,13,21,2,OTC
4924,14-02-2021 20:00,24 hrs.,pennystocks,TAUG,7,0,7,-7,1,1,1,1,OTC
4924,14-02-2021 20:00,24 hrs.,pennystocks,TGGI,7,7,0,7,1,1,1,1,OTC
4924,14-02-2021 20:00,24 hrs.,pennystocks,TLGN,162,162,0,162,1,59,40,1,OTC
4924,14-02-2021 20:00,24 hrs.,pennystocks,TLSS,112,0,112,-112,1,33,42,1,OTC
4924,14-02-2021 20:00,24 hrs.,pennystocks,TSNP,27,27,0,27,1,9,5,1,OTC
4924,14-02-2021 20:00,24 hrs.,pennystocks,UDHI,6,6,0,6,1,1,0,1,OTC
4924,14-02-2021 20:00,24 hrs.,pennystocks,VGLS,7,7,0,7,1,1,1,1,OTC
4924,14-02-2021 20:00,24 hrs.,pennystocks,VPER,7,7,0,7,1,1,1,1,OTC
4924,14-02-2021 20:00,24 hrs.,pennystocks,VSPC,29,0,29,-29,1,10,5,1,OTC
4924,14-02-2021 20:00,24 hrs.,pennystocks,WDLF,12,0,12,-12,2,2,0,1,OTC
4924,14-02-2021 20:00,24 hrs.,pennystocks,WEBB,196,0,196,-196,1,89,14,1,OTC
4924,14-02-2021 20:00,24 hrs.,pennystocks,WSGF,49,0,49,-49,1,12,21,1,OTC
4924,14-02-2021 20:00,24 hrs.,pennystocks,XMET,7,0,7,-7,1,1,1,1,OTC
4924,14-02-2021 20:00,24 hrs.,pennystocks,YAYO,57,0,57,-57,1,19,15,1,OTC
4924,14-02-2021 20:00,24 hrs.,pennystocks,ZMRK,6,0,6,-6,1,1,0,1,OTC
4924,14-02-2021 20:00,24 hrs.,pennystocks,AMYZF,24,0,24,-24,4,4,0,2,OTC
4924,14-02-2021 20:00,24 hrs.,pennystocks,ARBKF,538,343,195,148,9,154,194,8,OTC
4924,14-02-2021 20:00,24 hrs.,pennystocks,BEVVF,48,48,0,48,1,14,16,1,OTC
4924,14-02-2021 20:00,24 hrs.,pennystocks,BKTPF,39,39,0,39,1,11,13,1,OTC
4924,14-02-2021 20:00,24 hrs.,pennystocks,BLOZF,26,26,0,26,1,6,10,1,OTC
4924,14-02-2021 20:00,24 hrs.,pennystocks,BUROF,35,0,35,-35,1,12,7,1,OTC
4924,14-02-2021 20:00,24 hrs.,pennystocks,BVNNF,310,310,0,310,1,129,48,1,OTC
4924,14-02-2021 20:00,24 hrs.,pennystocks,CHOOF,6,6,0,6,1,1,0,1,OTC
4924,14-02-2021 20:00,24 hrs.,pennystocks,CINGF,49,0,49,-49,1,12,21,1,OTC
4924,14-02-2021 20:00,24 hrs.,pennystocks,DFMTF,22,22,0,22,1,3,12,1,OTC
4924,14-02-2021 20:00,24 hrs.,pennystocks,EMHTF,30,0,30,-30,1,9,8,1,OTC
4924,14-02-2021 20:00,24 hrs.,pennystocks,FUNFF,33,33,0,33,1,11,7,1,OTC
4924,14-02-2021 20:00,24 hrs.,pennystocks,GKPRF,7,7,0,7,1,1,1,1,OTC
4924,14-02-2021 20:00,24 hrs.,pennystocks,HITIF,598,203,395,-192,5,225,128,5,OTC
4924,14-02-2021 20:00,24 hrs.,pennystocks,HMSNF,23,23,0,23,1,7,5,1,OTC
4924,14-02-2021 20:00,24 hrs.,pennystocks,HTZGQ,6,0,6,-6,1,1,0,1,OTC
4924,14-02-2021 20:00,24 hrs.,pennystocks,ICNAF,6,0,6,-6,1,1,0,1,OTC
4924,14-02-2021 20:00,24 hrs.,pennystocks,ITMPF,43,37,6,31,4,10,7,3,OTC
4924,14-02-2021 20:00,24 hrs.,pennystocks,LTMCF,6,0,6,-6,1,1,0,1,OTC
4924,14-02-2021 20:00,24 hrs.,pennystocks,MMEDF,168,162,6,156,2,60,40,2,OTC
4924,14-02-2021 20:00,24 hrs.,pennystocks,MMNFF,41,0,41,-41,1,17,3,1,OTC
4924,14-02-2021 20:00,24 hrs.,pennystocks,MPUCF,7,0,7,-7,1,1,1,1,OTC
4924,14-02-2021 20:00,24 hrs.,pennystocks,NMGRF,52,0,52,-52,2,18,8,1,OTC
4924,14-02-2021 20:00,24 hrs.,pennystocks,NOSUF,162,162,0,162,1,59,40,1,OTC
4924,14-02-2021 20:00,24 hrs.,pennystocks,NXTTF,6,0,6,-6,1,1,0,1,OTC
4924,14-02-2021 20:00,24 hrs.,pennystocks,PEMIF,39,39,0,39,1,11,13,1,OTC
4924,14-02-2021 20:00,24 hrs.,pennystocks,PHPYF,15,0,15,-15,1,1,9,1,OTC
4924,14-02-2021 20:00,24 hrs.,pennystocks,PILBF,6,0,6,-6,1,1,0,1,OTC
4924,14-02-2021 20:00,24 hrs.,pennystocks,RAREF,22,22,0,22,1,3,12,1,OTC
4924,14-02-2021 20:00,24 hrs.,pennystocks,RLLCF,44,0,44,-44,3,6,20,2,OTC
4924,14-02-2021 20:00,24 hrs.,pennystocks,SNNAF,39,39,0,39,1,11,13,1,OTC
4924,14-02-2021 20:00,24 hrs.,pennystocks,SPMTF,39,39,0,39,1,11,13,1,OTC
4924,14-02-2021 20:00,24 hrs.,pennystocks,SPRWF,7,0,7,-7,1,1,1,1,OTC
4924,14-02-2021 20:00,24 hrs.,pennystocks,TAKOF,324,191,133,58,4,95,118,4,OTC
4924,14-02-2021 20:00,24 hrs.,pennystocks,WALRF,49,0,49,-49,1,12,21,1,OTC
4924,14-02-2021 20:00,24 hrs.,pennystocks,BOTY,6,6,0,6,1,1,0,1,OTC
4924,14-02-2021 20:00,24 hrs.,pennystocks,BRAV,7,7,0,7,1,1,1,1,OTC
4924,14-02-2021 20:00,24 hrs.,pennystocks,BRRN,162,162,0,162,1,59,40,1,OTC
4924,14-02-2021 20:00,24 hrs.,pennystocks,BRSE,6,0,6,-6,1,1,0,1,OTC
4924,14-02-2021 20:00,24 hrs.,pennystocks,BTSC,6,6,0,6,1,1,0,1,OTC
4924,14-02-2021 20:00,24 hrs.,pennystocks,BTZI,49,49,0,49,1,7,31,1,OTC
4924,14-02-2021 20:00,24 hrs.,pennystocks,CANN,6,0,6,-6,1,1,0,1,OTC
4924,14-02-2021 20:00,24 hrs.,pennystocks,CBDD,49,49,0,49,1,7,31,1,OTC
4924,14-02-2021 20:00,24 hrs.,pennystocks,CBDL,171,171,0,171,2,60,43,2,OTC
4924,14-02-2021 20:00,24 hrs.,pennystocks,CIDM,44,44,0,44,1,14,12,1,NASDAQ
4924,14-02-2021 20:00,24 hrs.,pennystocks,CJJD,26,0,26,-26,1,0,22,1,NASDAQ
4924,14-02-2021 20:00,24 hrs.,pennystocks,CLBS,179,179,0,179,2,61,49,2,NASDAQ
4924,14-02-2021 20:00,24 hrs.,pennystocks,CLPS,26,0,26,-26,1,0,22,1,NASDAQ
4924,14-02-2021 20:00,24 hrs.,pennystocks,CNET,26,0,26,-26,1,0,22,1,NASDAQ
4924,14-02-2021 20:00,24 hrs.,pennystocks,COCP,29,29,0,29,1,10,5,1,NASDAQ
4924,14-02-2021 20:00,24 hrs.,pennystocks,CRBP,108,108,0,108,2,38,24,2,NASDAQ
4924,14-02-2021 20:00,24 hrs.,pennystocks,CREX,150,102,48,54,2,46,50,2,NASDAQ
4924,14-02-2021 20:00,24 hrs.,pennystocks,CSCW,25,0,25,-25,2,6,5,2,NASDAQ
4924,14-02-2021 20:00,24 hrs.,pennystocks,CSTR,9,0,9,-9,1,0,5,1,NASDAQ
4924,14-02-2021 20:00,24 hrs.,pennystocks,CTMX,162,162,0,162,1,59,40,1,NASDAQ
4924,14-02-2021 20:00,24 hrs.,pennystocks,CTRM,237,109,128,-19,6,78,57,6,NASDAQ
4924,14-02-2021 20:00,24 hrs.,pennystocks,CXDC,26,0,26,-26,1,0,22,1,NASDAQ
4924,14-02-2021 20:00,24 hrs.,pennystocks,DFFN,248,162,86,76,3,89,58,3,NASDAQ
4924,14-02-2021 20:00,24 hrs.,pennystocks,EPR,16,0,16,-16,1,0,12,1,NYSE
4924,14-02-2021 20:00,24 hrs.,pennystocks,FLT,34,0,34,-34,1,8,14,1,NYSE
4924,14-02-2021 20:00,24 hrs.,pennystocks,GME,12,6,6,0,2,2,0,2,NYSE
4924,14-02-2021 20:00,24 hrs.,pennystocks,HPQ,6,6,0,6,1,1,0,1,NYSE
4924,14-02-2021 20:00,24 hrs.,pennystocks,IRS,192,192,0,192,1,85,18,1,NYSE
4924,14-02-2021 20:00,24 hrs.,pennystocks,NAT,6,6,0,6,1,1,0,1,NYSE
4924,14-02-2021 20:00,24 hrs.,pennystocks,PDT,23,0,23,-23,1,4,11,1,NYSE
4924,14-02-2021 20:00,24 hrs.,pennystocks,PEG,1112,21,1091,-1070,2,513,78,2,NYSE
4924,14-02-2021 20:00,24 hrs.,pennystocks,RSI,1138,21,1117,-1096,3,513,100,3,NYSE
4924,14-02-2021 20:00,24 hrs.,pennystocks,RYB,26,0,26,-26,1,0,22,1,NYSE
4924,14-02-2021 20:00,24 hrs.,pennystocks,SOS,332,260,72,188,10,107,78,9,NYSE
4924,14-02-2021 20:00,24 hrs.,pennystocks,STG,26,0,26,-26,1,0,22,1,NYSE
4924,14-02-2021 20:00,24 hrs.,pennystocks,SUP,41,0,41,-41,1,17,3,1,NYSE
4924,14-02-2021 20:00,24 hrs.,pennystocks,WEI,26,0,26,-26,1,0,22,1,NYSE
4924,14-02-2021 20:00,24 hrs.,pennystocks,XIN,26,0,26,-26,1,0,22,1,NYSE
4924,14-02-2021 20:00,24 hrs.,pennystocks,XYF,26,0,26,-26,1,0,22,1,NYSE
4924,14-02-2021 20:00,24 hrs.,pennystocks,BGI,41,0,41,-41,1,17,3,1,AMEX
4924,14-02-2021 20:00,24 hrs.,pennystocks,DNN,29,6,23,-17,3,2,13,3,AMEX
4924,14-02-2021 20:00,24 hrs.,pennystocks,DPW,162,162,0,162,1,59,40,1,AMEX
4924,14-02-2021 20:00,24 hrs.,pennystocks,DXF,26,0,26,-26,1,0,22,1,AMEX
4924,14-02-2021 20:00,24 hrs.,pennystocks,GSV,6,0,6,-6,1,1,0,1,AMEX
4924,14-02-2021 20:00,24 hrs.,pennystocks,GTE,35,35,0,35,1,10,11,1,AMEX
4924,14-02-2021 20:00,24 hrs.,pennystocks,ITP,26,0,26,-26,1,0,22,1,AMEX
4924,14-02-2021 20:00,24 hrs.,pennystocks,NBY,162,162,0,162,1,59,40,1,AMEX
4924,14-02-2021 20:00,24 hrs.,pennystocks,NTN,41,0,41,-41,1,17,3,1,AMEX
4924,14-02-2021 20:00,24 hrs.,pennystocks,RHE,41,0,41,-41,1,17,3,1,AMEX
4924,14-02-2021 20:00,24 hrs.,pennystocks,SYN,7,0,7,-7,1,1,1,1,AMEX
4924,14-02-2021 20:00,24 hrs.,pennystocks,TRX,6,6,0,6,1,1,0,1,AMEX
4924,14-02-2021 20:00,24 hrs.,pennystocks,ZOM,53,33,20,13,3,12,17,3,AMEX
4924,14-02-2021 20:00,24 hrs.,pennystocks,AMBO,26,0,26,-26,1,0,22,1,AMEX
4924,14-02-2021 20:00,24 hrs.,pennystocks,AMPE,41,0,41,-41,1,17,3,1,AMEX
4924,14-02-2021 20:00,24 hrs.,pennystocks,CPHI,26,0,26,-26,1,0,22,1,AMEX
4924,14-02-2021 20:00,24 hrs.,pennystocks,TKAT,26,0,26,-26,1,0,22,1,AMEX
4924,14-02-2021 20:00,24 hrs.,pennystocks,TMBR,41,0,41,-41,1,17,3,1,AMEX
4924,14-02-2021 20:00,24 hrs.,pennystocks,ABC,4581,0,4581,-4581,1,2136,305,1,NYSE
4924,14-02-2021 20:00,24 hrs.,pennystocks,ALB,39,39,0,39,1,11,13,1,NYSE
4924,14-02-2021 20:00,24 hrs.,pennystocks,ASX,41,41,0,41,7,6,1,2,NYSE
4924,14-02-2021 20:00,24 hrs.,pennystocks,BKD,32,32,0,32,1,11,6,1,NYSE
4924,14-02-2021 20:00,24 hrs.,pennystocks,CBD,183,162,21,141,2,65,45,2,NYSE
4924,14-02-2021 20:00,24 hrs.,pennystocks,CCM,26,0,26,-26,1,0,22,1,NYSE
4924,14-02-2021 20:00,24 hrs.,pennystocks,CMC,73,73,0,73,1,22,25,1,NYSE
4924,14-02-2021 20:00,24 hrs.,pennystocks,CNF,26,0,26,-26,1,0,22,1,NYSE
4924,14-02-2021 20:00,24 hrs.,pennystocks,CVE,39,39,0,39,1,11,13,1,NYSE
4924,14-02-2021 20:00,24 hrs.,pennystocks,DNK,26,0,26,-26,1,0,22,1,NYSE
4924,14-02-2021 20:00,24 hrs.,pennystocks,RBNW,6,0,6,-6,1,1,0,1,OTC
4924,14-02-2021 20:00,24 hrs.,pennystocks,RSSV,49,0,49,-49,1,12,21,1,OTC
4924,14-02-2021 20:00,24 hrs.,pennystocks,SAFS,6,0,6,-6,1,1,0,1,OTC
4924,14-02-2021 20:00,24 hrs.,pennystocks,SGMD,53,0,53,-53,1,16,17,1,OTC
4924,14-02-2021 20:00,24 hrs.,pennystocks,SGSI,32,32,0,32,1,11,6,1,OTC
4924,14-02-2021 20:00,24 hrs.,pennystocks,SHMP,6,6,0,6,1,1,0,1,OTC
4924,14-02-2021 20:00,24 hrs.,pennystocks,PLIN,26,0,26,-26,1,0,22,1,NASDAQ
4924,14-02-2021 20:00,24 hrs.,pennystocks,PULM,6,6,0,6,1,1,0,1,NASDAQ
4924,14-02-2021 20:00,24 hrs.,pennystocks,RAVE,41,0,41,-41,1,17,3,1,NASDAQ
4924,14-02-2021 20:00,24 hrs.,pennystocks,RCON,26,0,26,-26,1,0,22,1,NASDAQ
4924,14-02-2021 20:00,24 hrs.,pennystocks,RETO,26,0,26,-26,1,0,22,1,NASDAQ
4924,14-02-2021 20:00,24 hrs.,pennystocks,RUHN,26,0,26,-26,1,0,22,1,NASDAQ
4924,14-02-2021 20:00,24 hrs.,pennystocks,RWLK,41,0,41,-41,1,17,3,1,NASDAQ
4924,14-02-2021 20:00,24 hrs.,pennystocks,SALM,41,0,41,-41,1,17,3,1,NASDAQ
4924,14-02-2021 20:00,24 hrs.,pennystocks,SAVA,49,0,49,-49,1,12,21,1,NASDAQ
4924,14-02-2021 20:00,24 hrs.,pennystocks,SECO,26,0,26,-26,1,0,22,1,NASDAQ
4924,14-02-2021 20:00,24 hrs.,pennystocks,SELF,6,6,0,6,1,1,0,1,NASDAQ
4924,14-02-2021 20:00,24 hrs.,pennystocks,SESN,29,29,0,29,1,6,13,1,NASDAQ
4924,14-02-2021 20:00,24 hrs.,pennystocks,SGOC,26,0,26,-26,1,0,22,1,NASDAQ
4924,14-02-2021 20:00,24 hrs.,pennystocks,SHIP,161,114,47,67,5,57,27,4,NASDAQ
4924,14-02-2021 20:00,24 hrs.,pennystocks,ABBV,22,22,0,22,1,5,8,1,NYSE
4924,14-02-2021 20:00,24 hrs.,pennystocks,ARGO,267,267,0,267,2,90,79,2,NYSE
4924,14-02-2021 20:00,24 hrs.,pennystocks,BORR,7,0,7,-7,1,1,1,1,NYSE
4924,14-02-2021 20:00,24 hrs.,pennystocks,CMCM,26,0,26,-26,1,0,22,1,NYSE
4924,14-02-2021 20:00,24 hrs.,pennystocks,FEDU,26,0,26,-26,1,0,22,1,NYSE
4924,14-02-2021 20:00,24 hrs.,pennystocks,FENG,26,0,26,-26,1,0,22,1,NYSE
4924,14-02-2021 20:00,24 hrs.,pennystocks,LAIX,26,0,26,-26,1,0,22,1,NYSE
4924,14-02-2021 20:00,24 hrs.,pennystocks,LEJU,26,0,26,-26,1,0,22,1,NYSE
4924,14-02-2021 20:00,24 hrs.,pennystocks,LITB,26,0,26,-26,1,0,22,1,NYSE
4924,14-02-2021 20:00,24 hrs.,pennystocks,MOGU,26,0,26,-26,1,0,22,1,NYSE
4924,14-02-2021 20:00,24 hrs.,pennystocks,WELL,7,0,7,-7,1,1,1,1,NYSE
4924,14-02-2021 20:00,24 hrs.,pennystocks,CIH,26,0,26,-26,1,0,22,1,NASDAQ
4924,14-02-2021 20:00,24 hrs.,pennystocks,EVK,26,0,26,-26,1,0,22,1,NASDAQ
4924,14-02-2021 20:00,24 hrs.,pennystocks,GLG,26,0,26,-26,1,0,22,1,NASDAQ
4924,14-02-2021 20:00,24 hrs.,pennystocks,JFU,26,0,26,-26,1,0,22,1,NASDAQ
4924,14-02-2021 20:00,24 hrs.,pennystocks,LYL,26,0,26,-26,1,0,22,1,NASDAQ
4924,14-02-2021 20:00,24 hrs.,pennystocks,MKD,26,0,26,-26,1,0,22,1,NASDAQ
4924,14-02-2021 20:00,24 hrs.,pennystocks,MTC,26,0,26,-26,1,0,22,1,NASDAQ
4924,14-02-2021 20:00,24 hrs.,pennystocks,MYT,26,0,26,-26,1,0,22,1,NASDAQ
4924,14-02-2021 20:00,24 hrs.,pennystocks,OLB,6,6,0,6,1,1,0,1,NASDAQ
4924,14-02-2021 20:00,24 hrs.,pennystocks,OSN,26,0,26,-26,1,0,22,1,NASDAQ
4924,14-02-2021 20:00,24 hrs.,pennystocks,PME,26,0,26,-26,1,0,22,1,NASDAQ
4924,14-02-2021 20:00,24 hrs.,pennystocks,PPH,15,0,15,-15,1,1,9,1,NASDAQ
4924,14-02-2021 20:00,24 hrs.,pennystocks,SND,162,162,0,162,1,59,40,1,NASDAQ
4924,14-02-2021 20:00,24 hrs.,pennystocks,AAPL,1112,21,1091,-1070,2,513,78,2,NASDAQ
4924,14-02-2021 20:00,24 hrs.,pennystocks,ABEO,162,162,0,162,1,59,40,1,NASDAQ
4924,14-02-2021 20:00,24 hrs.,pennystocks,ACHV,49,0,49,-49,1,12,21,1,NASDAQ
4924,14-02-2021 20:00,24 hrs.,pennystocks,ADMP,7,7,0,7,1,1,1,1,NASDAQ
4924,14-02-2021 20:00,24 hrs.,pennystocks,ADTX,19,19,0,19,1,0,15,1,NASDAQ
4924,14-02-2021 20:00,24 hrs.,pennystocks,ADXS,6,0,6,-6,1,1,0,1,NASDAQ
4924,14-02-2021 20:00,24 hrs.,pennystocks,AEZS,28,0,28,-28,1,9,6,1,NASDAQ
4924,14-02-2021 20:00,24 hrs.,pennystocks,AGTC,20,20,0,20,1,6,4,1,NASDAQ
4924,14-02-2021 20:00,24 hrs.,pennystocks,AIHS,26,0,26,-26,1,0,22,1,NASDAQ
4924,14-02-2021 20:00,24 hrs.,pennystocks,ARTL,143,102,41,61,2,54,27,2,NASDAQ
4924,14-02-2021 20:00,24 hrs.,pennystocks,ASLN,26,0,26,-26,1,0,22,1,NASDAQ
4924,14-02-2021 20:00,24 hrs.,pennystocks,ASRT,6,0,6,-6,1,1,0,1,NASDAQ
4924,14-02-2021 20:00,24 hrs.,pennystocks,ATOS,79,45,34,11,3,12,43,3,NASDAQ
4924,14-02-2021 20:00,24 hrs.,pennystocks,AUTL,7,0,7,-7,1,0,3,1,NASDAQ
4924,14-02-2021 20:00,24 hrs.,pennystocks,AYRO,41,0,41,-41,1,17,3,1,NASDAQ
4924,14-02-2021 20:00,24 hrs.,pennystocks,BHAT,26,0,26,-26,1,0,22,1,NASDAQ
4924,14-02-2021 20:00,24 hrs.,pennystocks,BHTG,9,9,0,9,1,0,5,1,NASDAQ
4924,14-02-2021 20:00,24 hrs.,pennystocks,BIMI,26,0,26,-26,1,0,22,1,NASDAQ
4924,14-02-2021 20:00,24 hrs.,pennystocks,BNGO,469,0,469,-469,3,147,163,2,NASDAQ
4924,14-02-2021 20:00,24 hrs.,pennystocks,BRQS,26,0,26,-26,1,0,22,1,NASDAQ
4924,14-02-2021 20:00,24 hrs.,pennystocks,BVXV,6,0,6,-6,1,1,0,1,NASDAQ
4924,14-02-2021 20:00,24 hrs.,pennystocks,BWEN,6,0,6,-6,1,1,0,1,NASDAQ
4924,14-02-2021 20:00,24 hrs.,pennystocks,CCRC,26,0,26,-26,1,0,22,1,NASDAQ
4924,14-02-2021 20:00,24 hrs.,pennystocks,CFMS,13,13,0,13,2,2,1,1,NASDAQ
4924,14-02-2021 20:00,24 hrs.,pennystocks,CHEK,6,6,0,6,1,1,0,1,NASDAQ
4924,14-02-2021 20:00,24 hrs.,pennystocks,CHNR,26,0,26,-26,1,0,22,1,NASDAQ
4924,14-02-2021 20:00,24 hrs.,RobinHoodPennyStocks,AKBA,7,0,7,-7,1,1,1,1,NASDAQ
4924,14-02-2021 20:00,24 hrs.,RobinHoodPennyStocks,ARTL,6,6,0,6,1,1,0,1,NASDAQ
4924,14-02-2021 20:00,24 hrs.,RobinHoodPennyStocks,ASRT,19,6,13,-7,2,2,7,2,NASDAQ
4924,14-02-2021 20:00,24 hrs.,RobinHoodPennyStocks,BRQS,22,22,0,22,1,7,4,1,NASDAQ
4924,14-02-2021 20:00,24 hrs.,RobinHoodPennyStocks,BVXV,6,0,6,-6,1,1,0,1,NASDAQ
4924,14-02-2021 20:00,24 hrs.,RobinHoodPennyStocks,CLBS,77,77,0,77,1,27,19,1,NASDAQ
4924,14-02-2021 20:00,24 hrs.,RobinHoodPennyStocks,CRBP,58,58,0,58,2,19,12,2,NASDAQ
4924,14-02-2021 20:00,24 hrs.,RobinHoodPennyStocks,CSTR,4,0,4,-4,1,0,0,1,NASDAQ
4924,14-02-2021 20:00,24 hrs.,RobinHoodPennyStocks,CTMX,77,77,0,77,1,27,19,1,NASDAQ
4924,14-02-2021 20:00,24 hrs.,RobinHoodPennyStocks,CTRM,6,6,0,6,1,1,0,1,NASDAQ
4924,14-02-2021 20:00,24 hrs.,RobinHoodPennyStocks,DFFN,123,123,0,123,4,40,27,4,NASDAQ
4924,14-02-2021 20:00,24 hrs.,RobinHoodPennyStocks,GLBS,77,77,0,77,1,27,19,1,NASDAQ
4924,14-02-2021 20:00,24 hrs.,RobinHoodPennyStocks,GOGO,11,0,11,-11,1,0,7,1,NASDAQ
4924,14-02-2021 20:00,24 hrs.,RobinHoodPennyStocks,GRPN,37,6,31,-25,2,9,11,2,NASDAQ
4924,14-02-2021 20:00,24 hrs.,pennystocks,DOGZ,26,0,26,-26,1,0,22,1,NASDAQ
4924,14-02-2021 20:00,24 hrs.,pennystocks,DSWL,26,0,26,-26,1,0,22,1,NASDAQ
4924,14-02-2021 20:00,24 hrs.,pennystocks,DTSS,26,0,26,-26,1,0,22,1,NASDAQ
4924,14-02-2021 20:00,24 hrs.,pennystocks,ECOR,29,29,0,29,1,6,13,1,NASDAQ
4924,14-02-2021 20:00,24 hrs.,pennystocks,EDIT,1303,109,1194,-1085,2,398,499,2,NASDAQ
4924,14-02-2021 20:00,24 hrs.,pennystocks,EDTK,26,0,26,-26,1,0,22,1,NASDAQ
4924,14-02-2021 20:00,24 hrs.,pennystocks,EYES,6,0,6,-6,1,1,0,1,NASDAQ
4924,14-02-2021 20:00,24 hrs.,pennystocks,FAMI,26,0,26,-26,1,0,22,1,NASDAQ
4924,14-02-2021 20:00,24 hrs.,pennystocks,FLMN,6,0,6,-6,1,1,0,1,NASDAQ
4924,14-02-2021 20:00,24 hrs.,pennystocks,FTFT,48,7,41,-34,2,18,4,2,NASDAQ
4924,14-02-2021 20:00,24 hrs.,pennystocks,GIGM,26,0,26,-26,1,0,22,1,NASDAQ
4924,14-02-2021 20:00,24 hrs.,pennystocks,GLBS,162,162,0,162,1,59,40,1,NASDAQ
4924,14-02-2021 20:00,24 hrs.,pennystocks,GNUS,6,0,6,-6,1,1,0,1,NASDAQ
4924,14-02-2021 20:00,24 hrs.,pennystocks,GRIL,41,0,41,-41,1,17,3,1,NASDAQ
4924,14-02-2021 20:00,24 hrs.,pennystocks,GRNQ,26,0,26,-26,1,0,22,1,NASDAQ
4924,14-02-2021 20:00,24 hrs.,pennystocks,GSUM,26,0,26,-26,1,0,22,1,NASDAQ
4924,14-02-2021 20:00,24 hrs.,pennystocks,GTHX,6,0,6,-6,1,1,0,1,NASDAQ
4924,14-02-2021 20:00,24 hrs.,pennystocks,GURE,26,0,26,-26,1,0,22,1,NASDAQ
4924,14-02-2021 20:00,24 hrs.,pennystocks,HAPP,26,0,26,-26,1,0,22,1,NASDAQ
4924,14-02-2021 20:00,24 hrs.,pennystocks,HCDI,16,0,16,-16,1,2,8,1,NASDAQ
4924,14-02-2021 20:00,24 hrs.,pennystocks,HGSH,26,0,26,-26,1,0,22,1,NASDAQ
4924,14-02-2021 20:00,24 hrs.,pennystocks,HIHO,26,0,26,-26,1,0,22,1,NASDAQ
4924,14-02-2021 20:00,24 hrs.,pennystocks,HUSN,41,0,41,-41,1,17,3,1,NASDAQ
4924,14-02-2021 20:00,24 hrs.,pennystocks,ILMN,41,0,41,-41,1,17,3,1,NASDAQ
4924,14-02-2021 20:00,24 hrs.,pennystocks,JAGX,36,0,36,-36,3,11,2,2,NASDAQ
4924,14-02-2021 20:00,24 hrs.,pennystocks,JFIN,128,102,26,76,2,37,46,2,NASDAQ
4924,14-02-2021 20:00,24 hrs.,pennystocks,KBSF,26,0,26,-26,1,0,22,1,NASDAQ
4924,14-02-2021 20:00,24 hrs.,pennystocks,KRKR,26,0,26,-26,1,0,22,1,NASDAQ
4924,14-02-2021 20:00,24 hrs.,pennystocks,KTRA,29,29,0,29,1,6,13,1,NASDAQ
4924,14-02-2021 20:00,24 hrs.,pennystocks,KXIN,26,0,26,-26,1,0,22,1,NASDAQ
4924,14-02-2021 20:00,24 hrs.,pennystocks,LAZY,7,7,0,7,1,1,1,1,NASDAQ
4924,14-02-2021 20:00,24 hrs.,pennystocks,LGHL,41,0,41,-41,1,17,3,1,NASDAQ
4924,14-02-2021 20:00,24 hrs.,pennystocks,LIVE,23,0,23,-23,1,7,5,1,NASDAQ
4924,14-02-2021 20:00,24 hrs.,pennystocks,LKCO,67,0,67,-67,2,17,25,2,NASDAQ
4924,14-02-2021 20:00,24 hrs.,pennystocks,LLNW,6,0,6,-6,1,1,0,1,NASDAQ
4924,14-02-2021 20:00,24 hrs.,pennystocks,MDJH,26,0,26,-26,1,0,22,1,NASDAQ
4924,14-02-2021 20:00,24 hrs.,pennystocks,METX,26,0,26,-26,1,0,22,1,NASDAQ
4924,14-02-2021 20:00,24 hrs.,pennystocks,MOHO,26,0,26,-26,1,0,22,1,NASDAQ
4924,14-02-2021 20:00,24 hrs.,pennystocks,MOSY,41,0,41,-41,1,17,3,1,NASDAQ
4924,14-02-2021 20:00,24 hrs.,pennystocks,MOXC,26,0,26,-26,1,0,22,1,NASDAQ
4924,14-02-2021 20:00,24 hrs.,pennystocks,NAKD,177,162,15,147,3,60,45,3,NASDAQ
4924,14-02-2021 20:00,24 hrs.,pennystocks,NEWA,26,0,26,-26,1,0,22,1,NASDAQ
4924,14-02-2021 20:00,24 hrs.,pennystocks,NOVN,12,12,0,12,2,2,0,1,NASDAQ
4924,14-02-2021 20:00,24 hrs.,pennystocks,NVAX,19,19,0,19,1,0,15,1,NASDAQ
4924,14-02-2021 20:00,24 hrs.,pennystocks,NVCN,36,29,7,22,2,11,6,2,NASDAQ
4924,14-02-2021 20:00,24 hrs.,pennystocks,OPGN,7,0,7,-7,1,1,1,1,NASDAQ
4924,14-02-2021 20:00,24 hrs.,pennystocks,PBTS,26,0,26,-26,1,0,22,1,NASDAQ
4924,14-02-2021 20:00,24 hrs.,pennystocks,PETZ,26,0,26,-26,1,0,22,1,NASDAQ
4924,14-02-2021 20:00,24 hrs.,pennystocks,PHCF,26,0,26,-26,1,0,22,1,NASDAQ
4924,14-02-2021 20:00,24 hrs.,pennystocks,PLAY,12,6,6,0,2,2,0,2,NASDAQ
4924,14-02-2021 20:00,24 hrs.,RobinHoodPennyStocks,IDEX,28,22,6,16,2,8,4,2,NASDAQ
4924,14-02-2021 20:00,24 hrs.,RobinHoodPennyStocks,INPX,6,6,0,6,1,1,0,1,NASDAQ
4924,14-02-2021 20:00,24 hrs.,RobinHoodPennyStocks,JAGX,193,0,193,-193,1,79,31,1,NASDAQ
4924,14-02-2021 20:00,24 hrs.,RobinHoodPennyStocks,MARA,33,0,33,-33,1,3,23,1,NASDAQ
4924,14-02-2021 20:00,24 hrs.,RobinHoodPennyStocks,MVIS,22,22,0,22,1,7,4,1,NASDAQ
4924,14-02-2021 20:00,24 hrs.,RobinHoodPennyStocks,MYSZ,6,6,0,6,1,1,0,1,NASDAQ
4924,14-02-2021 20:00,24 hrs.,RobinHoodPennyStocks,NAKD,77,77,0,77,1,27,19,1,NASDAQ
4924,14-02-2021 20:00,24 hrs.,RobinHoodPennyStocks,NOVN,12,12,0,12,2,2,0,2,NASDAQ
4924,14-02-2021 20:00,24 hrs.,RobinHoodPennyStocks,PFMT,12,12,0,12,2,2,0,1,NASDAQ
4924,14-02-2021 20:00,24 hrs.,RobinHoodPennyStocks,PULM,7,7,0,7,1,1,1,1,NASDAQ
4924,14-02-2021 20:00,24 hrs.,RobinHoodPennyStocks,SNDL,144,132,12,120,6,48,24,4,NASDAQ
4924,14-02-2021 20:00,24 hrs.,RobinHoodPennyStocks,TNXP,30,12,18,-6,5,5,0,2,NASDAQ
4924,14-02-2021 20:00,24 hrs.,RobinHoodPennyStocks,TRCH,6,0,6,-6,1,1,0,1,NASDAQ
4924,14-02-2021 20:00,24 hrs.,RobinHoodPennyStocks,TXMD,13,0,13,-13,1,1,7,1,NASDAQ
4924,14-02-2021 20:00,24 hrs.,pennystocks,SNDL,19,6,13,-7,3,3,1,3,NASDAQ
4924,14-02-2021 20:00,24 hrs.,pennystocks,SNGX,12,0,12,-12,2,2,0,2,NASDAQ
4924,14-02-2021 20:00,24 hrs.,pennystocks,SXTC,26,0,26,-26,1,0,22,1,NASDAQ
4924,14-02-2021 20:00,24 hrs.,pennystocks,TANH,26,0,26,-26,1,0,22,1,NASDAQ
4924,14-02-2021 20:00,24 hrs.,pennystocks,TAOP,26,0,26,-26,1,0,22,1,NASDAQ
4924,14-02-2021 20:00,24 hrs.,pennystocks,TEDU,26,0,26,-26,1,0,22,1,NASDAQ
4924,14-02-2021 20:00,24 hrs.,pennystocks,TNXP,142,44,98,-54,4,42,42,4,NASDAQ
4924,14-02-2021 20:00,24 hrs.,pennystocks,TOPS,41,0,41,-41,1,17,3,1,NASDAQ
4924,14-02-2021 20:00,24 hrs.,pennystocks,TOUR,26,0,26,-26,1,0,22,1,NASDAQ
4924,14-02-2021 20:00,24 hrs.,pennystocks,TRVG,41,0,41,-41,1,17,3,1,NASDAQ
4924,14-02-2021 20:00,24 hrs.,pennystocks,TXMD,7,0,7,-7,1,1,1,1,NASDAQ
4924,14-02-2021 20:00,24 hrs.,pennystocks,TYHT,26,0,26,-26,1,0,22,1,NASDAQ
4924,14-02-2021 20:00,24 hrs.,pennystocks,USWS,6,0,6,-6,1,1,0,1,NASDAQ
4924,14-02-2021 20:00,24 hrs.,pennystocks,UTSI,26,0,26,-26,1,0,22,1,NASDAQ
4924,14-02-2021 20:00,24 hrs.,pennystocks,UXIN,26,0,26,-26,1,0,22,1,NASDAQ
4924,14-02-2021 20:00,24 hrs.,pennystocks,VYNE,33,0,33,-33,2,6,13,1,NASDAQ
4924,14-02-2021 20:00,24 hrs.,pennystocks,ZCMD,26,0,26,-26,1,0,22,1,NASDAQ
4924,14-02-2021 20:00,24 hrs.,pennystocks,ZSAN,46,0,46,-46,1,0,42,1,NASDAQ
4924,14-02-2021 20:00,24 hrs.,RobinHoodPennyStocks,HCMC,6,0,6,-6,1,1,0,1,OTC
4924,14-02-2021 20:00,24 hrs.,RobinHoodPennyStocks,MJNA,10,10,0,10,1,0,6,1,OTC
4924,14-02-2021 20:00,24 hrs.,RobinHoodPennyStocks,RTSL,6,0,6,-6,1,1,0,1,OTC
4924,14-02-2021 20:00,24 hrs.,RobinHoodPennyStocks,SGMD,6,0,6,-6,1,1,0,1,OTC
4924,14-02-2021 20:00,24 hrs.,RobinHoodPennyStocks,SSFT,15,15,0,15,1,0,11,1,OTC
4924,14-02-2021 20:00,24 hrs.,RobinHoodPennyStocks,ARBKF,33,0,33,-33,1,3,23,1,OTC
4924,14-02-2021 20:00,24 hrs.,RobinHoodPennyStocks,EMHTF,6,0,6,-6,1,1,0,1,OTC
4924,14-02-2021 20:00,24 hrs.,RobinHoodPennyStocks,LMNGF,8,8,0,8,1,1,2,1,OTC
4924,14-02-2021 20:00,24 hrs.,RobinHoodPennyStocks,TBPMF,7,0,7,-7,1,1,1,1,OTC
4924,14-02-2021 20:00,24 hrs.,RobinHoodPennyStocks,DNN,81,12,69,-57,3,24,21,3,AMEX
4924,14-02-2021 20:00,24 hrs.,RobinHoodPennyStocks,DPW,77,77,0,77,1,27,19,1,AMEX
4924,14-02-2021 20:00,24 hrs.,RobinHoodPennyStocks,GTE,59,18,41,-23,4,13,17,4,AMEX
4924,14-02-2021 20:00,24 hrs.,RobinHoodPennyStocks,NAK,6,0,6,-6,1,1,0,1,AMEX
4924,14-02-2021 20:00,24 hrs.,RobinHoodPennyStocks,NBY,77,77,0,77,1,27,19,1,AMEX
4924,14-02-2021 20:00,24 hrs.,RobinHoodPennyStocks,PTN,68,0,68,-68,1,26,12,1,AMEX
4924,14-02-2021 20:00,24 hrs.,RobinHoodPennyStocks,SYN,6,0,6,-6,1,1,0,1,AMEX
4924,14-02-2021 20:00,24 hrs.,RobinHoodPennyStocks,ZOM,509,6,503,-497,3,195,107,3,AMEX
4924,14-02-2021 20:00,24 hrs.,RobinHoodPennyStocks,XXII,6,0,6,-6,1,1,0,1,AMEX
4924,14-02-2021 20:00,24 hrs.,RobinHoodPennyStocks,BDN,6,6,0,6,1,1,0,1,NYSE
4924,14-02-2021 20:00,24 hrs.,RobinHoodPennyStocks,EPR,69,0,69,-69,1,22,21,1,NYSE
4924,14-02-2021 20:00,24 hrs.,RobinHoodPennyStocks,GME,8,0,8,-8,1,1,2,1,NYSE
4924,14-02-2021 20:00,24 hrs.,RobinHoodPennyStocks,NOK,8,0,8,-8,1,1,2,1,NYSE
4924,14-02-2021 20:00,24 hrs.,RobinHoodPennyStocks,PEG,1136,20,1116,-1096,2,528,72,2,NYSE
4924,14-02-2021 20:00,24 hrs.,RobinHoodPennyStocks,RSI,1136,20,1116,-1096,2,528,72,2,NYSE
4924,14-02-2021 20:00,24 hrs.,RobinHoodPennyStocks,SOS,83,77,6,71,2,28,19,2,NYSE
4924,14-02-2021 20:00,24 hrs.,RobinHoodPennyStocks,WTM,6,6,0,6,1,1,0,1,NYSE
4924,14-02-2021 20:00,24 hrs.,RobinHoodPennyStocks,DECK,6,0,6,-6,1,1,0,1,NYSE
4924,14-02-2021 20:00,24 hrs.,RobinHoodPennyStocks,SND,77,77,0,77,1,27,19,1,NASDAQ
4924,14-02-2021 20:00,24 hrs.,RobinHoodPennyStocks,AAPL,1136,20,1116,-1096,2,528,72,2,NASDAQ
4924,14-02-2021 20:00,24 hrs.,RobinHoodPennyStocks,ABEO,77,77,0,77,1,27,19,1,NASDAQ
4924,14-02-2021 20:00,24 hrs.,RobinHoodPennyStocks,ADXS,6,0,6,-6,1,1,0,1,NASDAQ
4924,14-02-2021 20:00,24 hrs.,RobinHoodPennyStocks,AGTC,359,0,359,-359,1,137,81,1,NASDAQ
4888,14-02-2021 14:00,24 hrs.,pennystocks,BDRBF,6,0,6,-6,1,1,0,1,OTC
4888,14-02-2021 14:00,24 hrs.,pennystocks,BKTPF,27,27,0,27,1,7,9,1,OTC
4888,14-02-2021 14:00,24 hrs.,pennystocks,BUROF,31,25,6,19,2,9,5,2,OTC
4888,14-02-2021 14:00,24 hrs.,pennystocks,CHOOF,6,6,0,6,1,1,0,1,OTC
4888,14-02-2021 14:00,24 hrs.,pennystocks,CINGF,45,45,0,45,1,11,19,1,OTC
4888,14-02-2021 14:00,24 hrs.,pennystocks,CLXPF,254,0,254,-254,1,95,60,1,OTC
4888,14-02-2021 14:00,24 hrs.,pennystocks,COCSF,13,0,13,-13,1,3,3,1,OTC
4888,14-02-2021 14:00,24 hrs.,pennystocks,EMHTF,30,0,30,-30,1,9,8,1,OTC
4888,14-02-2021 14:00,24 hrs.,pennystocks,GKPRF,7,7,0,7,1,1,1,1,OTC
4888,14-02-2021 14:00,24 hrs.,pennystocks,HITIF,1280,0,1280,-1280,5,523,214,5,OTC
4888,14-02-2021 14:00,24 hrs.,pennystocks,HTZGQ,6,6,0,6,1,1,0,1,OTC
4888,14-02-2021 14:00,24 hrs.,pennystocks,ICNAF,6,6,0,6,1,1,0,1,OTC
4888,14-02-2021 14:00,24 hrs.,pennystocks,ILHMF,7,0,7,-7,1,1,1,1,OTC
4888,14-02-2021 14:00,24 hrs.,pennystocks,ITMPF,12,0,12,-12,2,2,0,1,OTC
4888,14-02-2021 14:00,24 hrs.,pennystocks,LTMCF,6,0,6,-6,1,1,0,1,OTC
4888,14-02-2021 14:00,24 hrs.,pennystocks,MMEDF,116,0,116,-116,3,23,58,3,OTC
4888,14-02-2021 14:00,24 hrs.,pennystocks,MMNFF,33,0,33,-33,1,13,3,1,OTC
4888,14-02-2021 14:00,24 hrs.,pennystocks,MPUCF,7,0,7,-7,1,1,1,1,OTC
4888,14-02-2021 14:00,24 hrs.,pennystocks,NMGRF,52,0,52,-52,2,18,8,1,OTC
4888,14-02-2021 14:00,24 hrs.,pennystocks,NMTLF,22,0,22,-22,1,7,4,1,OTC
4888,14-02-2021 14:00,24 hrs.,pennystocks,SNNAF,27,27,0,27,1,7,9,1,OTC
4888,14-02-2021 14:00,24 hrs.,pennystocks,SPMTF,27,27,0,27,1,7,9,1,OTC
4888,14-02-2021 14:00,24 hrs.,pennystocks,SPRWF,7,7,0,7,1,1,1,1,OTC
4888,14-02-2021 14:00,24 hrs.,pennystocks,TAKOF,119,0,119,-119,3,31,45,3,OTC
4888,14-02-2021 14:00,24 hrs.,pennystocks,TLOFF,78,0,78,-78,1,17,40,1,OTC
4888,14-02-2021 14:00,24 hrs.,pennystocks,TOWTF,12,0,12,-12,2,2,0,1,OTC
4888,14-02-2021 14:00,24 hrs.,pennystocks,TRCNF,16,16,0,16,1,3,6,1,OTC
4888,14-02-2021 14:00,24 hrs.,pennystocks,TRUFF,6,0,6,-6,1,1,0,1,OTC
4888,14-02-2021 14:00,24 hrs.,pennystocks,TSCRF,38,0,38,-38,1,11,12,1,OTC
4888,14-02-2021 14:00,24 hrs.,pennystocks,WALRF,45,45,0,45,1,11,19,1,OTC
4888,14-02-2021 14:00,24 hrs.,pennystocks,BGI,33,0,33,-33,1,13,3,1,AMEX
4888,14-02-2021 14:00,24 hrs.,pennystocks,CTO,927,0,927,-927,1,384,155,1,AMEX
4888,14-02-2021 14:00,24 hrs.,pennystocks,CVM,6,0,6,-6,1,1,0,1,AMEX
4888,14-02-2021 14:00,24 hrs.,pennystocks,DNN,33,26,7,19,4,3,11,4,AMEX
4888,14-02-2021 14:00,24 hrs.,pennystocks,DXF,24,24,0,24,1,0,20,1,AMEX
4888,14-02-2021 14:00,24 hrs.,pennystocks,GSV,6,6,0,6,1,1,0,1,AMEX
4888,14-02-2021 14:00,24 hrs.,pennystocks,ITP,24,24,0,24,1,0,20,1,AMEX
4888,14-02-2021 14:00,24 hrs.,pennystocks,NTN,33,0,33,-33,1,13,3,1,AMEX
4888,14-02-2021 14:00,24 hrs.,pennystocks,RHE,33,0,33,-33,1,13,3,1,AMEX
4888,14-02-2021 14:00,24 hrs.,pennystocks,SYN,7,7,0,7,1,1,1,1,AMEX
4888,14-02-2021 14:00,24 hrs.,pennystocks,TRX,6,6,0,6,1,1,0,1,AMEX
4888,14-02-2021 14:00,24 hrs.,pennystocks,ZOM,356,0,356,-356,3,119,106,3,AMEX
4888,14-02-2021 14:00,24 hrs.,pennystocks,AMBO,24,24,0,24,1,0,20,1,AMEX
4888,14-02-2021 14:00,24 hrs.,pennystocks,AMPE,33,0,33,-33,1,13,3,1,AMEX
4888,14-02-2021 14:00,24 hrs.,pennystocks,CPHI,24,24,0,24,1,0,20,1,AMEX
4888,14-02-2021 14:00,24 hrs.,pennystocks,NSPR,114,0,114,-114,3,19,64,3,AMEX
4888,14-02-2021 14:00,24 hrs.,pennystocks,OGEN,72,0,72,-72,1,29,10,1,AMEX
4888,14-02-2021 14:00,24 hrs.,pennystocks,SENS,45,0,45,-45,2,18,1,2,AMEX
4888,14-02-2021 14:00,24 hrs.,pennystocks,SNMP,21,0,21,-21,1,6,5,1,AMEX
4888,14-02-2021 14:00,24 hrs.,pennystocks,NTRR,6,6,0,6,1,1,0,1,OTC
4888,14-02-2021 14:00,24 hrs.,pennystocks,OPTI,49,0,49,-49,2,12,17,2,OTC
4888,14-02-2021 14:00,24 hrs.,pennystocks,OZSC,190,7,183,-176,2,78,26,2,OTC
4888,14-02-2021 14:00,24 hrs.,pennystocks,PLYZ,6,6,0,6,1,1,0,1,OTC
4888,14-02-2021 14:00,24 hrs.,pennystocks,PRMO,7,7,0,7,1,0,3,1,OTC
4888,14-02-2021 14:00,24 hrs.,pennystocks,PUGE,153,0,153,-153,1,42,65,1,OTC
4888,14-02-2021 14:00,24 hrs.,pennystocks,PVDG,78,0,78,-78,1,17,40,1,OTC
4888,14-02-2021 14:00,24 hrs.,pennystocks,QBAN,9,9,0,9,1,0,5,1,OTC
4888,14-02-2021 14:00,24 hrs.,pennystocks,QMCI,78,0,78,-78,1,17,40,1,OTC
4888,14-02-2021 14:00,24 hrs.,pennystocks,RBNW,6,0,6,-6,1,1,0,1,OTC
4888,14-02-2021 14:00,24 hrs.,pennystocks,RCRT,24,0,24,-24,1,5,10,1,OTC
4888,14-02-2021 14:00,24 hrs.,pennystocks,RSSV,147,45,102,-57,2,54,31,2,OTC
4888,14-02-2021 14:00,24 hrs.,pennystocks,SAFS,6,6,0,6,1,1,0,1,OTC
4888,14-02-2021 14:00,24 hrs.,pennystocks,SGMD,178,0,178,-178,3,60,46,3,OTC
4888,14-02-2021 14:00,24 hrs.,pennystocks,SGSI,22,22,0,22,1,6,6,1,OTC
4888,14-02-2021 14:00,24 hrs.,pennystocks,SHMP,7,0,7,-7,1,1,1,1,OTC
4888,14-02-2021 14:00,24 hrs.,pennystocks,SING,86,51,35,16,3,20,34,3,OTC
4888,14-02-2021 14:00,24 hrs.,pennystocks,SNNC,6,0,6,-6,1,1,0,1,OTC
4888,14-02-2021 14:00,24 hrs.,pennystocks,SNPW,84,0,84,-84,2,18,40,2,OTC
4888,14-02-2021 14:00,24 hrs.,pennystocks,SRMX,7,7,0,7,1,0,3,1,OTC
4888,14-02-2021 14:00,24 hrs.,pennystocks,SSFT,45,45,0,45,1,11,19,1,OTC
4888,14-02-2021 14:00,24 hrs.,pennystocks,TAUG,7,0,7,-7,1,1,1,1,OTC
4888,14-02-2021 14:00,24 hrs.,pennystocks,TIDE,927,0,927,-927,1,384,155,1,OTC
4888,14-02-2021 14:00,24 hrs.,pennystocks,TLSS,107,107,0,107,1,31,41,1,OTC
4888,14-02-2021 14:00,24 hrs.,pennystocks,TSNP,74,0,74,-74,1,10,50,1,OTC
4888,14-02-2021 14:00,24 hrs.,pennystocks,TVPC,6,0,6,-6,1,1,0,1,OTC
4888,14-02-2021 14:00,24 hrs.,pennystocks,VSPC,26,0,26,-26,1,9,4,1,OTC
4888,14-02-2021 14:00,24 hrs.,pennystocks,WDLF,12,12,0,12,2,2,0,1,OTC
4888,14-02-2021 14:00,24 hrs.,pennystocks,WEBB,186,0,186,-186,1,84,14,1,OTC
4888,14-02-2021 14:00,24 hrs.,pennystocks,WSGF,45,45,0,45,1,11,19,1,OTC
4888,14-02-2021 14:00,24 hrs.,pennystocks,XMET,7,0,7,-7,1,1,1,1,OTC
4888,14-02-2021 14:00,24 hrs.,pennystocks,YAYO,49,0,49,-49,1,15,15,1,OTC
4888,14-02-2021 14:00,24 hrs.,pennystocks,ZMRK,6,0,6,-6,1,1,0,1,OTC
4888,14-02-2021 14:00,24 hrs.,pennystocks,AMYZF,48,12,36,-24,8,8,0,4,OTC
4888,14-02-2021 14:00,24 hrs.,pennystocks,ARBKF,326,10,316,-306,7,87,124,5,OTC
4888,14-02-2021 14:00,24 hrs.,pennystocks,OPTT,12,0,12,-12,2,2,0,2,NASDAQ
4888,14-02-2021 14:00,24 hrs.,pennystocks,PBTS,138,24,114,-90,2,30,70,2,NASDAQ
4888,14-02-2021 14:00,24 hrs.,pennystocks,PETZ,24,24,0,24,1,0,20,1,NASDAQ
4888,14-02-2021 14:00,24 hrs.,pennystocks,PGEN,6,0,6,-6,1,1,0,1,NASDAQ
4888,14-02-2021 14:00,24 hrs.,pennystocks,PHCF,24,24,0,24,1,0,20,1,NASDAQ
4888,14-02-2021 14:00,24 hrs.,pennystocks,PHUN,13,0,13,-13,1,0,9,1,NASDAQ
4888,14-02-2021 14:00,24 hrs.,pennystocks,PLAY,12,6,6,0,2,2,0,2,NASDAQ
4888,14-02-2021 14:00,24 hrs.,pennystocks,PLIN,24,24,0,24,1,0,20,1,NASDAQ
4888,14-02-2021 14:00,24 hrs.,pennystocks,PSTV,6,0,6,-6,1,1,0,1,NASDAQ
4888,14-02-2021 14:00,24 hrs.,pennystocks,PULM,6,0,6,-6,1,1,0,1,NASDAQ
4888,14-02-2021 14:00,24 hrs.,pennystocks,RAVE,33,0,33,-33,1,13,3,1,NASDAQ
4888,14-02-2021 14:00,24 hrs.,pennystocks,RCON,24,24,0,24,1,0,20,1,NASDAQ
4888,14-02-2021 14:00,24 hrs.,pennystocks,RETO,24,24,0,24,1,0,20,1,NASDAQ
4888,14-02-2021 14:00,24 hrs.,pennystocks,RUHN,24,24,0,24,1,0,20,1,NASDAQ
4888,14-02-2021 14:00,24 hrs.,pennystocks,RWLK,33,0,33,-33,1,13,3,1,NASDAQ
4888,14-02-2021 14:00,24 hrs.,pennystocks,SALM,33,0,33,-33,1,13,3,1,NASDAQ
4888,14-02-2021 14:00,24 hrs.,pennystocks,SAVA,45,45,0,45,1,11,19,1,NASDAQ
4888,14-02-2021 14:00,24 hrs.,pennystocks,SECO,24,24,0,24,1,0,20,1,NASDAQ
4888,14-02-2021 14:00,24 hrs.,pennystocks,SESN,24,24,0,24,1,5,10,1,NASDAQ
4888,14-02-2021 14:00,24 hrs.,pennystocks,SGOC,24,24,0,24,1,0,20,1,NASDAQ
4888,14-02-2021 14:00,24 hrs.,pennystocks,SHIP,123,90,33,57,3,46,19,3,NASDAQ
4888,14-02-2021 14:00,24 hrs.,pennystocks,SNDL,55,0,55,-55,8,8,7,3,NASDAQ
4888,14-02-2021 14:00,24 hrs.,pennystocks,SNGX,25,0,25,-25,4,4,1,3,NASDAQ
4888,14-02-2021 14:00,24 hrs.,pennystocks,SXTC,24,24,0,24,1,0,20,1,NASDAQ
4888,14-02-2021 14:00,24 hrs.,pennystocks,TANH,24,24,0,24,1,0,20,1,NASDAQ
4888,14-02-2021 14:00,24 hrs.,pennystocks,TAOP,24,24,0,24,1,0,20,1,NASDAQ
4888,14-02-2021 14:00,24 hrs.,pennystocks,CJJD,24,24,0,24,1,0,20,1,NASDAQ
4888,14-02-2021 14:00,24 hrs.,pennystocks,CLBS,109,7,102,-95,2,44,13,2,NASDAQ
4888,14-02-2021 14:00,24 hrs.,pennystocks,CLPS,24,24,0,24,1,0,20,1,NASDAQ
4888,14-02-2021 14:00,24 hrs.,pennystocks,CLRB,84,84,0,84,1,32,16,1,NASDAQ
4888,14-02-2021 14:00,24 hrs.,pennystocks,CNET,24,24,0,24,1,0,20,1,NASDAQ
4888,14-02-2021 14:00,24 hrs.,pennystocks,COCP,16,16,0,16,1,5,2,1,NASDAQ
4888,14-02-2021 14:00,24 hrs.,pennystocks,CREX,130,130,0,130,2,44,34,2,NASDAQ
4888,14-02-2021 14:00,24 hrs.,pennystocks,CSCW,25,25,0,25,2,6,5,2,NASDAQ
4888,14-02-2021 14:00,24 hrs.,pennystocks,CSTR,9,0,9,-9,1,0,5,1,NASDAQ
4888,14-02-2021 14:00,24 hrs.,pennystocks,CTRM,457,97,360,-263,6,163,107,6,NASDAQ
4888,14-02-2021 14:00,24 hrs.,pennystocks,CXDC,24,24,0,24,1,0,20,1,NASDAQ
4888,14-02-2021 14:00,24 hrs.,pennystocks,DFFN,84,0,84,-84,3,27,18,3,NASDAQ
4888,14-02-2021 14:00,24 hrs.,pennystocks,DOGZ,24,24,0,24,1,0,20,1,NASDAQ
4888,14-02-2021 14:00,24 hrs.,pennystocks,DSWL,24,24,0,24,1,0,20,1,NASDAQ
4888,14-02-2021 14:00,24 hrs.,pennystocks,DTSS,24,24,0,24,1,0,20,1,NASDAQ
4888,14-02-2021 14:00,24 hrs.,pennystocks,ECOR,24,24,0,24,1,5,10,1,NASDAQ
4888,14-02-2021 14:00,24 hrs.,pennystocks,EDIT,1171,0,1171,-1171,1,344,479,1,NASDAQ
4888,14-02-2021 14:00,24 hrs.,pennystocks,EDTK,24,24,0,24,1,0,20,1,NASDAQ
4888,14-02-2021 14:00,24 hrs.,pennystocks,EYES,6,0,6,-6,1,1,0,1,NASDAQ
4888,14-02-2021 14:00,24 hrs.,pennystocks,FAMI,24,24,0,24,1,0,20,1,NASDAQ
4888,14-02-2021 14:00,24 hrs.,pennystocks,FLMN,6,0,6,-6,1,1,0,1,NASDAQ
4888,14-02-2021 14:00,24 hrs.,pennystocks,FORD,93,0,93,-93,1,37,15,1,NASDAQ
4888,14-02-2021 14:00,24 hrs.,pennystocks,FTFT,40,7,33,-26,2,14,4,2,NASDAQ
4888,14-02-2021 14:00,24 hrs.,pennystocks,GIGM,24,24,0,24,1,0,20,1,NASDAQ
4888,14-02-2021 14:00,24 hrs.,pennystocks,GNUS,12,0,12,-12,2,2,0,2,NASDAQ
4888,14-02-2021 14:00,24 hrs.,pennystocks,GRIL,33,0,33,-33,1,13,3,1,NASDAQ
4888,14-02-2021 14:00,24 hrs.,pennystocks,GRNQ,24,24,0,24,1,0,20,1,NASDAQ
4888,14-02-2021 14:00,24 hrs.,pennystocks,GSUM,24,24,0,24,1,0,20,1,NASDAQ
4888,14-02-2021 14:00,24 hrs.,pennystocks,GTHX,6,0,6,-6,1,1,0,1,NASDAQ
4888,14-02-2021 14:00,24 hrs.,pennystocks,GURE,24,24,0,24,1,0,20,1,NASDAQ
4888,14-02-2021 14:00,24 hrs.,pennystocks,HAPP,24,24,0,24,1,0,20,1,NASDAQ
4888,14-02-2021 14:00,24 hrs.,pennystocks,HCDI,16,0,16,-16,1,2,8,1,NASDAQ
4888,14-02-2021 14:00,24 hrs.,pennystocks,HGSH,24,24,0,24,1,0,20,1,NASDAQ
4888,14-02-2021 14:00,24 hrs.,pennystocks,NXTTF,12,0,12,-12,2,2,0,2,OTC
4888,14-02-2021 14:00,24 hrs.,pennystocks,PEMIF,27,27,0,27,1,7,9,1,OTC
4888,14-02-2021 14:00,24 hrs.,pennystocks,PHPYF,11,11,0,11,1,1,5,1,OTC
4888,14-02-2021 14:00,24 hrs.,pennystocks,PILBF,6,6,0,6,1,1,0,1,OTC
4888,14-02-2021 14:00,24 hrs.,pennystocks,RLLCF,44,0,44,-44,3,6,20,2,OTC
4888,14-02-2021 14:00,24 hrs.,pennystocks,HQGE,6,0,6,-6,1,1,0,1,OTC
4888,14-02-2021 14:00,24 hrs.,pennystocks,ICNM,7,0,7,-7,1,1,1,1,OTC
4888,14-02-2021 14:00,24 hrs.,pennystocks,ICTY,6,0,6,-6,1,1,0,1,OTC
4888,14-02-2021 14:00,24 hrs.,pennystocks,IGEN,23,0,23,-23,2,3,9,2,OTC
4888,14-02-2021 14:00,24 hrs.,pennystocks,IJJP,7,7,0,7,1,0,3,1,OTC
4888,14-02-2021 14:00,24 hrs.,pennystocks,ILUS,75,75,0,75,1,28,15,1,OTC
4888,14-02-2021 14:00,24 hrs.,pennystocks,INND,25,25,0,25,1,0,21,1,OTC
4888,14-02-2021 14:00,24 hrs.,pennystocks,KGET,6,0,6,-6,1,1,0,1,OTC
4888,14-02-2021 14:00,24 hrs.,pennystocks,KULR,45,45,0,45,1,11,19,1,OTC
4888,14-02-2021 14:00,24 hrs.,pennystocks,KYNC,6,0,6,-6,1,1,0,1,OTC
4888,14-02-2021 14:00,24 hrs.,pennystocks,LATF,8,0,8,-8,1,1,2,1,OTC
4888,14-02-2021 14:00,24 hrs.,pennystocks,LGBS,7,7,0,7,1,0,3,1,OTC
4888,14-02-2021 14:00,24 hrs.,pennystocks,LTNC,49,7,42,-35,2,0,41,2,OTC
4888,14-02-2021 14:00,24 hrs.,pennystocks,MINE,86,12,74,-62,3,12,50,2,OTC
4888,14-02-2021 14:00,24 hrs.,pennystocks,MJNA,25,0,25,-25,1,5,11,1,OTC
4888,14-02-2021 14:00,24 hrs.,pennystocks,MJWL,7,7,0,7,1,0,3,1,OTC
4888,14-02-2021 14:00,24 hrs.,pennystocks,MLFB,62,45,17,28,2,22,10,2,OTC
4888,14-02-2021 14:00,24 hrs.,pennystocks,MSPC,6,0,6,-6,1,1,0,1,OTC
4888,14-02-2021 14:00,24 hrs.,pennystocks,NSPX,6,0,6,-6,1,1,0,1,OTC
4888,14-02-2021 14:00,24 hrs.,pennystocks,TEDU,24,24,0,24,1,0,20,1,NASDAQ
4888,14-02-2021 14:00,24 hrs.,pennystocks,TLRY,927,0,927,-927,1,384,155,1,NASDAQ
4888,14-02-2021 14:00,24 hrs.,pennystocks,TNXP,96,60,36,24,4,27,26,4,NASDAQ
4888,14-02-2021 14:00,24 hrs.,pennystocks,TOPS,33,0,33,-33,1,13,3,1,NASDAQ
4888,14-02-2021 14:00,24 hrs.,pennystocks,TOUR,24,24,0,24,1,0,20,1,NASDAQ
4888,14-02-2021 14:00,24 hrs.,pennystocks,TRVG,46,0,46,-46,3,15,4,3,NASDAQ
4888,14-02-2021 14:00,24 hrs.,pennystocks,TXMD,7,0,7,-7,1,1,1,1,NASDAQ
4888,14-02-2021 14:00,24 hrs.,pennystocks,TYHT,24,24,0,24,1,0,20,1,NASDAQ
4888,14-02-2021 14:00,24 hrs.,pennystocks,USWS,6,0,6,-6,1,1,0,1,NASDAQ
4888,14-02-2021 14:00,24 hrs.,pennystocks,UTSI,24,24,0,24,1,0,20,1,NASDAQ
4888,14-02-2021 14:00,24 hrs.,pennystocks,UXIN,24,24,0,24,1,0,20,1,NASDAQ
4888,14-02-2021 14:00,24 hrs.,pennystocks,VYNE,24,24,0,24,2,3,10,1,NASDAQ
4888,14-02-2021 14:00,24 hrs.,pennystocks,XSPA,24,0,24,-24,4,4,0,3,NASDAQ
4888,14-02-2021 14:00,24 hrs.,pennystocks,YMTX,17,0,17,-17,1,4,5,1,NASDAQ
4888,14-02-2021 14:00,24 hrs.,pennystocks,ZCMD,24,24,0,24,1,0,20,1,NASDAQ
4888,14-02-2021 14:00,24 hrs.,pennystocks,ZKIN,13,0,13,-13,1,0,9,1,NASDAQ
4888,14-02-2021 14:00,24 hrs.,pennystocks,ZSAN,46,0,46,-46,2,1,36,2,NASDAQ
4888,14-02-2021 14:00,24 hrs.,pennystocks,HIHO,24,24,0,24,1,0,20,1,NASDAQ
4888,14-02-2021 14:00,24 hrs.,pennystocks,HUSN,33,0,33,-33,1,13,3,1,NASDAQ
4888,14-02-2021 14:00,24 hrs.,pennystocks,ICON,14,0,14,-14,1,3,4,1,NASDAQ
4888,14-02-2021 14:00,24 hrs.,pennystocks,ILMN,33,0,33,-33,1,13,3,1,NASDAQ
4888,14-02-2021 14:00,24 hrs.,pennystocks,ITRM,7,0,7,-7,1,1,1,1,NASDAQ
4888,14-02-2021 14:00,24 hrs.,pennystocks,IZEA,13,0,13,-13,1,0,9,1,NASDAQ
4888,14-02-2021 14:00,24 hrs.,pennystocks,JAGX,36,36,0,36,3,11,2,2,NASDAQ
4888,14-02-2021 14:00,24 hrs.,pennystocks,JFIN,108,108,0,108,2,32,36,2,NASDAQ
4888,14-02-2021 14:00,24 hrs.,pennystocks,KBSF,24,24,0,24,1,0,20,1,NASDAQ
4888,14-02-2021 14:00,24 hrs.,pennystocks,KRKR,24,24,0,24,1,0,20,1,NASDAQ
4888,14-02-2021 14:00,24 hrs.,pennystocks,KTRA,24,24,0,24,1,5,10,1,NASDAQ
4888,14-02-2021 14:00,24 hrs.,pennystocks,KXIN,24,24,0,24,1,0,20,1,NASDAQ
4888,14-02-2021 14:00,24 hrs.,pennystocks,LGHL,46,0,46,-46,2,13,12,2,NASDAQ
4888,14-02-2021 14:00,24 hrs.,pennystocks,LIVE,23,0,23,-23,1,7,5,1,NASDAQ
4888,14-02-2021 14:00,24 hrs.,pennystocks,LKCO,57,24,33,-9,2,13,23,2,NASDAQ
4888,14-02-2021 14:00,24 hrs.,pennystocks,LLNW,6,0,6,-6,1,1,0,1,NASDAQ
4888,14-02-2021 14:00,24 hrs.,pennystocks,MDJH,24,24,0,24,1,0,20,1,NASDAQ
4888,14-02-2021 14:00,24 hrs.,pennystocks,METX,24,24,0,24,1,0,20,1,NASDAQ
4888,14-02-2021 14:00,24 hrs.,pennystocks,MOGO,34,0,34,-34,1,6,18,1,NASDAQ
4888,14-02-2021 14:00,24 hrs.,pennystocks,MOHO,24,24,0,24,1,0,20,1,NASDAQ
4888,14-02-2021 14:00,24 hrs.,pennystocks,MOSY,33,0,33,-33,1,13,3,1,NASDAQ
4888,14-02-2021 14:00,24 hrs.,pennystocks,MOXC,24,24,0,24,1,0,20,1,NASDAQ
4888,14-02-2021 14:00,24 hrs.,pennystocks,NAKD,15,0,15,-15,2,1,5,2,NASDAQ
4888,14-02-2021 14:00,24 hrs.,pennystocks,NEWA,24,24,0,24,1,0,20,1,NASDAQ
4888,14-02-2021 14:00,24 hrs.,pennystocks,NOVN,6,6,0,6,1,1,0,1,NASDAQ
4888,14-02-2021 14:00,24 hrs.,pennystocks,NVCN,23,16,7,9,2,6,3,2,NASDAQ
4888,14-02-2021 14:00,24 hrs.,pennystocks,OCGN,43,0,43,-43,1,12,15,1,NASDAQ
4888,14-02-2021 14:00,24 hrs.,pennystocks,OPGN,7,0,7,-7,1,1,1,1,NASDAQ
4888,14-02-2021 14:00,24 hrs.,pennystocks,PDT,36,0,36,-36,2,3,22,2,NYSE
4888,14-02-2021 14:00,24 hrs.,pennystocks,PEG,804,0,804,-804,1,370,60,1,NYSE
4888,14-02-2021 14:00,24 hrs.,pennystocks,RSI,828,24,804,-780,2,370,80,2,NYSE
4888,14-02-2021 14:00,24 hrs.,pennystocks,RYB,24,24,0,24,1,0,20,1,NYSE
4888,14-02-2021 14:00,24 hrs.,pennystocks,SOS,323,13,310,-297,11,84,111,11,NYSE
4888,14-02-2021 14:00,24 hrs.,pennystocks,STG,24,24,0,24,1,0,20,1,NYSE
4888,14-02-2021 14:00,24 hrs.,pennystocks,SUP,33,0,33,-33,1,13,3,1,NYSE
4888,14-02-2021 14:00,24 hrs.,pennystocks,THC,43,0,43,-43,1,12,15,1,NYSE
4888,14-02-2021 14:00,24 hrs.,pennystocks,TTM,927,0,927,-927,1,384,155,1,NYSE
4888,14-02-2021 14:00,24 hrs.,pennystocks,WEI,24,24,0,24,1,0,20,1,NYSE
4888,14-02-2021 14:00,24 hrs.,pennystocks,XIN,24,24,0,24,1,0,20,1,NYSE
4888,14-02-2021 14:00,24 hrs.,pennystocks,XYF,24,24,0,24,1,0,20,1,NYSE
4888,14-02-2021 14:00,24 hrs.,pennystocks,ABBV,9,9,0,9,1,2,1,1,NYSE
4888,14-02-2021 14:00,24 hrs.,pennystocks,BORR,7,7,0,7,1,1,1,1,NYSE
4888,14-02-2021 14:00,24 hrs.,pennystocks,CMCM,24,24,0,24,1,0,20,1,NYSE
4888,14-02-2021 14:00,24 hrs.,pennystocks,FEDU,24,24,0,24,1,0,20,1,NYSE
4888,14-02-2021 14:00,24 hrs.,pennystocks,FENG,24,24,0,24,1,0,20,1,NYSE
4888,14-02-2021 14:00,24 hrs.,pennystocks,HEXO,932,0,932,-932,2,384,156,2,NYSE
4888,14-02-2021 14:00,24 hrs.,pennystocks,LAIX,24,24,0,24,1,0,20,1,NYSE
4888,14-02-2021 14:00,24 hrs.,pennystocks,LEJU,24,24,0,24,1,0,20,1,NYSE
4888,14-02-2021 14:00,24 hrs.,pennystocks,LITB,24,24,0,24,1,0,20,1,NYSE
4888,14-02-2021 14:00,24 hrs.,pennystocks,MOGU,24,24,0,24,1,0,20,1,NYSE
4888,14-02-2021 14:00,24 hrs.,pennystocks,WELL,7,0,7,-7,1,1,1,1,NYSE
4888,14-02-2021 14:00,24 hrs.,pennystocks,CGC,927,0,927,-927,1,384,155,1,NASDAQ
4888,14-02-2021 14:00,24 hrs.,pennystocks,ABML,24,0,24,-24,4,4,0,1,OTC
4888,14-02-2021 14:00,24 hrs.,pennystocks,ACRL,57,57,0,57,3,15,15,3,OTC
4888,14-02-2021 14:00,24 hrs.,pennystocks,AITX,175,139,36,103,5,63,29,4,OTC
4888,14-02-2021 14:00,24 hrs.,pennystocks,ALYI,91,13,78,-65,3,19,41,2,OTC
4888,14-02-2021 14:00,24 hrs.,pennystocks,AMAZ,6,0,6,-6,1,1,0,1,OTC
4888,14-02-2021 14:00,24 hrs.,pennystocks,AMNE,13,0,13,-13,2,2,1,1,OTC
4888,14-02-2021 14:00,24 hrs.,pennystocks,ASTI,223,0,223,-223,2,83,49,2,OTC
4888,14-02-2021 14:00,24 hrs.,pennystocks,ATVK,52,45,7,38,2,12,20,2,OTC
4888,14-02-2021 14:00,24 hrs.,pennystocks,BANT,51,45,6,39,2,12,19,2,OTC
4888,14-02-2021 14:00,24 hrs.,pennystocks,BIEL,6,0,6,-6,1,1,0,1,OTC
4888,14-02-2021 14:00,24 hrs.,pennystocks,BNGI,6,0,6,-6,1,1,0,1,OTC
4888,14-02-2021 14:00,24 hrs.,pennystocks,BOTY,42,6,36,-30,2,13,8,2,OTC
4888,14-02-2021 14:00,24 hrs.,pennystocks,BRGO,6,0,6,-6,1,1,0,1,OTC
4888,14-02-2021 14:00,24 hrs.,pennystocks,BRRN,10,0,10,-10,1,2,2,1,OTC
4888,14-02-2021 14:00,24 hrs.,pennystocks,BRSE,6,0,6,-6,1,1,0,1,OTC
4888,14-02-2021 14:00,24 hrs.,pennystocks,CANN,12,0,12,-12,2,2,0,2,OTC
4888,14-02-2021 14:00,24 hrs.,pennystocks,CBBT,114,0,114,-114,2,29,48,2,OTC
4888,14-02-2021 14:00,24 hrs.,pennystocks,CBDL,36,0,36,-36,1,12,8,1,OTC
4888,14-02-2021 14:00,24 hrs.,pennystocks,CCTL,120,0,120,-120,2,31,50,2,OTC
4888,14-02-2021 14:00,24 hrs.,pennystocks,CHUC,21,21,0,21,1,5,7,1,OTC
4888,14-02-2021 14:00,24 hrs.,pennystocks,CLIS,18,0,18,-18,2,3,4,1,OTC
4888,14-02-2021 14:00,24 hrs.,pennystocks,COUV,39,39,0,39,1,7,21,1,OTC
4888,14-02-2021 14:00,24 hrs.,pennystocks,CTLE,31,0,31,-31,5,5,1,2,OTC
4888,14-02-2021 14:00,24 hrs.,pennystocks,DIGI,53,0,53,-53,1,20,9,1,OTC
4888,14-02-2021 14:00,24 hrs.,pennystocks,DPLS,24,0,24,-24,1,5,10,1,OTC
4888,14-02-2021 14:00,24 hrs.,pennystocks,DRNK,6,0,6,-6,1,1,0,1,OTC
4888,14-02-2021 14:00,24 hrs.,pennystocks,DXLG,33,0,33,-33,1,13,3,1,OTC
4888,14-02-2021 14:00,24 hrs.,pennystocks,ECEZ,7,0,7,-7,1,1,1,1,OTC
4888,14-02-2021 14:00,24 hrs.,pennystocks,ECOX,7,0,7,-7,1,1,1,1,OTC
4888,14-02-2021 14:00,24 hrs.,pennystocks,EMED,12,12,0,12,2,2,0,1,OTC
4888,14-02-2021 14:00,24 hrs.,pennystocks,ENZC,78,0,78,-78,1,17,40,1,OTC
4888,14-02-2021 14:00,24 hrs.,pennystocks,EWLL,7,7,0,7,1,1,1,1,OTC
4888,14-02-2021 14:00,24 hrs.,pennystocks,GAXY,24,0,24,-24,1,5,10,1,OTC
4888,14-02-2021 14:00,24 hrs.,pennystocks,GLFH,28,0,28,-28,1,5,14,1,OTC
4888,14-02-2021 14:00,24 hrs.,pennystocks,GRLT,7,7,0,7,1,0,3,1,OTC
4888,14-02-2021 14:00,24 hrs.,pennystocks,GRST,15,15,0,15,1,5,1,1,OTC
4888,14-02-2021 14:00,24 hrs.,pennystocks,GTEH,74,0,74,-74,1,10,50,1,OTC
4888,14-02-2021 14:00,24 hrs.,pennystocks,HCMC,90,41,49,-8,14,15,4,14,OTC
4888,14-02-2021 14:00,24 hrs.,pennystocks,HPIL,13,0,13,-13,2,2,1,1,OTC
4888,14-02-2021 14:00,24 hrs.,pennystocks,HPMM,13,6,7,-1,2,2,1,2,OTC
4888,14-02-2021 14:00,24 hrs.,pennystocks,CIH,24,24,0,24,1,0,20,1,NASDAQ
4888,14-02-2021 14:00,24 hrs.,pennystocks,EVK,24,24,0,24,1,0,20,1,NASDAQ
4888,14-02-2021 14:00,24 hrs.,pennystocks,GLG,24,24,0,24,1,0,20,1,NASDAQ
4888,14-02-2021 14:00,24 hrs.,pennystocks,INO,72,0,72,-72,1,29,10,1,NASDAQ
4888,14-02-2021 14:00,24 hrs.,pennystocks,JFU,24,24,0,24,1,0,20,1,NASDAQ
4888,14-02-2021 14:00,24 hrs.,pennystocks,LYL,24,24,0,24,1,0,20,1,NASDAQ
4888,14-02-2021 14:00,24 hrs.,pennystocks,MKD,24,24,0,24,1,0,20,1,NASDAQ
4888,14-02-2021 14:00,24 hrs.,pennystocks,MTC,24,24,0,24,1,0,20,1,NASDAQ
4888,14-02-2021 14:00,24 hrs.,pennystocks,MYT,24,24,0,24,1,0,20,1,NASDAQ
4888,14-02-2021 14:00,24 hrs.,pennystocks,OSN,24,24,0,24,1,0,20,1,NASDAQ
4888,14-02-2021 14:00,24 hrs.,pennystocks,PME,24,24,0,24,1,0,20,1,NASDAQ
4888,14-02-2021 14:00,24 hrs.,pennystocks,PPH,11,11,0,11,1,1,5,1,NASDAQ
4888,14-02-2021 14:00,24 hrs.,pennystocks,PTE,120,0,120,-120,1,47,22,1,NASDAQ
4888,14-02-2021 14:00,24 hrs.,pennystocks,AAPL,804,0,804,-804,1,370,60,1,NASDAQ
4888,14-02-2021 14:00,24 hrs.,pennystocks,ACHV,45,45,0,45,1,11,19,1,NASDAQ
4888,14-02-2021 14:00,24 hrs.,pennystocks,ADMP,7,7,0,7,1,1,1,1,NASDAQ
4888,14-02-2021 14:00,24 hrs.,pennystocks,ADXS,6,6,0,6,1,1,0,1,NASDAQ
4888,14-02-2021 14:00,24 hrs.,pennystocks,AEZS,28,0,28,-28,1,9,6,1,NASDAQ
4888,14-02-2021 14:00,24 hrs.,pennystocks,AIHS,24,24,0,24,1,0,20,1,NASDAQ
4888,14-02-2021 14:00,24 hrs.,pennystocks,ANTE,23,0,23,-23,1,7,5,1,NASDAQ
4888,14-02-2021 14:00,24 hrs.,pennystocks,AQMS,78,0,78,-78,1,17,40,1,NASDAQ
4888,14-02-2021 14:00,24 hrs.,pennystocks,ARTL,117,84,33,51,2,45,19,2,NASDAQ
4888,14-02-2021 14:00,24 hrs.,pennystocks,ASLN,24,24,0,24,1,0,20,1,NASDAQ
4888,14-02-2021 14:00,24 hrs.,pennystocks,ASRT,83,0,83,-83,3,23,25,3,NASDAQ
4888,14-02-2021 14:00,24 hrs.,pennystocks,ATOS,29,0,29,-29,1,4,17,1,NASDAQ
4888,14-02-2021 14:00,24 hrs.,pennystocks,AUTL,7,7,0,7,1,0,3,1,NASDAQ
4888,14-02-2021 14:00,24 hrs.,pennystocks,AVGR,120,0,120,-120,1,47,22,1,NASDAQ
4888,14-02-2021 14:00,24 hrs.,pennystocks,AYRO,33,0,33,-33,1,13,3,1,NASDAQ
4888,14-02-2021 14:00,24 hrs.,pennystocks,BHAT,24,24,0,24,1,0,20,1,NASDAQ
4888,14-02-2021 14:00,24 hrs.,pennystocks,BHTG,7,7,0,7,1,0,3,1,NASDAQ
4888,14-02-2021 14:00,24 hrs.,pennystocks,BIMI,24,24,0,24,1,0,20,1,NASDAQ
4888,14-02-2021 14:00,24 hrs.,pennystocks,BNGO,509,261,248,13,4,160,173,3,NASDAQ
4888,14-02-2021 14:00,24 hrs.,pennystocks,BRQS,37,24,13,11,2,0,29,2,NASDAQ
4888,14-02-2021 14:00,24 hrs.,pennystocks,BVXV,6,0,6,-6,1,1,0,1,NASDAQ
4888,14-02-2021 14:00,24 hrs.,pennystocks,BWEN,6,0,6,-6,1,1,0,1,NASDAQ
4888,14-02-2021 14:00,24 hrs.,pennystocks,BXRX,12,0,12,-12,2,2,0,2,NASDAQ
4888,14-02-2021 14:00,24 hrs.,pennystocks,CCNC,13,0,13,-13,1,0,9,1,NASDAQ
4888,14-02-2021 14:00,24 hrs.,pennystocks,CCRC,24,24,0,24,1,0,20,1,NASDAQ
4888,14-02-2021 14:00,24 hrs.,pennystocks,CFMS,7,7,0,7,1,1,1,1,NASDAQ
4888,14-02-2021 14:00,24 hrs.,pennystocks,CHEK,120,0,120,-120,1,47,22,1,NASDAQ
4888,14-02-2021 14:00,24 hrs.,pennystocks,CHNR,24,24,0,24,1,0,20,1,NASDAQ
4888,14-02-2021 14:00,24 hrs.,pennystocks,TKAT,24,24,0,24,1,0,20,1,AMEX
4888,14-02-2021 14:00,24 hrs.,pennystocks,TMBR,33,0,33,-33,1,13,3,1,AMEX
4888,14-02-2021 14:00,24 hrs.,pennystocks,UAMY,74,0,74,-74,1,10,50,1,AMEX
4888,14-02-2021 14:00,24 hrs.,pennystocks,ABC,2454,2454,0,2454,1,1150,150,1,NYSE
4888,14-02-2021 14:00,24 hrs.,pennystocks,ACB,927,0,927,-927,1,384,155,1,NYSE
4888,14-02-2021 14:00,24 hrs.,pennystocks,ALB,27,27,0,27,1,7,9,1,NYSE
4888,14-02-2021 14:00,24 hrs.,pennystocks,AMC,84,0,84,-84,2,22,32,2,NYSE
4888,14-02-2021 14:00,24 hrs.,pennystocks,ASX,38,29,9,20,6,5,4,2,NYSE
4888,14-02-2021 14:00,24 hrs.,pennystocks,BKD,22,22,0,22,1,6,6,1,NYSE
4888,14-02-2021 14:00,24 hrs.,pennystocks,CBD,950,0,950,-950,2,391,160,2,NYSE
4888,14-02-2021 14:00,24 hrs.,pennystocks,CCM,24,24,0,24,1,0,20,1,NYSE
4888,14-02-2021 14:00,24 hrs.,pennystocks,CMC,32,32,0,32,1,9,10,1,NYSE
4888,14-02-2021 14:00,24 hrs.,pennystocks,CNF,24,24,0,24,1,0,20,1,NYSE
4888,14-02-2021 14:00,24 hrs.,pennystocks,CVE,27,27,0,27,1,7,9,1,NYSE
4888,14-02-2021 14:00,24 hrs.,pennystocks,DNK,24,24,0,24,1,0,20,1,NYSE
4888,14-02-2021 14:00,24 hrs.,pennystocks,EPR,13,13,0,13,1,0,9,1,NYSE
4888,14-02-2021 14:00,24 hrs.,pennystocks,FLT,30,0,30,-30,1,7,12,1,NYSE
4888,14-02-2021 14:00,24 hrs.,pennystocks,FSD,12,0,12,-12,1,2,4,1,NYSE
4888,14-02-2021 14:00,24 hrs.,pennystocks,GME,18,12,6,6,3,3,0,3,NYSE
4888,14-02-2021 14:00,24 hrs.,pennystocks,KOF,13,0,13,-13,1,3,3,1,NYSE
4888,14-02-2021 14:00,24 hrs.,pennystocks,NGL,4996,0,4996,-4996,2,2415,158,2,NYSE
4888,14-02-2021 14:00,24 hrs.,pennystocks,NOK,254,0,254,-254,1,95,60,1,NYSE
4888,14-02-2021 14:00,24 hrs.,pennystocks,NYC,13,0,13,-13,1,0,9,1,NYSE
4877,14-02-2021 12:00,24 hrs.,pennystocks,HAPP,24,24,0,24,1,0,20,1,NASDAQ
4877,14-02-2021 12:00,24 hrs.,pennystocks,HCDI,16,16,0,16,1,2,8,1,NASDAQ
4877,14-02-2021 12:00,24 hrs.,pennystocks,HGSH,24,24,0,24,1,0,20,1,NASDAQ
4877,14-02-2021 12:00,24 hrs.,pennystocks,HIHO,24,24,0,24,1,0,20,1,NASDAQ
4877,14-02-2021 12:00,24 hrs.,pennystocks,HUSN,33,0,33,-33,1,13,3,1,NASDAQ
4877,14-02-2021 12:00,24 hrs.,pennystocks,ICON,14,0,14,-14,1,3,4,1,NASDAQ
4877,14-02-2021 12:00,24 hrs.,pennystocks,ILMN,33,0,33,-33,1,13,3,1,NASDAQ
4877,14-02-2021 12:00,24 hrs.,pennystocks,ITRM,7,0,7,-7,1,1,1,1,NASDAQ
4877,14-02-2021 12:00,24 hrs.,pennystocks,IZEA,13,0,13,-13,1,0,9,1,NASDAQ
4877,14-02-2021 12:00,24 hrs.,pennystocks,JAGX,34,34,0,34,3,10,2,2,NASDAQ
4877,14-02-2021 12:00,24 hrs.,pennystocks,JFIN,102,102,0,102,2,32,30,2,NASDAQ
4877,14-02-2021 12:00,24 hrs.,pennystocks,KBSF,24,24,0,24,1,0,20,1,NASDAQ
4877,14-02-2021 12:00,24 hrs.,pennystocks,KRKR,24,24,0,24,1,0,20,1,NASDAQ
4877,14-02-2021 12:00,24 hrs.,pennystocks,KTRA,12,12,0,12,1,3,2,1,NASDAQ
4877,14-02-2021 12:00,24 hrs.,pennystocks,KXIN,24,24,0,24,1,0,20,1,NASDAQ
4877,14-02-2021 12:00,24 hrs.,pennystocks,LGHL,46,0,46,-46,2,13,12,2,NASDAQ
4877,14-02-2021 12:00,24 hrs.,pennystocks,LIVE,25,0,25,-25,1,8,5,1,NASDAQ
4877,14-02-2021 12:00,24 hrs.,pennystocks,LKCO,57,24,33,-9,2,13,23,2,NASDAQ
4877,14-02-2021 12:00,24 hrs.,pennystocks,LLNW,6,0,6,-6,1,1,0,1,NASDAQ
4877,14-02-2021 12:00,24 hrs.,pennystocks,MDJH,24,24,0,24,1,0,20,1,NASDAQ
4877,14-02-2021 12:00,24 hrs.,pennystocks,METX,24,24,0,24,1,0,20,1,NASDAQ
4877,14-02-2021 12:00,24 hrs.,pennystocks,MOGO,30,0,30,-30,1,4,18,1,NASDAQ
4877,14-02-2021 12:00,24 hrs.,pennystocks,MOHO,24,24,0,24,1,0,20,1,NASDAQ
4877,14-02-2021 12:00,24 hrs.,pennystocks,MOSY,33,0,33,-33,1,13,3,1,NASDAQ
4877,14-02-2021 12:00,24 hrs.,pennystocks,MOXC,24,24,0,24,1,0,20,1,NASDAQ
4877,14-02-2021 12:00,24 hrs.,pennystocks,NAKD,15,9,6,3,2,1,5,2,NASDAQ
4877,14-02-2021 12:00,24 hrs.,pennystocks,NEWA,24,24,0,24,1,0,20,1,NASDAQ
4877,14-02-2021 12:00,24 hrs.,pennystocks,NOVN,6,6,0,6,1,1,0,1,NASDAQ
4877,14-02-2021 12:00,24 hrs.,pennystocks,NVCN,28,15,13,2,3,7,2,3,NASDAQ
4877,14-02-2021 12:00,24 hrs.,pennystocks,OCGN,45,0,45,-45,1,13,15,1,NASDAQ
4877,14-02-2021 12:00,24 hrs.,pennystocks,OPGN,7,0,7,-7,1,1,1,1,NASDAQ
4877,14-02-2021 12:00,24 hrs.,pennystocks,OPTT,12,0,12,-12,2,2,0,2,NASDAQ
4877,14-02-2021 12:00,24 hrs.,pennystocks,PBTS,138,24,114,-90,2,30,70,2,NASDAQ
4877,14-02-2021 12:00,24 hrs.,pennystocks,PETZ,24,24,0,24,1,0,20,1,NASDAQ
4877,14-02-2021 12:00,24 hrs.,pennystocks,PGEN,6,0,6,-6,1,1,0,1,NASDAQ
4877,14-02-2021 12:00,24 hrs.,pennystocks,PHCF,24,24,0,24,1,0,20,1,NASDAQ
4877,14-02-2021 12:00,24 hrs.,pennystocks,PHUN,13,0,13,-13,1,0,9,1,NASDAQ
4877,14-02-2021 12:00,24 hrs.,wallstreetbets,FNMA,14,0,14,-14,2,2,2,1,OTC
4877,14-02-2021 12:00,24 hrs.,wallstreetbets,GAXY,7,7,0,7,1,1,1,1,OTC
4877,14-02-2021 12:00,24 hrs.,wallstreetbets,GPFT,6,0,6,-6,1,1,0,1,OTC
4877,14-02-2021 12:00,24 hrs.,wallstreetbets,HCMC,170,33,137,-104,25,24,22,17,OTC
4877,14-02-2021 12:00,24 hrs.,wallstreetbets,HEMP,14,0,14,-14,2,2,2,1,OTC
4877,14-02-2021 12:00,24 hrs.,wallstreetbets,IDEA,89,0,89,-89,1,32,21,1,OTC
4877,14-02-2021 12:00,24 hrs.,wallstreetbets,IMTL,6,6,0,6,1,1,0,1,OTC
4877,14-02-2021 12:00,24 hrs.,wallstreetbets,INND,14,0,14,-14,2,2,2,1,OTC
4877,14-02-2021 12:00,24 hrs.,wallstreetbets,IQST,8,0,8,-8,1,1,2,1,OTC
4877,14-02-2021 12:00,24 hrs.,wallstreetbets,KGET,7,0,7,-7,1,1,1,1,OTC
4877,14-02-2021 12:00,24 hrs.,wallstreetbets,KWBT,6,0,6,-6,1,1,0,1,OTC
4877,14-02-2021 12:00,24 hrs.,wallstreetbets,LINK,1260,6,1254,-1248,4,586,72,4,OTC
4877,14-02-2021 12:00,24 hrs.,wallstreetbets,MAXD,7,7,0,7,1,1,1,1,OTC
4877,14-02-2021 12:00,24 hrs.,wallstreetbets,MDCN,14,0,14,-14,2,2,2,1,OTC
4877,14-02-2021 12:00,24 hrs.,pennystocks,PLAY,12,6,6,0,2,2,0,2,NASDAQ
4877,14-02-2021 12:00,24 hrs.,pennystocks,PLIN,24,24,0,24,1,0,20,1,NASDAQ
4877,14-02-2021 12:00,24 hrs.,pennystocks,PSEC,6,0,6,-6,1,1,0,1,NASDAQ
4877,14-02-2021 12:00,24 hrs.,pennystocks,PSTV,6,0,6,-6,1,1,0,1,NASDAQ
4877,14-02-2021 12:00,24 hrs.,pennystocks,PULM,6,0,6,-6,1,1,0,1,NASDAQ
4877,14-02-2021 12:00,24 hrs.,pennystocks,RAVE,33,0,33,-33,1,13,3,1,NASDAQ
4877,14-02-2021 12:00,24 hrs.,pennystocks,RCON,24,24,0,24,1,0,20,1,NASDAQ
4877,14-02-2021 12:00,24 hrs.,pennystocks,RETO,24,24,0,24,1,0,20,1,NASDAQ
4877,14-02-2021 12:00,24 hrs.,pennystocks,RUHN,24,24,0,24,1,0,20,1,NASDAQ
4877,14-02-2021 12:00,24 hrs.,pennystocks,RWLK,33,0,33,-33,1,13,3,1,NASDAQ
4877,14-02-2021 12:00,24 hrs.,pennystocks,SALM,33,0,33,-33,1,13,3,1,NASDAQ
4877,14-02-2021 12:00,24 hrs.,pennystocks,SAVA,47,47,0,47,1,12,19,1,NASDAQ
4877,14-02-2021 12:00,24 hrs.,pennystocks,SECO,24,24,0,24,1,0,20,1,NASDAQ
4877,14-02-2021 12:00,24 hrs.,pennystocks,SESN,12,12,0,12,1,3,2,1,NASDAQ
4877,14-02-2021 12:00,24 hrs.,pennystocks,SGOC,24,24,0,24,1,0,20,1,NASDAQ
4877,14-02-2021 12:00,24 hrs.,pennystocks,SHIP,117,84,33,51,3,46,13,3,NASDAQ
4877,14-02-2021 12:00,24 hrs.,pennystocks,SNDL,55,0,55,-55,8,8,7,3,NASDAQ
4877,14-02-2021 12:00,24 hrs.,pennystocks,SNGX,25,6,19,-13,4,4,1,3,NASDAQ
4877,14-02-2021 12:00,24 hrs.,pennystocks,SXTC,24,24,0,24,1,0,20,1,NASDAQ
4877,14-02-2021 12:00,24 hrs.,pennystocks,TANH,24,24,0,24,1,0,20,1,NASDAQ
4877,14-02-2021 12:00,24 hrs.,pennystocks,TAOP,24,24,0,24,1,0,20,1,NASDAQ
4877,14-02-2021 12:00,24 hrs.,pennystocks,TEDU,24,24,0,24,1,0,20,1,NASDAQ
4877,14-02-2021 12:00,24 hrs.,pennystocks,TLRY,849,0,849,-849,1,350,145,1,NASDAQ
4877,14-02-2021 12:00,24 hrs.,pennystocks,TNXP,99,87,12,75,5,27,25,5,NASDAQ
4877,14-02-2021 12:00,24 hrs.,pennystocks,TOPS,33,0,33,-33,1,13,3,1,NASDAQ
4877,14-02-2021 12:00,24 hrs.,pennystocks,TOUR,24,24,0,24,1,0,20,1,NASDAQ
4877,14-02-2021 12:00,24 hrs.,pennystocks,TRVG,46,0,46,-46,3,15,4,3,NASDAQ
4877,14-02-2021 12:00,24 hrs.,pennystocks,TXMD,7,0,7,-7,1,1,1,1,NASDAQ
4877,14-02-2021 12:00,24 hrs.,pennystocks,TYHT,24,24,0,24,1,0,20,1,NASDAQ
4877,14-02-2021 12:00,24 hrs.,pennystocks,USWS,6,0,6,-6,1,1,0,1,NASDAQ
4877,14-02-2021 12:00,24 hrs.,pennystocks,UTSI,24,24,0,24,1,0,20,1,NASDAQ
4877,14-02-2021 12:00,24 hrs.,pennystocks,UXIN,24,24,0,24,1,0,20,1,NASDAQ
4877,14-02-2021 12:00,24 hrs.,pennystocks,DOGZ,24,24,0,24,1,0,20,1,NASDAQ
4877,14-02-2021 12:00,24 hrs.,pennystocks,DSWL,24,24,0,24,1,0,20,1,NASDAQ
4877,14-02-2021 12:00,24 hrs.,pennystocks,DTSS,24,24,0,24,1,0,20,1,NASDAQ
4877,14-02-2021 12:00,24 hrs.,pennystocks,ECOR,12,12,0,12,1,3,2,1,NASDAQ
4877,14-02-2021 12:00,24 hrs.,pennystocks,EDIT,1147,0,1147,-1147,1,332,479,1,NASDAQ
4877,14-02-2021 12:00,24 hrs.,pennystocks,EDTK,24,24,0,24,1,0,20,1,NASDAQ
4877,14-02-2021 12:00,24 hrs.,pennystocks,EYES,6,0,6,-6,1,1,0,1,NASDAQ
4877,14-02-2021 12:00,24 hrs.,pennystocks,FAMI,24,24,0,24,1,0,20,1,NASDAQ
4877,14-02-2021 12:00,24 hrs.,pennystocks,FLMN,6,0,6,-6,1,1,0,1,NASDAQ
4877,14-02-2021 12:00,24 hrs.,pennystocks,FORD,105,0,105,-105,1,43,15,1,NASDAQ
4877,14-02-2021 12:00,24 hrs.,pennystocks,FTFT,40,7,33,-26,2,14,4,2,NASDAQ
4877,14-02-2021 12:00,24 hrs.,pennystocks,GIGM,24,24,0,24,1,0,20,1,NASDAQ
4877,14-02-2021 12:00,24 hrs.,pennystocks,GNUS,12,0,12,-12,2,2,0,2,NASDAQ
4877,14-02-2021 12:00,24 hrs.,pennystocks,GRIL,33,0,33,-33,1,13,3,1,NASDAQ
4877,14-02-2021 12:00,24 hrs.,pennystocks,GRNQ,24,24,0,24,1,0,20,1,NASDAQ
4877,14-02-2021 12:00,24 hrs.,pennystocks,GSUM,24,24,0,24,1,0,20,1,NASDAQ
4877,14-02-2021 12:00,24 hrs.,pennystocks,GTHX,6,6,0,6,1,1,0,1,NASDAQ
4877,14-02-2021 12:00,24 hrs.,pennystocks,GURE,24,24,0,24,1,0,20,1,NASDAQ
4877,14-02-2021 12:00,24 hrs.,wallstreetbets,PSYC,7,0,7,-7,1,1,1,1,OTC
4877,14-02-2021 12:00,24 hrs.,wallstreetbets,RBDC,7,0,7,-7,1,1,1,1,OTC
4877,14-02-2021 12:00,24 hrs.,wallstreetbets,RBNW,13,13,0,13,2,2,1,2,OTC
4877,14-02-2021 12:00,24 hrs.,wallstreetbets,SANP,28,0,28,-28,4,4,4,1,OTC
4877,14-02-2021 12:00,24 hrs.,wallstreetbets,SGMD,42,21,21,0,6,6,6,5,OTC
4877,14-02-2021 12:00,24 hrs.,wallstreetbets,SIGN,6,6,0,6,1,1,0,1,OTC
4877,14-02-2021 12:00,24 hrs.,wallstreetbets,SRMX,14,0,14,-14,2,2,2,1,OTC
4877,14-02-2021 12:00,24 hrs.,wallstreetbets,USPS,4232,0,4232,-4232,2,1925,374,2,OTC
4877,14-02-2021 12:00,24 hrs.,wallstreetbets,WGNR,8,0,8,-8,1,1,2,1,OTC
4877,14-02-2021 12:00,24 hrs.,wallstreetbets,WHEN,13,6,7,-1,2,2,1,2,OTC
4877,14-02-2021 12:00,24 hrs.,wallstreetbets,WWPW,8,8,0,8,1,1,2,1,OTC
4877,14-02-2021 12:00,24 hrs.,wallstreetbets,AAZZF,13,13,0,13,2,2,1,1,OTC
4877,14-02-2021 12:00,24 hrs.,wallstreetbets,AGFAF,14,7,7,0,2,2,2,2,OTC
4877,14-02-2021 12:00,24 hrs.,wallstreetbets,ARBKF,7,0,7,-7,1,1,1,1,OTC
4877,14-02-2021 12:00,24 hrs.,wallstreetbets,BABYF,7,0,7,-7,1,1,1,1,OTC
4877,14-02-2021 12:00,24 hrs.,wallstreetbets,BDRBF,7,0,7,-7,1,1,1,1,OTC
4877,14-02-2021 12:00,24 hrs.,wallstreetbets,CNTRF,8,0,8,-8,1,1,2,1,OTC
4877,14-02-2021 12:00,24 hrs.,wallstreetbets,CXRXF,7,0,7,-7,1,1,1,1,OTC
4877,14-02-2021 12:00,24 hrs.,wallstreetbets,DIGAF,6,0,6,-6,1,1,0,1,OTC
4877,14-02-2021 12:00,24 hrs.,wallstreetbets,GAYMF,6,0,6,-6,1,1,0,1,OTC
4877,14-02-2021 12:00,24 hrs.,wallstreetbets,GGTTF,20,0,20,-20,3,3,2,2,OTC
4877,14-02-2021 12:00,24 hrs.,wallstreetbets,HITIF,20,7,13,-6,3,3,2,3,OTC
4877,14-02-2021 12:00,24 hrs.,wallstreetbets,HTZGQ,6,0,6,-6,1,1,0,1,OTC
4877,14-02-2021 12:00,24 hrs.,wallstreetbets,IMNPQ,7,0,7,-7,1,1,1,1,OTC
4877,14-02-2021 12:00,24 hrs.,wallstreetbets,JROOF,7,7,0,7,1,1,1,1,OTC
4877,14-02-2021 12:00,24 hrs.,wallstreetbets,MMEDF,7,0,7,-7,1,1,1,1,OTC
4877,14-02-2021 12:00,24 hrs.,wallstreetbets,NXTTF,13,0,13,-13,2,2,1,2,OTC
4877,14-02-2021 12:00,24 hrs.,wallstreetbets,RECAF,13,7,6,1,2,2,1,2,OTC
4877,14-02-2021 12:00,24 hrs.,wallstreetbets,RLLCF,6,0,6,-6,1,1,0,1,OTC
4877,14-02-2021 12:00,24 hrs.,wallstreetbets,RWBYF,7,0,7,-7,1,1,1,1,OTC
4877,14-02-2021 12:00,24 hrs.,wallstreetbets,RYCEY,13,0,13,-13,2,2,1,2,OTC
4877,14-02-2021 12:00,24 hrs.,wallstreetbets,TAKOF,6,6,0,6,1,1,0,1,OTC
4877,14-02-2021 12:00,24 hrs.,wallstreetbets,TOWTF,12,0,12,-12,2,2,0,1,OTC
4877,14-02-2021 12:00,24 hrs.,wallstreetbets,TSCRF,21,21,0,21,3,3,3,1,OTC
4877,14-02-2021 12:00,24 hrs.,wallstreetbets,VLNCF,14,0,14,-14,1,0,10,1,OTC
4877,14-02-2021 12:00,24 hrs.,wallstreetbets,VRYYF,7,0,7,-7,1,1,1,1,OTC
4877,14-02-2021 12:00,24 hrs.,wallstreetbets,XJNGF,6,0,6,-6,1,1,0,1,OTC
4877,14-02-2021 12:00,24 hrs.,wallstreetbets,APT,7,0,7,-7,1,1,1,1,AMEX
4877,14-02-2021 12:00,24 hrs.,wallstreetbets,DNN,20,13,7,6,3,3,2,3,AMEX
4877,14-02-2021 12:00,24 hrs.,wallstreetbets,GDP,303,303,0,303,3,104,83,3,AMEX
4877,14-02-2021 12:00,24 hrs.,wallstreetbets,GSV,6,6,0,6,1,1,0,1,AMEX
4877,14-02-2021 12:00,24 hrs.,wallstreetbets,GTE,7,7,0,7,1,1,1,1,AMEX
4877,14-02-2021 12:00,24 hrs.,wallstreetbets,ITP,6,6,0,6,1,1,0,1,AMEX
4877,14-02-2021 12:00,24 hrs.,pennystocks,VYNE,26,26,0,26,2,4,10,1,NASDAQ
4877,14-02-2021 12:00,24 hrs.,pennystocks,XSPA,24,0,24,-24,4,4,0,3,NASDAQ
4877,14-02-2021 12:00,24 hrs.,pennystocks,YMTX,17,0,17,-17,1,4,5,1,NASDAQ
4877,14-02-2021 12:00,24 hrs.,pennystocks,ZCMD,24,24,0,24,1,0,20,1,NASDAQ
4877,14-02-2021 12:00,24 hrs.,pennystocks,ZKIN,13,0,13,-13,1,0,9,1,NASDAQ
4877,14-02-2021 12:00,24 hrs.,pennystocks,ZSAN,47,41,6,35,2,2,35,2,NASDAQ
4877,14-02-2021 12:00,24 hrs.,wallstreetbets,AABB,14,14,0,14,2,2,2,1,OTC
4877,14-02-2021 12:00,24 hrs.,wallstreetbets,ACRL,6,0,6,-6,1,1,0,1,OTC
4877,14-02-2021 12:00,24 hrs.,wallstreetbets,AITX,21,14,7,7,3,3,3,3,OTC
4877,14-02-2021 12:00,24 hrs.,wallstreetbets,BANT,6,0,6,-6,1,1,0,1,OTC
4877,14-02-2021 12:00,24 hrs.,wallstreetbets,BBRW,13,13,0,13,2,2,1,2,OTC
4877,14-02-2021 12:00,24 hrs.,wallstreetbets,BRLL,7,0,7,-7,1,1,1,1,OTC
4877,14-02-2021 12:00,24 hrs.,wallstreetbets,BRSE,9,0,9,-9,1,2,1,1,OTC
4877,14-02-2021 12:00,24 hrs.,wallstreetbets,BRZL,7,0,7,-7,1,1,1,1,OTC
4877,14-02-2021 12:00,24 hrs.,wallstreetbets,CAGR,407,0,407,-407,2,134,131,2,OTC
4877,14-02-2021 12:00,24 hrs.,wallstreetbets,CCTL,7,0,7,-7,1,1,1,1,OTC
4877,14-02-2021 12:00,24 hrs.,wallstreetbets,DKMR,7,7,0,7,1,1,1,1,OTC
4877,14-02-2021 12:00,24 hrs.,wallstreetbets,DPLS,7,7,0,7,1,1,1,1,OTC
4877,14-02-2021 12:00,24 hrs.,wallstreetbets,DRNG,7,7,0,7,1,1,1,1,OTC
4877,14-02-2021 12:00,24 hrs.,wallstreetbets,DROP,7060,0,7060,-7060,1,3352,352,1,OTC
4877,14-02-2021 12:00,24 hrs.,wallstreetbets,ECOX,14,0,14,-14,2,2,2,1,OTC
4877,14-02-2021 12:00,24 hrs.,wallstreetbets,EPR,145,145,0,145,1,39,63,1,NYSE
4877,14-02-2021 12:00,24 hrs.,wallstreetbets,ETN,7,0,7,-7,1,1,1,1,NYSE
4877,14-02-2021 12:00,24 hrs.,wallstreetbets,EXR,115,115,0,115,1,19,73,1,NYSE
4877,14-02-2021 12:00,24 hrs.,wallstreetbets,FCF,30,30,0,30,1,4,18,1,NYSE
4877,14-02-2021 12:00,24 hrs.,wallstreetbets,FCX,443,0,443,-443,1,167,105,1,NYSE
4877,14-02-2021 12:00,24 hrs.,wallstreetbets,FSR,4245,0,4245,-4245,4,1927,375,4,NYSE
4877,14-02-2021 12:00,24 hrs.,wallstreetbets,GEO,7,0,7,-7,1,1,1,1,NYSE
4877,14-02-2021 12:00,24 hrs.,wallstreetbets,GLW,31,31,0,31,1,2,23,1,NYSE
4877,14-02-2021 12:00,24 hrs.,wallstreetbets,GME,47777,2161,45616,-43455,214,20915,5091,162,NYSE
4877,14-02-2021 12:00,24 hrs.,wallstreetbets,GMS,7,7,0,7,1,1,1,1,NYSE
4877,14-02-2021 12:00,24 hrs.,wallstreetbets,GNW,6,0,6,-6,1,1,0,1,NYSE
4877,14-02-2021 12:00,24 hrs.,wallstreetbets,GSX,7,0,7,-7,1,1,1,1,NYSE
4877,14-02-2021 12:00,24 hrs.,wallstreetbets,HMI,27,6,21,-15,4,4,3,2,NYSE
4877,14-02-2021 12:00,24 hrs.,wallstreetbets,IBM,253,0,253,-253,1,103,43,1,NYSE
4877,14-02-2021 12:00,24 hrs.,wallstreetbets,ICE,30,30,0,30,1,4,18,1,NYSE
4877,14-02-2021 12:00,24 hrs.,wallstreetbets,IGT,1241,0,1241,-1241,1,583,71,1,NYSE
4877,14-02-2021 12:00,24 hrs.,wallstreetbets,IRL,7,7,0,7,1,1,1,1,NYSE
4877,14-02-2021 12:00,24 hrs.,wallstreetbets,KEY,6,6,0,6,1,1,0,1,NYSE
4877,14-02-2021 12:00,24 hrs.,wallstreetbets,KOS,21,0,21,-21,1,6,5,1,NYSE
4877,14-02-2021 12:00,24 hrs.,wallstreetbets,LOW,19,12,7,5,3,3,1,2,NYSE
4877,14-02-2021 12:00,24 hrs.,wallstreetbets,LPL,1241,0,1241,-1241,1,583,71,1,NYSE
4877,14-02-2021 12:00,24 hrs.,wallstreetbets,LTC,35,14,21,-7,5,5,5,4,NYSE
4877,14-02-2021 12:00,24 hrs.,wallstreetbets,LZB,176,0,176,-176,1,67,38,1,NYSE
4877,14-02-2021 12:00,24 hrs.,wallstreetbets,MFA,7,0,7,-7,1,1,1,1,NYSE
4877,14-02-2021 12:00,24 hrs.,wallstreetbets,MOS,176,0,176,-176,1,67,38,1,NYSE
4877,14-02-2021 12:00,24 hrs.,wallstreetbets,MRO,27,7,20,-13,2,4,11,2,NYSE
4877,14-02-2021 12:00,24 hrs.,wallstreetbets,MTD,1241,0,1241,-1241,1,583,71,1,NYSE
4877,14-02-2021 12:00,24 hrs.,wallstreetbets,NET,4610,0,4610,-4610,3,2054,490,3,NYSE
4877,14-02-2021 12:00,24 hrs.,wallstreetbets,NGL,7,0,7,-7,1,1,1,1,NYSE
4877,14-02-2021 12:00,24 hrs.,wallstreetbets,NIO,4259,13,4246,-4233,6,1929,377,5,NYSE
4877,14-02-2021 12:00,24 hrs.,wallstreetbets,NKE,6,0,6,-6,1,1,0,1,NYSE
4877,14-02-2021 12:00,24 hrs.,wallstreetbets,NMR,13,0,13,-13,2,2,1,2,NYSE
4877,14-02-2021 12:00,24 hrs.,wallstreetbets,NOK,1321,1266,55,1211,9,549,187,7,NYSE
4877,14-02-2021 12:00,24 hrs.,wallstreetbets,NPO,7,7,0,7,1,1,1,1,NYSE
4877,14-02-2021 12:00,24 hrs.,wallstreetbets,NTR,176,0,176,-176,1,67,38,1,NYSE
4877,14-02-2021 12:00,24 hrs.,wallstreetbets,OSK,136,0,136,-136,1,33,66,1,NYSE
4877,14-02-2021 12:00,24 hrs.,wallstreetbets,OXY,176,0,176,-176,1,67,38,1,NYSE
4877,14-02-2021 12:00,24 hrs.,wallstreetbets,MCF,7,0,7,-7,1,1,1,1,AMEX
4877,14-02-2021 12:00,24 hrs.,wallstreetbets,MXC,7,0,7,-7,1,1,1,1,AMEX
4877,14-02-2021 12:00,24 hrs.,wallstreetbets,NBA,7,7,0,7,1,1,1,1,AMEX
4877,14-02-2021 12:00,24 hrs.,wallstreetbets,NBY,6,0,6,-6,1,1,0,1,AMEX
4877,14-02-2021 12:00,24 hrs.,wallstreetbets,NTN,7,7,0,7,1,1,1,1,AMEX
4877,14-02-2021 12:00,24 hrs.,wallstreetbets,REI,6,0,6,-6,1,1,0,1,AMEX
4877,14-02-2021 12:00,24 hrs.,wallstreetbets,SSY,6,6,0,6,1,1,0,1,AMEX
4877,14-02-2021 12:00,24 hrs.,wallstreetbets,TRX,19,0,19,-19,3,3,1,3,AMEX
4877,14-02-2021 12:00,24 hrs.,wallstreetbets,UEC,7,7,0,7,1,1,1,1,AMEX
4877,14-02-2021 12:00,24 hrs.,wallstreetbets,ZOM,40,20,20,0,6,6,4,6,AMEX
4877,14-02-2021 12:00,24 hrs.,wallstreetbets,GOED,6,0,6,-6,1,1,0,1,AMEX
4877,14-02-2021 12:00,24 hrs.,wallstreetbets,IBIO,21,7,14,-7,3,3,3,3,AMEX
4877,14-02-2021 12:00,24 hrs.,wallstreetbets,SENS,6,0,6,-6,1,1,0,1,AMEX
4877,14-02-2021 12:00,24 hrs.,wallstreetbets,TRXC,27,7,20,-13,4,4,3,2,AMEX
4877,14-02-2021 12:00,24 hrs.,wallstreetbets,UAVS,7,0,7,-7,1,1,1,1,AMEX
4877,14-02-2021 12:00,24 hrs.,wallstreetbets,XXII,7,7,0,7,1,1,1,1,AMEX
4877,14-02-2021 12:00,24 hrs.,wallstreetbets,AAP,1417,0,1417,-1417,2,650,109,2,NYSE
4877,14-02-2021 12:00,24 hrs.,wallstreetbets,ABT,6,6,0,6,1,1,0,1,NYSE
4877,14-02-2021 12:00,24 hrs.,wallstreetbets,ACB,42,28,14,14,6,6,6,5,NYSE
4877,14-02-2021 12:00,24 hrs.,wallstreetbets,MINE,7,0,7,-7,1,1,1,1,OTC
4877,14-02-2021 12:00,24 hrs.,wallstreetbets,MKTY,7,0,7,-7,1,1,1,1,OTC
4877,14-02-2021 12:00,24 hrs.,wallstreetbets,MOST,1241,0,1241,-1241,1,583,71,1,OTC
4877,14-02-2021 12:00,24 hrs.,wallstreetbets,MRMD,8,0,8,-8,1,1,2,1,OTC
4877,14-02-2021 12:00,24 hrs.,wallstreetbets,MTVX,14,7,7,0,2,2,2,2,OTC
4877,14-02-2021 12:00,24 hrs.,wallstreetbets,NOVC,6,0,6,-6,1,1,0,1,OTC
4877,14-02-2021 12:00,24 hrs.,wallstreetbets,ONCX,7,0,7,-7,1,1,1,1,OTC
4877,14-02-2021 12:00,24 hrs.,wallstreetbets,PBHG,7,0,7,-7,1,1,1,1,OTC
4877,14-02-2021 12:00,24 hrs.,wallstreetbets,NVTA,176,0,176,-176,1,67,38,1,NYSE
4877,14-02-2021 12:00,24 hrs.,wallstreetbets,PLTR,5836,120,5716,-5596,20,2605,546,16,NYSE
4877,14-02-2021 12:00,24 hrs.,wallstreetbets,PRTY,15,0,15,-15,2,3,1,1,NYSE
4877,14-02-2021 12:00,24 hrs.,wallstreetbets,SHOP,1417,0,1417,-1417,2,650,109,2,NYSE
4877,14-02-2021 12:00,24 hrs.,wallstreetbets,SNOW,28,28,0,28,1,6,12,1,NYSE
4877,14-02-2021 12:00,24 hrs.,wallstreetbets,STPK,7,0,7,-7,1,1,1,1,NYSE
4877,14-02-2021 12:00,24 hrs.,wallstreetbets,TECK,176,0,176,-176,1,67,38,1,NYSE
4877,14-02-2021 12:00,24 hrs.,wallstreetbets,TWLO,1417,0,1417,-1417,2,650,109,2,NYSE
4877,14-02-2021 12:00,24 hrs.,wallstreetbets,TWTR,4226,0,4226,-4226,1,1924,374,1,NYSE
4877,14-02-2021 12:00,24 hrs.,wallstreetbets,UBER,14,0,14,-14,2,2,2,2,NYSE
4877,14-02-2021 12:00,24 hrs.,wallstreetbets,AAL,50,42,8,34,7,7,8,3,NASDAQ
4877,14-02-2021 12:00,24 hrs.,wallstreetbets,AMD,169,0,169,-169,3,33,91,2,NASDAQ
4877,14-02-2021 12:00,24 hrs.,wallstreetbets,BLI,1241,0,1241,-1241,1,583,71,1,NASDAQ
4877,14-02-2021 12:00,24 hrs.,wallstreetbets,CDC,30,30,0,30,1,0,26,1,NASDAQ
4877,14-02-2021 12:00,24 hrs.,wallstreetbets,CEY,24,0,24,-24,3,3,6,1,NASDAQ
4877,14-02-2021 12:00,24 hrs.,wallstreetbets,CFO,45,0,45,-45,1,11,19,1,NASDAQ
4877,14-02-2021 12:00,24 hrs.,wallstreetbets,CGC,7,0,7,-7,1,1,1,1,NASDAQ
4877,14-02-2021 12:00,24 hrs.,wallstreetbets,DBX,183,7,176,-169,2,68,39,2,NASDAQ
4877,14-02-2021 12:00,24 hrs.,wallstreetbets,FVE,253,0,253,-253,1,103,43,1,NASDAQ
4877,14-02-2021 12:00,24 hrs.,wallstreetbets,HAS,115,95,20,75,4,38,23,4,NASDAQ
4877,14-02-2021 12:00,24 hrs.,wallstreetbets,HOL,6,0,6,-6,1,1,0,1,NASDAQ
4877,14-02-2021 12:00,24 hrs.,wallstreetbets,III,28,8,20,-12,3,6,4,3,NASDAQ
4877,14-02-2021 12:00,24 hrs.,wallstreetbets,INO,96,0,96,-96,2,23,42,2,NASDAQ
4877,14-02-2021 12:00,24 hrs.,wallstreetbets,JAN,6,0,6,-6,1,1,0,1,NASDAQ
4877,14-02-2021 12:00,24 hrs.,wallstreetbets,KHC,236,236,0,236,2,69,90,2,NASDAQ
4877,14-02-2021 12:00,24 hrs.,wallstreetbets,KIN,14,0,14,-14,2,2,2,1,NASDAQ
4877,14-02-2021 12:00,24 hrs.,wallstreetbets,NEO,6,0,6,-6,1,1,0,1,NASDAQ
4877,14-02-2021 12:00,24 hrs.,wallstreetbets,NWL,115,115,0,115,1,19,73,1,NASDAQ
4877,14-02-2021 12:00,24 hrs.,wallstreetbets,PXD,176,0,176,-176,1,67,38,1,NYSE
4877,14-02-2021 12:00,24 hrs.,wallstreetbets,RCL,7,0,7,-7,1,1,1,1,NYSE
4877,14-02-2021 12:00,24 hrs.,wallstreetbets,RKT,62,6,56,-50,5,4,34,4,NYSE
4877,14-02-2021 12:00,24 hrs.,wallstreetbets,RNG,176,0,176,-176,1,67,38,1,NYSE
4877,14-02-2021 12:00,24 hrs.,wallstreetbets,SAM,176,0,176,-176,1,67,38,1,NYSE
4877,14-02-2021 12:00,24 hrs.,wallstreetbets,SAP,281,28,253,-225,2,109,55,2,NYSE
4877,14-02-2021 12:00,24 hrs.,wallstreetbets,SBE,7,0,7,-7,1,1,1,1,NYSE
4877,14-02-2021 12:00,24 hrs.,wallstreetbets,PEI,8,0,8,-8,1,1,2,1,NYSE
4877,14-02-2021 12:00,24 hrs.,wallstreetbets,PSA,166,166,0,166,2,36,86,2,NYSE
4877,14-02-2021 12:00,24 hrs.,wallstreetbets,AHT,28,28,0,28,4,4,4,2,NYSE
4877,14-02-2021 12:00,24 hrs.,wallstreetbets,AIN,7,0,7,-7,1,1,1,1,NYSE
4877,14-02-2021 12:00,24 hrs.,wallstreetbets,AMC,679,168,511,-343,63,130,167,55,NYSE
4877,14-02-2021 12:00,24 hrs.,wallstreetbets,AMP,7,7,0,7,1,1,1,1,NYSE
4877,14-02-2021 12:00,24 hrs.,wallstreetbets,ATH,445,30,415,-385,3,130,173,3,NYSE
4877,14-02-2021 12:00,24 hrs.,wallstreetbets,AYX,108,0,108,-108,1,37,30,1,NYSE
4877,14-02-2021 12:00,24 hrs.,wallstreetbets,BCH,34,28,6,22,5,5,4,5,NYSE
4877,14-02-2021 12:00,24 hrs.,wallstreetbets,BHC,7,0,7,-7,1,1,1,1,NYSE
4877,14-02-2021 12:00,24 hrs.,wallstreetbets,BOX,6,0,6,-6,1,1,0,1,NYSE
4877,14-02-2021 12:00,24 hrs.,wallstreetbets,BTI,65,65,0,65,1,10,41,1,NYSE
4877,14-02-2021 12:00,24 hrs.,wallstreetbets,BTT,23,16,7,9,3,4,3,3,NYSE
4877,14-02-2021 12:00,24 hrs.,wallstreetbets,BYD,176,0,176,-176,1,67,38,1,NYSE
4877,14-02-2021 12:00,24 hrs.,wallstreetbets,CBD,13,7,6,1,2,2,1,2,NYSE
4877,14-02-2021 12:00,24 hrs.,wallstreetbets,CCL,4233,0,4233,-4233,2,1925,375,2,NYSE
4877,14-02-2021 12:00,24 hrs.,wallstreetbets,CLS,46,46,0,46,1,7,28,1,NYSE
4877,14-02-2021 12:00,24 hrs.,wallstreetbets,CLX,7,7,0,7,1,1,1,1,NYSE
4877,14-02-2021 12:00,24 hrs.,wallstreetbets,CNC,7,0,7,-7,1,1,1,1,NYSE
4877,14-02-2021 12:00,24 hrs.,wallstreetbets,COO,12,6,6,0,2,2,0,2,NYSE
4877,14-02-2021 12:00,24 hrs.,wallstreetbets,CVS,1417,0,1417,-1417,2,650,109,2,NYSE
4877,14-02-2021 12:00,24 hrs.,wallstreetbets,CVX,6,6,0,6,1,1,0,1,NYSE
4877,14-02-2021 12:00,24 hrs.,wallstreetbets,DDD,1241,0,1241,-1241,1,583,71,1,NYSE
4877,14-02-2021 12:00,24 hrs.,wallstreetbets,DDS,1241,0,1241,-1241,1,583,71,1,NYSE
4877,14-02-2021 12:00,24 hrs.,wallstreetbets,DOW,4226,0,4226,-4226,1,1924,374,1,NYSE
4877,14-02-2021 12:00,24 hrs.,wallstreetbets,EAT,13,0,13,-13,2,2,1,2,NYSE
4877,14-02-2021 12:00,24 hrs.,wallstreetbets,EGO,56,0,56,-56,1,14,24,1,NYSE
4877,14-02-2021 12:00,24 hrs.,wallstreetbets,EOS,7,0,7,-7,1,1,1,1,NYSE
4877,14-02-2021 12:00,24 hrs.,wallstreetbets,EOT,7,0,7,-7,1,1,1,1,NYSE
4877,14-02-2021 12:00,24 hrs.,wallstreetbets,TXMD,20,14,6,8,3,3,2,3,NASDAQ
4877,14-02-2021 12:00,24 hrs.,wallstreetbets,TXRH,176,0,176,-176,1,67,38,1,NASDAQ
4877,14-02-2021 12:00,24 hrs.,wallstreetbets,TYME,8,8,0,8,1,1,2,1,NASDAQ
4877,14-02-2021 12:00,24 hrs.,wallstreetbets,UPST,7,7,0,7,1,1,1,1,NASDAQ
4877,14-02-2021 12:00,24 hrs.,wallstreetbets,VKTX,7,0,7,-7,1,1,1,1,NASDAQ
4877,14-02-2021 12:00,24 hrs.,wallstreetbets,VUZI,20,0,20,-20,3,3,2,3,NASDAQ
4877,14-02-2021 12:00,24 hrs.,wallstreetbets,VXRT,35,0,35,-35,5,5,5,1,NASDAQ
4877,14-02-2021 12:00,24 hrs.,wallstreetbets,WIMI,7,0,7,-7,1,1,1,1,NASDAQ
4877,14-02-2021 12:00,24 hrs.,wallstreetbets,WING,176,0,176,-176,1,67,38,1,NASDAQ
4877,14-02-2021 12:00,24 hrs.,wallstreetbets,WKHS,4323,6,4317,-4311,3,1939,433,3,NASDAQ
4877,14-02-2021 12:00,24 hrs.,wallstreetbets,YNDX,176,0,176,-176,1,67,38,1,NASDAQ
4877,14-02-2021 12:00,24 hrs.,wallstreetbets,ZNGA,7,0,7,-7,1,1,1,1,NASDAQ
4877,14-02-2021 12:00,24 hrs.,wallstreetbets,ZYXI,6,6,0,6,1,1,0,1,NASDAQ
4877,14-02-2021 12:00,24 hrs.,wallstreetbets,CMCSA,7,0,7,-7,1,1,1,1,NASDAQ
4877,14-02-2021 12:00,24 hrs.,RobinHoodPennyStocks,HCMC,6,6,0,6,1,1,0,1,OTC
4877,14-02-2021 12:00,24 hrs.,RobinHoodPennyStocks,RTSL,6,0,6,-6,1,1,0,1,OTC
4877,14-02-2021 12:00,24 hrs.,wallstreetbets,OGI,27,0,27,-27,4,4,3,3,NASDAQ
4877,14-02-2021 12:00,24 hrs.,wallstreetbets,QQQ,55,55,0,55,1,9,33,1,NASDAQ
4877,14-02-2021 12:00,24 hrs.,wallstreetbets,RNA,89,0,89,-89,1,22,41,1,NASDAQ
4877,14-02-2021 12:00,24 hrs.,wallstreetbets,SLP,6,0,6,-6,1,1,0,1,NASDAQ
4877,14-02-2021 12:00,24 hrs.,wallstreetbets,TGA,7,7,0,7,1,1,1,1,NASDAQ
4877,14-02-2021 12:00,24 hrs.,wallstreetbets,TTD,176,0,176,-176,1,67,38,1,NASDAQ
4877,14-02-2021 12:00,24 hrs.,wallstreetbets,UFO,15,15,0,15,2,2,3,1,NASDAQ
4877,14-02-2021 12:00,24 hrs.,wallstreetbets,VFF,7,7,0,7,1,1,1,1,NASDAQ
4877,14-02-2021 12:00,24 hrs.,wallstreetbets,VTC,6,6,0,6,1,1,0,1,NASDAQ
4877,14-02-2021 12:00,24 hrs.,wallstreetbets,WIX,176,0,176,-176,1,67,38,1,NASDAQ
4877,14-02-2021 12:00,24 hrs.,wallstreetbets,AACQ,7,0,7,-7,1,1,1,1,NASDAQ
4877,14-02-2021 12:00,24 hrs.,wallstreetbets,AAPL,4308,69,4239,-4170,6,1937,410,6,NASDAQ
4877,14-02-2021 12:00,24 hrs.,wallstreetbets,SKT,1263,22,1241,-1219,2,583,89,2,NYSE
4877,14-02-2021 12:00,24 hrs.,wallstreetbets,SOS,162,7,155,-148,14,33,40,6,NYSE
4877,14-02-2021 12:00,24 hrs.,wallstreetbets,STC,14,14,0,14,2,2,2,2,NYSE
4877,14-02-2021 12:00,24 hrs.,wallstreetbets,TDA,22,0,22,-22,1,3,12,1,NYSE
4877,14-02-2021 12:00,24 hrs.,wallstreetbets,THC,6,0,6,-6,1,1,0,1,NYSE
4877,14-02-2021 12:00,24 hrs.,wallstreetbets,THO,8,8,0,8,1,1,2,1,NYSE
4877,14-02-2021 12:00,24 hrs.,wallstreetbets,TRU,176,0,176,-176,1,67,38,1,NYSE
4877,14-02-2021 12:00,24 hrs.,wallstreetbets,TWO,65,65,0,65,1,10,41,1,NYSE
4877,14-02-2021 12:00,24 hrs.,wallstreetbets,UBS,76,0,76,-76,2,20,28,1,NYSE
4877,14-02-2021 12:00,24 hrs.,wallstreetbets,UTF,30,30,0,30,1,0,26,1,NYSE
4877,14-02-2021 12:00,24 hrs.,wallstreetbets,UVV,65,65,0,65,1,10,41,1,NYSE
4877,14-02-2021 12:00,24 hrs.,wallstreetbets,VET,9,0,9,-9,1,2,1,1,NYSE
4877,14-02-2021 12:00,24 hrs.,wallstreetbets,VHC,7,0,7,-7,1,1,1,1,NYSE
4877,14-02-2021 12:00,24 hrs.,wallstreetbets,WMT,1417,0,1417,-1417,2,650,109,2,NYSE
4877,14-02-2021 12:00,24 hrs.,wallstreetbets,WST,176,0,176,-176,1,67,38,1,NYSE
4877,14-02-2021 12:00,24 hrs.,wallstreetbets,XOM,443,0,443,-443,1,167,105,1,NYSE
4877,14-02-2021 12:00,24 hrs.,wallstreetbets,YPF,7,0,7,-7,1,1,1,1,NYSE
4877,14-02-2021 12:00,24 hrs.,wallstreetbets,ZTS,176,0,176,-176,1,67,38,1,NYSE
4877,14-02-2021 12:00,24 hrs.,wallstreetbets,ARGO,8,8,0,8,1,1,2,1,NYSE
4877,14-02-2021 12:00,24 hrs.,wallstreetbets,CCIV,75,12,63,-51,11,11,9,9,NYSE
4877,14-02-2021 12:00,24 hrs.,wallstreetbets,COTY,205,0,205,-205,1,73,55,1,NYSE
4877,14-02-2021 12:00,24 hrs.,wallstreetbets,DASH,65,19,46,-27,10,10,5,8,NYSE
4877,14-02-2021 12:00,24 hrs.,wallstreetbets,DNMR,7,7,0,7,1,1,1,1,NYSE
4877,14-02-2021 12:00,24 hrs.,wallstreetbets,EXPR,7,0,7,-7,1,1,1,1,NYSE
4877,14-02-2021 12:00,24 hrs.,wallstreetbets,FSLY,5688,0,5688,-5688,4,2585,502,4,NYSE
4877,14-02-2021 12:00,24 hrs.,wallstreetbets,FUBO,4233,7,4226,-4219,2,1925,375,2,NYSE
4877,14-02-2021 12:00,24 hrs.,wallstreetbets,FUSE,7,7,0,7,1,1,1,1,NYSE
4877,14-02-2021 12:00,24 hrs.,wallstreetbets,FVRR,1417,0,1417,-1417,2,650,109,2,NYSE
4877,14-02-2021 12:00,24 hrs.,wallstreetbets,GNRC,6,0,6,-6,1,1,0,1,NYSE
4877,14-02-2021 12:00,24 hrs.,wallstreetbets,HYLN,13,6,7,-1,2,2,1,2,NYSE
4877,14-02-2021 12:00,24 hrs.,wallstreetbets,IPOD,14,14,0,14,2,2,2,1,NYSE
4877,14-02-2021 12:00,24 hrs.,wallstreetbets,IPOF,14,14,0,14,2,2,2,1,NYSE
4877,14-02-2021 12:00,24 hrs.,wallstreetbets,MANU,6,6,0,6,1,1,0,1,NYSE
4877,14-02-2021 12:00,24 hrs.,wallstreetbets,MDLY,13,13,0,13,2,2,1,2,NYSE
4877,14-02-2021 12:00,24 hrs.,wallstreetbets,MITT,7,0,7,-7,1,1,1,1,NYSE
4877,14-02-2021 12:00,24 hrs.,wallstreetbets,NOVA,13,6,7,-1,2,2,1,2,NYSE
4877,14-02-2021 12:00,24 hrs.,RobinHoodPennyStocks,EMHTF,6,0,6,-6,1,1,0,1,OTC
4877,14-02-2021 12:00,24 hrs.,RobinHoodPennyStocks,TBPMF,7,7,0,7,1,1,1,1,OTC
4877,14-02-2021 12:00,24 hrs.,RobinHoodPennyStocks,DNN,49,43,6,37,3,15,7,3,AMEX
4877,14-02-2021 12:00,24 hrs.,RobinHoodPennyStocks,DPW,39,0,39,-39,1,12,11,1,AMEX
4877,14-02-2021 12:00,24 hrs.,RobinHoodPennyStocks,DSS,6,0,6,-6,1,1,0,1,AMEX
4877,14-02-2021 12:00,24 hrs.,RobinHoodPennyStocks,GTE,25,25,0,25,1,3,15,1,AMEX
4877,14-02-2021 12:00,24 hrs.,RobinHoodPennyStocks,NAK,6,6,0,6,1,1,0,1,AMEX
4877,14-02-2021 12:00,24 hrs.,RobinHoodPennyStocks,PTN,46,46,0,46,1,18,6,1,AMEX
4877,14-02-2021 12:00,24 hrs.,RobinHoodPennyStocks,SYN,6,6,0,6,1,1,0,1,AMEX
4877,14-02-2021 12:00,24 hrs.,RobinHoodPennyStocks,ZOM,252,252,0,252,2,95,54,2,AMEX
4877,14-02-2021 12:00,24 hrs.,RobinHoodPennyStocks,XXII,6,6,0,6,1,1,0,1,AMEX
4877,14-02-2021 12:00,24 hrs.,RobinHoodPennyStocks,EPR,37,37,0,37,1,13,7,1,NYSE
4877,14-02-2021 12:00,24 hrs.,RobinHoodPennyStocks,ETN,12,0,12,-12,2,2,0,1,NYSE
4877,14-02-2021 12:00,24 hrs.,RobinHoodPennyStocks,GME,8,0,8,-8,1,1,2,1,NYSE
4877,14-02-2021 12:00,24 hrs.,RobinHoodPennyStocks,MRO,67,0,67,-67,1,26,11,1,NYSE
4877,14-02-2021 12:00,24 hrs.,RobinHoodPennyStocks,NOK,8,0,8,-8,1,1,2,1,NYSE
4877,14-02-2021 12:00,24 hrs.,RobinHoodPennyStocks,PEG,751,751,0,751,1,347,53,1,NYSE
4877,14-02-2021 12:00,24 hrs.,RobinHoodPennyStocks,RSI,751,751,0,751,1,347,53,1,NYSE
4877,14-02-2021 12:00,24 hrs.,RobinHoodPennyStocks,SOS,6,0,6,-6,1,1,0,1,NYSE
4877,14-02-2021 12:00,24 hrs.,wallstreetbets,NCNO,1241,0,1241,-1241,1,583,71,1,NASDAQ
4877,14-02-2021 12:00,24 hrs.,wallstreetbets,NEPT,7,0,7,-7,1,1,1,1,NASDAQ
4877,14-02-2021 12:00,24 hrs.,wallstreetbets,NGAC,6,0,6,-6,1,1,0,1,NASDAQ
4877,14-02-2021 12:00,24 hrs.,wallstreetbets,NLOK,7,0,7,-7,1,1,1,1,NASDAQ
4877,14-02-2021 12:00,24 hrs.,wallstreetbets,NNDM,7,0,7,-7,1,1,1,1,NASDAQ
4877,14-02-2021 12:00,24 hrs.,wallstreetbets,NTEC,7,7,0,7,1,1,1,1,NASDAQ
4877,14-02-2021 12:00,24 hrs.,wallstreetbets,NVAX,14,14,0,14,2,2,2,2,NASDAQ
4877,14-02-2021 12:00,24 hrs.,wallstreetbets,NVCN,7,7,0,7,1,1,1,1,NASDAQ
4877,14-02-2021 12:00,24 hrs.,wallstreetbets,NVDA,7,0,7,-7,1,1,1,1,NASDAQ
4877,14-02-2021 12:00,24 hrs.,wallstreetbets,NXPI,7,0,7,-7,1,1,1,1,NASDAQ
4877,14-02-2021 12:00,24 hrs.,wallstreetbets,OCGN,21,15,6,9,3,3,3,3,NASDAQ
4877,14-02-2021 12:00,24 hrs.,wallstreetbets,PLAY,18598,0,18598,-18598,3,8783,1020,3,NASDAQ
4877,14-02-2021 12:00,24 hrs.,wallstreetbets,POWW,7,0,7,-7,1,1,1,1,NASDAQ
4877,14-02-2021 12:00,24 hrs.,wallstreetbets,PYPL,6,6,0,6,1,1,0,1,NASDAQ
4877,14-02-2021 12:00,24 hrs.,wallstreetbets,QCOM,6,0,6,-6,1,1,0,1,NASDAQ
4877,14-02-2021 12:00,24 hrs.,wallstreetbets,QDEL,176,0,176,-176,1,67,38,1,NASDAQ
4877,14-02-2021 12:00,24 hrs.,wallstreetbets,RAVE,7,0,7,-7,1,1,1,1,NASDAQ
4877,14-02-2021 12:00,24 hrs.,wallstreetbets,REAL,10,10,0,10,1,2,2,1,NASDAQ
4877,14-02-2021 12:00,24 hrs.,wallstreetbets,RIGL,7,0,7,-7,1,1,1,1,NASDAQ
4877,14-02-2021 12:00,24 hrs.,wallstreetbets,RIOT,28,21,7,14,4,4,4,4,NASDAQ
4877,14-02-2021 12:00,24 hrs.,wallstreetbets,RKDA,7,0,7,-7,1,1,1,1,NASDAQ
4877,14-02-2021 12:00,24 hrs.,wallstreetbets,RNWK,6,0,6,-6,1,1,0,1,NASDAQ
4877,14-02-2021 12:00,24 hrs.,wallstreetbets,ROKU,5643,0,5643,-5643,3,2574,483,3,NASDAQ
4877,14-02-2021 12:00,24 hrs.,wallstreetbets,SABR,7,0,7,-7,1,1,1,1,NASDAQ
4877,14-02-2021 12:00,24 hrs.,wallstreetbets,SEDG,176,0,176,-176,1,67,38,1,NASDAQ
4877,14-02-2021 12:00,24 hrs.,wallstreetbets,SESN,6,0,6,-6,1,1,0,1,NASDAQ
4877,14-02-2021 12:00,24 hrs.,wallstreetbets,SGEN,7,0,7,-7,1,1,1,1,NASDAQ
4877,14-02-2021 12:00,24 hrs.,wallstreetbets,SHIP,28,7,21,-14,4,4,4,2,NASDAQ
4877,14-02-2021 12:00,24 hrs.,wallstreetbets,SIRI,8,0,8,-8,1,1,2,1,NASDAQ
4877,14-02-2021 12:00,24 hrs.,wallstreetbets,SMCI,14,0,14,-14,2,2,2,1,NASDAQ
4877,14-02-2021 12:00,24 hrs.,wallstreetbets,SNDL,392,133,259,-126,58,58,44,45,NASDAQ
4877,14-02-2021 12:00,24 hrs.,wallstreetbets,SNGX,6,0,6,-6,1,1,0,1,NASDAQ
4877,14-02-2021 12:00,24 hrs.,wallstreetbets,SQQQ,7,0,7,-7,1,1,1,1,NASDAQ
4877,14-02-2021 12:00,24 hrs.,wallstreetbets,SRNE,7,7,0,7,1,1,1,1,NASDAQ
4877,14-02-2021 12:00,24 hrs.,wallstreetbets,STMP,176,0,176,-176,1,67,38,1,NASDAQ
4877,14-02-2021 12:00,24 hrs.,wallstreetbets,SWBI,7,0,7,-7,1,1,1,1,NASDAQ
4877,14-02-2021 12:00,24 hrs.,wallstreetbets,TELL,6,6,0,6,1,1,0,1,NASDAQ
4877,14-02-2021 12:00,24 hrs.,wallstreetbets,TLGT,19,12,7,5,3,3,1,2,NASDAQ
4877,14-02-2021 12:00,24 hrs.,wallstreetbets,TLRY,1675,202,1473,-1271,14,699,221,12,NASDAQ
4877,14-02-2021 12:00,24 hrs.,wallstreetbets,TNXP,14,0,14,-14,2,2,2,2,NASDAQ
4877,14-02-2021 12:00,24 hrs.,wallstreetbets,TRCH,7,0,7,-7,1,1,1,1,NASDAQ
4877,14-02-2021 12:00,24 hrs.,wallstreetbets,TREE,1241,0,1241,-1241,1,583,71,1,NASDAQ
4877,14-02-2021 12:00,24 hrs.,wallstreetbets,TRIT,27,0,27,-27,1,9,5,1,NASDAQ
4877,14-02-2021 12:00,24 hrs.,wallstreetbets,TRVG,40,21,19,2,6,6,4,6,NASDAQ
4877,14-02-2021 12:00,24 hrs.,wallstreetbets,TSLA,5776,575,5201,-4626,17,2410,888,14,NASDAQ
4877,14-02-2021 12:00,24 hrs.,stocks,ENKS,6,0,6,-6,1,1,0,1,OTC
4877,14-02-2021 12:00,24 hrs.,stocks,KYNC,6,0,6,-6,1,1,0,1,OTC
4877,14-02-2021 12:00,24 hrs.,stocks,LINK,683,0,683,-683,1,312,55,1,OTC
4877,14-02-2021 12:00,24 hrs.,stocks,LQMT,19,0,19,-19,1,6,3,1,OTC
4877,14-02-2021 12:00,24 hrs.,stocks,LTNC,6,0,6,-6,1,1,0,1,OTC
4877,14-02-2021 12:00,24 hrs.,stocks,MINE,24,6,18,-12,4,4,0,2,OTC
4877,14-02-2021 12:00,24 hrs.,stocks,MOST,683,0,683,-683,1,312,55,1,OTC
4877,14-02-2021 12:00,24 hrs.,stocks,NMTC,91,0,91,-91,1,36,15,1,OTC
4877,14-02-2021 12:00,24 hrs.,stocks,OPTI,6,6,0,6,1,1,0,1,OTC
4877,14-02-2021 12:00,24 hrs.,stocks,PPJE,6,6,0,6,1,1,0,1,OTC
4877,14-02-2021 12:00,24 hrs.,stocks,ROTH,7,7,0,7,1,1,1,1,OTC
4877,14-02-2021 12:00,24 hrs.,stocks,SAFS,6,6,0,6,1,1,0,1,OTC
4877,14-02-2021 12:00,24 hrs.,stocks,SAGD,19,0,19,-19,1,2,11,1,OTC
4877,14-02-2021 12:00,24 hrs.,stocks,SGMD,12,0,12,-12,2,2,0,1,OTC
4877,14-02-2021 12:00,24 hrs.,stocks,TRUL,6,0,6,-6,1,1,0,1,OTC
4877,14-02-2021 12:00,24 hrs.,RobinHoodPennyStocks,WTM,6,6,0,6,1,1,0,1,NYSE
4877,14-02-2021 12:00,24 hrs.,RobinHoodPennyStocks,DECK,6,6,0,6,1,1,0,1,NYSE
4877,14-02-2021 12:00,24 hrs.,RobinHoodPennyStocks,IPOE,6,0,6,-6,1,1,0,1,NYSE
4877,14-02-2021 12:00,24 hrs.,RobinHoodPennyStocks,SND,59,0,59,-59,1,17,21,1,NASDAQ
4877,14-02-2021 12:00,24 hrs.,RobinHoodPennyStocks,AAPL,751,751,0,751,1,347,53,1,NASDAQ
4877,14-02-2021 12:00,24 hrs.,RobinHoodPennyStocks,ADXS,6,6,0,6,1,1,0,1,NASDAQ
4877,14-02-2021 12:00,24 hrs.,RobinHoodPennyStocks,AGEN,6,0,6,-6,1,1,0,1,NASDAQ
4877,14-02-2021 12:00,24 hrs.,RobinHoodPennyStocks,AGTC,184,184,0,184,1,70,40,1,NASDAQ
4877,14-02-2021 12:00,24 hrs.,RobinHoodPennyStocks,AKBA,7,7,0,7,1,1,1,1,NASDAQ
4877,14-02-2021 12:00,24 hrs.,RobinHoodPennyStocks,ASRT,13,0,13,-13,1,1,7,1,NASDAQ
4877,14-02-2021 12:00,24 hrs.,RobinHoodPennyStocks,BVXV,6,6,0,6,1,1,0,1,NASDAQ
4877,14-02-2021 12:00,24 hrs.,RobinHoodPennyStocks,CSTR,4,0,4,-4,1,0,0,1,NASDAQ
4877,14-02-2021 12:00,24 hrs.,RobinHoodPennyStocks,CTRM,6,0,6,-6,1,1,0,1,NASDAQ
4877,14-02-2021 12:00,24 hrs.,RobinHoodPennyStocks,FLMN,6,0,6,-6,1,1,0,1,NASDAQ
4877,14-02-2021 12:00,24 hrs.,RobinHoodPennyStocks,GOGO,11,0,11,-11,1,0,7,1,NASDAQ
4877,14-02-2021 12:00,24 hrs.,RobinHoodPennyStocks,GRPN,26,0,26,-26,1,6,10,1,NASDAQ
4877,14-02-2021 12:00,24 hrs.,RobinHoodPennyStocks,IDEX,6,6,0,6,1,1,0,1,NASDAQ
4877,14-02-2021 12:00,24 hrs.,RobinHoodPennyStocks,INPX,6,6,0,6,1,1,0,1,NASDAQ
4877,14-02-2021 12:00,24 hrs.,RobinHoodPennyStocks,JAGX,150,150,0,150,1,61,24,1,NASDAQ
4877,14-02-2021 12:00,24 hrs.,RobinHoodPennyStocks,MARA,33,33,0,33,1,3,23,1,NASDAQ
4877,14-02-2021 12:00,24 hrs.,RobinHoodPennyStocks,SNDL,32,26,6,20,3,10,0,3,NASDAQ
4877,14-02-2021 12:00,24 hrs.,RobinHoodPennyStocks,SONM,23,0,23,-23,1,3,13,1,NASDAQ
4877,14-02-2021 12:00,24 hrs.,RobinHoodPennyStocks,SXTC,14,0,14,-14,1,4,2,1,NASDAQ
4877,14-02-2021 12:00,24 hrs.,RobinHoodPennyStocks,TNXP,18,18,0,18,3,3,0,1,NASDAQ
4877,14-02-2021 12:00,24 hrs.,RobinHoodPennyStocks,TRCH,78,6,72,-66,2,21,28,2,NASDAQ
4877,14-02-2021 12:00,24 hrs.,RobinHoodPennyStocks,TSLA,6,0,6,-6,1,1,0,1,NASDAQ
4877,14-02-2021 12:00,24 hrs.,RobinHoodPennyStocks,TXMD,13,0,13,-13,1,1,7,1,NASDAQ
4877,14-02-2021 12:00,24 hrs.,SPACs,CAGR,58,0,58,-58,1,2,50,1,OTC
4877,14-02-2021 12:00,24 hrs.,SPACs,NOVC,6,0,6,-6,1,0,2,1,OTC
4877,14-02-2021 12:00,24 hrs.,SPACs,AMC,18,0,18,-18,1,1,12,1,NYSE
4877,14-02-2021 12:00,24 hrs.,SPACs,BFT,71,0,71,-71,3,4,51,3,NYSE
4877,14-02-2021 12:00,24 hrs.,SPACs,GME,18,0,18,-18,1,1,12,1,NYSE
4877,14-02-2021 12:00,24 hrs.,SPACs,HLF,44,44,0,44,1,1,38,1,NYSE
4877,14-02-2021 12:00,24 hrs.,SPACs,JWS,67,0,67,-67,2,2,55,2,NYSE
4877,14-02-2021 12:00,24 hrs.,SPACs,MLM,44,44,0,44,1,1,38,1,NYSE
4877,14-02-2021 12:00,24 hrs.,SPACs,NAV,1227,0,1227,-1227,5,421,365,5,NYSE
4877,14-02-2021 12:00,24 hrs.,SPACs,RTP,27,27,0,27,1,6,11,1,NYSE
4877,14-02-2021 12:00,24 hrs.,SPACs,SBE,58,0,58,-58,1,2,50,1,NYSE
4877,14-02-2021 12:00,24 hrs.,SPACs,AJAX,87,0,87,-87,1,9,65,1,NYSE
4877,14-02-2021 12:00,24 hrs.,SPACs,ALUS,59,59,0,59,1,18,19,1,NYSE
4877,14-02-2021 12:00,24 hrs.,SPACs,CCIV,1876,640,1236,-596,9,709,422,7,NYSE
4877,14-02-2021 12:00,24 hrs.,SPACs,DNMR,65,0,65,-65,1,22,17,1,NYSE
4877,14-02-2021 12:00,24 hrs.,SPACs,FGNA,510,0,510,-510,1,159,188,1,NYSE
4877,14-02-2021 12:00,24 hrs.,SPACs,FUSE,555,45,510,-465,4,161,217,3,NYSE
4877,14-02-2021 12:00,24 hrs.,SPACs,IPOF,6,0,6,-6,1,1,0,1,NYSE
4877,14-02-2021 12:00,24 hrs.,SPACs,LGVW,7,0,7,-7,1,1,1,1,NYSE
4877,14-02-2021 12:00,24 hrs.,SPACs,MPLN,66,0,66,-66,1,26,10,1,NYSE
4877,14-02-2021 12:00,24 hrs.,RobinHoodPennyStocks,SGMD,6,6,0,6,1,1,0,1,OTC
4877,14-02-2021 12:00,24 hrs.,RobinHoodPennyStocks,ARBKF,33,33,0,33,1,3,23,1,OTC
4877,14-02-2021 12:00,24 hrs.,stocks,NET,5597,0,5597,-5597,1,2524,545,1,NYSE
4877,14-02-2021 12:00,24 hrs.,stocks,NGL,6,0,6,-6,1,1,0,1,NYSE
4877,14-02-2021 12:00,24 hrs.,stocks,NIO,168,25,143,-118,2,49,62,2,NYSE
4877,14-02-2021 12:00,24 hrs.,stocks,PBA,55,55,0,55,1,10,31,1,NYSE
4877,14-02-2021 12:00,24 hrs.,stocks,RBC,7,0,7,-7,1,1,1,1,NYSE
4877,14-02-2021 12:00,24 hrs.,stocks,SBE,47,0,47,-47,2,11,17,2,NYSE
4877,14-02-2021 12:00,24 hrs.,stocks,SHO,6,0,6,-6,1,1,0,1,NYSE
4877,14-02-2021 12:00,24 hrs.,stocks,SKT,683,0,683,-683,1,312,55,1,NYSE
4877,14-02-2021 12:00,24 hrs.,stocks,SOI,7,7,0,7,1,1,1,1,NYSE
4877,14-02-2021 12:00,24 hrs.,stocks,SOS,46,0,46,-46,1,12,18,1,NYSE
4877,14-02-2021 12:00,24 hrs.,stocks,THC,83,0,83,-83,1,21,37,1,NYSE
4877,14-02-2021 12:00,24 hrs.,stocks,TSM,41,41,0,41,1,3,31,1,NYSE
4877,14-02-2021 12:00,24 hrs.,stocks,WMT,683,0,683,-683,1,312,55,1,NYSE
4877,14-02-2021 12:00,24 hrs.,stocks,XOM,48,0,48,-48,1,14,16,1,NYSE
4877,14-02-2021 12:00,24 hrs.,stocks,BABA,33,33,0,33,1,6,17,1,NYSE
4877,14-02-2021 12:00,24 hrs.,stocks,BRMK,55,55,0,55,1,10,31,1,NYSE
4877,14-02-2021 12:00,24 hrs.,stocks,CHWY,299,0,299,-299,1,118,59,1,NYSE
4877,14-02-2021 12:00,24 hrs.,stocks,COTY,7,7,0,7,1,1,1,1,NYSE
4877,14-02-2021 12:00,24 hrs.,stocks,DSSI,15,0,15,-15,1,2,7,1,NYSE
4877,14-02-2021 12:00,24 hrs.,stocks,EARN,6,6,0,6,1,1,0,1,NYSE
4877,14-02-2021 12:00,24 hrs.,stocks,FSLY,683,0,683,-683,1,312,55,1,NYSE
4877,14-02-2021 12:00,24 hrs.,stocks,FVRR,683,0,683,-683,1,312,55,1,NYSE
4877,14-02-2021 12:00,24 hrs.,stocks,LGVW,8,8,0,8,1,1,2,1,NYSE
4877,14-02-2021 12:00,24 hrs.,stocks,NYCB,75,0,75,-75,1,17,37,1,NYSE
4877,14-02-2021 12:00,24 hrs.,stocks,PLTR,844,6,838,-832,5,359,106,4,NYSE
4877,14-02-2021 12:00,24 hrs.,stocks,SHOP,716,33,683,-650,2,318,72,2,NYSE
4877,14-02-2021 12:00,24 hrs.,stocks,SNAP,41,0,41,-41,1,9,19,1,NYSE
4877,14-02-2021 12:00,24 hrs.,stocks,SPCE,173,0,173,-173,1,46,77,1,NYSE
4877,14-02-2021 12:00,24 hrs.,stocks,TWLO,683,0,683,-683,1,312,55,1,NYSE
4877,14-02-2021 12:00,24 hrs.,stocks,COCSF,45,0,45,-45,1,20,1,1,OTC
4877,14-02-2021 12:00,24 hrs.,stocks,HRVSF,6,0,6,-6,1,1,0,1,OTC
4877,14-02-2021 12:00,24 hrs.,stocks,HVBTF,7,7,0,7,1,1,1,1,OTC
4877,14-02-2021 12:00,24 hrs.,stocks,TCEHY,6,6,0,6,1,1,0,1,OTC
4877,14-02-2021 12:00,24 hrs.,stocks,TCNNF,6,0,6,-6,1,1,0,1,OTC
4877,14-02-2021 12:00,24 hrs.,stocks,WXIBF,33,33,0,33,1,6,17,1,OTC
4877,14-02-2021 12:00,24 hrs.,stocks,XJNGF,6,0,6,-6,1,1,0,1,OTC
4877,14-02-2021 12:00,24 hrs.,stocks,DNN,12,12,0,12,1,0,8,1,AMEX
4877,14-02-2021 12:00,24 hrs.,stocks,UAVS,6,0,6,-6,1,1,0,1,AMEX
4877,14-02-2021 12:00,24 hrs.,stocks,AAP,683,0,683,-683,1,312,55,1,NYSE
4877,14-02-2021 12:00,24 hrs.,stocks,AEO,17,17,0,17,1,1,11,1,NYSE
4877,14-02-2021 12:00,24 hrs.,stocks,AIV,33,0,33,-33,1,10,9,1,NYSE
4877,14-02-2021 12:00,24 hrs.,stocks,AMC,6,6,0,6,1,1,0,1,NYSE
4877,14-02-2021 12:00,24 hrs.,SPACs,PCPL,510,0,510,-510,1,159,188,1,NYSE
4877,14-02-2021 12:00,24 hrs.,SPACs,PLNT,44,44,0,44,1,1,38,1,NYSE
4877,14-02-2021 12:00,24 hrs.,SPACs,PSTH,1488,308,1180,-872,9,550,352,8,NYSE
4877,14-02-2021 12:00,24 hrs.,SPACs,RBAC,23,0,23,-23,1,3,13,1,NYSE
4877,14-02-2021 12:00,24 hrs.,SPACs,SKLZ,27,0,27,-27,4,4,3,1,NYSE
4877,14-02-2021 12:00,24 hrs.,SPACs,STPK,87,7,80,-73,5,6,55,3,NYSE
4877,14-02-2021 12:00,24 hrs.,SPACs,VYGG,7,0,7,-7,1,1,1,1,NYSE
4877,14-02-2021 12:00,24 hrs.,SPACs,HAS,44,44,0,44,1,1,38,1,NASDAQ
4877,14-02-2021 12:00,24 hrs.,SPACs,III,141,0,141,-141,1,44,49,1,NASDAQ
4877,14-02-2021 12:00,24 hrs.,SPACs,AACQ,607,196,411,-215,6,219,145,6,NASDAQ
4877,14-02-2021 12:00,24 hrs.,SPACs,ACAC,45,0,45,-45,1,13,15,1,NASDAQ
4877,14-02-2021 12:00,24 hrs.,SPACs,BTAQ,117,0,117,-117,2,43,23,2,NASDAQ
4877,14-02-2021 12:00,24 hrs.,SPACs,FTOC,577,67,510,-443,2,186,197,2,NASDAQ
4877,14-02-2021 12:00,24 hrs.,SPACs,GHIV,651,0,651,-651,2,203,237,2,NASDAQ
4877,14-02-2021 12:00,24 hrs.,SPACs,NBAC,23,0,23,-23,1,9,1,1,NASDAQ
4877,14-02-2021 12:00,24 hrs.,SPACs,NGAC,169,0,169,-169,2,60,41,2,NASDAQ
4877,14-02-2021 12:00,24 hrs.,SPACs,PTON,44,44,0,44,1,1,38,1,NASDAQ
4877,14-02-2021 12:00,24 hrs.,SPACs,ROCH,22,22,0,22,1,5,8,1,NASDAQ
4877,14-02-2021 12:00,24 hrs.,SPACs,SSPK,26,26,0,26,1,5,12,1,NASDAQ
4877,14-02-2021 12:00,24 hrs.,SPACs,THCB,464,12,452,-440,2,195,66,2,NASDAQ
4877,14-02-2021 12:00,24 hrs.,SPACs,TSLA,9,9,0,9,1,0,5,1,NASDAQ
4877,14-02-2021 12:00,24 hrs.,SPACs,AACQW,44,0,44,-44,1,14,12,1,NASDAQ
4877,14-02-2021 12:00,24 hrs.,stocks,HOLI,12,0,12,-12,2,2,0,1,NASDAQ
4877,14-02-2021 12:00,24 hrs.,stocks,IFMK,18,18,0,18,3,3,0,1,NASDAQ
4877,14-02-2021 12:00,24 hrs.,stocks,KLIC,36,0,36,-36,1,14,4,1,NASDAQ
4877,14-02-2021 12:00,24 hrs.,stocks,KOPN,18,0,18,-18,1,5,4,1,NASDAQ
4877,14-02-2021 12:00,24 hrs.,stocks,LAZR,6,6,0,6,1,1,0,1,NASDAQ
4877,14-02-2021 12:00,24 hrs.,stocks,MSFT,131,58,73,-15,4,19,77,4,NASDAQ
4877,14-02-2021 12:00,24 hrs.,stocks,MVIS,6,6,0,6,1,1,0,1,NASDAQ
4877,14-02-2021 12:00,24 hrs.,stocks,NAKD,6,6,0,6,1,1,0,1,NASDAQ
4877,14-02-2021 12:00,24 hrs.,stocks,NCNO,683,0,683,-683,1,312,55,1,NASDAQ
4877,14-02-2021 12:00,24 hrs.,stocks,NNOX,6,6,0,6,1,1,0,1,NASDAQ
4877,14-02-2021 12:00,24 hrs.,stocks,NOVN,6,6,0,6,1,1,0,1,NASDAQ
4877,14-02-2021 12:00,24 hrs.,stocks,NVCN,20,20,0,20,1,6,4,1,NASDAQ
4877,14-02-2021 12:00,24 hrs.,stocks,VGAC,20,20,0,20,1,5,6,1,NYSE
4877,14-02-2021 12:00,24 hrs.,stocks,AAL,62,0,62,-62,1,11,36,1,NASDAQ
4877,14-02-2021 12:00,24 hrs.,stocks,AMD,13,6,7,-1,2,2,1,2,NASDAQ
4877,14-02-2021 12:00,24 hrs.,stocks,BLI,683,0,683,-683,1,312,55,1,NASDAQ
4877,14-02-2021 12:00,24 hrs.,stocks,CFO,6,0,6,-6,1,1,0,1,NASDAQ
4877,14-02-2021 12:00,24 hrs.,stocks,FUV,41,41,0,41,2,10,13,2,NASDAQ
4877,14-02-2021 12:00,24 hrs.,stocks,HAS,6,6,0,6,1,1,0,1,NASDAQ
4877,14-02-2021 12:00,24 hrs.,stocks,III,16,0,16,-16,1,4,4,1,NASDAQ
4877,14-02-2021 12:00,24 hrs.,stocks,NIU,173,0,173,-173,1,46,77,1,NASDAQ
4877,14-02-2021 12:00,24 hrs.,stocks,PAA,55,55,0,55,1,10,31,1,NASDAQ
4877,14-02-2021 12:00,24 hrs.,stocks,PEP,40,40,0,40,1,12,12,1,NASDAQ
4877,14-02-2021 12:00,24 hrs.,stocks,QQC,22,22,0,22,1,3,12,1,NASDAQ
4877,14-02-2021 12:00,24 hrs.,stocks,QQQ,64,64,0,64,3,9,34,3,NASDAQ
4877,14-02-2021 12:00,24 hrs.,stocks,QTT,6,0,6,-6,1,1,0,1,NASDAQ
4877,14-02-2021 12:00,24 hrs.,stocks,REG,6,0,6,-6,1,1,0,1,NASDAQ
4877,14-02-2021 12:00,24 hrs.,stocks,SDC,6,6,0,6,1,1,0,1,NASDAQ
4877,14-02-2021 12:00,24 hrs.,stocks,AAPL,137,58,79,-21,5,20,77,5,NASDAQ
4877,14-02-2021 12:00,24 hrs.,stocks,BCH,6,6,0,6,1,1,0,1,NYSE
4877,14-02-2021 12:00,24 hrs.,stocks,BKH,48,0,48,-48,1,14,16,1,NYSE
4877,14-02-2021 12:00,24 hrs.,stocks,BYD,25,25,0,25,1,5,11,1,NYSE
4877,14-02-2021 12:00,24 hrs.,stocks,CMA,6,0,6,-6,1,1,0,1,NYSE
4877,14-02-2021 12:00,24 hrs.,stocks,CNQ,19,0,19,-19,1,2,11,1,NYSE
4877,14-02-2021 12:00,24 hrs.,stocks,CVE,19,0,19,-19,1,2,11,1,NYSE
4877,14-02-2021 12:00,24 hrs.,stocks,CVS,683,0,683,-683,1,312,55,1,NYSE
4877,14-02-2021 12:00,24 hrs.,stocks,DCF,15,15,0,15,1,3,5,1,NYSE
4877,14-02-2021 12:00,24 hrs.,stocks,DDD,683,0,683,-683,1,312,55,1,NYSE
4877,14-02-2021 12:00,24 hrs.,stocks,DDS,683,0,683,-683,1,312,55,1,NYSE
4877,14-02-2021 12:00,24 hrs.,stocks,DIS,43,25,18,7,3,4,23,3,NYSE
4877,14-02-2021 12:00,24 hrs.,stocks,EFT,17,0,17,-17,1,5,3,1,NYSE
4877,14-02-2021 12:00,24 hrs.,stocks,ELY,55,55,0,55,1,10,31,1,NYSE
4877,14-02-2021 12:00,24 hrs.,stocks,ENB,17,17,0,17,1,4,5,1,NYSE
4877,14-02-2021 12:00,24 hrs.,stocks,EPR,12,12,0,12,1,0,8,1,NYSE
4877,14-02-2021 12:00,24 hrs.,stocks,ETH,6,0,6,-6,1,1,0,1,NYSE
4877,14-02-2021 12:00,24 hrs.,stocks,FTI,16,0,16,-16,2,4,0,2,NYSE
4877,14-02-2021 12:00,24 hrs.,stocks,GLW,19,19,0,19,1,3,9,1,NYSE
4877,14-02-2021 12:00,24 hrs.,stocks,GME,720,21,699,-678,6,318,60,6,NYSE
4877,14-02-2021 12:00,24 hrs.,stocks,GSK,6,6,0,6,1,1,0,1,NYSE
4877,14-02-2021 12:00,24 hrs.,stocks,HPQ,299,0,299,-299,1,118,59,1,NYSE
4877,14-02-2021 12:00,24 hrs.,stocks,IBM,48,0,48,-48,1,14,16,1,NYSE
4877,14-02-2021 12:00,24 hrs.,stocks,IGT,683,0,683,-683,1,312,55,1,NYSE
4877,14-02-2021 12:00,24 hrs.,stocks,JNJ,48,0,48,-48,1,14,16,1,NYSE
4877,14-02-2021 12:00,24 hrs.,stocks,JPM,48,0,48,-48,1,14,16,1,NYSE
4877,14-02-2021 12:00,24 hrs.,stocks,KOF,45,0,45,-45,1,20,1,1,NYSE
4877,14-02-2021 12:00,24 hrs.,stocks,LAC,6,0,6,-6,1,1,0,1,NYSE
4877,14-02-2021 12:00,24 hrs.,stocks,LEG,48,0,48,-48,1,14,16,1,NYSE
4877,14-02-2021 12:00,24 hrs.,stocks,LPL,683,0,683,-683,1,312,55,1,NYSE
4877,14-02-2021 12:00,24 hrs.,stocks,LTC,55,55,0,55,1,10,31,1,NYSE
4877,14-02-2021 12:00,24 hrs.,stocks,MAC,89,0,89,-89,1,35,15,1,NYSE
4877,14-02-2021 12:00,24 hrs.,stocks,MFA,6,0,6,-6,1,1,0,1,NYSE
4877,14-02-2021 12:00,24 hrs.,stocks,MMM,48,0,48,-48,1,14,16,1,NYSE
4877,14-02-2021 12:00,24 hrs.,stocks,MPW,55,55,0,55,1,10,31,1,NYSE
4877,14-02-2021 12:00,24 hrs.,stocks,MTD,683,0,683,-683,1,312,55,1,NYSE
4877,14-02-2021 12:00,24 hrs.,Daytrading,AMC,5,0,5,-5,1,0,1,1,NYSE
4877,14-02-2021 12:00,24 hrs.,Daytrading,GME,76,0,76,-76,2,19,30,2,NYSE
4877,14-02-2021 12:00,24 hrs.,Daytrading,IRS,13,0,13,-13,1,1,7,1,NYSE
4877,14-02-2021 12:00,24 hrs.,Daytrading,PDT,27,14,13,1,3,3,9,2,NYSE
4877,14-02-2021 12:00,24 hrs.,Daytrading,TWO,6,0,6,-6,1,1,0,1,NYSE
4877,14-02-2021 12:00,24 hrs.,Daytrading,USB,9,9,0,9,1,2,1,1,NYSE
4877,14-02-2021 12:00,24 hrs.,Daytrading,DUO,6,0,6,-6,1,1,0,1,NASDAQ
4877,14-02-2021 12:00,24 hrs.,Daytrading,SNDL,47,0,47,-47,1,9,25,1,NASDAQ
4877,14-02-2021 12:00,24 hrs.,Daytrading,TRMD,6,0,6,-6,1,1,0,1,NASDAQ
4877,14-02-2021 12:00,24 hrs.,trakstocks,DMNXF,95,0,95,-95,2,27,33,2,OTC
4877,14-02-2021 12:00,24 hrs.,trakstocks,LITOF,15,15,0,15,1,4,3,1,OTC
4877,14-02-2021 12:00,24 hrs.,trakstocks,LXXGF,22,16,6,10,3,5,0,3,OTC
4877,14-02-2021 12:00,24 hrs.,trakstocks,BIOX,11,11,0,11,1,3,1,1,AMEX
4877,14-02-2021 12:00,24 hrs.,trakstocks,CBO,24,0,24,-24,1,5,10,1,NYSE
4877,14-02-2021 12:00,24 hrs.,trakstocks,LAC,15,15,0,15,1,4,3,1,NYSE
4877,14-02-2021 12:00,24 hrs.,trakstocks,NAT,15,0,15,-15,1,4,3,1,NYSE
4877,14-02-2021 12:00,24 hrs.,trakstocks,PEG,516,516,0,516,1,240,32,1,NYSE
4877,14-02-2021 12:00,24 hrs.,trakstocks,RSI,516,516,0,516,1,240,32,1,NYSE
4877,14-02-2021 12:00,24 hrs.,trakstocks,HYLN,6,6,0,6,1,1,0,1,NYSE
4877,14-02-2021 12:00,24 hrs.,trakstocks,STPK,76,76,0,76,1,31,10,1,NYSE
4877,14-02-2021 12:00,24 hrs.,trakstocks,FUV,53,0,53,-53,1,20,9,1,NASDAQ
4877,14-02-2021 12:00,24 hrs.,trakstocks,PLL,15,15,0,15,1,4,3,1,NASDAQ
4877,14-02-2021 12:00,24 hrs.,trakstocks,AAPL,516,516,0,516,1,240,32,1,NASDAQ
4877,14-02-2021 12:00,24 hrs.,trakstocks,AYRO,70,0,70,-70,2,26,10,2,NASDAQ
4877,14-02-2021 12:00,24 hrs.,trakstocks,CLVS,27,0,27,-27,1,11,1,1,NASDAQ
4877,14-02-2021 12:00,24 hrs.,trakstocks,ENLV,10,0,10,-10,1,3,0,1,NASDAQ
4877,14-02-2021 12:00,24 hrs.,trakstocks,LIFE,100,100,0,100,1,36,24,1,NASDAQ
4877,14-02-2021 12:00,24 hrs.,trakstocks,MNOV,6,6,0,6,1,1,0,1,NASDAQ
4877,14-02-2021 12:00,24 hrs.,trakstocks,MVIS,19,0,19,-19,1,5,5,1,NASDAQ
4877,14-02-2021 12:00,24 hrs.,trakstocks,OTLK,7,7,0,7,1,0,3,1,NASDAQ
4877,14-02-2021 12:00,24 hrs.,trakstocks,PLAY,11,11,0,11,1,3,1,1,NASDAQ
4877,14-02-2021 12:00,24 hrs.,trakstocks,QLGN,24,16,8,8,2,7,2,2,NASDAQ
4877,14-02-2021 12:00,24 hrs.,trakstocks,TRCH,98,98,0,98,1,40,14,1,NASDAQ
4877,14-02-2021 12:00,24 hrs.,trakstocks,TSLA,15,15,0,15,1,4,3,1,NASDAQ
4877,14-02-2021 12:00,24 hrs.,wallstreetbets,ADXS,7,0,7,-7,1,1,1,1,NASDAQ
4877,14-02-2021 12:00,24 hrs.,wallstreetbets,AGTC,7,7,0,7,1,1,1,1,NASDAQ
4877,14-02-2021 12:00,24 hrs.,wallstreetbets,AKAM,59,0,59,-59,3,13,21,2,NASDAQ
4877,14-02-2021 12:00,24 hrs.,wallstreetbets,AKBA,7,0,7,-7,1,1,1,1,NASDAQ
4877,14-02-2021 12:00,24 hrs.,wallstreetbets,ALNA,7,0,7,-7,1,1,1,1,NASDAQ
4877,14-02-2021 12:00,24 hrs.,wallstreetbets,AMAT,396,0,396,-396,2,146,96,2,NASDAQ
4877,14-02-2021 12:00,24 hrs.,wallstreetbets,AMZN,7,0,7,-7,1,1,1,1,NASDAQ
4877,14-02-2021 12:00,24 hrs.,wallstreetbets,ANSS,14,14,0,14,2,2,2,2,NASDAQ
4877,14-02-2021 12:00,24 hrs.,stocks,AGTC,6,6,0,6,1,1,0,1,NASDAQ
4877,14-02-2021 12:00,24 hrs.,stocks,AMZN,6,0,6,-6,1,1,0,1,NASDAQ
4877,14-02-2021 12:00,24 hrs.,stocks,APHA,191,6,185,-179,4,49,77,4,NASDAQ
4877,14-02-2021 12:00,24 hrs.,stocks,APRE,6,6,0,6,1,1,0,1,NASDAQ
4877,14-02-2021 12:00,24 hrs.,stocks,ATOS,6,6,0,6,1,1,0,1,NASDAQ
4877,14-02-2021 12:00,24 hrs.,stocks,AZRX,6,0,6,-6,1,1,0,1,NASDAQ
4877,14-02-2021 12:00,24 hrs.,stocks,BIGC,683,0,683,-683,1,312,55,1,NASDAQ
4877,14-02-2021 12:00,24 hrs.,stocks,BNGO,18,6,12,-6,3,3,0,3,NASDAQ
4877,14-02-2021 12:00,24 hrs.,stocks,CCRC,6,0,6,-6,1,1,0,1,NASDAQ
4877,14-02-2021 12:00,24 hrs.,stocks,CRNT,6,0,6,-6,1,1,0,1,NASDAQ
4877,14-02-2021 12:00,24 hrs.,stocks,CRSR,261,0,261,-261,1,86,85,1,NASDAQ
4877,14-02-2021 12:00,24 hrs.,stocks,DRIV,34,0,34,-34,1,11,8,1,NASDAQ
4877,14-02-2021 12:00,24 hrs.,stocks,EXEL,10,0,10,-10,1,2,2,1,NASDAQ
4877,14-02-2021 12:00,24 hrs.,stocks,EXPI,4,0,4,-4,1,0,0,1,NASDAQ
4877,14-02-2021 12:00,24 hrs.,stocks,FIZZ,683,0,683,-683,1,312,55,1,NASDAQ
4877,14-02-2021 12:00,24 hrs.,stocks,FOLD,76,76,0,76,1,23,26,1,NASDAQ
4877,14-02-2021 12:00,24 hrs.,stocks,FROG,12,6,6,0,2,2,0,2,NASDAQ
4877,14-02-2021 12:00,24 hrs.,stocks,FTHM,1605,1605,0,1605,1,745,111,1,NASDAQ
4877,14-02-2021 12:00,24 hrs.,stocks,GNOG,6,0,6,-6,1,1,0,1,NASDAQ
4877,14-02-2021 12:00,24 hrs.,stocks,GOGO,689,0,689,-689,2,313,55,2,NASDAQ
4877,14-02-2021 12:00,24 hrs.,stocks,GOOG,95,33,62,-29,2,16,55,2,NASDAQ
4877,14-02-2021 12:00,24 hrs.,stocks,GTHX,18,18,0,18,3,3,0,2,NASDAQ
4877,14-02-2021 12:00,24 hrs.,wallstreetbets,CLEU,14,0,14,-14,2,2,2,2,NASDAQ
4877,14-02-2021 12:00,24 hrs.,wallstreetbets,CLVS,14,0,14,-14,2,2,2,1,NASDAQ
4877,14-02-2021 12:00,24 hrs.,wallstreetbets,COST,122,122,0,122,1,41,36,1,NASDAQ
4877,14-02-2021 12:00,24 hrs.,wallstreetbets,CPRT,176,0,176,-176,1,67,38,1,NASDAQ
4877,14-02-2021 12:00,24 hrs.,wallstreetbets,CREX,7,7,0,7,1,1,1,1,NASDAQ
4877,14-02-2021 12:00,24 hrs.,wallstreetbets,CRON,65,65,0,65,1,10,41,1,NASDAQ
4877,14-02-2021 12:00,24 hrs.,wallstreetbets,CRSR,99,92,7,85,4,24,35,3,NASDAQ
4877,14-02-2021 12:00,24 hrs.,wallstreetbets,CSTR,5,0,5,-5,1,0,1,1,NASDAQ
4877,14-02-2021 12:00,24 hrs.,wallstreetbets,CTHR,6,6,0,6,1,1,0,1,NASDAQ
4877,14-02-2021 12:00,24 hrs.,wallstreetbets,CTRM,73,39,34,5,11,11,7,10,NASDAQ
4877,14-02-2021 12:00,24 hrs.,wallstreetbets,DDOG,28,28,0,28,1,6,12,1,NASDAQ
4877,14-02-2021 12:00,24 hrs.,wallstreetbets,DENN,176,0,176,-176,1,67,38,1,NASDAQ
4877,14-02-2021 12:00,24 hrs.,wallstreetbets,DKNG,4226,0,4226,-4226,1,1924,374,1,NASDAQ
4877,14-02-2021 12:00,24 hrs.,wallstreetbets,EDIT,79,0,79,-79,1,3,69,1,NASDAQ
4877,14-02-2021 12:00,24 hrs.,wallstreetbets,EHTH,176,0,176,-176,1,67,38,1,NASDAQ
4877,14-02-2021 12:00,24 hrs.,wallstreetbets,EVBG,176,0,176,-176,1,67,38,1,NASDAQ
4877,14-02-2021 12:00,24 hrs.,wallstreetbets,EVFM,13,7,6,1,2,2,1,2,NASDAQ
4877,14-02-2021 12:00,24 hrs.,wallstreetbets,EXPI,11,0,11,-11,2,1,1,2,NASDAQ
4877,14-02-2021 12:00,24 hrs.,wallstreetbets,FIZZ,1248,0,1248,-1248,2,584,72,2,NASDAQ
4877,14-02-2021 12:00,24 hrs.,wallstreetbets,FLGT,15,0,15,-15,2,2,3,1,NASDAQ
4877,14-02-2021 12:00,24 hrs.,wallstreetbets,FLMN,6,0,6,-6,1,1,0,1,NASDAQ
4877,14-02-2021 12:00,24 hrs.,wallstreetbets,FOLD,13,7,6,1,2,2,1,2,NASDAQ
4877,14-02-2021 12:00,24 hrs.,wallstreetbets,FREQ,22,0,22,-22,1,0,18,1,NASDAQ
4877,14-02-2021 12:00,24 hrs.,wallstreetbets,FROG,7,7,0,7,1,1,1,1,NASDAQ
4877,14-02-2021 12:00,24 hrs.,wallstreetbets,GAIN,13,6,7,-1,2,2,1,2,NASDAQ
4877,14-02-2021 12:00,24 hrs.,wallstreetbets,GECC,7,7,0,7,1,1,1,1,NASDAQ
4877,14-02-2021 12:00,24 hrs.,wallstreetbets,GIGM,14,14,0,14,2,2,2,1,NASDAQ
4877,14-02-2021 12:00,24 hrs.,wallstreetbets,GMBL,7,7,0,7,1,1,1,1,NASDAQ
4877,14-02-2021 12:00,24 hrs.,wallstreetbets,GNOG,13,0,13,-13,2,2,1,2,NASDAQ
4877,14-02-2021 12:00,24 hrs.,wallstreetbets,GOGO,1307,6,1301,-1295,11,593,77,7,NASDAQ
4877,14-02-2021 12:00,24 hrs.,wallstreetbets,GOLD,255,0,255,-255,5,84,67,5,NASDAQ
4877,14-02-2021 12:00,24 hrs.,wallstreetbets,GRMN,176,0,176,-176,1,67,38,1,NASDAQ
4877,14-02-2021 12:00,24 hrs.,wallstreetbets,GTEC,6,0,6,-6,1,1,0,1,NASDAQ
4877,14-02-2021 12:00,24 hrs.,wallstreetbets,GTHX,360,12,348,-336,3,123,102,2,NASDAQ
4877,14-02-2021 12:00,24 hrs.,wallstreetbets,IBEX,7,0,7,-7,1,1,1,1,NASDAQ
4877,14-02-2021 12:00,24 hrs.,wallstreetbets,IDEX,7,0,7,-7,1,1,1,1,NASDAQ
4877,14-02-2021 12:00,24 hrs.,wallstreetbets,INTC,480,0,480,-480,4,118,228,3,NASDAQ
4877,14-02-2021 12:00,24 hrs.,wallstreetbets,JAGX,7,0,7,-7,1,1,1,1,NASDAQ
4877,14-02-2021 12:00,24 hrs.,wallstreetbets,KNSA,7,7,0,7,1,1,1,1,NASDAQ
4877,14-02-2021 12:00,24 hrs.,wallstreetbets,KOPN,6,0,6,-6,1,1,0,1,NASDAQ
4877,14-02-2021 12:00,24 hrs.,wallstreetbets,KOSS,7,0,7,-7,1,1,1,1,NASDAQ
4877,14-02-2021 12:00,24 hrs.,wallstreetbets,LAND,122,122,0,122,1,41,36,1,NASDAQ
4877,14-02-2021 12:00,24 hrs.,stocks,PAAS,15,15,0,15,1,4,3,1,NASDAQ
4877,14-02-2021 12:00,24 hrs.,stocks,PBCT,48,0,48,-48,1,14,16,1,NASDAQ
4877,14-02-2021 12:00,24 hrs.,stocks,PRTK,6,6,0,6,1,1,0,1,NASDAQ
4877,14-02-2021 12:00,24 hrs.,stocks,QQQJ,1525,0,1525,-1525,1,593,335,1,NASDAQ
4877,14-02-2021 12:00,24 hrs.,stocks,QQQM,1525,0,1525,-1525,1,593,335,1,NASDAQ
4877,14-02-2021 12:00,24 hrs.,stocks,REGI,14,14,0,14,1,2,6,1,NASDAQ
4877,14-02-2021 12:00,24 hrs.,stocks,RIOT,12,0,12,-12,2,2,0,1,NASDAQ
4877,14-02-2021 12:00,24 hrs.,stocks,ROKU,683,0,683,-683,1,312,55,1,NASDAQ
4877,14-02-2021 12:00,24 hrs.,stocks,SIRI,55,55,0,55,1,10,31,1,NASDAQ
4877,14-02-2021 12:00,24 hrs.,stocks,SNDL,14,8,6,2,2,2,2,2,NASDAQ
4877,14-02-2021 12:00,24 hrs.,stocks,SOLO,6,6,0,6,1,1,0,1,NASDAQ
4877,14-02-2021 12:00,24 hrs.,stocks,TFFP,32,0,32,-32,2,8,8,1,NASDAQ
4877,14-02-2021 12:00,24 hrs.,stocks,TLRY,695,0,695,-695,3,314,55,3,NASDAQ
4877,14-02-2021 12:00,24 hrs.,stocks,TQQQ,11,11,0,11,1,1,5,1,NASDAQ
4877,14-02-2021 12:00,24 hrs.,stocks,TRCH,14,7,7,0,2,2,2,2,NASDAQ
4877,14-02-2021 12:00,24 hrs.,stocks,TREE,683,0,683,-683,1,312,55,1,NASDAQ
4877,14-02-2021 12:00,24 hrs.,stocks,VGLT,6,0,6,-6,1,1,0,1,NASDAQ
4877,14-02-2021 12:00,24 hrs.,stocks,VXUS,11,0,11,-11,1,1,5,1,NASDAQ
4877,14-02-2021 12:00,24 hrs.,stocks,WIMI,6,0,6,-6,1,1,0,1,NASDAQ
4877,14-02-2021 12:00,24 hrs.,stocks,ZNGA,41,0,41,-41,1,13,11,1,NASDAQ
4877,14-02-2021 12:00,24 hrs.,stocks,LBTYB,7,0,7,-7,1,1,1,1,NASDAQ
4877,14-02-2021 12:00,24 hrs.,Daytrading,MSN,17,0,17,-17,1,2,9,1,AMEX
4877,14-02-2021 12:00,24 hrs.,StockMarket,SKT,79,0,79,-79,1,35,5,1,NYSE
4877,14-02-2021 12:00,24 hrs.,StockMarket,THC,12,0,12,-12,1,1,6,1,NYSE
4877,14-02-2021 12:00,24 hrs.,StockMarket,TRU,79,0,79,-79,1,35,5,1,NYSE
4877,14-02-2021 12:00,24 hrs.,StockMarket,VMC,79,0,79,-79,1,35,5,1,NYSE
4877,14-02-2021 12:00,24 hrs.,StockMarket,WMT,79,0,79,-79,1,35,5,1,NYSE
4877,14-02-2021 12:00,24 hrs.,StockMarket,ZTS,79,0,79,-79,1,35,5,1,NYSE
4877,14-02-2021 12:00,24 hrs.,StockMarket,ABBV,12,0,12,-12,1,1,6,1,NYSE
4877,14-02-2021 12:00,24 hrs.,StockMarket,COTY,12,12,0,12,2,2,0,1,NYSE
4877,14-02-2021 12:00,24 hrs.,StockMarket,FSLY,79,0,79,-79,1,35,5,1,NYSE
4877,14-02-2021 12:00,24 hrs.,StockMarket,FVRR,79,0,79,-79,1,35,5,1,NYSE
4877,14-02-2021 12:00,24 hrs.,StockMarket,LGVW,14,0,14,-14,3,0,2,1,NYSE
4877,14-02-2021 12:00,24 hrs.,StockMarket,PLTR,79,0,79,-79,1,35,5,1,NYSE
4877,14-02-2021 12:00,24 hrs.,StockMarket,PSTH,6,0,6,-6,1,1,0,1,NYSE
4877,14-02-2021 12:00,24 hrs.,StockMarket,SHOP,79,0,79,-79,1,35,5,1,NYSE
4877,14-02-2021 12:00,24 hrs.,StockMarket,STPK,6,6,0,6,1,1,0,1,NYSE
4877,14-02-2021 12:00,24 hrs.,StockMarket,TRTN,79,0,79,-79,1,35,5,1,NYSE
4877,14-02-2021 12:00,24 hrs.,StockMarket,TWLO,79,0,79,-79,1,35,5,1,NYSE
4877,14-02-2021 12:00,24 hrs.,StockMarket,USFD,79,0,79,-79,1,35,5,1,NYSE
4877,14-02-2021 12:00,24 hrs.,StockMarket,ADI,79,0,79,-79,1,35,5,1,NASDAQ
4877,14-02-2021 12:00,24 hrs.,StockMarket,BLI,79,0,79,-79,1,35,5,1,NASDAQ
4877,14-02-2021 12:00,24 hrs.,StockMarket,DBX,79,0,79,-79,1,35,5,1,NASDAQ
4877,14-02-2021 12:00,24 hrs.,StockMarket,FOX,13,0,13,-13,1,1,7,1,NASDAQ
4877,14-02-2021 12:00,24 hrs.,StockMarket,TTD,79,0,79,-79,1,35,5,1,NASDAQ
4877,14-02-2021 12:00,24 hrs.,StockMarket,UFO,17,0,17,-17,1,3,7,1,NASDAQ
4877,14-02-2021 12:00,24 hrs.,StockMarket,WIX,79,0,79,-79,1,35,5,1,NASDAQ
4877,14-02-2021 12:00,24 hrs.,StockMarket,WNW,6,0,6,-6,1,1,0,1,NASDAQ
4877,14-02-2021 12:00,24 hrs.,StockMarket,AKER,6,0,6,-6,1,1,0,1,NASDAQ
4877,14-02-2021 12:00,24 hrs.,trakstocks,VUZI,24,24,0,24,1,9,2,1,NASDAQ
4877,14-02-2021 12:00,24 hrs.,trakstocks,ZSAN,18,0,18,-18,1,4,6,1,NASDAQ
4877,14-02-2021 12:00,24 hrs.,StockMarket,COMS,13,0,13,-13,1,1,7,1,OTC
4877,14-02-2021 12:00,24 hrs.,StockMarket,GBTC,14,0,14,-14,3,0,2,1,OTC
4877,14-02-2021 12:00,24 hrs.,StockMarket,HRBR,6,0,6,-6,1,1,0,1,OTC
4877,14-02-2021 12:00,24 hrs.,wallstreetbets,LIFE,17,10,7,3,2,3,3,2,NASDAQ
4877,14-02-2021 12:00,24 hrs.,wallstreetbets,LKCO,6,0,6,-6,1,1,0,1,NASDAQ
4877,14-02-2021 12:00,24 hrs.,wallstreetbets,LSCC,176,0,176,-176,1,67,38,1,NASDAQ
4877,14-02-2021 12:00,24 hrs.,wallstreetbets,LXRX,7,0,7,-7,1,1,1,1,NASDAQ
4877,14-02-2021 12:00,24 hrs.,wallstreetbets,MARA,23,8,15,-7,3,3,5,3,NASDAQ
4877,14-02-2021 12:00,24 hrs.,wallstreetbets,MESO,7,0,7,-7,1,1,1,1,NASDAQ
4877,14-02-2021 12:00,24 hrs.,wallstreetbets,MSFT,7,7,0,7,1,1,1,1,NASDAQ
4877,14-02-2021 12:00,24 hrs.,wallstreetbets,MVIS,1396,1278,118,1160,13,497,350,7,NASDAQ
4877,14-02-2021 12:00,24 hrs.,wallstreetbets,NAKD,20,6,14,-8,3,3,2,3,NASDAQ
4877,14-02-2021 12:00,24 hrs.,wallstreetbets,NCLH,223,223,0,223,1,70,79,1,NASDAQ
4877,14-02-2021 12:00,24 hrs.,wallstreetbets,APHA,113,20,93,-73,12,24,17,8,NASDAQ
4877,14-02-2021 12:00,24 hrs.,wallstreetbets,APPN,176,0,176,-176,1,67,38,1,NASDAQ
4877,14-02-2021 12:00,24 hrs.,wallstreetbets,APPS,6,0,6,-6,1,1,0,1,NASDAQ
4877,14-02-2021 12:00,24 hrs.,wallstreetbets,ASRT,14,7,7,0,2,2,2,2,NASDAQ
4877,14-02-2021 12:00,24 hrs.,wallstreetbets,ATNF,6,0,6,-6,1,1,0,1,NASDAQ
4877,14-02-2021 12:00,24 hrs.,wallstreetbets,ATNX,7,7,0,7,1,1,1,1,NASDAQ
4877,14-02-2021 12:00,24 hrs.,wallstreetbets,AZRX,7,0,7,-7,1,1,1,1,NASDAQ
4877,14-02-2021 12:00,24 hrs.,wallstreetbets,BBBY,4226,0,4226,-4226,1,1924,374,1,NASDAQ
4877,14-02-2021 12:00,24 hrs.,wallstreetbets,BHTG,7,0,7,-7,1,1,1,1,NASDAQ
4877,14-02-2021 12:00,24 hrs.,wallstreetbets,BIDU,176,0,176,-176,1,67,38,1,NASDAQ
4877,14-02-2021 12:00,24 hrs.,wallstreetbets,BIGC,1241,0,1241,-1241,1,583,71,1,NASDAQ
4877,14-02-2021 12:00,24 hrs.,wallstreetbets,BLDP,7,0,7,-7,1,1,1,1,NASDAQ
4877,14-02-2021 12:00,24 hrs.,wallstreetbets,BLMN,176,0,176,-176,1,67,38,1,NASDAQ
4877,14-02-2021 12:00,24 hrs.,wallstreetbets,BLPH,6,0,6,-6,1,1,0,1,NASDAQ
4877,14-02-2021 12:00,24 hrs.,wallstreetbets,BLRX,6,0,6,-6,1,1,0,1,NASDAQ
4877,14-02-2021 12:00,24 hrs.,wallstreetbets,BNGO,54,6,48,-42,8,8,6,7,NASDAQ
4877,14-02-2021 12:00,24 hrs.,wallstreetbets,BSQR,7,0,7,-7,1,1,1,1,NASDAQ
4877,14-02-2021 12:00,24 hrs.,wallstreetbets,CCRC,8,0,8,-8,1,2,0,1,NASDAQ
4877,14-02-2021 12:00,24 hrs.,wallstreetbets,CGIX,6,0,6,-6,1,1,0,1,NASDAQ
4877,14-02-2021 12:00,24 hrs.,wallstreetbets,CHEK,7,7,0,7,1,1,1,1,NASDAQ
4877,14-02-2021 12:00,24 hrs.,wallstreetbets,CIDM,6,0,6,-6,1,1,0,1,NASDAQ
4877,14-02-2021 12:00,24 hrs.,wallstreetbets,CLBS,7,0,7,-7,1,1,1,1,NASDAQ
4877,14-02-2021 12:00,24 hrs.,pennystocks,BANT,26,20,6,14,2,5,8,2,OTC
4877,14-02-2021 12:00,24 hrs.,pennystocks,BIEL,6,6,0,6,1,1,0,1,OTC
4877,14-02-2021 12:00,24 hrs.,pennystocks,BNGI,6,0,6,-6,1,1,0,1,OTC
4877,14-02-2021 12:00,24 hrs.,pennystocks,BOTY,34,0,34,-34,1,11,8,1,OTC
4877,14-02-2021 12:00,24 hrs.,pennystocks,BRGO,6,0,6,-6,1,1,0,1,OTC
4877,14-02-2021 12:00,24 hrs.,pennystocks,BRRN,10,0,10,-10,1,2,2,1,OTC
4877,14-02-2021 12:00,24 hrs.,pennystocks,BRSE,6,0,6,-6,1,1,0,1,OTC
4877,14-02-2021 12:00,24 hrs.,pennystocks,CANN,12,0,12,-12,2,2,0,2,OTC
4877,14-02-2021 12:00,24 hrs.,StockMarket,AMAT,79,0,79,-79,1,35,5,1,NASDAQ
4877,14-02-2021 12:00,24 hrs.,StockMarket,AMGN,12,0,12,-12,1,1,6,1,NASDAQ
4877,14-02-2021 12:00,24 hrs.,StockMarket,AMZN,51,0,51,-51,1,13,21,1,NASDAQ
4877,14-02-2021 12:00,24 hrs.,StockMarket,ATNF,12,0,12,-12,1,1,6,1,NASDAQ
4877,14-02-2021 12:00,24 hrs.,StockMarket,BIDU,79,0,79,-79,1,35,5,1,NASDAQ
4877,14-02-2021 12:00,24 hrs.,StockMarket,BIGC,79,0,79,-79,1,35,5,1,NASDAQ
4877,14-02-2021 12:00,24 hrs.,StockMarket,CLIR,6,0,6,-6,1,1,0,1,NASDAQ
4877,14-02-2021 12:00,24 hrs.,StockMarket,CLVS,79,0,79,-79,1,35,5,1,NASDAQ
4877,14-02-2021 12:00,24 hrs.,StockMarket,CPLP,14,0,14,-14,1,4,2,1,NASDAQ
4877,14-02-2021 12:00,24 hrs.,StockMarket,CTRM,6,0,6,-6,1,1,0,1,NASDAQ
4877,14-02-2021 12:00,24 hrs.,StockMarket,EDIT,42,42,0,42,1,6,26,1,NASDAQ
4877,14-02-2021 12:00,24 hrs.,StockMarket,EXPD,79,0,79,-79,1,35,5,1,NASDAQ
4877,14-02-2021 12:00,24 hrs.,StockMarket,FIZZ,79,0,79,-79,1,35,5,1,NASDAQ
4877,14-02-2021 12:00,24 hrs.,StockMarket,GOGO,79,0,79,-79,1,35,5,1,NASDAQ
4877,14-02-2021 12:00,24 hrs.,StockMarket,GOLD,79,0,79,-79,1,35,5,1,NASDAQ
4877,14-02-2021 12:00,24 hrs.,StockMarket,GTHX,6,0,6,-6,1,1,0,1,NASDAQ
4877,14-02-2021 12:00,24 hrs.,StockMarket,HTBX,14,8,6,2,2,2,2,2,NASDAQ
4877,14-02-2021 12:00,24 hrs.,StockMarket,INVE,6,6,0,6,1,0,2,1,NASDAQ
4877,14-02-2021 12:00,24 hrs.,StockMarket,ITRM,13,0,13,-13,1,1,7,1,NASDAQ
4877,14-02-2021 12:00,24 hrs.,StockMarket,LINK,79,0,79,-79,1,35,5,1,OTC
4877,14-02-2021 12:00,24 hrs.,StockMarket,LRDR,6,0,6,-6,1,1,0,1,OTC
4877,14-02-2021 12:00,24 hrs.,StockMarket,MOST,79,0,79,-79,1,35,5,1,OTC
4877,14-02-2021 12:00,24 hrs.,StockMarket,SGMD,15,15,0,15,1,4,3,1,OTC
4877,14-02-2021 12:00,24 hrs.,StockMarket,AMKBY,22,0,22,-22,1,6,6,1,OTC
4877,14-02-2021 12:00,24 hrs.,StockMarket,CADMF,6,0,6,-6,1,1,0,1,OTC
4877,14-02-2021 12:00,24 hrs.,StockMarket,EMHTF,12,0,12,-12,1,3,2,1,OTC
4877,14-02-2021 12:00,24 hrs.,StockMarket,NXTTF,12,0,12,-12,2,2,0,1,OTC
4877,14-02-2021 12:00,24 hrs.,StockMarket,PYNKF,9,9,0,9,1,2,1,1,OTC
4877,14-02-2021 12:00,24 hrs.,StockMarket,XJNGF,16,0,16,-16,1,0,12,1,OTC
4877,14-02-2021 12:00,24 hrs.,StockMarket,DNN,49,49,0,49,1,17,11,1,AMEX
4877,14-02-2021 12:00,24 hrs.,StockMarket,SENS,22,22,0,22,1,8,2,1,AMEX
4877,14-02-2021 12:00,24 hrs.,StockMarket,TRXC,6,6,0,6,1,1,0,1,AMEX
4877,14-02-2021 12:00,24 hrs.,StockMarket,AAP,79,0,79,-79,1,35,5,1,NYSE
4877,14-02-2021 12:00,24 hrs.,StockMarket,AMC,79,6,73,-67,5,23,13,5,NYSE
4877,14-02-2021 12:00,24 hrs.,StockMarket,BKI,79,0,79,-79,1,35,5,1,NYSE
4877,14-02-2021 12:00,24 hrs.,StockMarket,CBD,12,0,12,-12,1,1,6,1,NYSE
4877,14-02-2021 12:00,24 hrs.,StockMarket,CMA,6,0,6,-6,1,1,0,1,NYSE
4877,14-02-2021 12:00,24 hrs.,StockMarket,CMO,245,0,245,-245,1,118,5,1,NYSE
4877,14-02-2021 12:00,24 hrs.,StockMarket,CVS,79,0,79,-79,1,35,5,1,NYSE
4877,14-02-2021 12:00,24 hrs.,StockMarket,DDD,79,0,79,-79,1,35,5,1,NYSE
4877,14-02-2021 12:00,24 hrs.,StockMarket,DDS,79,0,79,-79,1,35,5,1,NYSE
4877,14-02-2021 12:00,24 hrs.,StockMarket,ECL,79,0,79,-79,1,35,5,1,NYSE
4877,14-02-2021 12:00,24 hrs.,StockMarket,FIX,4,0,4,-4,1,0,0,1,NYSE
4877,14-02-2021 12:00,24 hrs.,StockMarket,GME,90,6,84,-78,3,35,8,3,NYSE
4877,14-02-2021 12:00,24 hrs.,StockMarket,HLT,79,0,79,-79,1,35,5,1,NYSE
4877,14-02-2021 12:00,24 hrs.,StockMarket,IGT,79,0,79,-79,1,35,5,1,NYSE
4877,14-02-2021 12:00,24 hrs.,StockMarket,JNJ,12,0,12,-12,1,1,6,1,NYSE
4877,14-02-2021 12:00,24 hrs.,StockMarket,LPL,79,0,79,-79,1,35,5,1,NYSE
4877,14-02-2021 12:00,24 hrs.,StockMarket,LPX,79,0,79,-79,1,35,5,1,NYSE
4877,14-02-2021 12:00,24 hrs.,StockMarket,MRO,79,0,79,-79,1,35,5,1,NYSE
4877,14-02-2021 12:00,24 hrs.,StockMarket,MTD,79,0,79,-79,1,35,5,1,NYSE
4877,14-02-2021 12:00,24 hrs.,StockMarket,NET,4,0,4,-4,1,0,0,1,NYSE
4877,14-02-2021 12:00,24 hrs.,StockMarket,NVS,12,0,12,-12,1,1,6,1,NYSE
4877,14-02-2021 12:00,24 hrs.,StockMarket,OXY,79,0,79,-79,1,35,5,1,NYSE
4877,14-02-2021 12:00,24 hrs.,StockMarket,PMO,6,0,6,-6,1,1,0,1,NYSE
4877,14-02-2021 12:00,24 hrs.,StockMarket,RNG,79,0,79,-79,1,35,5,1,NYSE
4877,14-02-2021 12:00,24 hrs.,pennystocks,GAXY,24,0,24,-24,1,5,10,1,OTC
4877,14-02-2021 12:00,24 hrs.,pennystocks,GLFH,28,0,28,-28,1,5,14,1,OTC
4877,14-02-2021 12:00,24 hrs.,pennystocks,GTEH,69,0,69,-69,1,9,47,1,OTC
4877,14-02-2021 12:00,24 hrs.,pennystocks,HALB,29,0,29,-29,1,8,9,1,OTC
4877,14-02-2021 12:00,24 hrs.,pennystocks,HCMC,79,30,49,-19,13,12,3,13,OTC
4877,14-02-2021 12:00,24 hrs.,pennystocks,HPIL,13,7,6,1,2,2,1,2,OTC
4877,14-02-2021 12:00,24 hrs.,pennystocks,HPMM,13,6,7,-1,2,2,1,2,OTC
4877,14-02-2021 12:00,24 hrs.,pennystocks,HQGE,6,0,6,-6,1,1,0,1,OTC
4877,14-02-2021 12:00,24 hrs.,pennystocks,ICNM,7,0,7,-7,1,1,1,1,OTC
4877,14-02-2021 12:00,24 hrs.,pennystocks,ICTY,6,0,6,-6,1,1,0,1,OTC
4877,14-02-2021 12:00,24 hrs.,pennystocks,IGEN,23,0,23,-23,2,3,9,2,OTC
4877,14-02-2021 12:00,24 hrs.,pennystocks,ILUS,61,61,0,61,1,24,9,1,OTC
4877,14-02-2021 12:00,24 hrs.,pennystocks,INKW,6,0,6,-6,1,1,0,1,OTC
4877,14-02-2021 12:00,24 hrs.,pennystocks,INND,609,24,585,-561,3,256,85,3,OTC
4877,14-02-2021 12:00,24 hrs.,pennystocks,KGET,6,6,0,6,1,1,0,1,OTC
4877,14-02-2021 12:00,24 hrs.,pennystocks,KULR,47,47,0,47,1,12,19,1,OTC
4877,14-02-2021 12:00,24 hrs.,pennystocks,KYNC,6,0,6,-6,1,1,0,1,OTC
4877,14-02-2021 12:00,24 hrs.,pennystocks,LATF,8,0,8,-8,1,1,2,1,OTC
4877,14-02-2021 12:00,24 hrs.,pennystocks,LTNC,42,0,42,-42,1,0,38,1,OTC
4877,14-02-2021 12:00,24 hrs.,pennystocks,MINE,81,12,69,-57,3,11,47,2,OTC
4877,14-02-2021 12:00,24 hrs.,pennystocks,MJNA,90,0,90,-90,3,23,32,2,OTC
4877,14-02-2021 12:00,24 hrs.,pennystocks,MLFB,29,12,17,-5,2,7,7,2,OTC
4877,14-02-2021 12:00,24 hrs.,pennystocks,MSPC,6,0,6,-6,1,1,0,1,OTC
4877,14-02-2021 12:00,24 hrs.,pennystocks,NSPX,6,0,6,-6,1,1,0,1,OTC
4877,14-02-2021 12:00,24 hrs.,pennystocks,NTRR,6,6,0,6,1,1,0,1,OTC
4877,14-02-2021 12:00,24 hrs.,pennystocks,OPTI,47,47,0,47,2,11,17,2,OTC
4877,14-02-2021 12:00,24 hrs.,pennystocks,OZSC,192,7,185,-178,2,79,26,2,OTC
4877,14-02-2021 12:00,24 hrs.,pennystocks,PLYZ,6,6,0,6,1,1,0,1,OTC
4877,14-02-2021 12:00,24 hrs.,pennystocks,PUGE,151,0,151,-151,1,41,65,1,OTC
4877,14-02-2021 12:00,24 hrs.,pennystocks,PVDG,72,0,72,-72,1,14,40,1,OTC
4877,14-02-2021 12:00,24 hrs.,pennystocks,QBAN,8,8,0,8,1,0,4,1,OTC
4877,14-02-2021 12:00,24 hrs.,pennystocks,QMCI,72,0,72,-72,1,14,40,1,OTC
4877,14-02-2021 12:00,24 hrs.,pennystocks,RBNW,6,0,6,-6,1,1,0,1,OTC
4877,14-02-2021 12:00,24 hrs.,pennystocks,RCRT,24,0,24,-24,1,5,10,1,OTC
4877,14-02-2021 12:00,24 hrs.,pennystocks,RSSV,139,47,92,-45,2,50,31,2,OTC
4877,14-02-2021 12:00,24 hrs.,StockMarket,KLIC,22,0,22,-22,1,6,6,1,NASDAQ
4877,14-02-2021 12:00,24 hrs.,StockMarket,LGND,79,0,79,-79,1,35,5,1,NASDAQ
4877,14-02-2021 12:00,24 hrs.,StockMarket,NBIX,12,0,12,-12,1,1,6,1,NASDAQ
4877,14-02-2021 12:00,24 hrs.,StockMarket,NCNO,79,0,79,-79,1,35,5,1,NASDAQ
4877,14-02-2021 12:00,24 hrs.,StockMarket,NOVN,6,0,6,-6,1,1,0,1,NASDAQ
4877,14-02-2021 12:00,24 hrs.,StockMarket,ROKU,79,0,79,-79,1,35,5,1,NASDAQ
4877,14-02-2021 12:00,24 hrs.,StockMarket,SEDG,79,0,79,-79,1,35,5,1,NASDAQ
4877,14-02-2021 12:00,24 hrs.,StockMarket,SNBR,79,0,79,-79,1,35,5,1,NASDAQ
4877,14-02-2021 12:00,24 hrs.,StockMarket,SNDL,26,20,6,14,3,5,4,3,NASDAQ
4877,14-02-2021 12:00,24 hrs.,StockMarket,SPWR,79,0,79,-79,1,35,5,1,NASDAQ
4877,14-02-2021 12:00,24 hrs.,StockMarket,STMP,79,0,79,-79,1,35,5,1,NASDAQ
4877,14-02-2021 12:00,24 hrs.,StockMarket,TEAM,12,0,12,-12,1,1,6,1,NASDAQ
4877,14-02-2021 12:00,24 hrs.,StockMarket,THCB,96,96,0,96,1,38,16,1,NASDAQ
4877,14-02-2021 12:00,24 hrs.,StockMarket,TLRY,91,6,85,-79,3,36,7,3,NASDAQ
4877,14-02-2021 12:00,24 hrs.,StockMarket,TRCH,13,0,13,-13,1,1,7,1,NASDAQ
4877,14-02-2021 12:00,24 hrs.,StockMarket,TREE,79,0,79,-79,1,35,5,1,NASDAQ
4877,14-02-2021 12:00,24 hrs.,StockMarket,TSEM,79,0,79,-79,1,35,5,1,NASDAQ
4877,14-02-2021 12:00,24 hrs.,StockMarket,VXRT,24,0,24,-24,1,1,18,1,NASDAQ
4877,14-02-2021 12:00,24 hrs.,StockMarket,WING,79,0,79,-79,1,35,5,1,NASDAQ
4877,14-02-2021 12:00,24 hrs.,StockMarket,XONE,14,0,14,-14,3,0,2,1,NASDAQ
4877,14-02-2021 12:00,24 hrs.,StockMarket,YNDX,79,0,79,-79,1,35,5,1,NASDAQ
4877,14-02-2021 12:00,24 hrs.,pennystocks,ABML,24,0,24,-24,4,4,0,1,OTC
4877,14-02-2021 12:00,24 hrs.,pennystocks,ACRL,56,56,0,56,3,15,14,3,OTC
4877,14-02-2021 12:00,24 hrs.,pennystocks,AITX,136,102,34,68,5,49,18,4,OTC
4877,14-02-2021 12:00,24 hrs.,pennystocks,ALYI,85,13,72,-59,3,16,41,2,OTC
4877,14-02-2021 12:00,24 hrs.,pennystocks,AMAZ,6,0,6,-6,1,1,0,1,OTC
4877,14-02-2021 12:00,24 hrs.,pennystocks,AMNE,13,0,13,-13,2,2,1,1,OTC
4877,14-02-2021 12:00,24 hrs.,pennystocks,ASTI,207,0,207,-207,2,76,47,2,OTC
4877,14-02-2021 12:00,24 hrs.,pennystocks,ATVK,54,47,7,40,2,13,20,2,OTC
4877,14-02-2021 12:00,24 hrs.,pennystocks,ARBKF,303,7,296,-289,7,78,119,5,OTC
4877,14-02-2021 12:00,24 hrs.,pennystocks,BDRBF,6,0,6,-6,1,1,0,1,OTC
4877,14-02-2021 12:00,24 hrs.,pennystocks,BKTPF,22,22,0,22,1,5,8,1,OTC
4877,14-02-2021 12:00,24 hrs.,pennystocks,BUROF,24,18,6,12,2,7,2,2,OTC
4877,14-02-2021 12:00,24 hrs.,pennystocks,CINGF,47,47,0,47,1,12,19,1,OTC
4877,14-02-2021 12:00,24 hrs.,pennystocks,CLXPF,260,0,260,-260,1,98,60,1,OTC
4877,14-02-2021 12:00,24 hrs.,pennystocks,COCSF,13,0,13,-13,1,3,3,1,OTC
4877,14-02-2021 12:00,24 hrs.,pennystocks,EMHTF,28,0,28,-28,1,8,8,1,OTC
4877,14-02-2021 12:00,24 hrs.,pennystocks,HITIF,1175,17,1158,-1141,5,477,201,5,OTC
4877,14-02-2021 12:00,24 hrs.,pennystocks,HTZGQ,6,6,0,6,1,1,0,1,OTC
4877,14-02-2021 12:00,24 hrs.,pennystocks,ICNAF,6,6,0,6,1,1,0,1,OTC
4877,14-02-2021 12:00,24 hrs.,pennystocks,ILHMF,7,0,7,-7,1,1,1,1,OTC
4877,14-02-2021 12:00,24 hrs.,pennystocks,ITMPF,12,0,12,-12,2,2,0,1,OTC
4877,14-02-2021 12:00,24 hrs.,pennystocks,LTMCF,6,6,0,6,1,1,0,1,OTC
4877,14-02-2021 12:00,24 hrs.,pennystocks,MMEDF,109,0,109,-109,3,21,55,3,OTC
4877,14-02-2021 12:00,24 hrs.,pennystocks,MMNFF,33,0,33,-33,1,13,3,1,OTC
4877,14-02-2021 12:00,24 hrs.,pennystocks,MPUCF,7,0,7,-7,1,1,1,1,OTC
4877,14-02-2021 12:00,24 hrs.,pennystocks,MSNVF,6,0,6,-6,1,1,0,1,OTC
4877,14-02-2021 12:00,24 hrs.,pennystocks,NMGRF,54,0,54,-54,2,19,8,1,OTC
4877,14-02-2021 12:00,24 hrs.,pennystocks,NMTLF,22,0,22,-22,1,7,4,1,OTC
4877,14-02-2021 12:00,24 hrs.,pennystocks,NXTTF,12,0,12,-12,2,2,0,2,OTC
4877,14-02-2021 12:00,24 hrs.,pennystocks,PEMIF,22,22,0,22,1,5,8,1,OTC
4877,14-02-2021 12:00,24 hrs.,pennystocks,PHPYF,9,9,0,9,1,0,5,1,OTC
4877,14-02-2021 12:00,24 hrs.,pennystocks,PILBF,6,6,0,6,1,1,0,1,OTC
4877,14-02-2021 12:00,24 hrs.,pennystocks,RLLCF,44,0,44,-44,3,6,20,2,OTC
4877,14-02-2021 12:00,24 hrs.,pennystocks,SNNAF,22,22,0,22,1,5,8,1,OTC
4877,14-02-2021 12:00,24 hrs.,pennystocks,SPMTF,22,22,0,22,1,5,8,1,OTC
4877,14-02-2021 12:00,24 hrs.,pennystocks,SPRWF,7,7,0,7,1,1,1,1,OTC
4877,14-02-2021 12:00,24 hrs.,pennystocks,TAKOF,108,72,36,36,3,27,42,3,OTC
4877,14-02-2021 12:00,24 hrs.,pennystocks,TLOFF,72,0,72,-72,1,14,40,1,OTC
4877,14-02-2021 12:00,24 hrs.,pennystocks,TOWTF,12,0,12,-12,2,2,0,1,OTC
4877,14-02-2021 12:00,24 hrs.,pennystocks,TRCNF,17,17,0,17,1,4,5,1,OTC
4877,14-02-2021 12:00,24 hrs.,pennystocks,TRUFF,6,0,6,-6,1,1,0,1,OTC
4877,14-02-2021 12:00,24 hrs.,pennystocks,TSCRF,38,0,38,-38,1,11,12,1,OTC
4877,14-02-2021 12:00,24 hrs.,pennystocks,WALRF,47,47,0,47,1,12,19,1,OTC
4877,14-02-2021 12:00,24 hrs.,pennystocks,BGI,33,0,33,-33,1,13,3,1,AMEX
4877,14-02-2021 12:00,24 hrs.,pennystocks,CTO,849,0,849,-849,1,350,145,1,AMEX
4877,14-02-2021 12:00,24 hrs.,pennystocks,CVM,6,0,6,-6,1,1,0,1,AMEX
4877,14-02-2021 12:00,24 hrs.,pennystocks,DNN,31,18,13,5,4,3,9,4,AMEX
4877,14-02-2021 12:00,24 hrs.,pennystocks,DSS,6,0,6,-6,1,1,0,1,AMEX
4877,14-02-2021 12:00,24 hrs.,pennystocks,DXF,24,24,0,24,1,0,20,1,AMEX
4877,14-02-2021 12:00,24 hrs.,pennystocks,GSV,6,6,0,6,1,1,0,1,AMEX
4877,14-02-2021 12:00,24 hrs.,pennystocks,ITP,24,24,0,24,1,0,20,1,AMEX
4877,14-02-2021 12:00,24 hrs.,pennystocks,NGD,11,0,11,-11,1,2,3,1,AMEX
4877,14-02-2021 12:00,24 hrs.,pennystocks,SAFS,6,6,0,6,1,1,0,1,OTC
4877,14-02-2021 12:00,24 hrs.,pennystocks,SGMD,321,0,321,-321,5,107,87,5,OTC
4877,14-02-2021 12:00,24 hrs.,pennystocks,SGSI,17,17,0,17,1,4,5,1,OTC
4877,14-02-2021 12:00,24 hrs.,pennystocks,SHMP,7,0,7,-7,1,1,1,1,OTC
4877,14-02-2021 12:00,24 hrs.,pennystocks,CBBT,106,0,106,-106,2,25,48,2,OTC
4877,14-02-2021 12:00,24 hrs.,pennystocks,CBDL,34,0,34,-34,1,11,8,1,OTC
4877,14-02-2021 12:00,24 hrs.,pennystocks,CCTL,120,6,114,-108,2,31,50,2,OTC
4877,14-02-2021 12:00,24 hrs.,pennystocks,CHUC,15,15,0,15,1,3,5,1,OTC
4877,14-02-2021 12:00,24 hrs.,pennystocks,CLIS,18,0,18,-18,2,3,4,1,OTC
4877,14-02-2021 12:00,24 hrs.,pennystocks,COUV,10,10,0,10,1,1,4,1,OTC
4877,14-02-2021 12:00,24 hrs.,pennystocks,CTLE,31,0,31,-31,5,5,1,2,OTC
4877,14-02-2021 12:00,24 hrs.,pennystocks,DIGI,49,0,49,-49,1,18,9,1,OTC
4877,14-02-2021 12:00,24 hrs.,pennystocks,DPLS,24,0,24,-24,1,5,10,1,OTC
4877,14-02-2021 12:00,24 hrs.,pennystocks,DRNK,6,6,0,6,1,1,0,1,OTC
4877,14-02-2021 12:00,24 hrs.,pennystocks,DXLG,33,0,33,-33,1,13,3,1,OTC
4877,14-02-2021 12:00,24 hrs.,pennystocks,ECEZ,7,0,7,-7,1,1,1,1,OTC
4877,14-02-2021 12:00,24 hrs.,pennystocks,ECOX,7,0,7,-7,1,1,1,1,OTC
4877,14-02-2021 12:00,24 hrs.,pennystocks,EMED,12,12,0,12,2,2,0,1,OTC
4877,14-02-2021 12:00,24 hrs.,pennystocks,ENZC,72,0,72,-72,1,14,40,1,OTC
4877,14-02-2021 12:00,24 hrs.,pennystocks,EWLL,7,7,0,7,1,1,1,1,OTC
4877,14-02-2021 12:00,24 hrs.,pennystocks,RSI,659,659,0,659,2,289,73,2,NYSE
4877,14-02-2021 12:00,24 hrs.,pennystocks,RYB,24,24,0,24,1,0,20,1,NYSE
4877,14-02-2021 12:00,24 hrs.,pennystocks,SOS,1288,27,1261,-1234,11,445,354,11,NYSE
4877,14-02-2021 12:00,24 hrs.,pennystocks,STG,24,24,0,24,1,0,20,1,NYSE
4877,14-02-2021 12:00,24 hrs.,pennystocks,SUP,33,0,33,-33,1,13,3,1,NYSE
4877,14-02-2021 12:00,24 hrs.,pennystocks,THC,45,0,45,-45,1,14,13,1,NYSE
4877,14-02-2021 12:00,24 hrs.,pennystocks,TTM,849,0,849,-849,1,350,145,1,NYSE
4877,14-02-2021 12:00,24 hrs.,pennystocks,WEI,24,24,0,24,1,0,20,1,NYSE
4877,14-02-2021 12:00,24 hrs.,pennystocks,XIN,24,24,0,24,1,0,20,1,NYSE
4877,14-02-2021 12:00,24 hrs.,pennystocks,XYF,24,24,0,24,1,0,20,1,NYSE
4877,14-02-2021 12:00,24 hrs.,pennystocks,BORR,7,7,0,7,1,1,1,1,NYSE
4877,14-02-2021 12:00,24 hrs.,pennystocks,CMCM,24,24,0,24,1,0,20,1,NYSE
4877,14-02-2021 12:00,24 hrs.,pennystocks,FEDU,24,24,0,24,1,0,20,1,NYSE
4877,14-02-2021 12:00,24 hrs.,pennystocks,FENG,24,24,0,24,1,0,20,1,NYSE
4877,14-02-2021 12:00,24 hrs.,pennystocks,HEXO,856,0,856,-856,2,351,146,2,NYSE
4877,14-02-2021 12:00,24 hrs.,pennystocks,LAIX,24,24,0,24,1,0,20,1,NYSE
4877,14-02-2021 12:00,24 hrs.,pennystocks,LEJU,24,24,0,24,1,0,20,1,NYSE
4877,14-02-2021 12:00,24 hrs.,pennystocks,LITB,24,24,0,24,1,0,20,1,NYSE
4877,14-02-2021 12:00,24 hrs.,pennystocks,MOGU,24,24,0,24,1,0,20,1,NYSE
4877,14-02-2021 12:00,24 hrs.,pennystocks,WELL,7,0,7,-7,1,1,1,1,NYSE
4877,14-02-2021 12:00,24 hrs.,pennystocks,CGC,849,0,849,-849,1,350,145,1,NASDAQ
4877,14-02-2021 12:00,24 hrs.,pennystocks,CIH,24,24,0,24,1,0,20,1,NASDAQ
4877,14-02-2021 12:00,24 hrs.,pennystocks,EVK,24,24,0,24,1,0,20,1,NASDAQ
4877,14-02-2021 12:00,24 hrs.,pennystocks,GLG,24,24,0,24,1,0,20,1,NASDAQ
4877,14-02-2021 12:00,24 hrs.,pennystocks,NTN,33,0,33,-33,1,13,3,1,AMEX
4877,14-02-2021 12:00,24 hrs.,pennystocks,RHE,33,0,33,-33,1,13,3,1,AMEX
4877,14-02-2021 12:00,24 hrs.,pennystocks,SYN,7,7,0,7,1,1,1,1,AMEX
4877,14-02-2021 12:00,24 hrs.,pennystocks,ZOM,356,24,332,-308,3,119,106,3,AMEX
4877,14-02-2021 12:00,24 hrs.,pennystocks,AMBO,24,24,0,24,1,0,20,1,AMEX
4877,14-02-2021 12:00,24 hrs.,pennystocks,AMPE,33,0,33,-33,1,13,3,1,AMEX
4877,14-02-2021 12:00,24 hrs.,pennystocks,CPHI,24,24,0,24,1,0,20,1,AMEX
4877,14-02-2021 12:00,24 hrs.,pennystocks,NSPR,109,0,109,-109,3,18,61,3,AMEX
4877,14-02-2021 12:00,24 hrs.,pennystocks,OGEN,70,0,70,-70,1,28,10,1,AMEX
4877,14-02-2021 12:00,24 hrs.,pennystocks,SENS,39,0,39,-39,2,15,1,2,AMEX
4877,14-02-2021 12:00,24 hrs.,pennystocks,SNMP,17,0,17,-17,1,4,5,1,AMEX
4877,14-02-2021 12:00,24 hrs.,pennystocks,TKAT,24,24,0,24,1,0,20,1,AMEX
4877,14-02-2021 12:00,24 hrs.,pennystocks,TMBR,33,0,33,-33,1,13,3,1,AMEX
4877,14-02-2021 12:00,24 hrs.,pennystocks,UAMY,69,0,69,-69,1,9,47,1,AMEX
4877,14-02-2021 12:00,24 hrs.,pennystocks,ABC,1196,1196,0,1196,1,558,76,1,NYSE
4877,14-02-2021 12:00,24 hrs.,pennystocks,ACB,849,0,849,-849,1,350,145,1,NYSE
4877,14-02-2021 12:00,24 hrs.,pennystocks,ALB,22,22,0,22,1,5,8,1,NYSE
4877,14-02-2021 12:00,24 hrs.,pennystocks,AMC,82,0,82,-82,2,21,32,2,NYSE
4877,14-02-2021 12:00,24 hrs.,pennystocks,ASX,9,0,9,-9,1,1,3,1,NYSE
4877,14-02-2021 12:00,24 hrs.,pennystocks,BKD,17,17,0,17,1,4,5,1,NYSE
4877,14-02-2021 12:00,24 hrs.,pennystocks,SING,81,47,34,13,2,20,33,2,OTC
4877,14-02-2021 12:00,24 hrs.,pennystocks,SIRC,64,0,64,-64,2,17,22,2,OTC
4877,14-02-2021 12:00,24 hrs.,pennystocks,SNNC,6,6,0,6,1,1,0,1,OTC
4877,14-02-2021 12:00,24 hrs.,pennystocks,SNPW,78,0,78,-78,2,15,40,2,OTC
4877,14-02-2021 12:00,24 hrs.,pennystocks,SSFT,47,47,0,47,1,12,19,1,OTC
4877,14-02-2021 12:00,24 hrs.,pennystocks,TAUG,7,0,7,-7,1,1,1,1,OTC
4877,14-02-2021 12:00,24 hrs.,pennystocks,TIDE,849,0,849,-849,1,350,145,1,OTC
4877,14-02-2021 12:00,24 hrs.,pennystocks,TLSS,102,102,0,102,1,29,40,1,OTC
4877,14-02-2021 12:00,24 hrs.,pennystocks,TSNP,69,0,69,-69,1,9,47,1,OTC
4877,14-02-2021 12:00,24 hrs.,pennystocks,TVPC,6,0,6,-6,1,1,0,1,OTC
4877,14-02-2021 12:00,24 hrs.,pennystocks,UAPC,19,0,19,-19,1,0,15,1,OTC
4877,14-02-2021 12:00,24 hrs.,pennystocks,VSPC,24,0,24,-24,1,8,4,1,OTC
4877,14-02-2021 12:00,24 hrs.,pennystocks,WDLF,12,12,0,12,2,2,0,1,OTC
4877,14-02-2021 12:00,24 hrs.,pennystocks,WEBB,174,0,174,-174,1,79,12,1,OTC
4877,14-02-2021 12:00,24 hrs.,pennystocks,WSGF,47,47,0,47,1,12,19,1,OTC
4877,14-02-2021 12:00,24 hrs.,pennystocks,XMET,7,0,7,-7,1,1,1,1,OTC
4877,14-02-2021 12:00,24 hrs.,pennystocks,YAYO,49,49,0,49,1,15,15,1,OTC
4877,14-02-2021 12:00,24 hrs.,pennystocks,ZMRK,6,0,6,-6,1,1,0,1,OTC
4877,14-02-2021 12:00,24 hrs.,pennystocks,ABEPF,6,0,6,-6,1,1,0,1,OTC
4877,14-02-2021 12:00,24 hrs.,pennystocks,AMYZF,48,12,36,-24,8,8,0,4,OTC
4877,14-02-2021 12:00,24 hrs.,pennystocks,INO,70,0,70,-70,1,28,10,1,NASDAQ
4877,14-02-2021 12:00,24 hrs.,pennystocks,JFU,24,24,0,24,1,0,20,1,NASDAQ
4877,14-02-2021 12:00,24 hrs.,pennystocks,LYL,24,24,0,24,1,0,20,1,NASDAQ
4877,14-02-2021 12:00,24 hrs.,pennystocks,MKD,24,24,0,24,1,0,20,1,NASDAQ
4877,14-02-2021 12:00,24 hrs.,pennystocks,MTC,24,24,0,24,1,0,20,1,NASDAQ
4877,14-02-2021 12:00,24 hrs.,pennystocks,MYT,24,24,0,24,1,0,20,1,NASDAQ
4877,14-02-2021 12:00,24 hrs.,pennystocks,OSN,24,24,0,24,1,0,20,1,NASDAQ
4877,14-02-2021 12:00,24 hrs.,pennystocks,PME,24,24,0,24,1,0,20,1,NASDAQ
4877,14-02-2021 12:00,24 hrs.,pennystocks,PPH,9,9,0,9,1,0,5,1,NASDAQ
4877,14-02-2021 12:00,24 hrs.,pennystocks,PTE,122,0,122,-122,1,48,22,1,NASDAQ
4877,14-02-2021 12:00,24 hrs.,pennystocks,AAPL,635,635,0,635,1,289,53,1,NASDAQ
4877,14-02-2021 12:00,24 hrs.,pennystocks,ACHV,47,47,0,47,1,12,19,1,NASDAQ
4877,14-02-2021 12:00,24 hrs.,pennystocks,ADXS,6,6,0,6,1,1,0,1,NASDAQ
4877,14-02-2021 12:00,24 hrs.,pennystocks,AEZS,26,0,26,-26,1,8,6,1,NASDAQ
4877,14-02-2021 12:00,24 hrs.,pennystocks,AIHS,24,24,0,24,1,0,20,1,NASDAQ
4877,14-02-2021 12:00,24 hrs.,pennystocks,ANTE,25,0,25,-25,1,8,5,1,NASDAQ
4877,14-02-2021 12:00,24 hrs.,pennystocks,AQMS,72,0,72,-72,1,14,40,1,NASDAQ
4877,14-02-2021 12:00,24 hrs.,pennystocks,ARTL,111,78,33,45,2,45,13,2,NASDAQ
4877,14-02-2021 12:00,24 hrs.,pennystocks,ASLN,24,24,0,24,1,0,20,1,NASDAQ
4877,14-02-2021 12:00,24 hrs.,pennystocks,ASRT,77,6,71,-65,3,20,25,3,NASDAQ
4877,14-02-2021 12:00,24 hrs.,pennystocks,ATOS,29,0,29,-29,1,4,17,1,NASDAQ
4877,14-02-2021 12:00,24 hrs.,pennystocks,AUTL,7,7,0,7,1,0,3,1,NASDAQ
4877,14-02-2021 12:00,24 hrs.,pennystocks,AVGR,122,0,122,-122,1,48,22,1,NASDAQ
4877,14-02-2021 12:00,24 hrs.,pennystocks,AYRO,33,0,33,-33,1,13,3,1,NASDAQ
4877,14-02-2021 12:00,24 hrs.,pennystocks,BHAT,24,24,0,24,1,0,20,1,NASDAQ
4877,14-02-2021 12:00,24 hrs.,pennystocks,BHTG,87,0,87,-87,1,35,13,1,NASDAQ
4877,14-02-2021 12:00,24 hrs.,pennystocks,BIMI,24,24,0,24,1,0,20,1,NASDAQ
4877,14-02-2021 12:00,24 hrs.,pennystocks,BNGO,471,221,250,-29,4,143,169,3,NASDAQ
4877,14-02-2021 12:00,24 hrs.,pennystocks,BRQS,37,24,13,11,2,0,29,2,NASDAQ
4877,14-02-2021 12:00,24 hrs.,pennystocks,BVXV,6,6,0,6,1,1,0,1,NASDAQ
4877,14-02-2021 12:00,24 hrs.,pennystocks,BWEN,6,6,0,6,1,1,0,1,NASDAQ
4877,14-02-2021 12:00,24 hrs.,pennystocks,BXRX,12,0,12,-12,2,2,0,2,NASDAQ
4877,14-02-2021 12:00,24 hrs.,pennystocks,CCNC,13,0,13,-13,1,0,9,1,NASDAQ
4877,14-02-2021 12:00,24 hrs.,pennystocks,CCRC,24,24,0,24,1,0,20,1,NASDAQ
4877,14-02-2021 12:00,24 hrs.,pennystocks,CHEK,122,0,122,-122,1,48,22,1,NASDAQ
4877,14-02-2021 12:00,24 hrs.,pennystocks,CHNR,24,24,0,24,1,0,20,1,NASDAQ
4877,14-02-2021 12:00,24 hrs.,pennystocks,CJJD,24,24,0,24,1,0,20,1,NASDAQ
4877,14-02-2021 12:00,24 hrs.,pennystocks,CLBS,92,0,92,-92,1,38,12,1,NASDAQ
4877,14-02-2021 12:00,24 hrs.,pennystocks,CLPS,24,24,0,24,1,0,20,1,NASDAQ
4877,14-02-2021 12:00,24 hrs.,pennystocks,CLRB,78,78,0,78,1,32,10,1,NASDAQ
4877,14-02-2021 12:00,24 hrs.,pennystocks,CNET,24,24,0,24,1,0,20,1,NASDAQ
4877,14-02-2021 12:00,24 hrs.,pennystocks,COCP,15,15,0,15,1,5,1,1,NASDAQ
4877,14-02-2021 12:00,24 hrs.,pennystocks,CREX,122,122,0,122,2,43,28,2,NASDAQ
4877,14-02-2021 12:00,24 hrs.,pennystocks,CSCW,23,23,0,23,2,5,5,2,NASDAQ
4877,14-02-2021 12:00,24 hrs.,pennystocks,CSTR,9,0,9,-9,1,0,5,1,NASDAQ
4877,14-02-2021 12:00,24 hrs.,pennystocks,CTRM,460,98,362,-264,7,166,100,7,NASDAQ
4877,14-02-2021 12:00,24 hrs.,pennystocks,CXDC,24,24,0,24,1,0,20,1,NASDAQ
4877,14-02-2021 12:00,24 hrs.,pennystocks,DFFN,80,0,80,-80,3,25,18,3,NASDAQ
4877,14-02-2021 12:00,24 hrs.,pennystocks,CBD,870,21,849,-828,2,356,150,2,NYSE
4877,14-02-2021 12:00,24 hrs.,pennystocks,CCM,24,24,0,24,1,0,20,1,NYSE
4877,14-02-2021 12:00,24 hrs.,pennystocks,CNF,24,24,0,24,1,0,20,1,NYSE
4877,14-02-2021 12:00,24 hrs.,pennystocks,CVE,22,22,0,22,1,5,8,1,NYSE
4877,14-02-2021 12:00,24 hrs.,pennystocks,DNK,24,24,0,24,1,0,20,1,NYSE
4877,14-02-2021 12:00,24 hrs.,pennystocks,EPR,11,11,0,11,1,0,7,1,NYSE
4877,14-02-2021 12:00,24 hrs.,pennystocks,FLT,26,0,26,-26,1,5,12,1,NYSE
4877,14-02-2021 12:00,24 hrs.,pennystocks,FSD,12,0,12,-12,1,2,4,1,NYSE
4877,14-02-2021 12:00,24 hrs.,pennystocks,GME,12,6,6,0,2,2,0,2,NYSE
4877,14-02-2021 12:00,24 hrs.,pennystocks,KOF,13,0,13,-13,1,3,3,1,NYSE
4877,14-02-2021 12:00,24 hrs.,pennystocks,NGL,4626,0,4626,-4626,2,2233,152,2,NYSE
4877,14-02-2021 12:00,24 hrs.,pennystocks,NOK,260,0,260,-260,1,98,60,1,NYSE
4877,14-02-2021 12:00,24 hrs.,pennystocks,NYC,13,0,13,-13,1,0,9,1,NYSE
4877,14-02-2021 12:00,24 hrs.,pennystocks,PDT,97,0,97,-97,3,27,31,3,NYSE
4877,14-02-2021 12:00,24 hrs.,pennystocks,PEG,635,635,0,635,1,289,53,1,NYSE
4877,14-02-2021 12:00,24 hrs.,pennystocks,PKG,51,0,51,-51,1,20,7,1,NYSE
4865,14-02-2021 10:00,24 hrs.,pennystocks,ECEZ,7,0,7,-7,1,1,1,1,OTC
4865,14-02-2021 10:00,24 hrs.,pennystocks,ECOX,7,0,7,-7,1,1,1,1,OTC
4865,14-02-2021 10:00,24 hrs.,pennystocks,EMED,12,12,0,12,2,2,0,1,OTC
4865,14-02-2021 10:00,24 hrs.,pennystocks,ENZC,72,0,72,-72,1,14,40,1,OTC
4865,14-02-2021 10:00,24 hrs.,pennystocks,EWLL,7,7,0,7,1,1,1,1,OTC
4865,14-02-2021 10:00,24 hrs.,pennystocks,GAXY,26,0,26,-26,1,6,10,1,OTC
4865,14-02-2021 10:00,24 hrs.,pennystocks,GLFH,26,26,0,26,1,4,14,1,OTC
4865,14-02-2021 10:00,24 hrs.,pennystocks,GRSO,7,0,7,-7,1,1,1,1,OTC
4865,14-02-2021 10:00,24 hrs.,pennystocks,GTEH,70,0,70,-70,1,10,46,1,OTC
4865,14-02-2021 10:00,24 hrs.,pennystocks,ABML,24,0,24,-24,4,4,0,1,OTC
4865,14-02-2021 10:00,24 hrs.,pennystocks,ACRL,56,56,0,56,3,15,14,3,OTC
4865,14-02-2021 10:00,24 hrs.,pennystocks,AITX,121,85,36,49,3,48,13,3,OTC
4865,14-02-2021 10:00,24 hrs.,pennystocks,ILHMF,7,0,7,-7,1,1,1,1,OTC
4865,14-02-2021 10:00,24 hrs.,pennystocks,ITMPF,12,0,12,-12,2,2,0,1,OTC
4865,14-02-2021 10:00,24 hrs.,pennystocks,LTHUQ,34,0,34,-34,1,9,12,1,OTC
4865,14-02-2021 10:00,24 hrs.,pennystocks,LTMCF,6,6,0,6,1,1,0,1,OTC
4865,14-02-2021 10:00,24 hrs.,pennystocks,MMEDF,112,0,112,-112,3,23,54,3,OTC
4865,14-02-2021 10:00,24 hrs.,pennystocks,MMNFF,35,0,35,-35,1,14,3,1,OTC
4865,14-02-2021 10:00,24 hrs.,pennystocks,MPUCF,7,0,7,-7,1,1,1,1,OTC
4865,14-02-2021 10:00,24 hrs.,pennystocks,MSNVF,6,0,6,-6,1,1,0,1,OTC
4865,14-02-2021 10:00,24 hrs.,pennystocks,NMGRF,50,0,50,-50,2,17,8,1,OTC
4865,14-02-2021 10:00,24 hrs.,pennystocks,NMTLF,22,0,22,-22,1,7,4,1,OTC
4865,14-02-2021 10:00,24 hrs.,pennystocks,NXTTF,12,6,6,0,2,2,0,2,OTC
4865,14-02-2021 10:00,24 hrs.,pennystocks,PEMIF,17,17,0,17,1,5,3,1,OTC
4865,14-02-2021 10:00,24 hrs.,pennystocks,PHPYF,9,9,0,9,1,0,5,1,OTC
4865,14-02-2021 10:00,24 hrs.,pennystocks,PILBF,6,6,0,6,1,1,0,1,OTC
4865,14-02-2021 10:00,24 hrs.,pennystocks,RLLCF,44,38,6,32,3,6,20,3,OTC
4865,14-02-2021 10:00,24 hrs.,pennystocks,SNNAF,17,17,0,17,1,5,3,1,OTC
4865,14-02-2021 10:00,24 hrs.,pennystocks,SPMTF,17,17,0,17,1,5,3,1,OTC
4865,14-02-2021 10:00,24 hrs.,pennystocks,SPRWF,7,7,0,7,1,1,1,1,OTC
4865,14-02-2021 10:00,24 hrs.,pennystocks,TAKOF,105,95,10,85,3,26,41,3,OTC
4865,14-02-2021 10:00,24 hrs.,pennystocks,TLOFF,72,0,72,-72,1,14,40,1,OTC
4865,14-02-2021 10:00,24 hrs.,pennystocks,HALB,27,0,27,-27,1,7,9,1,OTC
4865,14-02-2021 10:00,24 hrs.,pennystocks,HCMC,97,36,61,-25,16,15,3,15,OTC
4865,14-02-2021 10:00,24 hrs.,pennystocks,HPIL,13,13,0,13,2,2,1,1,OTC
4865,14-02-2021 10:00,24 hrs.,pennystocks,HPMM,13,6,7,-1,2,2,1,2,OTC
4865,14-02-2021 10:00,24 hrs.,pennystocks,HQGE,6,0,6,-6,1,1,0,1,OTC
4865,14-02-2021 10:00,24 hrs.,pennystocks,ICNM,7,0,7,-7,1,1,1,1,OTC
4865,14-02-2021 10:00,24 hrs.,pennystocks,ICTY,6,0,6,-6,1,1,0,1,OTC
4865,14-02-2021 10:00,24 hrs.,pennystocks,IGEN,21,0,21,-21,2,2,9,2,OTC
4865,14-02-2021 10:00,24 hrs.,pennystocks,ILUS,58,58,0,58,1,24,6,1,OTC
4865,14-02-2021 10:00,24 hrs.,pennystocks,INKW,6,0,6,-6,1,1,0,1,OTC
4865,14-02-2021 10:00,24 hrs.,pennystocks,INND,618,25,593,-568,3,261,84,3,OTC
4865,14-02-2021 10:00,24 hrs.,pennystocks,KGET,6,6,0,6,1,1,0,1,OTC
4865,14-02-2021 10:00,24 hrs.,pennystocks,KULR,49,49,0,49,1,13,19,1,OTC
4865,14-02-2021 10:00,24 hrs.,pennystocks,KYNC,6,0,6,-6,1,1,0,1,OTC
4865,14-02-2021 10:00,24 hrs.,pennystocks,LATF,8,0,8,-8,1,1,2,1,OTC
4865,14-02-2021 10:00,24 hrs.,pennystocks,LTNC,42,0,42,-42,1,0,38,1,OTC
4865,14-02-2021 10:00,24 hrs.,pennystocks,MINE,70,0,70,-70,1,10,46,1,OTC
4865,14-02-2021 10:00,24 hrs.,pennystocks,MJNA,88,0,88,-88,3,22,32,2,OTC
4865,14-02-2021 10:00,24 hrs.,pennystocks,MLFB,17,0,17,-17,1,4,5,1,OTC
4865,14-02-2021 10:00,24 hrs.,pennystocks,MSPC,6,0,6,-6,1,1,0,1,OTC
4865,14-02-2021 10:00,24 hrs.,pennystocks,NSPX,6,0,6,-6,1,1,0,1,OTC
4865,14-02-2021 10:00,24 hrs.,pennystocks,NTRR,6,6,0,6,1,1,0,1,OTC
4865,14-02-2021 10:00,24 hrs.,pennystocks,ALYI,85,13,72,-59,3,16,41,2,OTC
4865,14-02-2021 10:00,24 hrs.,pennystocks,AMAZ,6,0,6,-6,1,1,0,1,OTC
4865,14-02-2021 10:00,24 hrs.,pennystocks,AMNE,13,0,13,-13,2,2,1,1,OTC
4865,14-02-2021 10:00,24 hrs.,pennystocks,ASTI,199,193,6,187,2,72,47,2,OTC
4865,14-02-2021 10:00,24 hrs.,pennystocks,ATVK,56,49,7,42,2,14,20,2,OTC
4865,14-02-2021 10:00,24 hrs.,pennystocks,BANT,6,6,0,6,1,1,0,1,OTC
4865,14-02-2021 10:00,24 hrs.,pennystocks,BIEL,6,6,0,6,1,1,0,1,OTC
4865,14-02-2021 10:00,24 hrs.,pennystocks,BNGI,6,6,0,6,1,1,0,1,OTC
4865,14-02-2021 10:00,24 hrs.,pennystocks,BOTY,36,0,36,-36,1,12,8,1,OTC
4865,14-02-2021 10:00,24 hrs.,pennystocks,BRGO,6,0,6,-6,1,1,0,1,OTC
4865,14-02-2021 10:00,24 hrs.,pennystocks,BRRN,10,0,10,-10,1,2,2,1,OTC
4865,14-02-2021 10:00,24 hrs.,pennystocks,BRSE,6,6,0,6,1,1,0,1,OTC
4865,14-02-2021 10:00,24 hrs.,pennystocks,CANN,12,6,6,0,2,2,0,2,OTC
4865,14-02-2021 10:00,24 hrs.,pennystocks,CBBT,108,0,108,-108,2,26,48,2,OTC
4865,14-02-2021 10:00,24 hrs.,pennystocks,CBDL,36,0,36,-36,1,12,8,1,OTC
4865,14-02-2021 10:00,24 hrs.,pennystocks,CCTL,118,6,112,-106,2,30,50,2,OTC
4865,14-02-2021 10:00,24 hrs.,pennystocks,CLIS,18,0,18,-18,2,3,4,1,OTC
4865,14-02-2021 10:00,24 hrs.,pennystocks,CTLE,31,0,31,-31,5,5,1,2,OTC
4865,14-02-2021 10:00,24 hrs.,pennystocks,DIGI,47,0,47,-47,1,17,9,1,OTC
4865,14-02-2021 10:00,24 hrs.,pennystocks,DPLS,26,0,26,-26,1,6,10,1,OTC
4865,14-02-2021 10:00,24 hrs.,pennystocks,DRNK,6,6,0,6,1,1,0,1,OTC
4865,14-02-2021 10:00,24 hrs.,pennystocks,DXLG,35,0,35,-35,1,14,3,1,OTC
4865,14-02-2021 10:00,24 hrs.,pennystocks,GME,12,6,6,0,2,2,0,2,NYSE
4865,14-02-2021 10:00,24 hrs.,pennystocks,KOF,13,0,13,-13,1,3,3,1,NYSE
4865,14-02-2021 10:00,24 hrs.,pennystocks,NGL,4357,0,4357,-4357,2,2102,145,2,NYSE
4865,14-02-2021 10:00,24 hrs.,pennystocks,NOK,254,0,254,-254,1,95,60,1,NYSE
4865,14-02-2021 10:00,24 hrs.,pennystocks,NYC,13,0,13,-13,1,0,9,1,NYSE
4865,14-02-2021 10:00,24 hrs.,pennystocks,PDT,95,23,72,-49,3,26,31,3,NYSE
4865,14-02-2021 10:00,24 hrs.,pennystocks,PEG,505,505,0,505,1,226,49,1,NYSE
4865,14-02-2021 10:00,24 hrs.,pennystocks,PKG,47,0,47,-47,1,18,7,1,NYSE
4865,14-02-2021 10:00,24 hrs.,pennystocks,RSI,529,529,0,529,2,226,69,2,NYSE
4865,14-02-2021 10:00,24 hrs.,pennystocks,RYB,24,24,0,24,1,0,20,1,NYSE
4865,14-02-2021 10:00,24 hrs.,pennystocks,SOS,1282,56,1226,-1170,10,444,354,10,NYSE
4865,14-02-2021 10:00,24 hrs.,pennystocks,STG,24,24,0,24,1,0,20,1,NYSE
4865,14-02-2021 10:00,24 hrs.,pennystocks,SUP,35,0,35,-35,1,14,3,1,NYSE
4865,14-02-2021 10:00,24 hrs.,pennystocks,THC,39,0,39,-39,1,11,13,1,NYSE
4865,14-02-2021 10:00,24 hrs.,pennystocks,TTM,777,0,777,-777,1,317,139,1,NYSE
4865,14-02-2021 10:00,24 hrs.,pennystocks,WEI,24,24,0,24,1,0,20,1,NYSE
4865,14-02-2021 10:00,24 hrs.,pennystocks,XIN,24,24,0,24,1,0,20,1,NYSE
4865,14-02-2021 10:00,24 hrs.,pennystocks,TOWTF,12,0,12,-12,2,2,0,1,OTC
4865,14-02-2021 10:00,24 hrs.,pennystocks,TRUFF,34,0,34,-34,2,7,12,2,OTC
4865,14-02-2021 10:00,24 hrs.,pennystocks,TSCRF,36,0,36,-36,1,10,12,1,OTC
4865,14-02-2021 10:00,24 hrs.,pennystocks,OPTI,47,47,0,47,2,11,17,2,OTC
4865,14-02-2021 10:00,24 hrs.,pennystocks,OZSC,192,7,185,-178,2,79,26,2,OTC
4865,14-02-2021 10:00,24 hrs.,pennystocks,PUGE,155,0,155,-155,1,43,65,1,OTC
4865,14-02-2021 10:00,24 hrs.,pennystocks,PVDG,72,0,72,-72,1,14,40,1,OTC
4865,14-02-2021 10:00,24 hrs.,pennystocks,QBAN,7,7,0,7,1,0,3,1,OTC
4865,14-02-2021 10:00,24 hrs.,pennystocks,QMCI,72,0,72,-72,1,14,40,1,OTC
4865,14-02-2021 10:00,24 hrs.,pennystocks,RBNW,6,6,0,6,1,1,0,1,OTC
4865,14-02-2021 10:00,24 hrs.,pennystocks,RCRT,26,0,26,-26,1,6,10,1,OTC
4865,14-02-2021 10:00,24 hrs.,pennystocks,RSSV,139,49,90,-41,2,50,31,2,OTC
4865,14-02-2021 10:00,24 hrs.,pennystocks,SAFS,6,6,0,6,1,1,0,1,OTC
4865,14-02-2021 10:00,24 hrs.,pennystocks,SGMD,301,0,301,-301,5,97,87,5,OTC
4865,14-02-2021 10:00,24 hrs.,pennystocks,SHMP,7,0,7,-7,1,1,1,1,OTC
4865,14-02-2021 10:00,24 hrs.,pennystocks,SING,83,83,0,83,2,21,33,2,OTC
4865,14-02-2021 10:00,24 hrs.,pennystocks,SIRC,60,0,60,-60,2,15,22,2,OTC
4865,14-02-2021 10:00,24 hrs.,pennystocks,SNNC,6,6,0,6,1,1,0,1,OTC
4865,14-02-2021 10:00,24 hrs.,pennystocks,SNPW,78,0,78,-78,2,15,40,2,OTC
4865,14-02-2021 10:00,24 hrs.,pennystocks,SSFT,49,49,0,49,1,13,19,1,OTC
4865,14-02-2021 10:00,24 hrs.,pennystocks,TAUG,7,7,0,7,1,1,1,1,OTC
4865,14-02-2021 10:00,24 hrs.,pennystocks,TIDE,777,0,777,-777,1,317,139,1,OTC
4865,14-02-2021 10:00,24 hrs.,pennystocks,TLSS,102,102,0,102,1,30,38,1,OTC
4865,14-02-2021 10:00,24 hrs.,pennystocks,TSNP,70,0,70,-70,1,10,46,1,OTC
4865,14-02-2021 10:00,24 hrs.,pennystocks,TVPC,6,0,6,-6,1,1,0,1,OTC
4865,14-02-2021 10:00,24 hrs.,pennystocks,UAPC,25,0,25,-25,2,1,15,2,OTC
4865,14-02-2021 10:00,24 hrs.,pennystocks,VSPC,24,24,0,24,1,8,4,1,OTC
4865,14-02-2021 10:00,24 hrs.,pennystocks,WDLF,12,12,0,12,2,2,0,1,OTC
4865,14-02-2021 10:00,24 hrs.,pennystocks,WEBB,168,168,0,168,1,76,12,1,OTC
4865,14-02-2021 10:00,24 hrs.,pennystocks,WSGF,49,49,0,49,1,13,19,1,OTC
4865,14-02-2021 10:00,24 hrs.,pennystocks,XMET,7,7,0,7,1,1,1,1,OTC
4865,14-02-2021 10:00,24 hrs.,pennystocks,YAYO,43,43,0,43,1,12,15,1,OTC
4865,14-02-2021 10:00,24 hrs.,pennystocks,ZMRK,6,0,6,-6,1,1,0,1,OTC
4865,14-02-2021 10:00,24 hrs.,pennystocks,ABEPF,6,0,6,-6,1,1,0,1,OTC
4865,14-02-2021 10:00,24 hrs.,pennystocks,AMYZF,48,24,24,0,8,8,0,3,OTC
4865,14-02-2021 10:00,24 hrs.,pennystocks,AQSZF,6,0,6,-6,1,1,0,1,OTC
4865,14-02-2021 10:00,24 hrs.,pennystocks,ARBKF,356,58,298,-240,7,100,128,6,OTC
4865,14-02-2021 10:00,24 hrs.,pennystocks,BDRBF,6,0,6,-6,1,1,0,1,OTC
4865,14-02-2021 10:00,24 hrs.,pennystocks,BKTPF,17,17,0,17,1,5,3,1,OTC
4865,14-02-2021 10:00,24 hrs.,pennystocks,BUROF,12,6,6,0,2,2,0,2,OTC
4865,14-02-2021 10:00,24 hrs.,pennystocks,CINGF,49,49,0,49,1,13,19,1,OTC
4865,14-02-2021 10:00,24 hrs.,pennystocks,CLXPF,254,0,254,-254,1,95,60,1,OTC
4865,14-02-2021 10:00,24 hrs.,pennystocks,COCSF,13,0,13,-13,1,3,3,1,OTC
4865,14-02-2021 10:00,24 hrs.,pennystocks,EMHTF,28,28,0,28,1,8,8,1,OTC
4865,14-02-2021 10:00,24 hrs.,pennystocks,HITIF,1085,17,1068,-1051,5,436,193,5,OTC
4865,14-02-2021 10:00,24 hrs.,pennystocks,HTZGQ,6,6,0,6,1,1,0,1,OTC
4865,14-02-2021 10:00,24 hrs.,pennystocks,ICNAF,6,6,0,6,1,1,0,1,OTC
4865,14-02-2021 10:00,24 hrs.,pennystocks,LAIX,24,24,0,24,1,0,20,1,NYSE
4865,14-02-2021 10:00,24 hrs.,pennystocks,LEJU,24,24,0,24,1,0,20,1,NYSE
4865,14-02-2021 10:00,24 hrs.,pennystocks,LITB,24,24,0,24,1,0,20,1,NYSE
4865,14-02-2021 10:00,24 hrs.,pennystocks,MOGU,24,24,0,24,1,0,20,1,NYSE
4865,14-02-2021 10:00,24 hrs.,pennystocks,WELL,7,0,7,-7,1,1,1,1,NYSE
4865,14-02-2021 10:00,24 hrs.,pennystocks,CGC,777,0,777,-777,1,317,139,1,NASDAQ
4865,14-02-2021 10:00,24 hrs.,pennystocks,CIH,24,24,0,24,1,0,20,1,NASDAQ
4865,14-02-2021 10:00,24 hrs.,pennystocks,EVK,24,24,0,24,1,0,20,1,NASDAQ
4865,14-02-2021 10:00,24 hrs.,pennystocks,GLG,24,24,0,24,1,0,20,1,NASDAQ
4865,14-02-2021 10:00,24 hrs.,pennystocks,INO,66,0,66,-66,1,26,10,1,NASDAQ
4865,14-02-2021 10:00,24 hrs.,pennystocks,JFU,24,24,0,24,1,0,20,1,NASDAQ
4865,14-02-2021 10:00,24 hrs.,pennystocks,LYL,24,24,0,24,1,0,20,1,NASDAQ
4865,14-02-2021 10:00,24 hrs.,pennystocks,MKD,24,24,0,24,1,0,20,1,NASDAQ
4865,14-02-2021 10:00,24 hrs.,pennystocks,MTC,24,24,0,24,1,0,20,1,NASDAQ
4865,14-02-2021 10:00,24 hrs.,pennystocks,MYT,24,24,0,24,1,0,20,1,NASDAQ
4865,14-02-2021 10:00,24 hrs.,pennystocks,OSN,24,24,0,24,1,0,20,1,NASDAQ
4865,14-02-2021 10:00,24 hrs.,pennystocks,PME,24,24,0,24,1,0,20,1,NASDAQ
4865,14-02-2021 10:00,24 hrs.,pennystocks,PPH,9,9,0,9,1,0,5,1,NASDAQ
4865,14-02-2021 10:00,24 hrs.,pennystocks,PTE,130,0,130,-130,1,52,22,1,NASDAQ
4865,14-02-2021 10:00,24 hrs.,pennystocks,AAPL,505,505,0,505,1,226,49,1,NASDAQ
4865,14-02-2021 10:00,24 hrs.,pennystocks,ACHV,49,49,0,49,1,13,19,1,NASDAQ
4865,14-02-2021 10:00,24 hrs.,pennystocks,ADXS,6,6,0,6,1,1,0,1,NASDAQ
4865,14-02-2021 10:00,24 hrs.,pennystocks,AEZS,28,0,28,-28,1,9,6,1,NASDAQ
4865,14-02-2021 10:00,24 hrs.,pennystocks,AIHS,24,24,0,24,1,0,20,1,NASDAQ
4865,14-02-2021 10:00,24 hrs.,pennystocks,ALNA,16,0,16,-16,1,2,8,1,NASDAQ
4865,14-02-2021 10:00,24 hrs.,pennystocks,ANTE,23,0,23,-23,1,7,5,1,NASDAQ
4865,14-02-2021 10:00,24 hrs.,pennystocks,AQMS,72,0,72,-72,1,14,40,1,NASDAQ
4865,14-02-2021 10:00,24 hrs.,pennystocks,WALRF,49,49,0,49,1,13,19,1,OTC
4865,14-02-2021 10:00,24 hrs.,pennystocks,BGI,35,0,35,-35,1,14,3,1,AMEX
4865,14-02-2021 10:00,24 hrs.,pennystocks,CTO,777,0,777,-777,1,317,139,1,AMEX
4865,14-02-2021 10:00,24 hrs.,pennystocks,CVM,6,0,6,-6,1,1,0,1,AMEX
4865,14-02-2021 10:00,24 hrs.,pennystocks,DNN,29,16,13,3,4,3,7,4,AMEX
4865,14-02-2021 10:00,24 hrs.,pennystocks,DSS,6,0,6,-6,1,1,0,1,AMEX
4865,14-02-2021 10:00,24 hrs.,pennystocks,DXF,24,24,0,24,1,0,20,1,AMEX
4865,14-02-2021 10:00,24 hrs.,pennystocks,GSV,6,6,0,6,1,1,0,1,AMEX
4865,14-02-2021 10:00,24 hrs.,pennystocks,ITP,24,24,0,24,1,0,20,1,AMEX
4865,14-02-2021 10:00,24 hrs.,pennystocks,NGD,11,0,11,-11,1,2,3,1,AMEX
4865,14-02-2021 10:00,24 hrs.,pennystocks,NTN,35,0,35,-35,1,14,3,1,AMEX
4865,14-02-2021 10:00,24 hrs.,pennystocks,RHE,35,0,35,-35,1,14,3,1,AMEX
4865,14-02-2021 10:00,24 hrs.,pennystocks,SYN,7,7,0,7,1,1,1,1,AMEX
4865,14-02-2021 10:00,24 hrs.,pennystocks,ZOM,348,22,326,-304,3,115,106,3,AMEX
4865,14-02-2021 10:00,24 hrs.,pennystocks,AMBO,24,24,0,24,1,0,20,1,AMEX
4865,14-02-2021 10:00,24 hrs.,pennystocks,AMPE,35,0,35,-35,1,14,3,1,AMEX
4865,14-02-2021 10:00,24 hrs.,pennystocks,CPHI,24,24,0,24,1,0,20,1,AMEX
4865,14-02-2021 10:00,24 hrs.,pennystocks,NSPR,110,0,110,-110,3,19,60,3,AMEX
4865,14-02-2021 10:00,24 hrs.,pennystocks,OGEN,66,0,66,-66,1,26,10,1,AMEX
4865,14-02-2021 10:00,24 hrs.,pennystocks,SENS,37,0,37,-37,2,14,1,2,AMEX
4865,14-02-2021 10:00,24 hrs.,pennystocks,SNMP,17,0,17,-17,1,4,5,1,AMEX
4865,14-02-2021 10:00,24 hrs.,pennystocks,TKAT,24,24,0,24,1,0,20,1,AMEX
4865,14-02-2021 10:00,24 hrs.,pennystocks,TMBR,35,0,35,-35,1,14,3,1,AMEX
4865,14-02-2021 10:00,24 hrs.,pennystocks,UAMY,70,0,70,-70,1,10,46,1,AMEX
4865,14-02-2021 10:00,24 hrs.,pennystocks,ABC,581,581,0,581,1,264,49,1,NYSE
4865,14-02-2021 10:00,24 hrs.,pennystocks,ACB,777,0,777,-777,1,317,139,1,NYSE
4865,14-02-2021 10:00,24 hrs.,pennystocks,ALB,17,17,0,17,1,5,3,1,NYSE
4865,14-02-2021 10:00,24 hrs.,pennystocks,AMC,88,0,88,-88,2,24,32,2,NYSE
4865,14-02-2021 10:00,24 hrs.,pennystocks,ASX,9,0,9,-9,1,1,3,1,NYSE
4865,14-02-2021 10:00,24 hrs.,pennystocks,CBD,802,25,777,-752,2,325,144,2,NYSE
4865,14-02-2021 10:00,24 hrs.,pennystocks,CCM,24,24,0,24,1,0,20,1,NYSE
4865,14-02-2021 10:00,24 hrs.,pennystocks,CNF,24,24,0,24,1,0,20,1,NYSE
4865,14-02-2021 10:00,24 hrs.,pennystocks,CVE,17,17,0,17,1,5,3,1,NYSE
4865,14-02-2021 10:00,24 hrs.,pennystocks,DNK,24,24,0,24,1,0,20,1,NYSE
4865,14-02-2021 10:00,24 hrs.,pennystocks,EPR,9,9,0,9,1,0,5,1,NYSE
4865,14-02-2021 10:00,24 hrs.,pennystocks,FLT,25,25,0,25,1,5,11,1,NYSE
4865,14-02-2021 10:00,24 hrs.,pennystocks,FSD,12,0,12,-12,1,2,4,1,NYSE
4865,14-02-2021 10:00,24 hrs.,pennystocks,HAPP,24,24,0,24,1,0,20,1,NASDAQ
4865,14-02-2021 10:00,24 hrs.,pennystocks,HCDI,16,16,0,16,1,2,8,1,NASDAQ
4865,14-02-2021 10:00,24 hrs.,pennystocks,HGSH,24,24,0,24,1,0,20,1,NASDAQ
4865,14-02-2021 10:00,24 hrs.,pennystocks,HIHO,24,24,0,24,1,0,20,1,NASDAQ
4865,14-02-2021 10:00,24 hrs.,pennystocks,HUSN,35,0,35,-35,1,14,3,1,NASDAQ
4865,14-02-2021 10:00,24 hrs.,pennystocks,ICON,14,0,14,-14,1,3,4,1,NASDAQ
4865,14-02-2021 10:00,24 hrs.,pennystocks,ILMN,35,0,35,-35,1,14,3,1,NASDAQ
4865,14-02-2021 10:00,24 hrs.,pennystocks,ITRM,7,0,7,-7,1,1,1,1,NASDAQ
4865,14-02-2021 10:00,24 hrs.,pennystocks,IZEA,13,0,13,-13,1,0,9,1,NASDAQ
4865,14-02-2021 10:00,24 hrs.,pennystocks,JAGX,32,32,0,32,3,9,2,2,NASDAQ
4865,14-02-2021 10:00,24 hrs.,pennystocks,JFIN,66,66,0,66,2,17,24,2,NASDAQ
4865,14-02-2021 10:00,24 hrs.,pennystocks,KBSF,24,24,0,24,1,0,20,1,NASDAQ
4865,14-02-2021 10:00,24 hrs.,pennystocks,KRKR,24,24,0,24,1,0,20,1,NASDAQ
4865,14-02-2021 10:00,24 hrs.,pennystocks,KXIN,24,24,0,24,1,0,20,1,NASDAQ
4865,14-02-2021 10:00,24 hrs.,pennystocks,LGHL,48,0,48,-48,2,14,12,2,NASDAQ
4865,14-02-2021 10:00,24 hrs.,pennystocks,LIVE,25,25,0,25,1,8,5,1,NASDAQ
4865,14-02-2021 10:00,24 hrs.,pennystocks,LIVX,6,0,6,-6,1,1,0,1,NASDAQ
4865,14-02-2021 10:00,24 hrs.,pennystocks,LKCO,59,24,35,-11,2,14,23,2,NASDAQ
4865,14-02-2021 10:00,24 hrs.,pennystocks,LLNW,6,0,6,-6,1,1,0,1,NASDAQ
4865,14-02-2021 10:00,24 hrs.,pennystocks,MDJH,24,24,0,24,1,0,20,1,NASDAQ
4865,14-02-2021 10:00,24 hrs.,pennystocks,METX,24,24,0,24,1,0,20,1,NASDAQ
4865,14-02-2021 10:00,24 hrs.,pennystocks,MOGO,30,0,30,-30,1,4,18,1,NASDAQ
4865,14-02-2021 10:00,24 hrs.,pennystocks,MOHO,24,24,0,24,1,0,20,1,NASDAQ
4865,14-02-2021 10:00,24 hrs.,pennystocks,MOSY,35,0,35,-35,1,14,3,1,NASDAQ
4865,14-02-2021 10:00,24 hrs.,pennystocks,MOXC,24,24,0,24,1,0,20,1,NASDAQ
4865,14-02-2021 10:00,24 hrs.,pennystocks,NAKD,15,15,0,15,2,1,5,2,NASDAQ
4865,14-02-2021 10:00,24 hrs.,pennystocks,NEWA,24,24,0,24,1,0,20,1,NASDAQ
4865,14-02-2021 10:00,24 hrs.,pennystocks,NVCN,13,0,13,-13,2,2,1,2,NASDAQ
4865,14-02-2021 10:00,24 hrs.,pennystocks,OCGN,47,0,47,-47,1,14,15,1,NASDAQ
4865,14-02-2021 10:00,24 hrs.,pennystocks,OPGN,7,0,7,-7,1,1,1,1,NASDAQ
4865,14-02-2021 10:00,24 hrs.,pennystocks,OPTT,12,0,12,-12,2,2,0,2,NASDAQ
4865,14-02-2021 10:00,24 hrs.,pennystocks,PBTS,136,24,112,-88,2,29,70,2,NASDAQ
4865,14-02-2021 10:00,24 hrs.,pennystocks,PETZ,24,24,0,24,1,0,20,1,NASDAQ
4865,14-02-2021 10:00,24 hrs.,pennystocks,PGEN,6,0,6,-6,1,1,0,1,NASDAQ
4865,14-02-2021 10:00,24 hrs.,pennystocks,PHCF,24,24,0,24,1,0,20,1,NASDAQ
4865,14-02-2021 10:00,24 hrs.,pennystocks,PHUN,13,0,13,-13,1,0,9,1,NASDAQ
4865,14-02-2021 10:00,24 hrs.,pennystocks,PLAY,6,6,0,6,1,1,0,1,NASDAQ
4865,14-02-2021 10:00,24 hrs.,pennystocks,ARTL,77,42,35,7,2,31,7,2,NASDAQ
4865,14-02-2021 10:00,24 hrs.,pennystocks,ASLN,24,24,0,24,1,0,20,1,NASDAQ
4865,14-02-2021 10:00,24 hrs.,pennystocks,ASRT,83,6,77,-71,3,23,25,3,NASDAQ
4865,14-02-2021 10:00,24 hrs.,pennystocks,ATOS,33,33,0,33,1,6,17,1,NASDAQ
4865,14-02-2021 10:00,24 hrs.,pennystocks,AUTL,7,7,0,7,1,0,3,1,NASDAQ
4865,14-02-2021 10:00,24 hrs.,pennystocks,AVGR,130,0,130,-130,1,52,22,1,NASDAQ
4865,14-02-2021 10:00,24 hrs.,pennystocks,AYRO,35,0,35,-35,1,14,3,1,NASDAQ
4865,14-02-2021 10:00,24 hrs.,pennystocks,BHAT,24,24,0,24,1,0,20,1,NASDAQ
4865,14-02-2021 10:00,24 hrs.,pennystocks,BHTG,87,0,87,-87,1,35,13,1,NASDAQ
4865,14-02-2021 10:00,24 hrs.,pennystocks,BIMI,24,24,0,24,1,0,20,1,NASDAQ
4865,14-02-2021 10:00,24 hrs.,pennystocks,BNGO,462,332,130,202,4,139,168,3,NASDAQ
4865,14-02-2021 10:00,24 hrs.,pennystocks,BRQS,37,24,13,11,2,0,29,2,NASDAQ
4865,14-02-2021 10:00,24 hrs.,pennystocks,BVXV,6,6,0,6,1,1,0,1,NASDAQ
4865,14-02-2021 10:00,24 hrs.,pennystocks,BWEN,6,6,0,6,1,1,0,1,NASDAQ
4865,14-02-2021 10:00,24 hrs.,pennystocks,BXRX,12,0,12,-12,2,2,0,2,NASDAQ
4865,14-02-2021 10:00,24 hrs.,pennystocks,CCNC,13,0,13,-13,1,0,9,1,NASDAQ
4865,14-02-2021 10:00,24 hrs.,pennystocks,CCRC,24,24,0,24,1,0,20,1,NASDAQ
4865,14-02-2021 10:00,24 hrs.,pennystocks,CHEK,130,0,130,-130,1,52,22,1,NASDAQ
4865,14-02-2021 10:00,24 hrs.,pennystocks,CHNR,24,24,0,24,1,0,20,1,NASDAQ
4865,14-02-2021 10:00,24 hrs.,pennystocks,CJJD,24,24,0,24,1,0,20,1,NASDAQ
4865,14-02-2021 10:00,24 hrs.,pennystocks,XYF,24,24,0,24,1,0,20,1,NYSE
4865,14-02-2021 10:00,24 hrs.,pennystocks,ARGO,68,0,68,-68,1,25,14,1,NYSE
4865,14-02-2021 10:00,24 hrs.,pennystocks,BORR,7,7,0,7,1,1,1,1,NYSE
4865,14-02-2021 10:00,24 hrs.,pennystocks,CMCM,24,24,0,24,1,0,20,1,NYSE
4865,14-02-2021 10:00,24 hrs.,pennystocks,FEDU,24,24,0,24,1,0,20,1,NYSE
4865,14-02-2021 10:00,24 hrs.,pennystocks,FENG,24,24,0,24,1,0,20,1,NYSE
4865,14-02-2021 10:00,24 hrs.,pennystocks,HEXO,782,0,782,-782,2,317,140,2,NYSE
4865,14-02-2021 10:00,24 hrs.,pennystocks,PULM,6,0,6,-6,1,1,0,1,NASDAQ
4865,14-02-2021 10:00,24 hrs.,pennystocks,RAVE,35,0,35,-35,1,14,3,1,NASDAQ
4865,14-02-2021 10:00,24 hrs.,pennystocks,RCON,24,24,0,24,1,0,20,1,NASDAQ
4865,14-02-2021 10:00,24 hrs.,pennystocks,RETO,24,24,0,24,1,0,20,1,NASDAQ
4865,14-02-2021 10:00,24 hrs.,pennystocks,RUHN,24,24,0,24,1,0,20,1,NASDAQ
4865,14-02-2021 10:00,24 hrs.,pennystocks,RWLK,35,0,35,-35,1,14,3,1,NASDAQ
4865,14-02-2021 10:00,24 hrs.,pennystocks,SALM,35,0,35,-35,1,14,3,1,NASDAQ
4865,14-02-2021 10:00,24 hrs.,pennystocks,SAVA,49,49,0,49,1,13,19,1,NASDAQ
4865,14-02-2021 10:00,24 hrs.,pennystocks,SECO,24,24,0,24,1,0,20,1,NASDAQ
4865,14-02-2021 10:00,24 hrs.,pennystocks,SGOC,24,24,0,24,1,0,20,1,NASDAQ
4865,14-02-2021 10:00,24 hrs.,pennystocks,SHIP,83,48,35,13,3,32,7,3,NASDAQ
4865,14-02-2021 10:00,24 hrs.,pennystocks,SNDL,55,7,48,-41,8,8,7,3,NASDAQ
4865,14-02-2021 10:00,24 hrs.,pennystocks,SNGX,25,12,13,-1,4,4,1,3,NASDAQ
4865,14-02-2021 10:00,24 hrs.,pennystocks,SXTC,24,24,0,24,1,0,20,1,NASDAQ
4865,14-02-2021 10:00,24 hrs.,pennystocks,TANH,24,24,0,24,1,0,20,1,NASDAQ
4865,14-02-2021 10:00,24 hrs.,pennystocks,TAOP,24,24,0,24,1,0,20,1,NASDAQ
4865,14-02-2021 10:00,24 hrs.,pennystocks,TEDU,24,24,0,24,1,0,20,1,NASDAQ
4865,14-02-2021 10:00,24 hrs.,pennystocks,TLRY,777,0,777,-777,1,317,139,1,NASDAQ
4865,14-02-2021 10:00,24 hrs.,pennystocks,TNXP,94,82,12,70,5,25,24,5,NASDAQ
4865,14-02-2021 10:00,24 hrs.,pennystocks,TOPS,35,0,35,-35,1,14,3,1,NASDAQ
4865,14-02-2021 10:00,24 hrs.,pennystocks,TOUR,24,24,0,24,1,0,20,1,NASDAQ
4865,14-02-2021 10:00,24 hrs.,pennystocks,TRIP,28,0,28,-28,1,6,12,1,NASDAQ
4865,14-02-2021 10:00,24 hrs.,pennystocks,TRVG,48,0,48,-48,3,16,4,3,NASDAQ
4865,14-02-2021 10:00,24 hrs.,pennystocks,TXMD,7,0,7,-7,1,1,1,1,NASDAQ
4865,14-02-2021 10:00,24 hrs.,pennystocks,TYHT,24,24,0,24,1,0,20,1,NASDAQ
4865,14-02-2021 10:00,24 hrs.,pennystocks,USWS,6,6,0,6,1,1,0,1,NASDAQ
4865,14-02-2021 10:00,24 hrs.,pennystocks,UTSI,24,24,0,24,1,0,20,1,NASDAQ
4865,14-02-2021 10:00,24 hrs.,pennystocks,UXIN,24,24,0,24,1,0,20,1,NASDAQ
4865,14-02-2021 10:00,24 hrs.,pennystocks,VYNE,25,25,0,25,2,4,9,1,NASDAQ
4865,14-02-2021 10:00,24 hrs.,pennystocks,XSPA,24,0,24,-24,4,4,0,3,NASDAQ
4865,14-02-2021 10:00,24 hrs.,pennystocks,YMTX,15,0,15,-15,1,3,5,1,NASDAQ
4865,14-02-2021 10:00,24 hrs.,pennystocks,ZCMD,24,24,0,24,1,0,20,1,NASDAQ
4865,14-02-2021 10:00,24 hrs.,pennystocks,ZKIN,13,0,13,-13,1,0,9,1,NASDAQ
4865,14-02-2021 10:00,24 hrs.,pennystocks,ZSAN,45,39,6,33,2,2,33,2,NASDAQ
4865,14-02-2021 10:00,24 hrs.,pennystocks,PLIN,24,24,0,24,1,0,20,1,NASDAQ
4865,14-02-2021 10:00,24 hrs.,pennystocks,PSEC,6,0,6,-6,1,1,0,1,NASDAQ
4865,14-02-2021 10:00,24 hrs.,pennystocks,PSTV,6,0,6,-6,1,1,0,1,NASDAQ
4865,14-02-2021 10:00,24 hrs.,pennystocks,CLBS,90,0,90,-90,1,37,12,1,NASDAQ
4865,14-02-2021 10:00,24 hrs.,pennystocks,CLPS,24,24,0,24,1,0,20,1,NASDAQ
4865,14-02-2021 10:00,24 hrs.,pennystocks,CLRB,42,42,0,42,1,17,4,1,NASDAQ
4865,14-02-2021 10:00,24 hrs.,pennystocks,CNET,24,24,0,24,1,0,20,1,NASDAQ
4865,14-02-2021 10:00,24 hrs.,pennystocks,CREX,80,80,0,80,2,26,20,2,NASDAQ
4865,14-02-2021 10:00,24 hrs.,pennystocks,CSCW,25,25,0,25,2,6,5,2,NASDAQ
4865,14-02-2021 10:00,24 hrs.,pennystocks,CSTR,9,0,9,-9,1,0,5,1,NASDAQ
4865,14-02-2021 10:00,24 hrs.,pennystocks,CTRM,408,62,346,-284,7,143,94,7,NASDAQ
4865,14-02-2021 10:00,24 hrs.,pennystocks,CXDC,24,24,0,24,1,0,20,1,NASDAQ
4865,14-02-2021 10:00,24 hrs.,pennystocks,DFFN,82,7,75,-68,3,26,18,3,NASDAQ
4865,14-02-2021 10:00,24 hrs.,pennystocks,DOGZ,24,24,0,24,1,0,20,1,NASDAQ
4865,14-02-2021 10:00,24 hrs.,pennystocks,DSWL,24,24,0,24,1,0,20,1,NASDAQ
4865,14-02-2021 10:00,24 hrs.,pennystocks,DTSS,24,24,0,24,1,0,20,1,NASDAQ
4865,14-02-2021 10:00,24 hrs.,pennystocks,EDIT,1119,0,1119,-1119,1,318,479,1,NASDAQ
4865,14-02-2021 10:00,24 hrs.,pennystocks,EDTK,24,24,0,24,1,0,20,1,NASDAQ
4865,14-02-2021 10:00,24 hrs.,pennystocks,EYES,6,0,6,-6,1,1,0,1,NASDAQ
4865,14-02-2021 10:00,24 hrs.,pennystocks,FAMI,24,24,0,24,1,0,20,1,NASDAQ
4865,14-02-2021 10:00,24 hrs.,pennystocks,FLMN,6,6,0,6,1,1,0,1,NASDAQ
4865,14-02-2021 10:00,24 hrs.,pennystocks,FORD,97,0,97,-97,1,39,15,1,NASDAQ
4865,14-02-2021 10:00,24 hrs.,pennystocks,FTFT,35,0,35,-35,1,14,3,1,NASDAQ
4865,14-02-2021 10:00,24 hrs.,pennystocks,GIGM,24,24,0,24,1,0,20,1,NASDAQ
4865,14-02-2021 10:00,24 hrs.,pennystocks,GNUS,12,0,12,-12,2,2,0,2,NASDAQ
4865,14-02-2021 10:00,24 hrs.,pennystocks,GRIL,35,0,35,-35,1,14,3,1,NASDAQ
4865,14-02-2021 10:00,24 hrs.,pennystocks,GRNQ,24,24,0,24,1,0,20,1,NASDAQ
4865,14-02-2021 10:00,24 hrs.,pennystocks,GSUM,24,24,0,24,1,0,20,1,NASDAQ
4865,14-02-2021 10:00,24 hrs.,pennystocks,GTHX,6,6,0,6,1,1,0,1,NASDAQ
4865,14-02-2021 10:00,24 hrs.,pennystocks,GURE,24,24,0,24,1,0,20,1,NASDAQ
4852,14-02-2021 08:00,24 hrs.,pennystocks,ILMN,35,35,0,35,1,14,3,1,NASDAQ
4852,14-02-2021 08:00,24 hrs.,pennystocks,ITRM,7,0,7,-7,1,1,1,1,NASDAQ
4852,14-02-2021 08:00,24 hrs.,pennystocks,IZEA,13,0,13,-13,1,0,9,1,NASDAQ
4852,14-02-2021 08:00,24 hrs.,pennystocks,JAGX,36,36,0,36,3,11,2,2,NASDAQ
4852,14-02-2021 08:00,24 hrs.,pennystocks,JFIN,24,24,0,24,1,0,20,1,NASDAQ
4852,14-02-2021 08:00,24 hrs.,pennystocks,KBSF,24,24,0,24,1,0,20,1,NASDAQ
4852,14-02-2021 08:00,24 hrs.,pennystocks,KRKR,24,24,0,24,1,0,20,1,NASDAQ
4852,14-02-2021 08:00,24 hrs.,pennystocks,KXIN,24,24,0,24,1,0,20,1,NASDAQ
4852,14-02-2021 08:00,24 hrs.,pennystocks,LGHL,48,35,13,22,2,14,12,2,NASDAQ
4852,14-02-2021 08:00,24 hrs.,pennystocks,LIVE,27,27,0,27,1,9,5,1,NASDAQ
4852,14-02-2021 08:00,24 hrs.,pennystocks,LIVX,6,0,6,-6,1,1,0,1,NASDAQ
4852,14-02-2021 08:00,24 hrs.,pennystocks,LKCO,59,59,0,59,2,14,23,2,NASDAQ
4852,14-02-2021 08:00,24 hrs.,pennystocks,LLNW,6,6,0,6,1,1,0,1,NASDAQ
4852,14-02-2021 08:00,24 hrs.,pennystocks,MDJH,24,24,0,24,1,0,20,1,NASDAQ
4852,14-02-2021 08:00,24 hrs.,pennystocks,METX,24,24,0,24,1,0,20,1,NASDAQ
4852,14-02-2021 08:00,24 hrs.,pennystocks,MOGO,34,0,34,-34,1,6,18,1,NASDAQ
4852,14-02-2021 08:00,24 hrs.,pennystocks,MOHO,24,24,0,24,1,0,20,1,NASDAQ
4852,14-02-2021 08:00,24 hrs.,pennystocks,MOSY,35,35,0,35,1,14,3,1,NASDAQ
4852,14-02-2021 08:00,24 hrs.,pennystocks,MOXC,24,24,0,24,1,0,20,1,NASDAQ
4852,14-02-2021 08:00,24 hrs.,pennystocks,NAKD,15,15,0,15,2,1,5,2,NASDAQ
4852,14-02-2021 08:00,24 hrs.,pennystocks,NEWA,24,24,0,24,1,0,20,1,NASDAQ
4852,14-02-2021 08:00,24 hrs.,pennystocks,NVCN,13,7,6,1,2,2,1,2,NASDAQ
4852,14-02-2021 08:00,24 hrs.,pennystocks,OCGN,45,0,45,-45,1,13,15,1,NASDAQ
4852,14-02-2021 08:00,24 hrs.,pennystocks,OPGN,7,7,0,7,1,1,1,1,NASDAQ
4852,14-02-2021 08:00,24 hrs.,pennystocks,OPTT,12,0,12,-12,2,2,0,2,NASDAQ
4852,14-02-2021 08:00,24 hrs.,pennystocks,PBTS,134,24,110,-86,2,28,70,2,NASDAQ
4852,14-02-2021 08:00,24 hrs.,pennystocks,PETZ,24,24,0,24,1,0,20,1,NASDAQ
4852,14-02-2021 08:00,24 hrs.,pennystocks,PGEN,6,0,6,-6,1,1,0,1,NASDAQ
4852,14-02-2021 08:00,24 hrs.,pennystocks,PHCF,24,24,0,24,1,0,20,1,NASDAQ
4852,14-02-2021 08:00,24 hrs.,pennystocks,PHUN,13,0,13,-13,1,0,9,1,NASDAQ
4852,14-02-2021 08:00,24 hrs.,pennystocks,PLAY,6,6,0,6,1,1,0,1,NASDAQ
4852,14-02-2021 08:00,24 hrs.,pennystocks,PLIN,24,24,0,24,1,0,20,1,NASDAQ
4852,14-02-2021 08:00,24 hrs.,pennystocks,PSEC,6,0,6,-6,1,1,0,1,NASDAQ
4852,14-02-2021 08:00,24 hrs.,pennystocks,PSTV,6,0,6,-6,1,1,0,1,NASDAQ
4852,14-02-2021 08:00,24 hrs.,pennystocks,PULM,6,0,6,-6,1,1,0,1,NASDAQ
4852,14-02-2021 08:00,24 hrs.,pennystocks,RAVE,35,35,0,35,1,14,3,1,NASDAQ
4852,14-02-2021 08:00,24 hrs.,pennystocks,RCON,24,24,0,24,1,0,20,1,NASDAQ
4852,14-02-2021 08:00,24 hrs.,pennystocks,RETO,24,24,0,24,1,0,20,1,NASDAQ
4852,14-02-2021 08:00,24 hrs.,pennystocks,RUHN,24,24,0,24,1,0,20,1,NASDAQ
4852,14-02-2021 08:00,24 hrs.,pennystocks,RWLK,35,35,0,35,1,14,3,1,NASDAQ
4852,14-02-2021 08:00,24 hrs.,pennystocks,SALM,35,35,0,35,1,14,3,1,NASDAQ
4852,14-02-2021 08:00,24 hrs.,pennystocks,SAVA,54,54,0,54,1,16,18,1,NASDAQ
4852,14-02-2021 08:00,24 hrs.,pennystocks,SEAC,5,0,5,-5,1,0,1,1,NASDAQ
4852,14-02-2021 08:00,24 hrs.,pennystocks,SECO,24,24,0,24,1,0,20,1,NASDAQ
4852,14-02-2021 08:00,24 hrs.,pennystocks,SGOC,24,24,0,24,1,0,20,1,NASDAQ
4852,14-02-2021 08:00,24 hrs.,pennystocks,SHIP,41,41,0,41,2,15,3,2,NASDAQ
4852,14-02-2021 08:00,24 hrs.,pennystocks,SNDL,55,13,42,-29,8,8,7,3,NASDAQ
4852,14-02-2021 08:00,24 hrs.,pennystocks,SNGX,25,12,13,-1,4,4,1,3,NASDAQ
4852,14-02-2021 08:00,24 hrs.,pennystocks,BXRX,12,0,12,-12,2,2,0,2,NASDAQ
4852,14-02-2021 08:00,24 hrs.,pennystocks,CCNC,13,0,13,-13,1,0,9,1,NASDAQ
4852,14-02-2021 08:00,24 hrs.,pennystocks,CCRC,24,24,0,24,1,0,20,1,NASDAQ
4852,14-02-2021 08:00,24 hrs.,pennystocks,CHEK,128,0,128,-128,1,51,22,1,NASDAQ
4852,14-02-2021 08:00,24 hrs.,pennystocks,CHNR,24,24,0,24,1,0,20,1,NASDAQ
4852,14-02-2021 08:00,24 hrs.,pennystocks,CJJD,24,24,0,24,1,0,20,1,NASDAQ
4852,14-02-2021 08:00,24 hrs.,pennystocks,CLBS,100,0,100,-100,1,42,12,1,NASDAQ
4852,14-02-2021 08:00,24 hrs.,pennystocks,CLPS,24,24,0,24,1,0,20,1,NASDAQ
4852,14-02-2021 08:00,24 hrs.,pennystocks,CMPS,24,0,24,-24,1,4,12,1,NASDAQ
4852,14-02-2021 08:00,24 hrs.,pennystocks,CNET,24,24,0,24,1,0,20,1,NASDAQ
4852,14-02-2021 08:00,24 hrs.,pennystocks,CREX,36,36,0,36,1,8,16,1,NASDAQ
4852,14-02-2021 08:00,24 hrs.,pennystocks,CSCW,23,23,0,23,2,5,5,2,NASDAQ
4852,14-02-2021 08:00,24 hrs.,pennystocks,CSTR,9,9,0,9,1,0,5,1,NASDAQ
4852,14-02-2021 08:00,24 hrs.,pennystocks,CTRM,415,104,311,-207,7,136,115,7,NASDAQ
4852,14-02-2021 08:00,24 hrs.,pennystocks,CXDC,24,24,0,24,1,0,20,1,NASDAQ
4852,14-02-2021 08:00,24 hrs.,pennystocks,DFFN,77,70,7,63,3,25,15,3,NASDAQ
4852,14-02-2021 08:00,24 hrs.,pennystocks,DOGZ,24,24,0,24,1,0,20,1,NASDAQ
4852,14-02-2021 08:00,24 hrs.,pennystocks,DSWL,24,24,0,24,1,0,20,1,NASDAQ
4852,14-02-2021 08:00,24 hrs.,pennystocks,DTSS,24,24,0,24,1,0,20,1,NASDAQ
4852,14-02-2021 08:00,24 hrs.,pennystocks,EDIT,1234,1091,143,948,2,352,522,2,NASDAQ
4852,14-02-2021 08:00,24 hrs.,pennystocks,EDTK,24,24,0,24,1,0,20,1,NASDAQ
4852,14-02-2021 08:00,24 hrs.,pennystocks,EYES,6,6,0,6,1,1,0,1,NASDAQ
4852,14-02-2021 08:00,24 hrs.,pennystocks,FAMI,24,24,0,24,1,0,20,1,NASDAQ
4852,14-02-2021 08:00,24 hrs.,pennystocks,FLMN,6,6,0,6,1,1,0,1,NASDAQ
4852,14-02-2021 08:00,24 hrs.,pennystocks,FORD,97,0,97,-97,1,39,15,1,NASDAQ
4852,14-02-2021 08:00,24 hrs.,pennystocks,FTFT,35,35,0,35,1,14,3,1,NASDAQ
4852,14-02-2021 08:00,24 hrs.,pennystocks,GIGM,24,24,0,24,1,0,20,1,NASDAQ
4852,14-02-2021 08:00,24 hrs.,pennystocks,GNUS,12,6,6,0,2,2,0,2,NASDAQ
4852,14-02-2021 08:00,24 hrs.,pennystocks,GRIL,35,35,0,35,1,14,3,1,NASDAQ
4852,14-02-2021 08:00,24 hrs.,pennystocks,GRNQ,24,24,0,24,1,0,20,1,NASDAQ
4852,14-02-2021 08:00,24 hrs.,pennystocks,GSUM,24,24,0,24,1,0,20,1,NASDAQ
4852,14-02-2021 08:00,24 hrs.,pennystocks,GTHX,6,6,0,6,1,1,0,1,NASDAQ
4852,14-02-2021 08:00,24 hrs.,pennystocks,GURE,24,24,0,24,1,0,20,1,NASDAQ
4852,14-02-2021 08:00,24 hrs.,pennystocks,HAPP,24,24,0,24,1,0,20,1,NASDAQ
4852,14-02-2021 08:00,24 hrs.,pennystocks,HCDI,16,16,0,16,1,2,8,1,NASDAQ
4852,14-02-2021 08:00,24 hrs.,pennystocks,HGSH,24,24,0,24,1,0,20,1,NASDAQ
4852,14-02-2021 08:00,24 hrs.,pennystocks,HIHO,24,24,0,24,1,0,20,1,NASDAQ
4852,14-02-2021 08:00,24 hrs.,pennystocks,HUSN,35,35,0,35,1,14,3,1,NASDAQ
4852,14-02-2021 08:00,24 hrs.,pennystocks,ICON,14,0,14,-14,1,3,4,1,NASDAQ
4852,14-02-2021 08:00,24 hrs.,pennystocks,PTE,128,0,128,-128,1,51,22,1,NASDAQ
4852,14-02-2021 08:00,24 hrs.,pennystocks,AAPL,390,390,0,390,1,172,42,1,NASDAQ
4852,14-02-2021 08:00,24 hrs.,pennystocks,ACHV,54,54,0,54,1,16,18,1,NASDAQ
4852,14-02-2021 08:00,24 hrs.,pennystocks,ADXS,6,6,0,6,1,1,0,1,NASDAQ
4852,14-02-2021 08:00,24 hrs.,pennystocks,AEZS,24,24,0,24,1,7,6,1,NASDAQ
4852,14-02-2021 08:00,24 hrs.,pennystocks,AIHS,24,24,0,24,1,0,20,1,NASDAQ
4852,14-02-2021 08:00,24 hrs.,pennystocks,ALNA,15,0,15,-15,1,2,7,1,NASDAQ
4852,14-02-2021 08:00,24 hrs.,pennystocks,ANTE,23,0,23,-23,1,7,5,1,NASDAQ
4852,14-02-2021 08:00,24 hrs.,pennystocks,AQMS,76,0,76,-76,1,16,40,1,NASDAQ
4852,14-02-2021 08:00,24 hrs.,pennystocks,ARTL,35,35,0,35,1,14,3,1,NASDAQ
4852,14-02-2021 08:00,24 hrs.,pennystocks,ASLN,24,24,0,24,1,0,20,1,NASDAQ
4852,14-02-2021 08:00,24 hrs.,pennystocks,ASRT,77,6,71,-65,3,20,25,3,NASDAQ
4852,14-02-2021 08:00,24 hrs.,pennystocks,ATOS,27,27,0,27,1,3,17,1,NASDAQ
4852,14-02-2021 08:00,24 hrs.,pennystocks,AUTL,6,6,0,6,1,0,2,1,NASDAQ
4852,14-02-2021 08:00,24 hrs.,pennystocks,AVGR,128,0,128,-128,1,51,22,1,NASDAQ
4852,14-02-2021 08:00,24 hrs.,pennystocks,AYRO,35,35,0,35,1,14,3,1,NASDAQ
4852,14-02-2021 08:00,24 hrs.,pennystocks,BHAT,24,24,0,24,1,0,20,1,NASDAQ
4852,14-02-2021 08:00,24 hrs.,pennystocks,BHTG,83,0,83,-83,1,33,13,1,NASDAQ
4852,14-02-2021 08:00,24 hrs.,pennystocks,BIMI,24,24,0,24,1,0,20,1,NASDAQ
4852,14-02-2021 08:00,24 hrs.,pennystocks,BLUE,36,0,36,-36,1,7,18,1,NASDAQ
4852,14-02-2021 08:00,24 hrs.,pennystocks,BNGO,422,294,128,166,4,121,164,3,NASDAQ
4852,14-02-2021 08:00,24 hrs.,pennystocks,BRQS,37,24,13,11,2,0,29,2,NASDAQ
4852,14-02-2021 08:00,24 hrs.,pennystocks,BVXV,6,6,0,6,1,1,0,1,NASDAQ
4852,14-02-2021 08:00,24 hrs.,pennystocks,BWEN,6,6,0,6,1,1,0,1,NASDAQ
4852,14-02-2021 08:00,24 hrs.,pennystocks,ZOM,345,24,321,-297,3,114,105,3,AMEX
4852,14-02-2021 08:00,24 hrs.,pennystocks,AMBO,24,24,0,24,1,0,20,1,AMEX
4852,14-02-2021 08:00,24 hrs.,pennystocks,AMPE,35,35,0,35,1,14,3,1,AMEX
4852,14-02-2021 08:00,24 hrs.,pennystocks,CPHI,24,24,0,24,1,0,20,1,AMEX
4852,14-02-2021 08:00,24 hrs.,pennystocks,NSPR,108,0,108,-108,3,18,60,3,AMEX
4852,14-02-2021 08:00,24 hrs.,pennystocks,OGEN,66,0,66,-66,1,26,10,1,AMEX
4852,14-02-2021 08:00,24 hrs.,pennystocks,SENS,41,0,41,-41,2,16,1,2,AMEX
4852,14-02-2021 08:00,24 hrs.,pennystocks,SNMP,17,0,17,-17,1,4,5,1,AMEX
4852,14-02-2021 08:00,24 hrs.,pennystocks,TKAT,24,24,0,24,1,0,20,1,AMEX
4852,14-02-2021 08:00,24 hrs.,pennystocks,TMBR,35,35,0,35,1,14,3,1,AMEX
4852,14-02-2021 08:00,24 hrs.,pennystocks,UAMY,70,0,70,-70,1,10,46,1,AMEX
4852,14-02-2021 08:00,24 hrs.,pennystocks,ABC,220,220,0,220,1,98,20,1,NYSE
4852,14-02-2021 08:00,24 hrs.,pennystocks,ACB,698,698,0,698,1,279,136,1,NYSE
4852,14-02-2021 08:00,24 hrs.,pennystocks,AMC,80,0,80,-80,2,20,32,2,NYSE
4852,14-02-2021 08:00,24 hrs.,pennystocks,ASX,9,0,9,-9,1,1,3,1,NYSE
4852,14-02-2021 08:00,24 hrs.,pennystocks,CBD,721,721,0,721,2,286,141,2,NYSE
4852,14-02-2021 08:00,24 hrs.,pennystocks,CCM,24,24,0,24,1,0,20,1,NYSE
4852,14-02-2021 08:00,24 hrs.,pennystocks,CNF,24,24,0,24,1,0,20,1,NYSE
4852,14-02-2021 08:00,24 hrs.,pennystocks,DNK,24,24,0,24,1,0,20,1,NYSE
4852,14-02-2021 08:00,24 hrs.,pennystocks,EPR,9,9,0,9,1,0,5,1,NYSE
4852,14-02-2021 08:00,24 hrs.,pennystocks,FLT,27,27,0,27,1,6,11,1,NYSE
4852,14-02-2021 08:00,24 hrs.,pennystocks,FSD,12,0,12,-12,1,2,4,1,NYSE
4852,14-02-2021 08:00,24 hrs.,pennystocks,GME,12,6,6,0,2,2,0,2,NYSE
4852,14-02-2021 08:00,24 hrs.,pennystocks,KOF,13,0,13,-13,1,3,3,1,NYSE
4852,14-02-2021 08:00,24 hrs.,pennystocks,NGL,4043,0,4043,-4043,2,1947,141,2,NYSE
4852,14-02-2021 08:00,24 hrs.,pennystocks,NOK,245,0,245,-245,1,91,59,1,NYSE
4852,14-02-2021 08:00,24 hrs.,pennystocks,NYC,13,0,13,-13,1,0,9,1,NYSE
4852,14-02-2021 08:00,24 hrs.,pennystocks,PDT,95,23,72,-49,3,26,31,3,NYSE
4852,14-02-2021 08:00,24 hrs.,pennystocks,PEG,390,390,0,390,1,172,42,1,NYSE
4852,14-02-2021 08:00,24 hrs.,pennystocks,PKG,45,0,45,-45,1,17,7,1,NYSE
4852,14-02-2021 08:00,24 hrs.,pennystocks,RSI,414,414,0,414,2,172,62,2,NYSE
4852,14-02-2021 08:00,24 hrs.,pennystocks,RYB,24,24,0,24,1,0,20,1,NYSE
4852,14-02-2021 08:00,24 hrs.,pennystocks,SOS,1272,62,1210,-1148,10,442,348,10,NYSE
4852,14-02-2021 08:00,24 hrs.,pennystocks,STG,24,24,0,24,1,0,20,1,NYSE
4852,14-02-2021 08:00,24 hrs.,pennystocks,SUP,35,35,0,35,1,14,3,1,NYSE
4852,14-02-2021 08:00,24 hrs.,pennystocks,THC,39,0,39,-39,1,11,13,1,NYSE
4852,14-02-2021 08:00,24 hrs.,pennystocks,TTM,698,698,0,698,1,279,136,1,NYSE
4852,14-02-2021 08:00,24 hrs.,pennystocks,WEI,24,24,0,24,1,0,20,1,NYSE
4852,14-02-2021 08:00,24 hrs.,pennystocks,XIN,24,24,0,24,1,0,20,1,NYSE
4852,14-02-2021 08:00,24 hrs.,pennystocks,XYF,24,24,0,24,1,0,20,1,NYSE
4852,14-02-2021 08:00,24 hrs.,pennystocks,ARGO,66,0,66,-66,1,24,14,1,NYSE
4852,14-02-2021 08:00,24 hrs.,pennystocks,BORR,7,7,0,7,1,1,1,1,NYSE
4852,14-02-2021 08:00,24 hrs.,pennystocks,CMCM,24,24,0,24,1,0,20,1,NYSE
4852,14-02-2021 08:00,24 hrs.,pennystocks,FEDU,24,24,0,24,1,0,20,1,NYSE
4852,14-02-2021 08:00,24 hrs.,pennystocks,FENG,24,24,0,24,1,0,20,1,NYSE
4852,14-02-2021 08:00,24 hrs.,pennystocks,HEXO,703,698,5,693,2,279,137,2,NYSE
4852,14-02-2021 08:00,24 hrs.,pennystocks,LAIX,24,24,0,24,1,0,20,1,NYSE
4852,14-02-2021 08:00,24 hrs.,pennystocks,LEJU,24,24,0,24,1,0,20,1,NYSE
4852,14-02-2021 08:00,24 hrs.,pennystocks,LITB,24,24,0,24,1,0,20,1,NYSE
4852,14-02-2021 08:00,24 hrs.,pennystocks,MOGU,24,24,0,24,1,0,20,1,NYSE
4852,14-02-2021 08:00,24 hrs.,pennystocks,WELL,7,7,0,7,1,1,1,1,NYSE
4852,14-02-2021 08:00,24 hrs.,pennystocks,CGC,698,698,0,698,1,279,136,1,NASDAQ
4852,14-02-2021 08:00,24 hrs.,pennystocks,CIH,24,24,0,24,1,0,20,1,NASDAQ
4852,14-02-2021 08:00,24 hrs.,pennystocks,EVK,24,24,0,24,1,0,20,1,NASDAQ
4852,14-02-2021 08:00,24 hrs.,pennystocks,GLG,24,24,0,24,1,0,20,1,NASDAQ
4852,14-02-2021 08:00,24 hrs.,pennystocks,INO,66,0,66,-66,1,26,10,1,NASDAQ
4852,14-02-2021 08:00,24 hrs.,pennystocks,JFU,24,24,0,24,1,0,20,1,NASDAQ
4852,14-02-2021 08:00,24 hrs.,pennystocks,LYL,24,24,0,24,1,0,20,1,NASDAQ
4852,14-02-2021 08:00,24 hrs.,pennystocks,MKD,24,24,0,24,1,0,20,1,NASDAQ
4852,14-02-2021 08:00,24 hrs.,pennystocks,MTC,24,24,0,24,1,0,20,1,NASDAQ
4852,14-02-2021 08:00,24 hrs.,pennystocks,MYT,24,24,0,24,1,0,20,1,NASDAQ
4852,14-02-2021 08:00,24 hrs.,pennystocks,OSN,24,24,0,24,1,0,20,1,NASDAQ
4852,14-02-2021 08:00,24 hrs.,pennystocks,PME,24,24,0,24,1,0,20,1,NASDAQ
4852,14-02-2021 08:00,24 hrs.,pennystocks,PPH,8,8,0,8,1,0,4,1,NASDAQ
4852,14-02-2021 08:00,24 hrs.,pennystocks,TIDE,698,698,0,698,1,279,136,1,OTC
4852,14-02-2021 08:00,24 hrs.,pennystocks,TLSS,86,86,0,86,1,23,36,1,OTC
4852,14-02-2021 08:00,24 hrs.,pennystocks,TSNP,70,0,70,-70,1,10,46,1,OTC
4852,14-02-2021 08:00,24 hrs.,pennystocks,TVPC,6,0,6,-6,1,1,0,1,OTC
4852,14-02-2021 08:00,24 hrs.,pennystocks,UAPC,25,0,25,-25,2,1,15,2,OTC
4852,14-02-2021 08:00,24 hrs.,pennystocks,VSPC,28,28,0,28,1,10,4,1,OTC
4852,14-02-2021 08:00,24 hrs.,pennystocks,WDLF,12,12,0,12,2,2,0,1,OTC
4852,14-02-2021 08:00,24 hrs.,pennystocks,WEBB,159,159,0,159,1,72,11,1,OTC
4852,14-02-2021 08:00,24 hrs.,pennystocks,WSGF,54,54,0,54,1,16,18,1,OTC
4852,14-02-2021 08:00,24 hrs.,pennystocks,XFLS,4,0,4,-4,1,0,0,1,OTC
4852,14-02-2021 08:00,24 hrs.,pennystocks,XMET,7,7,0,7,1,1,1,1,OTC
4852,14-02-2021 08:00,24 hrs.,pennystocks,YAYO,43,43,0,43,1,12,15,1,OTC
4852,14-02-2021 08:00,24 hrs.,pennystocks,ZMRK,6,6,0,6,1,1,0,1,OTC
4852,14-02-2021 08:00,24 hrs.,pennystocks,ABEPF,6,0,6,-6,1,1,0,1,OTC
4852,14-02-2021 08:00,24 hrs.,pennystocks,AMYZF,48,24,24,0,8,8,0,3,OTC
4852,14-02-2021 08:00,24 hrs.,pennystocks,AQSZF,6,0,6,-6,1,1,0,1,OTC
4852,14-02-2021 08:00,24 hrs.,pennystocks,ARBKF,350,174,176,-2,7,99,124,6,OTC
4852,14-02-2021 08:00,24 hrs.,pennystocks,BDRBF,6,0,6,-6,1,1,0,1,OTC
4852,14-02-2021 08:00,24 hrs.,pennystocks,BUROF,12,6,6,0,2,2,0,2,OTC
4852,14-02-2021 08:00,24 hrs.,pennystocks,CINGF,54,54,0,54,1,16,18,1,OTC
4852,14-02-2021 08:00,24 hrs.,pennystocks,CLXPF,245,0,245,-245,1,91,59,1,OTC
4852,14-02-2021 08:00,24 hrs.,pennystocks,COCSF,13,0,13,-13,1,3,3,1,OTC
4852,14-02-2021 08:00,24 hrs.,pennystocks,EMHTF,25,25,0,25,1,7,7,1,OTC
4852,14-02-2021 08:00,24 hrs.,pennystocks,HITIF,988,982,6,976,5,391,186,5,OTC
4852,14-02-2021 08:00,24 hrs.,pennystocks,HTZGQ,6,6,0,6,1,1,0,1,OTC
4852,14-02-2021 08:00,24 hrs.,pennystocks,ICNAF,6,6,0,6,1,1,0,1,OTC
4852,14-02-2021 08:00,24 hrs.,pennystocks,ILHMF,7,0,7,-7,1,1,1,1,OTC
4852,14-02-2021 08:00,24 hrs.,pennystocks,ITMPF,12,6,6,0,2,2,0,2,OTC
4852,14-02-2021 08:00,24 hrs.,pennystocks,LTHUQ,30,0,30,-30,1,7,12,1,OTC
4852,14-02-2021 08:00,24 hrs.,pennystocks,LTMCF,6,6,0,6,1,1,0,1,OTC
4852,14-02-2021 08:00,24 hrs.,pennystocks,MMEDF,112,6,106,-100,3,23,54,3,OTC
4852,14-02-2021 08:00,24 hrs.,pennystocks,MMNFF,35,35,0,35,1,14,3,1,OTC
4852,14-02-2021 08:00,24 hrs.,pennystocks,MPUCF,7,7,0,7,1,1,1,1,OTC
4852,14-02-2021 08:00,24 hrs.,pennystocks,MSNVF,6,0,6,-6,1,1,0,1,OTC
4852,14-02-2021 08:00,24 hrs.,pennystocks,NMGRF,48,48,0,48,2,16,8,1,OTC
4852,14-02-2021 08:00,24 hrs.,pennystocks,NMTLF,24,0,24,-24,1,8,4,1,OTC
4852,14-02-2021 08:00,24 hrs.,pennystocks,NXTTF,12,6,6,0,2,2,0,2,OTC
4852,14-02-2021 08:00,24 hrs.,pennystocks,PHPYF,8,8,0,8,1,0,4,1,OTC
4852,14-02-2021 08:00,24 hrs.,pennystocks,PILBF,6,6,0,6,1,1,0,1,OTC
4852,14-02-2021 08:00,24 hrs.,pennystocks,RLLCF,44,44,0,44,3,6,20,2,OTC
4852,14-02-2021 08:00,24 hrs.,pennystocks,SPRWF,7,7,0,7,1,1,1,1,OTC
4852,14-02-2021 08:00,24 hrs.,pennystocks,TAKOF,99,89,10,79,3,24,39,3,OTC
4852,14-02-2021 08:00,24 hrs.,pennystocks,TLOFF,76,0,76,-76,1,16,40,1,OTC
4852,14-02-2021 08:00,24 hrs.,pennystocks,TOWTF,12,0,12,-12,2,2,0,1,OTC
4852,14-02-2021 08:00,24 hrs.,pennystocks,TRUFF,38,0,38,-38,2,9,12,2,OTC
4852,14-02-2021 08:00,24 hrs.,pennystocks,TSCRF,38,0,38,-38,1,11,12,1,OTC
4852,14-02-2021 08:00,24 hrs.,pennystocks,WALRF,54,54,0,54,1,16,18,1,OTC
4852,14-02-2021 08:00,24 hrs.,pennystocks,BGI,35,35,0,35,1,14,3,1,AMEX
4852,14-02-2021 08:00,24 hrs.,pennystocks,CTO,698,698,0,698,1,279,136,1,AMEX
4852,14-02-2021 08:00,24 hrs.,pennystocks,CVM,6,0,6,-6,1,1,0,1,AMEX
4852,14-02-2021 08:00,24 hrs.,pennystocks,DNN,29,16,13,3,4,3,7,4,AMEX
4852,14-02-2021 08:00,24 hrs.,pennystocks,DSS,6,0,6,-6,1,1,0,1,AMEX
4852,14-02-2021 08:00,24 hrs.,pennystocks,DXF,24,24,0,24,1,0,20,1,AMEX
4852,14-02-2021 08:00,24 hrs.,pennystocks,GSV,6,6,0,6,1,1,0,1,AMEX
4852,14-02-2021 08:00,24 hrs.,pennystocks,GTE,60,0,60,-60,1,15,26,1,AMEX
4852,14-02-2021 08:00,24 hrs.,pennystocks,ITP,24,24,0,24,1,0,20,1,AMEX
4852,14-02-2021 08:00,24 hrs.,pennystocks,NGD,11,0,11,-11,1,2,3,1,AMEX
4852,14-02-2021 08:00,24 hrs.,pennystocks,NTN,35,35,0,35,1,14,3,1,AMEX
4852,14-02-2021 08:00,24 hrs.,pennystocks,RHE,35,35,0,35,1,14,3,1,AMEX
4852,14-02-2021 08:00,24 hrs.,pennystocks,SYN,7,7,0,7,1,1,1,1,AMEX
4852,14-02-2021 08:00,24 hrs.,pennystocks,KYNC,6,6,0,6,1,1,0,1,OTC
4852,14-02-2021 08:00,24 hrs.,pennystocks,LATF,8,0,8,-8,1,1,2,1,OTC
4852,14-02-2021 08:00,24 hrs.,pennystocks,LTNC,42,42,0,42,1,0,38,1,OTC
4852,14-02-2021 08:00,24 hrs.,pennystocks,MAXD,33,0,33,-33,1,7,15,1,OTC
4852,14-02-2021 08:00,24 hrs.,pennystocks,MINE,70,0,70,-70,1,10,46,1,OTC
4852,14-02-2021 08:00,24 hrs.,pennystocks,MJNA,86,0,86,-86,3,21,32,2,OTC
4852,14-02-2021 08:00,24 hrs.,pennystocks,MLFB,19,19,0,19,1,5,5,1,OTC
4852,14-02-2021 08:00,24 hrs.,pennystocks,MSPC,6,0,6,-6,1,1,0,1,OTC
4852,14-02-2021 08:00,24 hrs.,pennystocks,NSPT,25,0,25,-25,1,4,13,1,OTC
4852,14-02-2021 08:00,24 hrs.,pennystocks,NSPX,6,0,6,-6,1,1,0,1,OTC
4852,14-02-2021 08:00,24 hrs.,pennystocks,NTRR,6,6,0,6,1,1,0,1,OTC
4852,14-02-2021 08:00,24 hrs.,pennystocks,OPTI,45,45,0,45,2,10,17,2,OTC
4852,14-02-2021 08:00,24 hrs.,pennystocks,OZSC,179,7,172,-165,2,73,25,2,OTC
4852,14-02-2021 08:00,24 hrs.,pennystocks,PUGE,153,0,153,-153,1,42,65,1,OTC
4852,14-02-2021 08:00,24 hrs.,pennystocks,PVDG,76,0,76,-76,1,16,40,1,OTC
4852,14-02-2021 08:00,24 hrs.,pennystocks,QBAN,9,9,0,9,1,1,3,1,OTC
4852,14-02-2021 08:00,24 hrs.,pennystocks,QMCI,76,0,76,-76,1,16,40,1,OTC
4852,14-02-2021 08:00,24 hrs.,pennystocks,RBNW,6,6,0,6,1,1,0,1,OTC
4852,14-02-2021 08:00,24 hrs.,pennystocks,RCRT,24,0,24,-24,1,5,10,1,OTC
4852,14-02-2021 08:00,24 hrs.,pennystocks,RSSV,154,54,100,-46,2,58,30,2,OTC
4852,14-02-2021 08:00,24 hrs.,pennystocks,SAFS,6,6,0,6,1,1,0,1,OTC
4852,14-02-2021 08:00,24 hrs.,pennystocks,SGMD,458,54,404,-350,6,153,128,6,OTC
4852,14-02-2021 08:00,24 hrs.,pennystocks,SHMP,7,0,7,-7,1,1,1,1,OTC
4852,14-02-2021 08:00,24 hrs.,pennystocks,SING,86,86,0,86,2,23,32,2,OTC
4852,14-02-2021 08:00,24 hrs.,pennystocks,SIRC,60,0,60,-60,2,15,22,2,OTC
4852,14-02-2021 08:00,24 hrs.,pennystocks,SNNC,6,6,0,6,1,1,0,1,OTC
4852,14-02-2021 08:00,24 hrs.,pennystocks,SNPW,82,6,76,-70,2,17,40,2,OTC
4852,14-02-2021 08:00,24 hrs.,pennystocks,SOBR,6,0,6,-6,1,1,0,1,OTC
4852,14-02-2021 08:00,24 hrs.,pennystocks,SSFT,54,54,0,54,1,16,18,1,OTC
4852,14-02-2021 08:00,24 hrs.,pennystocks,TAUG,7,7,0,7,1,1,1,1,OTC
4852,14-02-2021 08:00,24 hrs.,pennystocks,CTLE,31,0,31,-31,5,5,1,2,OTC
4852,14-02-2021 08:00,24 hrs.,pennystocks,DIGI,47,0,47,-47,1,17,9,1,OTC
4852,14-02-2021 08:00,24 hrs.,pennystocks,DPLS,24,0,24,-24,1,5,10,1,OTC
4852,14-02-2021 08:00,24 hrs.,pennystocks,DRNK,6,6,0,6,1,1,0,1,OTC
4852,14-02-2021 08:00,24 hrs.,pennystocks,DXLG,35,35,0,35,1,14,3,1,OTC
4852,14-02-2021 08:00,24 hrs.,pennystocks,ECEZ,7,0,7,-7,1,1,1,1,OTC
4852,14-02-2021 08:00,24 hrs.,pennystocks,ECOX,7,7,0,7,1,1,1,1,OTC
4852,14-02-2021 08:00,24 hrs.,pennystocks,EMED,12,12,0,12,2,2,0,1,OTC
4852,14-02-2021 08:00,24 hrs.,pennystocks,ENZC,76,0,76,-76,1,16,40,1,OTC
4852,14-02-2021 08:00,24 hrs.,pennystocks,EWLL,7,7,0,7,1,1,1,1,OTC
4852,14-02-2021 08:00,24 hrs.,pennystocks,GAXY,24,0,24,-24,1,5,10,1,OTC
4852,14-02-2021 08:00,24 hrs.,pennystocks,GLFH,28,28,0,28,1,5,14,1,OTC
4852,14-02-2021 08:00,24 hrs.,pennystocks,GRSO,7,0,7,-7,1,1,1,1,OTC
4852,14-02-2021 08:00,24 hrs.,pennystocks,GTEH,70,0,70,-70,1,10,46,1,OTC
4852,14-02-2021 08:00,24 hrs.,pennystocks,HALB,31,0,31,-31,1,9,9,1,OTC
4852,14-02-2021 08:00,24 hrs.,pennystocks,HCMC,90,35,55,-20,15,14,2,14,OTC
4852,14-02-2021 08:00,24 hrs.,pennystocks,HPIL,13,13,0,13,2,2,1,1,OTC
4852,14-02-2021 08:00,24 hrs.,pennystocks,HPMM,7,0,7,-7,1,1,1,1,OTC
4852,14-02-2021 08:00,24 hrs.,pennystocks,HQGE,6,6,0,6,1,1,0,1,OTC
4852,14-02-2021 08:00,24 hrs.,pennystocks,ICNM,7,0,7,-7,1,1,1,1,OTC
4852,14-02-2021 08:00,24 hrs.,pennystocks,ICTY,6,0,6,-6,1,1,0,1,OTC
4852,14-02-2021 08:00,24 hrs.,pennystocks,IGEN,23,0,23,-23,2,3,9,2,OTC
4852,14-02-2021 08:00,24 hrs.,pennystocks,ILUS,52,52,0,52,1,21,6,1,OTC
4852,14-02-2021 08:00,24 hrs.,pennystocks,INKW,6,0,6,-6,1,1,0,1,OTC
4852,14-02-2021 08:00,24 hrs.,pennystocks,INND,614,23,591,-568,3,259,84,3,OTC
4852,14-02-2021 08:00,24 hrs.,pennystocks,KGET,6,6,0,6,1,1,0,1,OTC
4852,14-02-2021 08:00,24 hrs.,pennystocks,KULR,54,54,0,54,1,16,18,1,OTC
4852,14-02-2021 08:00,24 hrs.,StockMarket,WIX,79,0,79,-79,1,35,5,1,NASDAQ
4852,14-02-2021 08:00,24 hrs.,StockMarket,WNW,6,0,6,-6,1,1,0,1,NASDAQ
4852,14-02-2021 08:00,24 hrs.,StockMarket,AKER,6,0,6,-6,1,1,0,1,NASDAQ
4852,14-02-2021 08:00,24 hrs.,StockMarket,AMAT,79,0,79,-79,1,35,5,1,NASDAQ
4852,14-02-2021 08:00,24 hrs.,StockMarket,AMGN,12,0,12,-12,1,1,6,1,NASDAQ
4852,14-02-2021 08:00,24 hrs.,StockMarket,AMZN,45,45,0,45,1,10,21,1,NASDAQ
4852,14-02-2021 08:00,24 hrs.,StockMarket,ATNF,12,0,12,-12,1,1,6,1,NASDAQ
4852,14-02-2021 08:00,24 hrs.,StockMarket,BIDU,79,0,79,-79,1,35,5,1,NASDAQ
4852,14-02-2021 08:00,24 hrs.,StockMarket,BIGC,79,0,79,-79,1,35,5,1,NASDAQ
4852,14-02-2021 08:00,24 hrs.,StockMarket,CLIR,6,0,6,-6,1,1,0,1,NASDAQ
4852,14-02-2021 08:00,24 hrs.,StockMarket,CLVS,79,0,79,-79,1,35,5,1,NASDAQ
4852,14-02-2021 08:00,24 hrs.,StockMarket,CPLP,16,16,0,16,1,5,2,1,NASDAQ
4852,14-02-2021 08:00,24 hrs.,StockMarket,CTRM,6,0,6,-6,1,1,0,1,NASDAQ
4852,14-02-2021 08:00,24 hrs.,StockMarket,EXPD,79,0,79,-79,1,35,5,1,NASDAQ
4852,14-02-2021 08:00,24 hrs.,StockMarket,FIZZ,79,0,79,-79,1,35,5,1,NASDAQ
4852,14-02-2021 08:00,24 hrs.,StockMarket,GOGO,79,0,79,-79,1,35,5,1,NASDAQ
4852,14-02-2021 08:00,24 hrs.,StockMarket,GOLD,79,0,79,-79,1,35,5,1,NASDAQ
4852,14-02-2021 08:00,24 hrs.,StockMarket,GTHX,6,0,6,-6,1,1,0,1,NASDAQ
4852,14-02-2021 08:00,24 hrs.,StockMarket,HTBX,13,7,6,1,2,2,1,2,NASDAQ
4852,14-02-2021 08:00,24 hrs.,StockMarket,ITRM,13,13,0,13,1,1,7,1,NASDAQ
4852,14-02-2021 08:00,24 hrs.,StockMarket,KLIC,20,0,20,-20,1,5,6,1,NASDAQ
4852,14-02-2021 08:00,24 hrs.,StockMarket,LGND,79,0,79,-79,1,35,5,1,NASDAQ
4852,14-02-2021 08:00,24 hrs.,StockMarket,NBIX,12,0,12,-12,1,1,6,1,NASDAQ
4852,14-02-2021 08:00,24 hrs.,StockMarket,NCNO,79,0,79,-79,1,35,5,1,NASDAQ
4852,14-02-2021 08:00,24 hrs.,StockMarket,NOVN,6,0,6,-6,1,1,0,1,NASDAQ
4852,14-02-2021 08:00,24 hrs.,StockMarket,ROKU,79,0,79,-79,1,35,5,1,NASDAQ
4852,14-02-2021 08:00,24 hrs.,StockMarket,SEDG,79,0,79,-79,1,35,5,1,NASDAQ
4852,14-02-2021 08:00,24 hrs.,StockMarket,SNBR,79,0,79,-79,1,35,5,1,NASDAQ
4852,14-02-2021 08:00,24 hrs.,StockMarket,SNDL,12,6,6,0,2,1,2,2,NASDAQ
4852,14-02-2021 08:00,24 hrs.,StockMarket,SPWR,79,0,79,-79,1,35,5,1,NASDAQ
4852,14-02-2021 08:00,24 hrs.,StockMarket,STMP,79,0,79,-79,1,35,5,1,NASDAQ
4852,14-02-2021 08:00,24 hrs.,StockMarket,TEAM,12,0,12,-12,1,1,6,1,NASDAQ
4852,14-02-2021 08:00,24 hrs.,StockMarket,THCB,65,65,0,65,1,23,15,1,NASDAQ
4852,14-02-2021 08:00,24 hrs.,StockMarket,TLRY,91,6,85,-79,3,36,7,3,NASDAQ
4852,14-02-2021 08:00,24 hrs.,StockMarket,TRCH,13,13,0,13,1,1,7,1,NASDAQ
4852,14-02-2021 08:00,24 hrs.,StockMarket,TREE,79,0,79,-79,1,35,5,1,NASDAQ
4852,14-02-2021 08:00,24 hrs.,StockMarket,TSEM,79,0,79,-79,1,35,5,1,NASDAQ
4852,14-02-2021 08:00,24 hrs.,StockMarket,VXRT,24,0,24,-24,1,1,18,1,NASDAQ
4852,14-02-2021 08:00,24 hrs.,StockMarket,WING,79,0,79,-79,1,35,5,1,NASDAQ
4852,14-02-2021 08:00,24 hrs.,StockMarket,XONE,14,0,14,-14,3,0,2,1,NASDAQ
4852,14-02-2021 08:00,24 hrs.,StockMarket,YNDX,79,0,79,-79,1,35,5,1,NASDAQ
4852,14-02-2021 08:00,24 hrs.,pennystocks,ABML,24,0,24,-24,4,4,0,1,OTC
4852,14-02-2021 08:00,24 hrs.,pennystocks,ACRL,58,58,0,58,3,16,14,3,OTC
4852,14-02-2021 08:00,24 hrs.,pennystocks,AITX,121,85,36,49,3,48,13,3,OTC
4852,14-02-2021 08:00,24 hrs.,pennystocks,ALYI,89,13,76,-63,3,18,41,2,OTC
4852,14-02-2021 08:00,24 hrs.,pennystocks,AMAZ,6,0,6,-6,1,1,0,1,OTC
4852,14-02-2021 08:00,24 hrs.,pennystocks,AMNE,13,13,0,13,2,2,1,1,OTC
4852,14-02-2021 08:00,24 hrs.,pennystocks,ASTI,188,188,0,188,2,67,46,2,OTC
4852,14-02-2021 08:00,24 hrs.,pennystocks,ATVK,61,54,7,47,2,17,19,2,OTC
4852,14-02-2021 08:00,24 hrs.,pennystocks,BANT,6,6,0,6,1,1,0,1,OTC
4852,14-02-2021 08:00,24 hrs.,pennystocks,BIEL,6,6,0,6,1,1,0,1,OTC
4852,14-02-2021 08:00,24 hrs.,pennystocks,BNGI,6,6,0,6,1,1,0,1,OTC
4852,14-02-2021 08:00,24 hrs.,pennystocks,BOTY,42,0,42,-42,2,13,8,2,OTC
4852,14-02-2021 08:00,24 hrs.,pennystocks,BRGO,6,0,6,-6,1,1,0,1,OTC
4852,14-02-2021 08:00,24 hrs.,pennystocks,BRRN,10,0,10,-10,1,2,2,1,OTC
4852,14-02-2021 08:00,24 hrs.,pennystocks,BRSE,6,6,0,6,1,1,0,1,OTC
4852,14-02-2021 08:00,24 hrs.,pennystocks,CANN,12,6,6,0,2,2,0,2,OTC
4852,14-02-2021 08:00,24 hrs.,pennystocks,CBBT,112,0,112,-112,2,28,48,2,OTC
4852,14-02-2021 08:00,24 hrs.,pennystocks,CBDL,36,0,36,-36,1,12,8,1,OTC
4852,14-02-2021 08:00,24 hrs.,pennystocks,CCTL,116,6,110,-104,2,29,50,2,OTC
4852,14-02-2021 08:00,24 hrs.,pennystocks,CLIS,18,0,18,-18,2,3,4,1,OTC
4852,14-02-2021 08:00,24 hrs.,StockMarket,EMHTF,12,12,0,12,1,3,2,1,OTC
4852,14-02-2021 08:00,24 hrs.,StockMarket,NXTTF,12,0,12,-12,2,2,0,1,OTC
4852,14-02-2021 08:00,24 hrs.,StockMarket,PYNKF,9,9,0,9,1,2,1,1,OTC
4852,14-02-2021 08:00,24 hrs.,StockMarket,XJNGF,18,0,18,-18,1,1,12,1,OTC
4852,14-02-2021 08:00,24 hrs.,StockMarket,DNN,43,43,0,43,1,15,9,1,AMEX
4852,14-02-2021 08:00,24 hrs.,StockMarket,MXC,9,0,9,-9,1,0,5,1,AMEX
4852,14-02-2021 08:00,24 hrs.,StockMarket,ZOM,6,0,6,-6,1,1,0,1,AMEX
4852,14-02-2021 08:00,24 hrs.,StockMarket,SENS,14,14,0,14,1,4,2,1,AMEX
4852,14-02-2021 08:00,24 hrs.,StockMarket,TRXC,6,6,0,6,1,1,0,1,AMEX
4852,14-02-2021 08:00,24 hrs.,StockMarket,AAP,79,0,79,-79,1,35,5,1,NYSE
4852,14-02-2021 08:00,24 hrs.,StockMarket,AMC,75,59,16,43,5,21,13,5,NYSE
4852,14-02-2021 08:00,24 hrs.,StockMarket,ASX,9,0,9,-9,1,0,5,1,NYSE
4852,14-02-2021 08:00,24 hrs.,StockMarket,BKI,79,0,79,-79,1,35,5,1,NYSE
4852,14-02-2021 08:00,24 hrs.,StockMarket,CBD,12,0,12,-12,1,1,6,1,NYSE
4852,14-02-2021 08:00,24 hrs.,StockMarket,CMA,6,0,6,-6,1,1,0,1,NYSE
4852,14-02-2021 08:00,24 hrs.,StockMarket,CMO,233,0,233,-233,1,112,5,1,NYSE
4852,14-02-2021 08:00,24 hrs.,StockMarket,CVS,79,0,79,-79,1,35,5,1,NYSE
4852,14-02-2021 08:00,24 hrs.,StockMarket,DDD,79,0,79,-79,1,35,5,1,NYSE
4852,14-02-2021 08:00,24 hrs.,StockMarket,DDS,79,0,79,-79,1,35,5,1,NYSE
4852,14-02-2021 08:00,24 hrs.,StockMarket,ECL,79,0,79,-79,1,35,5,1,NYSE
4852,14-02-2021 08:00,24 hrs.,StockMarket,FIX,4,0,4,-4,1,0,0,1,NYSE
4852,14-02-2021 08:00,24 hrs.,StockMarket,GME,90,11,79,-68,3,35,8,3,NYSE
4852,14-02-2021 08:00,24 hrs.,StockMarket,HLT,79,0,79,-79,1,35,5,1,NYSE
4852,14-02-2021 08:00,24 hrs.,StockMarket,IGT,79,0,79,-79,1,35,5,1,NYSE
4852,14-02-2021 08:00,24 hrs.,StockMarket,JNJ,12,0,12,-12,1,1,6,1,NYSE
4852,14-02-2021 08:00,24 hrs.,StockMarket,LPL,79,0,79,-79,1,35,5,1,NYSE
4852,14-02-2021 08:00,24 hrs.,StockMarket,LPX,79,0,79,-79,1,35,5,1,NYSE
4852,14-02-2021 08:00,24 hrs.,StockMarket,MRO,79,0,79,-79,1,35,5,1,NYSE
4852,14-02-2021 08:00,24 hrs.,StockMarket,MTD,79,0,79,-79,1,35,5,1,NYSE
4852,14-02-2021 08:00,24 hrs.,StockMarket,NET,4,0,4,-4,1,0,0,1,NYSE
4852,14-02-2021 08:00,24 hrs.,StockMarket,NVS,12,0,12,-12,1,1,6,1,NYSE
4852,14-02-2021 08:00,24 hrs.,StockMarket,OXY,79,0,79,-79,1,35,5,1,NYSE
4852,14-02-2021 08:00,24 hrs.,StockMarket,PMO,12,0,12,-12,2,2,0,1,NYSE
4852,14-02-2021 08:00,24 hrs.,StockMarket,RNG,79,0,79,-79,1,35,5,1,NYSE
4852,14-02-2021 08:00,24 hrs.,StockMarket,SKT,79,0,79,-79,1,35,5,1,NYSE
4852,14-02-2021 08:00,24 hrs.,StockMarket,THC,12,0,12,-12,1,1,6,1,NYSE
4852,14-02-2021 08:00,24 hrs.,StockMarket,TRU,79,0,79,-79,1,35,5,1,NYSE
4852,14-02-2021 08:00,24 hrs.,StockMarket,VMC,79,0,79,-79,1,35,5,1,NYSE
4852,14-02-2021 08:00,24 hrs.,StockMarket,WMT,79,0,79,-79,1,35,5,1,NYSE
4852,14-02-2021 08:00,24 hrs.,StockMarket,ZTS,79,0,79,-79,1,35,5,1,NYSE
4852,14-02-2021 08:00,24 hrs.,StockMarket,ABBV,12,0,12,-12,1,1,6,1,NYSE
4852,14-02-2021 08:00,24 hrs.,StockMarket,CCIV,6,0,6,-6,1,1,0,1,NYSE
4852,14-02-2021 08:00,24 hrs.,StockMarket,FSLY,79,0,79,-79,1,35,5,1,NYSE
4852,14-02-2021 08:00,24 hrs.,StockMarket,FVRR,79,0,79,-79,1,35,5,1,NYSE
4852,14-02-2021 08:00,24 hrs.,StockMarket,LGVW,14,0,14,-14,3,0,2,1,NYSE
4852,14-02-2021 08:00,24 hrs.,StockMarket,PLTR,79,0,79,-79,1,35,5,1,NYSE
4852,14-02-2021 08:00,24 hrs.,StockMarket,PSTH,6,0,6,-6,1,1,0,1,NYSE
4852,14-02-2021 08:00,24 hrs.,StockMarket,PUMP,6,0,6,-6,1,1,0,1,NYSE
4852,14-02-2021 08:00,24 hrs.,StockMarket,SHOP,79,0,79,-79,1,35,5,1,NYSE
4852,14-02-2021 08:00,24 hrs.,StockMarket,TRTN,79,0,79,-79,1,35,5,1,NYSE
4852,14-02-2021 08:00,24 hrs.,StockMarket,TWLO,79,0,79,-79,1,35,5,1,NYSE
4852,14-02-2021 08:00,24 hrs.,StockMarket,USFD,79,0,79,-79,1,35,5,1,NYSE
4852,14-02-2021 08:00,24 hrs.,StockMarket,ADI,79,0,79,-79,1,35,5,1,NASDAQ
4852,14-02-2021 08:00,24 hrs.,StockMarket,BLI,79,0,79,-79,1,35,5,1,NASDAQ
4852,14-02-2021 08:00,24 hrs.,StockMarket,DBX,79,0,79,-79,1,35,5,1,NASDAQ
4852,14-02-2021 08:00,24 hrs.,StockMarket,FOX,13,13,0,13,1,1,7,1,NASDAQ
4852,14-02-2021 08:00,24 hrs.,StockMarket,QQQ,9,0,9,-9,1,0,5,1,NASDAQ
4852,14-02-2021 08:00,24 hrs.,StockMarket,TTD,79,0,79,-79,1,35,5,1,NASDAQ
4852,14-02-2021 08:00,24 hrs.,StockMarket,UFO,17,17,0,17,1,3,7,1,NASDAQ
4852,14-02-2021 08:00,24 hrs.,trakstocks,PEG,383,383,0,383,1,176,27,1,NYSE
4852,14-02-2021 08:00,24 hrs.,trakstocks,RSI,383,383,0,383,1,176,27,1,NYSE
4852,14-02-2021 08:00,24 hrs.,trakstocks,STPK,56,56,0,56,1,22,8,1,NYSE
4852,14-02-2021 08:00,24 hrs.,trakstocks,FUV,51,51,0,51,1,19,9,1,NASDAQ
4852,14-02-2021 08:00,24 hrs.,trakstocks,PLL,13,13,0,13,1,3,3,1,NASDAQ
4852,14-02-2021 08:00,24 hrs.,trakstocks,AAPL,383,383,0,383,1,176,27,1,NASDAQ
4852,14-02-2021 08:00,24 hrs.,trakstocks,AYRO,76,51,25,26,3,24,16,3,NASDAQ
4852,14-02-2021 08:00,24 hrs.,trakstocks,CLVS,25,0,25,-25,1,10,1,1,NASDAQ
4852,14-02-2021 08:00,24 hrs.,trakstocks,ENLV,8,0,8,-8,1,2,0,1,NASDAQ
4852,14-02-2021 08:00,24 hrs.,trakstocks,LIFE,92,92,0,92,1,32,24,1,NASDAQ
4852,14-02-2021 08:00,24 hrs.,trakstocks,MNOV,6,6,0,6,1,1,0,1,NASDAQ
4852,14-02-2021 08:00,24 hrs.,trakstocks,MVIS,17,17,0,17,1,4,5,1,NASDAQ
4852,14-02-2021 08:00,24 hrs.,trakstocks,OTLK,6,6,0,6,1,0,2,1,NASDAQ
4852,14-02-2021 08:00,24 hrs.,trakstocks,PLAY,6,6,0,6,1,1,0,1,NASDAQ
4852,14-02-2021 08:00,24 hrs.,trakstocks,QLGN,20,20,0,20,2,5,2,1,NASDAQ
4852,14-02-2021 08:00,24 hrs.,trakstocks,TRCH,86,86,0,86,1,35,12,1,NASDAQ
4852,14-02-2021 08:00,24 hrs.,trakstocks,TSLA,13,13,0,13,1,3,3,1,NASDAQ
4852,14-02-2021 08:00,24 hrs.,trakstocks,VUZI,20,20,0,20,1,7,2,1,NASDAQ
4852,14-02-2021 08:00,24 hrs.,trakstocks,ZSAN,16,0,16,-16,1,3,6,1,NASDAQ
4852,14-02-2021 08:00,24 hrs.,StockMarket,BOTH,9,0,9,-9,1,0,5,1,OTC
4852,14-02-2021 08:00,24 hrs.,StockMarket,BOTY,8,0,8,-8,1,1,2,1,OTC
4852,14-02-2021 08:00,24 hrs.,StockMarket,COMS,13,13,0,13,1,1,7,1,OTC
4852,14-02-2021 08:00,24 hrs.,StockMarket,GBTC,14,0,14,-14,3,0,2,1,OTC
4852,14-02-2021 08:00,24 hrs.,StockMarket,HRBR,6,6,0,6,1,1,0,1,OTC
4852,14-02-2021 08:00,24 hrs.,StockMarket,LINK,79,0,79,-79,1,35,5,1,OTC
4852,14-02-2021 08:00,24 hrs.,StockMarket,LRDR,6,0,6,-6,1,1,0,1,OTC
4852,14-02-2021 08:00,24 hrs.,StockMarket,MOST,79,0,79,-79,1,35,5,1,OTC
4852,14-02-2021 08:00,24 hrs.,StockMarket,SGMD,11,11,0,11,1,2,3,1,OTC
4852,14-02-2021 08:00,24 hrs.,StockMarket,AMKBY,19,0,19,-19,1,5,5,1,OTC
4852,14-02-2021 08:00,24 hrs.,StockMarket,CADMF,6,0,6,-6,1,1,0,1,OTC
4852,14-02-2021 08:00,24 hrs.,stocks,SIRI,50,50,0,50,1,8,30,1,NASDAQ
4852,14-02-2021 08:00,24 hrs.,stocks,SNDL,14,8,6,2,2,2,2,2,NASDAQ
4852,14-02-2021 08:00,24 hrs.,stocks,TFFP,30,0,30,-30,2,7,8,1,NASDAQ
4852,14-02-2021 08:00,24 hrs.,stocks,TLRY,669,6,663,-657,4,301,51,4,NASDAQ
4852,14-02-2021 08:00,24 hrs.,stocks,TRCH,14,7,7,0,2,2,2,2,NASDAQ
4852,14-02-2021 08:00,24 hrs.,stocks,TREE,651,0,651,-651,1,298,51,1,NASDAQ
4852,14-02-2021 08:00,24 hrs.,stocks,VGLT,6,0,6,-6,1,1,0,1,NASDAQ
4852,14-02-2021 08:00,24 hrs.,stocks,VXUS,11,0,11,-11,1,1,5,1,NASDAQ
4852,14-02-2021 08:00,24 hrs.,stocks,WIMI,6,0,6,-6,1,1,0,1,NASDAQ
4852,14-02-2021 08:00,24 hrs.,stocks,ZNGA,41,0,41,-41,1,13,11,1,NASDAQ
4852,14-02-2021 08:00,24 hrs.,stocks,LBTYB,7,7,0,7,1,1,1,1,NASDAQ
4852,14-02-2021 08:00,24 hrs.,Daytrading,MSN,17,17,0,17,1,2,9,1,AMEX
4852,14-02-2021 08:00,24 hrs.,Daytrading,AMC,5,5,0,5,1,0,1,1,NYSE
4852,14-02-2021 08:00,24 hrs.,Daytrading,GME,73,73,0,73,2,19,27,2,NYSE
4852,14-02-2021 08:00,24 hrs.,Daytrading,IRS,13,13,0,13,1,1,7,1,NYSE
4852,14-02-2021 08:00,24 hrs.,Daytrading,NIO,12,0,12,-12,1,2,4,1,NYSE
4852,14-02-2021 08:00,24 hrs.,Daytrading,PDT,27,27,0,27,3,3,9,2,NYSE
4852,14-02-2021 08:00,24 hrs.,Daytrading,TWO,6,0,6,-6,1,1,0,1,NYSE
4852,14-02-2021 08:00,24 hrs.,Daytrading,USB,10,10,0,10,1,3,0,1,NYSE
4852,14-02-2021 08:00,24 hrs.,Daytrading,DUO,6,0,6,-6,1,1,0,1,NASDAQ
4852,14-02-2021 08:00,24 hrs.,Daytrading,AAPL,12,0,12,-12,1,2,4,1,NASDAQ
4852,14-02-2021 08:00,24 hrs.,Daytrading,SNDL,45,0,45,-45,1,8,25,1,NASDAQ
4852,14-02-2021 08:00,24 hrs.,Daytrading,TRMD,6,0,6,-6,1,1,0,1,NASDAQ
4852,14-02-2021 08:00,24 hrs.,trakstocks,DMNXF,95,0,95,-95,2,27,33,2,OTC
4852,14-02-2021 08:00,24 hrs.,trakstocks,LITOF,13,13,0,13,1,3,3,1,OTC
4852,14-02-2021 08:00,24 hrs.,trakstocks,LXXGF,22,22,0,22,3,5,0,2,OTC
4852,14-02-2021 08:00,24 hrs.,trakstocks,BIOX,6,6,0,6,1,1,0,1,AMEX
4852,14-02-2021 08:00,24 hrs.,trakstocks,CBO,19,0,19,-19,1,4,7,1,NYSE
4852,14-02-2021 08:00,24 hrs.,trakstocks,LAC,13,13,0,13,1,3,3,1,NYSE
4852,14-02-2021 08:00,24 hrs.,trakstocks,NAT,15,0,15,-15,1,4,3,1,NYSE
4852,14-02-2021 08:00,24 hrs.,stocks,PLTR,800,6,794,-788,5,340,100,4,NYSE
4852,14-02-2021 08:00,24 hrs.,stocks,SHOP,667,16,651,-635,2,301,57,2,NYSE
4852,14-02-2021 08:00,24 hrs.,stocks,SNAP,39,0,39,-39,1,8,19,1,NYSE
4852,14-02-2021 08:00,24 hrs.,stocks,SPCE,165,0,165,-165,1,43,75,1,NYSE
4852,14-02-2021 08:00,24 hrs.,stocks,TWLO,651,0,651,-651,1,298,51,1,NYSE
4852,14-02-2021 08:00,24 hrs.,stocks,VGAC,14,14,0,14,1,2,6,1,NYSE
4852,14-02-2021 08:00,24 hrs.,stocks,AAL,58,58,0,58,1,9,36,1,NASDAQ
4852,14-02-2021 08:00,24 hrs.,stocks,AMD,7,0,7,-7,1,1,1,1,NASDAQ
4852,14-02-2021 08:00,24 hrs.,stocks,BLI,651,0,651,-651,1,298,51,1,NASDAQ
4852,14-02-2021 08:00,24 hrs.,stocks,CFO,6,0,6,-6,1,1,0,1,NASDAQ
4852,14-02-2021 08:00,24 hrs.,stocks,FUV,35,35,0,35,2,7,13,2,NASDAQ
4852,14-02-2021 08:00,24 hrs.,stocks,III,10,10,0,10,1,1,4,1,NASDAQ
4852,14-02-2021 08:00,24 hrs.,stocks,NIU,165,0,165,-165,1,43,75,1,NASDAQ
4852,14-02-2021 08:00,24 hrs.,stocks,PAA,50,50,0,50,1,8,30,1,NASDAQ
4852,14-02-2021 08:00,24 hrs.,stocks,PEP,31,31,0,31,1,9,9,1,NASDAQ
4852,14-02-2021 08:00,24 hrs.,stocks,QQC,13,13,0,13,1,1,7,1,NASDAQ
4852,14-02-2021 08:00,24 hrs.,stocks,QQQ,34,34,0,34,2,7,12,2,NASDAQ
4852,14-02-2021 08:00,24 hrs.,stocks,QTT,6,0,6,-6,1,1,0,1,NASDAQ
4852,14-02-2021 08:00,24 hrs.,stocks,REG,6,0,6,-6,1,1,0,1,NASDAQ
4852,14-02-2021 08:00,24 hrs.,stocks,VFF,6,0,6,-6,1,1,0,1,NASDAQ
4852,14-02-2021 08:00,24 hrs.,stocks,AAPL,119,41,78,-37,5,17,65,5,NASDAQ
4852,14-02-2021 08:00,24 hrs.,stocks,AGTC,6,6,0,6,1,1,0,1,NASDAQ
4852,14-02-2021 08:00,24 hrs.,stocks,AMZN,6,0,6,-6,1,1,0,1,NASDAQ
4852,14-02-2021 08:00,24 hrs.,stocks,ANTE,12,0,12,-12,2,2,0,1,NASDAQ
4852,14-02-2021 08:00,24 hrs.,stocks,APHA,183,6,177,-171,4,46,75,4,NASDAQ
4852,14-02-2021 08:00,24 hrs.,stocks,APRE,6,6,0,6,1,1,0,1,NASDAQ
4852,14-02-2021 08:00,24 hrs.,stocks,ATOS,6,6,0,6,1,1,0,1,NASDAQ
4852,14-02-2021 08:00,24 hrs.,stocks,AZRX,6,0,6,-6,1,1,0,1,NASDAQ
4852,14-02-2021 08:00,24 hrs.,stocks,BIGC,651,0,651,-651,1,298,51,1,NASDAQ
4852,14-02-2021 08:00,24 hrs.,stocks,BNGO,24,6,18,-12,4,4,0,4,NASDAQ
4852,14-02-2021 08:00,24 hrs.,stocks,CCRC,6,0,6,-6,1,1,0,1,NASDAQ
4852,14-02-2021 08:00,24 hrs.,stocks,CRNT,6,0,6,-6,1,1,0,1,NASDAQ
4852,14-02-2021 08:00,24 hrs.,stocks,CRSR,239,0,239,-239,1,77,81,1,NASDAQ
4852,14-02-2021 08:00,24 hrs.,stocks,DRIV,40,0,40,-40,1,14,8,1,NASDAQ
4852,14-02-2021 08:00,24 hrs.,stocks,EXEL,6,6,0,6,1,0,2,1,NASDAQ
4852,14-02-2021 08:00,24 hrs.,stocks,EXPI,34,0,34,-34,2,9,8,2,NASDAQ
4852,14-02-2021 08:00,24 hrs.,stocks,FIZZ,651,0,651,-651,1,298,51,1,NASDAQ
4852,14-02-2021 08:00,24 hrs.,stocks,FOLD,63,63,0,63,1,21,17,1,NASDAQ
4852,14-02-2021 08:00,24 hrs.,stocks,FROG,12,6,6,0,2,2,0,2,NASDAQ
4852,14-02-2021 08:00,24 hrs.,stocks,FTHM,215,215,0,215,1,93,25,1,NASDAQ
4852,14-02-2021 08:00,24 hrs.,stocks,GLUU,6,0,6,-6,1,1,0,1,NASDAQ
4852,14-02-2021 08:00,24 hrs.,stocks,GNOG,6,0,6,-6,1,1,0,1,NASDAQ
4852,14-02-2021 08:00,24 hrs.,stocks,GOGO,657,0,657,-657,2,299,51,2,NASDAQ
4852,14-02-2021 08:00,24 hrs.,stocks,GOOG,77,16,61,-45,2,13,43,2,NASDAQ
4852,14-02-2021 08:00,24 hrs.,stocks,GTHX,18,18,0,18,3,3,0,2,NASDAQ
4852,14-02-2021 08:00,24 hrs.,stocks,HOLI,12,12,0,12,2,2,0,1,NASDAQ
4852,14-02-2021 08:00,24 hrs.,stocks,IFMK,18,18,0,18,3,3,0,1,NASDAQ
4852,14-02-2021 08:00,24 hrs.,stocks,KLIC,38,0,38,-38,1,15,4,1,NASDAQ
4852,14-02-2021 08:00,24 hrs.,stocks,KOPN,22,0,22,-22,1,7,4,1,NASDAQ
4852,14-02-2021 08:00,24 hrs.,stocks,LAZR,6,6,0,6,1,1,0,1,NASDAQ
4852,14-02-2021 08:00,24 hrs.,stocks,MSFT,113,41,72,-31,4,16,65,4,NASDAQ
4852,14-02-2021 08:00,24 hrs.,stocks,MVIS,6,6,0,6,1,1,0,1,NASDAQ
4852,14-02-2021 08:00,24 hrs.,stocks,NCNO,651,0,651,-651,1,298,51,1,NASDAQ
4852,14-02-2021 08:00,24 hrs.,stocks,NVCN,6,6,0,6,1,1,0,1,NASDAQ
4852,14-02-2021 08:00,24 hrs.,stocks,NXTD,6,0,6,-6,1,1,0,1,NASDAQ
4852,14-02-2021 08:00,24 hrs.,stocks,PBCT,52,0,52,-52,1,16,16,1,NASDAQ
4852,14-02-2021 08:00,24 hrs.,stocks,QQQJ,1447,0,1447,-1447,1,557,329,1,NASDAQ
4852,14-02-2021 08:00,24 hrs.,stocks,QQQM,1447,0,1447,-1447,1,557,329,1,NASDAQ
4852,14-02-2021 08:00,24 hrs.,stocks,RDFN,30,0,30,-30,1,9,8,1,NASDAQ
4852,14-02-2021 08:00,24 hrs.,stocks,REGI,13,13,0,13,1,2,5,1,NASDAQ
4852,14-02-2021 08:00,24 hrs.,stocks,RIOT,12,0,12,-12,2,2,0,1,NASDAQ
4852,14-02-2021 08:00,24 hrs.,stocks,ROKU,651,0,651,-651,1,298,51,1,NASDAQ
4852,14-02-2021 08:00,24 hrs.,stocks,DCF,15,15,0,15,1,3,5,1,NYSE
4852,14-02-2021 08:00,24 hrs.,stocks,DDD,651,0,651,-651,1,298,51,1,NYSE
4852,14-02-2021 08:00,24 hrs.,stocks,DDS,651,0,651,-651,1,298,51,1,NYSE
4852,14-02-2021 08:00,24 hrs.,stocks,DIS,43,25,18,7,3,4,23,3,NYSE
4852,14-02-2021 08:00,24 hrs.,stocks,EFT,17,0,17,-17,1,5,3,1,NYSE
4852,14-02-2021 08:00,24 hrs.,stocks,ELY,50,50,0,50,1,8,30,1,NYSE
4852,14-02-2021 08:00,24 hrs.,stocks,ENB,21,21,0,21,1,6,5,1,NYSE
4852,14-02-2021 08:00,24 hrs.,stocks,EPR,13,13,0,13,1,1,7,1,NYSE
4852,14-02-2021 08:00,24 hrs.,stocks,ETH,6,0,6,-6,1,1,0,1,NYSE
4852,14-02-2021 08:00,24 hrs.,stocks,FTI,16,0,16,-16,2,4,0,2,NYSE
4852,14-02-2021 08:00,24 hrs.,stocks,GME,689,20,669,-649,6,305,55,6,NYSE
4852,14-02-2021 08:00,24 hrs.,stocks,HPQ,295,0,295,-295,1,116,59,1,NYSE
4852,14-02-2021 08:00,24 hrs.,stocks,IBM,1934,0,1934,-1934,2,869,188,2,NYSE
4852,14-02-2021 08:00,24 hrs.,stocks,IGT,651,0,651,-651,1,298,51,1,NYSE
4852,14-02-2021 08:00,24 hrs.,stocks,JNJ,52,0,52,-52,1,16,16,1,NYSE
4852,14-02-2021 08:00,24 hrs.,stocks,JPM,52,0,52,-52,1,16,16,1,NYSE
4852,14-02-2021 08:00,24 hrs.,stocks,KOF,45,45,0,45,1,20,1,1,NYSE
4852,14-02-2021 08:00,24 hrs.,stocks,LAC,6,0,6,-6,1,1,0,1,NYSE
4852,14-02-2021 08:00,24 hrs.,stocks,LEG,52,0,52,-52,1,16,16,1,NYSE
4852,14-02-2021 08:00,24 hrs.,stocks,LPL,651,0,651,-651,1,298,51,1,NYSE
4852,14-02-2021 08:00,24 hrs.,stocks,LTC,50,50,0,50,1,8,30,1,NYSE
4852,14-02-2021 08:00,24 hrs.,stocks,MAC,93,0,93,-93,1,37,15,1,NYSE
4852,14-02-2021 08:00,24 hrs.,stocks,MFA,6,0,6,-6,1,1,0,1,NYSE
4852,14-02-2021 08:00,24 hrs.,stocks,MMM,52,0,52,-52,1,16,16,1,NYSE
4852,14-02-2021 08:00,24 hrs.,stocks,MPW,50,50,0,50,1,8,30,1,NYSE
4852,14-02-2021 08:00,24 hrs.,stocks,MTD,651,0,651,-651,1,298,51,1,NYSE
4852,14-02-2021 08:00,24 hrs.,stocks,NET,5456,0,5456,-5456,1,2458,536,1,NYSE
4852,14-02-2021 08:00,24 hrs.,stocks,NGL,6,0,6,-6,1,1,0,1,NYSE
4852,14-02-2021 08:00,24 hrs.,stocks,NIO,131,0,131,-131,1,39,49,1,NYSE
4852,14-02-2021 08:00,24 hrs.,stocks,NSA,1882,0,1882,-1882,1,853,172,1,NYSE
4852,14-02-2021 08:00,24 hrs.,stocks,PBA,50,50,0,50,1,8,30,1,NYSE
4852,14-02-2021 08:00,24 hrs.,stocks,RBC,7,0,7,-7,1,1,1,1,NYSE
4852,14-02-2021 08:00,24 hrs.,stocks,SBE,45,0,45,-45,2,11,15,2,NYSE
4852,14-02-2021 08:00,24 hrs.,stocks,SHO,6,0,6,-6,1,1,0,1,NYSE
4852,14-02-2021 08:00,24 hrs.,stocks,SKT,651,0,651,-651,1,298,51,1,NYSE
4852,14-02-2021 08:00,24 hrs.,stocks,SOI,7,7,0,7,1,1,1,1,NYSE
4852,14-02-2021 08:00,24 hrs.,stocks,SOS,40,0,40,-40,1,9,18,1,NYSE
4852,14-02-2021 08:00,24 hrs.,stocks,TDA,12,0,12,-12,1,1,6,1,NYSE
4852,14-02-2021 08:00,24 hrs.,stocks,THC,84,0,84,-84,1,22,36,1,NYSE
4852,14-02-2021 08:00,24 hrs.,stocks,TSM,36,36,0,36,1,1,30,1,NYSE
4852,14-02-2021 08:00,24 hrs.,stocks,WMT,651,0,651,-651,1,298,51,1,NYSE
4852,14-02-2021 08:00,24 hrs.,stocks,XOM,52,0,52,-52,1,16,16,1,NYSE
4852,14-02-2021 08:00,24 hrs.,stocks,BABA,16,16,0,16,1,3,6,1,NYSE
4852,14-02-2021 08:00,24 hrs.,stocks,BRMK,50,50,0,50,1,8,30,1,NYSE
4852,14-02-2021 08:00,24 hrs.,stocks,CCIV,6,0,6,-6,1,1,0,1,NYSE
4852,14-02-2021 08:00,24 hrs.,stocks,CHWY,295,0,295,-295,1,116,59,1,NYSE
4852,14-02-2021 08:00,24 hrs.,stocks,COTY,7,7,0,7,1,1,1,1,NYSE
4852,14-02-2021 08:00,24 hrs.,stocks,DSSI,19,0,19,-19,1,4,7,1,NYSE
4852,14-02-2021 08:00,24 hrs.,stocks,FSLY,651,0,651,-651,1,298,51,1,NYSE
4852,14-02-2021 08:00,24 hrs.,stocks,FVRR,651,0,651,-651,1,298,51,1,NYSE
4852,14-02-2021 08:00,24 hrs.,stocks,NYCB,80,0,80,-80,1,20,36,1,NYSE
4852,14-02-2021 08:00,24 hrs.,SPACs,PTON,29,29,0,29,1,2,21,1,NASDAQ
4852,14-02-2021 08:00,24 hrs.,SPACs,ROCH,31,31,0,31,1,10,7,1,NASDAQ
4852,14-02-2021 08:00,24 hrs.,SPACs,SSPK,30,30,0,30,1,7,12,1,NASDAQ
4852,14-02-2021 08:00,24 hrs.,SPACs,THCB,372,372,0,372,2,152,60,2,NASDAQ
4852,14-02-2021 08:00,24 hrs.,SPACs,TSLA,9,9,0,9,1,0,5,1,NASDAQ
4852,14-02-2021 08:00,24 hrs.,SPACs,AACQW,40,0,40,-40,1,12,12,1,NASDAQ
4852,14-02-2021 08:00,24 hrs.,stocks,ABML,14,0,14,-14,1,1,8,1,OTC
4852,14-02-2021 08:00,24 hrs.,stocks,ENKS,6,0,6,-6,1,1,0,1,OTC
4852,14-02-2021 08:00,24 hrs.,stocks,KYNC,6,0,6,-6,1,1,0,1,OTC
4852,14-02-2021 08:00,24 hrs.,stocks,LINK,651,0,651,-651,1,298,51,1,OTC
4852,14-02-2021 08:00,24 hrs.,stocks,LQMT,21,0,21,-21,1,7,3,1,OTC
4852,14-02-2021 08:00,24 hrs.,stocks,LTNC,6,0,6,-6,1,1,0,1,OTC
4852,14-02-2021 08:00,24 hrs.,stocks,MINE,18,0,18,-18,3,3,0,1,OTC
4852,14-02-2021 08:00,24 hrs.,stocks,MOST,651,0,651,-651,1,298,51,1,OTC
4852,14-02-2021 08:00,24 hrs.,stocks,NMTC,89,0,89,-89,1,35,15,1,OTC
4852,14-02-2021 08:00,24 hrs.,stocks,OPTI,6,6,0,6,1,1,0,1,OTC
4852,14-02-2021 08:00,24 hrs.,stocks,PPJE,6,6,0,6,1,1,0,1,OTC
4852,14-02-2021 08:00,24 hrs.,stocks,ROTH,7,7,0,7,1,1,1,1,OTC
4852,14-02-2021 08:00,24 hrs.,stocks,SAFS,6,6,0,6,1,1,0,1,OTC
4852,14-02-2021 08:00,24 hrs.,stocks,SAGD,21,0,21,-21,1,3,11,1,OTC
4852,14-02-2021 08:00,24 hrs.,stocks,SGMD,12,0,12,-12,2,2,0,1,OTC
4852,14-02-2021 08:00,24 hrs.,stocks,SOBR,6,0,6,-6,1,1,0,1,OTC
4852,14-02-2021 08:00,24 hrs.,stocks,TRUL,6,6,0,6,1,1,0,1,OTC
4852,14-02-2021 08:00,24 hrs.,stocks,XFLS,4,0,4,-4,1,0,0,1,OTC
4852,14-02-2021 08:00,24 hrs.,stocks,COCSF,45,45,0,45,1,20,1,1,OTC
4852,14-02-2021 08:00,24 hrs.,stocks,HITIF,6,0,6,-6,1,1,0,1,OTC
4852,14-02-2021 08:00,24 hrs.,stocks,HRVSF,6,6,0,6,1,1,0,1,OTC
4852,14-02-2021 08:00,24 hrs.,stocks,HVBTF,7,7,0,7,1,1,1,1,OTC
4852,14-02-2021 08:00,24 hrs.,stocks,TCEHY,6,6,0,6,1,1,0,1,OTC
4852,14-02-2021 08:00,24 hrs.,stocks,TCNNF,6,6,0,6,1,1,0,1,OTC
4852,14-02-2021 08:00,24 hrs.,stocks,WXIBF,16,16,0,16,1,3,6,1,OTC
4852,14-02-2021 08:00,24 hrs.,stocks,XJNGF,6,0,6,-6,1,1,0,1,OTC
4852,14-02-2021 08:00,24 hrs.,stocks,DNN,13,13,0,13,1,1,7,1,AMEX
4852,14-02-2021 08:00,24 hrs.,stocks,SENS,19,0,19,-19,2,1,9,1,AMEX
4852,14-02-2021 08:00,24 hrs.,stocks,UAVS,6,0,6,-6,1,1,0,1,AMEX
4852,14-02-2021 08:00,24 hrs.,stocks,AAP,651,0,651,-651,1,298,51,1,NYSE
4852,14-02-2021 08:00,24 hrs.,stocks,AEO,17,17,0,17,1,1,11,1,NYSE
4852,14-02-2021 08:00,24 hrs.,stocks,AIV,31,0,31,-31,1,9,9,1,NYSE
4852,14-02-2021 08:00,24 hrs.,stocks,AMC,6,6,0,6,1,1,0,1,NYSE
4852,14-02-2021 08:00,24 hrs.,stocks,BKH,52,0,52,-52,1,16,16,1,NYSE
4852,14-02-2021 08:00,24 hrs.,stocks,CMA,6,0,6,-6,1,1,0,1,NYSE
4852,14-02-2021 08:00,24 hrs.,stocks,CNQ,21,0,21,-21,1,3,11,1,NYSE
4852,14-02-2021 08:00,24 hrs.,stocks,CVE,21,0,21,-21,1,3,11,1,NYSE
4852,14-02-2021 08:00,24 hrs.,stocks,CVS,651,0,651,-651,1,298,51,1,NYSE
4852,14-02-2021 08:00,24 hrs.,SPACs,VYGG,27,7,20,-13,4,4,3,2,NYSE
4852,14-02-2021 08:00,24 hrs.,SPACs,HAS,29,29,0,29,1,2,21,1,NASDAQ
4852,14-02-2021 08:00,24 hrs.,SPACs,III,141,0,141,-141,1,44,49,1,NASDAQ
4852,14-02-2021 08:00,24 hrs.,SPACs,AACQ,502,473,29,444,6,173,132,6,NASDAQ
4852,14-02-2021 08:00,24 hrs.,SPACs,ACAC,43,0,43,-43,1,12,15,1,NASDAQ
4852,14-02-2021 08:00,24 hrs.,SPACs,BTAQ,109,0,109,-109,2,40,21,2,NASDAQ
4852,14-02-2021 08:00,24 hrs.,SPACs,FTOC,466,466,0,466,2,146,166,2,NASDAQ
4852,14-02-2021 08:00,24 hrs.,SPACs,GHIV,587,446,141,305,2,183,213,2,NASDAQ
4852,14-02-2021 08:00,24 hrs.,SPACs,NBAC,21,0,21,-21,1,8,1,1,NASDAQ
4852,14-02-2021 08:00,24 hrs.,SPACs,NGAC,159,159,0,159,2,57,37,2,NASDAQ
4852,14-02-2021 08:00,24 hrs.,SPACs,CAGR,56,56,0,56,1,1,50,1,OTC
4852,14-02-2021 08:00,24 hrs.,SPACs,NOVC,6,0,6,-6,1,0,2,1,OTC
4852,14-02-2021 08:00,24 hrs.,SPACs,AMC,20,0,20,-20,1,2,12,1,NYSE
4852,14-02-2021 08:00,24 hrs.,SPACs,BFT,69,62,7,55,3,3,51,3,NYSE
4852,14-02-2021 08:00,24 hrs.,SPACs,GME,20,0,20,-20,1,2,12,1,NYSE
4852,14-02-2021 08:00,24 hrs.,SPACs,HLF,29,29,0,29,1,2,21,1,NYSE
4852,14-02-2021 08:00,24 hrs.,SPACs,JWS,65,65,0,65,2,1,55,2,NYSE
4852,14-02-2021 08:00,24 hrs.,SPACs,MLM,29,29,0,29,1,2,21,1,NYSE
4852,14-02-2021 08:00,24 hrs.,SPACs,NAV,1184,451,733,-282,6,403,354,6,NYSE
4852,14-02-2021 08:00,24 hrs.,SPACs,RTP,22,22,0,22,1,5,8,1,NYSE
4852,14-02-2021 08:00,24 hrs.,SPACs,SBE,56,56,0,56,1,1,50,1,NYSE
4852,14-02-2021 08:00,24 hrs.,SPACs,ACIC,6,0,6,-6,1,1,0,1,NYSE
4852,14-02-2021 08:00,24 hrs.,SPACs,AJAX,84,84,0,84,1,10,60,1,NYSE
4852,14-02-2021 08:00,24 hrs.,SPACs,ALUS,41,41,0,41,1,13,11,1,NYSE
4852,14-02-2021 08:00,24 hrs.,SPACs,AVAN,44,0,44,-44,1,12,16,1,NYSE
4852,14-02-2021 08:00,24 hrs.,SPACs,CCIV,1730,934,796,138,11,638,410,9,NYSE
4852,14-02-2021 08:00,24 hrs.,SPACs,DNMR,62,0,62,-62,1,21,16,1,NYSE
4852,14-02-2021 08:00,24 hrs.,SPACs,FGNA,446,446,0,446,1,139,164,1,NYSE
4852,14-02-2021 08:00,24 hrs.,SPACs,FUSE,483,483,0,483,3,140,191,3,NYSE
4852,14-02-2021 08:00,24 hrs.,SPACs,IPOF,6,0,6,-6,1,1,0,1,NYSE
4852,14-02-2021 08:00,24 hrs.,SPACs,LGVW,7,0,7,-7,1,1,1,1,NYSE
4852,14-02-2021 08:00,24 hrs.,SPACs,MPLN,64,0,64,-64,1,25,10,1,NYSE
4852,14-02-2021 08:00,24 hrs.,SPACs,PCPL,446,446,0,446,1,139,164,1,NYSE
4852,14-02-2021 08:00,24 hrs.,SPACs,PLNT,29,29,0,29,1,2,21,1,NYSE
4852,14-02-2021 08:00,24 hrs.,SPACs,PSTH,1352,708,644,64,9,497,322,8,NYSE
4852,14-02-2021 08:00,24 hrs.,SPACs,RBAC,23,0,23,-23,1,3,13,1,NYSE
4852,14-02-2021 08:00,24 hrs.,SPACs,SKLZ,27,0,27,-27,4,4,3,1,NYSE
4852,14-02-2021 08:00,24 hrs.,SPACs,STPK,78,56,22,34,4,4,54,2,NYSE
4852,14-02-2021 08:00,24 hrs.,RobinHoodPennyStocks,ARBKF,33,33,0,33,1,3,23,1,OTC
4852,14-02-2021 08:00,24 hrs.,RobinHoodPennyStocks,EMHTF,6,6,0,6,1,1,0,1,OTC
4852,14-02-2021 08:00,24 hrs.,RobinHoodPennyStocks,MEDIF,6,0,6,-6,1,1,0,1,OTC
4852,14-02-2021 08:00,24 hrs.,RobinHoodPennyStocks,TBPMF,7,7,0,7,1,1,1,1,OTC
4852,14-02-2021 08:00,24 hrs.,RobinHoodPennyStocks,DNN,39,33,6,27,2,13,5,2,AMEX
4852,14-02-2021 08:00,24 hrs.,RobinHoodPennyStocks,DPW,35,0,35,-35,1,10,11,1,AMEX
4852,14-02-2021 08:00,24 hrs.,RobinHoodPennyStocks,DSS,6,0,6,-6,1,1,0,1,AMEX
4852,14-02-2021 08:00,24 hrs.,RobinHoodPennyStocks,GTE,22,22,0,22,1,2,14,1,AMEX
4852,14-02-2021 08:00,24 hrs.,RobinHoodPennyStocks,NAK,6,6,0,6,1,1,0,1,AMEX
4852,14-02-2021 08:00,24 hrs.,RobinHoodPennyStocks,PTN,36,36,0,36,1,13,6,1,AMEX
4852,14-02-2021 08:00,24 hrs.,RobinHoodPennyStocks,SYN,6,6,0,6,1,1,0,1,AMEX
4852,14-02-2021 08:00,24 hrs.,RobinHoodPennyStocks,ZOM,147,147,0,147,2,51,37,2,AMEX
4852,14-02-2021 08:00,24 hrs.,RobinHoodPennyStocks,XXII,6,6,0,6,1,1,0,1,AMEX
4852,14-02-2021 08:00,24 hrs.,RobinHoodPennyStocks,EPR,33,33,0,33,1,12,5,1,NYSE
4852,14-02-2021 08:00,24 hrs.,RobinHoodPennyStocks,ETN,12,0,12,-12,2,2,0,1,NYSE
4852,14-02-2021 08:00,24 hrs.,RobinHoodPennyStocks,GME,8,8,0,8,1,1,2,1,NYSE
4852,14-02-2021 08:00,24 hrs.,RobinHoodPennyStocks,MRO,69,0,69,-69,1,27,11,1,NYSE
4852,14-02-2021 08:00,24 hrs.,RobinHoodPennyStocks,NOK,8,8,0,8,1,1,2,1,NYSE
4852,14-02-2021 08:00,24 hrs.,RobinHoodPennyStocks,PEG,607,607,0,607,1,277,49,1,NYSE
4852,14-02-2021 08:00,24 hrs.,RobinHoodPennyStocks,RSI,607,607,0,607,1,277,49,1,NYSE
4852,14-02-2021 08:00,24 hrs.,RobinHoodPennyStocks,SOS,6,6,0,6,1,1,0,1,NYSE
4852,14-02-2021 08:00,24 hrs.,RobinHoodPennyStocks,DECK,6,6,0,6,1,1,0,1,NYSE
4852,14-02-2021 08:00,24 hrs.,RobinHoodPennyStocks,IPOE,6,0,6,-6,1,1,0,1,NYSE
4852,14-02-2021 08:00,24 hrs.,RobinHoodPennyStocks,SND,55,0,55,-55,1,15,21,1,NASDAQ
4852,14-02-2021 08:00,24 hrs.,RobinHoodPennyStocks,AAPL,607,607,0,607,1,277,49,1,NASDAQ
4852,14-02-2021 08:00,24 hrs.,RobinHoodPennyStocks,ADXS,6,6,0,6,1,1,0,1,NASDAQ
4852,14-02-2021 08:00,24 hrs.,RobinHoodPennyStocks,AGEN,6,0,6,-6,1,1,0,1,NASDAQ
4852,14-02-2021 08:00,24 hrs.,RobinHoodPennyStocks,AGTC,114,114,0,114,1,40,30,1,NASDAQ
4852,14-02-2021 08:00,24 hrs.,RobinHoodPennyStocks,AKBA,7,7,0,7,1,1,1,1,NASDAQ
4852,14-02-2021 08:00,24 hrs.,RobinHoodPennyStocks,ASRT,13,13,0,13,1,1,7,1,NASDAQ
4852,14-02-2021 08:00,24 hrs.,RobinHoodPennyStocks,BNGO,4,0,4,-4,1,0,0,1,NASDAQ
4852,14-02-2021 08:00,24 hrs.,RobinHoodPennyStocks,BVXV,6,6,0,6,1,1,0,1,NASDAQ
4852,14-02-2021 08:00,24 hrs.,RobinHoodPennyStocks,CLBS,6,0,6,-6,1,1,0,1,NASDAQ
4852,14-02-2021 08:00,24 hrs.,RobinHoodPennyStocks,CSTR,4,4,0,4,1,0,0,1,NASDAQ
4852,14-02-2021 08:00,24 hrs.,RobinHoodPennyStocks,CTRM,6,0,6,-6,1,1,0,1,NASDAQ
4852,14-02-2021 08:00,24 hrs.,RobinHoodPennyStocks,DFFN,74,0,74,-74,1,16,38,1,NASDAQ
4852,14-02-2021 08:00,24 hrs.,RobinHoodPennyStocks,FLMN,6,0,6,-6,1,1,0,1,NASDAQ
4852,14-02-2021 08:00,24 hrs.,RobinHoodPennyStocks,GOGO,11,11,0,11,1,0,7,1,NASDAQ
4852,14-02-2021 08:00,24 hrs.,RobinHoodPennyStocks,GRPN,21,21,0,21,1,4,9,1,NASDAQ
4852,14-02-2021 08:00,24 hrs.,RobinHoodPennyStocks,IDEX,6,6,0,6,1,1,0,1,NASDAQ
4852,14-02-2021 08:00,24 hrs.,RobinHoodPennyStocks,JAGX,124,124,0,124,1,49,22,1,NASDAQ
4852,14-02-2021 08:00,24 hrs.,RobinHoodPennyStocks,MARA,33,33,0,33,1,3,23,1,NASDAQ
4852,14-02-2021 08:00,24 hrs.,RobinHoodPennyStocks,SNDL,24,12,12,0,4,4,0,3,NASDAQ
4852,14-02-2021 08:00,24 hrs.,RobinHoodPennyStocks,SONM,25,0,25,-25,1,4,13,1,NASDAQ
4852,14-02-2021 08:00,24 hrs.,RobinHoodPennyStocks,SXTC,12,0,12,-12,1,3,2,1,NASDAQ
4852,14-02-2021 08:00,24 hrs.,RobinHoodPennyStocks,TNXP,18,18,0,18,3,3,0,1,NASDAQ
4852,14-02-2021 08:00,24 hrs.,RobinHoodPennyStocks,TRCH,76,6,70,-64,2,20,28,2,NASDAQ
4852,14-02-2021 08:00,24 hrs.,RobinHoodPennyStocks,TSLA,6,0,6,-6,1,1,0,1,NASDAQ
4852,14-02-2021 08:00,24 hrs.,RobinHoodPennyStocks,TXMD,13,13,0,13,1,1,7,1,NASDAQ
4852,14-02-2021 08:00,24 hrs.,wallstreetbets,WING,177,0,177,-177,1,68,37,1,NASDAQ
4852,14-02-2021 08:00,24 hrs.,wallstreetbets,WKHS,4055,99,3956,-3857,3,1813,417,3,NASDAQ
4852,14-02-2021 08:00,24 hrs.,wallstreetbets,WSBC,8,0,8,-8,1,1,2,1,NASDAQ
4852,14-02-2021 08:00,24 hrs.,wallstreetbets,YNDX,177,0,177,-177,1,68,37,1,NASDAQ
4852,14-02-2021 08:00,24 hrs.,wallstreetbets,ZNGA,7,7,0,7,1,1,1,1,NASDAQ
4852,14-02-2021 08:00,24 hrs.,wallstreetbets,CMCSA,7,0,7,-7,1,1,1,1,NASDAQ
4852,14-02-2021 08:00,24 hrs.,RobinHoodPennyStocks,HCMC,6,6,0,6,1,1,0,1,OTC
4852,14-02-2021 08:00,24 hrs.,RobinHoodPennyStocks,RTSL,6,6,0,6,1,1,0,1,OTC
4852,14-02-2021 08:00,24 hrs.,RobinHoodPennyStocks,SGMD,6,6,0,6,1,1,0,1,OTC
4852,14-02-2021 08:00,24 hrs.,wallstreetbets,LIFE,24,10,14,-4,3,4,4,3,NASDAQ
4852,14-02-2021 08:00,24 hrs.,wallstreetbets,LKCO,6,0,6,-6,1,1,0,1,NASDAQ
4852,14-02-2021 08:00,24 hrs.,wallstreetbets,LSCC,177,0,177,-177,1,68,37,1,NASDAQ
4852,14-02-2021 08:00,24 hrs.,wallstreetbets,LXRX,7,7,0,7,1,1,1,1,NASDAQ
4852,14-02-2021 08:00,24 hrs.,wallstreetbets,MARA,23,15,8,7,3,3,5,3,NASDAQ
4852,14-02-2021 08:00,24 hrs.,wallstreetbets,MESO,7,7,0,7,1,1,1,1,NASDAQ
4852,14-02-2021 08:00,24 hrs.,wallstreetbets,MSFT,7,7,0,7,1,1,1,1,NASDAQ
4852,14-02-2021 08:00,24 hrs.,wallstreetbets,MVIS,888,771,117,654,13,272,292,7,NASDAQ
4852,14-02-2021 08:00,24 hrs.,wallstreetbets,NAKD,20,6,14,-8,3,3,2,3,NASDAQ
4852,14-02-2021 08:00,24 hrs.,wallstreetbets,NCLH,132,132,0,132,1,36,56,1,NASDAQ
4852,14-02-2021 08:00,24 hrs.,wallstreetbets,NCNO,1191,0,1191,-1191,1,560,67,1,NASDAQ
4852,14-02-2021 08:00,24 hrs.,wallstreetbets,NEPT,7,0,7,-7,1,1,1,1,NASDAQ
4852,14-02-2021 08:00,24 hrs.,wallstreetbets,NGAC,6,0,6,-6,1,1,0,1,NASDAQ
4852,14-02-2021 08:00,24 hrs.,wallstreetbets,NLOK,7,0,7,-7,1,1,1,1,NASDAQ
4852,14-02-2021 08:00,24 hrs.,wallstreetbets,NNDM,39,0,39,-39,2,1,29,2,NASDAQ
4852,14-02-2021 08:00,24 hrs.,wallstreetbets,NVAX,21,14,7,7,3,3,3,3,NASDAQ
4852,14-02-2021 08:00,24 hrs.,wallstreetbets,NVCN,7,7,0,7,1,1,1,1,NASDAQ
4852,14-02-2021 08:00,24 hrs.,wallstreetbets,NVDA,7,0,7,-7,1,1,1,1,NASDAQ
4852,14-02-2021 08:00,24 hrs.,wallstreetbets,NXPI,7,7,0,7,1,1,1,1,NASDAQ
4852,14-02-2021 08:00,24 hrs.,wallstreetbets,OCGN,6,0,6,-6,1,1,0,1,NASDAQ
4852,14-02-2021 08:00,24 hrs.,wallstreetbets,PLAY,18308,6,18302,-18296,3,8645,1006,3,NASDAQ
4852,14-02-2021 08:00,24 hrs.,wallstreetbets,POWW,14,0,14,-14,2,2,2,2,NASDAQ
4852,14-02-2021 08:00,24 hrs.,wallstreetbets,PTON,7,0,7,-7,1,1,1,1,NASDAQ
4852,14-02-2021 08:00,24 hrs.,wallstreetbets,PYPL,6,6,0,6,1,1,0,1,NASDAQ
4852,14-02-2021 08:00,24 hrs.,wallstreetbets,QCOM,6,0,6,-6,1,1,0,1,NASDAQ
4852,14-02-2021 08:00,24 hrs.,wallstreetbets,QDEL,177,0,177,-177,1,68,37,1,NASDAQ
4852,14-02-2021 08:00,24 hrs.,wallstreetbets,RAVE,7,0,7,-7,1,1,1,1,NASDAQ
4852,14-02-2021 08:00,24 hrs.,wallstreetbets,REAL,10,10,0,10,1,2,2,1,NASDAQ
4852,14-02-2021 08:00,24 hrs.,wallstreetbets,RIGL,7,7,0,7,1,1,1,1,NASDAQ
4852,14-02-2021 08:00,24 hrs.,wallstreetbets,RIOT,35,21,14,7,5,5,5,5,NASDAQ
4852,14-02-2021 08:00,24 hrs.,wallstreetbets,RKDA,7,7,0,7,1,1,1,1,NASDAQ
4852,14-02-2021 08:00,24 hrs.,wallstreetbets,RNWK,6,0,6,-6,1,1,0,1,NASDAQ
4852,14-02-2021 08:00,24 hrs.,wallstreetbets,ROKU,5324,0,5324,-5324,3,2423,466,3,NASDAQ
4852,14-02-2021 08:00,24 hrs.,wallstreetbets,SABR,7,7,0,7,1,1,1,1,NASDAQ
4852,14-02-2021 08:00,24 hrs.,wallstreetbets,SEDG,177,0,177,-177,1,68,37,1,NASDAQ
4852,14-02-2021 08:00,24 hrs.,wallstreetbets,SESN,6,0,6,-6,1,1,0,1,NASDAQ
4852,14-02-2021 08:00,24 hrs.,wallstreetbets,SGEN,7,0,7,-7,1,1,1,1,NASDAQ
4852,14-02-2021 08:00,24 hrs.,wallstreetbets,SHIP,28,28,0,28,4,4,4,2,NASDAQ
4852,14-02-2021 08:00,24 hrs.,wallstreetbets,SIRI,8,8,0,8,1,1,2,1,NASDAQ
4852,14-02-2021 08:00,24 hrs.,wallstreetbets,SMCI,14,14,0,14,2,2,2,1,NASDAQ
4852,14-02-2021 08:00,24 hrs.,wallstreetbets,SNDL,385,146,239,-93,57,57,43,43,NASDAQ
4852,14-02-2021 08:00,24 hrs.,wallstreetbets,SNGX,12,0,12,-12,2,2,0,2,NASDAQ
4852,14-02-2021 08:00,24 hrs.,wallstreetbets,SQQQ,7,0,7,-7,1,1,1,1,NASDAQ
4852,14-02-2021 08:00,24 hrs.,wallstreetbets,SRNE,7,7,0,7,1,1,1,1,NASDAQ
4852,14-02-2021 08:00,24 hrs.,wallstreetbets,STMP,177,0,177,-177,1,68,37,1,NASDAQ
4852,14-02-2021 08:00,24 hrs.,wallstreetbets,SWBI,7,0,7,-7,1,1,1,1,NASDAQ
4852,14-02-2021 08:00,24 hrs.,wallstreetbets,TELL,6,6,0,6,1,1,0,1,NASDAQ
4852,14-02-2021 08:00,24 hrs.,wallstreetbets,TLGT,19,12,7,5,3,3,1,2,NASDAQ
4852,14-02-2021 08:00,24 hrs.,wallstreetbets,TLRY,1597,173,1424,-1251,15,667,203,13,NASDAQ
4852,14-02-2021 08:00,24 hrs.,wallstreetbets,TNXP,21,0,21,-21,3,3,3,3,NASDAQ
4852,14-02-2021 08:00,24 hrs.,wallstreetbets,TRCH,19,0,19,-19,3,3,1,3,NASDAQ
4852,14-02-2021 08:00,24 hrs.,wallstreetbets,TREE,1191,0,1191,-1191,1,560,67,1,NASDAQ
4852,14-02-2021 08:00,24 hrs.,wallstreetbets,TRIT,25,25,0,25,1,8,5,1,NASDAQ
4852,14-02-2021 08:00,24 hrs.,wallstreetbets,TRVG,32,13,19,-6,5,5,2,5,NASDAQ
4852,14-02-2021 08:00,24 hrs.,wallstreetbets,TSLA,5231,535,4696,-4161,14,2200,775,11,NASDAQ
4852,14-02-2021 08:00,24 hrs.,wallstreetbets,TXMD,20,14,6,8,3,3,2,3,NASDAQ
4852,14-02-2021 08:00,24 hrs.,wallstreetbets,TXRH,177,0,177,-177,1,68,37,1,NASDAQ
4852,14-02-2021 08:00,24 hrs.,wallstreetbets,UPST,7,7,0,7,1,1,1,1,NASDAQ
4852,14-02-2021 08:00,24 hrs.,wallstreetbets,VISL,7,0,7,-7,1,1,1,1,NASDAQ
4852,14-02-2021 08:00,24 hrs.,wallstreetbets,VKTX,7,7,0,7,1,1,1,1,NASDAQ
4852,14-02-2021 08:00,24 hrs.,wallstreetbets,VUZI,20,6,14,-8,3,3,2,3,NASDAQ
4852,14-02-2021 08:00,24 hrs.,wallstreetbets,VXRT,42,0,42,-42,6,6,6,2,NASDAQ
4852,14-02-2021 08:00,24 hrs.,wallstreetbets,WATT,7,0,7,-7,1,1,1,1,NASDAQ
4852,14-02-2021 08:00,24 hrs.,wallstreetbets,WIMI,7,0,7,-7,1,1,1,1,NASDAQ
4852,14-02-2021 08:00,24 hrs.,wallstreetbets,GTHX,304,304,0,304,3,97,98,2,NASDAQ
4852,14-02-2021 08:00,24 hrs.,wallstreetbets,HEAR,7,0,7,-7,1,1,1,1,NASDAQ
4852,14-02-2021 08:00,24 hrs.,wallstreetbets,IBEX,7,7,0,7,1,1,1,1,NASDAQ
4852,14-02-2021 08:00,24 hrs.,wallstreetbets,IDEX,7,7,0,7,1,1,1,1,NASDAQ
4852,14-02-2021 08:00,24 hrs.,wallstreetbets,INTC,470,0,470,-470,5,114,222,4,NASDAQ
4852,14-02-2021 08:00,24 hrs.,wallstreetbets,IRBT,6,0,6,-6,1,1,0,1,NASDAQ
4852,14-02-2021 08:00,24 hrs.,wallstreetbets,JAGX,7,0,7,-7,1,1,1,1,NASDAQ
4852,14-02-2021 08:00,24 hrs.,wallstreetbets,KOPN,6,0,6,-6,1,1,0,1,NASDAQ
4852,14-02-2021 08:00,24 hrs.,wallstreetbets,KOSS,7,7,0,7,1,1,1,1,NASDAQ
4852,14-02-2021 08:00,24 hrs.,wallstreetbets,APPS,6,6,0,6,1,1,0,1,NASDAQ
4852,14-02-2021 08:00,24 hrs.,wallstreetbets,ASRT,14,14,0,14,2,2,2,2,NASDAQ
4852,14-02-2021 08:00,24 hrs.,wallstreetbets,ASTC,7,0,7,-7,1,1,1,1,NASDAQ
4852,14-02-2021 08:00,24 hrs.,wallstreetbets,ATNF,6,6,0,6,1,1,0,1,NASDAQ
4852,14-02-2021 08:00,24 hrs.,wallstreetbets,ATNX,7,7,0,7,1,1,1,1,NASDAQ
4852,14-02-2021 08:00,24 hrs.,wallstreetbets,ATVI,33,0,33,-33,1,0,29,1,NASDAQ
4852,14-02-2021 08:00,24 hrs.,wallstreetbets,AZRX,7,7,0,7,1,1,1,1,NASDAQ
4852,14-02-2021 08:00,24 hrs.,wallstreetbets,BBBY,3956,0,3956,-3956,1,1795,362,1,NASDAQ
4852,14-02-2021 08:00,24 hrs.,wallstreetbets,BHTG,7,0,7,-7,1,1,1,1,NASDAQ
4852,14-02-2021 08:00,24 hrs.,wallstreetbets,BIDU,177,0,177,-177,1,68,37,1,NASDAQ
4852,14-02-2021 08:00,24 hrs.,wallstreetbets,BIGC,1191,0,1191,-1191,1,560,67,1,NASDAQ
4852,14-02-2021 08:00,24 hrs.,wallstreetbets,BLDP,7,0,7,-7,1,1,1,1,NASDAQ
4852,14-02-2021 08:00,24 hrs.,wallstreetbets,BLMN,177,0,177,-177,1,68,37,1,NASDAQ
4852,14-02-2021 08:00,24 hrs.,wallstreetbets,BLPH,6,0,6,-6,1,1,0,1,NASDAQ
4852,14-02-2021 08:00,24 hrs.,wallstreetbets,BLRX,6,0,6,-6,1,1,0,1,NASDAQ
4852,14-02-2021 08:00,24 hrs.,wallstreetbets,BNGO,60,20,40,-20,9,9,6,7,NASDAQ
4852,14-02-2021 08:00,24 hrs.,wallstreetbets,BSQR,7,0,7,-7,1,1,1,1,NASDAQ
4852,14-02-2021 08:00,24 hrs.,wallstreetbets,CCRC,8,0,8,-8,1,2,0,1,NASDAQ
4852,14-02-2021 08:00,24 hrs.,wallstreetbets,CGIX,6,0,6,-6,1,1,0,1,NASDAQ
4852,14-02-2021 08:00,24 hrs.,wallstreetbets,CHEK,7,7,0,7,1,1,1,1,NASDAQ
4852,14-02-2021 08:00,24 hrs.,wallstreetbets,CIDM,6,0,6,-6,1,1,0,1,NASDAQ
4852,14-02-2021 08:00,24 hrs.,wallstreetbets,CLBS,14,0,14,-14,2,2,2,2,NASDAQ
4852,14-02-2021 08:00,24 hrs.,wallstreetbets,CLEU,14,7,7,0,2,2,2,2,NASDAQ
4852,14-02-2021 08:00,24 hrs.,wallstreetbets,CLVS,14,0,14,-14,2,2,2,1,NASDAQ
4852,14-02-2021 08:00,24 hrs.,wallstreetbets,CMPS,6,0,6,-6,1,1,0,1,NASDAQ
4852,14-02-2021 08:00,24 hrs.,wallstreetbets,CPRT,177,0,177,-177,1,68,37,1,NASDAQ
4852,14-02-2021 08:00,24 hrs.,wallstreetbets,CRBP,6,0,6,-6,1,1,0,1,NASDAQ
4852,14-02-2021 08:00,24 hrs.,wallstreetbets,CREX,7,7,0,7,1,1,1,1,NASDAQ
4852,14-02-2021 08:00,24 hrs.,wallstreetbets,CRON,57,57,0,57,1,7,39,1,NASDAQ
4852,14-02-2021 08:00,24 hrs.,wallstreetbets,CRSR,24,17,7,10,2,1,14,2,NASDAQ
4852,14-02-2021 08:00,24 hrs.,wallstreetbets,CSTR,5,5,0,5,1,0,1,1,NASDAQ
4852,14-02-2021 08:00,24 hrs.,wallstreetbets,CTHR,6,6,0,6,1,1,0,1,NASDAQ
4852,14-02-2021 08:00,24 hrs.,wallstreetbets,CTRM,53,19,34,-15,8,8,5,7,NASDAQ
4852,14-02-2021 08:00,24 hrs.,wallstreetbets,DDOG,27,27,0,27,1,6,11,1,NASDAQ
4852,14-02-2021 08:00,24 hrs.,wallstreetbets,DENN,177,0,177,-177,1,68,37,1,NASDAQ
4852,14-02-2021 08:00,24 hrs.,wallstreetbets,DKNG,3956,0,3956,-3956,1,1795,362,1,NASDAQ
4852,14-02-2021 08:00,24 hrs.,wallstreetbets,EDIT,80,80,0,80,1,4,68,1,NASDAQ
4852,14-02-2021 08:00,24 hrs.,wallstreetbets,EHTH,177,0,177,-177,1,68,37,1,NASDAQ
4852,14-02-2021 08:00,24 hrs.,wallstreetbets,EVBG,177,0,177,-177,1,68,37,1,NASDAQ
4852,14-02-2021 08:00,24 hrs.,wallstreetbets,EVFM,13,7,6,1,2,2,1,2,NASDAQ
4852,14-02-2021 08:00,24 hrs.,wallstreetbets,EXPI,11,0,11,-11,2,1,1,2,NASDAQ
4852,14-02-2021 08:00,24 hrs.,wallstreetbets,FIZZ,1212,7,1205,-1198,4,563,70,3,NASDAQ
4852,14-02-2021 08:00,24 hrs.,wallstreetbets,FLGT,15,15,0,15,2,2,3,1,NASDAQ
4852,14-02-2021 08:00,24 hrs.,wallstreetbets,FLMN,6,0,6,-6,1,1,0,1,NASDAQ
4852,14-02-2021 08:00,24 hrs.,wallstreetbets,FOLD,13,7,6,1,2,2,1,2,NASDAQ
4852,14-02-2021 08:00,24 hrs.,wallstreetbets,FREQ,21,21,0,21,1,0,17,1,NASDAQ
4852,14-02-2021 08:00,24 hrs.,wallstreetbets,FROG,7,7,0,7,1,1,1,1,NASDAQ
4852,14-02-2021 08:00,24 hrs.,wallstreetbets,GAIN,13,13,0,13,2,2,1,2,NASDAQ
4852,14-02-2021 08:00,24 hrs.,wallstreetbets,GECC,7,7,0,7,1,1,1,1,NASDAQ
4852,14-02-2021 08:00,24 hrs.,wallstreetbets,GIGM,14,14,0,14,2,2,2,1,NASDAQ
4852,14-02-2021 08:00,24 hrs.,wallstreetbets,GLBS,7,0,7,-7,1,1,1,1,NASDAQ
4852,14-02-2021 08:00,24 hrs.,wallstreetbets,GMBL,7,7,0,7,1,1,1,1,NASDAQ
4852,14-02-2021 08:00,24 hrs.,wallstreetbets,GNOG,13,6,7,-1,2,2,1,2,NASDAQ
4852,14-02-2021 08:00,24 hrs.,wallstreetbets,GOGO,1257,54,1203,-1149,11,570,73,7,NASDAQ
4852,14-02-2021 08:00,24 hrs.,wallstreetbets,GOLD,257,65,192,-127,5,86,65,5,NASDAQ
4852,14-02-2021 08:00,24 hrs.,wallstreetbets,GRMN,177,0,177,-177,1,68,37,1,NASDAQ
4852,14-02-2021 08:00,24 hrs.,wallstreetbets,GTEC,6,0,6,-6,1,1,0,1,NASDAQ
4852,14-02-2021 08:00,24 hrs.,wallstreetbets,KHC,205,205,0,205,2,55,87,2,NASDAQ
4852,14-02-2021 08:00,24 hrs.,wallstreetbets,KIN,14,0,14,-14,2,2,2,1,NASDAQ
4852,14-02-2021 08:00,24 hrs.,wallstreetbets,NEO,6,6,0,6,1,1,0,1,NASDAQ
4852,14-02-2021 08:00,24 hrs.,wallstreetbets,NWL,107,107,0,107,1,17,69,1,NASDAQ
4852,14-02-2021 08:00,24 hrs.,wallstreetbets,OGI,27,0,27,-27,4,4,3,3,NASDAQ
4852,14-02-2021 08:00,24 hrs.,wallstreetbets,QQQ,6,0,6,-6,1,1,0,1,NASDAQ
4852,14-02-2021 08:00,24 hrs.,wallstreetbets,RNA,83,83,0,83,1,20,39,1,NASDAQ
4852,14-02-2021 08:00,24 hrs.,wallstreetbets,RUN,7,0,7,-7,1,1,1,1,NASDAQ
4852,14-02-2021 08:00,24 hrs.,wallstreetbets,SLP,6,0,6,-6,1,1,0,1,NASDAQ
4852,14-02-2021 08:00,24 hrs.,wallstreetbets,TTD,177,0,177,-177,1,68,37,1,NASDAQ
4852,14-02-2021 08:00,24 hrs.,wallstreetbets,UFO,15,15,0,15,2,2,3,1,NASDAQ
4852,14-02-2021 08:00,24 hrs.,wallstreetbets,VFF,7,7,0,7,1,1,1,1,NASDAQ
4852,14-02-2021 08:00,24 hrs.,wallstreetbets,WIX,177,0,177,-177,1,68,37,1,NASDAQ
4852,14-02-2021 08:00,24 hrs.,wallstreetbets,AACQ,7,0,7,-7,1,1,1,1,NASDAQ
4852,14-02-2021 08:00,24 hrs.,wallstreetbets,AAPL,3976,7,3969,-3962,4,1798,364,4,NASDAQ
4852,14-02-2021 08:00,24 hrs.,wallstreetbets,ADXS,7,7,0,7,1,1,1,1,NASDAQ
4852,14-02-2021 08:00,24 hrs.,wallstreetbets,AKAM,57,0,57,-57,3,12,21,2,NASDAQ
4852,14-02-2021 08:00,24 hrs.,wallstreetbets,AKBA,7,7,0,7,1,1,1,1,NASDAQ
4852,14-02-2021 08:00,24 hrs.,wallstreetbets,ALNA,7,0,7,-7,1,1,1,1,NASDAQ
4852,14-02-2021 08:00,24 hrs.,wallstreetbets,AMAT,388,0,388,-388,2,143,94,2,NASDAQ
4852,14-02-2021 08:00,24 hrs.,wallstreetbets,AMZN,7,7,0,7,1,1,1,1,NASDAQ
4852,14-02-2021 08:00,24 hrs.,wallstreetbets,ANSS,14,14,0,14,2,2,2,2,NASDAQ
4852,14-02-2021 08:00,24 hrs.,wallstreetbets,ANTE,7,0,7,-7,1,1,1,1,NASDAQ
4852,14-02-2021 08:00,24 hrs.,wallstreetbets,APHA,115,63,52,11,12,25,17,8,NASDAQ
4852,14-02-2021 08:00,24 hrs.,wallstreetbets,APPN,177,0,177,-177,1,68,37,1,NASDAQ
4852,14-02-2021 08:00,24 hrs.,wallstreetbets,ARGO,8,8,0,8,1,1,2,1,NYSE
4852,14-02-2021 08:00,24 hrs.,wallstreetbets,CCIV,89,26,63,-37,13,13,11,11,NYSE
4852,14-02-2021 08:00,24 hrs.,wallstreetbets,COTY,190,0,190,-190,1,66,54,1,NYSE
4852,14-02-2021 08:00,24 hrs.,wallstreetbets,DASH,52,12,40,-28,8,8,4,7,NYSE
4852,14-02-2021 08:00,24 hrs.,wallstreetbets,DNMR,7,7,0,7,1,1,1,1,NYSE
4852,14-02-2021 08:00,24 hrs.,wallstreetbets,EXPR,7,7,0,7,1,1,1,1,NYSE
4852,14-02-2021 08:00,24 hrs.,wallstreetbets,FSLY,5367,0,5367,-5367,4,2433,485,4,NYSE
4852,14-02-2021 08:00,24 hrs.,wallstreetbets,FUBO,3963,7,3956,-3949,2,1796,363,2,NYSE
4852,14-02-2021 08:00,24 hrs.,wallstreetbets,FVRR,1368,0,1368,-1368,2,628,104,2,NYSE
4852,14-02-2021 08:00,24 hrs.,wallstreetbets,GNRC,6,0,6,-6,1,1,0,1,NYSE
4852,14-02-2021 08:00,24 hrs.,wallstreetbets,HYLN,7,7,0,7,1,1,1,1,NYSE
4852,14-02-2021 08:00,24 hrs.,wallstreetbets,IPOD,14,14,0,14,2,2,2,1,NYSE
4852,14-02-2021 08:00,24 hrs.,wallstreetbets,IPOF,14,14,0,14,2,2,2,1,NYSE
4852,14-02-2021 08:00,24 hrs.,wallstreetbets,LEAP,6,0,6,-6,1,1,0,1,NYSE
4852,14-02-2021 08:00,24 hrs.,wallstreetbets,LGVW,14,0,14,-14,2,2,2,1,NYSE
4852,14-02-2021 08:00,24 hrs.,wallstreetbets,MANU,6,6,0,6,1,1,0,1,NYSE
4852,14-02-2021 08:00,24 hrs.,wallstreetbets,MDLY,13,13,0,13,2,2,1,2,NYSE
4852,14-02-2021 08:00,24 hrs.,wallstreetbets,MITT,7,0,7,-7,1,1,1,1,NYSE
4852,14-02-2021 08:00,24 hrs.,wallstreetbets,NOVA,13,6,7,-1,2,2,1,2,NYSE
4852,14-02-2021 08:00,24 hrs.,wallstreetbets,NVTA,177,0,177,-177,1,68,37,1,NYSE
4852,14-02-2021 08:00,24 hrs.,wallstreetbets,PLTR,5515,117,5398,-5281,21,2452,527,17,NYSE
4852,14-02-2021 08:00,24 hrs.,wallstreetbets,PRTY,15,0,15,-15,2,3,1,1,NYSE
4852,14-02-2021 08:00,24 hrs.,wallstreetbets,SHOP,1368,0,1368,-1368,2,628,104,2,NYSE
4852,14-02-2021 08:00,24 hrs.,wallstreetbets,SNOW,27,27,0,27,1,6,11,1,NYSE
4852,14-02-2021 08:00,24 hrs.,wallstreetbets,SPCE,7,0,7,-7,1,1,1,1,NYSE
4852,14-02-2021 08:00,24 hrs.,wallstreetbets,STPK,7,7,0,7,1,1,1,1,NYSE
4852,14-02-2021 08:00,24 hrs.,wallstreetbets,TECK,177,0,177,-177,1,68,37,1,NYSE
4852,14-02-2021 08:00,24 hrs.,wallstreetbets,TWLO,1368,0,1368,-1368,2,628,104,2,NYSE
4852,14-02-2021 08:00,24 hrs.,wallstreetbets,TWTR,3956,0,3956,-3956,1,1795,362,1,NYSE
4852,14-02-2021 08:00,24 hrs.,wallstreetbets,UBER,14,0,14,-14,2,2,2,2,NYSE
4852,14-02-2021 08:00,24 hrs.,wallstreetbets,AAL,50,42,8,34,7,7,8,3,NASDAQ
4852,14-02-2021 08:00,24 hrs.,wallstreetbets,AMD,689,15,674,-659,6,202,261,5,NASDAQ
4852,14-02-2021 08:00,24 hrs.,wallstreetbets,API,7,0,7,-7,1,1,1,1,NASDAQ
4852,14-02-2021 08:00,24 hrs.,wallstreetbets,BLI,1191,0,1191,-1191,1,560,67,1,NASDAQ
4852,14-02-2021 08:00,24 hrs.,wallstreetbets,CDC,28,28,0,28,1,0,24,1,NASDAQ
4852,14-02-2021 08:00,24 hrs.,wallstreetbets,CEY,24,0,24,-24,3,3,6,1,NASDAQ
4852,14-02-2021 08:00,24 hrs.,wallstreetbets,CFO,49,0,49,-49,2,11,19,2,NASDAQ
4852,14-02-2021 08:00,24 hrs.,wallstreetbets,CGC,7,0,7,-7,1,1,1,1,NASDAQ
4852,14-02-2021 08:00,24 hrs.,wallstreetbets,DBX,184,7,177,-170,2,69,38,2,NASDAQ
4852,14-02-2021 08:00,24 hrs.,wallstreetbets,FVE,233,0,233,-233,1,94,41,1,NASDAQ
4852,14-02-2021 08:00,24 hrs.,wallstreetbets,HAS,71,65,6,59,4,23,9,4,NASDAQ
4852,14-02-2021 08:00,24 hrs.,wallstreetbets,HOL,6,0,6,-6,1,1,0,1,NASDAQ
4852,14-02-2021 08:00,24 hrs.,wallstreetbets,III,28,17,11,6,3,6,4,3,NASDAQ
4852,14-02-2021 08:00,24 hrs.,wallstreetbets,INO,90,90,0,90,2,21,40,2,NASDAQ
4852,14-02-2021 08:00,24 hrs.,wallstreetbets,JAN,6,0,6,-6,1,1,0,1,NASDAQ
4852,14-02-2021 08:00,24 hrs.,wallstreetbets,NGL,7,0,7,-7,1,1,1,1,NYSE
4852,14-02-2021 08:00,24 hrs.,wallstreetbets,NIO,3997,13,3984,-3971,7,1801,367,6,NYSE
4852,14-02-2021 08:00,24 hrs.,wallstreetbets,NKE,6,0,6,-6,1,1,0,1,NYSE
4852,14-02-2021 08:00,24 hrs.,wallstreetbets,NMR,13,0,13,-13,2,2,1,2,NYSE
4852,14-02-2021 08:00,24 hrs.,wallstreetbets,NOK,1008,994,14,980,11,398,168,9,NYSE
4852,14-02-2021 08:00,24 hrs.,wallstreetbets,NPO,7,7,0,7,1,1,1,1,NYSE
4852,14-02-2021 08:00,24 hrs.,wallstreetbets,NSA,1897,0,1897,-1897,1,870,153,1,NYSE
4852,14-02-2021 08:00,24 hrs.,wallstreetbets,NTR,177,0,177,-177,1,68,37,1,NYSE
4852,14-02-2021 08:00,24 hrs.,wallstreetbets,OSK,143,0,143,-143,1,37,65,1,NYSE
4852,14-02-2021 08:00,24 hrs.,wallstreetbets,OXY,177,0,177,-177,1,68,37,1,NYSE
4852,14-02-2021 08:00,24 hrs.,wallstreetbets,PEI,8,8,0,8,1,1,2,1,NYSE
4852,14-02-2021 08:00,24 hrs.,wallstreetbets,PSA,114,107,7,100,2,18,70,2,NYSE
4852,14-02-2021 08:00,24 hrs.,wallstreetbets,PXD,177,0,177,-177,1,68,37,1,NYSE
4852,14-02-2021 08:00,24 hrs.,wallstreetbets,RCL,7,0,7,-7,1,1,1,1,NYSE
4852,14-02-2021 08:00,24 hrs.,wallstreetbets,RKT,56,0,56,-56,4,3,34,3,NYSE
4852,14-02-2021 08:00,24 hrs.,wallstreetbets,RNG,177,0,177,-177,1,68,37,1,NYSE
4852,14-02-2021 08:00,24 hrs.,wallstreetbets,SAM,177,0,177,-177,1,68,37,1,NYSE
4852,14-02-2021 08:00,24 hrs.,wallstreetbets,SAP,260,27,233,-206,2,100,52,2,NYSE
4852,14-02-2021 08:00,24 hrs.,wallstreetbets,SBE,7,0,7,-7,1,1,1,1,NYSE
4852,14-02-2021 08:00,24 hrs.,wallstreetbets,SKT,1213,22,1191,-1169,2,560,85,2,NYSE
4852,14-02-2021 08:00,24 hrs.,wallstreetbets,SOS,179,28,151,-123,16,37,41,8,NYSE
4852,14-02-2021 08:00,24 hrs.,wallstreetbets,STC,6,6,0,6,1,1,0,1,NYSE
4852,14-02-2021 08:00,24 hrs.,wallstreetbets,TDA,20,20,0,20,1,2,12,1,NYSE
4852,14-02-2021 08:00,24 hrs.,wallstreetbets,THC,6,0,6,-6,1,1,0,1,NYSE
4852,14-02-2021 08:00,24 hrs.,wallstreetbets,THO,8,8,0,8,1,1,2,1,NYSE
4852,14-02-2021 08:00,24 hrs.,wallstreetbets,TRQ,7,0,7,-7,1,1,1,1,NYSE
4852,14-02-2021 08:00,24 hrs.,wallstreetbets,TRU,177,0,177,-177,1,68,37,1,NYSE
4852,14-02-2021 08:00,24 hrs.,wallstreetbets,TWO,57,57,0,57,1,7,39,1,NYSE
4852,14-02-2021 08:00,24 hrs.,wallstreetbets,UBS,76,0,76,-76,2,20,28,1,NYSE
4852,14-02-2021 08:00,24 hrs.,wallstreetbets,UTF,28,28,0,28,1,0,24,1,NYSE
4852,14-02-2021 08:00,24 hrs.,wallstreetbets,UVV,57,57,0,57,1,7,39,1,NYSE
4852,14-02-2021 08:00,24 hrs.,wallstreetbets,VET,7,0,7,-7,1,1,1,1,NYSE
4852,14-02-2021 08:00,24 hrs.,wallstreetbets,VHC,7,0,7,-7,1,1,1,1,NYSE
4852,14-02-2021 08:00,24 hrs.,wallstreetbets,WMT,1368,0,1368,-1368,2,628,104,2,NYSE
4852,14-02-2021 08:00,24 hrs.,wallstreetbets,WST,177,0,177,-177,1,68,37,1,NYSE
4852,14-02-2021 08:00,24 hrs.,wallstreetbets,XOM,419,0,419,-419,1,156,103,1,NYSE
4852,14-02-2021 08:00,24 hrs.,wallstreetbets,YPF,7,0,7,-7,1,1,1,1,NYSE
4852,14-02-2021 08:00,24 hrs.,wallstreetbets,ZTS,177,0,177,-177,1,68,37,1,NYSE
4852,14-02-2021 08:00,24 hrs.,wallstreetbets,DOW,3956,0,3956,-3956,1,1795,362,1,NYSE
4852,14-02-2021 08:00,24 hrs.,wallstreetbets,EAT,13,6,7,-1,2,2,1,2,NYSE
4852,14-02-2021 08:00,24 hrs.,wallstreetbets,EGO,57,57,0,57,1,15,23,1,NYSE
4852,14-02-2021 08:00,24 hrs.,wallstreetbets,EOS,7,0,7,-7,1,1,1,1,NYSE
4852,14-02-2021 08:00,24 hrs.,wallstreetbets,EOT,7,0,7,-7,1,1,1,1,NYSE
4852,14-02-2021 08:00,24 hrs.,wallstreetbets,EPR,91,91,0,91,1,22,43,1,NYSE
4852,14-02-2021 08:00,24 hrs.,wallstreetbets,ETN,7,0,7,-7,1,1,1,1,NYSE
4852,14-02-2021 08:00,24 hrs.,wallstreetbets,EXR,107,107,0,107,1,17,69,1,NYSE
4852,14-02-2021 08:00,24 hrs.,wallstreetbets,FCX,419,0,419,-419,1,156,103,1,NYSE
4852,14-02-2021 08:00,24 hrs.,wallstreetbets,FSR,3975,6,3969,-3963,4,1798,363,4,NYSE
4852,14-02-2021 08:00,24 hrs.,wallstreetbets,FUN,7,0,7,-7,1,1,1,1,NYSE
4852,14-02-2021 08:00,24 hrs.,wallstreetbets,GEO,7,0,7,-7,1,1,1,1,NYSE
4852,14-02-2021 08:00,24 hrs.,wallstreetbets,GME,45476,6794,38682,-31888,220,19977,4642,165,NYSE
4852,14-02-2021 08:00,24 hrs.,wallstreetbets,GNW,6,6,0,6,1,1,0,1,NYSE
4852,14-02-2021 08:00,24 hrs.,wallstreetbets,GSX,7,0,7,-7,1,1,1,1,NYSE
4852,14-02-2021 08:00,24 hrs.,wallstreetbets,HMI,27,27,0,27,4,4,3,1,NYSE
4852,14-02-2021 08:00,24 hrs.,wallstreetbets,IBM,2137,0,2137,-2137,3,965,195,3,NYSE
4852,14-02-2021 08:00,24 hrs.,wallstreetbets,IGT,1191,0,1191,-1191,1,560,67,1,NYSE
4852,14-02-2021 08:00,24 hrs.,wallstreetbets,IRL,7,7,0,7,1,1,1,1,NYSE
4852,14-02-2021 08:00,24 hrs.,wallstreetbets,KOS,17,17,0,17,1,4,5,1,NYSE
4852,14-02-2021 08:00,24 hrs.,wallstreetbets,LOW,19,19,0,19,3,3,1,2,NYSE
4852,14-02-2021 08:00,24 hrs.,wallstreetbets,LPL,1191,0,1191,-1191,1,560,67,1,NYSE
4852,14-02-2021 08:00,24 hrs.,wallstreetbets,LTC,35,21,14,7,5,5,5,4,NYSE
4852,14-02-2021 08:00,24 hrs.,wallstreetbets,LZB,177,0,177,-177,1,68,37,1,NYSE
4852,14-02-2021 08:00,24 hrs.,wallstreetbets,MFA,7,0,7,-7,1,1,1,1,NYSE
4852,14-02-2021 08:00,24 hrs.,wallstreetbets,MOS,177,0,177,-177,1,68,37,1,NYSE
4852,14-02-2021 08:00,24 hrs.,wallstreetbets,MRO,16,16,0,16,1,1,10,1,NYSE
4852,14-02-2021 08:00,24 hrs.,wallstreetbets,MTD,1191,0,1191,-1191,1,560,67,1,NYSE
4852,14-02-2021 08:00,24 hrs.,wallstreetbets,NET,4337,0,4337,-4337,3,1924,477,3,NYSE
4852,14-02-2021 08:00,24 hrs.,wallstreetbets,NXTTF,13,0,13,-13,2,2,1,2,OTC
4852,14-02-2021 08:00,24 hrs.,wallstreetbets,RECAF,13,7,6,1,2,2,1,2,OTC
4852,14-02-2021 08:00,24 hrs.,wallstreetbets,RLLCF,6,6,0,6,1,1,0,1,OTC
4852,14-02-2021 08:00,24 hrs.,wallstreetbets,RWBYF,7,0,7,-7,1,1,1,1,OTC
4852,14-02-2021 08:00,24 hrs.,wallstreetbets,RYCEY,13,6,7,-1,2,2,1,2,OTC
4852,14-02-2021 08:00,24 hrs.,wallstreetbets,TAKOF,6,6,0,6,1,1,0,1,OTC
4852,14-02-2021 08:00,24 hrs.,wallstreetbets,TCNNF,6,0,6,-6,1,1,0,1,OTC
4852,14-02-2021 08:00,24 hrs.,wallstreetbets,TOWTF,12,0,12,-12,2,2,0,1,OTC
4852,14-02-2021 08:00,24 hrs.,wallstreetbets,VLNCF,14,0,14,-14,1,0,10,1,OTC
4852,14-02-2021 08:00,24 hrs.,wallstreetbets,VRYYF,7,0,7,-7,1,1,1,1,OTC
4852,14-02-2021 08:00,24 hrs.,wallstreetbets,XJNGF,6,0,6,-6,1,1,0,1,OTC
4852,14-02-2021 08:00,24 hrs.,wallstreetbets,APT,7,7,0,7,1,1,1,1,AMEX
4852,14-02-2021 08:00,24 hrs.,wallstreetbets,DNN,41,13,28,-15,6,6,5,5,AMEX
4852,14-02-2021 08:00,24 hrs.,wallstreetbets,GDP,154,154,0,154,1,57,36,1,AMEX
4852,14-02-2021 08:00,24 hrs.,wallstreetbets,GSV,6,6,0,6,1,1,0,1,AMEX
4852,14-02-2021 08:00,24 hrs.,wallstreetbets,ITP,6,6,0,6,1,1,0,1,AMEX
4852,14-02-2021 08:00,24 hrs.,wallstreetbets,MCF,7,0,7,-7,1,1,1,1,AMEX
4852,14-02-2021 08:00,24 hrs.,wallstreetbets,MXC,7,0,7,-7,1,1,1,1,AMEX
4852,14-02-2021 08:00,24 hrs.,wallstreetbets,NBA,7,7,0,7,1,1,1,1,AMEX
4852,14-02-2021 08:00,24 hrs.,wallstreetbets,NBY,6,0,6,-6,1,1,0,1,AMEX
4852,14-02-2021 08:00,24 hrs.,wallstreetbets,NTN,7,7,0,7,1,1,1,1,AMEX
4852,14-02-2021 08:00,24 hrs.,wallstreetbets,REI,6,0,6,-6,1,1,0,1,AMEX
4852,14-02-2021 08:00,24 hrs.,wallstreetbets,SSY,6,6,0,6,1,1,0,1,AMEX
4852,14-02-2021 08:00,24 hrs.,wallstreetbets,TRX,19,13,6,7,3,3,1,3,AMEX
4852,14-02-2021 08:00,24 hrs.,wallstreetbets,ZOM,60,33,27,6,9,9,6,9,AMEX
4852,14-02-2021 08:00,24 hrs.,wallstreetbets,GOED,6,0,6,-6,1,1,0,1,AMEX
4852,14-02-2021 08:00,24 hrs.,wallstreetbets,IBIO,21,14,7,7,3,3,3,3,AMEX
4852,14-02-2021 08:00,24 hrs.,wallstreetbets,SENS,13,0,13,-13,2,2,1,2,AMEX
4852,14-02-2021 08:00,24 hrs.,wallstreetbets,TRXC,27,27,0,27,4,4,3,2,AMEX
4852,14-02-2021 08:00,24 hrs.,wallstreetbets,UAVS,20,0,20,-20,3,3,2,2,AMEX
4852,14-02-2021 08:00,24 hrs.,wallstreetbets,XXII,7,7,0,7,1,1,1,1,AMEX
4852,14-02-2021 08:00,24 hrs.,wallstreetbets,AAP,1368,0,1368,-1368,2,628,104,2,NYSE
4852,14-02-2021 08:00,24 hrs.,wallstreetbets,ABT,6,6,0,6,1,1,0,1,NYSE
4852,14-02-2021 08:00,24 hrs.,wallstreetbets,ACB,35,21,14,7,5,5,5,4,NYSE
4852,14-02-2021 08:00,24 hrs.,wallstreetbets,AHT,28,28,0,28,4,4,4,2,NYSE
4852,14-02-2021 08:00,24 hrs.,wallstreetbets,AIN,7,0,7,-7,1,1,1,1,NYSE
4852,14-02-2021 08:00,24 hrs.,wallstreetbets,AMC,669,382,287,95,66,121,163,58,NYSE
4852,14-02-2021 08:00,24 hrs.,wallstreetbets,AMP,7,7,0,7,1,1,1,1,NYSE
4852,14-02-2021 08:00,24 hrs.,wallstreetbets,ATH,391,80,311,-231,2,116,151,2,NYSE
4852,14-02-2021 08:00,24 hrs.,wallstreetbets,AYX,116,116,0,116,1,41,30,1,NYSE
4852,14-02-2021 08:00,24 hrs.,wallstreetbets,BCH,27,27,0,27,4,4,3,4,NYSE
4852,14-02-2021 08:00,24 hrs.,wallstreetbets,BHC,7,7,0,7,1,1,1,1,NYSE
4852,14-02-2021 08:00,24 hrs.,wallstreetbets,BOX,6,6,0,6,1,1,0,1,NYSE
4852,14-02-2021 08:00,24 hrs.,wallstreetbets,BTI,57,57,0,57,1,7,39,1,NYSE
4852,14-02-2021 08:00,24 hrs.,wallstreetbets,BTT,15,8,7,1,2,3,1,2,NYSE
4852,14-02-2021 08:00,24 hrs.,wallstreetbets,BYD,184,0,184,-184,2,69,38,2,NYSE
4852,14-02-2021 08:00,24 hrs.,wallstreetbets,CBD,13,7,6,1,2,2,1,2,NYSE
4852,14-02-2021 08:00,24 hrs.,wallstreetbets,CCL,3963,0,3963,-3963,2,1796,363,2,NYSE
4852,14-02-2021 08:00,24 hrs.,wallstreetbets,CLS,50,50,0,50,1,9,28,1,NYSE
4852,14-02-2021 08:00,24 hrs.,wallstreetbets,CLX,7,7,0,7,1,1,1,1,NYSE
4852,14-02-2021 08:00,24 hrs.,wallstreetbets,CNC,7,7,0,7,1,1,1,1,NYSE
4852,14-02-2021 08:00,24 hrs.,wallstreetbets,COO,12,6,6,0,2,2,0,2,NYSE
4852,14-02-2021 08:00,24 hrs.,wallstreetbets,CVS,1368,0,1368,-1368,2,628,104,2,NYSE
4852,14-02-2021 08:00,24 hrs.,wallstreetbets,CVX,6,6,0,6,1,1,0,1,NYSE
4852,14-02-2021 08:00,24 hrs.,wallstreetbets,DDD,1191,0,1191,-1191,1,560,67,1,NYSE
4852,14-02-2021 08:00,24 hrs.,wallstreetbets,DDS,1191,0,1191,-1191,1,560,67,1,NYSE
4852,14-02-2021 08:00,24 hrs.,wallstreetbets,CXRXF,7,0,7,-7,1,1,1,1,OTC
4852,14-02-2021 08:00,24 hrs.,wallstreetbets,DIGAF,6,0,6,-6,1,1,0,1,OTC
4852,14-02-2021 08:00,24 hrs.,wallstreetbets,GAYMF,13,0,13,-13,2,2,1,2,OTC
4852,14-02-2021 08:00,24 hrs.,wallstreetbets,GGTTF,20,0,20,-20,3,3,2,2,OTC
4852,14-02-2021 08:00,24 hrs.,wallstreetbets,HITIF,20,7,13,-6,3,3,2,3,OTC
4852,14-02-2021 08:00,24 hrs.,wallstreetbets,HTZGQ,6,0,6,-6,1,1,0,1,OTC
4852,14-02-2021 08:00,24 hrs.,wallstreetbets,IMNPQ,7,0,7,-7,1,1,1,1,OTC
4852,14-02-2021 08:00,24 hrs.,wallstreetbets,JROOF,7,7,0,7,1,1,1,1,OTC
4852,14-02-2021 08:00,24 hrs.,wallstreetbets,MMEDF,7,7,0,7,1,1,1,1,OTC
4852,14-02-2021 08:00,24 hrs.,pennystocks,UTSI,24,24,0,24,1,0,20,1,NASDAQ
4852,14-02-2021 08:00,24 hrs.,pennystocks,UXIN,24,24,0,24,1,0,20,1,NASDAQ
4852,14-02-2021 08:00,24 hrs.,pennystocks,VYNE,18,18,0,18,2,1,8,1,NASDAQ
4852,14-02-2021 08:00,24 hrs.,pennystocks,XSPA,24,0,24,-24,4,4,0,3,NASDAQ
4852,14-02-2021 08:00,24 hrs.,pennystocks,YMTX,19,0,19,-19,1,5,5,1,NASDAQ
4852,14-02-2021 08:00,24 hrs.,pennystocks,ZCMD,24,24,0,24,1,0,20,1,NASDAQ
4852,14-02-2021 08:00,24 hrs.,pennystocks,ZKIN,13,0,13,-13,1,0,9,1,NASDAQ
4852,14-02-2021 08:00,24 hrs.,pennystocks,ZSAN,41,35,6,29,2,1,31,2,NASDAQ
4852,14-02-2021 08:00,24 hrs.,wallstreetbets,AABB,14,14,0,14,2,2,2,1,OTC
4852,14-02-2021 08:00,24 hrs.,wallstreetbets,ACRL,6,0,6,-6,1,1,0,1,OTC
4852,14-02-2021 08:00,24 hrs.,wallstreetbets,AITX,21,21,0,21,3,3,3,3,OTC
4852,14-02-2021 08:00,24 hrs.,wallstreetbets,BANT,6,6,0,6,1,1,0,1,OTC
4852,14-02-2021 08:00,24 hrs.,wallstreetbets,BBRW,12,6,6,0,2,2,0,2,OTC
4852,14-02-2021 08:00,24 hrs.,wallstreetbets,BOTY,6,0,6,-6,1,1,0,1,OTC
4852,14-02-2021 08:00,24 hrs.,wallstreetbets,BRLL,7,0,7,-7,1,1,1,1,OTC
4852,14-02-2021 08:00,24 hrs.,wallstreetbets,BRSE,9,9,0,9,1,2,1,1,OTC
4852,14-02-2021 08:00,24 hrs.,wallstreetbets,BRZL,7,0,7,-7,1,1,1,1,OTC
4852,14-02-2021 08:00,24 hrs.,wallstreetbets,CAGR,370,0,370,-370,2,118,126,2,OTC
4852,14-02-2021 08:00,24 hrs.,wallstreetbets,CCTL,7,0,7,-7,1,1,1,1,OTC
4852,14-02-2021 08:00,24 hrs.,wallstreetbets,DKMR,7,7,0,7,1,1,1,1,OTC
4852,14-02-2021 08:00,24 hrs.,wallstreetbets,DRNG,7,7,0,7,1,1,1,1,OTC
4852,14-02-2021 08:00,24 hrs.,wallstreetbets,DROP,6203,6203,0,6203,1,2943,313,1,OTC
4852,14-02-2021 08:00,24 hrs.,wallstreetbets,ECOX,14,14,0,14,2,2,2,1,OTC
4852,14-02-2021 08:00,24 hrs.,wallstreetbets,EFIR,7,0,7,-7,1,1,1,1,OTC
4852,14-02-2021 08:00,24 hrs.,wallstreetbets,FNMA,14,14,0,14,2,2,2,1,OTC
4852,14-02-2021 08:00,24 hrs.,wallstreetbets,GAXY,7,7,0,7,1,1,1,1,OTC
4852,14-02-2021 08:00,24 hrs.,wallstreetbets,GPFT,6,0,6,-6,1,1,0,1,OTC
4852,14-02-2021 08:00,24 hrs.,wallstreetbets,HCMC,177,65,112,-47,26,25,23,20,OTC
4852,14-02-2021 08:00,24 hrs.,wallstreetbets,HEMP,14,0,14,-14,2,2,2,1,OTC
4852,14-02-2021 08:00,24 hrs.,wallstreetbets,IDEA,93,0,93,-93,1,34,21,1,OTC
4852,14-02-2021 08:00,24 hrs.,wallstreetbets,IMTL,6,6,0,6,1,1,0,1,OTC
4852,14-02-2021 08:00,24 hrs.,wallstreetbets,INND,14,0,14,-14,2,2,2,1,OTC
4852,14-02-2021 08:00,24 hrs.,wallstreetbets,IQST,8,8,0,8,1,1,2,1,OTC
4852,14-02-2021 08:00,24 hrs.,wallstreetbets,KGET,7,0,7,-7,1,1,1,1,OTC
4852,14-02-2021 08:00,24 hrs.,wallstreetbets,KWBT,6,6,0,6,1,1,0,1,OTC
4852,14-02-2021 08:00,24 hrs.,wallstreetbets,LINK,1210,13,1197,-1184,4,563,68,4,OTC
4852,14-02-2021 08:00,24 hrs.,wallstreetbets,MDCN,14,0,14,-14,2,2,2,1,OTC
4852,14-02-2021 08:00,24 hrs.,wallstreetbets,MINE,7,7,0,7,1,1,1,1,OTC
4852,14-02-2021 08:00,24 hrs.,wallstreetbets,MKTY,7,0,7,-7,1,1,1,1,OTC
4852,14-02-2021 08:00,24 hrs.,wallstreetbets,MLFB,7,0,7,-7,1,1,1,1,OTC
4852,14-02-2021 08:00,24 hrs.,wallstreetbets,MOST,1191,0,1191,-1191,1,560,67,1,OTC
4852,14-02-2021 08:00,24 hrs.,wallstreetbets,MRMD,8,0,8,-8,1,1,2,1,OTC
4852,14-02-2021 08:00,24 hrs.,wallstreetbets,MTVX,14,14,0,14,2,2,2,2,OTC
4852,14-02-2021 08:00,24 hrs.,wallstreetbets,NOVC,6,0,6,-6,1,1,0,1,OTC
4852,14-02-2021 08:00,24 hrs.,wallstreetbets,ONCX,7,7,0,7,1,1,1,1,OTC
4852,14-02-2021 08:00,24 hrs.,wallstreetbets,PBHG,7,7,0,7,1,1,1,1,OTC
4852,14-02-2021 08:00,24 hrs.,wallstreetbets,PSYC,7,0,7,-7,1,1,1,1,OTC
4852,14-02-2021 08:00,24 hrs.,wallstreetbets,RBDC,7,0,7,-7,1,1,1,1,OTC
4852,14-02-2021 08:00,24 hrs.,wallstreetbets,RBNW,13,13,0,13,2,2,1,2,OTC
4852,14-02-2021 08:00,24 hrs.,wallstreetbets,SANP,28,0,28,-28,4,4,4,1,OTC
4852,14-02-2021 08:00,24 hrs.,wallstreetbets,SGMD,28,7,21,-14,4,4,4,3,OTC
4852,14-02-2021 08:00,24 hrs.,wallstreetbets,SIGN,6,6,0,6,1,1,0,1,OTC
4852,14-02-2021 08:00,24 hrs.,wallstreetbets,SRMX,14,0,14,-14,2,2,2,1,OTC
4852,14-02-2021 08:00,24 hrs.,wallstreetbets,USPS,3962,6,3956,-3950,2,1796,362,2,OTC
4852,14-02-2021 08:00,24 hrs.,wallstreetbets,WGNR,8,0,8,-8,1,1,2,1,OTC
4852,14-02-2021 08:00,24 hrs.,wallstreetbets,WHEN,13,13,0,13,2,2,1,2,OTC
4852,14-02-2021 08:00,24 hrs.,wallstreetbets,WWPW,8,8,0,8,1,1,2,1,OTC
4852,14-02-2021 08:00,24 hrs.,wallstreetbets,XFLS,4,0,4,-4,1,0,0,1,OTC
4852,14-02-2021 08:00,24 hrs.,wallstreetbets,AAZZF,13,13,0,13,2,2,1,1,OTC
4852,14-02-2021 08:00,24 hrs.,wallstreetbets,AGFAF,14,7,7,0,2,2,2,2,OTC
4852,14-02-2021 08:00,24 hrs.,wallstreetbets,ARBKF,7,7,0,7,1,1,1,1,OTC
4852,14-02-2021 08:00,24 hrs.,wallstreetbets,BABYF,7,0,7,-7,1,1,1,1,OTC
4852,14-02-2021 08:00,24 hrs.,wallstreetbets,BDRBF,7,0,7,-7,1,1,1,1,OTC
4852,14-02-2021 08:00,24 hrs.,wallstreetbets,CNTRF,8,8,0,8,1,1,2,1,OTC
4852,14-02-2021 08:00,24 hrs.,pennystocks,SXTC,24,24,0,24,1,0,20,1,NASDAQ
4852,14-02-2021 08:00,24 hrs.,pennystocks,TANH,24,24,0,24,1,0,20,1,NASDAQ
4852,14-02-2021 08:00,24 hrs.,pennystocks,TAOP,24,24,0,24,1,0,20,1,NASDAQ
4852,14-02-2021 08:00,24 hrs.,pennystocks,TEDU,24,24,0,24,1,0,20,1,NASDAQ
4852,14-02-2021 08:00,24 hrs.,pennystocks,TLRY,698,698,0,698,1,279,136,1,NASDAQ
4852,14-02-2021 08:00,24 hrs.,pennystocks,TNXP,82,70,12,58,5,22,18,5,NASDAQ
4852,14-02-2021 08:00,24 hrs.,pennystocks,TOPS,35,35,0,35,1,14,3,1,NASDAQ
4852,14-02-2021 08:00,24 hrs.,pennystocks,TOUR,24,24,0,24,1,0,20,1,NASDAQ
4852,14-02-2021 08:00,24 hrs.,pennystocks,TRIP,32,0,32,-32,1,8,12,1,NASDAQ
4852,14-02-2021 08:00,24 hrs.,pennystocks,TRVG,48,35,13,22,3,16,4,3,NASDAQ
4852,14-02-2021 08:00,24 hrs.,pennystocks,TXMD,7,7,0,7,1,1,1,1,NASDAQ
4852,14-02-2021 08:00,24 hrs.,pennystocks,TYHT,24,24,0,24,1,0,20,1,NASDAQ
4852,14-02-2021 08:00,24 hrs.,pennystocks,USWS,6,6,0,6,1,1,0,1,NASDAQ
4841,14-02-2021 06:00,24 hrs.,StockMarket,NCNO,77,0,77,-77,1,34,5,1,NASDAQ
4841,14-02-2021 06:00,24 hrs.,StockMarket,NOVN,6,0,6,-6,1,1,0,1,NASDAQ
4841,14-02-2021 06:00,24 hrs.,StockMarket,ROKU,77,0,77,-77,1,34,5,1,NASDAQ
4841,14-02-2021 06:00,24 hrs.,StockMarket,SEDG,77,0,77,-77,1,34,5,1,NASDAQ
4841,14-02-2021 06:00,24 hrs.,StockMarket,SNBR,77,0,77,-77,1,34,5,1,NASDAQ
4841,14-02-2021 06:00,24 hrs.,StockMarket,NXTTF,12,0,12,-12,2,2,0,1,OTC
4841,14-02-2021 06:00,24 hrs.,StockMarket,PYNKF,7,7,0,7,1,1,1,1,OTC
4841,14-02-2021 06:00,24 hrs.,StockMarket,XJNGF,16,0,16,-16,1,0,12,1,OTC
4841,14-02-2021 06:00,24 hrs.,StockMarket,DNN,28,28,0,28,1,9,6,1,AMEX
4841,14-02-2021 06:00,24 hrs.,StockMarket,MXC,9,0,9,-9,1,0,5,1,AMEX
4841,14-02-2021 06:00,24 hrs.,StockMarket,ZOM,6,0,6,-6,1,1,0,1,AMEX
4841,14-02-2021 06:00,24 hrs.,StockMarket,AAP,77,0,77,-77,1,34,5,1,NYSE
4841,14-02-2021 06:00,24 hrs.,StockMarket,AMC,74,74,0,74,5,21,12,5,NYSE
4841,14-02-2021 06:00,24 hrs.,StockMarket,ASX,9,0,9,-9,1,0,5,1,NYSE
4841,14-02-2021 06:00,24 hrs.,StockMarket,BKI,77,0,77,-77,1,34,5,1,NYSE
4841,14-02-2021 06:00,24 hrs.,StockMarket,CBD,12,0,12,-12,1,1,6,1,NYSE
4841,14-02-2021 06:00,24 hrs.,StockMarket,CMA,6,0,6,-6,1,1,0,1,NYSE
4841,14-02-2021 06:00,24 hrs.,StockMarket,CMO,243,0,243,-243,1,117,5,1,NYSE
4841,14-02-2021 06:00,24 hrs.,StockMarket,CVS,77,0,77,-77,1,34,5,1,NYSE
4841,14-02-2021 06:00,24 hrs.,StockMarket,DDD,77,0,77,-77,1,34,5,1,NYSE
4841,14-02-2021 06:00,24 hrs.,StockMarket,DDS,77,0,77,-77,1,34,5,1,NYSE
4841,14-02-2021 06:00,24 hrs.,StockMarket,ECL,77,0,77,-77,1,34,5,1,NYSE
4841,14-02-2021 06:00,24 hrs.,StockMarket,FIX,4,0,4,-4,1,0,0,1,NYSE
4841,14-02-2021 06:00,24 hrs.,StockMarket,GME,87,10,77,-67,3,34,7,3,NYSE
4841,14-02-2021 06:00,24 hrs.,StockMarket,HLT,77,0,77,-77,1,34,5,1,NYSE
4841,14-02-2021 06:00,24 hrs.,StockMarket,IGT,77,0,77,-77,1,34,5,1,NYSE
4841,14-02-2021 06:00,24 hrs.,StockMarket,JNJ,12,0,12,-12,1,1,6,1,NYSE
4841,14-02-2021 06:00,24 hrs.,StockMarket,LPL,77,0,77,-77,1,34,5,1,NYSE
4841,14-02-2021 06:00,24 hrs.,StockMarket,LPX,77,0,77,-77,1,34,5,1,NYSE
4841,14-02-2021 06:00,24 hrs.,StockMarket,MRO,77,0,77,-77,1,34,5,1,NYSE
4841,14-02-2021 06:00,24 hrs.,StockMarket,MTD,77,0,77,-77,1,34,5,1,NYSE
4841,14-02-2021 06:00,24 hrs.,StockMarket,NET,6,0,6,-6,1,1,0,1,NYSE
4841,14-02-2021 06:00,24 hrs.,StockMarket,NVS,12,0,12,-12,1,1,6,1,NYSE
4841,14-02-2021 06:00,24 hrs.,StockMarket,OXY,77,0,77,-77,1,34,5,1,NYSE
4841,14-02-2021 06:00,24 hrs.,StockMarket,PEG,160,160,0,160,1,73,10,1,NYSE
4841,14-02-2021 06:00,24 hrs.,StockMarket,PMO,12,0,12,-12,2,2,0,1,NYSE
4841,14-02-2021 06:00,24 hrs.,StockMarket,RNG,77,0,77,-77,1,34,5,1,NYSE
4841,14-02-2021 06:00,24 hrs.,StockMarket,RSI,160,160,0,160,1,73,10,1,NYSE
4841,14-02-2021 06:00,24 hrs.,Daytrading,GTE,7,0,7,-7,1,1,1,1,AMEX
4841,14-02-2021 06:00,24 hrs.,Daytrading,MSN,17,17,0,17,1,2,9,1,AMEX
4841,14-02-2021 06:00,24 hrs.,Daytrading,AMC,5,5,0,5,1,0,1,1,NYSE
4841,14-02-2021 06:00,24 hrs.,Daytrading,GME,69,69,0,69,2,18,25,2,NYSE
4841,14-02-2021 06:00,24 hrs.,Daytrading,IRS,13,13,0,13,1,1,7,1,NYSE
4841,14-02-2021 06:00,24 hrs.,Daytrading,NIO,12,0,12,-12,1,2,4,1,NYSE
4841,14-02-2021 06:00,24 hrs.,Daytrading,PDT,25,25,0,25,3,2,9,2,NYSE
4841,14-02-2021 06:00,24 hrs.,Daytrading,TWO,6,6,0,6,1,1,0,1,NYSE
4841,14-02-2021 06:00,24 hrs.,Daytrading,DUO,6,6,0,6,1,1,0,1,NASDAQ
4841,14-02-2021 06:00,24 hrs.,Daytrading,AAPL,12,0,12,-12,1,2,4,1,NASDAQ
4841,14-02-2021 06:00,24 hrs.,Daytrading,SNDL,43,0,43,-43,1,7,25,1,NASDAQ
4841,14-02-2021 06:00,24 hrs.,Daytrading,TRMD,6,6,0,6,1,1,0,1,NASDAQ
4841,14-02-2021 06:00,24 hrs.,StockMarket,BOTH,9,0,9,-9,1,0,5,1,OTC
4841,14-02-2021 06:00,24 hrs.,StockMarket,BOTY,8,0,8,-8,1,1,2,1,OTC
4841,14-02-2021 06:00,24 hrs.,StockMarket,COMS,13,13,0,13,1,1,7,1,OTC
4841,14-02-2021 06:00,24 hrs.,StockMarket,GBTC,16,0,16,-16,3,1,2,1,OTC
4841,14-02-2021 06:00,24 hrs.,StockMarket,HRBR,6,6,0,6,1,1,0,1,OTC
4841,14-02-2021 06:00,24 hrs.,StockMarket,LINK,77,0,77,-77,1,34,5,1,OTC
4841,14-02-2021 06:00,24 hrs.,StockMarket,LRDR,6,6,0,6,1,1,0,1,OTC
4841,14-02-2021 06:00,24 hrs.,StockMarket,MOST,77,0,77,-77,1,34,5,1,OTC
4841,14-02-2021 06:00,24 hrs.,StockMarket,SGMD,8,8,0,8,1,2,0,1,OTC
4841,14-02-2021 06:00,24 hrs.,StockMarket,AMKBY,21,21,0,21,1,6,5,1,OTC
4841,14-02-2021 06:00,24 hrs.,StockMarket,CADMF,6,0,6,-6,1,1,0,1,OTC
4841,14-02-2021 06:00,24 hrs.,StockMarket,EMHTF,11,11,0,11,1,3,1,1,OTC
4841,14-02-2021 06:00,24 hrs.,pennystocks,PUGE,153,0,153,-153,1,42,65,1,OTC
4841,14-02-2021 06:00,24 hrs.,StockMarket,SNDL,11,5,6,-1,2,1,1,2,NASDAQ
4841,14-02-2021 06:00,24 hrs.,StockMarket,SPWR,77,0,77,-77,1,34,5,1,NASDAQ
4841,14-02-2021 06:00,24 hrs.,StockMarket,STMP,77,0,77,-77,1,34,5,1,NASDAQ
4841,14-02-2021 06:00,24 hrs.,StockMarket,TEAM,12,0,12,-12,1,1,6,1,NASDAQ
4841,14-02-2021 06:00,24 hrs.,StockMarket,THCB,38,38,0,38,1,13,8,1,NASDAQ
4841,14-02-2021 06:00,24 hrs.,StockMarket,TLRY,88,11,77,-66,3,35,6,3,NASDAQ
4841,14-02-2021 06:00,24 hrs.,StockMarket,TRCH,13,13,0,13,1,1,7,1,NASDAQ
4841,14-02-2021 06:00,24 hrs.,StockMarket,TREE,77,0,77,-77,1,34,5,1,NASDAQ
4841,14-02-2021 06:00,24 hrs.,StockMarket,TSEM,77,0,77,-77,1,34,5,1,NASDAQ
4841,14-02-2021 06:00,24 hrs.,StockMarket,VXRT,21,21,0,21,1,0,17,1,NASDAQ
4841,14-02-2021 06:00,24 hrs.,StockMarket,WING,77,0,77,-77,1,34,5,1,NASDAQ
4841,14-02-2021 06:00,24 hrs.,StockMarket,XONE,16,0,16,-16,3,1,2,1,NASDAQ
4841,14-02-2021 06:00,24 hrs.,StockMarket,YNDX,77,0,77,-77,1,34,5,1,NASDAQ
4841,14-02-2021 06:00,24 hrs.,StockMarket,SKT,77,0,77,-77,1,34,5,1,NYSE
4841,14-02-2021 06:00,24 hrs.,StockMarket,SOS,6,0,6,-6,1,1,0,1,NYSE
4841,14-02-2021 06:00,24 hrs.,StockMarket,THC,12,0,12,-12,1,1,6,1,NYSE
4841,14-02-2021 06:00,24 hrs.,StockMarket,TRU,77,0,77,-77,1,34,5,1,NYSE
4841,14-02-2021 06:00,24 hrs.,StockMarket,VMC,77,0,77,-77,1,34,5,1,NYSE
4841,14-02-2021 06:00,24 hrs.,StockMarket,WMT,77,0,77,-77,1,34,5,1,NYSE
4841,14-02-2021 06:00,24 hrs.,StockMarket,ZTS,77,0,77,-77,1,34,5,1,NYSE
4841,14-02-2021 06:00,24 hrs.,StockMarket,ABBV,12,0,12,-12,1,1,6,1,NYSE
4841,14-02-2021 06:00,24 hrs.,StockMarket,CCIV,6,0,6,-6,1,1,0,1,NYSE
4841,14-02-2021 06:00,24 hrs.,StockMarket,FSLY,77,0,77,-77,1,34,5,1,NYSE
4841,14-02-2021 06:00,24 hrs.,StockMarket,FVRR,77,0,77,-77,1,34,5,1,NYSE
4841,14-02-2021 06:00,24 hrs.,StockMarket,LGVW,16,0,16,-16,3,1,2,1,NYSE
4841,14-02-2021 06:00,24 hrs.,StockMarket,PLTR,77,0,77,-77,1,34,5,1,NYSE
4841,14-02-2021 06:00,24 hrs.,StockMarket,PSTH,6,0,6,-6,1,1,0,1,NYSE
4841,14-02-2021 06:00,24 hrs.,StockMarket,PUMP,6,0,6,-6,1,1,0,1,NYSE
4841,14-02-2021 06:00,24 hrs.,StockMarket,SHOP,77,0,77,-77,1,34,5,1,NYSE
4841,14-02-2021 06:00,24 hrs.,StockMarket,TRTN,77,0,77,-77,1,34,5,1,NYSE
4841,14-02-2021 06:00,24 hrs.,StockMarket,TWLO,77,0,77,-77,1,34,5,1,NYSE
4841,14-02-2021 06:00,24 hrs.,StockMarket,USFD,77,0,77,-77,1,34,5,1,NYSE
4841,14-02-2021 06:00,24 hrs.,StockMarket,ADI,77,0,77,-77,1,34,5,1,NASDAQ
4841,14-02-2021 06:00,24 hrs.,StockMarket,BLI,77,0,77,-77,1,34,5,1,NASDAQ
4841,14-02-2021 06:00,24 hrs.,StockMarket,DBX,77,0,77,-77,1,34,5,1,NASDAQ
4841,14-02-2021 06:00,24 hrs.,StockMarket,FOX,13,13,0,13,1,1,7,1,NASDAQ
4841,14-02-2021 06:00,24 hrs.,StockMarket,QQQ,9,0,9,-9,1,0,5,1,NASDAQ
4841,14-02-2021 06:00,24 hrs.,StockMarket,TTD,77,0,77,-77,1,34,5,1,NASDAQ
4841,14-02-2021 06:00,24 hrs.,StockMarket,UFO,19,19,0,19,1,4,7,1,NASDAQ
4841,14-02-2021 06:00,24 hrs.,StockMarket,WIX,77,0,77,-77,1,34,5,1,NASDAQ
4841,14-02-2021 06:00,24 hrs.,StockMarket,WNW,6,0,6,-6,1,1,0,1,NASDAQ
4841,14-02-2021 06:00,24 hrs.,StockMarket,AAPL,160,160,0,160,1,73,10,1,NASDAQ
4841,14-02-2021 06:00,24 hrs.,StockMarket,AKER,6,0,6,-6,1,1,0,1,NASDAQ
4841,14-02-2021 06:00,24 hrs.,StockMarket,AMAT,77,0,77,-77,1,34,5,1,NASDAQ
4841,14-02-2021 06:00,24 hrs.,StockMarket,AMGN,12,0,12,-12,1,1,6,1,NASDAQ
4841,14-02-2021 06:00,24 hrs.,StockMarket,AMZN,55,55,0,55,1,15,21,1,NASDAQ
4841,14-02-2021 06:00,24 hrs.,StockMarket,ATNF,12,0,12,-12,1,1,6,1,NASDAQ
4841,14-02-2021 06:00,24 hrs.,StockMarket,BIDU,77,0,77,-77,1,34,5,1,NASDAQ
4841,14-02-2021 06:00,24 hrs.,StockMarket,BIGC,77,0,77,-77,1,34,5,1,NASDAQ
4841,14-02-2021 06:00,24 hrs.,StockMarket,CLIR,6,6,0,6,1,1,0,1,NASDAQ
4841,14-02-2021 06:00,24 hrs.,StockMarket,CLVS,77,0,77,-77,1,34,5,1,NASDAQ
4841,14-02-2021 06:00,24 hrs.,StockMarket,CPLP,12,12,0,12,1,3,2,1,NASDAQ
4841,14-02-2021 06:00,24 hrs.,StockMarket,CTRM,6,6,0,6,1,1,0,1,NASDAQ
4841,14-02-2021 06:00,24 hrs.,StockMarket,EXPD,77,0,77,-77,1,34,5,1,NASDAQ
4841,14-02-2021 06:00,24 hrs.,StockMarket,FIZZ,77,0,77,-77,1,34,5,1,NASDAQ
4841,14-02-2021 06:00,24 hrs.,StockMarket,GOGO,77,0,77,-77,1,34,5,1,NASDAQ
4841,14-02-2021 06:00,24 hrs.,StockMarket,GOLD,77,0,77,-77,1,34,5,1,NASDAQ
4841,14-02-2021 06:00,24 hrs.,StockMarket,GTHX,6,0,6,-6,1,1,0,1,NASDAQ
4841,14-02-2021 06:00,24 hrs.,StockMarket,HTBX,12,6,6,0,2,2,0,2,NASDAQ
4841,14-02-2021 06:00,24 hrs.,StockMarket,ITRM,13,13,0,13,1,1,7,1,NASDAQ
4841,14-02-2021 06:00,24 hrs.,StockMarket,KLIC,24,0,24,-24,1,7,6,1,NASDAQ
4841,14-02-2021 06:00,24 hrs.,StockMarket,LGND,77,0,77,-77,1,34,5,1,NASDAQ
4841,14-02-2021 06:00,24 hrs.,StockMarket,NBIX,12,0,12,-12,1,1,6,1,NASDAQ
4841,14-02-2021 06:00,24 hrs.,pennystocks,SNPW,135,76,59,17,3,37,49,3,OTC
4841,14-02-2021 06:00,24 hrs.,pennystocks,ABML,24,0,24,-24,4,4,0,1,OTC
4841,14-02-2021 06:00,24 hrs.,pennystocks,ACRL,49,49,0,49,3,12,13,3,OTC
4841,14-02-2021 06:00,24 hrs.,pennystocks,AITX,96,66,30,36,3,36,12,3,OTC
4841,14-02-2021 06:00,24 hrs.,pennystocks,ALYI,77,77,0,77,2,14,41,2,OTC
4841,14-02-2021 06:00,24 hrs.,pennystocks,AMAZ,6,0,6,-6,1,1,0,1,OTC
4841,14-02-2021 06:00,24 hrs.,pennystocks,AMNE,13,13,0,13,2,2,1,1,OTC
4841,14-02-2021 06:00,24 hrs.,pennystocks,ASTI,167,167,0,167,2,58,43,2,OTC
4841,14-02-2021 06:00,24 hrs.,pennystocks,ATVK,55,55,0,55,2,15,17,2,OTC
4841,14-02-2021 06:00,24 hrs.,pennystocks,BANT,6,6,0,6,1,1,0,1,OTC
4841,14-02-2021 06:00,24 hrs.,pennystocks,BIEL,6,6,0,6,1,1,0,1,OTC
4841,14-02-2021 06:00,24 hrs.,pennystocks,BNGI,6,6,0,6,1,1,0,1,OTC
4841,14-02-2021 06:00,24 hrs.,pennystocks,BOTY,36,0,36,-36,2,10,8,2,OTC
4841,14-02-2021 06:00,24 hrs.,pennystocks,BRGO,6,0,6,-6,1,1,0,1,OTC
4841,14-02-2021 06:00,24 hrs.,pennystocks,BRRN,10,0,10,-10,1,2,2,1,OTC
4841,14-02-2021 06:00,24 hrs.,pennystocks,BRSE,6,6,0,6,1,1,0,1,OTC
4841,14-02-2021 06:00,24 hrs.,pennystocks,CAFS,7,0,7,-7,1,1,1,1,OTC
4841,14-02-2021 06:00,24 hrs.,pennystocks,CANN,12,6,6,0,2,2,0,2,OTC
4841,14-02-2021 06:00,24 hrs.,pennystocks,CBBT,100,70,30,40,2,22,48,2,OTC
4841,14-02-2021 06:00,24 hrs.,pennystocks,CBDL,30,0,30,-30,1,9,8,1,OTC
4841,14-02-2021 06:00,24 hrs.,pennystocks,CCTL,114,114,0,114,2,28,50,2,OTC
4841,14-02-2021 06:00,24 hrs.,pennystocks,CELZ,6,0,6,-6,1,1,0,1,OTC
4841,14-02-2021 06:00,24 hrs.,pennystocks,CLIS,18,18,0,18,2,3,4,1,OTC
4841,14-02-2021 06:00,24 hrs.,pennystocks,CTLE,31,0,31,-31,5,5,1,2,OTC
4841,14-02-2021 06:00,24 hrs.,pennystocks,DIGI,51,0,51,-51,1,19,9,1,OTC
4841,14-02-2021 06:00,24 hrs.,pennystocks,DPLS,26,0,26,-26,1,6,10,1,OTC
4841,14-02-2021 06:00,24 hrs.,pennystocks,DRNK,6,6,0,6,1,1,0,1,OTC
4841,14-02-2021 06:00,24 hrs.,pennystocks,DXLG,35,35,0,35,1,14,3,1,OTC
4841,14-02-2021 06:00,24 hrs.,pennystocks,ECEZ,7,7,0,7,1,1,1,1,OTC
4841,14-02-2021 06:00,24 hrs.,pennystocks,ECOX,7,7,0,7,1,1,1,1,OTC
4841,14-02-2021 06:00,24 hrs.,pennystocks,EMED,12,12,0,12,2,2,0,1,OTC
4841,14-02-2021 06:00,24 hrs.,pennystocks,ENZC,70,70,0,70,1,13,40,1,OTC
4841,14-02-2021 06:00,24 hrs.,pennystocks,EWLL,7,7,0,7,1,1,1,1,OTC
4841,14-02-2021 06:00,24 hrs.,pennystocks,GAXY,26,0,26,-26,1,6,10,1,OTC
4841,14-02-2021 06:00,24 hrs.,pennystocks,GLFH,28,28,0,28,1,5,14,1,OTC
4841,14-02-2021 06:00,24 hrs.,pennystocks,GRCV,7,0,7,-7,1,1,1,1,OTC
4841,14-02-2021 06:00,24 hrs.,pennystocks,GRSO,7,0,7,-7,1,1,1,1,OTC
4841,14-02-2021 06:00,24 hrs.,pennystocks,GTEH,67,67,0,67,1,9,45,1,OTC
4841,14-02-2021 06:00,24 hrs.,pennystocks,HALB,29,0,29,-29,1,8,9,1,OTC
4841,14-02-2021 06:00,24 hrs.,pennystocks,HCMC,97,60,37,23,16,15,3,14,OTC
4841,14-02-2021 06:00,24 hrs.,pennystocks,HPIL,13,13,0,13,2,2,1,1,OTC
4841,14-02-2021 06:00,24 hrs.,pennystocks,HPMM,7,7,0,7,1,1,1,1,OTC
4841,14-02-2021 06:00,24 hrs.,pennystocks,HQGE,6,6,0,6,1,1,0,1,OTC
4841,14-02-2021 06:00,24 hrs.,pennystocks,ICNM,7,0,7,-7,1,1,1,1,OTC
4841,14-02-2021 06:00,24 hrs.,pennystocks,ICTY,6,0,6,-6,1,1,0,1,OTC
4841,14-02-2021 06:00,24 hrs.,pennystocks,IGEN,23,0,23,-23,2,3,9,2,OTC
4841,14-02-2021 06:00,24 hrs.,pennystocks,ILUS,48,48,0,48,1,19,6,1,OTC
4841,14-02-2021 06:00,24 hrs.,pennystocks,INKW,6,0,6,-6,1,1,0,1,OTC
4841,14-02-2021 06:00,24 hrs.,pennystocks,INND,653,21,632,-611,4,273,91,4,OTC
4841,14-02-2021 06:00,24 hrs.,pennystocks,KGET,6,6,0,6,1,1,0,1,OTC
4841,14-02-2021 06:00,24 hrs.,pennystocks,KULR,48,48,0,48,1,14,16,1,OTC
4841,14-02-2021 06:00,24 hrs.,pennystocks,KYNC,6,6,0,6,1,1,0,1,OTC
4841,14-02-2021 06:00,24 hrs.,pennystocks,LATF,8,8,0,8,1,1,2,1,OTC
4841,14-02-2021 06:00,24 hrs.,pennystocks,LTNC,41,41,0,41,1,0,37,1,OTC
4841,14-02-2021 06:00,24 hrs.,pennystocks,MAXD,31,0,31,-31,1,6,15,1,OTC
4841,14-02-2021 06:00,24 hrs.,pennystocks,MINE,67,67,0,67,1,9,45,1,OTC
4841,14-02-2021 06:00,24 hrs.,pennystocks,MJNA,86,23,63,-40,3,21,32,2,OTC
4841,14-02-2021 06:00,24 hrs.,pennystocks,MLFB,17,17,0,17,1,4,5,1,OTC
4841,14-02-2021 06:00,24 hrs.,pennystocks,MSPC,6,0,6,-6,1,1,0,1,OTC
4841,14-02-2021 06:00,24 hrs.,pennystocks,NSPT,23,0,23,-23,1,3,13,1,OTC
4841,14-02-2021 06:00,24 hrs.,pennystocks,NSPX,6,0,6,-6,1,1,0,1,OTC
4841,14-02-2021 06:00,24 hrs.,pennystocks,NTRR,6,6,0,6,1,1,0,1,OTC
4841,14-02-2021 06:00,24 hrs.,pennystocks,OPTI,45,45,0,45,2,10,17,2,OTC
4841,14-02-2021 06:00,24 hrs.,pennystocks,OZSC,240,7,233,-226,3,97,34,3,OTC
4841,14-02-2021 06:00,24 hrs.,pennystocks,NGL,3737,3737,0,3737,2,1796,137,2,NYSE
4841,14-02-2021 06:00,24 hrs.,pennystocks,NOK,238,0,238,-238,1,88,58,1,NYSE
4841,14-02-2021 06:00,24 hrs.,pennystocks,NYC,13,0,13,-13,1,0,9,1,NYSE
4841,14-02-2021 06:00,24 hrs.,pennystocks,PDT,95,40,55,-15,3,26,31,3,NYSE
4841,14-02-2021 06:00,24 hrs.,pennystocks,PEG,272,272,0,272,1,118,32,1,NYSE
4841,14-02-2021 06:00,24 hrs.,pennystocks,PKG,45,0,45,-45,1,17,7,1,NYSE
4841,14-02-2021 06:00,24 hrs.,pennystocks,SOBR,6,0,6,-6,1,1,0,1,OTC
4841,14-02-2021 06:00,24 hrs.,pennystocks,SSFT,48,48,0,48,1,14,16,1,OTC
4841,14-02-2021 06:00,24 hrs.,pennystocks,TAUG,15,7,8,-1,2,3,1,2,OTC
4841,14-02-2021 06:00,24 hrs.,pennystocks,TIDE,652,652,0,652,1,259,130,1,OTC
4841,14-02-2021 06:00,24 hrs.,pennystocks,TLSS,76,76,0,76,1,21,30,1,OTC
4841,14-02-2021 06:00,24 hrs.,pennystocks,TSNP,126,67,59,8,2,32,54,2,OTC
4841,14-02-2021 06:00,24 hrs.,pennystocks,TVPC,6,0,6,-6,1,1,0,1,OTC
4841,14-02-2021 06:00,24 hrs.,pennystocks,UAPC,25,0,25,-25,2,1,15,2,OTC
4841,14-02-2021 06:00,24 hrs.,pennystocks,VSPC,24,24,0,24,1,8,4,1,OTC
4841,14-02-2021 06:00,24 hrs.,pennystocks,WEBB,143,143,0,143,1,64,11,1,OTC
4841,14-02-2021 06:00,24 hrs.,pennystocks,WSGF,48,48,0,48,1,14,16,1,OTC
4841,14-02-2021 06:00,24 hrs.,pennystocks,XFLS,4,0,4,-4,1,0,0,1,OTC
4841,14-02-2021 06:00,24 hrs.,pennystocks,XMET,7,7,0,7,1,1,1,1,OTC
4841,14-02-2021 06:00,24 hrs.,pennystocks,YAYO,41,41,0,41,1,11,15,1,OTC
4841,14-02-2021 06:00,24 hrs.,pennystocks,ZMRK,6,6,0,6,1,1,0,1,OTC
4841,14-02-2021 06:00,24 hrs.,pennystocks,ABEPF,6,0,6,-6,1,1,0,1,OTC
4841,14-02-2021 06:00,24 hrs.,pennystocks,AMYZF,48,24,24,0,8,8,0,3,OTC
4841,14-02-2021 06:00,24 hrs.,pennystocks,AQSZF,6,0,6,-6,1,1,0,1,OTC
4841,14-02-2021 06:00,24 hrs.,pennystocks,ARBKF,330,268,62,206,7,91,120,5,OTC
4841,14-02-2021 06:00,24 hrs.,pennystocks,BDRBF,6,6,0,6,1,1,0,1,OTC
4841,14-02-2021 06:00,24 hrs.,pennystocks,BUROF,6,0,6,-6,1,1,0,1,OTC
4841,14-02-2021 06:00,24 hrs.,pennystocks,CINGF,48,48,0,48,1,14,16,1,OTC
4841,14-02-2021 06:00,24 hrs.,pennystocks,CLXPF,238,0,238,-238,1,88,58,1,OTC
4841,14-02-2021 06:00,24 hrs.,pennystocks,COCSF,13,0,13,-13,1,3,3,1,OTC
4841,14-02-2021 06:00,24 hrs.,pennystocks,EMHTF,23,23,0,23,1,6,7,1,OTC
4841,14-02-2021 06:00,24 hrs.,pennystocks,HITIF,911,911,0,911,5,357,177,5,OTC
4841,14-02-2021 06:00,24 hrs.,pennystocks,HTZGQ,6,6,0,6,1,1,0,1,OTC
4841,14-02-2021 06:00,24 hrs.,pennystocks,ICNAF,6,6,0,6,1,1,0,1,OTC
4841,14-02-2021 06:00,24 hrs.,pennystocks,ILHMF,7,7,0,7,1,1,1,1,OTC
4841,14-02-2021 06:00,24 hrs.,pennystocks,ITMPF,12,12,0,12,2,2,0,1,OTC
4841,14-02-2021 06:00,24 hrs.,pennystocks,LTHUQ,30,0,30,-30,1,7,12,1,OTC
4841,14-02-2021 06:00,24 hrs.,pennystocks,LTMCF,6,6,0,6,1,1,0,1,OTC
4841,14-02-2021 06:00,24 hrs.,pennystocks,MMEDF,103,73,30,43,3,19,53,3,OTC
4841,14-02-2021 06:00,24 hrs.,pennystocks,MMNFF,35,35,0,35,1,14,3,1,OTC
4841,14-02-2021 06:00,24 hrs.,pennystocks,MPUCF,7,7,0,7,1,1,1,1,OTC
4841,14-02-2021 06:00,24 hrs.,pennystocks,MSNVF,6,0,6,-6,1,1,0,1,OTC
4841,14-02-2021 06:00,24 hrs.,pennystocks,NMGRF,50,50,0,50,2,17,8,1,OTC
4841,14-02-2021 06:00,24 hrs.,pennystocks,NMTLF,24,0,24,-24,1,8,4,1,OTC
4841,14-02-2021 06:00,24 hrs.,pennystocks,NXTTF,12,6,6,0,2,2,0,2,OTC
4841,14-02-2021 06:00,24 hrs.,pennystocks,PHPYF,7,7,0,7,1,0,3,1,OTC
4841,14-02-2021 06:00,24 hrs.,pennystocks,RLLCF,44,44,0,44,3,6,20,2,OTC
4841,14-02-2021 06:00,24 hrs.,pennystocks,SPRWF,7,7,0,7,1,1,1,1,OTC
4841,14-02-2021 06:00,24 hrs.,pennystocks,TAKOF,95,85,10,75,3,23,37,3,OTC
4841,14-02-2021 06:00,24 hrs.,pennystocks,TLOFF,70,70,0,70,1,13,40,1,OTC
4841,14-02-2021 06:00,24 hrs.,pennystocks,TOWTF,12,0,12,-12,2,2,0,1,OTC
4841,14-02-2021 06:00,24 hrs.,pennystocks,TRUFF,36,6,30,-24,2,8,12,2,OTC
4841,14-02-2021 06:00,24 hrs.,pennystocks,TSCRF,38,38,0,38,1,11,12,1,OTC
4841,14-02-2021 06:00,24 hrs.,pennystocks,PVDG,70,70,0,70,1,13,40,1,OTC
4841,14-02-2021 06:00,24 hrs.,pennystocks,QBAN,7,7,0,7,1,1,1,1,OTC
4841,14-02-2021 06:00,24 hrs.,pennystocks,QMCI,70,70,0,70,1,13,40,1,OTC
4841,14-02-2021 06:00,24 hrs.,pennystocks,RBNW,6,6,0,6,1,1,0,1,OTC
4841,14-02-2021 06:00,24 hrs.,pennystocks,RCRT,26,0,26,-26,1,6,10,1,OTC
4841,14-02-2021 06:00,24 hrs.,pennystocks,RSSV,144,48,96,-48,2,54,28,2,OTC
4841,14-02-2021 06:00,24 hrs.,pennystocks,SGMD,465,52,413,-361,7,155,127,7,OTC
4841,14-02-2021 06:00,24 hrs.,pennystocks,SHMP,7,7,0,7,1,1,1,1,OTC
4841,14-02-2021 06:00,24 hrs.,pennystocks,SING,84,84,0,84,2,23,30,2,OTC
4841,14-02-2021 06:00,24 hrs.,pennystocks,SIRC,62,0,62,-62,2,16,22,2,OTC
4841,14-02-2021 06:00,24 hrs.,pennystocks,SNNC,6,6,0,6,1,1,0,1,OTC
4841,14-02-2021 06:00,24 hrs.,pennystocks,CHNR,24,24,0,24,1,1,18,1,NASDAQ
4841,14-02-2021 06:00,24 hrs.,pennystocks,CJJD,24,24,0,24,1,1,18,1,NASDAQ
4841,14-02-2021 06:00,24 hrs.,pennystocks,CLBS,96,0,96,-96,1,40,12,1,NASDAQ
4841,14-02-2021 06:00,24 hrs.,pennystocks,CLPS,24,24,0,24,1,1,18,1,NASDAQ
4841,14-02-2021 06:00,24 hrs.,pennystocks,CMPS,18,0,18,-18,1,1,12,1,NASDAQ
4841,14-02-2021 06:00,24 hrs.,pennystocks,CNET,24,24,0,24,1,1,18,1,NASDAQ
4841,14-02-2021 06:00,24 hrs.,pennystocks,CREX,33,33,0,33,1,7,15,1,NASDAQ
4841,14-02-2021 06:00,24 hrs.,pennystocks,CSCW,41,41,0,41,3,8,13,3,NASDAQ
4841,14-02-2021 06:00,24 hrs.,pennystocks,CSTR,9,9,0,9,1,0,5,1,NASDAQ
4841,14-02-2021 06:00,24 hrs.,pennystocks,CTRM,410,100,310,-210,8,133,112,8,NASDAQ
4841,14-02-2021 06:00,24 hrs.,pennystocks,CXDC,24,24,0,24,1,1,18,1,NASDAQ
4841,14-02-2021 06:00,24 hrs.,pennystocks,DFFN,71,64,7,57,3,22,15,3,NASDAQ
4841,14-02-2021 06:00,24 hrs.,pennystocks,DOGZ,24,24,0,24,1,1,18,1,NASDAQ
4841,14-02-2021 06:00,24 hrs.,pennystocks,DSWL,24,24,0,24,1,1,18,1,NASDAQ
4841,14-02-2021 06:00,24 hrs.,pennystocks,DTSS,24,24,0,24,1,1,18,1,NASDAQ
4841,14-02-2021 06:00,24 hrs.,pennystocks,RSI,296,296,0,296,2,119,50,2,NYSE
4841,14-02-2021 06:00,24 hrs.,pennystocks,RYB,24,24,0,24,1,1,18,1,NYSE
4841,14-02-2021 06:00,24 hrs.,pennystocks,SOS,1272,289,983,-694,10,444,344,10,NYSE
4841,14-02-2021 06:00,24 hrs.,pennystocks,STG,24,24,0,24,1,1,18,1,NYSE
4841,14-02-2021 06:00,24 hrs.,pennystocks,SUP,35,35,0,35,1,14,3,1,NYSE
4841,14-02-2021 06:00,24 hrs.,pennystocks,THC,39,0,39,-39,1,11,13,1,NYSE
4841,14-02-2021 06:00,24 hrs.,pennystocks,TTM,652,652,0,652,1,259,130,1,NYSE
4841,14-02-2021 06:00,24 hrs.,pennystocks,WEI,24,24,0,24,1,1,18,1,NYSE
4841,14-02-2021 06:00,24 hrs.,pennystocks,XIN,24,24,0,24,1,1,18,1,NYSE
4841,14-02-2021 06:00,24 hrs.,pennystocks,XYF,24,24,0,24,1,1,18,1,NYSE
4841,14-02-2021 06:00,24 hrs.,pennystocks,ARGO,62,0,62,-62,1,22,14,1,NYSE
4841,14-02-2021 06:00,24 hrs.,pennystocks,BORR,7,7,0,7,1,1,1,1,NYSE
4841,14-02-2021 06:00,24 hrs.,pennystocks,CMCM,24,24,0,24,1,1,18,1,NYSE
4841,14-02-2021 06:00,24 hrs.,pennystocks,WALRF,48,48,0,48,1,14,16,1,OTC
4841,14-02-2021 06:00,24 hrs.,pennystocks,BGI,35,35,0,35,1,14,3,1,AMEX
4841,14-02-2021 06:00,24 hrs.,pennystocks,CTO,652,652,0,652,1,259,130,1,AMEX
4841,14-02-2021 06:00,24 hrs.,pennystocks,CVM,6,0,6,-6,1,1,0,1,AMEX
4841,14-02-2021 06:00,24 hrs.,pennystocks,DNN,20,7,13,-6,3,3,2,3,AMEX
4841,14-02-2021 06:00,24 hrs.,pennystocks,DSS,6,0,6,-6,1,1,0,1,AMEX
4841,14-02-2021 06:00,24 hrs.,pennystocks,DXF,24,24,0,24,1,1,18,1,AMEX
4841,14-02-2021 06:00,24 hrs.,pennystocks,GSV,6,6,0,6,1,1,0,1,AMEX
4841,14-02-2021 06:00,24 hrs.,pennystocks,GTE,64,0,64,-64,2,15,26,2,AMEX
4841,14-02-2021 06:00,24 hrs.,pennystocks,ITP,24,24,0,24,1,1,18,1,AMEX
4841,14-02-2021 06:00,24 hrs.,pennystocks,NGD,11,0,11,-11,1,2,3,1,AMEX
4841,14-02-2021 06:00,24 hrs.,pennystocks,NTN,35,35,0,35,1,14,3,1,AMEX
4841,14-02-2021 06:00,24 hrs.,pennystocks,RHE,35,35,0,35,1,14,3,1,AMEX
4841,14-02-2021 06:00,24 hrs.,pennystocks,SYN,7,7,0,7,1,1,1,1,AMEX
4841,14-02-2021 06:00,24 hrs.,pennystocks,ZOM,330,92,238,-146,3,107,104,3,AMEX
4841,14-02-2021 06:00,24 hrs.,pennystocks,AMBO,24,24,0,24,1,1,18,1,AMEX
4841,14-02-2021 06:00,24 hrs.,pennystocks,AMPE,35,35,0,35,1,14,3,1,AMEX
4841,14-02-2021 06:00,24 hrs.,pennystocks,CPHI,44,44,0,44,2,5,26,2,AMEX
4841,14-02-2021 06:00,24 hrs.,pennystocks,NSPR,105,67,38,29,3,17,59,3,AMEX
4841,14-02-2021 06:00,24 hrs.,pennystocks,OGEN,66,0,66,-66,1,26,10,1,AMEX
4841,14-02-2021 06:00,24 hrs.,pennystocks,SENS,37,6,31,-25,2,14,1,2,AMEX
4841,14-02-2021 06:00,24 hrs.,pennystocks,SNMP,21,0,21,-21,1,6,5,1,AMEX
4841,14-02-2021 06:00,24 hrs.,pennystocks,TKAT,24,24,0,24,1,1,18,1,AMEX
4841,14-02-2021 06:00,24 hrs.,pennystocks,TMBR,35,35,0,35,1,14,3,1,AMEX
4841,14-02-2021 06:00,24 hrs.,pennystocks,UAMY,67,67,0,67,1,9,45,1,AMEX
4841,14-02-2021 06:00,24 hrs.,pennystocks,ACB,652,652,0,652,1,259,130,1,NYSE
4841,14-02-2021 06:00,24 hrs.,pennystocks,AMC,78,31,47,-16,2,19,32,2,NYSE
4841,14-02-2021 06:00,24 hrs.,pennystocks,ASX,9,0,9,-9,1,1,3,1,NYSE
4841,14-02-2021 06:00,24 hrs.,pennystocks,CBD,675,675,0,675,2,266,135,2,NYSE
4841,14-02-2021 06:00,24 hrs.,pennystocks,CCM,24,24,0,24,1,1,18,1,NYSE
4841,14-02-2021 06:00,24 hrs.,pennystocks,CNF,24,24,0,24,1,1,18,1,NYSE
4841,14-02-2021 06:00,24 hrs.,pennystocks,DNK,24,24,0,24,1,1,18,1,NYSE
4841,14-02-2021 06:00,24 hrs.,pennystocks,FLT,27,27,0,27,1,6,11,1,NYSE
4841,14-02-2021 06:00,24 hrs.,pennystocks,FSD,12,0,12,-12,1,2,4,1,NYSE
4841,14-02-2021 06:00,24 hrs.,pennystocks,GME,12,6,6,0,2,2,0,2,NYSE
4841,14-02-2021 06:00,24 hrs.,pennystocks,KOF,13,0,13,-13,1,3,3,1,NYSE
4841,14-02-2021 06:00,24 hrs.,pennystocks,PGEN,6,0,6,-6,1,1,0,1,NASDAQ
4841,14-02-2021 06:00,24 hrs.,pennystocks,PHCF,24,24,0,24,1,1,18,1,NASDAQ
4841,14-02-2021 06:00,24 hrs.,pennystocks,PHUN,13,13,0,13,1,0,9,1,NASDAQ
4841,14-02-2021 06:00,24 hrs.,pennystocks,PLAY,6,6,0,6,1,1,0,1,NASDAQ
4841,14-02-2021 06:00,24 hrs.,pennystocks,PLIN,24,24,0,24,1,1,18,1,NASDAQ
4841,14-02-2021 06:00,24 hrs.,pennystocks,EDIT,1228,1079,149,930,3,343,530,3,NASDAQ
4841,14-02-2021 06:00,24 hrs.,pennystocks,EDTK,24,24,0,24,1,1,18,1,NASDAQ
4841,14-02-2021 06:00,24 hrs.,pennystocks,EYES,6,6,0,6,1,1,0,1,NASDAQ
4841,14-02-2021 06:00,24 hrs.,pennystocks,FAMI,24,24,0,24,1,1,18,1,NASDAQ
4841,14-02-2021 06:00,24 hrs.,pennystocks,FLMN,6,6,0,6,1,1,0,1,NASDAQ
4841,14-02-2021 06:00,24 hrs.,pennystocks,FORD,93,0,93,-93,1,37,15,1,NASDAQ
4841,14-02-2021 06:00,24 hrs.,pennystocks,FTFT,35,35,0,35,1,14,3,1,NASDAQ
4841,14-02-2021 06:00,24 hrs.,pennystocks,GIGM,24,24,0,24,1,1,18,1,NASDAQ
4841,14-02-2021 06:00,24 hrs.,pennystocks,GNUS,12,6,6,0,2,2,0,2,NASDAQ
4841,14-02-2021 06:00,24 hrs.,pennystocks,GRIL,35,35,0,35,1,14,3,1,NASDAQ
4841,14-02-2021 06:00,24 hrs.,pennystocks,DASH,26,0,26,-26,1,8,6,1,NYSE
4841,14-02-2021 06:00,24 hrs.,pennystocks,FEDU,24,24,0,24,1,1,18,1,NYSE
4841,14-02-2021 06:00,24 hrs.,pennystocks,FENG,24,24,0,24,1,1,18,1,NYSE
4841,14-02-2021 06:00,24 hrs.,pennystocks,HEXO,657,652,5,647,2,259,131,2,NYSE
4841,14-02-2021 06:00,24 hrs.,pennystocks,LAIX,24,24,0,24,1,1,18,1,NYSE
4841,14-02-2021 06:00,24 hrs.,pennystocks,LEJU,24,24,0,24,1,1,18,1,NYSE
4841,14-02-2021 06:00,24 hrs.,pennystocks,LITB,24,24,0,24,1,1,18,1,NYSE
4841,14-02-2021 06:00,24 hrs.,pennystocks,MOGU,24,24,0,24,1,1,18,1,NYSE
4841,14-02-2021 06:00,24 hrs.,pennystocks,WELL,7,7,0,7,1,1,1,1,NYSE
4841,14-02-2021 06:00,24 hrs.,pennystocks,CGC,652,652,0,652,1,259,130,1,NASDAQ
4841,14-02-2021 06:00,24 hrs.,pennystocks,CIH,24,24,0,24,1,1,18,1,NASDAQ
4841,14-02-2021 06:00,24 hrs.,pennystocks,EVK,24,24,0,24,1,1,18,1,NASDAQ
4841,14-02-2021 06:00,24 hrs.,pennystocks,GLG,24,24,0,24,1,1,18,1,NASDAQ
4841,14-02-2021 06:00,24 hrs.,pennystocks,INO,66,0,66,-66,1,26,10,1,NASDAQ
4841,14-02-2021 06:00,24 hrs.,pennystocks,JFU,24,24,0,24,1,1,18,1,NASDAQ
4841,14-02-2021 06:00,24 hrs.,pennystocks,LYL,24,24,0,24,1,1,18,1,NASDAQ
4841,14-02-2021 06:00,24 hrs.,pennystocks,MKD,24,24,0,24,1,1,18,1,NASDAQ
4841,14-02-2021 06:00,24 hrs.,pennystocks,MTC,24,24,0,24,1,1,18,1,NASDAQ
4841,14-02-2021 06:00,24 hrs.,pennystocks,MYT,24,24,0,24,1,1,18,1,NASDAQ
4841,14-02-2021 06:00,24 hrs.,pennystocks,OSN,24,24,0,24,1,1,18,1,NASDAQ
4841,14-02-2021 06:00,24 hrs.,pennystocks,PME,24,24,0,24,1,1,18,1,NASDAQ
4841,14-02-2021 06:00,24 hrs.,pennystocks,PPH,7,7,0,7,1,0,3,1,NASDAQ
4841,14-02-2021 06:00,24 hrs.,pennystocks,PTE,126,0,126,-126,1,50,22,1,NASDAQ
4841,14-02-2021 06:00,24 hrs.,pennystocks,AAPL,272,272,0,272,1,118,32,1,NASDAQ
4841,14-02-2021 06:00,24 hrs.,pennystocks,ACHV,48,48,0,48,1,14,16,1,NASDAQ
4841,14-02-2021 06:00,24 hrs.,pennystocks,ADXS,6,6,0,6,1,1,0,1,NASDAQ
4841,14-02-2021 06:00,24 hrs.,pennystocks,AEZS,23,23,0,23,1,7,5,1,NASDAQ
4841,14-02-2021 06:00,24 hrs.,pennystocks,AIHS,24,24,0,24,1,1,18,1,NASDAQ
4841,14-02-2021 06:00,24 hrs.,pennystocks,ALNA,15,0,15,-15,1,2,7,1,NASDAQ
4841,14-02-2021 06:00,24 hrs.,pennystocks,ANTE,23,0,23,-23,1,7,5,1,NASDAQ
4841,14-02-2021 06:00,24 hrs.,pennystocks,AQMS,70,70,0,70,1,13,40,1,NASDAQ
4841,14-02-2021 06:00,24 hrs.,pennystocks,ARTL,35,35,0,35,1,14,3,1,NASDAQ
4841,14-02-2021 06:00,24 hrs.,pennystocks,ASLN,24,24,0,24,1,1,18,1,NASDAQ
4841,14-02-2021 06:00,24 hrs.,pennystocks,ASRT,67,37,30,7,3,15,25,3,NASDAQ
4841,14-02-2021 06:00,24 hrs.,pennystocks,ATOS,29,29,0,29,1,4,17,1,NASDAQ
4841,14-02-2021 06:00,24 hrs.,pennystocks,AVGR,126,0,126,-126,1,50,22,1,NASDAQ
4841,14-02-2021 06:00,24 hrs.,pennystocks,AYRO,35,35,0,35,1,14,3,1,NASDAQ
4841,14-02-2021 06:00,24 hrs.,pennystocks,BHAT,24,24,0,24,1,1,18,1,NASDAQ
4841,14-02-2021 06:00,24 hrs.,pennystocks,BHTG,79,0,79,-79,1,31,13,1,NASDAQ
4841,14-02-2021 06:00,24 hrs.,pennystocks,BIMI,24,24,0,24,1,1,18,1,NASDAQ
4841,14-02-2021 06:00,24 hrs.,pennystocks,BLUE,36,0,36,-36,1,7,18,1,NASDAQ
4841,14-02-2021 06:00,24 hrs.,pennystocks,BNGO,363,237,126,111,4,93,161,3,NASDAQ
4841,14-02-2021 06:00,24 hrs.,pennystocks,BRQS,37,37,0,37,2,1,27,2,NASDAQ
4841,14-02-2021 06:00,24 hrs.,pennystocks,BVXV,6,6,0,6,1,1,0,1,NASDAQ
4841,14-02-2021 06:00,24 hrs.,pennystocks,BWEN,6,6,0,6,1,1,0,1,NASDAQ
4841,14-02-2021 06:00,24 hrs.,pennystocks,BXRX,12,0,12,-12,2,2,0,2,NASDAQ
4841,14-02-2021 06:00,24 hrs.,pennystocks,CCNC,13,13,0,13,1,0,9,1,NASDAQ
4841,14-02-2021 06:00,24 hrs.,pennystocks,CCRC,24,24,0,24,1,1,18,1,NASDAQ
4841,14-02-2021 06:00,24 hrs.,pennystocks,CHEK,126,0,126,-126,1,50,22,1,NASDAQ
4841,14-02-2021 06:00,24 hrs.,pennystocks,TANH,24,24,0,24,1,1,18,1,NASDAQ
4841,14-02-2021 06:00,24 hrs.,pennystocks,TAOP,24,24,0,24,1,1,18,1,NASDAQ
4841,14-02-2021 06:00,24 hrs.,pennystocks,TEDU,24,24,0,24,1,1,18,1,NASDAQ
4841,14-02-2021 06:00,24 hrs.,pennystocks,TLRY,652,652,0,652,1,259,130,1,NASDAQ
4841,14-02-2021 06:00,24 hrs.,pennystocks,TNXP,76,70,6,64,5,20,16,5,NASDAQ
4841,14-02-2021 06:00,24 hrs.,pennystocks,TOPS,35,35,0,35,1,14,3,1,NASDAQ
4841,14-02-2021 06:00,24 hrs.,pennystocks,TOUR,24,24,0,24,1,1,18,1,NASDAQ
4841,14-02-2021 06:00,24 hrs.,pennystocks,TRIP,30,0,30,-30,1,7,12,1,NASDAQ
4841,14-02-2021 06:00,24 hrs.,pennystocks,TRVG,48,41,7,34,3,16,4,3,NASDAQ
4841,14-02-2021 06:00,24 hrs.,pennystocks,TXMD,7,7,0,7,1,1,1,1,NASDAQ
4841,14-02-2021 06:00,24 hrs.,pennystocks,TYHT,24,24,0,24,1,1,18,1,NASDAQ
4841,14-02-2021 06:00,24 hrs.,pennystocks,USWS,6,6,0,6,1,1,0,1,NASDAQ
4841,14-02-2021 06:00,24 hrs.,pennystocks,UTSI,24,24,0,24,1,1,18,1,NASDAQ
4841,14-02-2021 06:00,24 hrs.,pennystocks,UXIN,24,24,0,24,1,1,18,1,NASDAQ
4841,14-02-2021 06:00,24 hrs.,pennystocks,VYNE,7,7,0,7,1,1,1,1,NASDAQ
4841,14-02-2021 06:00,24 hrs.,pennystocks,XSPA,24,6,18,-12,4,4,0,3,NASDAQ
4841,14-02-2021 06:00,24 hrs.,pennystocks,YMTX,19,19,0,19,1,5,5,1,NASDAQ
4841,14-02-2021 06:00,24 hrs.,pennystocks,ZCMD,24,24,0,24,1,1,18,1,NASDAQ
4841,14-02-2021 06:00,24 hrs.,pennystocks,ZKIN,13,13,0,13,1,0,9,1,NASDAQ
4841,14-02-2021 06:00,24 hrs.,pennystocks,ZSAN,41,41,0,41,2,1,31,2,NASDAQ
4841,14-02-2021 06:00,24 hrs.,RobinHoodPennyStocks,HCMC,6,6,0,6,1,1,0,1,OTC
4841,14-02-2021 06:00,24 hrs.,RobinHoodPennyStocks,RTSL,6,6,0,6,1,1,0,1,OTC
4841,14-02-2021 06:00,24 hrs.,RobinHoodPennyStocks,SGMD,6,6,0,6,1,1,0,1,OTC
4841,14-02-2021 06:00,24 hrs.,RobinHoodPennyStocks,ARBKF,33,33,0,33,1,3,23,1,OTC
4841,14-02-2021 06:00,24 hrs.,RobinHoodPennyStocks,EMHTF,6,6,0,6,1,1,0,1,OTC
4841,14-02-2021 06:00,24 hrs.,RobinHoodPennyStocks,MEDIF,6,0,6,-6,1,1,0,1,OTC
4841,14-02-2021 06:00,24 hrs.,RobinHoodPennyStocks,TBPMF,7,7,0,7,1,1,1,1,OTC
4841,14-02-2021 06:00,24 hrs.,pennystocks,GRNQ,24,24,0,24,1,1,18,1,NASDAQ
4841,14-02-2021 06:00,24 hrs.,pennystocks,GSUM,24,24,0,24,1,1,18,1,NASDAQ
4841,14-02-2021 06:00,24 hrs.,pennystocks,GTHX,6,6,0,6,1,1,0,1,NASDAQ
4841,14-02-2021 06:00,24 hrs.,pennystocks,GURE,24,24,0,24,1,1,18,1,NASDAQ
4841,14-02-2021 06:00,24 hrs.,pennystocks,HAPP,24,24,0,24,1,1,18,1,NASDAQ
4841,14-02-2021 06:00,24 hrs.,pennystocks,HCDI,14,14,0,14,1,1,8,1,NASDAQ
4841,14-02-2021 06:00,24 hrs.,pennystocks,HGSH,24,24,0,24,1,1,18,1,NASDAQ
4841,14-02-2021 06:00,24 hrs.,pennystocks,HIHO,24,24,0,24,1,1,18,1,NASDAQ
4841,14-02-2021 06:00,24 hrs.,pennystocks,HUSN,35,35,0,35,1,14,3,1,NASDAQ
4841,14-02-2021 06:00,24 hrs.,pennystocks,ICON,14,0,14,-14,1,3,4,1,NASDAQ
4841,14-02-2021 06:00,24 hrs.,pennystocks,ILMN,35,35,0,35,1,14,3,1,NASDAQ
4841,14-02-2021 06:00,24 hrs.,pennystocks,ITRM,7,7,0,7,1,1,1,1,NASDAQ
4841,14-02-2021 06:00,24 hrs.,pennystocks,IZEA,13,13,0,13,1,0,9,1,NASDAQ
4841,14-02-2021 06:00,24 hrs.,pennystocks,JAGX,34,34,0,34,3,10,2,2,NASDAQ
4841,14-02-2021 06:00,24 hrs.,pennystocks,JFIN,24,24,0,24,1,1,18,1,NASDAQ
4841,14-02-2021 06:00,24 hrs.,pennystocks,KBSF,24,24,0,24,1,1,18,1,NASDAQ
4841,14-02-2021 06:00,24 hrs.,pennystocks,KRKR,24,24,0,24,1,1,18,1,NASDAQ
4841,14-02-2021 06:00,24 hrs.,pennystocks,KXIN,24,24,0,24,1,1,18,1,NASDAQ
4841,14-02-2021 06:00,24 hrs.,pennystocks,LGHL,48,48,0,48,2,14,12,2,NASDAQ
4841,14-02-2021 06:00,24 hrs.,pennystocks,LIVE,27,27,0,27,1,9,5,1,NASDAQ
4841,14-02-2021 06:00,24 hrs.,pennystocks,LIVX,6,0,6,-6,1,1,0,1,NASDAQ
4841,14-02-2021 06:00,24 hrs.,pennystocks,LKCO,59,59,0,59,2,15,21,2,NASDAQ
4841,14-02-2021 06:00,24 hrs.,pennystocks,LLNW,6,6,0,6,1,1,0,1,NASDAQ
4841,14-02-2021 06:00,24 hrs.,pennystocks,MDJH,24,24,0,24,1,1,18,1,NASDAQ
4841,14-02-2021 06:00,24 hrs.,pennystocks,METX,24,24,0,24,1,1,18,1,NASDAQ
4841,14-02-2021 06:00,24 hrs.,pennystocks,MOGO,30,0,30,-30,1,5,16,1,NASDAQ
4841,14-02-2021 06:00,24 hrs.,pennystocks,MOHO,24,24,0,24,1,1,18,1,NASDAQ
4841,14-02-2021 06:00,24 hrs.,pennystocks,MOSY,35,35,0,35,1,14,3,1,NASDAQ
4841,14-02-2021 06:00,24 hrs.,pennystocks,MOXC,24,24,0,24,1,1,18,1,NASDAQ
4841,14-02-2021 06:00,24 hrs.,pennystocks,NAKD,15,15,0,15,2,1,5,2,NASDAQ
4841,14-02-2021 06:00,24 hrs.,pennystocks,NEWA,24,24,0,24,1,1,18,1,NASDAQ
4841,14-02-2021 06:00,24 hrs.,pennystocks,NVCN,13,7,6,1,2,2,1,2,NASDAQ
4841,14-02-2021 06:00,24 hrs.,pennystocks,OCGN,47,0,47,-47,1,14,15,1,NASDAQ
4841,14-02-2021 06:00,24 hrs.,pennystocks,OPGN,7,7,0,7,1,1,1,1,NASDAQ
4841,14-02-2021 06:00,24 hrs.,pennystocks,OPTT,12,0,12,-12,2,2,0,2,NASDAQ
4841,14-02-2021 06:00,24 hrs.,pennystocks,PBTS,132,132,0,132,2,28,68,2,NASDAQ
4841,14-02-2021 06:00,24 hrs.,pennystocks,PETZ,24,24,0,24,1,1,18,1,NASDAQ
4841,14-02-2021 06:00,24 hrs.,RobinHoodPennyStocks,MRO,69,0,69,-69,1,27,11,1,NYSE
4841,14-02-2021 06:00,24 hrs.,RobinHoodPennyStocks,NOK,8,8,0,8,1,1,2,1,NYSE
4841,14-02-2021 06:00,24 hrs.,RobinHoodPennyStocks,PEG,468,468,0,468,1,217,30,1,NYSE
4841,14-02-2021 06:00,24 hrs.,RobinHoodPennyStocks,RSI,468,468,0,468,1,217,30,1,NYSE
4841,14-02-2021 06:00,24 hrs.,RobinHoodPennyStocks,SOS,6,6,0,6,1,1,0,1,NYSE
4841,14-02-2021 06:00,24 hrs.,RobinHoodPennyStocks,DECK,6,6,0,6,1,1,0,1,NYSE
4841,14-02-2021 06:00,24 hrs.,RobinHoodPennyStocks,IPOE,6,0,6,-6,1,1,0,1,NYSE
4841,14-02-2021 06:00,24 hrs.,RobinHoodPennyStocks,SND,59,0,59,-59,1,17,21,1,NASDAQ
4841,14-02-2021 06:00,24 hrs.,RobinHoodPennyStocks,AAPL,468,468,0,468,1,217,30,1,NASDAQ
4841,14-02-2021 06:00,24 hrs.,RobinHoodPennyStocks,ADXS,6,6,0,6,1,1,0,1,NASDAQ
4841,14-02-2021 06:00,24 hrs.,RobinHoodPennyStocks,AGEN,6,0,6,-6,1,1,0,1,NASDAQ
4841,14-02-2021 06:00,24 hrs.,RobinHoodPennyStocks,AGTC,81,81,0,81,1,26,25,1,NASDAQ
4841,14-02-2021 06:00,24 hrs.,RobinHoodPennyStocks,AKBA,7,7,0,7,1,1,1,1,NASDAQ
4841,14-02-2021 06:00,24 hrs.,RobinHoodPennyStocks,ASRT,13,13,0,13,1,1,7,1,NASDAQ
4841,14-02-2021 06:00,24 hrs.,RobinHoodPennyStocks,BNGO,4,0,4,-4,1,0,0,1,NASDAQ
4841,14-02-2021 06:00,24 hrs.,RobinHoodPennyStocks,BVXV,6,6,0,6,1,1,0,1,NASDAQ
4841,14-02-2021 06:00,24 hrs.,RobinHoodPennyStocks,CLBS,6,0,6,-6,1,1,0,1,NASDAQ
4841,14-02-2021 06:00,24 hrs.,RobinHoodPennyStocks,CSCW,106,106,0,106,1,38,26,1,NASDAQ
4841,14-02-2021 06:00,24 hrs.,RobinHoodPennyStocks,CSTR,4,4,0,4,1,0,0,1,NASDAQ
4841,14-02-2021 06:00,24 hrs.,RobinHoodPennyStocks,CTRM,53,6,47,-41,2,10,25,2,NASDAQ
4841,14-02-2021 06:00,24 hrs.,RobinHoodPennyStocks,DFFN,70,0,70,-70,1,14,38,1,NASDAQ
4841,14-02-2021 06:00,24 hrs.,RobinHoodPennyStocks,EDIT,106,106,0,106,1,38,26,1,NASDAQ
4841,14-02-2021 06:00,24 hrs.,RobinHoodPennyStocks,FLMN,6,6,0,6,1,1,0,1,NASDAQ
4841,14-02-2021 06:00,24 hrs.,RobinHoodPennyStocks,GOGO,11,11,0,11,1,0,7,1,NASDAQ
4841,14-02-2021 06:00,24 hrs.,RobinHoodPennyStocks,GRPN,21,21,0,21,1,5,7,1,NASDAQ
4841,14-02-2021 06:00,24 hrs.,RobinHoodPennyStocks,IDEX,6,6,0,6,1,1,0,1,NASDAQ
4841,14-02-2021 06:00,24 hrs.,RobinHoodPennyStocks,JAGX,119,119,0,119,1,47,21,1,NASDAQ
4841,14-02-2021 06:00,24 hrs.,RobinHoodPennyStocks,MARA,33,33,0,33,1,3,23,1,NASDAQ
4841,14-02-2021 06:00,24 hrs.,RobinHoodPennyStocks,RETO,106,106,0,106,1,38,26,1,NASDAQ
4841,14-02-2021 06:00,24 hrs.,RobinHoodPennyStocks,SNDL,24,12,12,0,4,4,0,3,NASDAQ
4841,14-02-2021 06:00,24 hrs.,RobinHoodPennyStocks,SONM,23,0,23,-23,1,3,13,1,NASDAQ
4841,14-02-2021 06:00,24 hrs.,RobinHoodPennyStocks,SXTC,10,10,0,10,1,2,2,1,NASDAQ
4841,14-02-2021 06:00,24 hrs.,RobinHoodPennyStocks,TNXP,18,18,0,18,3,3,0,1,NASDAQ
4841,14-02-2021 06:00,24 hrs.,RobinHoodPennyStocks,TRCH,74,6,68,-62,2,19,28,2,NASDAQ
4841,14-02-2021 06:00,24 hrs.,RobinHoodPennyStocks,TSLA,6,0,6,-6,1,1,0,1,NASDAQ
4841,14-02-2021 06:00,24 hrs.,RobinHoodPennyStocks,TXMD,13,13,0,13,1,1,7,1,NASDAQ
4841,14-02-2021 06:00,24 hrs.,RobinHoodPennyStocks,DNN,6,0,6,-6,1,1,0,1,AMEX
4841,14-02-2021 06:00,24 hrs.,RobinHoodPennyStocks,DPW,37,0,37,-37,1,11,11,1,AMEX
4841,14-02-2021 06:00,24 hrs.,RobinHoodPennyStocks,DSS,6,6,0,6,1,1,0,1,AMEX
4841,14-02-2021 06:00,24 hrs.,RobinHoodPennyStocks,GTE,112,21,91,-70,2,34,36,2,AMEX
4841,14-02-2021 06:00,24 hrs.,RobinHoodPennyStocks,NAK,6,6,0,6,1,1,0,1,AMEX
4841,14-02-2021 06:00,24 hrs.,RobinHoodPennyStocks,PTN,24,24,0,24,1,7,6,1,AMEX
4841,14-02-2021 06:00,24 hrs.,RobinHoodPennyStocks,SYN,6,6,0,6,1,1,0,1,AMEX
4841,14-02-2021 06:00,24 hrs.,RobinHoodPennyStocks,ZOM,245,104,141,-37,3,81,71,3,AMEX
4841,14-02-2021 06:00,24 hrs.,RobinHoodPennyStocks,CPHI,106,106,0,106,1,38,26,1,AMEX
4841,14-02-2021 06:00,24 hrs.,RobinHoodPennyStocks,ETN,12,6,6,0,2,2,0,2,NYSE
4841,14-02-2021 06:00,24 hrs.,RobinHoodPennyStocks,GME,8,8,0,8,1,1,2,1,NYSE
4841,14-02-2021 06:00,24 hrs.,pennystocks,PSEC,6,0,6,-6,1,1,0,1,NASDAQ
4841,14-02-2021 06:00,24 hrs.,pennystocks,PSTV,6,0,6,-6,1,1,0,1,NASDAQ
4841,14-02-2021 06:00,24 hrs.,pennystocks,PULM,6,0,6,-6,1,1,0,1,NASDAQ
4841,14-02-2021 06:00,24 hrs.,pennystocks,RAVE,35,35,0,35,1,14,3,1,NASDAQ
4841,14-02-2021 06:00,24 hrs.,pennystocks,RCON,24,24,0,24,1,1,18,1,NASDAQ
4841,14-02-2021 06:00,24 hrs.,pennystocks,RETO,44,44,0,44,2,5,26,2,NASDAQ
4841,14-02-2021 06:00,24 hrs.,pennystocks,RUHN,24,24,0,24,1,1,18,1,NASDAQ
4841,14-02-2021 06:00,24 hrs.,pennystocks,RWLK,35,35,0,35,1,14,3,1,NASDAQ
4841,14-02-2021 06:00,24 hrs.,pennystocks,SALM,35,35,0,35,1,14,3,1,NASDAQ
4841,14-02-2021 06:00,24 hrs.,pennystocks,SAVA,48,48,0,48,1,14,16,1,NASDAQ
4841,14-02-2021 06:00,24 hrs.,pennystocks,SEAC,5,0,5,-5,1,0,1,1,NASDAQ
4841,14-02-2021 06:00,24 hrs.,pennystocks,SECO,24,24,0,24,1,1,18,1,NASDAQ
4841,14-02-2021 06:00,24 hrs.,pennystocks,SGOC,24,24,0,24,1,1,18,1,NASDAQ
4841,14-02-2021 06:00,24 hrs.,pennystocks,SHIP,41,41,0,41,2,15,3,2,NASDAQ
4841,14-02-2021 06:00,24 hrs.,pennystocks,SNDL,55,55,0,55,8,8,7,3,NASDAQ
4841,14-02-2021 06:00,24 hrs.,pennystocks,SNGX,25,25,0,25,4,4,1,3,NASDAQ
4841,14-02-2021 06:00,24 hrs.,pennystocks,SXTC,24,24,0,24,1,1,18,1,NASDAQ
4829,14-02-2021 04:00,24 hrs.,wallstreetbets,CRSP,77,0,77,-77,4,3,55,2,NASDAQ
4829,14-02-2021 04:00,24 hrs.,wallstreetbets,CRSR,37,17,20,-3,4,3,15,4,NASDAQ
4829,14-02-2021 04:00,24 hrs.,wallstreetbets,CSTR,5,5,0,5,1,0,1,1,NASDAQ
4829,14-02-2021 04:00,24 hrs.,wallstreetbets,CTRM,48,34,14,20,7,7,6,6,NASDAQ
4829,14-02-2021 04:00,24 hrs.,wallstreetbets,DENN,154,154,0,154,1,57,36,1,NASDAQ
4829,14-02-2021 04:00,24 hrs.,wallstreetbets,DKNG,3308,3301,7,3294,2,1483,334,2,NASDAQ
4829,14-02-2021 04:00,24 hrs.,wallstreetbets,EHTH,154,154,0,154,1,57,36,1,NASDAQ
4829,14-02-2021 04:00,24 hrs.,wallstreetbets,EVBG,154,154,0,154,1,57,36,1,NASDAQ
4829,14-02-2021 04:00,24 hrs.,wallstreetbets,EVFM,6,0,6,-6,1,1,0,1,NASDAQ
4829,14-02-2021 04:00,24 hrs.,wallstreetbets,EXPI,17,11,6,5,3,2,1,3,NASDAQ
4829,14-02-2021 04:00,24 hrs.,wallstreetbets,FIZZ,1107,7,1100,-1093,4,513,65,3,NASDAQ
4829,14-02-2021 04:00,24 hrs.,wallstreetbets,FLGT,15,15,0,15,2,2,3,1,NASDAQ
4829,14-02-2021 04:00,24 hrs.,wallstreetbets,FLMN,6,6,0,6,1,1,0,1,NASDAQ
4829,14-02-2021 04:00,24 hrs.,wallstreetbets,FOLD,13,13,0,13,2,2,1,2,NASDAQ
4829,14-02-2021 04:00,24 hrs.,wallstreetbets,III,28,28,0,28,3,6,4,2,NASDAQ
4829,14-02-2021 04:00,24 hrs.,wallstreetbets,INO,77,77,0,77,2,17,35,2,NASDAQ
4829,14-02-2021 04:00,24 hrs.,wallstreetbets,JAN,6,6,0,6,1,1,0,1,NASDAQ
4829,14-02-2021 04:00,24 hrs.,wallstreetbets,KHC,136,136,0,136,2,33,62,2,NASDAQ
4829,14-02-2021 04:00,24 hrs.,wallstreetbets,KIN,14,14,0,14,2,2,2,1,NASDAQ
4829,14-02-2021 04:00,24 hrs.,wallstreetbets,MKD,6,0,6,-6,1,1,0,1,NASDAQ
4829,14-02-2021 04:00,24 hrs.,wallstreetbets,NEO,6,6,0,6,1,1,0,1,NASDAQ
4829,14-02-2021 04:00,24 hrs.,wallstreetbets,NWL,43,43,0,43,1,5,29,1,NASDAQ
4829,14-02-2021 04:00,24 hrs.,wallstreetbets,OGI,27,13,14,-1,4,4,3,3,NASDAQ
4829,14-02-2021 04:00,24 hrs.,wallstreetbets,PDD,7,0,7,-7,1,1,1,1,NASDAQ
4829,14-02-2021 04:00,24 hrs.,wallstreetbets,QQQ,6,0,6,-6,1,1,0,1,NASDAQ
4829,14-02-2021 04:00,24 hrs.,wallstreetbets,SGEN,7,7,0,7,1,1,1,1,NASDAQ
4829,14-02-2021 04:00,24 hrs.,wallstreetbets,SHIP,28,28,0,28,4,4,4,2,NASDAQ
4829,14-02-2021 04:00,24 hrs.,wallstreetbets,SIRI,8,8,0,8,1,1,2,1,NASDAQ
4829,14-02-2021 04:00,24 hrs.,wallstreetbets,SMCI,14,14,0,14,2,2,2,1,NASDAQ
4829,14-02-2021 04:00,24 hrs.,wallstreetbets,SNDL,438,285,153,132,65,65,48,52,NASDAQ
4829,14-02-2021 04:00,24 hrs.,wallstreetbets,SNGX,12,6,6,0,2,2,0,2,NASDAQ
4829,14-02-2021 04:00,24 hrs.,wallstreetbets,FREQ,21,21,0,21,1,0,17,1,NASDAQ
4829,14-02-2021 04:00,24 hrs.,wallstreetbets,GAIN,7,7,0,7,1,1,1,1,NASDAQ
4829,14-02-2021 04:00,24 hrs.,wallstreetbets,GLBS,7,0,7,-7,1,1,1,1,NASDAQ
4829,14-02-2021 04:00,24 hrs.,wallstreetbets,GMBL,7,7,0,7,1,1,1,1,NASDAQ
4829,14-02-2021 04:00,24 hrs.,wallstreetbets,GNOG,13,6,7,-1,2,2,1,2,NASDAQ
4829,14-02-2021 04:00,24 hrs.,wallstreetbets,GNUS,7,0,7,-7,1,1,1,1,NASDAQ
4829,14-02-2021 04:00,24 hrs.,wallstreetbets,GOGO,1144,58,1086,-1028,10,518,68,6,NASDAQ
4829,14-02-2021 04:00,24 hrs.,wallstreetbets,GOLD,224,224,0,224,5,71,62,5,NASDAQ
4829,14-02-2021 04:00,24 hrs.,wallstreetbets,RNA,70,70,0,70,1,16,34,1,NASDAQ
4829,14-02-2021 04:00,24 hrs.,wallstreetbets,RUN,7,0,7,-7,1,1,1,1,NASDAQ
4829,14-02-2021 04:00,24 hrs.,wallstreetbets,SLP,13,0,13,-13,2,2,1,2,NASDAQ
4829,14-02-2021 04:00,24 hrs.,wallstreetbets,SND,7,0,7,-7,1,1,1,1,NASDAQ
4829,14-02-2021 04:00,24 hrs.,wallstreetbets,TTD,154,154,0,154,1,57,36,1,NASDAQ
4829,14-02-2021 04:00,24 hrs.,wallstreetbets,UFO,15,15,0,15,2,2,3,1,NASDAQ
4829,14-02-2021 04:00,24 hrs.,wallstreetbets,VFF,7,7,0,7,1,1,1,1,NASDAQ
4829,14-02-2021 04:00,24 hrs.,wallstreetbets,WIX,154,154,0,154,1,57,36,1,NASDAQ
4829,14-02-2021 04:00,24 hrs.,wallstreetbets,WNW,9,0,9,-9,1,1,3,1,NASDAQ
4829,14-02-2021 04:00,24 hrs.,wallstreetbets,AACQ,7,7,0,7,1,1,1,1,NASDAQ
4829,14-02-2021 04:00,24 hrs.,wallstreetbets,AAPL,3321,3314,7,3307,4,1485,335,4,NASDAQ
4829,14-02-2021 04:00,24 hrs.,wallstreetbets,ABCL,7,0,7,-7,1,1,1,1,NASDAQ
4829,14-02-2021 04:00,24 hrs.,wallstreetbets,ABNB,6,0,6,-6,1,1,0,1,NASDAQ
4829,14-02-2021 04:00,24 hrs.,wallstreetbets,ADXS,7,7,0,7,1,1,1,1,NASDAQ
4829,14-02-2021 04:00,24 hrs.,wallstreetbets,AKAM,52,52,0,52,3,10,20,2,NASDAQ
4829,14-02-2021 04:00,24 hrs.,wallstreetbets,AKBA,7,7,0,7,1,1,1,1,NASDAQ
4829,14-02-2021 04:00,24 hrs.,wallstreetbets,ALNA,7,7,0,7,1,1,1,1,NASDAQ
4829,14-02-2021 04:00,24 hrs.,wallstreetbets,AMAT,334,334,0,334,2,122,82,2,NASDAQ
4829,14-02-2021 04:00,24 hrs.,wallstreetbets,AMZN,7,7,0,7,1,1,1,1,NASDAQ
4829,14-02-2021 04:00,24 hrs.,wallstreetbets,ANSS,14,14,0,14,2,2,2,2,NASDAQ
4829,14-02-2021 04:00,24 hrs.,wallstreetbets,ANTE,7,0,7,-7,1,1,1,1,NASDAQ
4829,14-02-2021 04:00,24 hrs.,wallstreetbets,APHA,1762,88,1674,-1586,16,688,322,10,NASDAQ
4829,14-02-2021 04:00,24 hrs.,wallstreetbets,APPN,154,154,0,154,1,57,36,1,NASDAQ
4829,14-02-2021 04:00,24 hrs.,wallstreetbets,APPS,13,6,7,-1,2,2,1,2,NASDAQ
4829,14-02-2021 04:00,24 hrs.,wallstreetbets,ASRT,14,14,0,14,2,2,2,2,NASDAQ
4829,14-02-2021 04:00,24 hrs.,wallstreetbets,ASTC,7,0,7,-7,1,1,1,1,NASDAQ
4829,14-02-2021 04:00,24 hrs.,wallstreetbets,ATNF,6,6,0,6,1,1,0,1,NASDAQ
4829,14-02-2021 04:00,24 hrs.,wallstreetbets,ATNX,7,7,0,7,1,1,1,1,NASDAQ
4829,14-02-2021 04:00,24 hrs.,wallstreetbets,ATVI,33,0,33,-33,1,0,29,1,NASDAQ
4829,14-02-2021 04:00,24 hrs.,wallstreetbets,AZRX,7,7,0,7,1,1,1,1,NASDAQ
4829,14-02-2021 04:00,24 hrs.,wallstreetbets,BBBY,3301,3301,0,3301,1,1482,333,1,NASDAQ
4829,14-02-2021 04:00,24 hrs.,wallstreetbets,BHTG,7,0,7,-7,1,1,1,1,NASDAQ
4829,14-02-2021 04:00,24 hrs.,wallstreetbets,BIDU,154,154,0,154,1,57,36,1,NASDAQ
4829,14-02-2021 04:00,24 hrs.,wallstreetbets,BIGC,1086,0,1086,-1086,1,510,62,1,NASDAQ
4829,14-02-2021 04:00,24 hrs.,wallstreetbets,BLDP,7,7,0,7,1,1,1,1,NASDAQ
4829,14-02-2021 04:00,24 hrs.,wallstreetbets,BLMN,154,154,0,154,1,57,36,1,NASDAQ
4829,14-02-2021 04:00,24 hrs.,wallstreetbets,BLPH,6,0,6,-6,1,1,0,1,NASDAQ
4829,14-02-2021 04:00,24 hrs.,wallstreetbets,BLRX,6,6,0,6,1,1,0,1,NASDAQ
4829,14-02-2021 04:00,24 hrs.,wallstreetbets,BNGO,60,41,19,22,9,9,6,8,NASDAQ
4829,14-02-2021 04:00,24 hrs.,wallstreetbets,BSQR,7,0,7,-7,1,1,1,1,NASDAQ
4829,14-02-2021 04:00,24 hrs.,wallstreetbets,CCRC,8,8,0,8,1,2,0,1,NASDAQ
4829,14-02-2021 04:00,24 hrs.,wallstreetbets,CGIX,6,6,0,6,1,1,0,1,NASDAQ
4829,14-02-2021 04:00,24 hrs.,wallstreetbets,CHEK,7,7,0,7,1,1,1,1,NASDAQ
4829,14-02-2021 04:00,24 hrs.,wallstreetbets,CIDM,6,6,0,6,1,1,0,1,NASDAQ
4829,14-02-2021 04:00,24 hrs.,wallstreetbets,CLBS,14,7,7,0,2,2,2,2,NASDAQ
4829,14-02-2021 04:00,24 hrs.,wallstreetbets,CLEU,14,7,7,0,2,2,2,2,NASDAQ
4829,14-02-2021 04:00,24 hrs.,wallstreetbets,CLVS,14,0,14,-14,2,2,2,1,NASDAQ
4829,14-02-2021 04:00,24 hrs.,wallstreetbets,CMPS,6,0,6,-6,1,1,0,1,NASDAQ
4829,14-02-2021 04:00,24 hrs.,wallstreetbets,CPRT,154,154,0,154,1,57,36,1,NASDAQ
4829,14-02-2021 04:00,24 hrs.,wallstreetbets,CRBP,6,0,6,-6,1,1,0,1,NASDAQ
4829,14-02-2021 04:00,24 hrs.,wallstreetbets,TREE,1086,0,1086,-1086,1,510,62,1,NASDAQ
4829,14-02-2021 04:00,24 hrs.,wallstreetbets,TRIT,23,23,0,23,1,7,5,1,NASDAQ
4829,14-02-2021 04:00,24 hrs.,wallstreetbets,TRVG,26,14,12,2,4,4,2,4,NASDAQ
4829,14-02-2021 04:00,24 hrs.,wallstreetbets,TSLA,5608,3657,1951,1706,15,2178,1192,12,NASDAQ
4829,14-02-2021 04:00,24 hrs.,wallstreetbets,TXMD,13,7,6,1,2,2,1,2,NASDAQ
4829,14-02-2021 04:00,24 hrs.,wallstreetbets,TXRH,154,154,0,154,1,57,36,1,NASDAQ
4829,14-02-2021 04:00,24 hrs.,wallstreetbets,VISL,7,0,7,-7,1,1,1,1,NASDAQ
4829,14-02-2021 04:00,24 hrs.,wallstreetbets,VIVO,7,0,7,-7,1,1,1,1,NASDAQ
4829,14-02-2021 04:00,24 hrs.,wallstreetbets,VKTX,7,7,0,7,1,1,1,1,NASDAQ
4829,14-02-2021 04:00,24 hrs.,wallstreetbets,VUZI,20,20,0,20,3,3,2,3,NASDAQ
4829,14-02-2021 04:00,24 hrs.,wallstreetbets,VXRT,42,28,14,14,6,6,6,3,NASDAQ
4829,14-02-2021 04:00,24 hrs.,wallstreetbets,WATT,7,0,7,-7,1,1,1,1,NASDAQ
4829,14-02-2021 04:00,24 hrs.,wallstreetbets,WIMI,7,7,0,7,1,1,1,1,NASDAQ
4829,14-02-2021 04:00,24 hrs.,wallstreetbets,WING,154,154,0,154,1,57,36,1,NASDAQ
4829,14-02-2021 04:00,24 hrs.,wallstreetbets,GRMN,154,154,0,154,1,57,36,1,NASDAQ
4829,14-02-2021 04:00,24 hrs.,wallstreetbets,GTEC,6,6,0,6,1,1,0,1,NASDAQ
4829,14-02-2021 04:00,24 hrs.,wallstreetbets,GTHX,254,248,6,242,4,77,84,3,NASDAQ
4829,14-02-2021 04:00,24 hrs.,wallstreetbets,HEAR,7,0,7,-7,1,1,1,1,NASDAQ
4829,14-02-2021 04:00,24 hrs.,wallstreetbets,HZNP,7,0,7,-7,1,1,1,1,NASDAQ
4829,14-02-2021 04:00,24 hrs.,wallstreetbets,IBEX,7,7,0,7,1,1,1,1,NASDAQ
4829,14-02-2021 04:00,24 hrs.,wallstreetbets,IDEX,7,7,0,7,1,1,1,1,NASDAQ
4829,14-02-2021 04:00,24 hrs.,wallstreetbets,IFMK,7,0,7,-7,1,1,1,1,NASDAQ
4829,14-02-2021 04:00,24 hrs.,wallstreetbets,INTC,437,424,13,411,5,104,209,4,NASDAQ
4829,14-02-2021 04:00,24 hrs.,wallstreetbets,IRBT,6,0,6,-6,1,1,0,1,NASDAQ
4829,14-02-2021 04:00,24 hrs.,wallstreetbets,ITRM,7,0,7,-7,1,1,1,1,NASDAQ
4829,14-02-2021 04:00,24 hrs.,wallstreetbets,JAGX,7,7,0,7,1,1,1,1,NASDAQ
4829,14-02-2021 04:00,24 hrs.,wallstreetbets,KOPN,6,6,0,6,1,1,0,1,NASDAQ
4829,14-02-2021 04:00,24 hrs.,wallstreetbets,KOSS,7,7,0,7,1,1,1,1,NASDAQ
4829,14-02-2021 04:00,24 hrs.,wallstreetbets,LIFE,20,0,20,-20,3,3,2,3,NASDAQ
4829,14-02-2021 04:00,24 hrs.,wallstreetbets,LKCO,6,0,6,-6,1,1,0,1,NASDAQ
4829,14-02-2021 04:00,24 hrs.,wallstreetbets,LSCC,154,154,0,154,1,57,36,1,NASDAQ
4829,14-02-2021 04:00,24 hrs.,wallstreetbets,LXRX,14,7,7,0,2,2,2,2,NASDAQ
4829,14-02-2021 04:00,24 hrs.,wallstreetbets,MARA,22,7,15,-8,3,3,4,3,NASDAQ
4829,14-02-2021 04:00,24 hrs.,wallstreetbets,MESO,107,7,100,-93,2,34,31,2,NASDAQ
4829,14-02-2021 04:00,24 hrs.,wallstreetbets,MRKR,6,0,6,-6,1,1,0,1,NASDAQ
4829,14-02-2021 04:00,24 hrs.,wallstreetbets,MSFT,7,7,0,7,1,1,1,1,NASDAQ
4829,14-02-2021 04:00,24 hrs.,wallstreetbets,MVIS,208,208,0,208,11,21,122,4,NASDAQ
4829,14-02-2021 04:00,24 hrs.,wallstreetbets,NAKD,42,20,22,-2,6,6,6,6,NASDAQ
4829,14-02-2021 04:00,24 hrs.,wallstreetbets,NCNO,1086,0,1086,-1086,1,510,62,1,NASDAQ
4829,14-02-2021 04:00,24 hrs.,wallstreetbets,NEPT,7,0,7,-7,1,1,1,1,NASDAQ
4829,14-02-2021 04:00,24 hrs.,wallstreetbets,NGAC,6,6,0,6,1,1,0,1,NASDAQ
4829,14-02-2021 04:00,24 hrs.,wallstreetbets,NLOK,7,0,7,-7,1,1,1,1,NASDAQ
4829,14-02-2021 04:00,24 hrs.,wallstreetbets,NNDM,39,0,39,-39,2,1,29,2,NASDAQ
4829,14-02-2021 04:00,24 hrs.,wallstreetbets,NVAX,21,14,7,7,3,3,3,3,NASDAQ
4829,14-02-2021 04:00,24 hrs.,wallstreetbets,NVDA,7,0,7,-7,1,1,1,1,NASDAQ
4829,14-02-2021 04:00,24 hrs.,wallstreetbets,NXPI,7,7,0,7,1,1,1,1,NASDAQ
4829,14-02-2021 04:00,24 hrs.,wallstreetbets,OCGN,6,0,6,-6,1,1,0,1,NASDAQ
4829,14-02-2021 04:00,24 hrs.,wallstreetbets,PLAY,16640,3307,13333,-10026,3,7858,912,3,NASDAQ
4829,14-02-2021 04:00,24 hrs.,wallstreetbets,POWW,14,7,7,0,2,2,2,2,NASDAQ
4829,14-02-2021 04:00,24 hrs.,wallstreetbets,PTON,7,0,7,-7,1,1,1,1,NASDAQ
4829,14-02-2021 04:00,24 hrs.,wallstreetbets,QCOM,6,6,0,6,1,1,0,1,NASDAQ
4829,14-02-2021 04:00,24 hrs.,wallstreetbets,QDEL,154,154,0,154,1,57,36,1,NASDAQ
4829,14-02-2021 04:00,24 hrs.,wallstreetbets,RAVE,7,7,0,7,1,1,1,1,NASDAQ
4829,14-02-2021 04:00,24 hrs.,wallstreetbets,REAL,91,0,91,-91,2,29,25,2,NASDAQ
4829,14-02-2021 04:00,24 hrs.,wallstreetbets,REGI,7,0,7,-7,1,1,1,1,NASDAQ
4829,14-02-2021 04:00,24 hrs.,wallstreetbets,REGN,14,0,14,-14,2,2,2,1,NASDAQ
4829,14-02-2021 04:00,24 hrs.,wallstreetbets,RIGL,7,7,0,7,1,1,1,1,NASDAQ
4829,14-02-2021 04:00,24 hrs.,wallstreetbets,RIOT,21,7,14,-7,3,3,3,3,NASDAQ
4829,14-02-2021 04:00,24 hrs.,wallstreetbets,RKDA,7,7,0,7,1,1,1,1,NASDAQ
4829,14-02-2021 04:00,24 hrs.,wallstreetbets,RNWK,6,6,0,6,1,1,0,1,NASDAQ
4829,14-02-2021 04:00,24 hrs.,wallstreetbets,ROKU,4548,3455,1093,2362,4,2050,432,4,NASDAQ
4829,14-02-2021 04:00,24 hrs.,wallstreetbets,SABR,7,7,0,7,1,1,1,1,NASDAQ
4829,14-02-2021 04:00,24 hrs.,wallstreetbets,SEDG,154,154,0,154,1,57,36,1,NASDAQ
4829,14-02-2021 04:00,24 hrs.,wallstreetbets,SESN,6,6,0,6,1,1,0,1,NASDAQ
4829,14-02-2021 04:00,24 hrs.,RobinHoodPennyStocks,RETO,73,73,0,73,1,24,21,1,NASDAQ
4829,14-02-2021 04:00,24 hrs.,RobinHoodPennyStocks,SNDL,18,6,12,-6,3,3,0,3,NASDAQ
4829,14-02-2021 04:00,24 hrs.,RobinHoodPennyStocks,SONM,23,0,23,-23,1,3,13,1,NASDAQ
4829,14-02-2021 04:00,24 hrs.,RobinHoodPennyStocks,SXTC,14,14,0,14,1,4,2,1,NASDAQ
4829,14-02-2021 04:00,24 hrs.,RobinHoodPennyStocks,TNXP,18,18,0,18,3,3,0,1,NASDAQ
4829,14-02-2021 04:00,24 hrs.,RobinHoodPennyStocks,TRCH,72,6,66,-60,2,18,28,2,NASDAQ
4829,14-02-2021 04:00,24 hrs.,RobinHoodPennyStocks,TSLA,6,6,0,6,1,1,0,1,NASDAQ
4829,14-02-2021 04:00,24 hrs.,RobinHoodPennyStocks,TXMD,19,13,6,7,2,2,7,2,NASDAQ
4829,14-02-2021 04:00,24 hrs.,RobinHoodPennyStocks,TYME,6,0,6,-6,1,1,0,1,NASDAQ
4829,14-02-2021 04:00,24 hrs.,wallstreetbets,WKHS,3406,3392,14,3378,5,1499,388,4,NASDAQ
4829,14-02-2021 04:00,24 hrs.,wallstreetbets,WSBC,8,0,8,-8,1,1,2,1,NASDAQ
4829,14-02-2021 04:00,24 hrs.,wallstreetbets,YNDX,154,154,0,154,1,57,36,1,NASDAQ
4829,14-02-2021 04:00,24 hrs.,wallstreetbets,ZNGA,7,7,0,7,1,1,1,1,NASDAQ
4829,14-02-2021 04:00,24 hrs.,wallstreetbets,CMCSA,7,0,7,-7,1,1,1,1,NASDAQ
4829,14-02-2021 04:00,24 hrs.,RobinHoodPennyStocks,CRWG,6,0,6,-6,1,1,0,1,OTC
4829,14-02-2021 04:00,24 hrs.,RobinHoodPennyStocks,HCMC,6,6,0,6,1,1,0,1,OTC
4829,14-02-2021 04:00,24 hrs.,RobinHoodPennyStocks,RTSL,6,6,0,6,1,1,0,1,OTC
4829,14-02-2021 04:00,24 hrs.,RobinHoodPennyStocks,SGMD,6,6,0,6,1,1,0,1,OTC
4829,14-02-2021 04:00,24 hrs.,RobinHoodPennyStocks,EMHTF,6,6,0,6,1,1,0,1,OTC
4829,14-02-2021 04:00,24 hrs.,RobinHoodPennyStocks,MEDIF,6,0,6,-6,1,1,0,1,OTC
4829,14-02-2021 04:00,24 hrs.,RobinHoodPennyStocks,TBPMF,7,7,0,7,1,1,1,1,OTC
4829,14-02-2021 04:00,24 hrs.,RobinHoodPennyStocks,DNN,6,0,6,-6,1,1,0,1,AMEX
4829,14-02-2021 04:00,24 hrs.,RobinHoodPennyStocks,DPW,37,37,0,37,1,11,11,1,AMEX
4829,14-02-2021 04:00,24 hrs.,RobinHoodPennyStocks,DSS,6,6,0,6,1,1,0,1,AMEX
4829,14-02-2021 04:00,24 hrs.,RobinHoodPennyStocks,GTE,99,16,83,-67,2,28,35,2,AMEX
4829,14-02-2021 04:00,24 hrs.,RobinHoodPennyStocks,NAK,6,6,0,6,1,1,0,1,AMEX
4829,14-02-2021 04:00,24 hrs.,RobinHoodPennyStocks,PTN,10,10,0,10,1,2,2,1,AMEX
4829,14-02-2021 04:00,24 hrs.,RobinHoodPennyStocks,ZOM,153,16,137,-121,2,48,49,2,AMEX
4829,14-02-2021 04:00,24 hrs.,RobinHoodPennyStocks,CPHI,73,73,0,73,1,24,21,1,AMEX
4829,14-02-2021 04:00,24 hrs.,RobinHoodPennyStocks,ETN,12,12,0,12,2,2,0,1,NYSE
4829,14-02-2021 04:00,24 hrs.,RobinHoodPennyStocks,GME,8,8,0,8,1,1,2,1,NYSE
4829,14-02-2021 04:00,24 hrs.,RobinHoodPennyStocks,MRO,67,0,67,-67,1,26,11,1,NYSE
4829,14-02-2021 04:00,24 hrs.,RobinHoodPennyStocks,NOK,8,8,0,8,1,1,2,1,NYSE
4829,14-02-2021 04:00,24 hrs.,RobinHoodPennyStocks,PEG,242,242,0,242,1,111,16,1,NYSE
4829,14-02-2021 04:00,24 hrs.,RobinHoodPennyStocks,RSI,242,242,0,242,1,111,16,1,NYSE
4829,14-02-2021 04:00,24 hrs.,RobinHoodPennyStocks,SOS,6,6,0,6,1,1,0,1,NYSE
4829,14-02-2021 04:00,24 hrs.,RobinHoodPennyStocks,DECK,6,6,0,6,1,1,0,1,NYSE
4829,14-02-2021 04:00,24 hrs.,RobinHoodPennyStocks,IPOE,6,6,0,6,1,1,0,1,NYSE
4829,14-02-2021 04:00,24 hrs.,RobinHoodPennyStocks,SND,59,0,59,-59,1,17,21,1,NASDAQ
4829,14-02-2021 04:00,24 hrs.,RobinHoodPennyStocks,AAPL,242,242,0,242,1,111,16,1,NASDAQ
4829,14-02-2021 04:00,24 hrs.,RobinHoodPennyStocks,ADXS,6,6,0,6,1,1,0,1,NASDAQ
4829,14-02-2021 04:00,24 hrs.,RobinHoodPennyStocks,AGEN,6,6,0,6,1,1,0,1,NASDAQ
4829,14-02-2021 04:00,24 hrs.,RobinHoodPennyStocks,AGTC,16,16,0,16,1,3,6,1,NASDAQ
4829,14-02-2021 04:00,24 hrs.,RobinHoodPennyStocks,AKBA,7,7,0,7,1,1,1,1,NASDAQ
4829,14-02-2021 04:00,24 hrs.,RobinHoodPennyStocks,ASRT,13,13,0,13,1,1,7,1,NASDAQ
4829,14-02-2021 04:00,24 hrs.,RobinHoodPennyStocks,BNGO,4,0,4,-4,1,0,0,1,NASDAQ
4829,14-02-2021 04:00,24 hrs.,RobinHoodPennyStocks,BVXV,6,6,0,6,1,1,0,1,NASDAQ
4829,14-02-2021 04:00,24 hrs.,RobinHoodPennyStocks,CLBS,6,0,6,-6,1,1,0,1,NASDAQ
4829,14-02-2021 04:00,24 hrs.,RobinHoodPennyStocks,CRBP,46,0,46,-46,1,17,8,1,NASDAQ
4829,14-02-2021 04:00,24 hrs.,RobinHoodPennyStocks,CSCW,73,73,0,73,1,24,21,1,NASDAQ
4829,14-02-2021 04:00,24 hrs.,RobinHoodPennyStocks,CSTR,4,4,0,4,1,0,0,1,NASDAQ
4829,14-02-2021 04:00,24 hrs.,RobinHoodPennyStocks,CTRM,47,6,41,-35,2,7,25,2,NASDAQ
4829,14-02-2021 04:00,24 hrs.,wallstreetbets,SQQQ,7,7,0,7,1,1,1,1,NASDAQ
4829,14-02-2021 04:00,24 hrs.,wallstreetbets,SRAC,7,0,7,-7,1,1,1,1,NASDAQ
4829,14-02-2021 04:00,24 hrs.,wallstreetbets,SRNE,7,7,0,7,1,1,1,1,NASDAQ
4829,14-02-2021 04:00,24 hrs.,wallstreetbets,SSRM,6,0,6,-6,1,1,0,1,NASDAQ
4829,14-02-2021 04:00,24 hrs.,wallstreetbets,STAF,6,0,6,-6,1,1,0,1,NASDAQ
4829,14-02-2021 04:00,24 hrs.,wallstreetbets,STMP,154,154,0,154,1,57,36,1,NASDAQ
4829,14-02-2021 04:00,24 hrs.,wallstreetbets,SWBI,7,0,7,-7,1,1,1,1,NASDAQ
4829,14-02-2021 04:00,24 hrs.,wallstreetbets,TLGT,19,19,0,19,3,3,1,1,NASDAQ
4829,14-02-2021 04:00,24 hrs.,wallstreetbets,TLRY,1427,278,1149,-871,18,593,169,14,NASDAQ
4829,14-02-2021 04:00,24 hrs.,wallstreetbets,TNXP,21,0,21,-21,3,3,3,3,NASDAQ
4829,14-02-2021 04:00,24 hrs.,wallstreetbets,TQQQ,14,0,14,-14,2,2,2,1,NASDAQ
4829,14-02-2021 04:00,24 hrs.,wallstreetbets,TRCH,19,0,19,-19,3,3,1,3,NASDAQ
4829,14-02-2021 04:00,24 hrs.,stocks,SOBR,6,0,6,-6,1,1,0,1,OTC
4829,14-02-2021 04:00,24 hrs.,stocks,TRUL,6,6,0,6,1,1,0,1,OTC
4829,14-02-2021 04:00,24 hrs.,SPACs,CAGR,44,44,0,44,1,0,40,1,OTC
4829,14-02-2021 04:00,24 hrs.,SPACs,NOVC,6,0,6,-6,1,0,2,1,OTC
4829,14-02-2021 04:00,24 hrs.,SPACs,PTK,83,0,83,-83,1,23,33,1,AMEX
4829,14-02-2021 04:00,24 hrs.,SPACs,CHAQ,83,0,83,-83,1,23,33,1,AMEX
4829,14-02-2021 04:00,24 hrs.,SPACs,AMC,20,0,20,-20,1,2,12,1,NYSE
4829,14-02-2021 04:00,24 hrs.,SPACs,BFT,57,57,0,57,3,2,41,3,NYSE
4829,14-02-2021 04:00,24 hrs.,SPACs,FSR,34,0,34,-34,1,5,20,1,NYSE
4829,14-02-2021 04:00,24 hrs.,SPACs,GME,20,0,20,-20,1,2,12,1,NYSE
4829,14-02-2021 04:00,24 hrs.,SPACs,JWS,59,53,6,47,3,1,45,3,NYSE
4829,14-02-2021 04:00,24 hrs.,SPACs,NAV,1030,789,241,548,6,351,304,6,NYSE
4829,14-02-2021 04:00,24 hrs.,SPACs,NGA,34,0,34,-34,1,5,20,1,NYSE
4829,14-02-2021 04:00,24 hrs.,SPACs,SBE,78,44,34,10,2,5,60,2,NYSE
4829,14-02-2021 04:00,24 hrs.,SPACs,SOS,7,0,7,-7,1,1,1,1,NYSE
4829,14-02-2021 04:00,24 hrs.,SPACs,ACIC,6,0,6,-6,1,1,0,1,NYSE
4829,14-02-2021 04:00,24 hrs.,SPACs,AJAX,76,76,0,76,1,9,54,1,NYSE
4829,14-02-2021 04:00,24 hrs.,SPACs,ALUS,17,17,0,17,1,4,5,1,NYSE
4829,14-02-2021 04:00,24 hrs.,SPACs,AVAN,46,0,46,-46,1,13,16,1,NYSE
4829,14-02-2021 04:00,24 hrs.,SPACs,CCIV,1298,988,310,678,13,450,346,11,NYSE
4829,14-02-2021 04:00,24 hrs.,SPACs,DNMR,64,0,64,-64,1,22,16,1,NYSE
4829,14-02-2021 04:00,24 hrs.,SPACs,FGNA,342,342,0,342,1,104,130,1,NYSE
4829,14-02-2021 04:00,24 hrs.,SPACs,FUSE,401,342,59,283,2,107,179,2,NYSE
4829,14-02-2021 04:00,24 hrs.,SPACs,HYLN,34,0,34,-34,1,5,20,1,NYSE
4829,14-02-2021 04:00,24 hrs.,SPACs,IPOF,11,0,11,-11,2,1,1,2,NYSE
4829,14-02-2021 04:00,24 hrs.,SPACs,LGVW,41,0,41,-41,2,6,21,2,NYSE
4829,14-02-2021 04:00,24 hrs.,SPACs,MPLN,61,61,0,61,1,24,9,1,NYSE
4829,14-02-2021 04:00,24 hrs.,SPACs,PCPL,342,342,0,342,1,104,130,1,NYSE
4829,14-02-2021 04:00,24 hrs.,SPACs,PSTH,1073,1034,39,995,10,386,261,9,NYSE
4829,14-02-2021 04:00,24 hrs.,SPACs,RBAC,19,19,0,19,1,2,11,1,NYSE
4829,14-02-2021 04:00,24 hrs.,SPACs,SKLZ,27,27,0,27,4,4,3,1,NYSE
4829,14-02-2021 04:00,24 hrs.,SPACs,SNPR,6,0,6,-6,1,1,0,1,NYSE
4829,14-02-2021 04:00,24 hrs.,SPACs,STPK,100,66,34,32,5,8,64,3,NYSE
4829,14-02-2021 04:00,24 hrs.,SPACs,TPGY,34,0,34,-34,1,5,20,1,NYSE
4829,14-02-2021 04:00,24 hrs.,SPACs,VYGG,27,7,20,-13,4,4,3,2,NYSE
4829,14-02-2021 04:00,24 hrs.,SPACs,III,120,120,0,120,1,37,42,1,NASDAQ
4829,14-02-2021 04:00,24 hrs.,SPACs,AACQ,489,345,144,201,6,165,135,6,NASDAQ
4829,14-02-2021 04:00,24 hrs.,SPACs,ACAC,39,39,0,39,1,10,15,1,NASDAQ
4829,14-02-2021 04:00,24 hrs.,SPACs,ACTC,34,0,34,-34,1,5,20,1,NASDAQ
4829,14-02-2021 04:00,24 hrs.,SPACs,ADOC,83,0,83,-83,1,23,33,1,NASDAQ
4829,14-02-2021 04:00,24 hrs.,SPACs,BHSE,83,0,83,-83,1,23,33,1,NASDAQ
4829,14-02-2021 04:00,24 hrs.,SPACs,BRPA,34,0,34,-34,1,5,20,1,NASDAQ
4829,14-02-2021 04:00,24 hrs.,SPACs,BTAQ,94,94,0,94,2,34,18,2,NASDAQ
4829,14-02-2021 04:00,24 hrs.,SPACs,CIIC,34,0,34,-34,1,5,20,1,NASDAQ
4829,14-02-2021 04:00,24 hrs.,SPACs,CMLF,34,0,34,-34,1,5,20,1,NASDAQ
4829,14-02-2021 04:00,24 hrs.,SPACs,FTOC,618,342,276,66,2,216,178,2,NASDAQ
4829,14-02-2021 04:00,24 hrs.,SPACs,GHIV,462,462,0,462,2,141,172,2,NASDAQ
4829,14-02-2021 04:00,24 hrs.,SPACs,GRCY,83,0,83,-83,1,23,33,1,NASDAQ
4829,14-02-2021 04:00,24 hrs.,SPACs,MACU,83,0,83,-83,1,23,33,1,NASDAQ
4829,14-02-2021 04:00,24 hrs.,SPACs,NBAC,21,0,21,-21,1,8,1,1,NASDAQ
4829,14-02-2021 04:00,24 hrs.,SPACs,NGAC,138,138,0,138,2,50,30,2,NASDAQ
4829,14-02-2021 04:00,24 hrs.,SPACs,NKLA,34,0,34,-34,1,5,20,1,NASDAQ
4829,14-02-2021 04:00,24 hrs.,SPACs,RIDE,34,0,34,-34,1,5,20,1,NASDAQ
4829,14-02-2021 04:00,24 hrs.,SPACs,ROCH,56,22,34,-12,2,12,24,2,NASDAQ
4829,14-02-2021 04:00,24 hrs.,SPACs,SSPK,52,18,34,-16,2,7,30,2,NASDAQ
4829,14-02-2021 04:00,24 hrs.,SPACs,THCB,262,228,34,194,2,102,50,2,NASDAQ
4829,14-02-2021 04:00,24 hrs.,SPACs,TSLA,10,10,0,10,1,0,6,1,NASDAQ
4829,14-02-2021 04:00,24 hrs.,SPACs,VTIQ,34,0,34,-34,1,5,20,1,NASDAQ
4829,14-02-2021 04:00,24 hrs.,RobinHoodPennyStocks,DFFN,74,0,74,-74,1,16,38,1,NASDAQ
4829,14-02-2021 04:00,24 hrs.,RobinHoodPennyStocks,EDIT,73,73,0,73,1,24,21,1,NASDAQ
4829,14-02-2021 04:00,24 hrs.,RobinHoodPennyStocks,FLMN,6,6,0,6,1,1,0,1,NASDAQ
4829,14-02-2021 04:00,24 hrs.,RobinHoodPennyStocks,GOGO,11,11,0,11,1,0,7,1,NASDAQ
4829,14-02-2021 04:00,24 hrs.,RobinHoodPennyStocks,GRPN,21,21,0,21,1,5,7,1,NASDAQ
4829,14-02-2021 04:00,24 hrs.,RobinHoodPennyStocks,JAGX,84,84,0,84,1,31,18,1,NASDAQ
4829,14-02-2021 04:00,24 hrs.,stocks,VFF,6,0,6,-6,1,1,0,1,NASDAQ
4829,14-02-2021 04:00,24 hrs.,stocks,AAPL,97,97,0,97,4,13,55,4,NASDAQ
4829,14-02-2021 04:00,24 hrs.,stocks,AESE,6,0,6,-6,1,1,0,1,NASDAQ
4829,14-02-2021 04:00,24 hrs.,stocks,AGTC,6,6,0,6,1,1,0,1,NASDAQ
4829,14-02-2021 04:00,24 hrs.,stocks,AMAT,35,0,35,-35,1,8,15,1,NASDAQ
4829,14-02-2021 04:00,24 hrs.,stocks,AMZN,6,6,0,6,1,1,0,1,NASDAQ
4829,14-02-2021 04:00,24 hrs.,stocks,XFLS,4,0,4,-4,1,0,0,1,OTC
4829,14-02-2021 04:00,24 hrs.,stocks,COCSF,37,37,0,37,1,16,1,1,OTC
4829,14-02-2021 04:00,24 hrs.,stocks,HITIF,6,0,6,-6,1,1,0,1,OTC
4829,14-02-2021 04:00,24 hrs.,stocks,HRVSF,6,6,0,6,1,1,0,1,OTC
4829,14-02-2021 04:00,24 hrs.,stocks,TCEHY,6,6,0,6,1,1,0,1,OTC
4829,14-02-2021 04:00,24 hrs.,stocks,TCNNF,6,6,0,6,1,1,0,1,OTC
4829,14-02-2021 04:00,24 hrs.,stocks,XJNGF,6,0,6,-6,1,1,0,1,OTC
4829,14-02-2021 04:00,24 hrs.,stocks,SENS,19,0,19,-19,2,1,9,1,AMEX
4829,14-02-2021 04:00,24 hrs.,stocks,UAVS,6,6,0,6,1,1,0,1,AMEX
4829,14-02-2021 04:00,24 hrs.,stocks,AAP,549,0,549,-549,1,253,39,1,NYSE
4829,14-02-2021 04:00,24 hrs.,stocks,AEO,15,15,0,15,1,2,7,1,NYSE
4829,14-02-2021 04:00,24 hrs.,stocks,AIV,37,37,0,37,1,12,9,1,NYSE
4829,14-02-2021 04:00,24 hrs.,stocks,AMC,6,6,0,6,1,1,0,1,NYSE
4829,14-02-2021 04:00,24 hrs.,stocks,ASX,6,0,6,-6,1,1,0,1,NYSE
4829,14-02-2021 04:00,24 hrs.,stocks,BKH,50,50,0,50,1,15,16,1,NYSE
4829,14-02-2021 04:00,24 hrs.,stocks,CMA,6,0,6,-6,1,1,0,1,NYSE
4829,14-02-2021 04:00,24 hrs.,stocks,CNQ,24,24,0,24,1,5,10,1,NYSE
4829,14-02-2021 04:00,24 hrs.,stocks,CVE,24,24,0,24,1,5,10,1,NYSE
4829,14-02-2021 04:00,24 hrs.,stocks,CVS,549,0,549,-549,1,253,39,1,NYSE
4829,14-02-2021 04:00,24 hrs.,stocks,DCF,14,14,0,14,1,3,4,1,NYSE
4829,14-02-2021 04:00,24 hrs.,stocks,DDD,549,0,549,-549,1,253,39,1,NYSE
4829,14-02-2021 04:00,24 hrs.,stocks,DDS,549,0,549,-549,1,253,39,1,NYSE
4829,14-02-2021 04:00,24 hrs.,stocks,DIS,42,42,0,42,3,4,22,3,NYSE
4829,14-02-2021 04:00,24 hrs.,stocks,EFT,17,0,17,-17,1,5,3,1,NYSE
4829,14-02-2021 04:00,24 hrs.,stocks,ELY,34,34,0,34,1,3,24,1,NYSE
4829,14-02-2021 04:00,24 hrs.,stocks,ENB,13,13,0,13,1,3,3,1,NYSE
4829,14-02-2021 04:00,24 hrs.,stocks,ETH,6,6,0,6,1,1,0,1,NYSE
4829,14-02-2021 04:00,24 hrs.,stocks,FTI,16,16,0,16,2,4,0,2,NYSE
4829,14-02-2021 04:00,24 hrs.,stocks,GME,567,12,555,-543,4,256,39,4,NYSE
4829,14-02-2021 04:00,24 hrs.,stocks,HPQ,253,0,253,-253,1,99,51,1,NYSE
4829,14-02-2021 04:00,24 hrs.,stocks,IBM,1813,50,1763,-1713,2,814,177,2,NYSE
4829,14-02-2021 04:00,24 hrs.,stocks,IGT,549,0,549,-549,1,253,39,1,NYSE
4829,14-02-2021 04:00,24 hrs.,stocks,IRS,9,0,9,-9,1,0,5,1,NYSE
4829,14-02-2021 04:00,24 hrs.,stocks,JNJ,56,50,6,44,2,16,16,2,NYSE
4829,14-02-2021 04:00,24 hrs.,stocks,JPM,50,50,0,50,1,15,16,1,NYSE
4829,14-02-2021 04:00,24 hrs.,stocks,KOF,37,37,0,37,1,16,1,1,NYSE
4829,14-02-2021 04:00,24 hrs.,stocks,LAC,6,6,0,6,1,1,0,1,NYSE
4829,14-02-2021 04:00,24 hrs.,stocks,LEG,50,50,0,50,1,15,16,1,NYSE
4829,14-02-2021 04:00,24 hrs.,stocks,LOW,9,0,9,-9,1,0,5,1,NYSE
4829,14-02-2021 04:00,24 hrs.,stocks,LPL,549,0,549,-549,1,253,39,1,NYSE
4829,14-02-2021 04:00,24 hrs.,stocks,LTC,34,34,0,34,1,3,24,1,NYSE
4829,14-02-2021 04:00,24 hrs.,stocks,MAC,87,87,0,87,1,34,15,1,NYSE
4829,14-02-2021 04:00,24 hrs.,stocks,MFA,6,6,0,6,1,1,0,1,NYSE
4829,14-02-2021 04:00,24 hrs.,SPACs,AACQW,41,0,41,-41,1,13,11,1,NASDAQ
4829,14-02-2021 04:00,24 hrs.,stocks,ABML,14,0,14,-14,1,1,8,1,OTC
4829,14-02-2021 04:00,24 hrs.,stocks,ENKS,6,6,0,6,1,1,0,1,OTC
4829,14-02-2021 04:00,24 hrs.,stocks,KYNC,6,0,6,-6,1,1,0,1,OTC
4829,14-02-2021 04:00,24 hrs.,stocks,LINK,549,0,549,-549,1,253,39,1,OTC
4829,14-02-2021 04:00,24 hrs.,stocks,LQMT,15,15,0,15,1,4,3,1,OTC
4829,14-02-2021 04:00,24 hrs.,stocks,LTNC,6,6,0,6,1,1,0,1,OTC
4829,14-02-2021 04:00,24 hrs.,stocks,MINE,18,0,18,-18,3,3,0,1,OTC
4829,14-02-2021 04:00,24 hrs.,stocks,MOST,549,0,549,-549,1,253,39,1,OTC
4829,14-02-2021 04:00,24 hrs.,stocks,NMTC,69,69,0,69,1,26,13,1,OTC
4829,14-02-2021 04:00,24 hrs.,stocks,OPTI,6,6,0,6,1,1,0,1,OTC
4829,14-02-2021 04:00,24 hrs.,stocks,PPJE,6,6,0,6,1,1,0,1,OTC
4829,14-02-2021 04:00,24 hrs.,stocks,ROTH,7,7,0,7,1,1,1,1,OTC
4829,14-02-2021 04:00,24 hrs.,stocks,SAGD,24,24,0,24,1,5,10,1,OTC
4829,14-02-2021 04:00,24 hrs.,stocks,SGMD,12,6,6,0,2,2,0,2,OTC
4829,14-02-2021 04:00,24 hrs.,Daytrading,MSN,16,16,0,16,1,2,8,1,AMEX
4829,14-02-2021 04:00,24 hrs.,Daytrading,AMC,5,5,0,5,1,0,1,1,NYSE
4829,14-02-2021 04:00,24 hrs.,Daytrading,GME,57,57,0,57,2,12,25,2,NYSE
4829,14-02-2021 04:00,24 hrs.,Daytrading,IRS,11,11,0,11,1,1,5,1,NYSE
4829,14-02-2021 04:00,24 hrs.,Daytrading,NIO,12,0,12,-12,1,2,4,1,NYSE
4829,14-02-2021 04:00,24 hrs.,Daytrading,PDT,35,25,10,15,4,3,13,3,NYSE
4829,14-02-2021 04:00,24 hrs.,Daytrading,TWO,6,6,0,6,1,1,0,1,NYSE
4829,14-02-2021 04:00,24 hrs.,Daytrading,DUO,6,6,0,6,1,1,0,1,NASDAQ
4829,14-02-2021 04:00,24 hrs.,Daytrading,AAPL,12,0,12,-12,1,2,4,1,NASDAQ
4829,14-02-2021 04:00,24 hrs.,Daytrading,ARTL,6,0,6,-6,1,1,0,1,NASDAQ
4829,14-02-2021 04:00,24 hrs.,Daytrading,SNDL,42,0,42,-42,1,7,24,1,NASDAQ
4829,14-02-2021 04:00,24 hrs.,Daytrading,TRMD,6,6,0,6,1,1,0,1,NASDAQ
4829,14-02-2021 04:00,24 hrs.,Daytrading,TSLA,27,0,27,-27,1,2,19,1,NASDAQ
4829,14-02-2021 04:00,24 hrs.,trakstocks,DMNXF,93,0,93,-93,2,26,33,2,OTC
4829,14-02-2021 04:00,24 hrs.,stocks,ANTE,12,0,12,-12,2,2,0,1,NASDAQ
4829,14-02-2021 04:00,24 hrs.,stocks,APHA,175,6,169,-163,3,44,75,3,NASDAQ
4829,14-02-2021 04:00,24 hrs.,stocks,APRE,6,6,0,6,1,1,0,1,NASDAQ
4829,14-02-2021 04:00,24 hrs.,stocks,ATOS,6,6,0,6,1,1,0,1,NASDAQ
4829,14-02-2021 04:00,24 hrs.,stocks,AZRX,6,6,0,6,1,1,0,1,NASDAQ
4829,14-02-2021 04:00,24 hrs.,stocks,MMM,50,50,0,50,1,15,16,1,NYSE
4829,14-02-2021 04:00,24 hrs.,stocks,MPW,34,34,0,34,1,3,24,1,NYSE
4829,14-02-2021 04:00,24 hrs.,stocks,MTD,549,0,549,-549,1,253,39,1,NYSE
4829,14-02-2021 04:00,24 hrs.,stocks,NET,4822,0,4822,-4822,2,2155,504,2,NYSE
4829,14-02-2021 04:00,24 hrs.,stocks,NGL,6,0,6,-6,1,1,0,1,NYSE
4829,14-02-2021 04:00,24 hrs.,stocks,NIO,123,0,123,-123,1,35,49,1,NYSE
4829,14-02-2021 04:00,24 hrs.,stocks,NSA,1763,0,1763,-1763,1,799,161,1,NYSE
4829,14-02-2021 04:00,24 hrs.,stocks,PBA,34,34,0,34,1,3,24,1,NYSE
4829,14-02-2021 04:00,24 hrs.,stocks,RBC,7,7,0,7,1,1,1,1,NYSE
4829,14-02-2021 04:00,24 hrs.,stocks,SBE,49,22,27,-5,2,13,15,2,NYSE
4829,14-02-2021 04:00,24 hrs.,stocks,SHO,6,0,6,-6,1,1,0,1,NYSE
4829,14-02-2021 04:00,24 hrs.,stocks,SKT,549,0,549,-549,1,253,39,1,NYSE
4829,14-02-2021 04:00,24 hrs.,stocks,SOI,7,7,0,7,1,1,1,1,NYSE
4829,14-02-2021 04:00,24 hrs.,stocks,SOS,42,42,0,42,1,11,16,1,NYSE
4829,14-02-2021 04:00,24 hrs.,stocks,TDA,14,0,14,-14,1,2,6,1,NYSE
4829,14-02-2021 04:00,24 hrs.,stocks,THC,73,73,0,73,1,19,31,1,NYSE
4829,14-02-2021 04:00,24 hrs.,stocks,TSM,31,31,0,31,1,1,25,1,NYSE
4829,14-02-2021 04:00,24 hrs.,stocks,WMT,549,0,549,-549,1,253,39,1,NYSE
4829,14-02-2021 04:00,24 hrs.,stocks,XOM,50,50,0,50,1,15,16,1,NYSE
4829,14-02-2021 04:00,24 hrs.,stocks,BABA,6,0,6,-6,1,1,0,1,NYSE
4829,14-02-2021 04:00,24 hrs.,stocks,BRMK,34,34,0,34,1,3,24,1,NYSE
4829,14-02-2021 04:00,24 hrs.,stocks,CCIV,6,0,6,-6,1,1,0,1,NYSE
4829,14-02-2021 04:00,24 hrs.,stocks,CHWY,253,0,253,-253,1,99,51,1,NYSE
4829,14-02-2021 04:00,24 hrs.,stocks,COTY,7,7,0,7,1,1,1,1,NYSE
4829,14-02-2021 04:00,24 hrs.,stocks,DSSI,17,17,0,17,1,3,7,1,NYSE
4829,14-02-2021 04:00,24 hrs.,stocks,FSLY,549,0,549,-549,1,253,39,1,NYSE
4829,14-02-2021 04:00,24 hrs.,stocks,FVRR,549,0,549,-549,1,253,39,1,NYSE
4829,14-02-2021 04:00,24 hrs.,stocks,NYCB,70,70,0,70,1,15,36,1,NYSE
4829,14-02-2021 04:00,24 hrs.,stocks,PLTR,684,0,684,-684,4,290,88,3,NYSE
4829,14-02-2021 04:00,24 hrs.,stocks,SHOP,549,0,549,-549,1,253,39,1,NYSE
4829,14-02-2021 04:00,24 hrs.,stocks,SNAP,36,36,0,36,1,7,18,1,NYSE
4829,14-02-2021 04:00,24 hrs.,stocks,SPCE,163,0,163,-163,1,42,75,1,NYSE
4829,14-02-2021 04:00,24 hrs.,stocks,TWLO,549,0,549,-549,1,253,39,1,NYSE
4829,14-02-2021 04:00,24 hrs.,stocks,AAL,46,46,0,46,1,4,34,1,NASDAQ
4829,14-02-2021 04:00,24 hrs.,stocks,AMD,7,7,0,7,1,1,1,1,NASDAQ
4829,14-02-2021 04:00,24 hrs.,stocks,BLI,549,0,549,-549,1,253,39,1,NASDAQ
4829,14-02-2021 04:00,24 hrs.,stocks,CFO,6,6,0,6,1,1,0,1,NASDAQ
4829,14-02-2021 04:00,24 hrs.,stocks,FUV,19,19,0,19,2,3,5,2,NASDAQ
4829,14-02-2021 04:00,24 hrs.,stocks,III,10,10,0,10,1,2,2,1,NASDAQ
4829,14-02-2021 04:00,24 hrs.,stocks,NIU,163,0,163,-163,1,42,75,1,NASDAQ
4829,14-02-2021 04:00,24 hrs.,stocks,PAA,34,34,0,34,1,3,24,1,NASDAQ
4829,14-02-2021 04:00,24 hrs.,stocks,PEP,23,23,0,23,1,7,5,1,NASDAQ
4829,14-02-2021 04:00,24 hrs.,stocks,QQQ,13,13,0,13,1,3,3,1,NASDAQ
4829,14-02-2021 04:00,24 hrs.,stocks,QTT,6,6,0,6,1,1,0,1,NASDAQ
4829,14-02-2021 04:00,24 hrs.,stocks,REG,6,0,6,-6,1,1,0,1,NASDAQ
4829,14-02-2021 04:00,24 hrs.,trakstocks,STPK,66,8,58,-50,2,25,8,2,NYSE
4829,14-02-2021 04:00,24 hrs.,trakstocks,FUV,42,42,0,42,1,15,8,1,NASDAQ
4829,14-02-2021 04:00,24 hrs.,trakstocks,PLL,15,15,0,15,1,4,3,1,NASDAQ
4829,14-02-2021 04:00,24 hrs.,trakstocks,AAPL,102,102,0,102,1,45,8,1,NASDAQ
4829,14-02-2021 04:00,24 hrs.,trakstocks,AYRO,63,53,10,43,3,18,15,3,NASDAQ
4829,14-02-2021 04:00,24 hrs.,trakstocks,CLVS,29,0,29,-29,1,12,1,1,NASDAQ
4829,14-02-2021 04:00,24 hrs.,trakstocks,ENLV,6,6,0,6,1,1,0,1,NASDAQ
4829,14-02-2021 04:00,24 hrs.,trakstocks,LIFE,94,94,0,94,1,33,24,1,NASDAQ
4829,14-02-2021 04:00,24 hrs.,trakstocks,MNOV,6,6,0,6,1,1,0,1,NASDAQ
4829,14-02-2021 04:00,24 hrs.,trakstocks,MVIS,17,17,0,17,1,5,3,1,NASDAQ
4829,14-02-2021 04:00,24 hrs.,trakstocks,QLGN,18,18,0,18,2,5,0,1,NASDAQ
4829,14-02-2021 04:00,24 hrs.,trakstocks,SNDL,58,0,58,-58,1,23,8,1,NASDAQ
4829,14-02-2021 04:00,24 hrs.,trakstocks,TLRY,58,0,58,-58,1,23,8,1,NASDAQ
4829,14-02-2021 04:00,24 hrs.,trakstocks,TRCH,48,48,0,48,1,18,8,1,NASDAQ
4829,14-02-2021 04:00,24 hrs.,stocks,BIGC,549,0,549,-549,1,253,39,1,NASDAQ
4829,14-02-2021 04:00,24 hrs.,stocks,BNGO,24,18,6,12,4,4,0,4,NASDAQ
4829,14-02-2021 04:00,24 hrs.,stocks,CCRC,6,6,0,6,1,1,0,1,NASDAQ
4829,14-02-2021 04:00,24 hrs.,stocks,CRNC,27,0,27,-27,1,8,7,1,NASDAQ
4829,14-02-2021 04:00,24 hrs.,stocks,CRNT,6,6,0,6,1,1,0,1,NASDAQ
4829,14-02-2021 04:00,24 hrs.,stocks,CRSR,174,174,0,174,1,50,70,1,NASDAQ
4829,14-02-2021 04:00,24 hrs.,stocks,DRIV,28,28,0,28,1,9,6,1,NASDAQ
4829,14-02-2021 04:00,24 hrs.,stocks,EDIT,54,0,54,-54,2,12,22,2,NASDAQ
4829,14-02-2021 04:00,24 hrs.,stocks,EXEL,6,6,0,6,1,0,2,1,NASDAQ
4829,14-02-2021 04:00,24 hrs.,stocks,EXPI,36,4,32,-28,3,9,6,3,NASDAQ
4829,14-02-2021 04:00,24 hrs.,stocks,FIZZ,549,0,549,-549,1,253,39,1,NASDAQ
4829,14-02-2021 04:00,24 hrs.,stocks,FOLD,33,33,0,33,1,7,15,1,NASDAQ
4829,14-02-2021 04:00,24 hrs.,stocks,FROG,6,0,6,-6,1,1,0,1,NASDAQ
4829,14-02-2021 04:00,24 hrs.,stocks,GLUU,6,0,6,-6,1,1,0,1,NASDAQ
4829,14-02-2021 04:00,24 hrs.,stocks,GNOG,6,0,6,-6,1,1,0,1,NASDAQ
4829,14-02-2021 04:00,24 hrs.,stocks,GOGO,555,6,549,-543,2,254,39,2,NASDAQ
4829,14-02-2021 04:00,24 hrs.,stocks,GOOG,56,56,0,56,1,9,34,1,NASDAQ
4829,14-02-2021 04:00,24 hrs.,stocks,GTHX,12,12,0,12,2,2,0,1,NASDAQ
4829,14-02-2021 04:00,24 hrs.,stocks,HOLI,12,12,0,12,2,2,0,1,NASDAQ
4829,14-02-2021 04:00,24 hrs.,stocks,IFMK,18,18,0,18,3,3,0,1,NASDAQ
4829,14-02-2021 04:00,24 hrs.,stocks,ITRM,6,0,6,-6,1,1,0,1,NASDAQ
4829,14-02-2021 04:00,24 hrs.,stocks,KLIC,34,0,34,-34,1,13,4,1,NASDAQ
4829,14-02-2021 04:00,24 hrs.,stocks,KOPN,18,18,0,18,1,5,4,1,NASDAQ
4829,14-02-2021 04:00,24 hrs.,stocks,MSFT,91,91,0,91,3,12,55,3,NASDAQ
4829,14-02-2021 04:00,24 hrs.,stocks,MVIS,6,6,0,6,1,1,0,1,NASDAQ
4829,14-02-2021 04:00,24 hrs.,stocks,NCNO,549,0,549,-549,1,253,39,1,NASDAQ
4829,14-02-2021 04:00,24 hrs.,stocks,NXTD,6,0,6,-6,1,1,0,1,NASDAQ
4829,14-02-2021 04:00,24 hrs.,stocks,PBCT,50,50,0,50,1,15,16,1,NASDAQ
4829,14-02-2021 04:00,24 hrs.,stocks,QQQJ,1124,1124,0,1124,1,419,282,1,NASDAQ
4829,14-02-2021 04:00,24 hrs.,stocks,QQQM,1124,1124,0,1124,1,419,282,1,NASDAQ
4829,14-02-2021 04:00,24 hrs.,stocks,RDFN,26,0,26,-26,1,8,6,1,NASDAQ
4829,14-02-2021 04:00,24 hrs.,stocks,REGI,13,13,0,13,1,2,5,1,NASDAQ
4829,14-02-2021 04:00,24 hrs.,stocks,REGN,6,0,6,-6,1,1,0,1,NASDAQ
4829,14-02-2021 04:00,24 hrs.,stocks,RIOT,12,12,0,12,2,2,0,1,NASDAQ
4829,14-02-2021 04:00,24 hrs.,stocks,ROKU,549,0,549,-549,1,253,39,1,NASDAQ
4829,14-02-2021 04:00,24 hrs.,stocks,RRGB,31,0,31,-31,1,6,15,1,NASDAQ
4829,14-02-2021 04:00,24 hrs.,stocks,SIRI,34,34,0,34,1,3,24,1,NASDAQ
4829,14-02-2021 04:00,24 hrs.,stocks,SNDL,14,14,0,14,2,2,2,2,NASDAQ
4829,14-02-2021 04:00,24 hrs.,stocks,TFFP,26,0,26,-26,2,5,8,1,NASDAQ
4829,14-02-2021 04:00,24 hrs.,stocks,TLRY,567,12,555,-543,4,256,39,4,NASDAQ
4829,14-02-2021 04:00,24 hrs.,stocks,TRCH,7,7,0,7,1,1,1,1,NASDAQ
4829,14-02-2021 04:00,24 hrs.,stocks,TREE,549,0,549,-549,1,253,39,1,NASDAQ
4829,14-02-2021 04:00,24 hrs.,stocks,VGLT,6,6,0,6,1,1,0,1,NASDAQ
4829,14-02-2021 04:00,24 hrs.,stocks,VXUS,11,11,0,11,1,1,5,1,NASDAQ
4829,14-02-2021 04:00,24 hrs.,stocks,WIMI,6,6,0,6,1,1,0,1,NASDAQ
4829,14-02-2021 04:00,24 hrs.,stocks,XONE,12,0,12,-12,1,2,4,1,NASDAQ
4829,14-02-2021 04:00,24 hrs.,stocks,ZNGA,41,41,0,41,1,13,11,1,NASDAQ
4829,14-02-2021 04:00,24 hrs.,stocks,LBTYB,7,7,0,7,1,1,1,1,NASDAQ
4829,14-02-2021 04:00,24 hrs.,stocks,LILAK,12,0,12,-12,2,2,0,1,NASDAQ
4829,14-02-2021 04:00,24 hrs.,Daytrading,GTE,7,0,7,-7,1,1,1,1,AMEX
4829,14-02-2021 04:00,24 hrs.,StockMarket,AQB,8,0,8,-8,1,2,0,1,NASDAQ
4829,14-02-2021 04:00,24 hrs.,StockMarket,BLI,81,0,81,-81,1,36,5,1,NASDAQ
4829,14-02-2021 04:00,24 hrs.,StockMarket,DBX,81,0,81,-81,1,36,5,1,NASDAQ
4829,14-02-2021 04:00,24 hrs.,StockMarket,FOX,13,13,0,13,1,1,7,1,NASDAQ
4829,14-02-2021 04:00,24 hrs.,StockMarket,QQQ,9,0,9,-9,1,0,5,1,NASDAQ
4829,14-02-2021 04:00,24 hrs.,StockMarket,TTD,81,0,81,-81,1,36,5,1,NASDAQ
4829,14-02-2021 04:00,24 hrs.,StockMarket,UFO,17,17,0,17,1,3,7,1,NASDAQ
4829,14-02-2021 04:00,24 hrs.,StockMarket,WIX,81,0,81,-81,1,36,5,1,NASDAQ
4829,14-02-2021 04:00,24 hrs.,StockMarket,WNW,6,0,6,-6,1,1,0,1,NASDAQ
4829,14-02-2021 04:00,24 hrs.,StockMarket,AAPL,100,100,0,100,1,43,10,1,NASDAQ
4829,14-02-2021 04:00,24 hrs.,StockMarket,AKER,6,0,6,-6,1,1,0,1,NASDAQ
4829,14-02-2021 04:00,24 hrs.,StockMarket,AMAT,81,0,81,-81,1,36,5,1,NASDAQ
4829,14-02-2021 04:00,24 hrs.,StockMarket,AMGN,12,12,0,12,1,1,6,1,NASDAQ
4829,14-02-2021 04:00,24 hrs.,StockMarket,AMZN,47,47,0,47,1,11,21,1,NASDAQ
4829,14-02-2021 04:00,24 hrs.,StockMarket,ATNF,12,12,0,12,1,1,6,1,NASDAQ
4829,14-02-2021 04:00,24 hrs.,StockMarket,BIDU,81,0,81,-81,1,36,5,1,NASDAQ
4829,14-02-2021 04:00,24 hrs.,StockMarket,BIGC,81,0,81,-81,1,36,5,1,NASDAQ
4829,14-02-2021 04:00,24 hrs.,StockMarket,CLIR,6,6,0,6,1,1,0,1,NASDAQ
4829,14-02-2021 04:00,24 hrs.,StockMarket,CLVS,81,0,81,-81,1,36,5,1,NASDAQ
4829,14-02-2021 04:00,24 hrs.,StockMarket,CPLP,12,12,0,12,1,3,2,1,NASDAQ
4829,14-02-2021 04:00,24 hrs.,trakstocks,TRIT,148,0,148,-148,1,58,28,1,NASDAQ
4829,14-02-2021 04:00,24 hrs.,trakstocks,TSLA,15,15,0,15,1,4,3,1,NASDAQ
4829,14-02-2021 04:00,24 hrs.,trakstocks,VUZI,24,24,0,24,1,9,2,1,NASDAQ
4829,14-02-2021 04:00,24 hrs.,trakstocks,ZSAN,18,18,0,18,1,4,6,1,NASDAQ
4829,14-02-2021 04:00,24 hrs.,StockMarket,BOTH,9,0,9,-9,1,0,5,1,OTC
4829,14-02-2021 04:00,24 hrs.,StockMarket,BOTY,8,0,8,-8,1,1,2,1,OTC
4829,14-02-2021 04:00,24 hrs.,StockMarket,COMS,13,13,0,13,1,1,7,1,OTC
4829,14-02-2021 04:00,24 hrs.,StockMarket,GBTC,14,0,14,-14,3,0,2,1,OTC
4829,14-02-2021 04:00,24 hrs.,StockMarket,HRBR,6,6,0,6,1,1,0,1,OTC
4829,14-02-2021 04:00,24 hrs.,StockMarket,LINK,81,0,81,-81,1,36,5,1,OTC
4829,14-02-2021 04:00,24 hrs.,StockMarket,LRDR,6,6,0,6,1,1,0,1,OTC
4829,14-02-2021 04:00,24 hrs.,StockMarket,MOST,81,0,81,-81,1,36,5,1,OTC
4829,14-02-2021 04:00,24 hrs.,StockMarket,SGMD,8,8,0,8,1,2,0,1,OTC
4829,14-02-2021 04:00,24 hrs.,StockMarket,AMKBY,17,17,0,17,1,4,5,1,OTC
4829,14-02-2021 04:00,24 hrs.,StockMarket,CADMF,6,6,0,6,1,1,0,1,OTC
4829,14-02-2021 04:00,24 hrs.,StockMarket,EMHTF,11,11,0,11,1,3,1,1,OTC
4829,14-02-2021 04:00,24 hrs.,StockMarket,NXTTF,12,12,0,12,2,2,0,1,OTC
4829,14-02-2021 04:00,24 hrs.,StockMarket,PYNKF,5,5,0,5,1,0,1,1,OTC
4829,14-02-2021 04:00,24 hrs.,StockMarket,XJNGF,16,0,16,-16,1,0,12,1,OTC
4829,14-02-2021 04:00,24 hrs.,StockMarket,DNN,13,13,0,13,1,3,3,1,AMEX
4829,14-02-2021 04:00,24 hrs.,StockMarket,MXC,9,0,9,-9,1,0,5,1,AMEX
4829,14-02-2021 04:00,24 hrs.,StockMarket,ZOM,6,0,6,-6,1,1,0,1,AMEX
4829,14-02-2021 04:00,24 hrs.,StockMarket,AAP,81,0,81,-81,1,36,5,1,NYSE
4829,14-02-2021 04:00,24 hrs.,StockMarket,AMC,75,75,0,75,5,22,11,5,NYSE
4829,14-02-2021 04:00,24 hrs.,StockMarket,ASX,9,0,9,-9,1,0,5,1,NYSE
4829,14-02-2021 04:00,24 hrs.,StockMarket,BKI,81,0,81,-81,1,36,5,1,NYSE
4829,14-02-2021 04:00,24 hrs.,StockMarket,CBD,12,12,0,12,1,1,6,1,NYSE
4829,14-02-2021 04:00,24 hrs.,StockMarket,CMA,6,0,6,-6,1,1,0,1,NYSE
4829,14-02-2021 04:00,24 hrs.,StockMarket,CMO,224,224,0,224,1,108,4,1,NYSE
4829,14-02-2021 04:00,24 hrs.,StockMarket,CVS,81,0,81,-81,1,36,5,1,NYSE
4829,14-02-2021 04:00,24 hrs.,StockMarket,DDD,81,0,81,-81,1,36,5,1,NYSE
4829,14-02-2021 04:00,24 hrs.,StockMarket,DDS,81,0,81,-81,1,36,5,1,NYSE
4829,14-02-2021 04:00,24 hrs.,StockMarket,ECL,81,0,81,-81,1,36,5,1,NYSE
4829,14-02-2021 04:00,24 hrs.,StockMarket,FIX,4,0,4,-4,1,0,0,1,NYSE
4829,14-02-2021 04:00,24 hrs.,StockMarket,GME,133,9,124,-115,4,47,23,4,NYSE
4829,14-02-2021 04:00,24 hrs.,StockMarket,HLT,81,0,81,-81,1,36,5,1,NYSE
4829,14-02-2021 04:00,24 hrs.,trakstocks,LITOF,15,15,0,15,1,4,3,1,OTC
4829,14-02-2021 04:00,24 hrs.,trakstocks,LXXGF,22,22,0,22,3,5,0,2,OTC
4829,14-02-2021 04:00,24 hrs.,trakstocks,CBO,19,19,0,19,1,4,7,1,NYSE
4829,14-02-2021 04:00,24 hrs.,trakstocks,LAC,15,15,0,15,1,4,3,1,NYSE
4829,14-02-2021 04:00,24 hrs.,trakstocks,NAT,15,0,15,-15,1,4,3,1,NYSE
4829,14-02-2021 04:00,24 hrs.,trakstocks,PEG,102,102,0,102,1,45,8,1,NYSE
4829,14-02-2021 04:00,24 hrs.,trakstocks,RSI,102,102,0,102,1,45,8,1,NYSE
4829,14-02-2021 04:00,24 hrs.,trakstocks,PLTR,58,0,58,-58,1,23,8,1,NYSE
4829,14-02-2021 04:00,24 hrs.,pennystocks,BRSE,6,6,0,6,1,1,0,1,OTC
4829,14-02-2021 04:00,24 hrs.,pennystocks,CAFS,7,0,7,-7,1,1,1,1,OTC
4829,14-02-2021 04:00,24 hrs.,pennystocks,CANN,12,6,6,0,2,2,0,2,OTC
4829,14-02-2021 04:00,24 hrs.,pennystocks,CBBT,104,104,0,104,2,24,48,2,OTC
4829,14-02-2021 04:00,24 hrs.,pennystocks,CBDL,34,34,0,34,1,11,8,1,OTC
4829,14-02-2021 04:00,24 hrs.,pennystocks,CCTL,109,109,0,109,2,26,49,2,OTC
4829,14-02-2021 04:00,24 hrs.,pennystocks,CELZ,6,0,6,-6,1,1,0,1,OTC
4829,14-02-2021 04:00,24 hrs.,pennystocks,CLIS,18,18,0,18,2,3,4,1,OTC
4829,14-02-2021 04:00,24 hrs.,pennystocks,COMS,13,0,13,-13,2,2,1,1,OTC
4829,14-02-2021 04:00,24 hrs.,pennystocks,CTLE,43,13,30,-17,7,7,1,3,OTC
4829,14-02-2021 04:00,24 hrs.,pennystocks,DIGI,51,51,0,51,1,19,9,1,OTC
4829,14-02-2021 04:00,24 hrs.,pennystocks,DPLS,117,0,117,-117,2,41,27,2,OTC
4829,14-02-2021 04:00,24 hrs.,pennystocks,DRNK,6,6,0,6,1,1,0,1,OTC
4829,14-02-2021 04:00,24 hrs.,pennystocks,DSGT,6,0,6,-6,1,1,0,1,OTC
4829,14-02-2021 04:00,24 hrs.,pennystocks,DXLG,33,33,0,33,1,13,3,1,OTC
4829,14-02-2021 04:00,24 hrs.,pennystocks,ECEZ,7,7,0,7,1,1,1,1,OTC
4829,14-02-2021 04:00,24 hrs.,pennystocks,ECOX,7,7,0,7,1,1,1,1,OTC
4829,14-02-2021 04:00,24 hrs.,pennystocks,EMED,12,12,0,12,2,2,0,1,OTC
4829,14-02-2021 04:00,24 hrs.,pennystocks,ENZC,70,70,0,70,1,13,40,1,OTC
4829,14-02-2021 04:00,24 hrs.,pennystocks,ETFM,6,0,6,-6,1,1,0,1,OTC
4829,14-02-2021 04:00,24 hrs.,pennystocks,GAXY,24,0,24,-24,1,5,10,1,OTC
4829,14-02-2021 04:00,24 hrs.,pennystocks,GLFH,26,26,0,26,1,4,14,1,OTC
4829,14-02-2021 04:00,24 hrs.,pennystocks,GRCV,7,0,7,-7,1,1,1,1,OTC
4829,14-02-2021 04:00,24 hrs.,pennystocks,GRSO,7,0,7,-7,1,1,1,1,OTC
4829,14-02-2021 04:00,24 hrs.,pennystocks,GTEH,65,65,0,65,1,9,43,1,OTC
4829,14-02-2021 04:00,24 hrs.,pennystocks,HALB,29,0,29,-29,1,8,9,1,OTC
4829,14-02-2021 04:00,24 hrs.,StockMarket,CTRM,6,6,0,6,1,1,0,1,NASDAQ
4829,14-02-2021 04:00,24 hrs.,StockMarket,EXPD,81,0,81,-81,1,36,5,1,NASDAQ
4829,14-02-2021 04:00,24 hrs.,StockMarket,FIZZ,81,0,81,-81,1,36,5,1,NASDAQ
4829,14-02-2021 04:00,24 hrs.,StockMarket,GOGO,81,0,81,-81,1,36,5,1,NASDAQ
4829,14-02-2021 04:00,24 hrs.,StockMarket,GOLD,81,0,81,-81,1,36,5,1,NASDAQ
4829,14-02-2021 04:00,24 hrs.,StockMarket,IGT,81,0,81,-81,1,36,5,1,NYSE
4829,14-02-2021 04:00,24 hrs.,StockMarket,JNJ,12,12,0,12,1,1,6,1,NYSE
4829,14-02-2021 04:00,24 hrs.,StockMarket,LPL,81,0,81,-81,1,36,5,1,NYSE
4829,14-02-2021 04:00,24 hrs.,StockMarket,LPX,81,0,81,-81,1,36,5,1,NYSE
4829,14-02-2021 04:00,24 hrs.,StockMarket,MRO,81,0,81,-81,1,36,5,1,NYSE
4829,14-02-2021 04:00,24 hrs.,StockMarket,MTD,81,0,81,-81,1,36,5,1,NYSE
4829,14-02-2021 04:00,24 hrs.,StockMarket,NET,8,8,0,8,1,2,0,1,NYSE
4829,14-02-2021 04:00,24 hrs.,StockMarket,NVS,12,12,0,12,1,1,6,1,NYSE
4829,14-02-2021 04:00,24 hrs.,StockMarket,OXY,81,0,81,-81,1,36,5,1,NYSE
4829,14-02-2021 04:00,24 hrs.,StockMarket,PEG,100,100,0,100,1,43,10,1,NYSE
4829,14-02-2021 04:00,24 hrs.,StockMarket,PMO,12,0,12,-12,2,2,0,1,NYSE
4829,14-02-2021 04:00,24 hrs.,StockMarket,RNG,81,0,81,-81,1,36,5,1,NYSE
4829,14-02-2021 04:00,24 hrs.,StockMarket,RSI,100,100,0,100,1,43,10,1,NYSE
4829,14-02-2021 04:00,24 hrs.,StockMarket,SKT,81,0,81,-81,1,36,5,1,NYSE
4829,14-02-2021 04:00,24 hrs.,StockMarket,SOS,6,0,6,-6,1,1,0,1,NYSE
4829,14-02-2021 04:00,24 hrs.,StockMarket,THC,12,12,0,12,1,1,6,1,NYSE
4829,14-02-2021 04:00,24 hrs.,StockMarket,TRU,81,0,81,-81,1,36,5,1,NYSE
4829,14-02-2021 04:00,24 hrs.,StockMarket,VMC,81,0,81,-81,1,36,5,1,NYSE
4829,14-02-2021 04:00,24 hrs.,StockMarket,WMT,81,0,81,-81,1,36,5,1,NYSE
4829,14-02-2021 04:00,24 hrs.,StockMarket,ZTS,81,0,81,-81,1,36,5,1,NYSE
4829,14-02-2021 04:00,24 hrs.,StockMarket,ABBV,12,12,0,12,1,1,6,1,NYSE
4829,14-02-2021 04:00,24 hrs.,StockMarket,CCIV,6,0,6,-6,1,1,0,1,NYSE
4829,14-02-2021 04:00,24 hrs.,StockMarket,FSLY,81,0,81,-81,1,36,5,1,NYSE
4829,14-02-2021 04:00,24 hrs.,StockMarket,FVRR,81,0,81,-81,1,36,5,1,NYSE
4829,14-02-2021 04:00,24 hrs.,StockMarket,LGVW,14,0,14,-14,3,0,2,1,NYSE
4829,14-02-2021 04:00,24 hrs.,StockMarket,PLTR,81,0,81,-81,1,36,5,1,NYSE
4829,14-02-2021 04:00,24 hrs.,StockMarket,PSTH,6,6,0,6,1,1,0,1,NYSE
4829,14-02-2021 04:00,24 hrs.,StockMarket,PUMP,6,0,6,-6,1,1,0,1,NYSE
4829,14-02-2021 04:00,24 hrs.,StockMarket,SHOP,81,0,81,-81,1,36,5,1,NYSE
4829,14-02-2021 04:00,24 hrs.,StockMarket,TRTN,81,0,81,-81,1,36,5,1,NYSE
4829,14-02-2021 04:00,24 hrs.,StockMarket,TWLO,81,0,81,-81,1,36,5,1,NYSE
4829,14-02-2021 04:00,24 hrs.,StockMarket,USFD,81,0,81,-81,1,36,5,1,NYSE
4829,14-02-2021 04:00,24 hrs.,StockMarket,ADI,81,0,81,-81,1,36,5,1,NASDAQ
4829,14-02-2021 04:00,24 hrs.,pennystocks,SOBR,6,0,6,-6,1,1,0,1,OTC
4829,14-02-2021 04:00,24 hrs.,pennystocks,SSFT,47,47,0,47,1,14,15,1,OTC
4829,14-02-2021 04:00,24 hrs.,pennystocks,STWC,39,0,39,-39,1,14,7,1,OTC
4829,14-02-2021 04:00,24 hrs.,pennystocks,TAUG,15,7,8,-1,2,3,1,2,OTC
4829,14-02-2021 04:00,24 hrs.,pennystocks,TIDE,566,566,0,566,1,225,112,1,OTC
4829,14-02-2021 04:00,24 hrs.,pennystocks,TLSS,43,43,0,43,1,9,21,1,OTC
4829,14-02-2021 04:00,24 hrs.,pennystocks,HCMC,104,49,55,-6,17,17,2,16,OTC
4829,14-02-2021 04:00,24 hrs.,pennystocks,HPIL,13,13,0,13,2,2,1,1,OTC
4829,14-02-2021 04:00,24 hrs.,pennystocks,HPMM,7,7,0,7,1,1,1,1,OTC
4829,14-02-2021 04:00,24 hrs.,pennystocks,HQGE,6,6,0,6,1,1,0,1,OTC
4829,14-02-2021 04:00,24 hrs.,pennystocks,ICNM,7,0,7,-7,1,1,1,1,OTC
4829,14-02-2021 04:00,24 hrs.,pennystocks,ICTY,6,0,6,-6,1,1,0,1,OTC
4829,14-02-2021 04:00,24 hrs.,pennystocks,IGEN,23,0,23,-23,2,3,9,2,OTC
4829,14-02-2021 04:00,24 hrs.,pennystocks,INKW,6,0,6,-6,1,1,0,1,OTC
4829,14-02-2021 04:00,24 hrs.,pennystocks,INND,631,0,631,-631,3,273,73,3,OTC
4829,14-02-2021 04:00,24 hrs.,pennystocks,INTV,7,0,7,-7,1,1,1,1,OTC
4829,14-02-2021 04:00,24 hrs.,pennystocks,KGET,6,6,0,6,1,1,0,1,OTC
4829,14-02-2021 04:00,24 hrs.,pennystocks,KULR,47,47,0,47,1,14,15,1,OTC
4829,14-02-2021 04:00,24 hrs.,pennystocks,KYNC,6,6,0,6,1,1,0,1,OTC
4829,14-02-2021 04:00,24 hrs.,pennystocks,LATF,8,8,0,8,1,1,2,1,OTC
4829,14-02-2021 04:00,24 hrs.,pennystocks,LBTI,6,0,6,-6,1,1,0,1,OTC
4829,14-02-2021 04:00,24 hrs.,pennystocks,LTNC,41,41,0,41,1,0,37,1,OTC
4829,14-02-2021 04:00,24 hrs.,pennystocks,MAXD,29,0,29,-29,1,6,13,1,OTC
4829,14-02-2021 04:00,24 hrs.,pennystocks,MINE,65,65,0,65,1,9,43,1,OTC
4829,14-02-2021 04:00,24 hrs.,pennystocks,MJNA,83,22,61,-39,3,20,31,2,OTC
4829,14-02-2021 04:00,24 hrs.,pennystocks,MLFB,17,17,0,17,1,4,5,1,OTC
4829,14-02-2021 04:00,24 hrs.,StockMarket,GTHX,6,0,6,-6,1,1,0,1,NASDAQ
4829,14-02-2021 04:00,24 hrs.,StockMarket,HTBX,12,12,0,12,2,2,0,2,NASDAQ
4829,14-02-2021 04:00,24 hrs.,StockMarket,ITRM,13,13,0,13,1,1,7,1,NASDAQ
4829,14-02-2021 04:00,24 hrs.,StockMarket,KLIC,20,20,0,20,1,5,6,1,NASDAQ
4829,14-02-2021 04:00,24 hrs.,StockMarket,LGND,81,0,81,-81,1,36,5,1,NASDAQ
4829,14-02-2021 04:00,24 hrs.,StockMarket,NBIX,12,12,0,12,1,1,6,1,NASDAQ
4829,14-02-2021 04:00,24 hrs.,StockMarket,NCNO,81,0,81,-81,1,36,5,1,NASDAQ
4829,14-02-2021 04:00,24 hrs.,StockMarket,NOVN,6,0,6,-6,1,1,0,1,NASDAQ
4829,14-02-2021 04:00,24 hrs.,StockMarket,ROKU,81,0,81,-81,1,36,5,1,NASDAQ
4829,14-02-2021 04:00,24 hrs.,StockMarket,SEDG,81,0,81,-81,1,36,5,1,NASDAQ
4829,14-02-2021 04:00,24 hrs.,StockMarket,SNBR,81,0,81,-81,1,36,5,1,NASDAQ
4829,14-02-2021 04:00,24 hrs.,StockMarket,SNDL,244,10,234,-224,3,51,130,3,NASDAQ
4829,14-02-2021 04:00,24 hrs.,StockMarket,SPWR,81,0,81,-81,1,36,5,1,NASDAQ
4829,14-02-2021 04:00,24 hrs.,StockMarket,STMP,81,0,81,-81,1,36,5,1,NASDAQ
4829,14-02-2021 04:00,24 hrs.,StockMarket,TEAM,12,12,0,12,1,1,6,1,NASDAQ
4829,14-02-2021 04:00,24 hrs.,StockMarket,THCB,7,7,0,7,1,1,1,1,NASDAQ
4829,14-02-2021 04:00,24 hrs.,StockMarket,TLRY,91,10,81,-71,3,37,5,3,NASDAQ
4829,14-02-2021 04:00,24 hrs.,StockMarket,TRCH,13,13,0,13,1,1,7,1,NASDAQ
4829,14-02-2021 04:00,24 hrs.,StockMarket,TREE,81,0,81,-81,1,36,5,1,NASDAQ
4829,14-02-2021 04:00,24 hrs.,StockMarket,TSEM,81,0,81,-81,1,36,5,1,NASDAQ
4829,14-02-2021 04:00,24 hrs.,StockMarket,VXRT,27,21,6,15,2,1,17,2,NASDAQ
4829,14-02-2021 04:00,24 hrs.,StockMarket,WING,81,0,81,-81,1,36,5,1,NASDAQ
4829,14-02-2021 04:00,24 hrs.,StockMarket,XONE,14,0,14,-14,3,0,2,1,NASDAQ
4829,14-02-2021 04:00,24 hrs.,StockMarket,YNDX,81,0,81,-81,1,36,5,1,NASDAQ
4829,14-02-2021 04:00,24 hrs.,pennystocks,ABML,24,24,0,24,4,4,0,1,OTC
4829,14-02-2021 04:00,24 hrs.,pennystocks,ACRL,26,26,0,26,2,7,4,2,OTC
4829,14-02-2021 04:00,24 hrs.,pennystocks,AITX,74,74,0,74,3,26,10,3,OTC
4829,14-02-2021 04:00,24 hrs.,pennystocks,ALYI,70,70,0,70,1,13,40,1,OTC
4829,14-02-2021 04:00,24 hrs.,pennystocks,AMAZ,6,6,0,6,1,1,0,1,OTC
4829,14-02-2021 04:00,24 hrs.,pennystocks,AMNE,13,13,0,13,2,2,1,1,OTC
4829,14-02-2021 04:00,24 hrs.,pennystocks,ASTI,129,129,0,129,2,49,23,2,OTC
4829,14-02-2021 04:00,24 hrs.,pennystocks,ATVK,54,54,0,54,2,15,16,2,OTC
4829,14-02-2021 04:00,24 hrs.,pennystocks,BANT,6,6,0,6,1,1,0,1,OTC
4829,14-02-2021 04:00,24 hrs.,pennystocks,BIEL,6,6,0,6,1,1,0,1,OTC
4829,14-02-2021 04:00,24 hrs.,pennystocks,BNGI,6,6,0,6,1,1,0,1,OTC
4829,14-02-2021 04:00,24 hrs.,pennystocks,BOTY,40,34,6,28,2,12,8,2,OTC
4829,14-02-2021 04:00,24 hrs.,pennystocks,BRGO,6,0,6,-6,1,1,0,1,OTC
4829,14-02-2021 04:00,24 hrs.,pennystocks,BRRN,10,10,0,10,1,2,2,1,OTC
4829,14-02-2021 04:00,24 hrs.,pennystocks,CINGF,47,47,0,47,1,14,15,1,OTC
4829,14-02-2021 04:00,24 hrs.,pennystocks,CLXPF,232,232,0,232,1,86,56,1,OTC
4829,14-02-2021 04:00,24 hrs.,pennystocks,COCSF,13,13,0,13,1,3,3,1,OTC
4829,14-02-2021 04:00,24 hrs.,pennystocks,EMHTF,27,27,0,27,1,8,7,1,OTC
4829,14-02-2021 04:00,24 hrs.,pennystocks,HITIF,795,795,0,795,5,309,157,5,OTC
4829,14-02-2021 04:00,24 hrs.,pennystocks,ILHMF,7,7,0,7,1,1,1,1,OTC
4829,14-02-2021 04:00,24 hrs.,pennystocks,ITMPF,12,12,0,12,2,2,0,1,OTC
4829,14-02-2021 04:00,24 hrs.,pennystocks,LTHUQ,30,0,30,-30,1,7,12,1,OTC
4829,14-02-2021 04:00,24 hrs.,pennystocks,LTMCF,6,6,0,6,1,1,0,1,OTC
4829,14-02-2021 04:00,24 hrs.,pennystocks,MMEDF,105,105,0,105,3,21,51,3,OTC
4829,14-02-2021 04:00,24 hrs.,pennystocks,MMNFF,33,33,0,33,1,13,3,1,OTC
4829,14-02-2021 04:00,24 hrs.,pennystocks,MPUCF,7,7,0,7,1,1,1,1,OTC
4829,14-02-2021 04:00,24 hrs.,pennystocks,MSNVF,6,0,6,-6,1,1,0,1,OTC
4829,14-02-2021 04:00,24 hrs.,pennystocks,NMGRF,46,46,0,46,2,15,8,1,OTC
4829,14-02-2021 04:00,24 hrs.,pennystocks,NMTLF,22,22,0,22,1,7,4,1,OTC
4829,14-02-2021 04:00,24 hrs.,pennystocks,NXTTF,12,12,0,12,2,2,0,2,OTC
4829,14-02-2021 04:00,24 hrs.,pennystocks,RLLCF,42,42,0,42,3,6,18,2,OTC
4829,14-02-2021 04:00,24 hrs.,pennystocks,TAKOF,76,76,0,76,3,16,32,3,OTC
4829,14-02-2021 04:00,24 hrs.,pennystocks,TLOFF,70,70,0,70,1,13,40,1,OTC
4829,14-02-2021 04:00,24 hrs.,pennystocks,TOWTF,12,6,6,0,2,2,0,2,OTC
4829,14-02-2021 04:00,24 hrs.,pennystocks,TRUFF,36,6,30,-24,2,8,12,2,OTC
4829,14-02-2021 04:00,24 hrs.,pennystocks,TSCRF,36,36,0,36,1,10,12,1,OTC
4829,14-02-2021 04:00,24 hrs.,pennystocks,WALRF,47,47,0,47,1,14,15,1,OTC
4829,14-02-2021 04:00,24 hrs.,pennystocks,BGI,33,33,0,33,1,13,3,1,AMEX
4829,14-02-2021 04:00,24 hrs.,pennystocks,CTO,566,566,0,566,1,225,112,1,AMEX
4829,14-02-2021 04:00,24 hrs.,pennystocks,CVM,6,6,0,6,1,1,0,1,AMEX
4829,14-02-2021 04:00,24 hrs.,pennystocks,DNN,20,14,6,8,3,3,2,3,AMEX
4829,14-02-2021 04:00,24 hrs.,pennystocks,DSS,6,0,6,-6,1,1,0,1,AMEX
4829,14-02-2021 04:00,24 hrs.,pennystocks,DXF,18,18,0,18,1,2,10,1,AMEX
4829,14-02-2021 04:00,24 hrs.,pennystocks,GSV,7,0,7,-7,1,1,1,1,AMEX
4829,14-02-2021 04:00,24 hrs.,pennystocks,GTE,66,0,66,-66,2,16,26,2,AMEX
4829,14-02-2021 04:00,24 hrs.,pennystocks,ITP,18,18,0,18,1,2,10,1,AMEX
4829,14-02-2021 04:00,24 hrs.,pennystocks,NGD,11,0,11,-11,1,2,3,1,AMEX
4829,14-02-2021 04:00,24 hrs.,pennystocks,NTN,33,33,0,33,1,13,3,1,AMEX
4829,14-02-2021 04:00,24 hrs.,pennystocks,RHE,33,33,0,33,1,13,3,1,AMEX
4829,14-02-2021 04:00,24 hrs.,pennystocks,SYN,7,7,0,7,1,1,1,1,AMEX
4829,14-02-2021 04:00,24 hrs.,pennystocks,TGB,6,0,6,-6,1,1,0,1,AMEX
4829,14-02-2021 04:00,24 hrs.,pennystocks,ZOM,316,316,0,316,3,101,102,3,AMEX
4829,14-02-2021 04:00,24 hrs.,pennystocks,AMBO,18,18,0,18,1,2,10,1,AMEX
4829,14-02-2021 04:00,24 hrs.,pennystocks,AMPE,33,33,0,33,1,13,3,1,AMEX
4829,14-02-2021 04:00,24 hrs.,pennystocks,CPHI,32,32,0,32,2,4,16,2,AMEX
4829,14-02-2021 04:00,24 hrs.,pennystocks,NSPR,103,103,0,103,3,17,57,3,AMEX
4829,14-02-2021 04:00,24 hrs.,pennystocks,OGEN,66,66,0,66,1,26,10,1,AMEX
4829,14-02-2021 04:00,24 hrs.,pennystocks,SENS,41,6,35,-29,2,16,1,2,AMEX
4829,14-02-2021 04:00,24 hrs.,pennystocks,SNMP,19,0,19,-19,1,5,5,1,AMEX
4829,14-02-2021 04:00,24 hrs.,pennystocks,TKAT,18,18,0,18,1,2,10,1,AMEX
4829,14-02-2021 04:00,24 hrs.,pennystocks,TMBR,33,33,0,33,1,13,3,1,AMEX
4829,14-02-2021 04:00,24 hrs.,pennystocks,MSPC,6,0,6,-6,1,1,0,1,OTC
4829,14-02-2021 04:00,24 hrs.,pennystocks,NSPT,23,0,23,-23,1,3,13,1,OTC
4829,14-02-2021 04:00,24 hrs.,pennystocks,NSPX,6,0,6,-6,1,1,0,1,OTC
4829,14-02-2021 04:00,24 hrs.,pennystocks,OPTI,34,34,0,34,2,9,8,2,OTC
4829,14-02-2021 04:00,24 hrs.,pennystocks,OZSC,227,166,61,105,2,95,29,2,OTC
4829,14-02-2021 04:00,24 hrs.,pennystocks,PUGE,150,0,150,-150,1,41,64,1,OTC
4829,14-02-2021 04:00,24 hrs.,pennystocks,PVDG,70,70,0,70,1,13,40,1,OTC
4829,14-02-2021 04:00,24 hrs.,pennystocks,QMCI,70,70,0,70,1,13,40,1,OTC
4829,14-02-2021 04:00,24 hrs.,pennystocks,RBNW,6,6,0,6,1,1,0,1,OTC
4829,14-02-2021 04:00,24 hrs.,pennystocks,RCRT,24,0,24,-24,1,5,10,1,OTC
4829,14-02-2021 04:00,24 hrs.,pennystocks,RSSV,135,135,0,135,2,50,27,2,OTC
4829,14-02-2021 04:00,24 hrs.,pennystocks,SGMD,451,58,393,-335,7,148,127,7,OTC
4829,14-02-2021 04:00,24 hrs.,pennystocks,SHMP,7,7,0,7,1,1,1,1,OTC
4829,14-02-2021 04:00,24 hrs.,pennystocks,SING,79,79,0,79,2,21,29,2,OTC
4829,14-02-2021 04:00,24 hrs.,pennystocks,SIRC,60,0,60,-60,2,15,22,2,OTC
4829,14-02-2021 04:00,24 hrs.,pennystocks,SNNC,6,6,0,6,1,1,0,1,OTC
4829,14-02-2021 04:00,24 hrs.,pennystocks,SNPW,137,76,61,15,3,38,49,3,OTC
4829,14-02-2021 04:00,24 hrs.,pennystocks,KOF,13,13,0,13,1,3,3,1,NYSE
4829,14-02-2021 04:00,24 hrs.,pennystocks,NGL,3293,3293,0,3293,2,1580,125,2,NYSE
4829,14-02-2021 04:00,24 hrs.,pennystocks,NOK,232,232,0,232,1,86,56,1,NYSE
4829,14-02-2021 04:00,24 hrs.,pennystocks,NYC,13,13,0,13,1,0,9,1,NYSE
4829,14-02-2021 04:00,24 hrs.,pennystocks,PDT,91,36,55,-19,3,24,31,3,NYSE
4829,14-02-2021 04:00,24 hrs.,pennystocks,PEG,140,140,0,140,1,60,16,1,NYSE
4829,14-02-2021 04:00,24 hrs.,pennystocks,PKG,43,0,43,-43,1,16,7,1,NYSE
4829,14-02-2021 04:00,24 hrs.,pennystocks,RSI,158,158,0,158,2,62,26,2,NYSE
4829,14-02-2021 04:00,24 hrs.,pennystocks,RYB,18,18,0,18,1,2,10,1,NYSE
4829,14-02-2021 04:00,24 hrs.,pennystocks,SOS,1242,272,970,-698,10,432,338,10,NYSE
4829,14-02-2021 04:00,24 hrs.,pennystocks,STG,18,18,0,18,1,2,10,1,NYSE
4829,14-02-2021 04:00,24 hrs.,pennystocks,SUP,33,33,0,33,1,13,3,1,NYSE
4829,14-02-2021 04:00,24 hrs.,pennystocks,THC,42,42,0,42,1,13,12,1,NYSE
4829,14-02-2021 04:00,24 hrs.,pennystocks,TTM,566,566,0,566,1,225,112,1,NYSE
4829,14-02-2021 04:00,24 hrs.,pennystocks,WEI,18,18,0,18,1,2,10,1,NYSE
4829,14-02-2021 04:00,24 hrs.,pennystocks,XIN,18,18,0,18,1,2,10,1,NYSE
4829,14-02-2021 04:00,24 hrs.,pennystocks,XYF,18,18,0,18,1,2,10,1,NYSE
4829,14-02-2021 04:00,24 hrs.,pennystocks,ARGO,64,0,64,-64,1,23,14,1,NYSE
4829,14-02-2021 04:00,24 hrs.,pennystocks,BORR,7,7,0,7,1,1,1,1,NYSE
4829,14-02-2021 04:00,24 hrs.,pennystocks,CMCM,18,18,0,18,1,2,10,1,NYSE
4829,14-02-2021 04:00,24 hrs.,pennystocks,DASH,28,0,28,-28,1,9,6,1,NYSE
4829,14-02-2021 04:00,24 hrs.,pennystocks,FEDU,18,18,0,18,1,2,10,1,NYSE
4829,14-02-2021 04:00,24 hrs.,pennystocks,FENG,18,18,0,18,1,2,10,1,NYSE
4829,14-02-2021 04:00,24 hrs.,pennystocks,HEXO,571,571,0,571,2,225,113,2,NYSE
4829,14-02-2021 04:00,24 hrs.,pennystocks,LAIX,18,18,0,18,1,2,10,1,NYSE
4829,14-02-2021 04:00,24 hrs.,pennystocks,LEJU,18,18,0,18,1,2,10,1,NYSE
4829,14-02-2021 04:00,24 hrs.,pennystocks,LITB,18,18,0,18,1,2,10,1,NYSE
4829,14-02-2021 04:00,24 hrs.,pennystocks,MOGU,18,18,0,18,1,2,10,1,NYSE
4829,14-02-2021 04:00,24 hrs.,pennystocks,WELL,7,7,0,7,1,1,1,1,NYSE
4829,14-02-2021 04:00,24 hrs.,pennystocks,CGC,566,566,0,566,1,225,112,1,NASDAQ
4829,14-02-2021 04:00,24 hrs.,pennystocks,CIH,18,18,0,18,1,2,10,1,NASDAQ
4829,14-02-2021 04:00,24 hrs.,pennystocks,EVK,18,18,0,18,1,2,10,1,NASDAQ
4829,14-02-2021 04:00,24 hrs.,pennystocks,GLG,18,18,0,18,1,2,10,1,NASDAQ
4829,14-02-2021 04:00,24 hrs.,pennystocks,INO,66,66,0,66,1,26,10,1,NASDAQ
4829,14-02-2021 04:00,24 hrs.,pennystocks,JFU,18,18,0,18,1,2,10,1,NASDAQ
4829,14-02-2021 04:00,24 hrs.,pennystocks,LYL,18,18,0,18,1,2,10,1,NASDAQ
4829,14-02-2021 04:00,24 hrs.,pennystocks,MKD,18,18,0,18,1,2,10,1,NASDAQ
4829,14-02-2021 04:00,24 hrs.,pennystocks,MTC,18,18,0,18,1,2,10,1,NASDAQ
4829,14-02-2021 04:00,24 hrs.,pennystocks,MYT,18,18,0,18,1,2,10,1,NASDAQ
4829,14-02-2021 04:00,24 hrs.,pennystocks,OSN,18,18,0,18,1,2,10,1,NASDAQ
4829,14-02-2021 04:00,24 hrs.,pennystocks,PME,18,18,0,18,1,2,10,1,NASDAQ
4829,14-02-2021 04:00,24 hrs.,pennystocks,PTE,122,122,0,122,1,48,22,1,NASDAQ
4829,14-02-2021 04:00,24 hrs.,pennystocks,SND,55,0,55,-55,1,12,27,1,NASDAQ
4829,14-02-2021 04:00,24 hrs.,pennystocks,AAPL,140,140,0,140,1,60,16,1,NASDAQ
4829,14-02-2021 04:00,24 hrs.,pennystocks,ACHV,47,47,0,47,1,14,15,1,NASDAQ
4829,14-02-2021 04:00,24 hrs.,pennystocks,UAMY,65,65,0,65,1,9,43,1,AMEX
4829,14-02-2021 04:00,24 hrs.,pennystocks,ACB,566,566,0,566,1,225,112,1,NYSE
4829,14-02-2021 04:00,24 hrs.,pennystocks,TSNP,126,65,61,4,2,33,52,2,OTC
4829,14-02-2021 04:00,24 hrs.,pennystocks,TVPC,6,0,6,-6,1,1,0,1,OTC
4829,14-02-2021 04:00,24 hrs.,pennystocks,UAPC,27,0,27,-27,2,2,15,2,OTC
4829,14-02-2021 04:00,24 hrs.,pennystocks,VSPC,30,24,6,18,2,9,4,2,OTC
4829,14-02-2021 04:00,24 hrs.,pennystocks,WEBB,127,127,0,127,1,56,11,1,OTC
4829,14-02-2021 04:00,24 hrs.,pennystocks,WSGF,47,47,0,47,1,14,15,1,OTC
4829,14-02-2021 04:00,24 hrs.,pennystocks,XFLS,4,0,4,-4,1,0,0,1,OTC
4829,14-02-2021 04:00,24 hrs.,pennystocks,XLPI,168,0,168,-168,1,73,18,1,OTC
4829,14-02-2021 04:00,24 hrs.,pennystocks,XMET,7,7,0,7,1,1,1,1,OTC
4829,14-02-2021 04:00,24 hrs.,pennystocks,YAYO,35,35,0,35,1,9,13,1,OTC
4829,14-02-2021 04:00,24 hrs.,pennystocks,ZMRK,6,6,0,6,1,1,0,1,OTC
4829,14-02-2021 04:00,24 hrs.,pennystocks,ABEPF,6,0,6,-6,1,1,0,1,OTC
4829,14-02-2021 04:00,24 hrs.,pennystocks,AMYZF,36,36,0,36,6,6,0,2,OTC
4829,14-02-2021 04:00,24 hrs.,pennystocks,AQSZF,6,0,6,-6,1,1,0,1,OTC
4829,14-02-2021 04:00,24 hrs.,pennystocks,ARBKF,330,266,64,202,7,92,118,5,OTC
4829,14-02-2021 04:00,24 hrs.,pennystocks,BDRBF,6,6,0,6,1,1,0,1,OTC
4829,14-02-2021 04:00,24 hrs.,pennystocks,BUROF,6,0,6,-6,1,1,0,1,OTC
4829,14-02-2021 04:00,24 hrs.,pennystocks,TRCH,6,0,6,-6,1,1,0,1,NASDAQ
4829,14-02-2021 04:00,24 hrs.,pennystocks,CXDC,18,18,0,18,1,2,10,1,NASDAQ
4829,14-02-2021 04:00,24 hrs.,pennystocks,DFFN,68,68,0,68,3,22,12,3,NASDAQ
4829,14-02-2021 04:00,24 hrs.,pennystocks,DOGZ,18,18,0,18,1,2,10,1,NASDAQ
4829,14-02-2021 04:00,24 hrs.,pennystocks,DSWL,18,18,0,18,1,2,10,1,NASDAQ
4829,14-02-2021 04:00,24 hrs.,pennystocks,DTSS,18,18,0,18,1,2,10,1,NASDAQ
4829,14-02-2021 04:00,24 hrs.,pennystocks,EDIT,1148,1003,145,858,3,304,528,3,NASDAQ
4829,14-02-2021 04:00,24 hrs.,pennystocks,EDTK,18,18,0,18,1,2,10,1,NASDAQ
4829,14-02-2021 04:00,24 hrs.,pennystocks,EYES,6,6,0,6,1,1,0,1,NASDAQ
4829,14-02-2021 04:00,24 hrs.,pennystocks,FAMI,18,18,0,18,1,2,10,1,NASDAQ
4829,14-02-2021 04:00,24 hrs.,pennystocks,FLMN,6,6,0,6,1,1,0,1,NASDAQ
4829,14-02-2021 04:00,24 hrs.,pennystocks,FORD,97,0,97,-97,1,39,15,1,NASDAQ
4829,14-02-2021 04:00,24 hrs.,pennystocks,FTFT,33,33,0,33,1,13,3,1,NASDAQ
4829,14-02-2021 04:00,24 hrs.,pennystocks,GIGM,18,18,0,18,1,2,10,1,NASDAQ
4829,14-02-2021 04:00,24 hrs.,pennystocks,GNUS,12,12,0,12,2,2,0,2,NASDAQ
4829,14-02-2021 04:00,24 hrs.,pennystocks,GRIL,33,33,0,33,1,13,3,1,NASDAQ
4829,14-02-2021 04:00,24 hrs.,pennystocks,GRNQ,18,18,0,18,1,2,10,1,NASDAQ
4829,14-02-2021 04:00,24 hrs.,pennystocks,GSUM,18,18,0,18,1,2,10,1,NASDAQ
4829,14-02-2021 04:00,24 hrs.,pennystocks,GTHX,6,6,0,6,1,1,0,1,NASDAQ
4829,14-02-2021 04:00,24 hrs.,pennystocks,GURE,18,18,0,18,1,2,10,1,NASDAQ
4829,14-02-2021 04:00,24 hrs.,pennystocks,HAPP,18,18,0,18,1,2,10,1,NASDAQ
4829,14-02-2021 04:00,24 hrs.,pennystocks,ADXS,6,6,0,6,1,1,0,1,NASDAQ
4829,14-02-2021 04:00,24 hrs.,pennystocks,AEZS,27,27,0,27,1,9,5,1,NASDAQ
4829,14-02-2021 04:00,24 hrs.,pennystocks,AIHS,18,18,0,18,1,2,10,1,NASDAQ
4829,14-02-2021 04:00,24 hrs.,pennystocks,ALNA,15,0,15,-15,1,2,7,1,NASDAQ
4829,14-02-2021 04:00,24 hrs.,pennystocks,ANTE,23,0,23,-23,1,7,5,1,NASDAQ
4829,14-02-2021 04:00,24 hrs.,pennystocks,AQMS,70,70,0,70,1,13,40,1,NASDAQ
4829,14-02-2021 04:00,24 hrs.,pennystocks,ARTL,33,33,0,33,1,13,3,1,NASDAQ
4829,14-02-2021 04:00,24 hrs.,pennystocks,ASLN,18,18,0,18,1,2,10,1,NASDAQ
4829,14-02-2021 04:00,24 hrs.,pennystocks,ASRT,73,73,0,73,3,18,25,3,NASDAQ
4829,14-02-2021 04:00,24 hrs.,pennystocks,ATOS,27,27,0,27,1,3,17,1,NASDAQ
4829,14-02-2021 04:00,24 hrs.,pennystocks,AVGR,122,122,0,122,1,48,22,1,NASDAQ
4829,14-02-2021 04:00,24 hrs.,pennystocks,AYRO,33,33,0,33,1,13,3,1,NASDAQ
4829,14-02-2021 04:00,24 hrs.,pennystocks,BHAT,18,18,0,18,1,2,10,1,NASDAQ
4829,14-02-2021 04:00,24 hrs.,pennystocks,BHTG,77,0,77,-77,1,30,13,1,NASDAQ
4829,14-02-2021 04:00,24 hrs.,pennystocks,BIMI,18,18,0,18,1,2,10,1,NASDAQ
4829,14-02-2021 04:00,24 hrs.,pennystocks,BIOL,55,0,55,-55,1,12,27,1,NASDAQ
4829,14-02-2021 04:00,24 hrs.,pennystocks,BLUE,36,0,36,-36,1,7,18,1,NASDAQ
4829,14-02-2021 04:00,24 hrs.,pennystocks,BNGO,295,295,0,295,4,63,153,3,NASDAQ
4829,14-02-2021 04:00,24 hrs.,pennystocks,BRQS,31,31,0,31,2,2,19,2,NASDAQ
4829,14-02-2021 04:00,24 hrs.,pennystocks,BVXV,6,6,0,6,1,1,0,1,NASDAQ
4829,14-02-2021 04:00,24 hrs.,pennystocks,BWEN,6,6,0,6,1,1,0,1,NASDAQ
4829,14-02-2021 04:00,24 hrs.,pennystocks,BXRX,12,6,6,0,2,2,0,2,NASDAQ
4829,14-02-2021 04:00,24 hrs.,pennystocks,CCNC,13,13,0,13,1,0,9,1,NASDAQ
4829,14-02-2021 04:00,24 hrs.,pennystocks,CCRC,18,18,0,18,1,2,10,1,NASDAQ
4829,14-02-2021 04:00,24 hrs.,pennystocks,CHEK,122,122,0,122,1,48,22,1,NASDAQ
4829,14-02-2021 04:00,24 hrs.,pennystocks,CHNR,18,18,0,18,1,2,10,1,NASDAQ
4829,14-02-2021 04:00,24 hrs.,pennystocks,CJJD,18,18,0,18,1,2,10,1,NASDAQ
4829,14-02-2021 04:00,24 hrs.,pennystocks,CLBS,88,88,0,88,1,36,12,1,NASDAQ
4829,14-02-2021 04:00,24 hrs.,pennystocks,CLPS,18,18,0,18,1,2,10,1,NASDAQ
4829,14-02-2021 04:00,24 hrs.,pennystocks,CMPS,23,0,23,-23,1,4,11,1,NASDAQ
4829,14-02-2021 04:00,24 hrs.,pennystocks,CNET,18,18,0,18,1,2,10,1,NASDAQ
4829,14-02-2021 04:00,24 hrs.,pennystocks,CSCW,32,32,0,32,3,5,10,3,NASDAQ
4829,14-02-2021 04:00,24 hrs.,pennystocks,CSTR,9,9,0,9,1,0,5,1,NASDAQ
4829,14-02-2021 04:00,24 hrs.,pennystocks,CTRM,387,313,74,239,6,128,107,6,NASDAQ
4829,14-02-2021 04:00,24 hrs.,pennystocks,AMC,78,33,45,-12,2,19,32,2,NYSE
4829,14-02-2021 04:00,24 hrs.,pennystocks,ASX,9,0,9,-9,1,1,3,1,NYSE
4829,14-02-2021 04:00,24 hrs.,pennystocks,CBD,604,584,20,564,3,237,118,3,NYSE
4829,14-02-2021 04:00,24 hrs.,pennystocks,CCM,18,18,0,18,1,2,10,1,NYSE
4829,14-02-2021 04:00,24 hrs.,pennystocks,CNF,18,18,0,18,1,2,10,1,NYSE
4829,14-02-2021 04:00,24 hrs.,pennystocks,DNK,18,18,0,18,1,2,10,1,NYSE
4829,14-02-2021 04:00,24 hrs.,pennystocks,FLT,23,23,0,23,1,4,11,1,NYSE
4829,14-02-2021 04:00,24 hrs.,pennystocks,FSD,12,0,12,-12,1,2,4,1,NYSE
4829,14-02-2021 04:00,24 hrs.,pennystocks,GME,6,0,6,-6,1,1,0,1,NYSE
4829,14-02-2021 04:00,24 hrs.,pennystocks,TXMD,13,7,6,1,2,2,1,2,NASDAQ
4829,14-02-2021 04:00,24 hrs.,pennystocks,HCDI,14,14,0,14,1,1,8,1,NASDAQ
4829,14-02-2021 04:00,24 hrs.,pennystocks,HGSH,18,18,0,18,1,2,10,1,NASDAQ
4829,14-02-2021 04:00,24 hrs.,pennystocks,HIHO,18,18,0,18,1,2,10,1,NASDAQ
4829,14-02-2021 04:00,24 hrs.,pennystocks,HUSN,33,33,0,33,1,13,3,1,NASDAQ
4829,14-02-2021 04:00,24 hrs.,pennystocks,ICON,14,0,14,-14,1,3,4,1,NASDAQ
4829,14-02-2021 04:00,24 hrs.,pennystocks,ILMN,33,33,0,33,1,13,3,1,NASDAQ
4829,14-02-2021 04:00,24 hrs.,pennystocks,ITRM,7,7,0,7,1,1,1,1,NASDAQ
4829,14-02-2021 04:00,24 hrs.,pennystocks,IZEA,13,13,0,13,1,0,9,1,NASDAQ
4829,14-02-2021 04:00,24 hrs.,pennystocks,JAGX,12,12,0,12,2,2,0,1,NASDAQ
4829,14-02-2021 04:00,24 hrs.,pennystocks,JFIN,18,18,0,18,1,2,10,1,NASDAQ
4829,14-02-2021 04:00,24 hrs.,pennystocks,KBSF,18,18,0,18,1,2,10,1,NASDAQ
4829,14-02-2021 04:00,24 hrs.,pennystocks,KRKR,18,18,0,18,1,2,10,1,NASDAQ
4829,14-02-2021 04:00,24 hrs.,pennystocks,KXIN,18,18,0,18,1,2,10,1,NASDAQ
4829,14-02-2021 04:00,24 hrs.,pennystocks,LGHL,46,46,0,46,2,13,12,2,NASDAQ
4829,14-02-2021 04:00,24 hrs.,pennystocks,LIFE,6,0,6,-6,1,1,0,1,NASDAQ
4829,14-02-2021 04:00,24 hrs.,pennystocks,LIVE,27,27,0,27,1,9,5,1,NASDAQ
4829,14-02-2021 04:00,24 hrs.,pennystocks,LIVX,6,0,6,-6,1,1,0,1,NASDAQ
4829,14-02-2021 04:00,24 hrs.,pennystocks,LKCO,51,51,0,51,2,15,13,2,NASDAQ
4829,14-02-2021 04:00,24 hrs.,pennystocks,LLNW,6,6,0,6,1,1,0,1,NASDAQ
4829,14-02-2021 04:00,24 hrs.,pennystocks,LPTX,55,0,55,-55,1,12,27,1,NASDAQ
4829,14-02-2021 04:00,24 hrs.,pennystocks,MDJH,18,18,0,18,1,2,10,1,NASDAQ
4829,14-02-2021 04:00,24 hrs.,pennystocks,METX,18,18,0,18,1,2,10,1,NASDAQ
4829,14-02-2021 04:00,24 hrs.,pennystocks,MOGO,30,0,30,-30,1,5,16,1,NASDAQ
4829,14-02-2021 04:00,24 hrs.,pennystocks,MOHO,18,18,0,18,1,2,10,1,NASDAQ
4829,14-02-2021 04:00,24 hrs.,pennystocks,MOSY,33,33,0,33,1,13,3,1,NASDAQ
4829,14-02-2021 04:00,24 hrs.,pennystocks,MOXC,18,18,0,18,1,2,10,1,NASDAQ
4829,14-02-2021 04:00,24 hrs.,pennystocks,NAKD,15,15,0,15,2,1,5,2,NASDAQ
4829,14-02-2021 04:00,24 hrs.,pennystocks,NEWA,18,18,0,18,1,2,10,1,NASDAQ
4829,14-02-2021 04:00,24 hrs.,pennystocks,NVCN,13,7,6,1,2,2,1,2,NASDAQ
4829,14-02-2021 04:00,24 hrs.,pennystocks,OCGN,45,0,45,-45,1,13,15,1,NASDAQ
4829,14-02-2021 04:00,24 hrs.,pennystocks,OPGN,7,7,0,7,1,1,1,1,NASDAQ
4829,14-02-2021 04:00,24 hrs.,pennystocks,OPTT,12,6,6,0,2,2,0,2,NASDAQ
4829,14-02-2021 04:00,24 hrs.,pennystocks,PBTS,121,121,0,121,2,27,59,2,NASDAQ
4829,14-02-2021 04:00,24 hrs.,pennystocks,PETZ,18,18,0,18,1,2,10,1,NASDAQ
4829,14-02-2021 04:00,24 hrs.,pennystocks,PGEN,6,0,6,-6,1,1,0,1,NASDAQ
4829,14-02-2021 04:00,24 hrs.,pennystocks,PHCF,18,18,0,18,1,2,10,1,NASDAQ
4829,14-02-2021 04:00,24 hrs.,pennystocks,PHUN,13,13,0,13,1,0,9,1,NASDAQ
4829,14-02-2021 04:00,24 hrs.,pennystocks,PLAY,6,6,0,6,1,1,0,1,NASDAQ
4829,14-02-2021 04:00,24 hrs.,pennystocks,PLIN,18,18,0,18,1,2,10,1,NASDAQ
4829,14-02-2021 04:00,24 hrs.,pennystocks,PSEC,6,0,6,-6,1,1,0,1,NASDAQ
4829,14-02-2021 04:00,24 hrs.,pennystocks,PSTV,6,0,6,-6,1,1,0,1,NASDAQ
4829,14-02-2021 04:00,24 hrs.,pennystocks,PULM,6,6,0,6,1,1,0,1,NASDAQ
4829,14-02-2021 04:00,24 hrs.,pennystocks,RAVE,33,33,0,33,1,13,3,1,NASDAQ
4829,14-02-2021 04:00,24 hrs.,pennystocks,RCON,18,18,0,18,1,2,10,1,NASDAQ
4829,14-02-2021 04:00,24 hrs.,pennystocks,RETO,32,32,0,32,2,4,16,2,NASDAQ
4829,14-02-2021 04:00,24 hrs.,pennystocks,RUHN,18,18,0,18,1,2,10,1,NASDAQ
4829,14-02-2021 04:00,24 hrs.,pennystocks,RWLK,33,33,0,33,1,13,3,1,NASDAQ
4829,14-02-2021 04:00,24 hrs.,pennystocks,SALM,33,33,0,33,1,13,3,1,NASDAQ
4829,14-02-2021 04:00,24 hrs.,pennystocks,SAVA,47,47,0,47,1,14,15,1,NASDAQ
4829,14-02-2021 04:00,24 hrs.,pennystocks,SEAC,5,0,5,-5,1,0,1,1,NASDAQ
4829,14-02-2021 04:00,24 hrs.,pennystocks,SECO,18,18,0,18,1,2,10,1,NASDAQ
4829,14-02-2021 04:00,24 hrs.,pennystocks,SGOC,18,18,0,18,1,2,10,1,NASDAQ
4829,14-02-2021 04:00,24 hrs.,pennystocks,SHIP,33,33,0,33,1,13,3,1,NASDAQ
4829,14-02-2021 04:00,24 hrs.,pennystocks,SNDL,55,55,0,55,8,8,7,3,NASDAQ
4829,14-02-2021 04:00,24 hrs.,pennystocks,SNGX,38,25,13,12,6,6,2,5,NASDAQ
4829,14-02-2021 04:00,24 hrs.,pennystocks,SXTC,18,18,0,18,1,2,10,1,NASDAQ
4829,14-02-2021 04:00,24 hrs.,pennystocks,TANH,18,18,0,18,1,2,10,1,NASDAQ
4829,14-02-2021 04:00,24 hrs.,pennystocks,TAOP,18,18,0,18,1,2,10,1,NASDAQ
4829,14-02-2021 04:00,24 hrs.,pennystocks,TEDU,18,18,0,18,1,2,10,1,NASDAQ
4829,14-02-2021 04:00,24 hrs.,pennystocks,TLRY,566,566,0,566,1,225,112,1,NASDAQ
4829,14-02-2021 04:00,24 hrs.,pennystocks,TNXP,64,58,6,52,5,15,14,5,NASDAQ
4829,14-02-2021 04:00,24 hrs.,pennystocks,TOPS,33,33,0,33,1,13,3,1,NASDAQ
4829,14-02-2021 04:00,24 hrs.,pennystocks,TOUR,18,18,0,18,1,2,10,1,NASDAQ
4829,14-02-2021 04:00,24 hrs.,wallstreetbets,CNTRF,8,8,0,8,1,1,2,1,OTC
4829,14-02-2021 04:00,24 hrs.,wallstreetbets,CRLBF,6,0,6,-6,1,1,0,1,OTC
4829,14-02-2021 04:00,24 hrs.,wallstreetbets,CURLF,6,0,6,-6,1,1,0,1,OTC
4829,14-02-2021 04:00,24 hrs.,wallstreetbets,CXRXF,7,0,7,-7,1,1,1,1,OTC
4829,14-02-2021 04:00,24 hrs.,wallstreetbets,DIGAF,6,6,0,6,1,1,0,1,OTC
4829,14-02-2021 04:00,24 hrs.,wallstreetbets,FUNFF,7,0,7,-7,1,1,1,1,OTC
4829,14-02-2021 04:00,24 hrs.,wallstreetbets,GAYMF,13,6,7,-1,2,2,1,2,OTC
4829,14-02-2021 04:00,24 hrs.,wallstreetbets,GGTTF,20,20,0,20,3,3,2,2,OTC
4829,14-02-2021 04:00,24 hrs.,wallstreetbets,GTBIF,6,0,6,-6,1,1,0,1,OTC
4829,14-02-2021 04:00,24 hrs.,wallstreetbets,HITIF,26,13,13,0,3,2,10,3,OTC
4829,14-02-2021 04:00,24 hrs.,pennystocks,TYHT,18,18,0,18,1,2,10,1,NASDAQ
4829,14-02-2021 04:00,24 hrs.,pennystocks,USWS,6,6,0,6,1,1,0,1,NASDAQ
4829,14-02-2021 04:00,24 hrs.,pennystocks,UTSI,18,18,0,18,1,2,10,1,NASDAQ
4829,14-02-2021 04:00,24 hrs.,pennystocks,UXIN,18,18,0,18,1,2,10,1,NASDAQ
4829,14-02-2021 04:00,24 hrs.,pennystocks,XSPA,24,24,0,24,4,4,0,3,NASDAQ
4829,14-02-2021 04:00,24 hrs.,pennystocks,YMTX,19,19,0,19,1,5,5,1,NASDAQ
4829,14-02-2021 04:00,24 hrs.,pennystocks,ZCMD,18,18,0,18,1,2,10,1,NASDAQ
4829,14-02-2021 04:00,24 hrs.,pennystocks,ZKIN,13,13,0,13,1,0,9,1,NASDAQ
4829,14-02-2021 04:00,24 hrs.,pennystocks,ZSAN,40,40,0,40,2,2,28,2,NASDAQ
4829,14-02-2021 04:00,24 hrs.,wallstreetbets,AABB,14,14,0,14,2,2,2,1,OTC
4829,14-02-2021 04:00,24 hrs.,wallstreetbets,ACRL,6,0,6,-6,1,1,0,1,OTC
4829,14-02-2021 04:00,24 hrs.,wallstreetbets,AITX,37,14,23,-9,4,3,15,4,OTC
4829,14-02-2021 04:00,24 hrs.,wallstreetbets,ASTI,7,0,7,-7,1,1,1,1,OTC
4829,14-02-2021 04:00,24 hrs.,wallstreetbets,BANT,6,6,0,6,1,1,0,1,OTC
4829,14-02-2021 04:00,24 hrs.,wallstreetbets,BBRW,6,0,6,-6,1,1,0,1,OTC
4829,14-02-2021 04:00,24 hrs.,wallstreetbets,BLSP,7,0,7,-7,1,1,1,1,OTC
4829,14-02-2021 04:00,24 hrs.,wallstreetbets,BOTY,6,0,6,-6,1,1,0,1,OTC
4829,14-02-2021 04:00,24 hrs.,wallstreetbets,BRLL,7,7,0,7,1,1,1,1,OTC
4829,14-02-2021 04:00,24 hrs.,wallstreetbets,BRSE,9,9,0,9,1,2,1,1,OTC
4829,14-02-2021 04:00,24 hrs.,wallstreetbets,BRZL,7,7,0,7,1,1,1,1,OTC
4829,14-02-2021 04:00,24 hrs.,wallstreetbets,CAGR,340,340,0,340,2,105,122,2,OTC
4829,14-02-2021 04:00,24 hrs.,wallstreetbets,CCTL,7,7,0,7,1,1,1,1,OTC
4829,14-02-2021 04:00,24 hrs.,wallstreetbets,DKMR,7,7,0,7,1,1,1,1,OTC
4829,14-02-2021 04:00,24 hrs.,wallstreetbets,DRNG,7,7,0,7,1,1,1,1,OTC
4829,14-02-2021 04:00,24 hrs.,wallstreetbets,DROP,4507,4507,0,4507,1,2144,215,1,OTC
4829,14-02-2021 04:00,24 hrs.,wallstreetbets,ECOX,14,14,0,14,2,2,2,1,OTC
4829,14-02-2021 04:00,24 hrs.,wallstreetbets,EFIR,7,0,7,-7,1,1,1,1,OTC
4829,14-02-2021 04:00,24 hrs.,wallstreetbets,FNMA,14,14,0,14,2,2,2,1,OTC
4829,14-02-2021 04:00,24 hrs.,wallstreetbets,GAXY,7,7,0,7,1,1,1,1,OTC
4829,14-02-2021 04:00,24 hrs.,wallstreetbets,GPFT,6,6,0,6,1,1,0,1,OTC
4829,14-02-2021 04:00,24 hrs.,wallstreetbets,GRNH,7,0,7,-7,1,1,1,1,OTC
4829,14-02-2021 04:00,24 hrs.,wallstreetbets,HCMC,198,81,117,-36,29,29,24,21,OTC
4829,14-02-2021 04:00,24 hrs.,wallstreetbets,HEMP,14,0,14,-14,2,2,2,1,OTC
4829,14-02-2021 04:00,24 hrs.,wallstreetbets,HYSR,7,0,7,-7,1,1,1,1,OTC
4829,14-02-2021 04:00,24 hrs.,wallstreetbets,IDEA,85,85,0,85,1,30,21,1,OTC
4829,14-02-2021 04:00,24 hrs.,wallstreetbets,IMTL,6,6,0,6,1,1,0,1,OTC
4829,14-02-2021 04:00,24 hrs.,wallstreetbets,INND,14,14,0,14,2,2,2,1,OTC
4829,14-02-2021 04:00,24 hrs.,wallstreetbets,INTV,7,0,7,-7,1,1,1,1,OTC
4829,14-02-2021 04:00,24 hrs.,wallstreetbets,IQST,8,8,0,8,1,1,2,1,OTC
4829,14-02-2021 04:00,24 hrs.,wallstreetbets,KGET,7,0,7,-7,1,1,1,1,OTC
4829,14-02-2021 04:00,24 hrs.,wallstreetbets,KWBT,6,6,0,6,1,1,0,1,OTC
4829,14-02-2021 04:00,24 hrs.,wallstreetbets,LINK,1105,19,1086,-1067,4,513,63,4,OTC
4829,14-02-2021 04:00,24 hrs.,wallstreetbets,LQMT,7,0,7,-7,1,1,1,1,OTC
4829,14-02-2021 04:00,24 hrs.,wallstreetbets,MDCN,14,14,0,14,2,2,2,1,OTC
4829,14-02-2021 04:00,24 hrs.,wallstreetbets,MINE,7,7,0,7,1,1,1,1,OTC
4829,14-02-2021 04:00,24 hrs.,wallstreetbets,MJNA,7,0,7,-7,1,1,1,1,OTC
4829,14-02-2021 04:00,24 hrs.,wallstreetbets,MKTY,7,0,7,-7,1,1,1,1,OTC
4829,14-02-2021 04:00,24 hrs.,wallstreetbets,MLFB,7,0,7,-7,1,1,1,1,OTC
4829,14-02-2021 04:00,24 hrs.,wallstreetbets,MOST,1086,0,1086,-1086,1,510,62,1,OTC
4829,14-02-2021 04:00,24 hrs.,wallstreetbets,MRMD,8,0,8,-8,1,1,2,1,OTC
4829,14-02-2021 04:00,24 hrs.,wallstreetbets,MTVX,14,14,0,14,2,2,2,2,OTC
4829,14-02-2021 04:00,24 hrs.,wallstreetbets,NOVC,6,0,6,-6,1,1,0,1,OTC
4829,14-02-2021 04:00,24 hrs.,pennystocks,TRIP,30,0,30,-30,1,7,12,1,NASDAQ
4829,14-02-2021 04:00,24 hrs.,pennystocks,TRVG,46,39,7,32,3,15,4,3,NASDAQ
4829,14-02-2021 04:00,24 hrs.,wallstreetbets,GEO,7,0,7,-7,1,1,1,1,NYSE
4829,14-02-2021 04:00,24 hrs.,wallstreetbets,GME,75360,33784,41576,-7792,250,34047,6266,186,NYSE
4829,14-02-2021 04:00,24 hrs.,wallstreetbets,GNT,14,0,14,-14,2,2,2,1,NYSE
4829,14-02-2021 04:00,24 hrs.,wallstreetbets,GNW,6,6,0,6,1,1,0,1,NYSE
4829,14-02-2021 04:00,24 hrs.,wallstreetbets,GSX,7,0,7,-7,1,1,1,1,NYSE
4829,14-02-2021 04:00,24 hrs.,wallstreetbets,HMI,27,27,0,27,4,4,3,1,NYSE
4829,14-02-2021 04:00,24 hrs.,wallstreetbets,IBM,2029,203,1826,-1623,5,910,189,5,NYSE
4829,14-02-2021 04:00,24 hrs.,wallstreetbets,IGT,1086,0,1086,-1086,1,510,62,1,NYSE
4829,14-02-2021 04:00,24 hrs.,wallstreetbets,IRL,7,7,0,7,1,1,1,1,NYSE
4829,14-02-2021 04:00,24 hrs.,wallstreetbets,JNJ,6,0,6,-6,1,1,0,1,NYSE
4829,14-02-2021 04:00,24 hrs.,wallstreetbets,KOS,21,21,0,21,1,6,5,1,NYSE
4829,14-02-2021 04:00,24 hrs.,wallstreetbets,LOW,13,13,0,13,2,2,1,2,NYSE
4829,14-02-2021 04:00,24 hrs.,wallstreetbets,LPL,1086,0,1086,-1086,1,510,62,1,NYSE
4829,14-02-2021 04:00,24 hrs.,wallstreetbets,LTC,42,35,7,28,6,6,6,5,NYSE
4829,14-02-2021 04:00,24 hrs.,wallstreetbets,LZB,154,154,0,154,1,57,36,1,NYSE
4829,14-02-2021 04:00,24 hrs.,wallstreetbets,MFA,7,7,0,7,1,1,1,1,NYSE
4829,14-02-2021 04:00,24 hrs.,wallstreetbets,MOS,154,154,0,154,1,57,36,1,NYSE
4829,14-02-2021 04:00,24 hrs.,wallstreetbets,MRO,18,18,0,18,1,2,10,1,NYSE
4829,14-02-2021 04:00,24 hrs.,wallstreetbets,MTD,1086,0,1086,-1086,1,510,62,1,NYSE
4829,14-02-2021 04:00,24 hrs.,wallstreetbets,HTZGQ,13,0,13,-13,2,2,1,2,OTC
4829,14-02-2021 04:00,24 hrs.,wallstreetbets,IMNPQ,7,7,0,7,1,1,1,1,OTC
4829,14-02-2021 04:00,24 hrs.,wallstreetbets,JROOF,7,7,0,7,1,1,1,1,OTC
4829,14-02-2021 04:00,24 hrs.,wallstreetbets,MMEDF,7,7,0,7,1,1,1,1,OTC
4829,14-02-2021 04:00,24 hrs.,wallstreetbets,NXTTF,13,6,7,-1,2,2,1,2,OTC
4829,14-02-2021 04:00,24 hrs.,wallstreetbets,RECAF,6,0,6,-6,1,1,0,1,OTC
4829,14-02-2021 04:00,24 hrs.,wallstreetbets,RLLCF,6,6,0,6,1,1,0,1,OTC
4829,14-02-2021 04:00,24 hrs.,wallstreetbets,RWBYF,7,7,0,7,1,1,1,1,OTC
4829,14-02-2021 04:00,24 hrs.,wallstreetbets,RYCEY,565,13,552,-539,4,216,117,4,OTC
4829,14-02-2021 04:00,24 hrs.,wallstreetbets,TCNNF,6,0,6,-6,1,1,0,1,OTC
4829,14-02-2021 04:00,24 hrs.,wallstreetbets,TOWTF,12,0,12,-12,2,2,0,1,OTC
4829,14-02-2021 04:00,24 hrs.,wallstreetbets,VLNCF,14,14,0,14,1,0,10,1,OTC
4829,14-02-2021 04:00,24 hrs.,wallstreetbets,VRYYF,7,0,7,-7,1,1,1,1,OTC
4829,14-02-2021 04:00,24 hrs.,wallstreetbets,VYGVF,6,0,6,-6,1,1,0,1,OTC
4829,14-02-2021 04:00,24 hrs.,wallstreetbets,XJNGF,6,0,6,-6,1,1,0,1,OTC
4829,14-02-2021 04:00,24 hrs.,wallstreetbets,APT,7,7,0,7,1,1,1,1,AMEX
4829,14-02-2021 04:00,24 hrs.,wallstreetbets,DNN,48,13,35,-22,7,7,6,6,AMEX
4829,14-02-2021 04:00,24 hrs.,wallstreetbets,GTE,6,0,6,-6,1,1,0,1,AMEX
4829,14-02-2021 04:00,24 hrs.,wallstreetbets,ITP,6,6,0,6,1,1,0,1,AMEX
4829,14-02-2021 04:00,24 hrs.,wallstreetbets,MCF,7,0,7,-7,1,1,1,1,AMEX
4829,14-02-2021 04:00,24 hrs.,wallstreetbets,MXC,7,7,0,7,1,1,1,1,AMEX
4829,14-02-2021 04:00,24 hrs.,wallstreetbets,ONCX,7,7,0,7,1,1,1,1,OTC
4829,14-02-2021 04:00,24 hrs.,wallstreetbets,PBHG,7,7,0,7,1,1,1,1,OTC
4829,14-02-2021 04:00,24 hrs.,wallstreetbets,PSYC,7,7,0,7,1,1,1,1,OTC
4829,14-02-2021 04:00,24 hrs.,wallstreetbets,RBDC,7,0,7,-7,1,1,1,1,OTC
4829,14-02-2021 04:00,24 hrs.,wallstreetbets,RBNW,7,7,0,7,1,1,1,1,OTC
4829,14-02-2021 04:00,24 hrs.,wallstreetbets,SANP,28,28,0,28,4,4,4,1,OTC
4829,14-02-2021 04:00,24 hrs.,wallstreetbets,SBFM,7,0,7,-7,1,1,1,1,OTC
4829,14-02-2021 04:00,24 hrs.,wallstreetbets,SFOR,7,0,7,-7,1,1,1,1,OTC
4829,14-02-2021 04:00,24 hrs.,wallstreetbets,SGMD,21,21,0,21,3,3,3,2,OTC
4829,14-02-2021 04:00,24 hrs.,wallstreetbets,SIGN,6,6,0,6,1,1,0,1,OTC
4829,14-02-2021 04:00,24 hrs.,wallstreetbets,SRMX,14,14,0,14,2,2,2,1,OTC
4829,14-02-2021 04:00,24 hrs.,wallstreetbets,TCHH,6,0,6,-6,1,1,0,1,OTC
4829,14-02-2021 04:00,24 hrs.,wallstreetbets,TSNP,7,0,7,-7,1,1,1,1,OTC
4829,14-02-2021 04:00,24 hrs.,wallstreetbets,USDC,13,0,13,-13,2,2,1,2,OTC
4829,14-02-2021 04:00,24 hrs.,wallstreetbets,USPS,3307,3307,0,3307,2,1483,333,2,OTC
4829,14-02-2021 04:00,24 hrs.,wallstreetbets,WGNR,8,0,8,-8,1,1,2,1,OTC
4829,14-02-2021 04:00,24 hrs.,wallstreetbets,WHEN,20,13,7,6,3,3,2,3,OTC
4829,14-02-2021 04:00,24 hrs.,wallstreetbets,WWPW,8,8,0,8,1,1,2,1,OTC
4829,14-02-2021 04:00,24 hrs.,wallstreetbets,XFLS,4,0,4,-4,1,0,0,1,OTC
4829,14-02-2021 04:00,24 hrs.,wallstreetbets,AAZZF,13,13,0,13,2,2,1,1,OTC
4829,14-02-2021 04:00,24 hrs.,wallstreetbets,AGFAF,14,7,7,0,2,2,2,2,OTC
4829,14-02-2021 04:00,24 hrs.,wallstreetbets,ARBKF,7,7,0,7,1,1,1,1,OTC
4829,14-02-2021 04:00,24 hrs.,wallstreetbets,BABYF,7,0,7,-7,1,1,1,1,OTC
4829,14-02-2021 04:00,24 hrs.,wallstreetbets,BDRBF,7,7,0,7,1,1,1,1,OTC
4829,14-02-2021 04:00,24 hrs.,wallstreetbets,YPF,7,0,7,-7,1,1,1,1,NYSE
4829,14-02-2021 04:00,24 hrs.,wallstreetbets,ZTS,154,154,0,154,1,57,36,1,NYSE
4829,14-02-2021 04:00,24 hrs.,wallstreetbets,ABBV,7,0,7,-7,1,1,1,1,NYSE
4829,14-02-2021 04:00,24 hrs.,wallstreetbets,ACIC,7,0,7,-7,1,1,1,1,NYSE
4829,14-02-2021 04:00,24 hrs.,wallstreetbets,CCIV,89,41,48,-7,13,13,11,11,NYSE
4829,14-02-2021 04:00,24 hrs.,wallstreetbets,COTY,187,0,187,-187,1,66,51,1,NYSE
4829,14-02-2021 04:00,24 hrs.,wallstreetbets,DASH,59,52,7,45,9,9,5,8,NYSE
4829,14-02-2021 04:00,24 hrs.,wallstreetbets,DNMR,7,7,0,7,1,1,1,1,NYSE
4829,14-02-2021 04:00,24 hrs.,wallstreetbets,EXPR,7,7,0,7,1,1,1,1,NYSE
4829,14-02-2021 04:00,24 hrs.,wallstreetbets,FSLY,4579,3493,1086,2407,4,2057,449,4,NYSE
4829,14-02-2021 04:00,24 hrs.,wallstreetbets,FUBO,3308,3308,0,3308,2,1483,334,2,NYSE
4829,14-02-2021 04:00,24 hrs.,wallstreetbets,FVRR,1240,154,1086,-932,2,567,98,2,NYSE
4829,14-02-2021 04:00,24 hrs.,wallstreetbets,GNRC,12,0,12,-12,2,2,0,2,NYSE
4829,14-02-2021 04:00,24 hrs.,wallstreetbets,HYLN,7,7,0,7,1,1,1,1,NYSE
4829,14-02-2021 04:00,24 hrs.,wallstreetbets,IPOD,14,14,0,14,2,2,2,1,NYSE
4829,14-02-2021 04:00,24 hrs.,wallstreetbets,IPOF,14,14,0,14,2,2,2,1,NYSE
4829,14-02-2021 04:00,24 hrs.,wallstreetbets,LEAP,6,0,6,-6,1,1,0,1,NYSE
4829,14-02-2021 04:00,24 hrs.,wallstreetbets,LGVW,14,0,14,-14,2,2,2,1,NYSE
4829,14-02-2021 04:00,24 hrs.,wallstreetbets,MAIN,6,0,6,-6,1,1,0,1,NYSE
4829,14-02-2021 04:00,24 hrs.,wallstreetbets,NBA,7,7,0,7,1,1,1,1,AMEX
4829,14-02-2021 04:00,24 hrs.,wallstreetbets,NBY,6,0,6,-6,1,1,0,1,AMEX
4829,14-02-2021 04:00,24 hrs.,wallstreetbets,NTN,7,7,0,7,1,1,1,1,AMEX
4829,14-02-2021 04:00,24 hrs.,wallstreetbets,REI,6,6,0,6,1,1,0,1,AMEX
4829,14-02-2021 04:00,24 hrs.,wallstreetbets,SSY,6,6,0,6,1,1,0,1,AMEX
4829,14-02-2021 04:00,24 hrs.,wallstreetbets,TRX,26,19,7,12,4,4,2,4,AMEX
4829,14-02-2021 04:00,24 hrs.,wallstreetbets,ZOM,60,34,26,8,9,9,6,9,AMEX
4829,14-02-2021 04:00,24 hrs.,wallstreetbets,GOED,6,0,6,-6,1,1,0,1,AMEX
4829,14-02-2021 04:00,24 hrs.,wallstreetbets,IBIO,21,21,0,21,3,3,3,3,AMEX
4829,14-02-2021 04:00,24 hrs.,wallstreetbets,SENS,13,6,7,-1,2,2,1,2,AMEX
4829,14-02-2021 04:00,24 hrs.,wallstreetbets,TRXC,20,20,0,20,3,3,2,1,AMEX
4829,14-02-2021 04:00,24 hrs.,wallstreetbets,UAVS,20,7,13,-6,3,3,2,2,AMEX
4829,14-02-2021 04:00,24 hrs.,wallstreetbets,AAP,1240,154,1086,-932,2,567,98,2,NYSE
4829,14-02-2021 04:00,24 hrs.,wallstreetbets,ACB,35,14,21,-7,5,5,5,4,NYSE
4829,14-02-2021 04:00,24 hrs.,wallstreetbets,AIN,7,7,0,7,1,1,1,1,NYSE
4829,14-02-2021 04:00,24 hrs.,wallstreetbets,AMC,940,489,451,38,71,214,228,62,NYSE
4829,14-02-2021 04:00,24 hrs.,wallstreetbets,AMP,7,7,0,7,1,1,1,1,NYSE
4829,14-02-2021 04:00,24 hrs.,wallstreetbets,ATH,356,343,13,330,4,97,146,4,NYSE
4829,14-02-2021 04:00,24 hrs.,wallstreetbets,AYX,96,96,0,96,1,31,30,1,NYSE
4829,14-02-2021 04:00,24 hrs.,wallstreetbets,BCH,13,13,0,13,2,2,1,2,NYSE
4829,14-02-2021 04:00,24 hrs.,wallstreetbets,BHC,7,7,0,7,1,1,1,1,NYSE
4829,14-02-2021 04:00,24 hrs.,wallstreetbets,BOX,6,6,0,6,1,1,0,1,NYSE
4829,14-02-2021 04:00,24 hrs.,wallstreetbets,BTI,28,28,0,28,1,3,18,1,NYSE
4829,14-02-2021 04:00,24 hrs.,wallstreetbets,BTT,14,7,7,0,2,2,2,2,NYSE
4829,14-02-2021 04:00,24 hrs.,wallstreetbets,BYD,161,154,7,147,2,58,37,2,NYSE
4829,14-02-2021 04:00,24 hrs.,wallstreetbets,CBD,13,13,0,13,2,2,1,2,NYSE
4829,14-02-2021 04:00,24 hrs.,wallstreetbets,CCL,3314,3308,6,3302,3,1484,334,3,NYSE
4829,14-02-2021 04:00,24 hrs.,wallstreetbets,CLS,54,54,0,54,1,14,22,1,NYSE
4829,14-02-2021 04:00,24 hrs.,wallstreetbets,CLX,7,7,0,7,1,1,1,1,NYSE
4829,14-02-2021 04:00,24 hrs.,wallstreetbets,CNC,7,7,0,7,1,1,1,1,NYSE
4829,14-02-2021 04:00,24 hrs.,wallstreetbets,COO,6,6,0,6,1,1,0,1,NYSE
4829,14-02-2021 04:00,24 hrs.,wallstreetbets,CVS,1240,154,1086,-932,2,567,98,2,NYSE
4829,14-02-2021 04:00,24 hrs.,wallstreetbets,CVX,6,6,0,6,1,1,0,1,NYSE
4829,14-02-2021 04:00,24 hrs.,wallstreetbets,DDD,1086,0,1086,-1086,1,510,62,1,NYSE
4829,14-02-2021 04:00,24 hrs.,wallstreetbets,DDS,1086,0,1086,-1086,1,510,62,1,NYSE
4829,14-02-2021 04:00,24 hrs.,wallstreetbets,DOW,3301,3301,0,3301,1,1482,333,1,NYSE
4829,14-02-2021 04:00,24 hrs.,wallstreetbets,EAT,13,13,0,13,2,2,1,2,NYSE
4829,14-02-2021 04:00,24 hrs.,wallstreetbets,EGO,47,47,0,47,1,11,21,1,NYSE
4829,14-02-2021 04:00,24 hrs.,wallstreetbets,EOS,7,0,7,-7,1,1,1,1,NYSE
4829,14-02-2021 04:00,24 hrs.,wallstreetbets,EOT,7,0,7,-7,1,1,1,1,NYSE
4829,14-02-2021 04:00,24 hrs.,wallstreetbets,ETN,7,7,0,7,1,1,1,1,NYSE
4829,14-02-2021 04:00,24 hrs.,wallstreetbets,EXR,43,43,0,43,1,5,29,1,NYSE
4829,14-02-2021 04:00,24 hrs.,wallstreetbets,FCX,386,386,0,386,1,142,98,1,NYSE
4829,14-02-2021 04:00,24 hrs.,wallstreetbets,FSR,3320,3320,0,3320,4,1485,334,4,NYSE
4829,14-02-2021 04:00,24 hrs.,wallstreetbets,FUN,7,0,7,-7,1,1,1,1,NYSE
4829,14-02-2021 04:00,24 hrs.,wallstreetbets,MDLY,13,13,0,13,2,2,1,2,NYSE
4829,14-02-2021 04:00,24 hrs.,wallstreetbets,MITT,7,7,0,7,1,1,1,1,NYSE
4829,14-02-2021 04:00,24 hrs.,wallstreetbets,NOVA,7,0,7,-7,1,1,1,1,NYSE
4829,14-02-2021 04:00,24 hrs.,wallstreetbets,NVTA,154,154,0,154,1,57,36,1,NYSE
4829,14-02-2021 04:00,24 hrs.,wallstreetbets,PLTR,5589,3544,2045,1499,22,2435,631,19,NYSE
4829,14-02-2021 04:00,24 hrs.,wallstreetbets,PRTY,15,15,0,15,2,3,1,1,NYSE
4829,14-02-2021 04:00,24 hrs.,wallstreetbets,SHOP,1240,154,1086,-932,2,567,98,2,NYSE
4829,14-02-2021 04:00,24 hrs.,wallstreetbets,SPCE,14,0,14,-14,2,2,2,2,NYSE
4829,14-02-2021 04:00,24 hrs.,wallstreetbets,STPK,7,7,0,7,1,1,1,1,NYSE
4829,14-02-2021 04:00,24 hrs.,wallstreetbets,TECK,154,154,0,154,1,57,36,1,NYSE
4829,14-02-2021 04:00,24 hrs.,wallstreetbets,TWLO,1240,154,1086,-932,2,567,98,2,NYSE
4829,14-02-2021 04:00,24 hrs.,wallstreetbets,TWTR,3301,3301,0,3301,1,1482,333,1,NYSE
4829,14-02-2021 04:00,24 hrs.,wallstreetbets,UBER,14,0,14,-14,2,2,2,2,NYSE
4829,14-02-2021 04:00,24 hrs.,wallstreetbets,AAL,36,28,8,20,5,5,6,2,NASDAQ
4829,14-02-2021 04:00,24 hrs.,wallstreetbets,AMD,686,152,534,-382,7,199,260,6,NASDAQ
4829,14-02-2021 04:00,24 hrs.,wallstreetbets,API,7,0,7,-7,1,1,1,1,NASDAQ
4829,14-02-2021 04:00,24 hrs.,wallstreetbets,BLI,1086,0,1086,-1086,1,510,62,1,NASDAQ
4829,14-02-2021 04:00,24 hrs.,wallstreetbets,CDC,24,24,0,24,1,0,20,1,NASDAQ
4829,14-02-2021 04:00,24 hrs.,wallstreetbets,CEY,24,0,24,-24,3,3,6,1,NASDAQ
4829,14-02-2021 04:00,24 hrs.,wallstreetbets,CFO,44,38,6,32,2,9,18,2,NASDAQ
4829,14-02-2021 04:00,24 hrs.,wallstreetbets,CGC,7,7,0,7,1,1,1,1,NASDAQ
4829,14-02-2021 04:00,24 hrs.,wallstreetbets,DBX,161,161,0,161,2,58,37,2,NASDAQ
4829,14-02-2021 04:00,24 hrs.,wallstreetbets,FVE,203,203,0,203,1,80,39,1,NASDAQ
4829,14-02-2021 04:00,24 hrs.,wallstreetbets,HAS,26,20,6,14,4,4,2,4,NASDAQ
4829,14-02-2021 04:00,24 hrs.,wallstreetbets,HOL,6,6,0,6,1,1,0,1,NASDAQ
4829,14-02-2021 04:00,24 hrs.,wallstreetbets,NET,3653,3339,314,3025,3,1601,439,3,NYSE
4829,14-02-2021 04:00,24 hrs.,wallstreetbets,NGL,7,7,0,7,1,1,1,1,NYSE
4829,14-02-2021 04:00,24 hrs.,wallstreetbets,NIO,3335,3327,8,3319,6,1487,337,5,NYSE
4829,14-02-2021 04:00,24 hrs.,wallstreetbets,NKE,6,6,0,6,1,1,0,1,NYSE
4829,14-02-2021 04:00,24 hrs.,wallstreetbets,NMR,20,13,7,6,3,3,2,3,NYSE
4829,14-02-2021 04:00,24 hrs.,wallstreetbets,NOK,1002,436,566,-130,13,375,200,11,NYSE
4829,14-02-2021 04:00,24 hrs.,wallstreetbets,NSA,1807,0,1807,-1807,1,827,149,1,NYSE
4829,14-02-2021 04:00,24 hrs.,wallstreetbets,NTR,154,154,0,154,1,57,36,1,NYSE
4829,14-02-2021 04:00,24 hrs.,wallstreetbets,OSK,133,133,0,133,1,32,65,1,NYSE
4829,14-02-2021 04:00,24 hrs.,wallstreetbets,OXY,154,154,0,154,1,57,36,1,NYSE
4829,14-02-2021 04:00,24 hrs.,wallstreetbets,PCG,545,0,545,-545,1,213,115,1,NYSE
4829,14-02-2021 04:00,24 hrs.,wallstreetbets,PEI,8,8,0,8,1,1,2,1,NYSE
4829,14-02-2021 04:00,24 hrs.,wallstreetbets,PHT,7,0,7,-7,1,1,1,1,NYSE
4829,14-02-2021 04:00,24 hrs.,wallstreetbets,PSA,57,43,14,29,3,7,31,3,NYSE
4829,14-02-2021 04:00,24 hrs.,wallstreetbets,PWR,6,0,6,-6,1,1,0,1,NYSE
4829,14-02-2021 04:00,24 hrs.,wallstreetbets,PXD,154,154,0,154,1,57,36,1,NYSE
4829,14-02-2021 04:00,24 hrs.,wallstreetbets,RCL,7,7,0,7,1,1,1,1,NYSE
4829,14-02-2021 04:00,24 hrs.,wallstreetbets,RKT,62,0,62,-62,5,4,34,4,NYSE
4829,14-02-2021 04:00,24 hrs.,wallstreetbets,RNG,154,154,0,154,1,57,36,1,NYSE
4829,14-02-2021 04:00,24 hrs.,wallstreetbets,SAM,154,154,0,154,1,57,36,1,NYSE
4829,14-02-2021 04:00,24 hrs.,wallstreetbets,SAP,203,203,0,203,1,80,39,1,NYSE
4829,14-02-2021 04:00,24 hrs.,wallstreetbets,SBE,7,7,0,7,1,1,1,1,NYSE
4829,14-02-2021 04:00,24 hrs.,wallstreetbets,SJM,208,0,208,-208,2,72,56,2,NYSE
4829,14-02-2021 04:00,24 hrs.,wallstreetbets,SKT,1104,18,1086,-1068,2,510,76,2,NYSE
4829,14-02-2021 04:00,24 hrs.,wallstreetbets,SOS,203,155,48,107,19,41,45,11,NYSE
4829,14-02-2021 04:00,24 hrs.,wallstreetbets,TDA,20,20,0,20,1,2,12,1,NYSE
4829,14-02-2021 04:00,24 hrs.,wallstreetbets,THC,6,6,0,6,1,1,0,1,NYSE
4829,14-02-2021 04:00,24 hrs.,wallstreetbets,THO,8,8,0,8,1,1,2,1,NYSE
4829,14-02-2021 04:00,24 hrs.,wallstreetbets,TRQ,7,0,7,-7,1,1,1,1,NYSE
4829,14-02-2021 04:00,24 hrs.,wallstreetbets,TRU,154,154,0,154,1,57,36,1,NYSE
4829,14-02-2021 04:00,24 hrs.,wallstreetbets,TWO,28,28,0,28,1,3,18,1,NYSE
4829,14-02-2021 04:00,24 hrs.,wallstreetbets,UBS,75,75,0,75,2,20,27,1,NYSE
4829,14-02-2021 04:00,24 hrs.,wallstreetbets,UTF,24,24,0,24,1,0,20,1,NYSE
4829,14-02-2021 04:00,24 hrs.,wallstreetbets,UVV,28,28,0,28,1,3,18,1,NYSE
4829,14-02-2021 04:00,24 hrs.,wallstreetbets,VET,7,7,0,7,1,1,1,1,NYSE
4829,14-02-2021 04:00,24 hrs.,wallstreetbets,VHC,7,7,0,7,1,1,1,1,NYSE
4829,14-02-2021 04:00,24 hrs.,wallstreetbets,WMT,1240,154,1086,-932,2,567,98,2,NYSE
4829,14-02-2021 04:00,24 hrs.,wallstreetbets,WST,154,154,0,154,1,57,36,1,NYSE
4829,14-02-2021 04:00,24 hrs.,wallstreetbets,XOM,386,386,0,386,1,142,98,1,NYSE
4809,14-02-2021 00:00,24 hrs.,stocks,DASH,6,0,6,-6,1,1,0,1,NYSE
4809,14-02-2021 00:00,24 hrs.,stocks,DSSI,15,15,0,15,1,2,7,1,NYSE
4809,14-02-2021 00:00,24 hrs.,stocks,FSLY,381,381,0,381,1,178,21,1,NYSE
4809,14-02-2021 00:00,24 hrs.,stocks,FVRR,381,381,0,381,1,178,21,1,NYSE
4809,14-02-2021 00:00,24 hrs.,stocks,NYCB,60,60,0,60,1,11,34,1,NYSE
4809,14-02-2021 00:00,24 hrs.,stocks,RIOT,12,12,0,12,2,2,0,1,NASDAQ
4809,14-02-2021 00:00,24 hrs.,stocks,ROKU,381,381,0,381,1,178,21,1,NASDAQ
4809,14-02-2021 00:00,24 hrs.,stocks,RRGB,29,0,29,-29,1,6,13,1,NASDAQ
4809,14-02-2021 00:00,24 hrs.,stocks,SNDL,6,6,0,6,1,1,0,1,NASDAQ
4809,14-02-2021 00:00,24 hrs.,stocks,SNGX,13,0,13,-13,2,2,1,2,NASDAQ
4809,14-02-2021 00:00,24 hrs.,SPACs,CAGR,8,8,0,8,1,1,2,1,OTC
4809,14-02-2021 00:00,24 hrs.,SPACs,NOVC,6,6,0,6,1,0,2,1,OTC
4809,14-02-2021 00:00,24 hrs.,SPACs,PTK,83,0,83,-83,1,23,33,1,AMEX
4809,14-02-2021 00:00,24 hrs.,SPACs,CHAQ,83,0,83,-83,1,23,33,1,AMEX
4809,14-02-2021 00:00,24 hrs.,SPACs,AMC,16,16,0,16,1,0,12,1,NYSE
4809,14-02-2021 00:00,24 hrs.,stocks,XJNGF,6,6,0,6,1,1,0,1,OTC
4809,14-02-2021 00:00,24 hrs.,stocks,GTE,7,0,7,-7,1,1,1,1,AMEX
4809,14-02-2021 00:00,24 hrs.,stocks,ZOM,6,0,6,-6,1,1,0,1,AMEX
4809,14-02-2021 00:00,24 hrs.,stocks,GSAT,18,0,18,-18,3,3,0,1,AMEX
4809,14-02-2021 00:00,24 hrs.,stocks,SENS,25,0,25,-25,3,2,9,2,AMEX
4809,14-02-2021 00:00,24 hrs.,stocks,UAVS,6,6,0,6,1,1,0,1,AMEX
4809,14-02-2021 00:00,24 hrs.,stocks,AAP,381,381,0,381,1,178,21,1,NYSE
4809,14-02-2021 00:00,24 hrs.,stocks,AIV,27,27,0,27,1,8,7,1,NYSE
4809,14-02-2021 00:00,24 hrs.,stocks,ASX,6,0,6,-6,1,1,0,1,NYSE
4809,14-02-2021 00:00,24 hrs.,stocks,BKH,44,44,0,44,1,12,16,1,NYSE
4809,14-02-2021 00:00,24 hrs.,stocks,CMA,6,6,0,6,1,1,0,1,NYSE
4809,14-02-2021 00:00,24 hrs.,stocks,CNQ,17,17,0,17,1,2,9,1,NYSE
4809,14-02-2021 00:00,24 hrs.,stocks,CVE,17,17,0,17,1,2,9,1,NYSE
4809,14-02-2021 00:00,24 hrs.,stocks,CVS,381,381,0,381,1,178,21,1,NYSE
4809,14-02-2021 00:00,24 hrs.,stocks,DDD,381,381,0,381,1,178,21,1,NYSE
4809,14-02-2021 00:00,24 hrs.,stocks,DDS,381,381,0,381,1,178,21,1,NYSE
4809,14-02-2021 00:00,24 hrs.,stocks,DIS,17,17,0,17,2,2,5,2,NYSE
4809,14-02-2021 00:00,24 hrs.,stocks,DPG,15,0,15,-15,1,3,5,1,NYSE
4809,14-02-2021 00:00,24 hrs.,stocks,EFT,15,15,0,15,1,4,3,1,NYSE
4809,14-02-2021 00:00,24 hrs.,stocks,ETH,6,6,0,6,1,1,0,1,NYSE
4809,14-02-2021 00:00,24 hrs.,stocks,FTI,16,16,0,16,2,4,0,2,NYSE
4809,14-02-2021 00:00,24 hrs.,stocks,GME,492,440,52,388,7,192,80,7,NYSE
4809,14-02-2021 00:00,24 hrs.,stocks,HPQ,204,204,0,204,1,82,36,1,NYSE
4809,14-02-2021 00:00,24 hrs.,stocks,IBM,1645,44,1601,-1557,2,738,161,2,NYSE
4809,14-02-2021 00:00,24 hrs.,stocks,IGT,381,381,0,381,1,178,21,1,NYSE
4809,14-02-2021 00:00,24 hrs.,stocks,IRS,9,0,9,-9,1,0,5,1,NYSE
4809,14-02-2021 00:00,24 hrs.,stocks,JNJ,50,44,6,38,2,13,16,2,NYSE
4809,14-02-2021 00:00,24 hrs.,stocks,JPM,44,44,0,44,1,12,16,1,NYSE
4809,14-02-2021 00:00,24 hrs.,stocks,KOF,24,24,0,24,1,10,0,1,NYSE
4809,14-02-2021 00:00,24 hrs.,stocks,LAC,6,6,0,6,1,1,0,1,NYSE
4809,14-02-2021 00:00,24 hrs.,stocks,LEG,44,44,0,44,1,12,16,1,NYSE
4809,14-02-2021 00:00,24 hrs.,stocks,LOW,9,0,9,-9,1,0,5,1,NYSE
4809,14-02-2021 00:00,24 hrs.,stocks,LPL,381,381,0,381,1,178,21,1,NYSE
4809,14-02-2021 00:00,24 hrs.,stocks,MAC,85,85,0,85,1,33,15,1,NYSE
4809,14-02-2021 00:00,24 hrs.,stocks,MFA,6,6,0,6,1,1,0,1,NYSE
4809,14-02-2021 00:00,24 hrs.,stocks,MMM,44,44,0,44,1,12,16,1,NYSE
4809,14-02-2021 00:00,24 hrs.,stocks,MTD,381,381,0,381,1,178,21,1,NYSE
4809,14-02-2021 00:00,24 hrs.,stocks,NET,3877,3868,9,3859,2,1710,449,2,NYSE
4809,14-02-2021 00:00,24 hrs.,stocks,NGL,6,6,0,6,1,1,0,1,NYSE
4809,14-02-2021 00:00,24 hrs.,stocks,NIO,116,116,0,116,1,32,48,1,NYSE
4809,14-02-2021 00:00,24 hrs.,stocks,NSA,1601,0,1601,-1601,1,726,145,1,NYSE
4809,14-02-2021 00:00,24 hrs.,stocks,RBC,7,7,0,7,1,1,1,1,NYSE
4809,14-02-2021 00:00,24 hrs.,stocks,SBE,40,40,0,40,2,9,14,2,NYSE
4809,14-02-2021 00:00,24 hrs.,stocks,SHO,6,6,0,6,1,1,0,1,NYSE
4809,14-02-2021 00:00,24 hrs.,stocks,SKT,381,381,0,381,1,178,21,1,NYSE
4809,14-02-2021 00:00,24 hrs.,stocks,SOS,23,23,0,23,1,3,13,1,NYSE
4809,14-02-2021 00:00,24 hrs.,stocks,SQZ,7,0,7,-7,1,1,1,1,NYSE
4809,14-02-2021 00:00,24 hrs.,stocks,TDA,11,0,11,-11,1,1,5,1,NYSE
4809,14-02-2021 00:00,24 hrs.,stocks,THC,59,59,0,59,1,17,21,1,NYSE
4809,14-02-2021 00:00,24 hrs.,stocks,WMT,381,381,0,381,1,178,21,1,NYSE
4809,14-02-2021 00:00,24 hrs.,stocks,XOM,44,44,0,44,1,12,16,1,NYSE
4809,14-02-2021 00:00,24 hrs.,stocks,BABA,6,0,6,-6,1,1,0,1,NYSE
4809,14-02-2021 00:00,24 hrs.,stocks,CCIV,12,0,12,-12,2,2,0,2,NYSE
4809,14-02-2021 00:00,24 hrs.,stocks,CHWY,204,204,0,204,1,82,36,1,NYSE
4809,14-02-2021 00:00,24 hrs.,StockMarket,MOST,57,57,0,57,1,24,5,1,OTC
4809,14-02-2021 00:00,24 hrs.,StockMarket,AMKBY,17,17,0,17,1,4,5,1,OTC
4809,14-02-2021 00:00,24 hrs.,StockMarket,CADMF,6,6,0,6,1,1,0,1,OTC
4809,14-02-2021 00:00,24 hrs.,StockMarket,EMHTF,9,9,0,9,1,2,1,1,OTC
4809,14-02-2021 00:00,24 hrs.,StockMarket,NXTTF,12,12,0,12,2,2,0,1,OTC
4809,14-02-2021 00:00,24 hrs.,stocks,PLTR,509,509,0,509,4,212,69,3,NYSE
4809,14-02-2021 00:00,24 hrs.,stocks,SHOP,463,381,82,299,2,196,63,2,NYSE
4809,14-02-2021 00:00,24 hrs.,stocks,SNAP,32,32,0,32,1,5,18,1,NYSE
4809,14-02-2021 00:00,24 hrs.,stocks,SPCE,147,147,0,147,1,37,69,1,NYSE
4809,14-02-2021 00:00,24 hrs.,stocks,TWLO,381,381,0,381,1,178,21,1,NYSE
4809,14-02-2021 00:00,24 hrs.,stocks,AAL,36,36,0,36,1,2,28,1,NASDAQ
4809,14-02-2021 00:00,24 hrs.,stocks,AMD,13,7,6,1,2,2,1,2,NASDAQ
4809,14-02-2021 00:00,24 hrs.,stocks,BLI,381,381,0,381,1,178,21,1,NASDAQ
4809,14-02-2021 00:00,24 hrs.,stocks,CFO,6,6,0,6,1,1,0,1,NASDAQ
4809,14-02-2021 00:00,24 hrs.,stocks,III,7,7,0,7,1,1,1,1,NASDAQ
4809,14-02-2021 00:00,24 hrs.,stocks,NIU,147,147,0,147,1,37,69,1,NASDAQ
4809,14-02-2021 00:00,24 hrs.,stocks,QTT,6,6,0,6,1,1,0,1,NASDAQ
4809,14-02-2021 00:00,24 hrs.,stocks,REG,6,6,0,6,1,1,0,1,NASDAQ
4809,14-02-2021 00:00,24 hrs.,stocks,SMH,33,0,33,-33,1,5,19,1,NASDAQ
4809,14-02-2021 00:00,24 hrs.,stocks,SPI,6,0,6,-6,1,1,0,1,NASDAQ
4809,14-02-2021 00:00,24 hrs.,stocks,VFF,6,0,6,-6,1,1,0,1,NASDAQ
4809,14-02-2021 00:00,24 hrs.,stocks,AAPL,57,57,0,57,3,7,31,3,NASDAQ
4809,14-02-2021 00:00,24 hrs.,stocks,AESE,6,0,6,-6,1,1,0,1,NASDAQ
4809,14-02-2021 00:00,24 hrs.,stocks,AMAT,30,0,30,-30,1,6,14,1,NASDAQ
4809,14-02-2021 00:00,24 hrs.,stocks,AMZN,22,6,16,-10,2,3,8,2,NASDAQ
4809,14-02-2021 00:00,24 hrs.,stocks,ANTE,12,0,12,-12,2,2,0,1,NASDAQ
4809,14-02-2021 00:00,24 hrs.,stocks,APHA,159,159,0,159,3,39,69,3,NASDAQ
4809,14-02-2021 00:00,24 hrs.,stocks,AZRX,6,6,0,6,1,1,0,1,NASDAQ
4809,14-02-2021 00:00,24 hrs.,stocks,BIGC,381,381,0,381,1,178,21,1,NASDAQ
4809,14-02-2021 00:00,24 hrs.,stocks,BNGO,18,12,6,6,3,3,0,3,NASDAQ
4809,14-02-2021 00:00,24 hrs.,stocks,CCRC,6,6,0,6,1,1,0,1,NASDAQ
4809,14-02-2021 00:00,24 hrs.,stocks,CLVR,17,0,17,-17,1,3,7,1,NASDAQ
4809,14-02-2021 00:00,24 hrs.,stocks,CMPS,6,0,6,-6,1,1,0,1,NASDAQ
4809,14-02-2021 00:00,24 hrs.,stocks,CREG,6,0,6,-6,1,1,0,1,NASDAQ
4809,14-02-2021 00:00,24 hrs.,stocks,CRNC,25,0,25,-25,1,7,7,1,NASDAQ
4809,14-02-2021 00:00,24 hrs.,stocks,CRNT,6,6,0,6,1,1,0,1,NASDAQ
4809,14-02-2021 00:00,24 hrs.,stocks,CRSR,110,110,0,110,1,26,54,1,NASDAQ
4809,14-02-2021 00:00,24 hrs.,stocks,DRIV,26,26,0,26,1,8,6,1,NASDAQ
4809,14-02-2021 00:00,24 hrs.,stocks,EDIT,52,0,52,-52,2,11,22,2,NASDAQ
4809,14-02-2021 00:00,24 hrs.,stocks,EXEL,8,8,0,8,1,1,2,1,NASDAQ
4809,14-02-2021 00:00,24 hrs.,stocks,EXPI,36,4,32,-28,3,9,6,3,NASDAQ
4809,14-02-2021 00:00,24 hrs.,stocks,FIZZ,381,381,0,381,1,178,21,1,NASDAQ
4809,14-02-2021 00:00,24 hrs.,stocks,FROG,6,6,0,6,1,1,0,1,NASDAQ
4809,14-02-2021 00:00,24 hrs.,stocks,GLUU,6,0,6,-6,1,1,0,1,NASDAQ
4809,14-02-2021 00:00,24 hrs.,stocks,GNOG,6,6,0,6,1,1,0,1,NASDAQ
4809,14-02-2021 00:00,24 hrs.,stocks,GOGO,387,387,0,387,2,179,21,2,NASDAQ
4809,14-02-2021 00:00,24 hrs.,stocks,GOOG,41,41,0,41,1,5,27,1,NASDAQ
4809,14-02-2021 00:00,24 hrs.,stocks,HOLI,12,12,0,12,2,2,0,1,NASDAQ
4809,14-02-2021 00:00,24 hrs.,stocks,ITRM,6,0,6,-6,1,1,0,1,NASDAQ
4809,14-02-2021 00:00,24 hrs.,stocks,KLIC,30,30,0,30,1,11,4,1,NASDAQ
4809,14-02-2021 00:00,24 hrs.,stocks,KOPN,19,19,0,19,1,6,3,1,NASDAQ
4809,14-02-2021 00:00,24 hrs.,stocks,MOGO,18,0,18,-18,3,3,0,2,NASDAQ
4809,14-02-2021 00:00,24 hrs.,stocks,MRNA,6,0,6,-6,1,1,0,1,NASDAQ
4809,14-02-2021 00:00,24 hrs.,stocks,MSFT,51,51,0,51,2,6,31,2,NASDAQ
4809,14-02-2021 00:00,24 hrs.,stocks,NCNO,381,381,0,381,1,178,21,1,NASDAQ
4809,14-02-2021 00:00,24 hrs.,stocks,NXTD,6,0,6,-6,1,1,0,1,NASDAQ
4809,14-02-2021 00:00,24 hrs.,stocks,OCGN,6,0,6,-6,1,1,0,1,NASDAQ
4809,14-02-2021 00:00,24 hrs.,stocks,ONCR,7,0,7,-7,1,1,1,1,NASDAQ
4809,14-02-2021 00:00,24 hrs.,stocks,PBCT,44,44,0,44,1,12,16,1,NASDAQ
4809,14-02-2021 00:00,24 hrs.,stocks,QDEL,6,0,6,-6,1,1,0,1,NASDAQ
4809,14-02-2021 00:00,24 hrs.,stocks,QQQJ,812,779,33,746,2,288,228,2,NASDAQ
4809,14-02-2021 00:00,24 hrs.,stocks,QQQM,812,779,33,746,2,288,228,2,NASDAQ
4809,14-02-2021 00:00,24 hrs.,stocks,RDFN,26,0,26,-26,1,8,6,1,NASDAQ
4809,14-02-2021 00:00,24 hrs.,stocks,REGN,6,0,6,-6,1,1,0,1,NASDAQ
4809,14-02-2021 00:00,24 hrs.,StockMarket,WNW,6,6,0,6,1,1,0,1,NASDAQ
4809,14-02-2021 00:00,24 hrs.,StockMarket,AKER,6,6,0,6,1,1,0,1,NASDAQ
4809,14-02-2021 00:00,24 hrs.,StockMarket,AMAT,57,57,0,57,1,24,5,1,NASDAQ
4809,14-02-2021 00:00,24 hrs.,StockMarket,AMGN,12,12,0,12,1,1,6,1,NASDAQ
4809,14-02-2021 00:00,24 hrs.,StockMarket,AMZN,27,27,0,27,1,6,11,1,NASDAQ
4809,14-02-2021 00:00,24 hrs.,stocks,TFFP,29,29,0,29,2,7,7,1,NASDAQ
4809,14-02-2021 00:00,24 hrs.,stocks,TLRY,399,393,6,387,4,181,21,4,NASDAQ
4809,14-02-2021 00:00,24 hrs.,stocks,TRCH,13,7,6,1,2,2,1,2,NASDAQ
4809,14-02-2021 00:00,24 hrs.,stocks,TREE,381,381,0,381,1,178,21,1,NASDAQ
4809,14-02-2021 00:00,24 hrs.,stocks,TSLA,40,0,40,-40,3,7,14,2,NASDAQ
4809,14-02-2021 00:00,24 hrs.,stocks,VGLT,6,6,0,6,1,1,0,1,NASDAQ
4809,14-02-2021 00:00,24 hrs.,stocks,VXUS,33,10,23,-13,2,7,11,2,NASDAQ
4809,14-02-2021 00:00,24 hrs.,stocks,WIMI,6,6,0,6,1,1,0,1,NASDAQ
4809,14-02-2021 00:00,24 hrs.,stocks,XONE,16,0,16,-16,1,4,4,1,NASDAQ
4809,14-02-2021 00:00,24 hrs.,stocks,ZNGA,30,30,0,30,1,8,10,1,NASDAQ
4809,14-02-2021 00:00,24 hrs.,stocks,LBTYB,7,7,0,7,1,1,1,1,NASDAQ
4809,14-02-2021 00:00,24 hrs.,stocks,LILAK,12,0,12,-12,2,2,0,1,NASDAQ
4809,14-02-2021 00:00,24 hrs.,Daytrading,GTE,7,0,7,-7,1,1,1,1,AMEX
4809,14-02-2021 00:00,24 hrs.,Daytrading,MSN,13,13,0,13,1,1,7,1,AMEX
4809,14-02-2021 00:00,24 hrs.,Daytrading,AMC,5,5,0,5,1,0,1,1,NYSE
4809,14-02-2021 00:00,24 hrs.,Daytrading,GME,38,38,0,38,3,2,22,3,NYSE
4809,14-02-2021 00:00,24 hrs.,Daytrading,IRS,11,11,0,11,1,1,5,1,NYSE
4809,14-02-2021 00:00,24 hrs.,Daytrading,NIO,12,0,12,-12,1,2,4,1,NYSE
4809,14-02-2021 00:00,24 hrs.,Daytrading,PDT,18,9,9,0,2,1,8,2,NYSE
4809,14-02-2021 00:00,24 hrs.,Daytrading,TWO,6,6,0,6,1,1,0,1,NYSE
4809,14-02-2021 00:00,24 hrs.,Daytrading,DUO,6,6,0,6,1,1,0,1,NASDAQ
4809,14-02-2021 00:00,24 hrs.,Daytrading,AAPL,12,0,12,-12,1,2,4,1,NASDAQ
4809,14-02-2021 00:00,24 hrs.,Daytrading,ARTL,6,0,6,-6,1,1,0,1,NASDAQ
4809,14-02-2021 00:00,24 hrs.,Daytrading,SNDL,40,40,0,40,1,7,22,1,NASDAQ
4809,14-02-2021 00:00,24 hrs.,Daytrading,TLRY,7,0,7,-7,1,1,1,1,NASDAQ
4809,14-02-2021 00:00,24 hrs.,Daytrading,TRMD,6,6,0,6,1,1,0,1,NASDAQ
4809,14-02-2021 00:00,24 hrs.,Daytrading,TSLA,27,0,27,-27,1,2,19,1,NASDAQ
4809,14-02-2021 00:00,24 hrs.,trakstocks,HCMC,11,0,11,-11,1,0,7,1,OTC
4809,14-02-2021 00:00,24 hrs.,trakstocks,INND,11,0,11,-11,1,0,7,1,OTC
4809,14-02-2021 00:00,24 hrs.,trakstocks,DMNXF,87,87,0,87,2,24,31,2,OTC
4809,14-02-2021 00:00,24 hrs.,trakstocks,LXXGF,6,6,0,6,1,1,0,1,OTC
4809,14-02-2021 00:00,24 hrs.,trakstocks,MGROF,17,0,17,-17,1,4,5,1,OTC
4809,14-02-2021 00:00,24 hrs.,trakstocks,VRYYF,7,0,7,-7,1,1,1,1,OTC
4809,14-02-2021 00:00,24 hrs.,trakstocks,DPW,6,0,6,-6,1,0,2,1,AMEX
4809,14-02-2021 00:00,24 hrs.,trakstocks,BFT,6,0,6,-6,1,1,0,1,NYSE
4809,14-02-2021 00:00,24 hrs.,trakstocks,CBO,8,8,0,8,1,2,0,1,NYSE
4809,14-02-2021 00:00,24 hrs.,trakstocks,NAT,15,15,0,15,1,4,3,1,NYSE
4809,14-02-2021 00:00,24 hrs.,trakstocks,SWN,11,0,11,-11,1,3,1,1,NYSE
4809,14-02-2021 00:00,24 hrs.,trakstocks,PLTR,49,0,49,-49,1,19,7,1,NYSE
4809,14-02-2021 00:00,24 hrs.,trakstocks,STPK,101,0,101,-101,3,36,17,2,NYSE
4809,14-02-2021 00:00,24 hrs.,trakstocks,FUV,9,9,0,9,1,2,1,1,NASDAQ
4809,14-02-2021 00:00,24 hrs.,trakstocks,AYRO,30,20,10,10,3,5,8,3,NASDAQ
4809,14-02-2021 00:00,24 hrs.,trakstocks,CLVS,41,25,16,9,2,14,5,2,NASDAQ
4809,14-02-2021 00:00,24 hrs.,trakstocks,ENLV,6,6,0,6,1,1,0,1,NASDAQ
4809,14-02-2021 00:00,24 hrs.,trakstocks,LIFE,13,0,13,-13,1,0,9,1,NASDAQ
4809,14-02-2021 00:00,24 hrs.,trakstocks,MVIS,15,15,0,15,1,4,3,1,NASDAQ
4809,14-02-2021 00:00,24 hrs.,trakstocks,QLGN,8,8,0,8,1,2,0,1,NASDAQ
4809,14-02-2021 00:00,24 hrs.,trakstocks,SNDL,49,0,49,-49,1,19,7,1,NASDAQ
4809,14-02-2021 00:00,24 hrs.,trakstocks,TLRY,49,0,49,-49,1,19,7,1,NASDAQ
4809,14-02-2021 00:00,24 hrs.,trakstocks,TRIT,133,0,133,-133,1,51,27,1,NASDAQ
4809,14-02-2021 00:00,24 hrs.,trakstocks,TTCF,27,0,27,-27,2,3,13,2,NASDAQ
4809,14-02-2021 00:00,24 hrs.,trakstocks,ZSAN,13,13,0,13,1,3,3,1,NASDAQ
4809,14-02-2021 00:00,24 hrs.,StockMarket,BOTH,9,0,9,-9,1,0,5,1,OTC
4809,14-02-2021 00:00,24 hrs.,StockMarket,BOTY,8,0,8,-8,1,1,2,1,OTC
4809,14-02-2021 00:00,24 hrs.,StockMarket,COMS,11,11,0,11,1,0,7,1,OTC
4809,14-02-2021 00:00,24 hrs.,StockMarket,GBTC,14,14,0,14,3,0,2,1,OTC
4809,14-02-2021 00:00,24 hrs.,StockMarket,HRBR,6,6,0,6,1,1,0,1,OTC
4809,14-02-2021 00:00,24 hrs.,StockMarket,LINK,57,57,0,57,1,24,5,1,OTC
4809,14-02-2021 00:00,24 hrs.,StockMarket,LRDR,6,6,0,6,1,1,0,1,OTC
4809,14-02-2021 00:00,24 hrs.,SPACs,ESG,24,0,24,-24,1,9,2,1,NASDAQ
4809,14-02-2021 00:00,24 hrs.,SPACs,III,99,99,0,99,1,29,37,1,NASDAQ
4809,14-02-2021 00:00,24 hrs.,SPACs,AACQ,1472,221,1251,-1030,12,473,478,10,NASDAQ
4809,14-02-2021 00:00,24 hrs.,SPACs,ACAC,34,34,0,34,1,10,10,1,NASDAQ
4809,14-02-2021 00:00,24 hrs.,SPACs,ACTC,34,0,34,-34,1,5,20,1,NASDAQ
4809,14-02-2021 00:00,24 hrs.,StockMarket,XJNGF,16,16,0,16,1,0,12,1,OTC
4809,14-02-2021 00:00,24 hrs.,StockMarket,MXC,9,0,9,-9,1,0,5,1,AMEX
4809,14-02-2021 00:00,24 hrs.,StockMarket,ZOM,6,0,6,-6,1,1,0,1,AMEX
4809,14-02-2021 00:00,24 hrs.,StockMarket,GSAT,24,0,24,-24,4,3,2,1,AMEX
4809,14-02-2021 00:00,24 hrs.,StockMarket,AAP,57,57,0,57,1,24,5,1,NYSE
4809,14-02-2021 00:00,24 hrs.,StockMarket,AMC,42,42,0,42,4,8,10,4,NYSE
4809,14-02-2021 00:00,24 hrs.,StockMarket,ASX,9,0,9,-9,1,0,5,1,NYSE
4809,14-02-2021 00:00,24 hrs.,StockMarket,BKI,57,57,0,57,1,24,5,1,NYSE
4809,14-02-2021 00:00,24 hrs.,StockMarket,CBD,12,12,0,12,1,1,6,1,NYSE
4809,14-02-2021 00:00,24 hrs.,StockMarket,CMA,6,6,0,6,1,1,0,1,NYSE
4809,14-02-2021 00:00,24 hrs.,StockMarket,CMO,175,175,0,175,1,84,3,1,NYSE
4809,14-02-2021 00:00,24 hrs.,StockMarket,CVS,57,57,0,57,1,24,5,1,NYSE
4809,14-02-2021 00:00,24 hrs.,StockMarket,DDD,57,57,0,57,1,24,5,1,NYSE
4809,14-02-2021 00:00,24 hrs.,StockMarket,DDS,57,57,0,57,1,24,5,1,NYSE
4809,14-02-2021 00:00,24 hrs.,StockMarket,ECL,57,57,0,57,1,24,5,1,NYSE
4809,14-02-2021 00:00,24 hrs.,StockMarket,FIX,4,4,0,4,1,0,0,1,NYSE
4809,14-02-2021 00:00,24 hrs.,StockMarket,GME,100,62,38,24,3,33,22,3,NYSE
4809,14-02-2021 00:00,24 hrs.,StockMarket,HLT,57,57,0,57,1,24,5,1,NYSE
4809,14-02-2021 00:00,24 hrs.,StockMarket,IGT,57,57,0,57,1,24,5,1,NYSE
4809,14-02-2021 00:00,24 hrs.,StockMarket,JNJ,12,12,0,12,1,1,6,1,NYSE
4809,14-02-2021 00:00,24 hrs.,StockMarket,JPM,26,0,26,-26,1,4,14,1,NYSE
4809,14-02-2021 00:00,24 hrs.,StockMarket,LPL,57,57,0,57,1,24,5,1,NYSE
4809,14-02-2021 00:00,24 hrs.,StockMarket,LPX,57,57,0,57,1,24,5,1,NYSE
4809,14-02-2021 00:00,24 hrs.,StockMarket,MRO,57,57,0,57,1,24,5,1,NYSE
4809,14-02-2021 00:00,24 hrs.,StockMarket,MTD,57,57,0,57,1,24,5,1,NYSE
4809,14-02-2021 00:00,24 hrs.,StockMarket,NET,6,6,0,6,1,1,0,1,NYSE
4809,14-02-2021 00:00,24 hrs.,StockMarket,NVS,12,12,0,12,1,1,6,1,NYSE
4809,14-02-2021 00:00,24 hrs.,StockMarket,OXY,57,57,0,57,1,24,5,1,NYSE
4809,14-02-2021 00:00,24 hrs.,StockMarket,PMO,12,6,6,0,2,2,0,2,NYSE
4809,14-02-2021 00:00,24 hrs.,StockMarket,RNG,57,57,0,57,1,24,5,1,NYSE
4809,14-02-2021 00:00,24 hrs.,StockMarket,SKT,57,57,0,57,1,24,5,1,NYSE
4809,14-02-2021 00:00,24 hrs.,StockMarket,SOS,6,0,6,-6,1,1,0,1,NYSE
4809,14-02-2021 00:00,24 hrs.,StockMarket,THC,12,12,0,12,1,1,6,1,NYSE
4809,14-02-2021 00:00,24 hrs.,StockMarket,TRU,57,57,0,57,1,24,5,1,NYSE
4809,14-02-2021 00:00,24 hrs.,StockMarket,VMC,57,57,0,57,1,24,5,1,NYSE
4809,14-02-2021 00:00,24 hrs.,StockMarket,VRT,13,0,13,-13,1,3,3,1,NYSE
4809,14-02-2021 00:00,24 hrs.,StockMarket,WMT,57,57,0,57,1,24,5,1,NYSE
4809,14-02-2021 00:00,24 hrs.,StockMarket,ZTS,57,57,0,57,1,24,5,1,NYSE
4809,14-02-2021 00:00,24 hrs.,StockMarket,ABBV,12,12,0,12,1,1,6,1,NYSE
4809,14-02-2021 00:00,24 hrs.,StockMarket,CCIV,6,0,6,-6,1,1,0,1,NYSE
4809,14-02-2021 00:00,24 hrs.,StockMarket,FSLY,57,57,0,57,1,24,5,1,NYSE
4809,14-02-2021 00:00,24 hrs.,StockMarket,FVRR,57,57,0,57,1,24,5,1,NYSE
4809,14-02-2021 00:00,24 hrs.,StockMarket,LGVW,14,14,0,14,3,0,2,1,NYSE
4809,14-02-2021 00:00,24 hrs.,StockMarket,PLTR,57,57,0,57,1,24,5,1,NYSE
4809,14-02-2021 00:00,24 hrs.,StockMarket,PSTH,6,6,0,6,1,1,0,1,NYSE
4809,14-02-2021 00:00,24 hrs.,StockMarket,PUMP,6,0,6,-6,1,1,0,1,NYSE
4809,14-02-2021 00:00,24 hrs.,StockMarket,SHOP,57,57,0,57,1,24,5,1,NYSE
4809,14-02-2021 00:00,24 hrs.,StockMarket,TRTN,57,57,0,57,1,24,5,1,NYSE
4809,14-02-2021 00:00,24 hrs.,StockMarket,TWLO,57,57,0,57,1,24,5,1,NYSE
4809,14-02-2021 00:00,24 hrs.,StockMarket,USFD,57,57,0,57,1,24,5,1,NYSE
4809,14-02-2021 00:00,24 hrs.,StockMarket,ADI,57,57,0,57,1,24,5,1,NASDAQ
4809,14-02-2021 00:00,24 hrs.,StockMarket,AQB,8,0,8,-8,1,2,0,1,NASDAQ
4809,14-02-2021 00:00,24 hrs.,StockMarket,BLI,57,57,0,57,1,24,5,1,NASDAQ
4809,14-02-2021 00:00,24 hrs.,StockMarket,DBX,57,57,0,57,1,24,5,1,NASDAQ
4809,14-02-2021 00:00,24 hrs.,StockMarket,FOX,11,11,0,11,1,0,7,1,NASDAQ
4809,14-02-2021 00:00,24 hrs.,StockMarket,QQQ,9,0,9,-9,1,0,5,1,NASDAQ
4809,14-02-2021 00:00,24 hrs.,StockMarket,TTD,57,57,0,57,1,24,5,1,NASDAQ
4809,14-02-2021 00:00,24 hrs.,StockMarket,UFO,6,6,0,6,1,1,0,1,NASDAQ
4809,14-02-2021 00:00,24 hrs.,StockMarket,WIX,57,57,0,57,1,24,5,1,NASDAQ
4809,14-02-2021 00:00,24 hrs.,stocks,COCSF,24,24,0,24,1,10,0,1,OTC
4809,14-02-2021 00:00,24 hrs.,stocks,HITIF,6,0,6,-6,1,1,0,1,OTC
4809,14-02-2021 00:00,24 hrs.,stocks,HRVSF,6,6,0,6,1,1,0,1,OTC
4809,14-02-2021 00:00,24 hrs.,stocks,ILIKF,6,0,6,-6,1,1,0,1,OTC
4809,14-02-2021 00:00,24 hrs.,stocks,TCNNF,6,6,0,6,1,1,0,1,OTC
4809,14-02-2021 00:00,24 hrs.,StockMarket,ATNF,12,12,0,12,1,1,6,1,NASDAQ
4809,14-02-2021 00:00,24 hrs.,StockMarket,BIDU,57,57,0,57,1,24,5,1,NASDAQ
4809,14-02-2021 00:00,24 hrs.,StockMarket,BIGC,57,57,0,57,1,24,5,1,NASDAQ
4809,14-02-2021 00:00,24 hrs.,StockMarket,CLIR,6,6,0,6,1,1,0,1,NASDAQ
4809,14-02-2021 00:00,24 hrs.,StockMarket,CLVS,57,57,0,57,1,24,5,1,NASDAQ
4809,14-02-2021 00:00,24 hrs.,StockMarket,CPLP,12,12,0,12,1,3,2,1,NASDAQ
4809,14-02-2021 00:00,24 hrs.,StockMarket,CTRM,6,6,0,6,1,1,0,1,NASDAQ
4809,14-02-2021 00:00,24 hrs.,StockMarket,EXPD,57,57,0,57,1,24,5,1,NASDAQ
4809,14-02-2021 00:00,24 hrs.,StockMarket,FIZZ,57,57,0,57,1,24,5,1,NASDAQ
4809,14-02-2021 00:00,24 hrs.,StockMarket,GOGO,57,57,0,57,1,24,5,1,NASDAQ
4809,14-02-2021 00:00,24 hrs.,StockMarket,GOLD,57,57,0,57,1,24,5,1,NASDAQ
4809,14-02-2021 00:00,24 hrs.,StockMarket,GTHX,70,6,64,-58,2,17,28,2,NASDAQ
4809,14-02-2021 00:00,24 hrs.,StockMarket,HTBX,6,6,0,6,1,1,0,1,NASDAQ
4809,14-02-2021 00:00,24 hrs.,StockMarket,ITRM,11,11,0,11,1,0,7,1,NASDAQ
4809,14-02-2021 00:00,24 hrs.,StockMarket,KLIC,20,20,0,20,1,5,6,1,NASDAQ
4809,14-02-2021 00:00,24 hrs.,StockMarket,LGND,57,57,0,57,1,24,5,1,NASDAQ
4809,14-02-2021 00:00,24 hrs.,StockMarket,NBIX,12,12,0,12,1,1,6,1,NASDAQ
4809,14-02-2021 00:00,24 hrs.,StockMarket,NCNO,57,57,0,57,1,24,5,1,NASDAQ
4809,14-02-2021 00:00,24 hrs.,StockMarket,NOVN,6,6,0,6,1,1,0,1,NASDAQ
4809,14-02-2021 00:00,24 hrs.,StockMarket,ROKU,57,57,0,57,1,24,5,1,NASDAQ
4809,14-02-2021 00:00,24 hrs.,StockMarket,SEDG,57,57,0,57,1,24,5,1,NASDAQ
4809,14-02-2021 00:00,24 hrs.,StockMarket,SNBR,57,57,0,57,1,24,5,1,NASDAQ
4809,14-02-2021 00:00,24 hrs.,SPACs,BFT,847,21,826,-805,5,40,747,5,NYSE
4809,14-02-2021 00:00,24 hrs.,SPACs,ELY,24,0,24,-24,1,9,2,1,NYSE
4809,14-02-2021 00:00,24 hrs.,SPACs,EQD,819,0,819,-819,1,36,743,1,NYSE
4809,14-02-2021 00:00,24 hrs.,SPACs,FSR,34,0,34,-34,1,5,20,1,NYSE
4809,14-02-2021 00:00,24 hrs.,SPACs,GME,16,16,0,16,1,0,12,1,NYSE
4809,14-02-2021 00:00,24 hrs.,SPACs,JWS,838,13,825,-812,4,38,746,4,NYSE
4809,14-02-2021 00:00,24 hrs.,SPACs,NAV,753,716,37,679,6,250,229,6,NYSE
4809,14-02-2021 00:00,24 hrs.,SPACs,NGA,34,0,34,-34,1,5,20,1,NYSE
4809,14-02-2021 00:00,24 hrs.,SPACs,RBC,7,0,7,-7,1,1,1,1,NYSE
4809,14-02-2021 00:00,24 hrs.,SPACs,RMO,6,0,6,-6,1,1,0,1,NYSE
4809,14-02-2021 00:00,24 hrs.,SPACs,RTP,819,0,819,-819,1,36,743,1,NYSE
4809,14-02-2021 00:00,24 hrs.,SPACs,SBE,42,8,34,-26,2,6,22,2,NYSE
4809,14-02-2021 00:00,24 hrs.,SPACs,SOS,7,0,7,-7,1,1,1,1,NYSE
4809,14-02-2021 00:00,24 hrs.,SPACs,ACIC,825,0,825,-825,2,37,743,2,NYSE
4809,14-02-2021 00:00,24 hrs.,SPACs,AJAX,44,44,0,44,1,4,32,1,NYSE
4809,14-02-2021 00:00,24 hrs.,SPACs,AVAN,37,0,37,-37,1,9,15,1,NYSE
4809,14-02-2021 00:00,24 hrs.,SPACs,CCIV,1645,725,920,-195,11,303,995,10,NYSE
4809,14-02-2021 00:00,24 hrs.,SPACs,DNMR,62,55,7,48,2,19,16,2,NYSE
4809,14-02-2021 00:00,24 hrs.,SPACs,EMPW,819,0,819,-819,1,36,743,1,NYSE
4809,14-02-2021 00:00,24 hrs.,SPACs,ENPC,819,0,819,-819,1,36,743,1,NYSE
4809,14-02-2021 00:00,24 hrs.,SPACs,FGNA,1238,192,1046,-854,2,391,448,2,NYSE
4809,14-02-2021 00:00,24 hrs.,SPACs,FUSE,2107,192,1915,-1723,4,428,1235,4,NYSE
4809,14-02-2021 00:00,24 hrs.,SPACs,GSAH,1046,0,1046,-1046,1,333,376,1,NYSE
4809,14-02-2021 00:00,24 hrs.,SPACs,HYLN,34,0,34,-34,1,5,20,1,NYSE
4809,14-02-2021 00:00,24 hrs.,SPACs,IPOE,1046,0,1046,-1046,1,333,376,1,NYSE
4809,14-02-2021 00:00,24 hrs.,SPACs,IPOF,11,6,5,1,2,1,1,2,NYSE
4809,14-02-2021 00:00,24 hrs.,SPACs,LGVW,41,7,34,-27,2,6,21,2,NYSE
4809,14-02-2021 00:00,24 hrs.,SPACs,MPLN,46,46,0,46,1,17,8,1,NYSE
4809,14-02-2021 00:00,24 hrs.,SPACs,PCPL,192,192,0,192,1,58,72,1,NYSE
4809,14-02-2021 00:00,24 hrs.,SPACs,PSTH,664,657,7,650,9,228,172,8,NYSE
4809,14-02-2021 00:00,24 hrs.,SPACs,RBAC,19,19,0,19,1,4,7,1,NYSE
4809,14-02-2021 00:00,24 hrs.,SPACs,SKLZ,27,27,0,27,4,4,3,1,NYSE
4809,14-02-2021 00:00,24 hrs.,SPACs,SNPR,13,0,13,-13,2,2,1,2,NYSE
4809,14-02-2021 00:00,24 hrs.,SPACs,STPK,70,30,40,-10,6,10,26,4,NYSE
4809,14-02-2021 00:00,24 hrs.,SPACs,TPGY,34,0,34,-34,1,5,20,1,NYSE
4809,14-02-2021 00:00,24 hrs.,SPACs,VYGG,27,7,20,-13,4,4,3,2,NYSE
4809,14-02-2021 00:00,24 hrs.,SPACs,ADV,819,0,819,-819,1,36,743,1,NASDAQ
4809,14-02-2021 00:00,24 hrs.,wallstreetbets,GGTTF,20,20,0,20,3,3,2,2,OTC
4809,14-02-2021 00:00,24 hrs.,wallstreetbets,GTBIF,6,0,6,-6,1,1,0,1,OTC
4809,14-02-2021 00:00,24 hrs.,wallstreetbets,HITIF,63,13,50,-37,5,13,17,4,OTC
4809,14-02-2021 00:00,24 hrs.,wallstreetbets,HTZGQ,13,6,7,-1,2,2,1,2,OTC
4809,14-02-2021 00:00,24 hrs.,wallstreetbets,IMNPQ,7,7,0,7,1,1,1,1,OTC
4809,14-02-2021 00:00,24 hrs.,wallstreetbets,LKNCY,8,0,8,-8,1,1,2,1,OTC
4809,14-02-2021 00:00,24 hrs.,wallstreetbets,MMEDF,7,7,0,7,1,1,1,1,OTC
4809,14-02-2021 00:00,24 hrs.,wallstreetbets,NONOF,7,0,7,-7,1,1,1,1,OTC
4809,14-02-2021 00:00,24 hrs.,wallstreetbets,NXTTF,13,13,0,13,2,2,1,2,OTC
4809,14-02-2021 00:00,24 hrs.,wallstreetbets,RECAF,6,6,0,6,1,1,0,1,OTC
4809,14-02-2021 00:00,24 hrs.,wallstreetbets,RLLCF,6,6,0,6,1,1,0,1,OTC
4809,14-02-2021 00:00,24 hrs.,wallstreetbets,RWBYF,7,7,0,7,1,1,1,1,OTC
4809,14-02-2021 00:00,24 hrs.,wallstreetbets,RYCEY,552,13,539,-526,4,211,114,4,OTC
4809,14-02-2021 00:00,24 hrs.,wallstreetbets,SHRMF,6,0,6,-6,1,1,0,1,OTC
4809,14-02-2021 00:00,24 hrs.,wallstreetbets,TCNNF,6,0,6,-6,1,1,0,1,OTC
4809,14-02-2021 00:00,24 hrs.,wallstreetbets,TOWTF,12,12,0,12,2,2,0,1,OTC
4809,14-02-2021 00:00,24 hrs.,wallstreetbets,VLNCF,14,14,0,14,1,0,10,1,OTC
4809,14-02-2021 00:00,24 hrs.,wallstreetbets,VRYYF,7,7,0,7,1,1,1,1,OTC
4809,14-02-2021 00:00,24 hrs.,SPACs,ADOC,83,0,83,-83,1,23,33,1,NASDAQ
4809,14-02-2021 00:00,24 hrs.,SPACs,BHSE,83,0,83,-83,1,23,33,1,NASDAQ
4809,14-02-2021 00:00,24 hrs.,SPACs,BRPA,853,0,853,-853,2,41,763,2,NASDAQ
4809,14-02-2021 00:00,24 hrs.,SPACs,BTAQ,75,75,0,75,2,25,17,2,NASDAQ
4809,14-02-2021 00:00,24 hrs.,SPACs,CIIC,76,0,76,-76,2,20,28,1,NASDAQ
4809,14-02-2021 00:00,24 hrs.,SPACs,CMLF,853,0,853,-853,2,41,763,2,NASDAQ
4809,14-02-2021 00:00,24 hrs.,SPACs,DFHT,819,0,819,-819,1,36,743,1,NASDAQ
4809,14-02-2021 00:00,24 hrs.,SPACs,FCAC,819,0,819,-819,1,36,743,1,NASDAQ
4809,14-02-2021 00:00,24 hrs.,SPACs,FTOC,627,192,435,-243,3,229,157,3,NASDAQ
4809,14-02-2021 00:00,24 hrs.,SPACs,GHIV,291,291,0,291,2,87,109,2,NASDAQ
4809,14-02-2021 00:00,24 hrs.,SPACs,GRCY,83,0,83,-83,1,23,33,1,NASDAQ
4809,14-02-2021 00:00,24 hrs.,SPACs,MACU,83,0,83,-83,1,23,33,1,NASDAQ
4809,14-02-2021 00:00,24 hrs.,SPACs,NBAC,23,23,0,23,1,9,1,1,NASDAQ
4809,14-02-2021 00:00,24 hrs.,SPACs,NGAC,81,81,0,81,2,31,11,2,NASDAQ
4809,14-02-2021 00:00,24 hrs.,SPACs,NKLA,34,0,34,-34,1,5,20,1,NASDAQ
4809,14-02-2021 00:00,24 hrs.,SPACs,RIDE,34,0,34,-34,1,5,20,1,NASDAQ
4809,14-02-2021 00:00,24 hrs.,SPACs,ROCH,34,0,34,-34,1,5,20,1,NASDAQ
4809,14-02-2021 00:00,24 hrs.,SPACs,SSPK,34,0,34,-34,1,5,20,1,NASDAQ
4809,14-02-2021 00:00,24 hrs.,SPACs,THBR,819,0,819,-819,1,36,743,1,NASDAQ
4809,14-02-2021 00:00,24 hrs.,SPACs,THCB,917,64,853,-789,3,68,769,3,NASDAQ
4809,14-02-2021 00:00,24 hrs.,SPACs,VTIQ,34,0,34,-34,1,5,20,1,NASDAQ
4809,14-02-2021 00:00,24 hrs.,SPACs,AACQW,40,40,0,40,1,13,10,1,NASDAQ
4809,14-02-2021 00:00,24 hrs.,SPACs,CMLFW,819,0,819,-819,1,36,743,1,NASDAQ
4809,14-02-2021 00:00,24 hrs.,SPACs,DSACW,819,0,819,-819,1,36,743,1,NASDAQ
4809,14-02-2021 00:00,24 hrs.,SPACs,EXPCW,819,0,819,-819,1,36,743,1,NASDAQ
4809,14-02-2021 00:00,24 hrs.,SPACs,FCACW,819,0,819,-819,1,36,743,1,NASDAQ
4809,14-02-2021 00:00,24 hrs.,SPACs,SAIIW,819,0,819,-819,1,36,743,1,NASDAQ
4809,14-02-2021 00:00,24 hrs.,SPACs,TWCTW,819,0,819,-819,1,36,743,1,NASDAQ
4809,14-02-2021 00:00,24 hrs.,stocks,ABML,14,0,14,-14,1,1,8,1,OTC
4809,14-02-2021 00:00,24 hrs.,stocks,ENKS,6,6,0,6,1,1,0,1,OTC
4809,14-02-2021 00:00,24 hrs.,stocks,FRCH,14,0,14,-14,1,5,0,1,OTC
4809,14-02-2021 00:00,24 hrs.,stocks,HCMC,16,0,16,-16,1,1,10,1,OTC
4809,14-02-2021 00:00,24 hrs.,stocks,HEMP,36,0,36,-36,1,8,16,1,OTC
4809,14-02-2021 00:00,24 hrs.,stocks,IJJP,6,0,6,-6,1,1,0,1,OTC
4809,14-02-2021 00:00,24 hrs.,stocks,KYNC,6,6,0,6,1,1,0,1,OTC
4809,14-02-2021 00:00,24 hrs.,stocks,LINK,381,381,0,381,1,178,21,1,OTC
4809,14-02-2021 00:00,24 hrs.,stocks,LQMT,17,17,0,17,1,5,3,1,OTC
4809,14-02-2021 00:00,24 hrs.,stocks,LTNC,6,6,0,6,1,1,0,1,OTC
4809,14-02-2021 00:00,24 hrs.,stocks,MINE,18,18,0,18,3,3,0,1,OTC
4809,14-02-2021 00:00,24 hrs.,stocks,MOST,381,381,0,381,1,178,21,1,OTC
4809,14-02-2021 00:00,24 hrs.,stocks,NMTC,55,55,0,55,1,22,7,1,OTC
4809,14-02-2021 00:00,24 hrs.,stocks,SAGD,17,17,0,17,1,2,9,1,OTC
4809,14-02-2021 00:00,24 hrs.,stocks,SGMD,12,12,0,12,2,2,0,1,OTC
4809,14-02-2021 00:00,24 hrs.,stocks,SOBR,6,0,6,-6,1,1,0,1,OTC
4809,14-02-2021 00:00,24 hrs.,stocks,TRUL,6,6,0,6,1,1,0,1,OTC
4809,14-02-2021 00:00,24 hrs.,stocks,XFLS,4,0,4,-4,1,0,0,1,OTC
4809,14-02-2021 00:00,24 hrs.,wallstreetbets,APT,7,7,0,7,1,1,1,1,AMEX
4809,14-02-2021 00:00,24 hrs.,wallstreetbets,DNN,62,7,55,-48,9,9,8,7,AMEX
4809,14-02-2021 00:00,24 hrs.,wallstreetbets,GTE,13,0,13,-13,2,2,1,2,AMEX
4809,14-02-2021 00:00,24 hrs.,wallstreetbets,MCF,7,7,0,7,1,1,1,1,AMEX
4809,14-02-2021 00:00,24 hrs.,wallstreetbets,MXC,7,7,0,7,1,1,1,1,AMEX
4809,14-02-2021 00:00,24 hrs.,wallstreetbets,NBY,6,6,0,6,1,1,0,1,AMEX
4809,14-02-2021 00:00,24 hrs.,wallstreetbets,REI,6,6,0,6,1,1,0,1,AMEX
4809,14-02-2021 00:00,24 hrs.,wallstreetbets,TRX,26,19,7,12,4,4,2,4,AMEX
4809,14-02-2021 00:00,24 hrs.,wallstreetbets,ZOM,53,20,33,-13,8,8,5,8,AMEX
4809,14-02-2021 00:00,24 hrs.,wallstreetbets,GOED,6,6,0,6,1,1,0,1,AMEX
4809,14-02-2021 00:00,24 hrs.,wallstreetbets,GSAT,7,0,7,-7,1,1,1,1,AMEX
4809,14-02-2021 00:00,24 hrs.,wallstreetbets,IBIO,14,14,0,14,2,2,2,2,AMEX
4809,14-02-2021 00:00,24 hrs.,wallstreetbets,SENS,367,6,361,-355,7,117,105,5,AMEX
4809,14-02-2021 00:00,24 hrs.,wallstreetbets,TRXC,20,20,0,20,3,3,2,1,AMEX
4809,14-02-2021 00:00,24 hrs.,wallstreetbets,UAVS,20,7,13,-6,3,3,2,2,AMEX
4809,14-02-2021 00:00,24 hrs.,wallstreetbets,XXII,7,0,7,-7,1,1,1,1,AMEX
4809,14-02-2021 00:00,24 hrs.,wallstreetbets,YCBD,7,0,7,-7,1,1,1,1,AMEX
4809,14-02-2021 00:00,24 hrs.,wallstreetbets,AAP,1040,1040,0,1040,2,475,82,2,NYSE
4809,14-02-2021 00:00,24 hrs.,wallstreetbets,ACB,42,14,28,-14,6,6,6,6,NYSE
4809,14-02-2021 00:00,24 hrs.,wallstreetbets,AIN,7,7,0,7,1,1,1,1,NYSE
4809,14-02-2021 00:00,24 hrs.,wallstreetbets,AMC,3460,434,3026,-2592,87,1265,582,72,NYSE
4809,14-02-2021 00:00,24 hrs.,wallstreetbets,ATH,249,236,13,223,4,76,81,4,NYSE
4809,14-02-2021 00:00,24 hrs.,wallstreetbets,AYX,33,33,0,33,1,9,11,1,NYSE
4809,14-02-2021 00:00,24 hrs.,wallstreetbets,BBY,2067,2067,0,2067,1,915,233,1,NYSE
4809,14-02-2021 00:00,24 hrs.,wallstreetbets,BCH,10,6,4,2,2,1,0,2,NYSE
4809,14-02-2021 00:00,24 hrs.,wallstreetbets,BHC,7,7,0,7,1,1,1,1,NYSE
4809,14-02-2021 00:00,24 hrs.,wallstreetbets,BOX,6,6,0,6,1,1,0,1,NYSE
4809,14-02-2021 00:00,24 hrs.,wallstreetbets,BTT,14,7,7,0,2,2,2,2,NYSE
4809,14-02-2021 00:00,24 hrs.,wallstreetbets,BYD,141,134,7,127,2,50,33,2,NYSE
4809,14-02-2021 00:00,24 hrs.,wallstreetbets,CAT,7,0,7,-7,1,1,1,1,NYSE
4809,14-02-2021 00:00,24 hrs.,wallstreetbets,CBD,6,6,0,6,1,1,0,1,NYSE
4809,14-02-2021 00:00,24 hrs.,wallstreetbets,CCL,2080,2074,6,2068,3,917,234,3,NYSE
4809,14-02-2021 00:00,24 hrs.,wallstreetbets,CMA,6,0,6,-6,1,1,0,1,NYSE
4809,14-02-2021 00:00,24 hrs.,wallstreetbets,CNC,7,7,0,7,1,1,1,1,NYSE
4809,14-02-2021 00:00,24 hrs.,wallstreetbets,COO,6,6,0,6,1,1,0,1,NYSE
4809,14-02-2021 00:00,24 hrs.,wallstreetbets,CPS,6,0,6,-6,1,1,0,1,NYSE
4809,14-02-2021 00:00,24 hrs.,wallstreetbets,CSV,250,0,250,-250,1,71,104,1,NYSE
4809,14-02-2021 00:00,24 hrs.,wallstreetbets,CVS,1047,1040,7,1033,3,476,83,3,NYSE
4809,14-02-2021 00:00,24 hrs.,wallstreetbets,DDD,906,906,0,906,1,426,50,1,NYSE
4809,14-02-2021 00:00,24 hrs.,wallstreetbets,DDS,906,906,0,906,1,426,50,1,NYSE
4809,14-02-2021 00:00,24 hrs.,wallstreetbets,DOW,2067,2067,0,2067,1,915,233,1,NYSE
4809,14-02-2021 00:00,24 hrs.,wallstreetbets,EAT,13,13,0,13,2,2,1,2,NYSE
4809,14-02-2021 00:00,24 hrs.,wallstreetbets,EGO,30,30,0,30,1,7,12,1,NYSE
4809,14-02-2021 00:00,24 hrs.,wallstreetbets,EOS,7,7,0,7,1,1,1,1,NYSE
4809,14-02-2021 00:00,24 hrs.,wallstreetbets,EOT,7,7,0,7,1,1,1,1,NYSE
4809,14-02-2021 00:00,24 hrs.,wallstreetbets,ETN,14,7,7,0,2,2,2,2,NYSE
4809,14-02-2021 00:00,24 hrs.,wallstreetbets,FCX,321,321,0,321,1,117,83,1,NYSE
4809,14-02-2021 00:00,24 hrs.,wallstreetbets,FSR,2086,2086,0,2086,4,918,234,4,NYSE
4809,14-02-2021 00:00,24 hrs.,wallstreetbets,FUN,7,0,7,-7,1,1,1,1,NYSE
4809,14-02-2021 00:00,24 hrs.,wallstreetbets,GEO,7,7,0,7,1,1,1,1,NYSE
4809,14-02-2021 00:00,24 hrs.,wallstreetbets,WHEN,14,7,7,0,2,2,2,2,OTC
4809,14-02-2021 00:00,24 hrs.,wallstreetbets,XFLS,4,0,4,-4,1,0,0,1,OTC
4809,14-02-2021 00:00,24 hrs.,wallstreetbets,AGFAF,7,7,0,7,1,1,1,1,OTC
4809,14-02-2021 00:00,24 hrs.,wallstreetbets,ARBKF,7,7,0,7,1,1,1,1,OTC
4809,14-02-2021 00:00,24 hrs.,wallstreetbets,BABYF,7,7,0,7,1,1,1,1,OTC
4809,14-02-2021 00:00,24 hrs.,wallstreetbets,BDRBF,7,7,0,7,1,1,1,1,OTC
4809,14-02-2021 00:00,24 hrs.,wallstreetbets,CNPOF,7,0,7,-7,1,1,1,1,OTC
4809,14-02-2021 00:00,24 hrs.,wallstreetbets,CNTRF,7,7,0,7,1,1,1,1,OTC
4809,14-02-2021 00:00,24 hrs.,wallstreetbets,CRLBF,6,0,6,-6,1,1,0,1,OTC
4809,14-02-2021 00:00,24 hrs.,wallstreetbets,CURLF,6,0,6,-6,1,1,0,1,OTC
4809,14-02-2021 00:00,24 hrs.,wallstreetbets,CXRXF,7,7,0,7,1,1,1,1,OTC
4809,14-02-2021 00:00,24 hrs.,wallstreetbets,DIGAF,6,6,0,6,1,1,0,1,OTC
4809,14-02-2021 00:00,24 hrs.,wallstreetbets,FUNFF,7,0,7,-7,1,1,1,1,OTC
4809,14-02-2021 00:00,24 hrs.,wallstreetbets,GAYMF,13,6,7,-1,2,2,1,2,OTC
4809,14-02-2021 00:00,24 hrs.,wallstreetbets,NVO,6,0,6,-6,1,1,0,1,NYSE
4809,14-02-2021 00:00,24 hrs.,wallstreetbets,NYC,7,0,7,-7,1,1,1,1,NYSE
4809,14-02-2021 00:00,24 hrs.,wallstreetbets,OSK,121,121,0,121,1,28,61,1,NYSE
4809,14-02-2021 00:00,24 hrs.,wallstreetbets,OXY,134,134,0,134,1,49,32,1,NYSE
4809,14-02-2021 00:00,24 hrs.,wallstreetbets,PCG,532,0,532,-532,1,208,112,1,NYSE
4809,14-02-2021 00:00,24 hrs.,wallstreetbets,PEI,8,8,0,8,1,1,2,1,NYSE
4809,14-02-2021 00:00,24 hrs.,wallstreetbets,PHT,7,0,7,-7,1,1,1,1,NYSE
4809,14-02-2021 00:00,24 hrs.,wallstreetbets,PSA,21,0,21,-21,3,3,3,2,NYSE
4809,14-02-2021 00:00,24 hrs.,wallstreetbets,PSN,7,0,7,-7,1,1,1,1,NYSE
4809,14-02-2021 00:00,24 hrs.,wallstreetbets,PWR,6,0,6,-6,1,1,0,1,NYSE
4809,14-02-2021 00:00,24 hrs.,wallstreetbets,PXD,134,134,0,134,1,49,32,1,NYSE
4809,14-02-2021 00:00,24 hrs.,wallstreetbets,RAD,7,0,7,-7,1,1,1,1,NYSE
4809,14-02-2021 00:00,24 hrs.,wallstreetbets,RCL,7,7,0,7,1,1,1,1,NYSE
4809,14-02-2021 00:00,24 hrs.,wallstreetbets,RKT,74,55,19,36,7,6,34,6,NYSE
4809,14-02-2021 00:00,24 hrs.,wallstreetbets,RNG,134,134,0,134,1,49,32,1,NYSE
4809,14-02-2021 00:00,24 hrs.,wallstreetbets,RSI,277,277,0,277,1,70,133,1,NYSE
4809,14-02-2021 00:00,24 hrs.,wallstreetbets,SAM,134,134,0,134,1,49,32,1,NYSE
4809,14-02-2021 00:00,24 hrs.,wallstreetbets,SAP,151,151,0,151,1,58,31,1,NYSE
4809,14-02-2021 00:00,24 hrs.,wallstreetbets,SBE,7,7,0,7,1,1,1,1,NYSE
4809,14-02-2021 00:00,24 hrs.,wallstreetbets,SJM,206,0,206,-206,2,72,54,2,NYSE
4809,14-02-2021 00:00,24 hrs.,wallstreetbets,SKT,906,906,0,906,1,426,50,1,NYSE
4809,14-02-2021 00:00,24 hrs.,wallstreetbets,SOS,204,155,49,106,20,39,46,12,NYSE
4809,14-02-2021 00:00,24 hrs.,wallstreetbets,TDA,22,22,0,22,1,3,12,1,NYSE
4809,14-02-2021 00:00,24 hrs.,wallstreetbets,TDC,26,0,26,-26,1,3,16,1,NYSE
4809,14-02-2021 00:00,24 hrs.,wallstreetbets,THC,6,6,0,6,1,1,0,1,NYSE
4809,14-02-2021 00:00,24 hrs.,wallstreetbets,THO,23,23,0,23,1,0,19,1,NYSE
4809,14-02-2021 00:00,24 hrs.,wallstreetbets,TRQ,7,0,7,-7,1,1,1,1,NYSE
4809,14-02-2021 00:00,24 hrs.,wallstreetbets,TRU,134,134,0,134,1,49,32,1,NYSE
4809,14-02-2021 00:00,24 hrs.,wallstreetbets,UBS,70,70,0,70,2,18,26,1,NYSE
4809,14-02-2021 00:00,24 hrs.,wallstreetbets,VET,7,7,0,7,1,1,1,1,NYSE
4809,14-02-2021 00:00,24 hrs.,wallstreetbets,VHC,7,7,0,7,1,1,1,1,NYSE
4809,14-02-2021 00:00,24 hrs.,wallstreetbets,WMT,1040,1040,0,1040,2,475,82,2,NYSE
4809,14-02-2021 00:00,24 hrs.,wallstreetbets,WST,134,134,0,134,1,49,32,1,NYSE
4809,14-02-2021 00:00,24 hrs.,wallstreetbets,XOM,321,321,0,321,1,117,83,1,NYSE
4809,14-02-2021 00:00,24 hrs.,wallstreetbets,YPF,7,7,0,7,1,1,1,1,NYSE
4809,14-02-2021 00:00,24 hrs.,wallstreetbets,ZTS,134,134,0,134,1,49,32,1,NYSE
4809,14-02-2021 00:00,24 hrs.,wallstreetbets,ABBV,7,0,7,-7,1,1,1,1,NYSE
4809,14-02-2021 00:00,24 hrs.,wallstreetbets,ACIC,7,0,7,-7,1,1,1,1,NYSE
4809,14-02-2021 00:00,24 hrs.,wallstreetbets,ALLY,7,0,7,-7,1,1,1,1,NYSE
4809,14-02-2021 00:00,24 hrs.,wallstreetbets,CCIV,91,63,28,35,13,13,13,11,NYSE
4809,14-02-2021 00:00,24 hrs.,wallstreetbets,COTY,187,187,0,187,1,67,49,1,NYSE
4809,14-02-2021 00:00,24 hrs.,wallstreetbets,DASH,53,46,7,39,8,8,5,7,NYSE
4809,14-02-2021 00:00,24 hrs.,wallstreetbets,EXPR,7,7,0,7,1,1,1,1,NYSE
4809,14-02-2021 00:00,24 hrs.,wallstreetbets,FSLY,3136,3136,0,3136,4,1396,328,4,NYSE
4809,14-02-2021 00:00,24 hrs.,wallstreetbets,FUBO,2074,2067,7,2060,2,916,234,2,NYSE
4809,14-02-2021 00:00,24 hrs.,wallstreetbets,FVRR,1040,1040,0,1040,2,475,82,2,NYSE
4809,14-02-2021 00:00,24 hrs.,wallstreetbets,GNRC,12,6,6,0,2,2,0,2,NYSE
4809,14-02-2021 00:00,24 hrs.,wallstreetbets,HEXO,14,0,14,-14,2,2,2,2,NYSE
4809,14-02-2021 00:00,24 hrs.,wallstreetbets,GME,71010,25747,45263,-19516,266,32152,5642,197,NYSE
4809,14-02-2021 00:00,24 hrs.,wallstreetbets,GNT,14,0,14,-14,2,2,2,1,NYSE
4809,14-02-2021 00:00,24 hrs.,wallstreetbets,GNW,6,6,0,6,1,1,0,1,NYSE
4809,14-02-2021 00:00,24 hrs.,wallstreetbets,GSX,7,7,0,7,1,1,1,1,NYSE
4809,14-02-2021 00:00,24 hrs.,wallstreetbets,HMI,21,21,0,21,3,3,3,1,NYSE
4809,14-02-2021 00:00,24 hrs.,wallstreetbets,HSY,8,0,8,-8,1,1,2,1,NYSE
4809,14-02-2021 00:00,24 hrs.,wallstreetbets,IBM,1819,151,1668,-1517,5,814,171,5,NYSE
4809,14-02-2021 00:00,24 hrs.,wallstreetbets,ICE,181,0,181,-181,1,56,65,1,NYSE
4809,14-02-2021 00:00,24 hrs.,wallstreetbets,IGT,906,906,0,906,1,426,50,1,NYSE
4809,14-02-2021 00:00,24 hrs.,wallstreetbets,IRS,6,0,6,-6,1,1,0,1,NYSE
4809,14-02-2021 00:00,24 hrs.,wallstreetbets,JNJ,6,0,6,-6,1,1,0,1,NYSE
4809,14-02-2021 00:00,24 hrs.,wallstreetbets,KOS,19,19,0,19,1,5,5,1,NYSE
4809,14-02-2021 00:00,24 hrs.,wallstreetbets,LEE,6,0,6,-6,1,1,0,1,NYSE
4809,14-02-2021 00:00,24 hrs.,wallstreetbets,VYGVF,6,0,6,-6,1,1,0,1,OTC
4809,14-02-2021 00:00,24 hrs.,wallstreetbets,XJNGF,6,6,0,6,1,1,0,1,OTC
4809,14-02-2021 00:00,24 hrs.,wallstreetbets,ZBISF,7,0,7,-7,1,1,1,1,OTC
4809,14-02-2021 00:00,24 hrs.,wallstreetbets,FVE,151,151,0,151,1,58,31,1,NASDAQ
4809,14-02-2021 00:00,24 hrs.,wallstreetbets,GSM,6,0,6,-6,1,1,0,1,NASDAQ
4809,14-02-2021 00:00,24 hrs.,wallstreetbets,HAS,26,20,6,14,4,4,2,4,NASDAQ
4809,14-02-2021 00:00,24 hrs.,wallstreetbets,HOL,6,6,0,6,1,1,0,1,NASDAQ
4809,14-02-2021 00:00,24 hrs.,wallstreetbets,III,14,14,0,14,2,2,2,2,NASDAQ
4809,14-02-2021 00:00,24 hrs.,wallstreetbets,INO,95,50,45,5,3,14,55,3,NASDAQ
4809,14-02-2021 00:00,24 hrs.,wallstreetbets,JAN,6,6,0,6,1,1,0,1,NASDAQ
4809,14-02-2021 00:00,24 hrs.,wallstreetbets,JFU,6,0,6,-6,1,1,0,1,NASDAQ
4809,14-02-2021 00:00,24 hrs.,wallstreetbets,KHC,7,0,7,-7,1,1,1,1,NASDAQ
4809,14-02-2021 00:00,24 hrs.,wallstreetbets,KIN,14,14,0,14,2,2,2,1,NASDAQ
4809,14-02-2021 00:00,24 hrs.,wallstreetbets,MKD,13,0,13,-13,2,2,1,2,NASDAQ
4809,14-02-2021 00:00,24 hrs.,wallstreetbets,MYT,7,0,7,-7,1,1,1,1,NASDAQ
4809,14-02-2021 00:00,24 hrs.,wallstreetbets,NEO,6,6,0,6,1,1,0,1,NASDAQ
4809,14-02-2021 00:00,24 hrs.,wallstreetbets,OGI,41,27,14,13,6,6,5,5,NASDAQ
4809,14-02-2021 00:00,24 hrs.,wallstreetbets,PDD,7,0,7,-7,1,1,1,1,NASDAQ
4809,14-02-2021 00:00,24 hrs.,wallstreetbets,QQQ,6,0,6,-6,1,1,0,1,NASDAQ
4809,14-02-2021 00:00,24 hrs.,wallstreetbets,RNA,43,43,0,43,1,9,21,1,NASDAQ
4809,14-02-2021 00:00,24 hrs.,wallstreetbets,RUN,7,0,7,-7,1,1,1,1,NASDAQ
4809,14-02-2021 00:00,24 hrs.,wallstreetbets,SLP,13,6,7,-1,2,2,1,2,NASDAQ
4809,14-02-2021 00:00,24 hrs.,wallstreetbets,SND,7,0,7,-7,1,1,1,1,NASDAQ
4809,14-02-2021 00:00,24 hrs.,wallstreetbets,TTD,134,134,0,134,1,49,32,1,NASDAQ
4809,14-02-2021 00:00,24 hrs.,wallstreetbets,WIX,134,134,0,134,1,49,32,1,NASDAQ
4809,14-02-2021 00:00,24 hrs.,wallstreetbets,WNW,17,0,17,-17,2,2,5,1,NASDAQ
4809,14-02-2021 00:00,24 hrs.,wallstreetbets,AACQ,7,7,0,7,1,1,1,1,NASDAQ
4809,14-02-2021 00:00,24 hrs.,wallstreetbets,AAPL,2086,2080,6,2074,4,918,234,4,NASDAQ
4809,14-02-2021 00:00,24 hrs.,wallstreetbets,ABCL,7,0,7,-7,1,1,1,1,NASDAQ
4809,14-02-2021 00:00,24 hrs.,wallstreetbets,ABNB,6,0,6,-6,1,1,0,1,NASDAQ
4809,14-02-2021 00:00,24 hrs.,wallstreetbets,ACOR,7,0,7,-7,1,1,1,1,NASDAQ
4809,14-02-2021 00:00,24 hrs.,wallstreetbets,ADXS,7,7,0,7,1,1,1,1,NASDAQ
4809,14-02-2021 00:00,24 hrs.,wallstreetbets,AKAM,43,43,0,43,3,8,15,2,NASDAQ
4809,14-02-2021 00:00,24 hrs.,wallstreetbets,AKBA,7,7,0,7,1,1,1,1,NASDAQ
4809,14-02-2021 00:00,24 hrs.,wallstreetbets,ALNA,7,7,0,7,1,1,1,1,NASDAQ
4809,14-02-2021 00:00,24 hrs.,wallstreetbets,AMAT,269,269,0,269,2,94,73,2,NASDAQ
4809,14-02-2021 00:00,24 hrs.,wallstreetbets,AMZN,7,7,0,7,1,1,1,1,NASDAQ
4809,14-02-2021 00:00,24 hrs.,wallstreetbets,ANTE,7,0,7,-7,1,1,1,1,NASDAQ
4809,14-02-2021 00:00,24 hrs.,wallstreetbets,APHA,1626,95,1531,-1436,18,634,286,9,NASDAQ
4809,14-02-2021 00:00,24 hrs.,wallstreetbets,APPN,134,134,0,134,1,49,32,1,NASDAQ
4809,14-02-2021 00:00,24 hrs.,wallstreetbets,APPS,13,6,7,-1,2,2,1,2,NASDAQ
4809,14-02-2021 00:00,24 hrs.,wallstreetbets,ASRT,14,7,7,0,2,2,2,2,NASDAQ
4809,14-02-2021 00:00,24 hrs.,wallstreetbets,ASTC,7,0,7,-7,1,1,1,1,NASDAQ
4809,14-02-2021 00:00,24 hrs.,wallstreetbets,HUYA,7,0,7,-7,1,1,1,1,NYSE
4809,14-02-2021 00:00,24 hrs.,wallstreetbets,HYLN,7,7,0,7,1,1,1,1,NYSE
4809,14-02-2021 00:00,24 hrs.,wallstreetbets,LEAP,6,0,6,-6,1,1,0,1,NYSE
4809,14-02-2021 00:00,24 hrs.,wallstreetbets,LGVW,14,0,14,-14,2,2,2,1,NYSE
4809,14-02-2021 00:00,24 hrs.,wallstreetbets,MAIN,6,0,6,-6,1,1,0,1,NYSE
4809,14-02-2021 00:00,24 hrs.,wallstreetbets,MITT,7,7,0,7,1,1,1,1,NYSE
4809,14-02-2021 00:00,24 hrs.,wallstreetbets,NOVA,7,7,0,7,1,1,1,1,NYSE
4809,14-02-2021 00:00,24 hrs.,wallstreetbets,NVTA,134,134,0,134,1,49,32,1,NYSE
4809,14-02-2021 00:00,24 hrs.,wallstreetbets,LOW,7,7,0,7,1,1,1,1,NYSE
4809,14-02-2021 00:00,24 hrs.,wallstreetbets,LPL,906,906,0,906,1,426,50,1,NYSE
4809,14-02-2021 00:00,24 hrs.,wallstreetbets,LTC,28,21,7,14,4,4,4,4,NYSE
4809,14-02-2021 00:00,24 hrs.,wallstreetbets,LZB,134,134,0,134,1,49,32,1,NYSE
4809,14-02-2021 00:00,24 hrs.,wallstreetbets,MFA,7,7,0,7,1,1,1,1,NYSE
4809,14-02-2021 00:00,24 hrs.,wallstreetbets,MOS,134,134,0,134,1,49,32,1,NYSE
4809,14-02-2021 00:00,24 hrs.,wallstreetbets,MRO,72,72,0,72,3,2,56,1,NYSE
4809,14-02-2021 00:00,24 hrs.,wallstreetbets,MTD,906,906,0,906,1,426,50,1,NYSE
4809,14-02-2021 00:00,24 hrs.,wallstreetbets,NET,2380,2380,0,2380,3,1020,328,3,NYSE
4809,14-02-2021 00:00,24 hrs.,wallstreetbets,NGL,7,7,0,7,1,1,1,1,NYSE
4809,14-02-2021 00:00,24 hrs.,wallstreetbets,NIO,2095,2087,8,2079,5,919,237,4,NYSE
4809,14-02-2021 00:00,24 hrs.,wallstreetbets,NKE,6,6,0,6,1,1,0,1,NYSE
4809,14-02-2021 00:00,24 hrs.,wallstreetbets,NMR,20,13,7,6,3,3,2,3,NYSE
4809,14-02-2021 00:00,24 hrs.,wallstreetbets,NOK,606,53,553,-500,10,221,124,8,NYSE
4809,14-02-2021 00:00,24 hrs.,wallstreetbets,NSA,1649,0,1649,-1649,1,753,139,1,NYSE
4809,14-02-2021 00:00,24 hrs.,wallstreetbets,NTR,134,134,0,134,1,49,32,1,NYSE
4809,14-02-2021 00:00,24 hrs.,wallstreetbets,GTEC,6,6,0,6,1,1,0,1,NASDAQ
4809,14-02-2021 00:00,24 hrs.,wallstreetbets,GTHX,160,147,13,134,3,48,52,3,NASDAQ
4809,14-02-2021 00:00,24 hrs.,wallstreetbets,HEAR,7,0,7,-7,1,1,1,1,NASDAQ
4809,14-02-2021 00:00,24 hrs.,wallstreetbets,HZNP,7,0,7,-7,1,1,1,1,NASDAQ
4809,14-02-2021 00:00,24 hrs.,wallstreetbets,IBEX,7,7,0,7,1,1,1,1,NASDAQ
4809,14-02-2021 00:00,24 hrs.,wallstreetbets,IDEX,7,7,0,7,1,1,1,1,NASDAQ
4809,14-02-2021 00:00,24 hrs.,wallstreetbets,IFMK,7,0,7,-7,1,1,1,1,NASDAQ
4809,14-02-2021 00:00,24 hrs.,wallstreetbets,INPX,7,0,7,-7,1,1,1,1,NASDAQ
4809,14-02-2021 00:00,24 hrs.,wallstreetbets,INSG,6,0,6,-6,1,1,0,1,NASDAQ
4809,14-02-2021 00:00,24 hrs.,wallstreetbets,INTC,404,384,20,364,7,96,184,6,NASDAQ
4809,14-02-2021 00:00,24 hrs.,wallstreetbets,IRBT,6,0,6,-6,1,1,0,1,NASDAQ
4809,14-02-2021 00:00,24 hrs.,wallstreetbets,ITRM,7,0,7,-7,1,1,1,1,NASDAQ
4809,14-02-2021 00:00,24 hrs.,wallstreetbets,JAGX,20,7,13,-6,3,3,2,2,NASDAQ
4809,14-02-2021 00:00,24 hrs.,wallstreetbets,JNCE,6,0,6,-6,1,1,0,1,NASDAQ
4809,14-02-2021 00:00,24 hrs.,wallstreetbets,KOPN,6,6,0,6,1,1,0,1,NASDAQ
4809,14-02-2021 00:00,24 hrs.,wallstreetbets,KOSS,14,7,7,0,2,2,2,2,NASDAQ
4809,14-02-2021 00:00,24 hrs.,wallstreetbets,LIFE,20,7,13,-6,3,3,2,3,NASDAQ
4809,14-02-2021 00:00,24 hrs.,wallstreetbets,LKCO,6,6,0,6,1,1,0,1,NASDAQ
4809,14-02-2021 00:00,24 hrs.,wallstreetbets,LSCC,134,134,0,134,1,49,32,1,NASDAQ
4809,14-02-2021 00:00,24 hrs.,wallstreetbets,LXRX,14,7,7,0,2,2,2,2,NASDAQ
4809,14-02-2021 00:00,24 hrs.,wallstreetbets,MARA,29,15,14,1,4,4,5,4,NASDAQ
4809,14-02-2021 00:00,24 hrs.,wallstreetbets,ATNF,6,6,0,6,1,1,0,1,NASDAQ
4809,14-02-2021 00:00,24 hrs.,wallstreetbets,ATOS,7,0,7,-7,1,1,1,1,NASDAQ
4809,14-02-2021 00:00,24 hrs.,wallstreetbets,ATVI,32,0,32,-32,1,0,28,1,NASDAQ
4809,14-02-2021 00:00,24 hrs.,wallstreetbets,AZRX,7,7,0,7,1,1,1,1,NASDAQ
4809,14-02-2021 00:00,24 hrs.,wallstreetbets,BBBY,2067,2067,0,2067,1,915,233,1,NASDAQ
4809,14-02-2021 00:00,24 hrs.,wallstreetbets,BEAT,31,31,0,31,1,0,27,1,NASDAQ
4809,14-02-2021 00:00,24 hrs.,wallstreetbets,BHTG,7,7,0,7,1,1,1,1,NASDAQ
4809,14-02-2021 00:00,24 hrs.,wallstreetbets,BIDU,134,134,0,134,1,49,32,1,NASDAQ
4809,14-02-2021 00:00,24 hrs.,wallstreetbets,BIGC,906,906,0,906,1,426,50,1,NASDAQ
4809,14-02-2021 00:00,24 hrs.,wallstreetbets,BLDP,7,7,0,7,1,1,1,1,NASDAQ
4809,14-02-2021 00:00,24 hrs.,wallstreetbets,BLMN,134,134,0,134,1,49,32,1,NASDAQ
4809,14-02-2021 00:00,24 hrs.,wallstreetbets,BLPH,6,6,0,6,1,1,0,1,NASDAQ
4809,14-02-2021 00:00,24 hrs.,wallstreetbets,BLRX,6,6,0,6,1,1,0,1,NASDAQ
4809,14-02-2021 00:00,24 hrs.,wallstreetbets,BNGO,340,48,292,-244,9,123,58,8,NASDAQ
4809,14-02-2021 00:00,24 hrs.,wallstreetbets,BSQR,7,7,0,7,1,1,1,1,NASDAQ
4809,14-02-2021 00:00,24 hrs.,wallstreetbets,BWEN,7,0,7,-7,1,1,1,1,NASDAQ
4809,14-02-2021 00:00,24 hrs.,wallstreetbets,CCRC,8,8,0,8,1,2,0,1,NASDAQ
4809,14-02-2021 00:00,24 hrs.,wallstreetbets,CGIX,6,6,0,6,1,1,0,1,NASDAQ
4809,14-02-2021 00:00,24 hrs.,wallstreetbets,CIDM,6,6,0,6,1,1,0,1,NASDAQ
4809,14-02-2021 00:00,24 hrs.,wallstreetbets,CLBS,14,7,7,0,2,2,2,2,NASDAQ
4809,14-02-2021 00:00,24 hrs.,wallstreetbets,CLEU,14,14,0,14,2,2,2,2,NASDAQ
4809,14-02-2021 00:00,24 hrs.,wallstreetbets,PLTR,4096,3180,916,2264,23,1757,490,18,NYSE
4809,14-02-2021 00:00,24 hrs.,wallstreetbets,PRTY,15,15,0,15,2,3,1,1,NYSE
4809,14-02-2021 00:00,24 hrs.,wallstreetbets,PSTH,237,0,237,-237,3,76,73,2,NYSE
4809,14-02-2021 00:00,24 hrs.,wallstreetbets,PUMP,54,54,0,54,2,0,46,1,NYSE
4809,14-02-2021 00:00,24 hrs.,wallstreetbets,SAFE,9,0,9,-9,1,2,1,1,NYSE
4809,14-02-2021 00:00,24 hrs.,wallstreetbets,SHOP,1040,1040,0,1040,2,475,82,2,NYSE
4809,14-02-2021 00:00,24 hrs.,wallstreetbets,SPCE,34,0,34,-34,5,5,4,5,NYSE
4809,14-02-2021 00:00,24 hrs.,wallstreetbets,STPK,13,7,6,1,2,2,1,2,NYSE
4809,14-02-2021 00:00,24 hrs.,wallstreetbets,TECK,134,134,0,134,1,49,32,1,NYSE
4809,14-02-2021 00:00,24 hrs.,wallstreetbets,TWLO,1040,1040,0,1040,2,475,82,2,NYSE
4809,14-02-2021 00:00,24 hrs.,wallstreetbets,TWTR,2067,2067,0,2067,1,915,233,1,NYSE
4809,14-02-2021 00:00,24 hrs.,wallstreetbets,UBER,14,14,0,14,2,2,2,2,NYSE
4809,14-02-2021 00:00,24 hrs.,wallstreetbets,VSTO,7,0,7,-7,1,1,1,1,NYSE
4809,14-02-2021 00:00,24 hrs.,wallstreetbets,AAL,8,8,0,8,1,1,2,1,NASDAQ
4809,14-02-2021 00:00,24 hrs.,wallstreetbets,AMD,625,140,485,-345,7,180,237,6,NASDAQ
4809,14-02-2021 00:00,24 hrs.,wallstreetbets,API,7,0,7,-7,1,1,1,1,NASDAQ
4809,14-02-2021 00:00,24 hrs.,wallstreetbets,AQB,7,0,7,-7,1,1,1,1,NASDAQ
4809,14-02-2021 00:00,24 hrs.,wallstreetbets,BLI,906,906,0,906,1,426,50,1,NASDAQ
4809,14-02-2021 00:00,24 hrs.,wallstreetbets,CEY,24,24,0,24,3,3,6,1,NASDAQ
4809,14-02-2021 00:00,24 hrs.,wallstreetbets,CFO,35,29,6,23,2,7,13,2,NASDAQ
4809,14-02-2021 00:00,24 hrs.,wallstreetbets,CGC,14,7,7,0,2,2,2,2,NASDAQ
4809,14-02-2021 00:00,24 hrs.,wallstreetbets,DBX,134,134,0,134,1,49,32,1,NASDAQ
4809,14-02-2021 00:00,24 hrs.,wallstreetbets,TRVG,19,19,0,19,3,3,1,3,NASDAQ
4809,14-02-2021 00:00,24 hrs.,wallstreetbets,TSLA,4249,3007,1242,1765,16,1563,1059,14,NASDAQ
4809,14-02-2021 00:00,24 hrs.,wallstreetbets,MBRX,7,0,7,-7,1,1,1,1,NASDAQ
4809,14-02-2021 00:00,24 hrs.,wallstreetbets,MESO,91,7,84,-77,2,27,29,2,NASDAQ
4809,14-02-2021 00:00,24 hrs.,wallstreetbets,MOGO,7,0,7,-7,1,1,1,1,NASDAQ
4809,14-02-2021 00:00,24 hrs.,wallstreetbets,MRKR,6,0,6,-6,1,1,0,1,NASDAQ
4809,14-02-2021 00:00,24 hrs.,wallstreetbets,MVIS,113,113,0,113,5,4,85,3,NASDAQ
4809,14-02-2021 00:00,24 hrs.,wallstreetbets,NAKD,50,14,36,-22,7,7,8,6,NASDAQ
4809,14-02-2021 00:00,24 hrs.,wallstreetbets,NCNO,906,906,0,906,1,426,50,1,NASDAQ
4809,14-02-2021 00:00,24 hrs.,wallstreetbets,NEPT,7,7,0,7,1,1,1,1,NASDAQ
4809,14-02-2021 00:00,24 hrs.,wallstreetbets,NGAC,6,6,0,6,1,1,0,1,NASDAQ
4809,14-02-2021 00:00,24 hrs.,wallstreetbets,NKLA,7,0,7,-7,1,1,1,1,NASDAQ
4809,14-02-2021 00:00,24 hrs.,wallstreetbets,NLOK,7,7,0,7,1,1,1,1,NASDAQ
4809,14-02-2021 00:00,24 hrs.,wallstreetbets,NNDM,39,7,32,-25,2,1,29,2,NASDAQ
4809,14-02-2021 00:00,24 hrs.,wallstreetbets,NOVN,15,0,15,-15,2,2,3,2,NASDAQ
4809,14-02-2021 00:00,24 hrs.,wallstreetbets,NVAX,13,0,13,-13,2,2,1,2,NASDAQ
4809,14-02-2021 00:00,24 hrs.,wallstreetbets,NVDA,7,7,0,7,1,1,1,1,NASDAQ
4809,14-02-2021 00:00,24 hrs.,wallstreetbets,NVIV,7,0,7,-7,1,1,1,1,NASDAQ
4809,14-02-2021 00:00,24 hrs.,wallstreetbets,NXPI,7,7,0,7,1,1,1,1,NASDAQ
4809,14-02-2021 00:00,24 hrs.,wallstreetbets,OCGN,6,6,0,6,1,1,0,1,NASDAQ
4809,14-02-2021 00:00,24 hrs.,wallstreetbets,ONTX,7,0,7,-7,1,1,1,1,NASDAQ
4809,14-02-2021 00:00,24 hrs.,wallstreetbets,PLAY,13817,13817,0,13817,3,6521,763,3,NASDAQ
4809,14-02-2021 00:00,24 hrs.,wallstreetbets,POWW,14,7,7,0,2,2,2,2,NASDAQ
4809,14-02-2021 00:00,24 hrs.,wallstreetbets,PTON,7,0,7,-7,1,1,1,1,NASDAQ
4809,14-02-2021 00:00,24 hrs.,wallstreetbets,QCOM,6,6,0,6,1,1,0,1,NASDAQ
4809,14-02-2021 00:00,24 hrs.,wallstreetbets,QDEL,134,134,0,134,1,49,32,1,NASDAQ
4809,14-02-2021 00:00,24 hrs.,wallstreetbets,RAVE,7,7,0,7,1,1,1,1,NASDAQ
4809,14-02-2021 00:00,24 hrs.,wallstreetbets,REAL,95,0,95,-95,2,31,25,2,NASDAQ
4809,14-02-2021 00:00,24 hrs.,wallstreetbets,REGI,7,0,7,-7,1,1,1,1,NASDAQ
4809,14-02-2021 00:00,24 hrs.,wallstreetbets,REGN,14,0,14,-14,2,2,2,1,NASDAQ
4809,14-02-2021 00:00,24 hrs.,wallstreetbets,RIGL,7,7,0,7,1,1,1,1,NASDAQ
4809,14-02-2021 00:00,24 hrs.,wallstreetbets,RIOT,21,7,14,-7,3,3,3,3,NASDAQ
4809,14-02-2021 00:00,24 hrs.,wallstreetbets,RKDA,7,7,0,7,1,1,1,1,NASDAQ
4809,14-02-2021 00:00,24 hrs.,wallstreetbets,CLVS,14,14,0,14,2,2,2,1,NASDAQ
4809,14-02-2021 00:00,24 hrs.,wallstreetbets,CMPS,12,0,12,-12,2,2,0,1,NASDAQ
4809,14-02-2021 00:00,24 hrs.,wallstreetbets,CPRT,134,134,0,134,1,49,32,1,NASDAQ
4809,14-02-2021 00:00,24 hrs.,wallstreetbets,CRBP,13,0,13,-13,2,2,1,2,NASDAQ
4809,14-02-2021 00:00,24 hrs.,wallstreetbets,CRSP,76,0,76,-76,4,3,54,2,NASDAQ
4809,14-02-2021 00:00,24 hrs.,wallstreetbets,CRSR,313,7,306,-299,5,119,55,5,NASDAQ
4809,14-02-2021 00:00,24 hrs.,wallstreetbets,CSTR,5,5,0,5,1,0,1,1,NASDAQ
4809,14-02-2021 00:00,24 hrs.,wallstreetbets,CTRM,41,34,7,27,6,6,5,5,NASDAQ
4809,14-02-2021 00:00,24 hrs.,wallstreetbets,CVAC,74,0,74,-74,1,26,18,1,NASDAQ
4809,14-02-2021 00:00,24 hrs.,wallstreetbets,DENN,134,134,0,134,1,49,32,1,NASDAQ
4809,14-02-2021 00:00,24 hrs.,wallstreetbets,DKNG,2074,2067,7,2060,2,916,234,2,NASDAQ
4809,14-02-2021 00:00,24 hrs.,wallstreetbets,DRIV,6,0,6,-6,1,1,0,1,NASDAQ
4809,14-02-2021 00:00,24 hrs.,wallstreetbets,EDIT,2340,2223,117,2106,3,993,342,3,NASDAQ
4809,14-02-2021 00:00,24 hrs.,wallstreetbets,EHTH,134,134,0,134,1,49,32,1,NASDAQ
4809,14-02-2021 00:00,24 hrs.,wallstreetbets,EVBG,134,134,0,134,1,49,32,1,NASDAQ
4809,14-02-2021 00:00,24 hrs.,wallstreetbets,EVER,7,0,7,-7,1,1,1,1,NASDAQ
4809,14-02-2021 00:00,24 hrs.,wallstreetbets,EVFM,6,6,0,6,1,1,0,1,NASDAQ
4809,14-02-2021 00:00,24 hrs.,wallstreetbets,EXPI,17,11,6,5,3,2,1,3,NASDAQ
4809,14-02-2021 00:00,24 hrs.,wallstreetbets,FIZZ,927,913,14,899,4,429,53,3,NASDAQ
4809,14-02-2021 00:00,24 hrs.,wallstreetbets,FLGT,15,15,0,15,2,2,3,1,NASDAQ
4809,14-02-2021 00:00,24 hrs.,wallstreetbets,FLMN,6,6,0,6,1,1,0,1,NASDAQ
4809,14-02-2021 00:00,24 hrs.,wallstreetbets,FLWR,7,0,7,-7,1,1,1,1,NASDAQ
4809,14-02-2021 00:00,24 hrs.,wallstreetbets,FOLD,6,6,0,6,1,1,0,1,NASDAQ
4809,14-02-2021 00:00,24 hrs.,wallstreetbets,FREQ,25,25,0,25,1,2,17,1,NASDAQ
4809,14-02-2021 00:00,24 hrs.,wallstreetbets,GAIN,7,7,0,7,1,1,1,1,NASDAQ
4809,14-02-2021 00:00,24 hrs.,wallstreetbets,GLBS,7,0,7,-7,1,1,1,1,NASDAQ
4809,14-02-2021 00:00,24 hrs.,wallstreetbets,GNOG,13,13,0,13,2,2,1,2,NASDAQ
4809,14-02-2021 00:00,24 hrs.,wallstreetbets,GNUS,14,0,14,-14,2,2,2,2,NASDAQ
4809,14-02-2021 00:00,24 hrs.,wallstreetbets,GOGO,980,962,18,944,13,437,54,8,NASDAQ
4809,14-02-2021 00:00,24 hrs.,wallstreetbets,GOLD,187,187,0,187,5,59,49,5,NASDAQ
4809,14-02-2021 00:00,24 hrs.,wallstreetbets,GRMN,134,134,0,134,1,49,32,1,NASDAQ
4809,14-02-2021 00:00,24 hrs.,wallstreetbets,YNDX,134,134,0,134,1,49,32,1,NASDAQ
4809,14-02-2021 00:00,24 hrs.,wallstreetbets,ZNGA,15,7,8,-1,2,2,3,2,NASDAQ
4809,14-02-2021 00:00,24 hrs.,wallstreetbets,CMCSA,7,7,0,7,1,1,1,1,NASDAQ
4809,14-02-2021 00:00,24 hrs.,RobinHoodPennyStocks,CRWG,6,0,6,-6,1,1,0,1,OTC
4809,14-02-2021 00:00,24 hrs.,RobinHoodPennyStocks,GTLL,6,0,6,-6,1,1,0,1,OTC
4809,14-02-2021 00:00,24 hrs.,RobinHoodPennyStocks,RTSL,6,6,0,6,1,1,0,1,OTC
4809,14-02-2021 00:00,24 hrs.,RobinHoodPennyStocks,ALLIF,6,0,6,-6,1,1,0,1,OTC
4809,14-02-2021 00:00,24 hrs.,RobinHoodPennyStocks,EMHTF,6,6,0,6,1,1,0,1,OTC
4809,14-02-2021 00:00,24 hrs.,RobinHoodPennyStocks,MEDIF,6,0,6,-6,1,1,0,1,OTC
4809,14-02-2021 00:00,24 hrs.,RobinHoodPennyStocks,MMEDF,28,0,28,-28,1,9,6,1,OTC
4809,14-02-2021 00:00,24 hrs.,RobinHoodPennyStocks,DNN,6,6,0,6,1,1,0,1,AMEX
4809,14-02-2021 00:00,24 hrs.,RobinHoodPennyStocks,DPW,64,39,25,14,2,17,22,2,AMEX
4809,14-02-2021 00:00,24 hrs.,RobinHoodPennyStocks,DSS,6,6,0,6,1,1,0,1,AMEX
4809,14-02-2021 00:00,24 hrs.,RobinHoodPennyStocks,GSV,6,0,6,-6,1,1,0,1,AMEX
4809,14-02-2021 00:00,24 hrs.,RobinHoodPennyStocks,GTE,83,0,83,-83,1,27,25,1,AMEX
4809,14-02-2021 00:00,24 hrs.,RobinHoodPennyStocks,XPL,6,0,6,-6,1,1,0,1,AMEX
4809,14-02-2021 00:00,24 hrs.,RobinHoodPennyStocks,ZOM,132,0,132,-132,1,43,42,1,AMEX
4809,14-02-2021 00:00,24 hrs.,RobinHoodPennyStocks,CPHI,11,11,0,11,1,2,3,1,AMEX
4809,14-02-2021 00:00,24 hrs.,RobinHoodPennyStocks,ETN,18,12,6,6,3,3,0,2,NYSE
4809,14-02-2021 00:00,24 hrs.,RobinHoodPennyStocks,GME,8,8,0,8,1,1,2,1,NYSE
4809,14-02-2021 00:00,24 hrs.,RobinHoodPennyStocks,MRO,70,64,6,58,2,26,10,2,NYSE
4809,14-02-2021 00:00,24 hrs.,RobinHoodPennyStocks,NOK,8,8,0,8,1,1,2,1,NYSE
4809,14-02-2021 00:00,24 hrs.,RobinHoodPennyStocks,SOS,6,6,0,6,1,1,0,1,NYSE
4809,14-02-2021 00:00,24 hrs.,RobinHoodPennyStocks,IPOE,6,6,0,6,1,1,0,1,NYSE
4809,14-02-2021 00:00,24 hrs.,RobinHoodPennyStocks,JFU,6,0,6,-6,1,1,0,1,NASDAQ
4809,14-02-2021 00:00,24 hrs.,RobinHoodPennyStocks,SND,51,51,0,51,1,13,21,1,NASDAQ
4809,14-02-2021 00:00,24 hrs.,RobinHoodPennyStocks,AGEN,6,6,0,6,1,1,0,1,NASDAQ
4809,14-02-2021 00:00,24 hrs.,RobinHoodPennyStocks,AGTC,90,0,90,-90,1,15,56,1,NASDAQ
4809,14-02-2021 00:00,24 hrs.,RobinHoodPennyStocks,ASRT,13,13,0,13,1,1,7,1,NASDAQ
4809,14-02-2021 00:00,24 hrs.,RobinHoodPennyStocks,BNGO,4,0,4,-4,1,0,0,1,NASDAQ
4809,14-02-2021 00:00,24 hrs.,RobinHoodPennyStocks,CIDM,90,0,90,-90,1,15,56,1,NASDAQ
4809,14-02-2021 00:00,24 hrs.,RobinHoodPennyStocks,CLBS,6,0,6,-6,1,1,0,1,NASDAQ
4809,14-02-2021 00:00,24 hrs.,RobinHoodPennyStocks,CRBP,42,0,42,-42,1,16,6,1,NASDAQ
4809,14-02-2021 00:00,24 hrs.,RobinHoodPennyStocks,CSCW,11,11,0,11,1,2,3,1,NASDAQ
4809,14-02-2021 00:00,24 hrs.,RobinHoodPennyStocks,CSTR,4,4,0,4,1,0,0,1,NASDAQ
4809,14-02-2021 00:00,24 hrs.,RobinHoodPennyStocks,CTRM,133,6,127,-121,3,20,81,3,NASDAQ
4809,14-02-2021 00:00,24 hrs.,wallstreetbets,RNWK,6,6,0,6,1,1,0,1,NASDAQ
4809,14-02-2021 00:00,24 hrs.,wallstreetbets,ROKU,3114,3107,7,3100,4,1391,316,4,NASDAQ
4809,14-02-2021 00:00,24 hrs.,wallstreetbets,SABR,7,7,0,7,1,1,1,1,NASDAQ
4809,14-02-2021 00:00,24 hrs.,wallstreetbets,SEDG,134,134,0,134,1,49,32,1,NASDAQ
4809,14-02-2021 00:00,24 hrs.,wallstreetbets,SESN,6,6,0,6,1,1,0,1,NASDAQ
4809,14-02-2021 00:00,24 hrs.,wallstreetbets,SGEN,7,7,0,7,1,1,1,1,NASDAQ
4809,14-02-2021 00:00,24 hrs.,wallstreetbets,SHIP,35,21,14,7,5,5,5,3,NASDAQ
4809,14-02-2021 00:00,24 hrs.,wallstreetbets,SIRI,8,8,0,8,1,1,2,1,NASDAQ
4809,14-02-2021 00:00,24 hrs.,wallstreetbets,SMCI,14,14,0,14,2,2,2,1,NASDAQ
4809,14-02-2021 00:00,24 hrs.,wallstreetbets,SNDL,472,259,213,46,70,69,54,59,NASDAQ
4809,14-02-2021 00:00,24 hrs.,wallstreetbets,SNGX,31,6,25,-19,5,5,1,5,NASDAQ
4809,14-02-2021 00:00,24 hrs.,wallstreetbets,SQQQ,7,7,0,7,1,1,1,1,NASDAQ
4809,14-02-2021 00:00,24 hrs.,wallstreetbets,SRAC,7,0,7,-7,1,1,1,1,NASDAQ
4809,14-02-2021 00:00,24 hrs.,wallstreetbets,SRNE,7,0,7,-7,1,1,1,1,NASDAQ
4809,14-02-2021 00:00,24 hrs.,wallstreetbets,SSRM,6,0,6,-6,1,1,0,1,NASDAQ
4809,14-02-2021 00:00,24 hrs.,wallstreetbets,STAF,13,0,13,-13,2,2,1,2,NASDAQ
4809,14-02-2021 00:00,24 hrs.,wallstreetbets,STAY,6,0,6,-6,1,1,0,1,NASDAQ
4809,14-02-2021 00:00,24 hrs.,wallstreetbets,STMP,134,134,0,134,1,49,32,1,NASDAQ
4809,14-02-2021 00:00,24 hrs.,wallstreetbets,SWBI,28,7,21,-14,4,4,4,3,NASDAQ
4809,14-02-2021 00:00,24 hrs.,wallstreetbets,TECH,7,0,7,-7,1,1,1,1,NASDAQ
4809,14-02-2021 00:00,24 hrs.,wallstreetbets,TLGT,7,7,0,7,1,1,1,1,NASDAQ
4809,14-02-2021 00:00,24 hrs.,wallstreetbets,TLRY,2150,1096,1054,42,20,812,446,16,NASDAQ
4809,14-02-2021 00:00,24 hrs.,wallstreetbets,TNXP,28,14,14,0,4,4,4,4,NASDAQ
4809,14-02-2021 00:00,24 hrs.,wallstreetbets,TOPS,14,0,14,-14,2,2,2,2,NASDAQ
4809,14-02-2021 00:00,24 hrs.,wallstreetbets,TQQQ,21,0,21,-21,3,3,3,1,NASDAQ
4809,14-02-2021 00:00,24 hrs.,wallstreetbets,TRCH,19,7,12,-5,3,3,1,3,NASDAQ
4809,14-02-2021 00:00,24 hrs.,wallstreetbets,TREE,906,906,0,906,1,426,50,1,NASDAQ
4809,14-02-2021 00:00,24 hrs.,wallstreetbets,TRIT,27,14,13,1,3,5,5,2,NASDAQ
4809,14-02-2021 00:00,24 hrs.,pennystocks,ABML,68,24,44,-20,5,20,8,2,OTC
4809,14-02-2021 00:00,24 hrs.,pennystocks,AITX,32,32,0,32,1,10,8,1,OTC
4809,14-02-2021 00:00,24 hrs.,pennystocks,ALYI,58,58,0,58,1,8,38,1,OTC
4809,14-02-2021 00:00,24 hrs.,pennystocks,AMAZ,6,6,0,6,1,1,0,1,OTC
4809,14-02-2021 00:00,24 hrs.,pennystocks,AMNE,13,13,0,13,2,2,1,1,OTC
4809,14-02-2021 00:00,24 hrs.,pennystocks,ASTI,28,28,0,28,2,8,4,2,OTC
4809,14-02-2021 00:00,24 hrs.,pennystocks,ATVK,7,7,0,7,1,1,1,1,OTC
4809,14-02-2021 00:00,24 hrs.,pennystocks,BANT,6,6,0,6,1,1,0,1,OTC
4809,14-02-2021 00:00,24 hrs.,pennystocks,BNGI,6,6,0,6,1,1,0,1,OTC
4809,14-02-2021 00:00,24 hrs.,pennystocks,BOTY,38,32,6,26,2,11,8,2,OTC
4809,14-02-2021 00:00,24 hrs.,pennystocks,BRGO,6,6,0,6,1,1,0,1,OTC
4809,14-02-2021 00:00,24 hrs.,pennystocks,BRRN,10,10,0,10,1,2,2,1,OTC
4809,14-02-2021 00:00,24 hrs.,pennystocks,BRSE,6,6,0,6,1,1,0,1,OTC
4809,14-02-2021 00:00,24 hrs.,pennystocks,CAFS,7,0,7,-7,1,1,1,1,OTC
4809,14-02-2021 00:00,24 hrs.,pennystocks,CANN,12,12,0,12,2,2,0,2,OTC
4809,14-02-2021 00:00,24 hrs.,pennystocks,CBBT,90,90,0,90,2,18,46,2,OTC
4809,14-02-2021 00:00,24 hrs.,pennystocks,CBDL,32,32,0,32,1,10,8,1,OTC
4809,14-02-2021 00:00,24 hrs.,pennystocks,CCTL,83,83,0,83,1,22,35,1,OTC
4809,14-02-2021 00:00,24 hrs.,pennystocks,CELZ,6,0,6,-6,1,1,0,1,OTC
4809,14-02-2021 00:00,24 hrs.,pennystocks,CLIS,18,18,0,18,2,3,4,1,OTC
4809,14-02-2021 00:00,24 hrs.,pennystocks,CNNA,89,0,89,-89,1,11,63,1,OTC
4809,14-02-2021 00:00,24 hrs.,pennystocks,COMS,13,0,13,-13,2,2,1,1,OTC
4809,14-02-2021 00:00,24 hrs.,pennystocks,CTLE,43,31,12,19,7,7,1,3,OTC
4809,14-02-2021 00:00,24 hrs.,pennystocks,DIGI,49,49,0,49,1,18,9,1,OTC
4809,14-02-2021 00:00,24 hrs.,pennystocks,DPLS,106,24,82,-58,2,36,26,2,OTC
4809,14-02-2021 00:00,24 hrs.,pennystocks,DSGT,6,0,6,-6,1,1,0,1,OTC
4809,14-02-2021 00:00,24 hrs.,pennystocks,DXLG,30,30,0,30,1,12,2,1,OTC
4809,14-02-2021 00:00,24 hrs.,pennystocks,EAWD,6,0,6,-6,1,1,0,1,OTC
4809,14-02-2021 00:00,24 hrs.,pennystocks,ECEZ,14,7,7,0,2,2,2,2,OTC
4809,14-02-2021 00:00,24 hrs.,pennystocks,ECOX,7,7,0,7,1,1,1,1,OTC
4809,14-02-2021 00:00,24 hrs.,pennystocks,EHOS,41,0,41,-41,1,9,19,1,OTC
4809,14-02-2021 00:00,24 hrs.,RobinHoodPennyStocks,SHIP,6,0,6,-6,1,1,0,1,NASDAQ
4809,14-02-2021 00:00,24 hrs.,RobinHoodPennyStocks,SNDL,24,6,18,-12,4,4,0,4,NASDAQ
4809,14-02-2021 00:00,24 hrs.,RobinHoodPennyStocks,SONM,23,23,0,23,1,3,13,1,NASDAQ
4809,14-02-2021 00:00,24 hrs.,RobinHoodPennyStocks,SXTC,12,12,0,12,1,3,2,1,NASDAQ
4809,14-02-2021 00:00,24 hrs.,RobinHoodPennyStocks,TRCH,56,56,0,56,1,13,26,1,NASDAQ
4809,14-02-2021 00:00,24 hrs.,RobinHoodPennyStocks,TSLA,6,6,0,6,1,1,0,1,NASDAQ
4809,14-02-2021 00:00,24 hrs.,RobinHoodPennyStocks,TXMD,25,13,12,1,3,3,7,3,NASDAQ
4809,14-02-2021 00:00,24 hrs.,RobinHoodPennyStocks,TYME,6,0,6,-6,1,1,0,1,NASDAQ
4809,14-02-2021 00:00,24 hrs.,RobinHoodPennyStocks,DFFN,79,0,79,-79,2,16,39,2,NASDAQ
4809,14-02-2021 00:00,24 hrs.,RobinHoodPennyStocks,EDIT,11,11,0,11,1,2,3,1,NASDAQ
4809,14-02-2021 00:00,24 hrs.,RobinHoodPennyStocks,FLMN,6,6,0,6,1,1,0,1,NASDAQ
4809,14-02-2021 00:00,24 hrs.,RobinHoodPennyStocks,GAIN,6,0,6,-6,1,1,0,1,NASDAQ
4809,14-02-2021 00:00,24 hrs.,RobinHoodPennyStocks,GOGO,11,11,0,11,1,0,7,1,NASDAQ
4809,14-02-2021 00:00,24 hrs.,RobinHoodPennyStocks,GRPN,19,19,0,19,1,4,7,1,NASDAQ
4809,14-02-2021 00:00,24 hrs.,RobinHoodPennyStocks,IMMR,15,0,15,-15,1,4,3,1,NASDAQ
4809,14-02-2021 00:00,24 hrs.,RobinHoodPennyStocks,INPX,12,0,12,-12,2,2,0,1,NASDAQ
4809,14-02-2021 00:00,24 hrs.,RobinHoodPennyStocks,NAKD,126,0,126,-126,1,51,20,1,NASDAQ
4809,14-02-2021 00:00,24 hrs.,RobinHoodPennyStocks,RETO,11,11,0,11,1,2,3,1,NASDAQ
4809,14-02-2021 00:00,24 hrs.,wallstreetbets,TXMD,6,6,0,6,1,1,0,1,NASDAQ
4809,14-02-2021 00:00,24 hrs.,wallstreetbets,TXRH,134,134,0,134,1,49,32,1,NASDAQ
4809,14-02-2021 00:00,24 hrs.,wallstreetbets,VISL,7,0,7,-7,1,1,1,1,NASDAQ
4809,14-02-2021 00:00,24 hrs.,wallstreetbets,VIVO,7,0,7,-7,1,1,1,1,NASDAQ
4809,14-02-2021 00:00,24 hrs.,wallstreetbets,VKTX,7,7,0,7,1,1,1,1,NASDAQ
4809,14-02-2021 00:00,24 hrs.,wallstreetbets,VOXX,6,0,6,-6,1,1,0,1,NASDAQ
4809,14-02-2021 00:00,24 hrs.,wallstreetbets,VTGN,7,0,7,-7,1,1,1,1,NASDAQ
4809,14-02-2021 00:00,24 hrs.,wallstreetbets,VUZI,41,20,21,-1,6,6,5,4,NASDAQ
4809,14-02-2021 00:00,24 hrs.,wallstreetbets,VXRT,42,35,7,28,6,6,6,2,NASDAQ
4809,14-02-2021 00:00,24 hrs.,wallstreetbets,WATT,7,0,7,-7,1,1,1,1,NASDAQ
4809,14-02-2021 00:00,24 hrs.,wallstreetbets,WIMI,7,7,0,7,1,1,1,1,NASDAQ
4809,14-02-2021 00:00,24 hrs.,wallstreetbets,WING,134,134,0,134,1,49,32,1,NASDAQ
4809,14-02-2021 00:00,24 hrs.,wallstreetbets,WKHS,2120,2100,20,2080,5,922,256,4,NASDAQ
4809,14-02-2021 00:00,24 hrs.,wallstreetbets,WSBC,8,0,8,-8,1,1,2,1,NASDAQ
4809,14-02-2021 00:00,24 hrs.,wallstreetbets,XSPA,6,0,6,-6,1,1,0,1,NASDAQ
4809,14-02-2021 00:00,24 hrs.,pennystocks,SNPW,133,64,69,-5,4,35,47,4,OTC
4809,14-02-2021 00:00,24 hrs.,pennystocks,SOBR,6,0,6,-6,1,1,0,1,OTC
4809,14-02-2021 00:00,24 hrs.,pennystocks,SRMX,6,0,6,-6,1,1,0,1,OTC
4809,14-02-2021 00:00,24 hrs.,pennystocks,STWC,35,0,35,-35,1,12,7,1,OTC
4809,14-02-2021 00:00,24 hrs.,pennystocks,TAUG,15,7,8,-1,2,3,1,2,OTC
4809,14-02-2021 00:00,24 hrs.,pennystocks,TIDE,286,286,0,286,1,113,56,1,OTC
4809,14-02-2021 00:00,24 hrs.,pennystocks,ENZC,58,58,0,58,1,8,38,1,OTC
4809,14-02-2021 00:00,24 hrs.,pennystocks,ERBB,20,0,20,-20,1,4,8,1,OTC
4809,14-02-2021 00:00,24 hrs.,pennystocks,ETFM,6,0,6,-6,1,1,0,1,OTC
4809,14-02-2021 00:00,24 hrs.,pennystocks,GAXY,347,24,323,-299,2,131,77,2,OTC
4809,14-02-2021 00:00,24 hrs.,pennystocks,GLFH,18,18,0,18,1,4,6,1,OTC
4809,14-02-2021 00:00,24 hrs.,pennystocks,GPFT,10,0,10,-10,1,2,2,1,OTC
4809,14-02-2021 00:00,24 hrs.,pennystocks,GRCV,7,0,7,-7,1,1,1,1,OTC
4809,14-02-2021 00:00,24 hrs.,pennystocks,GRSO,7,0,7,-7,1,1,1,1,OTC
4809,14-02-2021 00:00,24 hrs.,pennystocks,GTEH,109,58,51,7,2,19,63,2,OTC
4809,14-02-2021 00:00,24 hrs.,pennystocks,GTLL,6,0,6,-6,1,1,0,1,OTC
4809,14-02-2021 00:00,24 hrs.,pennystocks,HALB,24,24,0,24,1,6,8,1,OTC
4809,14-02-2021 00:00,24 hrs.,pennystocks,HCMC,104,49,55,-6,17,17,2,16,OTC
4809,14-02-2021 00:00,24 hrs.,pennystocks,HENC,17,0,17,-17,1,2,9,1,OTC
4809,14-02-2021 00:00,24 hrs.,pennystocks,HIPH,7,0,7,-7,1,0,3,1,OTC
4809,14-02-2021 00:00,24 hrs.,pennystocks,HPIL,6,6,0,6,1,1,0,1,OTC
4809,14-02-2021 00:00,24 hrs.,pennystocks,HPMM,7,7,0,7,1,1,1,1,OTC
4809,14-02-2021 00:00,24 hrs.,pennystocks,HQGE,6,6,0,6,1,1,0,1,OTC
4809,14-02-2021 00:00,24 hrs.,pennystocks,ICNM,7,7,0,7,1,1,1,1,OTC
4809,14-02-2021 00:00,24 hrs.,pennystocks,ICTY,6,6,0,6,1,1,0,1,OTC
4809,14-02-2021 00:00,24 hrs.,pennystocks,IGEN,22,22,0,22,2,3,8,2,OTC
4809,14-02-2021 00:00,24 hrs.,pennystocks,INKW,12,6,6,0,2,2,0,2,OTC
4809,14-02-2021 00:00,24 hrs.,pennystocks,INND,594,531,63,468,3,256,70,3,OTC
4809,14-02-2021 00:00,24 hrs.,pennystocks,INTV,7,0,7,-7,1,1,1,1,OTC
4809,14-02-2021 00:00,24 hrs.,pennystocks,ISBL,7,0,7,-7,1,1,1,1,OTC
4809,14-02-2021 00:00,24 hrs.,pennystocks,KYNC,6,6,0,6,1,1,0,1,OTC
4809,14-02-2021 00:00,24 hrs.,pennystocks,LATF,8,8,0,8,1,1,2,1,OTC
4809,14-02-2021 00:00,24 hrs.,pennystocks,LBTI,6,0,6,-6,1,1,0,1,OTC
4809,14-02-2021 00:00,24 hrs.,pennystocks,LTNC,39,39,0,39,1,0,35,1,OTC
4809,14-02-2021 00:00,24 hrs.,pennystocks,LVVV,40,0,40,-40,1,8,20,1,OTC
4809,14-02-2021 00:00,24 hrs.,pennystocks,MAXD,29,0,29,-29,1,7,11,1,OTC
4809,14-02-2021 00:00,24 hrs.,pennystocks,MINE,58,58,0,58,1,7,40,1,OTC
4809,14-02-2021 00:00,24 hrs.,pennystocks,MJNA,78,78,0,78,3,19,28,2,OTC
4809,14-02-2021 00:00,24 hrs.,pennystocks,MLFB,15,15,0,15,1,3,5,1,OTC
4809,14-02-2021 00:00,24 hrs.,pennystocks,MRMD,6,0,6,-6,1,0,2,1,OTC
4809,14-02-2021 00:00,24 hrs.,pennystocks,MSPC,6,6,0,6,1,1,0,1,OTC
4809,14-02-2021 00:00,24 hrs.,pennystocks,NSPT,21,0,21,-21,1,2,13,1,OTC
4809,14-02-2021 00:00,24 hrs.,pennystocks,NSPX,6,6,0,6,1,1,0,1,OTC
4809,14-02-2021 00:00,24 hrs.,pennystocks,NUGS,7,0,7,-7,1,1,1,1,OTC
4809,14-02-2021 00:00,24 hrs.,pennystocks,OZSC,283,148,135,13,3,103,65,3,OTC
4809,14-02-2021 00:00,24 hrs.,pennystocks,PUGE,125,125,0,125,1,38,45,1,OTC
4809,14-02-2021 00:00,24 hrs.,pennystocks,PURA,48,0,48,-48,1,7,30,1,OTC
4809,14-02-2021 00:00,24 hrs.,pennystocks,PVDG,58,58,0,58,1,8,38,1,OTC
4809,14-02-2021 00:00,24 hrs.,pennystocks,QMCI,58,58,0,58,1,8,38,1,OTC
4809,14-02-2021 00:00,24 hrs.,pennystocks,RBNW,6,6,0,6,1,1,0,1,OTC
4809,14-02-2021 00:00,24 hrs.,StockMarket,SNDL,238,6,232,-226,3,50,126,3,NASDAQ
4809,14-02-2021 00:00,24 hrs.,StockMarket,SPWR,57,57,0,57,1,24,5,1,NASDAQ
4809,14-02-2021 00:00,24 hrs.,StockMarket,STMP,57,57,0,57,1,24,5,1,NASDAQ
4809,14-02-2021 00:00,24 hrs.,StockMarket,TEAM,12,12,0,12,1,1,6,1,NASDAQ
4809,14-02-2021 00:00,24 hrs.,StockMarket,TLRY,63,63,0,63,2,25,5,2,NASDAQ
4809,14-02-2021 00:00,24 hrs.,StockMarket,TRCH,11,11,0,11,1,0,7,1,NASDAQ
4809,14-02-2021 00:00,24 hrs.,StockMarket,TREE,57,57,0,57,1,24,5,1,NASDAQ
4809,14-02-2021 00:00,24 hrs.,StockMarket,TSEM,57,57,0,57,1,24,5,1,NASDAQ
4809,14-02-2021 00:00,24 hrs.,StockMarket,TSLA,4213,0,4213,-4213,1,2037,135,1,NASDAQ
4809,14-02-2021 00:00,24 hrs.,StockMarket,VITL,76,0,76,-76,1,29,14,1,NASDAQ
4809,14-02-2021 00:00,24 hrs.,StockMarket,VXRT,27,21,6,15,2,1,17,2,NASDAQ
4809,14-02-2021 00:00,24 hrs.,StockMarket,WING,57,57,0,57,1,24,5,1,NASDAQ
4809,14-02-2021 00:00,24 hrs.,StockMarket,XONE,14,14,0,14,3,0,2,1,NASDAQ
4809,14-02-2021 00:00,24 hrs.,StockMarket,YNDX,57,57,0,57,1,24,5,1,NASDAQ
4809,14-02-2021 00:00,24 hrs.,pennystocks,XFLS,4,0,4,-4,1,0,0,1,OTC
4809,14-02-2021 00:00,24 hrs.,pennystocks,XLPI,172,0,172,-172,1,75,18,1,OTC
4809,14-02-2021 00:00,24 hrs.,pennystocks,XMET,7,7,0,7,1,1,1,1,OTC
4809,14-02-2021 00:00,24 hrs.,pennystocks,ZMRK,6,6,0,6,1,1,0,1,OTC
4809,14-02-2021 00:00,24 hrs.,pennystocks,ABEPF,6,6,0,6,1,1,0,1,OTC
4809,14-02-2021 00:00,24 hrs.,pennystocks,AMYZF,36,36,0,36,6,6,0,2,OTC
4809,14-02-2021 00:00,24 hrs.,pennystocks,AQSZF,6,0,6,-6,1,1,0,1,OTC
4809,14-02-2021 00:00,24 hrs.,pennystocks,ARBKF,297,211,86,125,8,86,93,6,OTC
4809,14-02-2021 00:00,24 hrs.,pennystocks,BDRBF,6,6,0,6,1,1,0,1,OTC
4809,14-02-2021 00:00,24 hrs.,pennystocks,BUROF,6,6,0,6,1,1,0,1,OTC
4809,14-02-2021 00:00,24 hrs.,pennystocks,CLXPF,207,207,0,207,1,75,53,1,OTC
4809,14-02-2021 00:00,24 hrs.,pennystocks,COCSF,13,13,0,13,1,3,3,1,OTC
4809,14-02-2021 00:00,24 hrs.,pennystocks,CRLBF,89,0,89,-89,1,11,63,1,OTC
4809,14-02-2021 00:00,24 hrs.,pennystocks,DIGAF,7,0,7,-7,1,1,1,1,OTC
4809,14-02-2021 00:00,24 hrs.,pennystocks,EMHTF,17,17,0,17,1,5,3,1,OTC
4809,14-02-2021 00:00,24 hrs.,pennystocks,EPWCF,14,0,14,-14,1,0,10,1,OTC
4809,14-02-2021 00:00,24 hrs.,pennystocks,ERPNF,44,0,44,-44,1,16,8,1,OTC
4809,14-02-2021 00:00,24 hrs.,pennystocks,HITIF,497,402,95,307,6,164,145,6,OTC
4809,14-02-2021 00:00,24 hrs.,pennystocks,ILHMF,7,7,0,7,1,1,1,1,OTC
4809,14-02-2021 00:00,24 hrs.,pennystocks,ITMPF,12,12,0,12,2,2,0,1,OTC
4809,14-02-2021 00:00,24 hrs.,pennystocks,LTHUQ,30,0,30,-30,1,7,12,1,OTC
4809,14-02-2021 00:00,24 hrs.,pennystocks,MMEDF,96,96,0,96,3,18,48,3,OTC
4809,14-02-2021 00:00,24 hrs.,pennystocks,MMNFF,30,30,0,30,1,12,2,1,OTC
4809,14-02-2021 00:00,24 hrs.,pennystocks,MPUCF,7,7,0,7,1,1,1,1,OTC
4809,14-02-2021 00:00,24 hrs.,pennystocks,MSNVF,6,6,0,6,1,1,0,1,OTC
4809,14-02-2021 00:00,24 hrs.,pennystocks,NMGRF,40,40,0,40,2,12,8,1,OTC
4809,14-02-2021 00:00,24 hrs.,pennystocks,NMTLF,20,20,0,20,1,6,4,1,OTC
4809,14-02-2021 00:00,24 hrs.,pennystocks,NXTTF,89,12,77,-65,3,25,27,3,OTC
4809,14-02-2021 00:00,24 hrs.,pennystocks,RLLCF,31,31,0,31,3,4,11,2,OTC
4809,14-02-2021 00:00,24 hrs.,pennystocks,TAKOF,28,28,0,28,2,6,8,2,OTC
4809,14-02-2021 00:00,24 hrs.,pennystocks,TLOFF,58,58,0,58,1,8,38,1,OTC
4809,14-02-2021 00:00,24 hrs.,pennystocks,TOWTF,12,12,0,12,2,2,0,1,OTC
4809,14-02-2021 00:00,24 hrs.,pennystocks,TRUFF,36,6,30,-24,2,8,12,2,OTC
4809,14-02-2021 00:00,24 hrs.,pennystocks,TSCRF,34,34,0,34,1,10,10,1,OTC
4809,14-02-2021 00:00,24 hrs.,pennystocks,BGI,30,30,0,30,1,12,2,1,AMEX
4809,14-02-2021 00:00,24 hrs.,pennystocks,CTO,286,286,0,286,1,113,56,1,AMEX
4809,14-02-2021 00:00,24 hrs.,pennystocks,CVM,6,6,0,6,1,1,0,1,AMEX
4809,14-02-2021 00:00,24 hrs.,pennystocks,DNN,32,13,19,-6,5,5,2,5,AMEX
4809,14-02-2021 00:00,24 hrs.,pennystocks,DPW,6,0,6,-6,1,1,0,1,AMEX
4809,14-02-2021 00:00,24 hrs.,pennystocks,DSS,6,6,0,6,1,1,0,1,AMEX
4809,14-02-2021 00:00,24 hrs.,pennystocks,GSV,7,0,7,-7,1,1,1,1,AMEX
4809,14-02-2021 00:00,24 hrs.,pennystocks,GTE,68,0,68,-68,3,15,26,3,AMEX
4809,14-02-2021 00:00,24 hrs.,pennystocks,NGD,10,10,0,10,1,2,2,1,AMEX
4809,14-02-2021 00:00,24 hrs.,pennystocks,NTN,30,30,0,30,1,12,2,1,AMEX
4809,14-02-2021 00:00,24 hrs.,pennystocks,RHE,30,30,0,30,1,12,2,1,AMEX
4809,14-02-2021 00:00,24 hrs.,pennystocks,TGB,6,0,6,-6,1,1,0,1,AMEX
4809,14-02-2021 00:00,24 hrs.,pennystocks,ZOM,354,265,89,176,3,94,154,3,AMEX
4809,14-02-2021 00:00,24 hrs.,pennystocks,AMPE,30,30,0,30,1,12,2,1,AMEX
4809,14-02-2021 00:00,24 hrs.,pennystocks,NSPR,98,98,0,98,3,16,54,3,AMEX
4809,14-02-2021 00:00,24 hrs.,pennystocks,OGEN,72,66,6,60,2,27,10,2,AMEX
4809,14-02-2021 00:00,24 hrs.,pennystocks,SENS,37,37,0,37,2,14,1,2,AMEX
4809,14-02-2021 00:00,24 hrs.,pennystocks,SNMP,19,19,0,19,1,5,5,1,AMEX
4809,14-02-2021 00:00,24 hrs.,pennystocks,TMBR,30,30,0,30,1,12,2,1,AMEX
4809,14-02-2021 00:00,24 hrs.,pennystocks,TRXC,6,0,6,-6,1,0,2,1,AMEX
4809,14-02-2021 00:00,24 hrs.,pennystocks,UAMY,58,58,0,58,1,7,40,1,AMEX
4809,14-02-2021 00:00,24 hrs.,pennystocks,ACB,286,286,0,286,1,113,56,1,NYSE
4809,14-02-2021 00:00,24 hrs.,pennystocks,AMC,74,74,0,74,2,18,30,2,NYSE
4809,14-02-2021 00:00,24 hrs.,pennystocks,RCRT,24,24,0,24,1,5,10,1,OTC
4809,14-02-2021 00:00,24 hrs.,pennystocks,RSSV,94,94,0,94,1,40,10,1,OTC
4809,14-02-2021 00:00,24 hrs.,pennystocks,SCNA,6,0,6,-6,1,1,0,1,OTC
4809,14-02-2021 00:00,24 hrs.,pennystocks,SGMD,430,282,148,134,7,140,122,7,OTC
4809,14-02-2021 00:00,24 hrs.,pennystocks,SHMP,7,7,0,7,1,1,1,1,OTC
4809,14-02-2021 00:00,24 hrs.,pennystocks,SING,15,15,0,15,1,2,7,1,OTC
4809,14-02-2021 00:00,24 hrs.,pennystocks,SIRC,60,60,0,60,2,15,22,2,OTC
4809,14-02-2021 00:00,24 hrs.,pennystocks,RIBT,6,0,6,-6,1,1,0,1,NASDAQ
4809,14-02-2021 00:00,24 hrs.,pennystocks,NYC,13,13,0,13,1,0,9,1,NYSE
4809,14-02-2021 00:00,24 hrs.,pennystocks,PDT,87,87,0,87,3,25,25,3,NYSE
4809,14-02-2021 00:00,24 hrs.,pennystocks,PKG,45,45,0,45,1,17,7,1,NYSE
4809,14-02-2021 00:00,24 hrs.,pennystocks,SOS,1083,1083,0,1083,8,374,303,8,NYSE
4809,14-02-2021 00:00,24 hrs.,pennystocks,SUP,30,30,0,30,1,12,2,1,NYSE
4809,14-02-2021 00:00,24 hrs.,pennystocks,THC,40,40,0,40,1,12,12,1,NYSE
4809,14-02-2021 00:00,24 hrs.,pennystocks,TTM,286,286,0,286,1,113,56,1,NYSE
4809,14-02-2021 00:00,24 hrs.,pennystocks,ARGO,64,0,64,-64,1,23,14,1,NYSE
4809,14-02-2021 00:00,24 hrs.,pennystocks,DASH,26,0,26,-26,1,8,6,1,NYSE
4809,14-02-2021 00:00,24 hrs.,pennystocks,HEXO,293,293,0,293,2,114,57,2,NYSE
4809,14-02-2021 00:00,24 hrs.,pennystocks,SPCE,44,0,44,-44,1,16,8,1,NYSE
4809,14-02-2021 00:00,24 hrs.,pennystocks,WELL,7,7,0,7,1,1,1,1,NYSE
4809,14-02-2021 00:00,24 hrs.,pennystocks,CGC,286,286,0,286,1,113,56,1,NASDAQ
4809,14-02-2021 00:00,24 hrs.,pennystocks,INO,66,66,0,66,1,26,10,1,NASDAQ
4809,14-02-2021 00:00,24 hrs.,pennystocks,OGI,19,0,19,-19,1,6,3,1,NASDAQ
4809,14-02-2021 00:00,24 hrs.,pennystocks,PTE,114,114,0,114,1,44,22,1,NASDAQ
4809,14-02-2021 00:00,24 hrs.,pennystocks,SND,51,0,51,-51,1,10,27,1,NASDAQ
4809,14-02-2021 00:00,24 hrs.,pennystocks,SPI,11,0,11,-11,1,2,3,1,NASDAQ
4809,14-02-2021 00:00,24 hrs.,pennystocks,AEZS,21,21,0,21,1,7,3,1,NASDAQ
4809,14-02-2021 00:00,24 hrs.,pennystocks,AIKI,6,0,6,-6,1,1,0,1,NASDAQ
4809,14-02-2021 00:00,24 hrs.,pennystocks,ALNA,15,0,15,-15,1,2,7,1,NASDAQ
4809,14-02-2021 00:00,24 hrs.,pennystocks,ANTE,21,21,0,21,1,6,5,1,NASDAQ
4809,14-02-2021 00:00,24 hrs.,pennystocks,APRE,6,0,6,-6,1,1,0,1,NASDAQ
4809,14-02-2021 00:00,24 hrs.,pennystocks,AQMS,58,58,0,58,1,8,38,1,NASDAQ
4809,14-02-2021 00:00,24 hrs.,pennystocks,ARTL,30,30,0,30,1,12,2,1,NASDAQ
4809,14-02-2021 00:00,24 hrs.,pennystocks,ASRT,63,63,0,63,2,16,23,2,NASDAQ
4809,14-02-2021 00:00,24 hrs.,pennystocks,ATOS,26,26,0,26,1,3,16,1,NASDAQ
4809,14-02-2021 00:00,24 hrs.,pennystocks,AVGR,114,114,0,114,1,44,22,1,NASDAQ
4809,14-02-2021 00:00,24 hrs.,pennystocks,AYRO,30,30,0,30,1,12,2,1,NASDAQ
4809,14-02-2021 00:00,24 hrs.,pennystocks,BCLI,6,0,6,-6,1,0,2,1,NASDAQ
4809,14-02-2021 00:00,24 hrs.,pennystocks,BHTG,79,79,0,79,1,31,13,1,NASDAQ
4809,14-02-2021 00:00,24 hrs.,pennystocks,BIOL,51,0,51,-51,1,10,27,1,NASDAQ
4809,14-02-2021 00:00,24 hrs.,pennystocks,BLUE,36,0,36,-36,1,7,18,1,NASDAQ
4809,14-02-2021 00:00,24 hrs.,pennystocks,BNGO,273,229,44,185,4,60,137,3,NASDAQ
4809,14-02-2021 00:00,24 hrs.,pennystocks,BRQS,8,8,0,8,1,0,4,1,NASDAQ
4809,14-02-2021 00:00,24 hrs.,pennystocks,BWEN,12,0,12,-12,2,2,0,2,NASDAQ
4809,14-02-2021 00:00,24 hrs.,pennystocks,BXRX,12,12,0,12,2,2,0,2,NASDAQ
4809,14-02-2021 00:00,24 hrs.,pennystocks,CCNC,8,8,0,8,1,0,4,1,NASDAQ
4809,14-02-2021 00:00,24 hrs.,pennystocks,CHEK,114,114,0,114,1,44,22,1,NASDAQ
4809,14-02-2021 00:00,24 hrs.,pennystocks,CLBS,145,94,51,43,3,51,31,3,NASDAQ
4809,14-02-2021 00:00,24 hrs.,pennystocks,CMPS,20,0,20,-20,1,3,10,1,NASDAQ
4809,14-02-2021 00:00,24 hrs.,pennystocks,CSTR,8,8,0,8,1,0,4,1,NASDAQ
4809,14-02-2021 00:00,24 hrs.,pennystocks,CTRM,328,257,71,186,6,104,96,6,NASDAQ
4809,14-02-2021 00:00,24 hrs.,pennystocks,DFFN,78,51,27,24,4,25,12,4,NASDAQ
4809,14-02-2021 00:00,24 hrs.,pennystocks,ASX,9,9,0,9,1,1,3,1,NYSE
4809,14-02-2021 00:00,24 hrs.,pennystocks,AXL,6,0,6,-6,1,0,2,1,NYSE
4809,14-02-2021 00:00,24 hrs.,pennystocks,CBD,314,286,28,258,3,122,58,3,NYSE
4809,14-02-2021 00:00,24 hrs.,pennystocks,FLT,18,18,0,18,1,4,6,1,NYSE
4809,14-02-2021 00:00,24 hrs.,pennystocks,FSD,12,12,0,12,1,2,4,1,NYSE
4809,14-02-2021 00:00,24 hrs.,pennystocks,GME,6,6,0,6,1,1,0,1,NYSE
4809,14-02-2021 00:00,24 hrs.,pennystocks,KOF,13,13,0,13,1,3,3,1,NYSE
4809,14-02-2021 00:00,24 hrs.,pennystocks,LOW,6,0,6,-6,1,1,0,1,NYSE
4809,14-02-2021 00:00,24 hrs.,pennystocks,MED,6,0,6,-6,1,1,0,1,NYSE
4809,14-02-2021 00:00,24 hrs.,pennystocks,MIN,6,0,6,-6,1,1,0,1,NYSE
4809,14-02-2021 00:00,24 hrs.,pennystocks,NGL,2031,2031,0,2031,2,964,95,2,NYSE
4809,14-02-2021 00:00,24 hrs.,pennystocks,NOK,207,207,0,207,1,75,53,1,NYSE
4809,14-02-2021 00:00,24 hrs.,pennystocks,TSNP,142,58,84,-26,3,38,54,2,OTC
4809,14-02-2021 00:00,24 hrs.,pennystocks,TVPC,6,6,0,6,1,1,0,1,OTC
4809,14-02-2021 00:00,24 hrs.,pennystocks,TXTM,7,0,7,-7,1,1,1,1,OTC
4809,14-02-2021 00:00,24 hrs.,pennystocks,UAPC,25,19,6,13,2,1,15,2,OTC
4809,14-02-2021 00:00,24 hrs.,pennystocks,VPER,72,0,72,-72,1,14,40,1,OTC
4809,14-02-2021 00:00,24 hrs.,pennystocks,VSPC,21,15,6,9,2,5,3,2,OTC
4809,14-02-2021 00:00,24 hrs.,pennystocks,WEBB,60,60,0,60,1,25,6,1,OTC
4809,14-02-2021 00:00,24 hrs.,wallstreetbets,SFOR,7,0,7,-7,1,1,1,1,OTC
4809,14-02-2021 00:00,24 hrs.,wallstreetbets,SGMD,21,21,0,21,3,3,3,2,OTC
4809,14-02-2021 00:00,24 hrs.,wallstreetbets,SHWZ,7,0,7,-7,1,1,1,1,OTC
4809,14-02-2021 00:00,24 hrs.,wallstreetbets,SIGN,14,0,14,-14,2,2,2,1,OTC
4809,14-02-2021 00:00,24 hrs.,wallstreetbets,SNDD,7,0,7,-7,1,1,1,1,OTC
4809,14-02-2021 00:00,24 hrs.,wallstreetbets,SNRS,7,0,7,-7,1,1,1,1,OTC
4809,14-02-2021 00:00,24 hrs.,pennystocks,RWLK,30,30,0,30,1,12,2,1,NASDAQ
4809,14-02-2021 00:00,24 hrs.,pennystocks,SALM,30,30,0,30,1,12,2,1,NASDAQ
4809,14-02-2021 00:00,24 hrs.,pennystocks,SEAC,5,0,5,-5,1,0,1,1,NASDAQ
4809,14-02-2021 00:00,24 hrs.,pennystocks,SHIP,30,30,0,30,1,12,2,1,NASDAQ
4809,14-02-2021 00:00,24 hrs.,pennystocks,SNDL,61,55,6,49,9,9,7,4,NASDAQ
4809,14-02-2021 00:00,24 hrs.,pennystocks,SNGX,38,19,19,0,6,6,2,5,NASDAQ
4809,14-02-2021 00:00,24 hrs.,pennystocks,TBLT,194,0,194,-194,1,71,48,1,NASDAQ
4809,14-02-2021 00:00,24 hrs.,pennystocks,TLRY,286,286,0,286,1,113,56,1,NASDAQ
4809,14-02-2021 00:00,24 hrs.,pennystocks,TNXP,185,12,173,-161,3,72,29,3,NASDAQ
4809,14-02-2021 00:00,24 hrs.,pennystocks,TOPS,30,30,0,30,1,12,2,1,NASDAQ
4809,14-02-2021 00:00,24 hrs.,pennystocks,TRCH,200,0,200,-200,2,72,48,2,NASDAQ
4809,14-02-2021 00:00,24 hrs.,pennystocks,TRIP,30,0,30,-30,1,7,12,1,NASDAQ
4809,14-02-2021 00:00,24 hrs.,pennystocks,TRVG,43,43,0,43,3,14,3,3,NASDAQ
4809,14-02-2021 00:00,24 hrs.,pennystocks,TXMD,13,7,6,1,2,2,1,2,NASDAQ
4809,14-02-2021 00:00,24 hrs.,pennystocks,USWS,6,6,0,6,1,1,0,1,NASDAQ
4809,14-02-2021 00:00,24 hrs.,pennystocks,VTGN,7,0,7,-7,1,1,1,1,NASDAQ
4809,14-02-2021 00:00,24 hrs.,pennystocks,EDIT,945,803,142,661,2,208,521,2,NASDAQ
4809,14-02-2021 00:00,24 hrs.,pennystocks,EYES,6,6,0,6,1,1,0,1,NASDAQ
4809,14-02-2021 00:00,24 hrs.,pennystocks,FLMN,6,6,0,6,1,1,0,1,NASDAQ
4809,14-02-2021 00:00,24 hrs.,pennystocks,FORD,93,93,0,93,1,38,13,1,NASDAQ
4809,14-02-2021 00:00,24 hrs.,pennystocks,FTFT,30,30,0,30,1,12,2,1,NASDAQ
4809,14-02-2021 00:00,24 hrs.,pennystocks,GNPX,6,0,6,-6,1,0,2,1,NASDAQ
4809,14-02-2021 00:00,24 hrs.,pennystocks,GNUS,18,12,6,6,3,3,0,3,NASDAQ
4809,14-02-2021 00:00,24 hrs.,pennystocks,GOOG,7,0,7,-7,1,0,3,1,NASDAQ
4809,14-02-2021 00:00,24 hrs.,pennystocks,GRIL,30,30,0,30,1,12,2,1,NASDAQ
4809,14-02-2021 00:00,24 hrs.,pennystocks,HUSN,30,30,0,30,1,12,2,1,NASDAQ
4809,14-02-2021 00:00,24 hrs.,pennystocks,ICON,14,14,0,14,1,3,4,1,NASDAQ
4809,14-02-2021 00:00,24 hrs.,pennystocks,IDEX,6,0,6,-6,1,0,2,1,NASDAQ
4809,14-02-2021 00:00,24 hrs.,pennystocks,ILMN,30,30,0,30,1,12,2,1,NASDAQ
4809,14-02-2021 00:00,24 hrs.,pennystocks,INPX,6,0,6,-6,1,1,0,1,NASDAQ
4809,14-02-2021 00:00,24 hrs.,pennystocks,ITRM,7,7,0,7,1,1,1,1,NASDAQ
4809,14-02-2021 00:00,24 hrs.,pennystocks,IZEA,8,8,0,8,1,0,4,1,NASDAQ
4809,14-02-2021 00:00,24 hrs.,pennystocks,LGHL,38,38,0,38,2,12,6,2,NASDAQ
4809,14-02-2021 00:00,24 hrs.,pennystocks,LIFE,6,0,6,-6,1,1,0,1,NASDAQ
4809,14-02-2021 00:00,24 hrs.,pennystocks,LIVE,20,20,0,20,1,6,4,1,NASDAQ
4809,14-02-2021 00:00,24 hrs.,pennystocks,LIVX,6,0,6,-6,1,1,0,1,NASDAQ
4809,14-02-2021 00:00,24 hrs.,pennystocks,LKCO,30,30,0,30,1,12,2,1,NASDAQ
4809,14-02-2021 00:00,24 hrs.,pennystocks,LLIT,7,0,7,-7,1,1,1,1,NASDAQ
4809,14-02-2021 00:00,24 hrs.,pennystocks,LLNW,6,6,0,6,1,1,0,1,NASDAQ
4809,14-02-2021 00:00,24 hrs.,pennystocks,LPTX,51,0,51,-51,1,10,27,1,NASDAQ
4809,14-02-2021 00:00,24 hrs.,pennystocks,MOGO,56,26,30,-4,2,12,24,2,NASDAQ
4809,14-02-2021 00:00,24 hrs.,pennystocks,MOSY,30,30,0,30,1,12,2,1,NASDAQ
4809,14-02-2021 00:00,24 hrs.,pennystocks,MVIS,14,0,14,-14,1,0,10,1,NASDAQ
4809,14-02-2021 00:00,24 hrs.,pennystocks,NAKD,1224,6,1218,-1212,2,533,150,2,NASDAQ
4809,14-02-2021 00:00,24 hrs.,pennystocks,NMTR,6,0,6,-6,1,1,0,1,NASDAQ
4809,14-02-2021 00:00,24 hrs.,pennystocks,NVCN,19,13,6,7,3,3,1,3,NASDAQ
4809,14-02-2021 00:00,24 hrs.,pennystocks,OCGN,49,43,6,37,2,13,15,2,NASDAQ
4809,14-02-2021 00:00,24 hrs.,pennystocks,OPGN,7,7,0,7,1,1,1,1,NASDAQ
4809,14-02-2021 00:00,24 hrs.,pennystocks,OPTT,12,12,0,12,2,2,0,2,NASDAQ
4809,14-02-2021 00:00,24 hrs.,pennystocks,PBTS,83,83,0,83,1,22,35,1,NASDAQ
4809,14-02-2021 00:00,24 hrs.,pennystocks,PGEN,6,6,0,6,1,1,0,1,NASDAQ
4809,14-02-2021 00:00,24 hrs.,pennystocks,PHUN,8,8,0,8,1,0,4,1,NASDAQ
4809,14-02-2021 00:00,24 hrs.,pennystocks,PLAY,6,6,0,6,1,1,0,1,NASDAQ
4809,14-02-2021 00:00,24 hrs.,pennystocks,PSEC,6,6,0,6,1,1,0,1,NASDAQ
4809,14-02-2021 00:00,24 hrs.,pennystocks,PSTV,6,6,0,6,1,1,0,1,NASDAQ
4809,14-02-2021 00:00,24 hrs.,pennystocks,PTON,44,0,44,-44,1,16,8,1,NASDAQ
4809,14-02-2021 00:00,24 hrs.,pennystocks,PULM,6,6,0,6,1,1,0,1,NASDAQ
4809,14-02-2021 00:00,24 hrs.,pennystocks,RAVE,30,30,0,30,1,12,2,1,NASDAQ
4809,14-02-2021 00:00,24 hrs.,wallstreetbets,SRMX,14,14,0,14,2,2,2,1,OTC
4809,14-02-2021 00:00,24 hrs.,wallstreetbets,TCHH,6,0,6,-6,1,1,0,1,OTC
4809,14-02-2021 00:00,24 hrs.,wallstreetbets,TSNP,7,0,7,-7,1,1,1,1,OTC
4809,14-02-2021 00:00,24 hrs.,wallstreetbets,USDC,13,0,13,-13,2,2,1,2,OTC
4809,14-02-2021 00:00,24 hrs.,wallstreetbets,USPS,2079,2073,6,2067,3,917,233,3,OTC
4809,14-02-2021 00:00,24 hrs.,wallstreetbets,WGNR,8,8,0,8,1,1,2,1,OTC
4809,14-02-2021 00:00,24 hrs.,pennystocks,VUZI,6,0,6,-6,1,0,2,1,NASDAQ
4809,14-02-2021 00:00,24 hrs.,pennystocks,XSPA,24,24,0,24,4,4,0,3,NASDAQ
4809,14-02-2021 00:00,24 hrs.,pennystocks,YMTX,15,15,0,15,1,3,5,1,NASDAQ
4809,14-02-2021 00:00,24 hrs.,pennystocks,ZKIN,8,8,0,8,1,0,4,1,NASDAQ
4809,14-02-2021 00:00,24 hrs.,pennystocks,ZSAN,6,6,0,6,1,1,0,1,NASDAQ
4809,14-02-2021 00:00,24 hrs.,wallstreetbets,ACRL,6,6,0,6,1,1,0,1,OTC
4809,14-02-2021 00:00,24 hrs.,wallstreetbets,AITX,30,7,23,-16,3,2,14,3,OTC
4809,14-02-2021 00:00,24 hrs.,wallstreetbets,ASTI,7,0,7,-7,1,1,1,1,OTC
4809,14-02-2021 00:00,24 hrs.,wallstreetbets,BANT,13,6,7,-1,2,2,1,2,OTC
4809,14-02-2021 00:00,24 hrs.,wallstreetbets,BBRW,20,0,20,-20,3,3,2,1,OTC
4809,14-02-2021 00:00,24 hrs.,wallstreetbets,BLSP,7,0,7,-7,1,1,1,1,OTC
4809,14-02-2021 00:00,24 hrs.,wallstreetbets,BOTY,6,0,6,-6,1,1,0,1,OTC
4809,14-02-2021 00:00,24 hrs.,wallstreetbets,BRLL,7,7,0,7,1,1,1,1,OTC
4809,14-02-2021 00:00,24 hrs.,wallstreetbets,BRSE,9,9,0,9,1,2,1,1,OTC
4809,14-02-2021 00:00,24 hrs.,wallstreetbets,BRZL,7,7,0,7,1,1,1,1,OTC
4809,14-02-2021 00:00,24 hrs.,wallstreetbets,CAGR,276,276,0,276,2,81,106,2,OTC
4809,14-02-2021 00:00,24 hrs.,wallstreetbets,CCTL,7,7,0,7,1,1,1,1,OTC
4809,14-02-2021 00:00,24 hrs.,wallstreetbets,DROP,2252,2252,0,2252,1,1069,110,1,OTC
4809,14-02-2021 00:00,24 hrs.,wallstreetbets,ECOX,14,14,0,14,2,2,2,1,OTC
4809,14-02-2021 00:00,24 hrs.,wallstreetbets,EFIR,7,0,7,-7,1,1,1,1,OTC
4809,14-02-2021 00:00,24 hrs.,wallstreetbets,ELTP,7,0,7,-7,1,1,1,1,OTC
4809,14-02-2021 00:00,24 hrs.,wallstreetbets,EPOR,8,0,8,-8,1,1,2,1,OTC
4809,14-02-2021 00:00,24 hrs.,wallstreetbets,FNMA,21,14,7,7,3,3,3,2,OTC
4809,14-02-2021 00:00,24 hrs.,wallstreetbets,GAHC,14,0,14,-14,2,2,2,1,OTC
4809,14-02-2021 00:00,24 hrs.,wallstreetbets,GPFT,6,6,0,6,1,1,0,1,OTC
4809,14-02-2021 00:00,24 hrs.,wallstreetbets,GRNH,7,0,7,-7,1,1,1,1,OTC
4809,14-02-2021 00:00,24 hrs.,wallstreetbets,GTLL,6,0,6,-6,1,1,0,1,OTC
4809,14-02-2021 00:00,24 hrs.,wallstreetbets,HCMC,198,137,61,76,29,29,24,20,OTC
4809,14-02-2021 00:00,24 hrs.,wallstreetbets,HEMP,20,14,6,8,3,3,2,2,OTC
4809,14-02-2021 00:00,24 hrs.,wallstreetbets,HGLC,14,0,14,-14,2,2,2,1,OTC
4809,14-02-2021 00:00,24 hrs.,wallstreetbets,HTRE,7,0,7,-7,1,1,1,1,OTC
4809,14-02-2021 00:00,24 hrs.,wallstreetbets,HYSR,7,0,7,-7,1,1,1,1,OTC
4809,14-02-2021 00:00,24 hrs.,wallstreetbets,IDEA,89,89,0,89,1,32,21,1,OTC
4809,14-02-2021 00:00,24 hrs.,wallstreetbets,INND,14,14,0,14,2,2,2,1,OTC
4809,14-02-2021 00:00,24 hrs.,wallstreetbets,INTV,7,0,7,-7,1,1,1,1,OTC
4809,14-02-2021 00:00,24 hrs.,wallstreetbets,IQST,8,8,0,8,1,1,2,1,OTC
4809,14-02-2021 00:00,24 hrs.,wallstreetbets,KGET,7,7,0,7,1,1,1,1,OTC
4809,14-02-2021 00:00,24 hrs.,wallstreetbets,KWBT,6,6,0,6,1,1,0,1,OTC
4809,14-02-2021 00:00,24 hrs.,wallstreetbets,LINK,919,919,0,919,3,428,51,3,OTC
4809,14-02-2021 00:00,24 hrs.,wallstreetbets,LQMT,7,0,7,-7,1,1,1,1,OTC
4809,14-02-2021 00:00,24 hrs.,wallstreetbets,LRDG,14,0,14,-14,2,2,2,1,OTC
4809,14-02-2021 00:00,24 hrs.,wallstreetbets,MDCN,14,14,0,14,2,2,2,1,OTC
4809,14-02-2021 00:00,24 hrs.,wallstreetbets,MINE,7,7,0,7,1,1,1,1,OTC
4809,14-02-2021 00:00,24 hrs.,wallstreetbets,MJNA,7,0,7,-7,1,1,1,1,OTC
4809,14-02-2021 00:00,24 hrs.,wallstreetbets,MKTY,7,7,0,7,1,1,1,1,OTC
4809,14-02-2021 00:00,24 hrs.,wallstreetbets,MLFB,7,0,7,-7,1,1,1,1,OTC
4809,14-02-2021 00:00,24 hrs.,wallstreetbets,MNGG,6,0,6,-6,1,1,0,1,OTC
4809,14-02-2021 00:00,24 hrs.,wallstreetbets,MOST,906,906,0,906,1,426,50,1,OTC
4809,14-02-2021 00:00,24 hrs.,wallstreetbets,MRMD,8,8,0,8,1,1,2,1,OTC
4809,14-02-2021 00:00,24 hrs.,wallstreetbets,MTVX,7,7,0,7,1,1,1,1,OTC
4809,14-02-2021 00:00,24 hrs.,wallstreetbets,NOVC,6,6,0,6,1,1,0,1,OTC
4809,14-02-2021 00:00,24 hrs.,wallstreetbets,ONCX,7,7,0,7,1,1,1,1,OTC
4809,14-02-2021 00:00,24 hrs.,wallstreetbets,PBHG,7,7,0,7,1,1,1,1,OTC
4809,14-02-2021 00:00,24 hrs.,wallstreetbets,PSYC,7,7,0,7,1,1,1,1,OTC
4809,14-02-2021 00:00,24 hrs.,wallstreetbets,RBDC,7,7,0,7,1,1,1,1,OTC
4809,14-02-2021 00:00,24 hrs.,wallstreetbets,RTON,6,0,6,-6,1,1,0,1,OTC
4809,14-02-2021 00:00,24 hrs.,wallstreetbets,SANP,28,28,0,28,4,4,4,1,OTC
4809,14-02-2021 00:00,24 hrs.,wallstreetbets,SBFM,7,0,7,-7,1,1,1,1,OTC
4773,13-02-2021 18:00,24 hrs.,wallstreetbets,NOVC,6,6,0,6,1,1,0,1,OTC
4773,13-02-2021 18:00,24 hrs.,wallstreetbets,NPHC,7,0,7,-7,1,1,1,1,OTC
4773,13-02-2021 18:00,24 hrs.,wallstreetbets,OWPC,6,0,6,-6,1,1,0,1,OTC
4773,13-02-2021 18:00,24 hrs.,wallstreetbets,OZSC,14,0,14,-14,2,2,2,2,OTC
4773,13-02-2021 18:00,24 hrs.,wallstreetbets,PHBI,14,0,14,-14,2,2,2,1,OTC
4773,13-02-2021 18:00,24 hrs.,wallstreetbets,RBDC,7,7,0,7,1,1,1,1,OTC
4773,13-02-2021 18:00,24 hrs.,wallstreetbets,RTON,6,0,6,-6,1,1,0,1,OTC
4773,13-02-2021 18:00,24 hrs.,wallstreetbets,SANP,21,21,0,21,3,3,3,1,OTC
4773,13-02-2021 18:00,24 hrs.,wallstreetbets,SBFM,7,0,7,-7,1,1,1,1,OTC
4773,13-02-2021 18:00,24 hrs.,wallstreetbets,SFOR,7,0,7,-7,1,1,1,1,OTC
4773,13-02-2021 18:00,24 hrs.,wallstreetbets,SHMP,7,0,7,-7,1,1,1,1,OTC
4773,13-02-2021 18:00,24 hrs.,wallstreetbets,SHWZ,7,0,7,-7,1,1,1,1,OTC
4773,13-02-2021 18:00,24 hrs.,wallstreetbets,SIGN,21,0,21,-21,3,3,3,2,OTC
4773,13-02-2021 18:00,24 hrs.,wallstreetbets,SIMP,7,0,7,-7,1,1,1,1,OTC
4773,13-02-2021 18:00,24 hrs.,wallstreetbets,SIRR,7,0,7,-7,1,1,1,1,OTC
4773,13-02-2021 18:00,24 hrs.,wallstreetbets,SNDD,7,0,7,-7,1,1,1,1,OTC
4773,13-02-2021 18:00,24 hrs.,wallstreetbets,SNRS,7,0,7,-7,1,1,1,1,OTC
4773,13-02-2021 18:00,24 hrs.,pennystocks,TRCH,265,0,265,-265,5,88,69,5,NASDAQ
4773,13-02-2021 18:00,24 hrs.,pennystocks,TRIP,22,22,0,22,1,4,10,1,NASDAQ
4773,13-02-2021 18:00,24 hrs.,pennystocks,TRVG,14,7,7,0,2,2,2,2,NASDAQ
4773,13-02-2021 18:00,24 hrs.,pennystocks,TXMD,6,0,6,-6,1,1,0,1,NASDAQ
4773,13-02-2021 18:00,24 hrs.,pennystocks,TYME,18,0,18,-18,1,5,4,1,NASDAQ
4773,13-02-2021 18:00,24 hrs.,pennystocks,VETS,1784,0,1784,-1784,1,757,266,1,NASDAQ
4773,13-02-2021 18:00,24 hrs.,pennystocks,VTGN,7,0,7,-7,1,1,1,1,NASDAQ
4773,13-02-2021 18:00,24 hrs.,pennystocks,VUZI,6,0,6,-6,1,0,2,1,NASDAQ
4773,13-02-2021 18:00,24 hrs.,pennystocks,XSPA,18,18,0,18,3,3,0,2,NASDAQ
4773,13-02-2021 18:00,24 hrs.,wallstreetbets,ACRL,6,6,0,6,1,1,0,1,OTC
4773,13-02-2021 18:00,24 hrs.,wallstreetbets,ACTX,8,0,8,-8,1,1,2,1,OTC
4773,13-02-2021 18:00,24 hrs.,wallstreetbets,AITX,23,16,7,9,2,1,13,2,OTC
4773,13-02-2021 18:00,24 hrs.,wallstreetbets,ALYI,7,0,7,-7,1,1,1,1,OTC
4773,13-02-2021 18:00,24 hrs.,wallstreetbets,APCX,7,0,7,-7,1,1,1,1,OTC
4773,13-02-2021 18:00,24 hrs.,wallstreetbets,ASTI,7,0,7,-7,1,1,1,1,OTC
4773,13-02-2021 18:00,24 hrs.,wallstreetbets,BANT,7,0,7,-7,1,1,1,1,OTC
4773,13-02-2021 18:00,24 hrs.,wallstreetbets,BBRW,20,6,14,-8,3,3,2,2,OTC
4773,13-02-2021 18:00,24 hrs.,wallstreetbets,BLSP,28,0,28,-28,4,4,4,2,OTC
4773,13-02-2021 18:00,24 hrs.,wallstreetbets,BOTH,7,0,7,-7,1,1,1,1,OTC
4773,13-02-2021 18:00,24 hrs.,wallstreetbets,BOTY,6,6,0,6,1,1,0,1,OTC
4773,13-02-2021 18:00,24 hrs.,wallstreetbets,BRLL,14,7,7,0,2,2,2,2,OTC
4773,13-02-2021 18:00,24 hrs.,wallstreetbets,BRZL,7,7,0,7,1,1,1,1,OTC
4773,13-02-2021 18:00,24 hrs.,wallstreetbets,CBDL,34,0,34,-34,5,5,4,4,OTC
4773,13-02-2021 18:00,24 hrs.,wallstreetbets,CGLD,7,0,7,-7,1,1,1,1,OTC
4773,13-02-2021 18:00,24 hrs.,wallstreetbets,CLIS,14,0,14,-14,2,2,2,1,OTC
4773,13-02-2021 18:00,24 hrs.,wallstreetbets,COMS,19,0,19,-19,3,3,1,2,OTC
4773,13-02-2021 18:00,24 hrs.,wallstreetbets,EFIR,7,7,0,7,1,1,1,1,OTC
4773,13-02-2021 18:00,24 hrs.,wallstreetbets,ELTP,7,0,7,-7,1,1,1,1,OTC
4773,13-02-2021 18:00,24 hrs.,wallstreetbets,EPOR,8,0,8,-8,1,1,2,1,OTC
4773,13-02-2021 18:00,24 hrs.,wallstreetbets,ETFM,17,0,17,-17,2,2,5,1,OTC
4773,13-02-2021 18:00,24 hrs.,wallstreetbets,FNMA,7,0,7,-7,1,1,1,1,OTC
4773,13-02-2021 18:00,24 hrs.,wallstreetbets,FTEG,7,0,7,-7,1,1,1,1,OTC
4773,13-02-2021 18:00,24 hrs.,wallstreetbets,GAHC,14,0,14,-14,2,2,2,1,OTC
4773,13-02-2021 18:00,24 hrs.,wallstreetbets,GARB,7,0,7,-7,1,1,1,1,OTC
4773,13-02-2021 18:00,24 hrs.,wallstreetbets,GMEV,7,0,7,-7,1,1,1,1,OTC
4773,13-02-2021 18:00,24 hrs.,wallstreetbets,GPFT,14,0,14,-14,2,2,2,2,OTC
4773,13-02-2021 18:00,24 hrs.,wallstreetbets,GRNH,7,7,0,7,1,1,1,1,OTC
4773,13-02-2021 18:00,24 hrs.,wallstreetbets,GTCH,7,0,7,-7,1,1,1,1,OTC
4773,13-02-2021 18:00,24 hrs.,wallstreetbets,GTEH,20,0,20,-20,3,3,2,2,OTC
4773,13-02-2021 18:00,24 hrs.,wallstreetbets,GTLL,6,0,6,-6,1,1,0,1,OTC
4773,13-02-2021 18:00,24 hrs.,wallstreetbets,GTXO,14,0,14,-14,2,2,2,1,OTC
4773,13-02-2021 18:00,24 hrs.,wallstreetbets,HCMC,236,112,124,-12,34,34,32,28,OTC
4773,13-02-2021 18:00,24 hrs.,wallstreetbets,HEMP,27,14,13,1,4,4,3,3,OTC
4773,13-02-2021 18:00,24 hrs.,wallstreetbets,HGLC,14,0,14,-14,2,2,2,1,OTC
4773,13-02-2021 18:00,24 hrs.,wallstreetbets,HMNY,28,0,28,-28,4,4,4,2,OTC
4773,13-02-2021 18:00,24 hrs.,wallstreetbets,HQGE,14,0,14,-14,2,2,2,2,OTC
4773,13-02-2021 18:00,24 hrs.,wallstreetbets,HTRE,7,0,7,-7,1,1,1,1,OTC
4773,13-02-2021 18:00,24 hrs.,wallstreetbets,DPW,14,0,14,-14,2,2,2,2,AMEX
4773,13-02-2021 18:00,24 hrs.,wallstreetbets,GTE,53,6,47,-41,8,8,5,5,AMEX
4773,13-02-2021 18:00,24 hrs.,wallstreetbets,MCF,7,7,0,7,1,1,1,1,AMEX
4773,13-02-2021 18:00,24 hrs.,wallstreetbets,MSN,7,0,7,-7,1,1,1,1,AMEX
4773,13-02-2021 18:00,24 hrs.,wallstreetbets,MXC,7,7,0,7,1,1,1,1,AMEX
4773,13-02-2021 18:00,24 hrs.,wallstreetbets,MYO,7,0,7,-7,1,1,1,1,AMEX
4773,13-02-2021 18:00,24 hrs.,wallstreetbets,NAK,28,0,28,-28,4,5,2,4,AMEX
4773,13-02-2021 18:00,24 hrs.,wallstreetbets,NBY,6,6,0,6,1,1,0,1,AMEX
4773,13-02-2021 18:00,24 hrs.,wallstreetbets,REI,6,6,0,6,1,1,0,1,AMEX
4773,13-02-2021 18:00,24 hrs.,wallstreetbets,TGB,6,0,6,-6,1,1,0,1,AMEX
4773,13-02-2021 18:00,24 hrs.,wallstreetbets,TRX,14,7,7,0,2,2,2,2,AMEX
4773,13-02-2021 18:00,24 hrs.,wallstreetbets,UUU,6,0,6,-6,1,1,0,1,AMEX
4773,13-02-2021 18:00,24 hrs.,wallstreetbets,ZOM,230,33,197,-164,12,68,46,11,AMEX
4773,13-02-2021 18:00,24 hrs.,wallstreetbets,AMPE,20,0,20,-20,3,3,2,2,AMEX
4773,13-02-2021 18:00,24 hrs.,wallstreetbets,CRMD,7,0,7,-7,1,1,1,1,AMEX
4773,13-02-2021 18:00,24 hrs.,wallstreetbets,EMAN,7,0,7,-7,1,1,1,1,AMEX
4773,13-02-2021 18:00,24 hrs.,wallstreetbets,GOED,20,6,14,-8,3,3,2,3,AMEX
4773,13-02-2021 18:00,24 hrs.,wallstreetbets,GSAT,26,0,26,-26,4,4,2,3,AMEX
4773,13-02-2021 18:00,24 hrs.,wallstreetbets,LODE,7,0,7,-7,1,1,1,1,AMEX
4773,13-02-2021 18:00,24 hrs.,wallstreetbets,OGEN,6,0,6,-6,1,1,0,1,AMEX
4773,13-02-2021 18:00,24 hrs.,wallstreetbets,SENS,353,7,346,-339,11,104,101,7,AMEX
4773,13-02-2021 18:00,24 hrs.,wallstreetbets,TMBR,34,0,34,-34,5,5,4,1,AMEX
4773,13-02-2021 18:00,24 hrs.,wallstreetbets,UAVS,27,20,7,13,4,4,3,3,AMEX
4773,13-02-2021 18:00,24 hrs.,wallstreetbets,SNYR,14,0,14,-14,2,2,2,1,OTC
4773,13-02-2021 18:00,24 hrs.,wallstreetbets,SRMX,20,14,6,8,3,3,2,2,OTC
4773,13-02-2021 18:00,24 hrs.,wallstreetbets,TCHH,6,6,0,6,1,1,0,1,OTC
4773,13-02-2021 18:00,24 hrs.,wallstreetbets,TGLO,7,0,7,-7,1,1,1,1,OTC
4773,13-02-2021 18:00,24 hrs.,wallstreetbets,TRTC,7,0,7,-7,1,1,1,1,OTC
4773,13-02-2021 18:00,24 hrs.,wallstreetbets,TSNP,7,0,7,-7,1,1,1,1,OTC
4773,13-02-2021 18:00,24 hrs.,wallstreetbets,UBQU,7,0,7,-7,1,1,1,1,OTC
4773,13-02-2021 18:00,24 hrs.,wallstreetbets,USDC,21,7,14,-7,3,3,3,3,OTC
4773,13-02-2021 18:00,24 hrs.,wallstreetbets,USPS,144,138,6,132,2,51,34,2,OTC
4773,13-02-2021 18:00,24 hrs.,wallstreetbets,VYST,6,0,6,-6,1,1,0,1,OTC
4773,13-02-2021 18:00,24 hrs.,wallstreetbets,WDLF,7,0,7,-7,1,1,1,1,OTC
4773,13-02-2021 18:00,24 hrs.,wallstreetbets,WGNR,8,8,0,8,1,1,2,1,OTC
4773,13-02-2021 18:00,24 hrs.,wallstreetbets,WHEN,7,0,7,-7,1,1,1,1,OTC
4773,13-02-2021 18:00,24 hrs.,wallstreetbets,XFLS,4,4,0,4,1,0,0,1,OTC
4773,13-02-2021 18:00,24 hrs.,wallstreetbets,YRIV,21,0,21,-21,1,4,9,1,OTC
4773,13-02-2021 18:00,24 hrs.,wallstreetbets,AGFAF,7,7,0,7,1,1,1,1,OTC
4773,13-02-2021 18:00,24 hrs.,wallstreetbets,AGUNF,6,0,6,-6,1,1,0,1,OTC
4773,13-02-2021 18:00,24 hrs.,wallstreetbets,ARBKF,6,0,6,-6,1,1,0,1,OTC
4773,13-02-2021 18:00,24 hrs.,wallstreetbets,AZKLF,18,0,18,-18,3,3,0,1,OTC
4773,13-02-2021 18:00,24 hrs.,wallstreetbets,HYSR,20,0,20,-20,3,3,2,3,OTC
4773,13-02-2021 18:00,24 hrs.,wallstreetbets,INCT,14,0,14,-14,2,2,2,1,OTC
4773,13-02-2021 18:00,24 hrs.,wallstreetbets,INKW,7,0,7,-7,1,1,1,1,OTC
4773,13-02-2021 18:00,24 hrs.,wallstreetbets,INND,28,14,14,0,4,4,4,2,OTC
4773,13-02-2021 18:00,24 hrs.,wallstreetbets,INTV,14,0,14,-14,2,2,2,2,OTC
4773,13-02-2021 18:00,24 hrs.,wallstreetbets,IQST,13,0,13,-13,2,2,1,1,OTC
4773,13-02-2021 18:00,24 hrs.,wallstreetbets,KGET,7,7,0,7,1,1,1,1,OTC
4773,13-02-2021 18:00,24 hrs.,wallstreetbets,LINK,336,323,13,310,4,141,38,4,OTC
4773,13-02-2021 18:00,24 hrs.,wallstreetbets,LQMT,7,0,7,-7,1,1,1,1,OTC
4773,13-02-2021 18:00,24 hrs.,wallstreetbets,LRDG,14,0,14,-14,2,2,2,1,OTC
4773,13-02-2021 18:00,24 hrs.,wallstreetbets,LTUM,6,0,6,-6,1,1,0,1,OTC
4773,13-02-2021 18:00,24 hrs.,wallstreetbets,MAXD,22,0,22,-22,3,3,4,3,OTC
4773,13-02-2021 18:00,24 hrs.,wallstreetbets,MGNT,7,0,7,-7,1,1,1,1,OTC
4773,13-02-2021 18:00,24 hrs.,wallstreetbets,MINE,20,0,20,-20,3,3,2,3,OTC
4773,13-02-2021 18:00,24 hrs.,wallstreetbets,MJNA,14,7,7,0,2,2,2,2,OTC
4773,13-02-2021 18:00,24 hrs.,wallstreetbets,MKTY,14,7,7,0,2,2,2,2,OTC
4773,13-02-2021 18:00,24 hrs.,wallstreetbets,MLFB,7,7,0,7,1,1,1,1,OTC
4773,13-02-2021 18:00,24 hrs.,wallstreetbets,MNGG,6,0,6,-6,1,1,0,1,OTC
4773,13-02-2021 18:00,24 hrs.,wallstreetbets,MOJO,6,0,6,-6,1,1,0,1,OTC
4773,13-02-2021 18:00,24 hrs.,wallstreetbets,MOST,374,317,57,260,5,156,42,5,OTC
4773,13-02-2021 18:00,24 hrs.,wallstreetbets,MRMD,8,8,0,8,1,1,2,1,OTC
4773,13-02-2021 18:00,24 hrs.,wallstreetbets,NEOM,14,0,14,-14,2,2,2,1,OTC
4773,13-02-2021 18:00,24 hrs.,wallstreetbets,FRO,13,0,13,-13,2,2,1,1,NYSE
4773,13-02-2021 18:00,24 hrs.,wallstreetbets,FSR,193,145,48,97,9,58,41,6,NYSE
4773,13-02-2021 18:00,24 hrs.,wallstreetbets,FUN,7,7,0,7,1,1,1,1,NYSE
4773,13-02-2021 18:00,24 hrs.,wallstreetbets,GEO,21,7,14,-7,3,3,3,2,NYSE
4773,13-02-2021 18:00,24 hrs.,wallstreetbets,GME,164508,93117,71391,21726,342,76470,10200,245,NYSE
4773,13-02-2021 18:00,24 hrs.,wallstreetbets,GNT,14,14,0,14,2,2,2,1,NYSE
4773,13-02-2021 18:00,24 hrs.,wallstreetbets,GSX,7,7,0,7,1,1,1,1,NYSE
4773,13-02-2021 18:00,24 hrs.,wallstreetbets,HMC,42,0,42,-42,1,13,12,1,NYSE
4773,13-02-2021 18:00,24 hrs.,wallstreetbets,HSY,8,0,8,-8,1,1,2,1,NYSE
4773,13-02-2021 18:00,24 hrs.,wallstreetbets,IBM,11145,1005,10140,-9135,7,5217,683,7,NYSE
4773,13-02-2021 18:00,24 hrs.,wallstreetbets,ICE,179,0,179,-179,1,55,65,1,NYSE
4773,13-02-2021 18:00,24 hrs.,wallstreetbets,IGT,324,317,7,310,2,139,38,2,NYSE
4773,13-02-2021 18:00,24 hrs.,wallstreetbets,IRS,12,0,12,-12,2,2,0,2,NYSE
4773,13-02-2021 18:00,24 hrs.,wallstreetbets,IVR,14,0,14,-14,2,2,2,2,NYSE
4773,13-02-2021 18:00,24 hrs.,wallstreetbets,JNJ,6,0,6,-6,1,1,0,1,NYSE
4773,13-02-2021 18:00,24 hrs.,wallstreetbets,JWS,12,0,12,-12,2,2,0,1,NYSE
4773,13-02-2021 18:00,24 hrs.,wallstreetbets,KMI,47,0,47,-47,2,12,15,1,NYSE
4773,13-02-2021 18:00,24 hrs.,wallstreetbets,LEE,6,0,6,-6,1,1,0,1,NYSE
4773,13-02-2021 18:00,24 hrs.,wallstreetbets,LPL,317,317,0,317,1,138,37,1,NYSE
4773,13-02-2021 18:00,24 hrs.,wallstreetbets,LTC,14,14,0,14,2,2,2,2,NYSE
4773,13-02-2021 18:00,24 hrs.,wallstreetbets,UUUU,14,0,14,-14,2,2,2,1,AMEX
4773,13-02-2021 18:00,24 hrs.,wallstreetbets,XXII,7,0,7,-7,1,1,1,1,AMEX
4773,13-02-2021 18:00,24 hrs.,wallstreetbets,YCBD,7,0,7,-7,1,1,1,1,AMEX
4773,13-02-2021 18:00,24 hrs.,wallstreetbets,BABYF,7,7,0,7,1,1,1,1,OTC
4773,13-02-2021 18:00,24 hrs.,wallstreetbets,BBKCF,6,0,6,-6,1,1,0,1,OTC
4773,13-02-2021 18:00,24 hrs.,wallstreetbets,BDRBF,7,7,0,7,1,1,1,1,OTC
4773,13-02-2021 18:00,24 hrs.,wallstreetbets,CNPOF,7,0,7,-7,1,1,1,1,OTC
4773,13-02-2021 18:00,24 hrs.,wallstreetbets,CRLBF,6,0,6,-6,1,1,0,1,OTC
4773,13-02-2021 18:00,24 hrs.,wallstreetbets,CTTAY,42,0,42,-42,1,13,12,1,OTC
4773,13-02-2021 18:00,24 hrs.,wallstreetbets,CURLF,6,0,6,-6,1,1,0,1,OTC
4773,13-02-2021 18:00,24 hrs.,wallstreetbets,CXRXF,7,7,0,7,1,1,1,1,OTC
4773,13-02-2021 18:00,24 hrs.,wallstreetbets,DIGAF,6,6,0,6,1,1,0,1,OTC
4773,13-02-2021 18:00,24 hrs.,wallstreetbets,EPWCF,7,0,7,-7,1,1,1,1,OTC
4773,13-02-2021 18:00,24 hrs.,wallstreetbets,FUNFF,7,7,0,7,1,1,1,1,OTC
4773,13-02-2021 18:00,24 hrs.,wallstreetbets,GAYMF,7,7,0,7,1,1,1,1,OTC
4773,13-02-2021 18:00,24 hrs.,wallstreetbets,GGTTF,27,20,7,13,4,4,3,2,OTC
4773,13-02-2021 18:00,24 hrs.,wallstreetbets,GTBIF,13,0,13,-13,2,2,1,2,OTC
4773,13-02-2021 18:00,24 hrs.,wallstreetbets,HITIF,52,0,52,-52,3,12,16,2,OTC
4773,13-02-2021 18:00,24 hrs.,wallstreetbets,HTZGQ,13,6,7,-1,2,2,1,2,OTC
4773,13-02-2021 18:00,24 hrs.,wallstreetbets,ISCNF,7,0,7,-7,1,1,1,1,OTC
4773,13-02-2021 18:00,24 hrs.,wallstreetbets,LKNCY,226,0,226,-226,2,7,204,2,OTC
4773,13-02-2021 18:00,24 hrs.,wallstreetbets,MOTNF,7,0,7,-7,1,1,1,1,OTC
4773,13-02-2021 18:00,24 hrs.,wallstreetbets,NONOF,7,0,7,-7,1,1,1,1,OTC
4773,13-02-2021 18:00,24 hrs.,wallstreetbets,NXTTF,13,13,0,13,2,2,1,2,OTC
4773,13-02-2021 18:00,24 hrs.,wallstreetbets,PCLOF,14,0,14,-14,2,2,2,1,OTC
4773,13-02-2021 18:00,24 hrs.,wallstreetbets,PMNXF,6,0,6,-6,1,1,0,1,OTC
4773,13-02-2021 18:00,24 hrs.,wallstreetbets,RECAF,6,6,0,6,1,1,0,1,OTC
4773,13-02-2021 18:00,24 hrs.,wallstreetbets,RLLCF,29,0,29,-29,4,4,5,4,OTC
4773,13-02-2021 18:00,24 hrs.,wallstreetbets,RYCEY,515,0,515,-515,7,189,109,7,OTC
4773,13-02-2021 18:00,24 hrs.,wallstreetbets,SBSAA,7,0,7,-7,1,1,1,1,OTC
4773,13-02-2021 18:00,24 hrs.,wallstreetbets,SHRMF,6,0,6,-6,1,1,0,1,OTC
4773,13-02-2021 18:00,24 hrs.,wallstreetbets,TBUIF,13,0,13,-13,2,2,1,1,OTC
4773,13-02-2021 18:00,24 hrs.,wallstreetbets,TCNNF,6,6,0,6,1,1,0,1,OTC
4773,13-02-2021 18:00,24 hrs.,wallstreetbets,TGODF,7,0,7,-7,1,1,1,1,OTC
4773,13-02-2021 18:00,24 hrs.,wallstreetbets,TOWTF,12,12,0,12,2,2,0,1,OTC
4773,13-02-2021 18:00,24 hrs.,wallstreetbets,TSCRF,64,0,64,-64,3,9,34,2,OTC
4773,13-02-2021 18:00,24 hrs.,wallstreetbets,VALPQ,10,0,10,-10,1,2,2,1,OTC
4773,13-02-2021 18:00,24 hrs.,wallstreetbets,VLNCF,14,14,0,14,1,0,10,1,OTC
4773,13-02-2021 18:00,24 hrs.,wallstreetbets,VRYYF,7,7,0,7,1,1,1,1,OTC
4773,13-02-2021 18:00,24 hrs.,wallstreetbets,VVCIF,6,0,6,-6,1,1,0,1,OTC
4773,13-02-2021 18:00,24 hrs.,wallstreetbets,VYGVF,6,6,0,6,1,1,0,1,OTC
4773,13-02-2021 18:00,24 hrs.,wallstreetbets,XJNGF,6,6,0,6,1,1,0,1,OTC
4773,13-02-2021 18:00,24 hrs.,wallstreetbets,ZBISF,7,0,7,-7,1,1,1,1,OTC
4773,13-02-2021 18:00,24 hrs.,wallstreetbets,DNN,103,28,75,-47,15,15,13,12,AMEX
4773,13-02-2021 18:00,24 hrs.,wallstreetbets,MFA,7,7,0,7,1,1,1,1,NYSE
4773,13-02-2021 18:00,24 hrs.,wallstreetbets,MFG,40,40,0,40,1,0,36,1,NYSE
4773,13-02-2021 18:00,24 hrs.,wallstreetbets,MIN,7,0,7,-7,1,1,1,1,NYSE
4773,13-02-2021 18:00,24 hrs.,wallstreetbets,MOS,23,23,0,23,1,8,3,1,NYSE
4773,13-02-2021 18:00,24 hrs.,wallstreetbets,MRO,6,0,6,-6,1,1,0,1,NYSE
4773,13-02-2021 18:00,24 hrs.,wallstreetbets,MTD,317,317,0,317,1,138,37,1,NYSE
4773,13-02-2021 18:00,24 hrs.,wallstreetbets,NAT,6,0,6,-6,1,1,0,1,NYSE
4773,13-02-2021 18:00,24 hrs.,wallstreetbets,NET,490,275,215,60,4,167,140,4,NYSE
4773,13-02-2021 18:00,24 hrs.,wallstreetbets,NIO,185,166,19,147,8,57,39,6,NYSE
4773,13-02-2021 18:00,24 hrs.,wallstreetbets,NLY,7,0,7,-7,1,1,1,1,NYSE
4773,13-02-2021 18:00,24 hrs.,wallstreetbets,NMR,13,13,0,13,2,2,1,2,NYSE
4773,13-02-2021 18:00,24 hrs.,wallstreetbets,NOK,1713,21,1692,-1671,13,682,297,13,NYSE
4773,13-02-2021 18:00,24 hrs.,wallstreetbets,NOV,6,0,6,-6,1,1,0,1,NYSE
4773,13-02-2021 18:00,24 hrs.,wallstreetbets,NRG,7,0,7,-7,1,1,1,1,NYSE
4773,13-02-2021 18:00,24 hrs.,wallstreetbets,NSA,992,992,0,992,1,458,72,1,NYSE
4773,13-02-2021 18:00,24 hrs.,wallstreetbets,NTR,23,23,0,23,1,8,3,1,NYSE
4773,13-02-2021 18:00,24 hrs.,wallstreetbets,NVO,86,0,86,-86,2,22,34,2,NYSE
4773,13-02-2021 18:00,24 hrs.,wallstreetbets,NYC,7,0,7,-7,1,1,1,1,NYSE
4773,13-02-2021 18:00,24 hrs.,wallstreetbets,OSK,204,49,155,-106,2,48,100,2,NYSE
4773,13-02-2021 18:00,24 hrs.,wallstreetbets,OXY,23,23,0,23,1,8,3,1,NYSE
4773,13-02-2021 18:00,24 hrs.,wallstreetbets,PCG,471,0,471,-471,1,183,101,1,NYSE
4773,13-02-2021 18:00,24 hrs.,wallstreetbets,PHT,7,0,7,-7,1,1,1,1,NYSE
4773,13-02-2021 18:00,24 hrs.,wallstreetbets,PSA,3928,7,3921,-3914,6,1637,630,6,NYSE
4773,13-02-2021 18:00,24 hrs.,wallstreetbets,PSN,7,0,7,-7,1,1,1,1,NYSE
4773,13-02-2021 18:00,24 hrs.,wallstreetbets,PVL,13,0,13,-13,2,2,1,1,NYSE
4773,13-02-2021 18:00,24 hrs.,wallstreetbets,AAP,340,340,0,340,2,146,40,2,NYSE
4773,13-02-2021 18:00,24 hrs.,wallstreetbets,ACB,104,21,83,-62,15,15,14,13,NYSE
4773,13-02-2021 18:00,24 hrs.,wallstreetbets,ACI,7,0,7,-7,1,1,1,1,NYSE
4773,13-02-2021 18:00,24 hrs.,wallstreetbets,AFC,7,0,7,-7,1,1,1,1,NYSE
4773,13-02-2021 18:00,24 hrs.,wallstreetbets,AIN,7,7,0,7,1,1,1,1,NYSE
4773,13-02-2021 18:00,24 hrs.,wallstreetbets,AMC,3343,534,2809,-2275,110,1156,591,90,NYSE
4773,13-02-2021 18:00,24 hrs.,wallstreetbets,AMP,8,0,8,-8,1,1,2,1,NYSE
4773,13-02-2021 18:00,24 hrs.,wallstreetbets,ATH,20,6,14,-8,3,3,2,3,NYSE
4773,13-02-2021 18:00,24 hrs.,wallstreetbets,AUY,97,0,97,-97,3,23,39,2,NYSE
4773,13-02-2021 18:00,24 hrs.,wallstreetbets,BBY,138,138,0,138,1,50,34,1,NYSE
4773,13-02-2021 18:00,24 hrs.,wallstreetbets,BCH,11,0,11,-11,2,1,1,2,NYSE
4773,13-02-2021 18:00,24 hrs.,wallstreetbets,BGS,8,0,8,-8,1,1,2,1,NYSE
4773,13-02-2021 18:00,24 hrs.,wallstreetbets,BTT,28,7,21,-14,4,4,4,4,NYSE
4773,13-02-2021 18:00,24 hrs.,wallstreetbets,BTU,14,0,14,-14,2,2,2,1,NYSE
4773,13-02-2021 18:00,24 hrs.,wallstreetbets,BYD,30,30,0,30,2,9,4,2,NYSE
4773,13-02-2021 18:00,24 hrs.,wallstreetbets,CAT,7,0,7,-7,1,1,1,1,NYSE
4773,13-02-2021 18:00,24 hrs.,wallstreetbets,CCL,165,151,14,137,5,54,37,4,NYSE
4773,13-02-2021 18:00,24 hrs.,wallstreetbets,CMA,6,0,6,-6,1,1,0,1,NYSE
4773,13-02-2021 18:00,24 hrs.,wallstreetbets,CMC,15,0,15,-15,1,1,9,1,NYSE
4773,13-02-2021 18:00,24 hrs.,wallstreetbets,COO,6,6,0,6,1,1,0,1,NYSE
4773,13-02-2021 18:00,24 hrs.,wallstreetbets,CPE,7,0,7,-7,1,1,1,1,NYSE
4773,13-02-2021 18:00,24 hrs.,wallstreetbets,CPS,6,0,6,-6,1,1,0,1,NYSE
4773,13-02-2021 18:00,24 hrs.,wallstreetbets,CSV,254,0,254,-254,1,72,106,1,NYSE
4773,13-02-2021 18:00,24 hrs.,wallstreetbets,CVS,354,340,14,326,4,148,42,4,NYSE
4773,13-02-2021 18:00,24 hrs.,wallstreetbets,DAC,13,0,13,-13,2,2,1,1,NYSE
4773,13-02-2021 18:00,24 hrs.,wallstreetbets,DDD,317,317,0,317,1,138,37,1,NYSE
4773,13-02-2021 18:00,24 hrs.,wallstreetbets,DDS,317,317,0,317,1,138,37,1,NYSE
4773,13-02-2021 18:00,24 hrs.,wallstreetbets,DHT,7,0,7,-7,1,1,1,1,NYSE
4773,13-02-2021 18:00,24 hrs.,wallstreetbets,DIS,6,0,6,-6,1,1,0,1,NYSE
4773,13-02-2021 18:00,24 hrs.,wallstreetbets,DOW,138,138,0,138,1,50,34,1,NYSE
4773,13-02-2021 18:00,24 hrs.,wallstreetbets,DVN,7,0,7,-7,1,1,1,1,NYSE
4773,13-02-2021 18:00,24 hrs.,wallstreetbets,EAT,7,0,7,-7,1,1,1,1,NYSE
4773,13-02-2021 18:00,24 hrs.,wallstreetbets,EOS,7,7,0,7,1,1,1,1,NYSE
4773,13-02-2021 18:00,24 hrs.,wallstreetbets,EOT,7,7,0,7,1,1,1,1,NYSE
4773,13-02-2021 18:00,24 hrs.,wallstreetbets,EPD,47,0,47,-47,2,12,15,1,NYSE
4773,13-02-2021 18:00,24 hrs.,wallstreetbets,ETN,21,0,21,-21,3,3,3,3,NYSE
4773,13-02-2021 18:00,24 hrs.,wallstreetbets,EXP,7,0,7,-7,1,1,1,1,NYSE
4773,13-02-2021 18:00,24 hrs.,wallstreetbets,FCX,109,109,0,109,1,38,29,1,NYSE
4773,13-02-2021 18:00,24 hrs.,wallstreetbets,FDX,7,0,7,-7,1,1,1,1,NYSE
4773,13-02-2021 18:00,24 hrs.,wallstreetbets,NVTA,23,23,0,23,1,8,3,1,NYSE
4773,13-02-2021 18:00,24 hrs.,wallstreetbets,PLTR,16219,545,15674,-15129,36,7287,1501,27,NYSE
4773,13-02-2021 18:00,24 hrs.,wallstreetbets,PRTY,6,0,6,-6,1,1,0,1,NYSE
4773,13-02-2021 18:00,24 hrs.,wallstreetbets,PSTH,236,0,236,-236,3,78,68,2,NYSE
4773,13-02-2021 18:00,24 hrs.,wallstreetbets,SAFE,9,0,9,-9,1,2,1,1,NYSE
4773,13-02-2021 18:00,24 hrs.,wallstreetbets,SHOP,340,340,0,340,2,146,40,2,NYSE
4773,13-02-2021 18:00,24 hrs.,wallstreetbets,SPCE,176,7,169,-162,10,43,50,7,NYSE
4773,13-02-2021 18:00,24 hrs.,wallstreetbets,STIC,7,0,7,-7,1,1,1,1,NYSE
4773,13-02-2021 18:00,24 hrs.,wallstreetbets,STPK,6,0,6,-6,1,1,0,1,NYSE
4773,13-02-2021 18:00,24 hrs.,wallstreetbets,TECK,23,23,0,23,1,8,3,1,NYSE
4773,13-02-2021 18:00,24 hrs.,wallstreetbets,TWLO,340,340,0,340,2,146,40,2,NYSE
4773,13-02-2021 18:00,24 hrs.,wallstreetbets,TWTR,138,138,0,138,1,50,34,1,NYSE
4773,13-02-2021 18:00,24 hrs.,wallstreetbets,UBER,14,14,0,14,2,2,2,2,NYSE
4773,13-02-2021 18:00,24 hrs.,wallstreetbets,VALE,7,0,7,-7,1,1,1,1,NYSE
4773,13-02-2021 18:00,24 hrs.,wallstreetbets,VGAC,12,0,12,-12,2,2,0,2,NYSE
4773,13-02-2021 18:00,24 hrs.,wallstreetbets,VSTO,7,0,7,-7,1,1,1,1,NYSE
4773,13-02-2021 18:00,24 hrs.,wallstreetbets,WORK,14,0,14,-14,2,2,2,2,NYSE
4773,13-02-2021 18:00,24 hrs.,wallstreetbets,YELP,7,0,7,-7,1,1,1,1,NYSE
4773,13-02-2021 18:00,24 hrs.,wallstreetbets,AAL,8,8,0,8,1,1,2,1,NASDAQ
4773,13-02-2021 18:00,24 hrs.,wallstreetbets,AMD,871,368,503,-135,12,292,239,10,NASDAQ
4773,13-02-2021 18:00,24 hrs.,wallstreetbets,API,7,7,0,7,1,1,1,1,NASDAQ
4773,13-02-2021 18:00,24 hrs.,wallstreetbets,AQB,7,0,7,-7,1,1,1,1,NASDAQ
4773,13-02-2021 18:00,24 hrs.,wallstreetbets,AZN,7,0,7,-7,1,1,1,1,NASDAQ
4773,13-02-2021 18:00,24 hrs.,wallstreetbets,PWR,6,6,0,6,1,1,0,1,NYSE
4773,13-02-2021 18:00,24 hrs.,wallstreetbets,PXD,23,23,0,23,1,8,3,1,NYSE
4773,13-02-2021 18:00,24 hrs.,wallstreetbets,RAD,7,0,7,-7,1,1,1,1,NYSE
4773,13-02-2021 18:00,24 hrs.,wallstreetbets,RCL,7,7,0,7,1,1,1,1,NYSE
4773,13-02-2021 18:00,24 hrs.,wallstreetbets,RDY,7,0,7,-7,1,1,1,1,NYSE
4773,13-02-2021 18:00,24 hrs.,wallstreetbets,RKT,8980,52,8928,-8876,13,4169,590,12,NYSE
4773,13-02-2021 18:00,24 hrs.,wallstreetbets,RMO,7,0,7,-7,1,1,1,1,NYSE
4773,13-02-2021 18:00,24 hrs.,wallstreetbets,RNG,23,23,0,23,1,8,3,1,NYSE
4773,13-02-2021 18:00,24 hrs.,wallstreetbets,RPT,7,0,7,-7,1,1,1,1,NYSE
4773,13-02-2021 18:00,24 hrs.,wallstreetbets,RTP,6,0,6,-6,1,1,0,1,NYSE
4773,13-02-2021 18:00,24 hrs.,wallstreetbets,SAM,23,23,0,23,1,8,3,1,NYSE
4773,13-02-2021 18:00,24 hrs.,wallstreetbets,SBE,13,7,6,1,2,2,1,2,NYSE
4773,13-02-2021 18:00,24 hrs.,wallstreetbets,SJM,183,176,7,169,2,63,49,2,NYSE
4773,13-02-2021 18:00,24 hrs.,wallstreetbets,SKT,317,317,0,317,1,138,37,1,NYSE
4773,13-02-2021 18:00,24 hrs.,wallstreetbets,SKY,6,0,6,-6,1,1,0,1,NYSE
4773,13-02-2021 18:00,24 hrs.,wallstreetbets,SNX,6,0,6,-6,1,1,0,1,NYSE
4773,13-02-2021 18:00,24 hrs.,wallstreetbets,SOS,187,82,105,-23,27,27,25,21,NYSE
4773,13-02-2021 18:00,24 hrs.,wallstreetbets,STM,7,0,7,-7,1,1,1,1,NYSE
4773,13-02-2021 18:00,24 hrs.,wallstreetbets,SUP,7,0,7,-7,1,1,1,1,NYSE
4773,13-02-2021 18:00,24 hrs.,wallstreetbets,TAP,6,0,6,-6,1,1,0,1,NYSE
4773,13-02-2021 18:00,24 hrs.,wallstreetbets,TBC,7,0,7,-7,1,1,1,1,NYSE
4773,13-02-2021 18:00,24 hrs.,wallstreetbets,TDC,24,0,24,-24,1,2,16,1,NYSE
4773,13-02-2021 18:00,24 hrs.,wallstreetbets,TFC,7,0,7,-7,1,1,1,1,NYSE
4773,13-02-2021 18:00,24 hrs.,wallstreetbets,THC,7,0,7,-7,1,1,1,1,NYSE
4773,13-02-2021 18:00,24 hrs.,wallstreetbets,TRQ,7,7,0,7,1,1,1,1,NYSE
4773,13-02-2021 18:00,24 hrs.,wallstreetbets,TRU,23,23,0,23,1,8,3,1,NYSE
4773,13-02-2021 18:00,24 hrs.,wallstreetbets,TWO,7,0,7,-7,1,1,1,1,NYSE
4773,13-02-2021 18:00,24 hrs.,wallstreetbets,UBS,45,38,7,31,3,8,17,2,NYSE
4773,13-02-2021 18:00,24 hrs.,wallstreetbets,VET,7,7,0,7,1,1,1,1,NYSE
4773,13-02-2021 18:00,24 hrs.,wallstreetbets,VHC,7,0,7,-7,1,1,1,1,NYSE
4773,13-02-2021 18:00,24 hrs.,wallstreetbets,VRT,156,0,156,-156,2,56,36,1,NYSE
4773,13-02-2021 18:00,24 hrs.,wallstreetbets,VST,7,0,7,-7,1,1,1,1,NYSE
4773,13-02-2021 18:00,24 hrs.,wallstreetbets,WMT,347,340,7,333,3,147,41,3,NYSE
4773,13-02-2021 18:00,24 hrs.,wallstreetbets,WST,23,23,0,23,1,8,3,1,NYSE
4773,13-02-2021 18:00,24 hrs.,wallstreetbets,XOM,109,109,0,109,1,38,29,1,NYSE
4773,13-02-2021 18:00,24 hrs.,wallstreetbets,YPF,7,7,0,7,1,1,1,1,NYSE
4773,13-02-2021 18:00,24 hrs.,wallstreetbets,ZTS,23,23,0,23,1,8,3,1,NYSE
4773,13-02-2021 18:00,24 hrs.,wallstreetbets,ABBV,7,0,7,-7,1,1,1,1,NYSE
4773,13-02-2021 18:00,24 hrs.,wallstreetbets,ACIC,20,0,20,-20,3,3,2,3,NYSE
4773,13-02-2021 18:00,24 hrs.,wallstreetbets,ALLY,7,0,7,-7,1,1,1,1,NYSE
4773,13-02-2021 18:00,24 hrs.,wallstreetbets,LZB,23,23,0,23,1,8,3,1,NYSE
4773,13-02-2021 18:00,24 hrs.,RobinHoodPennyStocks,CDTX,6,0,6,-6,1,1,0,1,NASDAQ
4773,13-02-2021 18:00,24 hrs.,RobinHoodPennyStocks,CIDM,116,0,116,-116,2,26,56,2,NASDAQ
4773,13-02-2021 18:00,24 hrs.,RobinHoodPennyStocks,CKPT,31,0,31,-31,1,11,5,1,NASDAQ
4773,13-02-2021 18:00,24 hrs.,RobinHoodPennyStocks,CLBS,32,6,26,-20,3,9,2,3,NASDAQ
4773,13-02-2021 18:00,24 hrs.,RobinHoodPennyStocks,CRBP,27,0,27,-27,1,9,5,1,NASDAQ
4773,13-02-2021 18:00,24 hrs.,RobinHoodPennyStocks,CTRM,202,28,174,-146,5,31,120,5,NASDAQ
4773,13-02-2021 18:00,24 hrs.,RobinHoodPennyStocks,DFFN,382,61,321,-260,4,144,78,4,NASDAQ
4773,13-02-2021 18:00,24 hrs.,RobinHoodPennyStocks,GAIN,6,0,6,-6,1,1,0,1,NASDAQ
4773,13-02-2021 18:00,24 hrs.,RobinHoodPennyStocks,IMMR,15,0,15,-15,1,4,3,1,NASDAQ
4773,13-02-2021 18:00,24 hrs.,RobinHoodPennyStocks,INPX,12,0,12,-12,2,2,0,1,NASDAQ
4773,13-02-2021 18:00,24 hrs.,RobinHoodPennyStocks,ITRM,6,0,6,-6,1,1,0,1,NASDAQ
4773,13-02-2021 18:00,24 hrs.,RobinHoodPennyStocks,KTRA,19,0,19,-19,1,5,5,1,NASDAQ
4773,13-02-2021 18:00,24 hrs.,RobinHoodPennyStocks,LKCO,24,0,24,-24,3,5,2,3,NASDAQ
4773,13-02-2021 18:00,24 hrs.,RobinHoodPennyStocks,NAKD,117,0,117,-117,1,47,19,1,NASDAQ
4773,13-02-2021 18:00,24 hrs.,RobinHoodPennyStocks,NMTR,160,0,160,-160,1,53,50,1,NASDAQ
4773,13-02-2021 18:00,24 hrs.,RobinHoodPennyStocks,NVCN,69,0,69,-69,2,18,25,2,NASDAQ
4773,13-02-2021 18:00,24 hrs.,RobinHoodPennyStocks,OPGN,6,0,6,-6,1,1,0,1,NASDAQ
4773,13-02-2021 18:00,24 hrs.,RobinHoodPennyStocks,PHUN,6,0,6,-6,1,1,0,1,NASDAQ
4773,13-02-2021 18:00,24 hrs.,RobinHoodPennyStocks,SHIP,24,0,24,-24,4,4,0,2,NASDAQ
4773,13-02-2021 18:00,24 hrs.,RobinHoodPennyStocks,SNDL,36,12,24,-12,6,6,0,6,NASDAQ
4773,13-02-2021 18:00,24 hrs.,RobinHoodPennyStocks,SNGX,9,0,9,-9,1,0,5,1,NASDAQ
4773,13-02-2021 18:00,24 hrs.,RobinHoodPennyStocks,SONM,18,18,0,18,1,1,12,1,NASDAQ
4773,13-02-2021 18:00,24 hrs.,RobinHoodPennyStocks,SRAX,6,0,6,-6,1,1,0,1,NASDAQ
4773,13-02-2021 18:00,24 hrs.,RobinHoodPennyStocks,TRCH,89,32,57,-25,3,18,41,2,NASDAQ
4773,13-02-2021 18:00,24 hrs.,RobinHoodPennyStocks,TSLA,6,6,0,6,1,1,0,1,NASDAQ
4773,13-02-2021 18:00,24 hrs.,RobinHoodPennyStocks,TXMD,18,0,18,-18,3,3,0,3,NASDAQ
4773,13-02-2021 18:00,24 hrs.,RobinHoodPennyStocks,TYME,6,0,6,-6,1,1,0,1,NASDAQ
4773,13-02-2021 18:00,24 hrs.,RobinHoodPennyStocks,GPFT,6,0,6,-6,1,1,0,1,OTC
4773,13-02-2021 18:00,24 hrs.,RobinHoodPennyStocks,GSPH,6,0,6,-6,1,1,0,1,OTC
4773,13-02-2021 18:00,24 hrs.,RobinHoodPennyStocks,GTLL,6,0,6,-6,1,1,0,1,OTC
4773,13-02-2021 18:00,24 hrs.,RobinHoodPennyStocks,HCMC,6,0,6,-6,1,1,0,1,OTC
4773,13-02-2021 18:00,24 hrs.,RobinHoodPennyStocks,INKW,6,0,6,-6,1,1,0,1,OTC
4773,13-02-2021 18:00,24 hrs.,RobinHoodPennyStocks,NUUU,6,0,6,-6,1,1,0,1,OTC
4773,13-02-2021 18:00,24 hrs.,RobinHoodPennyStocks,PHIL,6,0,6,-6,1,1,0,1,OTC
4773,13-02-2021 18:00,24 hrs.,RobinHoodPennyStocks,ALLIF,6,0,6,-6,1,1,0,1,OTC
4773,13-02-2021 18:00,24 hrs.,RobinHoodPennyStocks,MEDIF,6,6,0,6,1,1,0,1,OTC
4773,13-02-2021 18:00,24 hrs.,RobinHoodPennyStocks,MMEDF,28,0,28,-28,1,9,6,1,OTC
4773,13-02-2021 18:00,24 hrs.,RobinHoodPennyStocks,NXTTF,6,0,6,-6,1,1,0,1,OTC
4773,13-02-2021 18:00,24 hrs.,RobinHoodPennyStocks,RYCEY,6,0,6,-6,1,1,0,1,OTC
4773,13-02-2021 18:00,24 hrs.,RobinHoodPennyStocks,ZBISF,6,0,6,-6,1,1,0,1,OTC
4773,13-02-2021 18:00,24 hrs.,RobinHoodPennyStocks,DNN,156,6,150,-144,4,54,32,4,AMEX
4773,13-02-2021 18:00,24 hrs.,RobinHoodPennyStocks,DPW,42,19,23,-4,2,8,18,2,AMEX
4773,13-02-2021 18:00,24 hrs.,RobinHoodPennyStocks,GSV,6,0,6,-6,1,1,0,1,AMEX
4773,13-02-2021 18:00,24 hrs.,wallstreetbets,ARGO,6,0,6,-6,1,1,0,1,NYSE
4773,13-02-2021 18:00,24 hrs.,wallstreetbets,CCIV,192,56,136,-80,28,28,24,23,NYSE
4773,13-02-2021 18:00,24 hrs.,wallstreetbets,CLDR,6,0,6,-6,1,1,0,1,NYSE
4773,13-02-2021 18:00,24 hrs.,wallstreetbets,COTY,120,120,0,120,1,40,36,1,NYSE
4773,13-02-2021 18:00,24 hrs.,wallstreetbets,DASH,41,35,6,29,6,6,5,6,NYSE
4773,13-02-2021 18:00,24 hrs.,wallstreetbets,EXPR,8,0,8,-8,1,1,2,1,NYSE
4773,13-02-2021 18:00,24 hrs.,wallstreetbets,FSLY,478,478,0,478,3,196,74,3,NYSE
4773,13-02-2021 18:00,24 hrs.,wallstreetbets,FUBO,152,138,14,124,3,52,36,3,NYSE
4773,13-02-2021 18:00,24 hrs.,wallstreetbets,FVRR,340,340,0,340,2,146,40,2,NYSE
4773,13-02-2021 18:00,24 hrs.,wallstreetbets,GNRC,12,6,6,0,2,2,0,2,NYSE
4773,13-02-2021 18:00,24 hrs.,wallstreetbets,HEXO,27,0,27,-27,4,4,3,3,NYSE
4773,13-02-2021 18:00,24 hrs.,wallstreetbets,HUBS,13,0,13,-13,2,2,1,2,NYSE
4773,13-02-2021 18:00,24 hrs.,wallstreetbets,HUYA,14,0,14,-14,2,2,2,2,NYSE
4773,13-02-2021 18:00,24 hrs.,wallstreetbets,HYLN,101,0,101,-101,2,7,79,2,NYSE
4773,13-02-2021 18:00,24 hrs.,wallstreetbets,IIPR,8,0,8,-8,1,1,2,1,NYSE
4773,13-02-2021 18:00,24 hrs.,wallstreetbets,JMIA,21,0,21,-21,3,3,3,2,NYSE
4773,13-02-2021 18:00,24 hrs.,wallstreetbets,LEAP,6,6,0,6,1,1,0,1,NYSE
4773,13-02-2021 18:00,24 hrs.,wallstreetbets,LGVW,14,14,0,14,2,2,2,1,NYSE
4773,13-02-2021 18:00,24 hrs.,wallstreetbets,MAIN,6,0,6,-6,1,1,0,1,NYSE
4773,13-02-2021 18:00,24 hrs.,wallstreetbets,MITT,7,7,0,7,1,1,1,1,NYSE
4773,13-02-2021 18:00,24 hrs.,wallstreetbets,NOVA,7,7,0,7,1,1,1,1,NYSE
4773,13-02-2021 18:00,24 hrs.,wallstreetbets,FLWR,7,0,7,-7,1,1,1,1,NASDAQ
4773,13-02-2021 18:00,24 hrs.,wallstreetbets,FLWS,15,0,15,-15,2,2,3,2,NASDAQ
4773,13-02-2021 18:00,24 hrs.,wallstreetbets,FOLD,34,6,28,-22,5,5,4,4,NASDAQ
4773,13-02-2021 18:00,24 hrs.,wallstreetbets,FORM,201,0,201,-201,1,78,41,1,NASDAQ
4773,13-02-2021 18:00,24 hrs.,wallstreetbets,FTFT,7,0,7,-7,1,1,1,1,NASDAQ
4773,13-02-2021 18:00,24 hrs.,wallstreetbets,GAIN,6,0,6,-6,1,1,0,1,NASDAQ
4773,13-02-2021 18:00,24 hrs.,wallstreetbets,GERN,6,0,6,-6,1,1,0,1,NASDAQ
4773,13-02-2021 18:00,24 hrs.,wallstreetbets,GEVO,21,0,21,-21,3,3,3,3,NASDAQ
4773,13-02-2021 18:00,24 hrs.,wallstreetbets,GILT,7,0,7,-7,1,1,1,1,NASDAQ
4773,13-02-2021 18:00,24 hrs.,wallstreetbets,GLBS,28,7,21,-14,4,4,4,3,NASDAQ
4773,13-02-2021 18:00,24 hrs.,wallstreetbets,GNOG,7,7,0,7,1,1,1,1,NASDAQ
4773,13-02-2021 18:00,24 hrs.,wallstreetbets,GNUS,27,0,27,-27,4,4,3,4,NASDAQ
4773,13-02-2021 18:00,24 hrs.,wallstreetbets,GOEV,7,0,7,-7,1,1,1,1,NASDAQ
4773,13-02-2021 18:00,24 hrs.,wallstreetbets,GOGO,353,317,36,281,7,144,37,4,NASDAQ
4773,13-02-2021 18:00,24 hrs.,wallstreetbets,GOLD,38,38,0,38,3,10,6,3,NASDAQ
4773,13-02-2021 18:00,24 hrs.,wallstreetbets,GRIL,7,0,7,-7,1,1,1,1,NASDAQ
4773,13-02-2021 18:00,24 hrs.,wallstreetbets,GRMN,23,23,0,23,1,8,3,1,NASDAQ
4773,13-02-2021 18:00,24 hrs.,wallstreetbets,GTEC,14,6,8,-2,2,2,2,2,NASDAQ
4773,13-02-2021 18:00,24 hrs.,wallstreetbets,GTHX,32,0,32,-32,5,5,2,3,NASDAQ
4773,13-02-2021 18:00,24 hrs.,wallstreetbets,HEAR,13,7,6,1,2,2,1,2,NASDAQ
4773,13-02-2021 18:00,24 hrs.,wallstreetbets,HZNP,7,7,0,7,1,1,1,1,NASDAQ
4773,13-02-2021 18:00,24 hrs.,wallstreetbets,IFMK,7,0,7,-7,1,1,1,1,NASDAQ
4773,13-02-2021 18:00,24 hrs.,wallstreetbets,IMGN,7,0,7,-7,1,1,1,1,NASDAQ
4773,13-02-2021 18:00,24 hrs.,wallstreetbets,INPX,14,0,14,-14,2,2,2,2,NASDAQ
4773,13-02-2021 18:00,24 hrs.,wallstreetbets,INSG,6,0,6,-6,1,1,0,1,NASDAQ
4773,13-02-2021 18:00,24 hrs.,wallstreetbets,INTC,95,75,20,55,7,19,29,6,NASDAQ
4773,13-02-2021 18:00,24 hrs.,wallstreetbets,IRBT,6,6,0,6,1,1,0,1,NASDAQ
4773,13-02-2021 18:00,24 hrs.,wallstreetbets,ITRM,21,7,14,-7,3,3,3,2,NASDAQ
4773,13-02-2021 18:00,24 hrs.,wallstreetbets,JAGX,52,7,45,-38,8,8,4,4,NASDAQ
4773,13-02-2021 18:00,24 hrs.,wallstreetbets,JNCE,6,0,6,-6,1,1,0,1,NASDAQ
4773,13-02-2021 18:00,24 hrs.,wallstreetbets,KOPN,15,0,15,-15,2,2,3,2,NASDAQ
4773,13-02-2021 18:00,24 hrs.,wallstreetbets,KOSS,14,0,14,-14,2,2,2,1,NASDAQ
4773,13-02-2021 18:00,24 hrs.,wallstreetbets,LAZR,8,0,8,-8,1,1,2,1,NASDAQ
4773,13-02-2021 18:00,24 hrs.,RobinHoodPennyStocks,GTE,227,67,160,-93,7,60,79,7,AMEX
4773,13-02-2021 18:00,24 hrs.,RobinHoodPennyStocks,NAK,65,0,65,-65,2,12,33,2,AMEX
4773,13-02-2021 18:00,24 hrs.,RobinHoodPennyStocks,REI,26,0,26,-26,2,7,4,2,AMEX
4773,13-02-2021 18:00,24 hrs.,RobinHoodPennyStocks,SYN,6,0,6,-6,1,1,0,1,AMEX
4773,13-02-2021 18:00,24 hrs.,RobinHoodPennyStocks,XPL,6,0,6,-6,1,1,0,1,AMEX
4773,13-02-2021 18:00,24 hrs.,RobinHoodPennyStocks,ZOM,246,103,143,-40,4,79,72,4,AMEX
4773,13-02-2021 18:00,24 hrs.,RobinHoodPennyStocks,IBIO,37,0,37,-37,1,14,5,1,AMEX
4773,13-02-2021 18:00,24 hrs.,RobinHoodPennyStocks,SENS,6,0,6,-6,1,1,0,1,AMEX
4773,13-02-2021 18:00,24 hrs.,RobinHoodPennyStocks,DNK,6,0,6,-6,1,1,0,1,NYSE
4773,13-02-2021 18:00,24 hrs.,RobinHoodPennyStocks,ETN,12,6,6,0,2,2,0,2,NYSE
4773,13-02-2021 18:00,24 hrs.,RobinHoodPennyStocks,GME,59,0,59,-59,2,14,23,2,NYSE
4773,13-02-2021 18:00,24 hrs.,RobinHoodPennyStocks,MRO,50,44,6,38,2,19,4,2,NYSE
4773,13-02-2021 18:00,24 hrs.,RobinHoodPennyStocks,MTL,19,0,19,-19,2,2,7,2,NYSE
4773,13-02-2021 18:00,24 hrs.,RobinHoodPennyStocks,NAT,6,0,6,-6,1,1,0,1,NYSE
4773,13-02-2021 18:00,24 hrs.,RobinHoodPennyStocks,NBB,6,0,6,-6,1,1,0,1,NYSE
4773,13-02-2021 18:00,24 hrs.,RobinHoodPennyStocks,PHI,6,0,6,-6,1,1,0,1,NYSE
4773,13-02-2021 18:00,24 hrs.,RobinHoodPennyStocks,SOS,50,0,50,-50,1,9,28,1,NYSE
4773,13-02-2021 18:00,24 hrs.,RobinHoodPennyStocks,IPOE,6,6,0,6,1,1,0,1,NYSE
4773,13-02-2021 18:00,24 hrs.,RobinHoodPennyStocks,PLTR,6,0,6,-6,1,1,0,1,NYSE
4773,13-02-2021 18:00,24 hrs.,RobinHoodPennyStocks,JFU,6,0,6,-6,1,1,0,1,NASDAQ
4773,13-02-2021 18:00,24 hrs.,RobinHoodPennyStocks,SND,64,38,26,12,3,18,16,3,NASDAQ
4773,13-02-2021 18:00,24 hrs.,RobinHoodPennyStocks,ABEO,125,0,125,-125,1,48,25,1,NASDAQ
4773,13-02-2021 18:00,24 hrs.,RobinHoodPennyStocks,AEZS,143,0,143,-143,1,58,23,1,NASDAQ
4773,13-02-2021 18:00,24 hrs.,RobinHoodPennyStocks,AGEN,6,6,0,6,1,1,0,1,NASDAQ
4773,13-02-2021 18:00,24 hrs.,RobinHoodPennyStocks,AGTC,252,0,252,-252,5,72,88,5,NASDAQ
4773,13-02-2021 18:00,24 hrs.,RobinHoodPennyStocks,ARTL,6,0,6,-6,1,1,0,1,NASDAQ
4773,13-02-2021 18:00,24 hrs.,RobinHoodPennyStocks,ASRT,81,0,81,-81,2,33,7,2,NASDAQ
4773,13-02-2021 18:00,24 hrs.,RobinHoodPennyStocks,ATOS,7,0,7,-7,1,1,1,1,NASDAQ
4773,13-02-2021 18:00,24 hrs.,RobinHoodPennyStocks,BHTG,67,0,67,-67,2,21,17,2,NASDAQ
4773,13-02-2021 18:00,24 hrs.,RobinHoodPennyStocks,BIOL,6,0,6,-6,1,1,0,1,NASDAQ
4773,13-02-2021 18:00,24 hrs.,RobinHoodPennyStocks,BNGO,40,6,34,-28,3,10,8,3,NASDAQ
4773,13-02-2021 18:00,24 hrs.,SPACs,SNPR,405,0,405,-405,7,136,105,5,NYSE
4773,13-02-2021 18:00,24 hrs.,SPACs,STPK,48,0,48,-48,3,8,20,3,NYSE
4773,13-02-2021 18:00,24 hrs.,SPACs,TPGY,35,0,35,-35,1,6,19,1,NYSE
4773,13-02-2021 18:00,24 hrs.,SPACs,VTOL,166,0,166,-166,1,60,42,1,NYSE
4773,13-02-2021 18:00,24 hrs.,SPACs,VYGG,58,20,38,-18,4,12,18,2,NYSE
4773,13-02-2021 18:00,24 hrs.,SPACs,ADV,581,0,581,-581,1,35,507,1,NASDAQ
4773,13-02-2021 18:00,24 hrs.,SPACs,CFO,223,0,223,-223,2,78,59,2,NASDAQ
4773,13-02-2021 18:00,24 hrs.,SPACs,ESG,20,0,20,-20,1,7,2,1,NASDAQ
4773,13-02-2021 18:00,24 hrs.,SPACs,III,164,23,141,-118,2,54,48,2,NASDAQ
4773,13-02-2021 18:00,24 hrs.,SPACs,AACQ,2629,115,2514,-2399,11,836,913,9,NASDAQ
4773,13-02-2021 18:00,24 hrs.,SPACs,ACAC,14,14,0,14,1,4,2,1,NASDAQ
4773,13-02-2021 18:00,24 hrs.,SPACs,ACTC,35,0,35,-35,1,6,19,1,NASDAQ
4773,13-02-2021 18:00,24 hrs.,SPACs,ADOC,73,0,73,-73,1,20,29,1,NASDAQ
4773,13-02-2021 18:00,24 hrs.,SPACs,BHSE,73,0,73,-73,1,20,29,1,NASDAQ
4773,13-02-2021 18:00,24 hrs.,wallstreetbets,LIFE,20,14,6,8,3,3,2,3,NASDAQ
4773,13-02-2021 18:00,24 hrs.,wallstreetbets,LKCO,6,6,0,6,1,1,0,1,NASDAQ
4773,13-02-2021 18:00,24 hrs.,wallstreetbets,LLIT,7,0,7,-7,1,1,1,1,NASDAQ
4773,13-02-2021 18:00,24 hrs.,wallstreetbets,LLNW,6,0,6,-6,1,1,0,1,NASDAQ
4773,13-02-2021 18:00,24 hrs.,wallstreetbets,LOAN,14,0,14,-14,2,2,2,2,NASDAQ
4773,13-02-2021 18:00,24 hrs.,wallstreetbets,LSCC,23,23,0,23,1,8,3,1,NASDAQ
4773,13-02-2021 18:00,24 hrs.,wallstreetbets,LXRX,7,7,0,7,1,1,1,1,NASDAQ
4773,13-02-2021 18:00,24 hrs.,wallstreetbets,MARA,22,8,14,-6,3,3,4,3,NASDAQ
4773,13-02-2021 18:00,24 hrs.,wallstreetbets,MARK,7,0,7,-7,1,1,1,1,NASDAQ
4773,13-02-2021 18:00,24 hrs.,wallstreetbets,MBIO,6,0,6,-6,1,1,0,1,NASDAQ
4773,13-02-2021 18:00,24 hrs.,wallstreetbets,MBRX,7,0,7,-7,1,1,1,1,NASDAQ
4773,13-02-2021 18:00,24 hrs.,wallstreetbets,MESO,59,59,0,59,1,17,21,1,NASDAQ
4773,13-02-2021 18:00,24 hrs.,wallstreetbets,MOGO,7,0,7,-7,1,1,1,1,NASDAQ
4773,13-02-2021 18:00,24 hrs.,wallstreetbets,MRKR,6,0,6,-6,1,1,0,1,NASDAQ
4773,13-02-2021 18:00,24 hrs.,wallstreetbets,MRVL,7,0,7,-7,1,1,1,1,NASDAQ
4773,13-02-2021 18:00,24 hrs.,wallstreetbets,MSFT,10120,0,10120,-10120,1,4754,608,1,NASDAQ
4773,13-02-2021 18:00,24 hrs.,wallstreetbets,MSTR,9,0,9,-9,1,2,1,1,NASDAQ
4773,13-02-2021 18:00,24 hrs.,wallstreetbets,MVIS,71,14,57,-43,3,2,55,3,NASDAQ
4773,13-02-2021 18:00,24 hrs.,wallstreetbets,NAKD,85,28,57,-29,12,12,13,10,NASDAQ
4773,13-02-2021 18:00,24 hrs.,wallstreetbets,NBAC,14,0,14,-14,2,2,2,1,NASDAQ
4773,13-02-2021 18:00,24 hrs.,wallstreetbets,NCLH,28,0,28,-28,4,4,4,3,NASDAQ
4773,13-02-2021 18:00,24 hrs.,wallstreetbets,NCNO,317,317,0,317,1,138,37,1,NASDAQ
4773,13-02-2021 18:00,24 hrs.,wallstreetbets,NEPT,7,7,0,7,1,1,1,1,NASDAQ
4773,13-02-2021 18:00,24 hrs.,wallstreetbets,NGAC,6,6,0,6,1,1,0,1,NASDAQ
4773,13-02-2021 18:00,24 hrs.,wallstreetbets,COCP,7,0,7,-7,1,1,1,1,NASDAQ
4773,13-02-2021 18:00,24 hrs.,wallstreetbets,CPRT,23,23,0,23,1,8,3,1,NASDAQ
4773,13-02-2021 18:00,24 hrs.,wallstreetbets,CRBP,20,6,14,-8,3,3,2,3,NASDAQ
4773,13-02-2021 18:00,24 hrs.,wallstreetbets,CRON,14,0,14,-14,2,2,2,2,NASDAQ
4773,13-02-2021 18:00,24 hrs.,wallstreetbets,CRSP,75,0,75,-75,4,3,53,2,NASDAQ
4773,13-02-2021 18:00,24 hrs.,wallstreetbets,CRSR,641,20,621,-601,10,237,127,8,NASDAQ
4773,13-02-2021 18:00,24 hrs.,wallstreetbets,CTMX,7,0,7,-7,1,1,1,1,NASDAQ
4773,13-02-2021 18:00,24 hrs.,wallstreetbets,CTRM,97,41,56,-15,14,14,13,12,NASDAQ
4773,13-02-2021 18:00,24 hrs.,wallstreetbets,CVAC,70,0,70,-70,1,24,18,1,NASDAQ
4773,13-02-2021 18:00,24 hrs.,wallstreetbets,DENN,23,23,0,23,1,8,3,1,NASDAQ
4773,13-02-2021 18:00,24 hrs.,wallstreetbets,DKNG,145,138,7,131,2,51,35,2,NASDAQ
4773,13-02-2021 18:00,24 hrs.,wallstreetbets,DRIV,6,0,6,-6,1,1,0,1,NASDAQ
4773,13-02-2021 18:00,24 hrs.,wallstreetbets,DXYN,7,0,7,-7,1,1,1,1,NASDAQ
4773,13-02-2021 18:00,24 hrs.,wallstreetbets,EBON,49,0,49,-49,7,7,7,3,NASDAQ
4773,13-02-2021 18:00,24 hrs.,wallstreetbets,EDIT,10227,0,10227,-10227,2,4787,645,2,NASDAQ
4773,13-02-2021 18:00,24 hrs.,wallstreetbets,EHTH,23,23,0,23,1,8,3,1,NASDAQ
4773,13-02-2021 18:00,24 hrs.,wallstreetbets,ENLV,7,0,7,-7,1,1,1,1,NASDAQ
4773,13-02-2021 18:00,24 hrs.,wallstreetbets,ENVB,26,0,26,-26,4,4,2,3,NASDAQ
4773,13-02-2021 18:00,24 hrs.,wallstreetbets,EVBG,23,23,0,23,1,8,3,1,NASDAQ
4773,13-02-2021 18:00,24 hrs.,wallstreetbets,EVER,21,0,21,-21,3,3,3,3,NASDAQ
4773,13-02-2021 18:00,24 hrs.,wallstreetbets,EVFM,6,6,0,6,1,1,0,1,NASDAQ
4773,13-02-2021 18:00,24 hrs.,wallstreetbets,EXPC,7,0,7,-7,1,1,1,1,NASDAQ
4773,13-02-2021 18:00,24 hrs.,wallstreetbets,EXPI,12,6,6,0,2,2,0,2,NASDAQ
4773,13-02-2021 18:00,24 hrs.,wallstreetbets,FAST,7,0,7,-7,1,1,1,1,NASDAQ
4773,13-02-2021 18:00,24 hrs.,wallstreetbets,FIZZ,331,331,0,331,3,140,39,2,NASDAQ
4773,13-02-2021 18:00,24 hrs.,wallstreetbets,FLGT,6,0,6,-6,1,1,0,1,NASDAQ
4773,13-02-2021 18:00,24 hrs.,SPACs,NKLA,35,0,35,-35,1,6,19,1,NASDAQ
4773,13-02-2021 18:00,24 hrs.,SPACs,OKTA,60,0,60,-60,1,19,18,1,NASDAQ
4773,13-02-2021 18:00,24 hrs.,SPACs,PRCH,40,0,40,-40,1,15,6,1,NASDAQ
4773,13-02-2021 18:00,24 hrs.,SPACs,PYPL,109,0,109,-109,1,41,23,1,NASDAQ
4773,13-02-2021 18:00,24 hrs.,SPACs,QELL,166,0,166,-166,1,60,42,1,NASDAQ
4773,13-02-2021 18:00,24 hrs.,SPACs,RIDE,35,0,35,-35,1,6,19,1,NASDAQ
4773,13-02-2021 18:00,24 hrs.,SPACs,ROCH,35,0,35,-35,1,6,19,1,NASDAQ
4773,13-02-2021 18:00,24 hrs.,SPACs,SRAC,8,0,8,-8,1,1,2,1,NASDAQ
4773,13-02-2021 18:00,24 hrs.,SPACs,SSPK,35,0,35,-35,1,6,19,1,NASDAQ
4773,13-02-2021 18:00,24 hrs.,SPACs,THBR,581,0,581,-581,1,35,507,1,NASDAQ
4773,13-02-2021 18:00,24 hrs.,SPACs,THCB,616,0,616,-616,2,41,526,2,NASDAQ
4773,13-02-2021 18:00,24 hrs.,SPACs,VTIQ,35,0,35,-35,1,6,19,1,NASDAQ
4773,13-02-2021 18:00,24 hrs.,SPACs,AACQW,8,8,0,8,1,1,2,1,NASDAQ
4773,13-02-2021 18:00,24 hrs.,SPACs,CMLFW,581,0,581,-581,1,35,507,1,NASDAQ
4773,13-02-2021 18:00,24 hrs.,SPACs,DSACW,581,0,581,-581,1,35,507,1,NASDAQ
4773,13-02-2021 18:00,24 hrs.,SPACs,EXPCW,581,0,581,-581,1,35,507,1,NASDAQ
4773,13-02-2021 18:00,24 hrs.,SPACs,FCACW,581,0,581,-581,1,35,507,1,NASDAQ
4773,13-02-2021 18:00,24 hrs.,SPACs,NBACR,5,0,5,-5,1,0,1,1,NASDAQ
4773,13-02-2021 18:00,24 hrs.,SPACs,NBACW,5,0,5,-5,1,0,1,1,NASDAQ
4773,13-02-2021 18:00,24 hrs.,SPACs,SAIIW,581,0,581,-581,1,35,507,1,NASDAQ
4773,13-02-2021 18:00,24 hrs.,SPACs,TWCTW,581,0,581,-581,1,35,507,1,NASDAQ
4773,13-02-2021 18:00,24 hrs.,stocks,ABML,14,14,0,14,1,1,8,1,OTC
4773,13-02-2021 18:00,24 hrs.,stocks,BLSP,6,0,6,-6,1,1,0,1,OTC
4773,13-02-2021 18:00,24 hrs.,stocks,BONZ,6,0,6,-6,1,1,0,1,OTC
4773,13-02-2021 18:00,24 hrs.,stocks,CAPC,6,0,6,-6,1,1,0,1,OTC
4773,13-02-2021 18:00,24 hrs.,stocks,ETCG,6,0,6,-6,1,1,0,1,OTC
4773,13-02-2021 18:00,24 hrs.,SPACs,BRRN,11,0,11,-11,1,2,3,1,OTC
4773,13-02-2021 18:00,24 hrs.,SPACs,NOVC,6,6,0,6,1,0,2,1,OTC
4773,13-02-2021 18:00,24 hrs.,SPACs,PTK,73,0,73,-73,1,20,29,1,AMEX
4773,13-02-2021 18:00,24 hrs.,SPACs,CHAQ,73,0,73,-73,1,20,29,1,AMEX
4773,13-02-2021 18:00,24 hrs.,SPACs,AIR,166,0,166,-166,1,60,42,1,NYSE
4773,13-02-2021 18:00,24 hrs.,SPACs,AMC,15,15,0,15,1,0,11,1,NYSE
4773,13-02-2021 18:00,24 hrs.,SPACs,BFT,595,7,588,-581,3,37,509,3,NYSE
4773,13-02-2021 18:00,24 hrs.,SPACs,DFS,166,0,166,-166,1,60,42,1,NYSE
4773,13-02-2021 18:00,24 hrs.,SPACs,ELY,20,0,20,-20,1,7,2,1,NYSE
4773,13-02-2021 18:00,24 hrs.,SPACs,EQD,581,0,581,-581,1,35,507,1,NYSE
4773,13-02-2021 18:00,24 hrs.,SPACs,FSR,35,0,35,-35,1,6,19,1,NYSE
4773,13-02-2021 18:00,24 hrs.,SPACs,GME,15,15,0,15,1,0,11,1,NYSE
4773,13-02-2021 18:00,24 hrs.,SPACs,JWS,623,0,623,-623,7,41,513,3,NYSE
4773,13-02-2021 18:00,24 hrs.,SPACs,NAV,221,207,14,193,5,69,63,4,NYSE
4773,13-02-2021 18:00,24 hrs.,SPACs,NGA,35,0,35,-35,1,6,19,1,NYSE
4773,13-02-2021 18:00,24 hrs.,SPACs,RBC,7,0,7,-7,1,1,1,1,NYSE
4773,13-02-2021 18:00,24 hrs.,SPACs,RMO,6,0,6,-6,1,1,0,1,NYSE
4773,13-02-2021 18:00,24 hrs.,SPACs,RTP,581,0,581,-581,1,35,507,1,NYSE
4773,13-02-2021 18:00,24 hrs.,SPACs,SBE,405,0,405,-405,3,137,119,2,NYSE
4773,13-02-2021 18:00,24 hrs.,SPACs,SOS,7,0,7,-7,1,1,1,1,NYSE
4773,13-02-2021 18:00,24 hrs.,SPACs,YUM,57,0,57,-57,1,18,17,1,NYSE
4773,13-02-2021 18:00,24 hrs.,SPACs,ACIC,587,6,581,-575,2,36,507,2,NYSE
4773,13-02-2021 18:00,24 hrs.,SPACs,AVAN,25,25,0,25,1,6,9,1,NYSE
4773,13-02-2021 18:00,24 hrs.,SPACs,CCIV,1016,283,733,-450,12,134,700,12,NYSE
4773,13-02-2021 18:00,24 hrs.,SPACs,DNMR,55,48,7,41,2,16,15,2,NYSE
4773,13-02-2021 18:00,24 hrs.,SPACs,EMPW,581,0,581,-581,1,35,507,1,NYSE
4773,13-02-2021 18:00,24 hrs.,SPACs,ENPC,581,0,581,-581,1,35,507,1,NYSE
4773,13-02-2021 18:00,24 hrs.,SPACs,FGNA,1125,0,1125,-1125,2,366,385,1,NYSE
4773,13-02-2021 18:00,24 hrs.,SPACs,FUSE,1615,0,1615,-1615,4,354,891,4,NYSE
4773,13-02-2021 18:00,24 hrs.,SPACs,GSAH,984,0,984,-984,1,318,344,1,NYSE
4773,13-02-2021 18:00,24 hrs.,SPACs,HYLN,35,0,35,-35,1,6,19,1,NYSE
4773,13-02-2021 18:00,24 hrs.,SPACs,IPOE,984,0,984,-984,1,318,344,1,NYSE
4773,13-02-2021 18:00,24 hrs.,SPACs,IPOF,11,6,5,1,2,1,1,2,NYSE
4773,13-02-2021 18:00,24 hrs.,SPACs,LGVW,42,7,35,-28,2,7,20,2,NYSE
4773,13-02-2021 18:00,24 hrs.,SPACs,MPLN,8,8,0,8,1,1,2,1,NYSE
4773,13-02-2021 18:00,24 hrs.,SPACs,PDAC,7,0,7,-7,1,1,1,1,NYSE
4773,13-02-2021 18:00,24 hrs.,SPACs,PSTH,880,114,766,-652,9,246,352,8,NYSE
4773,13-02-2021 18:00,24 hrs.,SPACs,SKLZ,27,27,0,27,4,4,3,1,NYSE
4773,13-02-2021 18:00,24 hrs.,stocks,DASH,6,0,6,-6,1,1,0,1,NYSE
4773,13-02-2021 18:00,24 hrs.,stocks,DSSI,6,6,0,6,1,0,2,1,NYSE
4773,13-02-2021 18:00,24 hrs.,stocks,FSLY,86,86,0,86,1,36,10,1,NYSE
4773,13-02-2021 18:00,24 hrs.,stocks,FVRR,86,86,0,86,1,36,10,1,NYSE
4773,13-02-2021 18:00,24 hrs.,stocks,HOME,26,0,26,-26,1,6,10,1,NYSE
4773,13-02-2021 18:00,24 hrs.,stocks,HUYA,6,0,6,-6,1,1,0,1,NYSE
4773,13-02-2021 18:00,24 hrs.,stocks,NYCB,34,34,0,34,1,6,18,1,NYSE
4773,13-02-2021 18:00,24 hrs.,stocks,PLTR,731,174,557,-383,6,280,147,5,NYSE
4773,13-02-2021 18:00,24 hrs.,stocks,SHOP,162,86,76,10,2,52,50,2,NYSE
4773,13-02-2021 18:00,24 hrs.,stocks,SNAP,18,18,0,18,1,2,10,1,NYSE
4773,13-02-2021 18:00,24 hrs.,stocks,FRCH,12,0,12,-12,1,4,0,1,OTC
4773,13-02-2021 18:00,24 hrs.,stocks,GRYN,6,0,6,-6,1,1,0,1,OTC
4773,13-02-2021 18:00,24 hrs.,stocks,HCMC,16,0,16,-16,1,1,10,1,OTC
4773,13-02-2021 18:00,24 hrs.,stocks,HEMP,34,0,34,-34,1,7,16,1,OTC
4773,13-02-2021 18:00,24 hrs.,stocks,IGEN,6,0,6,-6,1,1,0,1,OTC
4773,13-02-2021 18:00,24 hrs.,stocks,IJJP,6,0,6,-6,1,1,0,1,OTC
4773,13-02-2021 18:00,24 hrs.,stocks,KYNC,6,6,0,6,1,1,0,1,OTC
4773,13-02-2021 18:00,24 hrs.,stocks,LINK,86,86,0,86,1,36,10,1,OTC
4773,13-02-2021 18:00,24 hrs.,stocks,LTNC,6,6,0,6,1,1,0,1,OTC
4773,13-02-2021 18:00,24 hrs.,stocks,MINE,24,18,6,12,4,4,0,2,OTC
4773,13-02-2021 18:00,24 hrs.,stocks,MOST,86,86,0,86,1,36,10,1,OTC
4773,13-02-2021 18:00,24 hrs.,stocks,NMTC,27,27,0,27,1,10,3,1,OTC
4773,13-02-2021 18:00,24 hrs.,stocks,SGMD,6,6,0,6,1,1,0,1,OTC
4773,13-02-2021 18:00,24 hrs.,stocks,SNYR,6,0,6,-6,1,1,0,1,OTC
4773,13-02-2021 18:00,24 hrs.,stocks,SOBR,6,6,0,6,1,1,0,1,OTC
4773,13-02-2021 18:00,24 hrs.,stocks,SSET,7,0,7,-7,1,1,1,1,OTC
4773,13-02-2021 18:00,24 hrs.,stocks,XFLS,4,4,0,4,1,0,0,1,OTC
4773,13-02-2021 18:00,24 hrs.,stocks,EMHTF,6,0,6,-6,1,1,0,1,OTC
4773,13-02-2021 18:00,24 hrs.,stocks,HITIF,6,6,0,6,1,1,0,1,OTC
4773,13-02-2021 18:00,24 hrs.,stocks,HRSTW,6,0,6,-6,1,1,0,1,OTC
4773,13-02-2021 18:00,24 hrs.,stocks,ILIKF,6,0,6,-6,1,1,0,1,OTC
4773,13-02-2021 18:00,24 hrs.,stocks,MMEDF,12,0,12,-12,2,2,0,1,OTC
4773,13-02-2021 18:00,24 hrs.,stocks,NXTTF,6,0,6,-6,1,1,0,1,OTC
4773,13-02-2021 18:00,24 hrs.,stocks,OILFF,6,0,6,-6,1,1,0,1,OTC
4773,13-02-2021 18:00,24 hrs.,stocks,RHHBY,32,0,32,-32,1,10,8,1,OTC
4773,13-02-2021 18:00,24 hrs.,stocks,RVVTF,13,0,13,-13,2,2,1,2,OTC
4773,13-02-2021 18:00,24 hrs.,stocks,TBUIF,6,0,6,-6,1,1,0,1,OTC
4773,13-02-2021 18:00,24 hrs.,stocks,XJNGF,6,6,0,6,1,1,0,1,OTC
4773,13-02-2021 18:00,24 hrs.,stocks,DNN,31,0,31,-31,1,7,13,1,AMEX
4773,13-02-2021 18:00,24 hrs.,stocks,GTE,13,0,13,-13,2,2,1,2,AMEX
4773,13-02-2021 18:00,24 hrs.,stocks,IGC,6,0,6,-6,1,1,0,1,AMEX
4773,13-02-2021 18:00,24 hrs.,stocks,ZOM,6,0,6,-6,1,1,0,1,AMEX
4773,13-02-2021 18:00,24 hrs.,stocks,GSAT,18,0,18,-18,3,3,0,1,AMEX
4773,13-02-2021 18:00,24 hrs.,stocks,SENS,25,19,6,13,3,2,9,2,AMEX
4773,13-02-2021 18:00,24 hrs.,stocks,AAP,86,86,0,86,1,36,10,1,NYSE
4773,13-02-2021 18:00,24 hrs.,stocks,ADT,6,0,6,-6,1,1,0,1,NYSE
4773,13-02-2021 18:00,24 hrs.,stocks,AMC,119,0,119,-119,4,23,57,4,NYSE
4773,13-02-2021 18:00,24 hrs.,stocks,ASX,6,0,6,-6,1,1,0,1,NYSE
4773,13-02-2021 18:00,24 hrs.,stocks,BEP,166,0,166,-166,1,52,58,1,NYSE
4773,13-02-2021 18:00,24 hrs.,stocks,BKH,22,22,0,22,1,6,6,1,NYSE
4773,13-02-2021 18:00,24 hrs.,stocks,CMA,6,6,0,6,1,1,0,1,NYSE
4773,13-02-2021 18:00,24 hrs.,stocks,CVS,114,86,28,58,3,43,16,3,NYSE
4773,13-02-2021 18:00,24 hrs.,SPACs,BRPA,616,0,616,-616,2,41,526,2,NASDAQ
4773,13-02-2021 18:00,24 hrs.,SPACs,BTAQ,583,0,583,-583,1,238,103,1,NASDAQ
4773,13-02-2021 18:00,24 hrs.,SPACs,CIIC,67,0,67,-67,2,17,25,1,NASDAQ
4773,13-02-2021 18:00,24 hrs.,SPACs,CMLF,616,0,616,-616,2,41,526,2,NASDAQ
4773,13-02-2021 18:00,24 hrs.,SPACs,DFHT,581,0,581,-581,1,35,507,1,NASDAQ
4773,13-02-2021 18:00,24 hrs.,SPACs,FCAC,593,0,593,-593,3,37,507,2,NASDAQ
4773,13-02-2021 18:00,24 hrs.,SPACs,FTOC,557,0,557,-557,6,200,133,5,NASDAQ
4773,13-02-2021 18:00,24 hrs.,SPACs,GHIV,23,23,0,23,1,6,7,1,NASDAQ
4773,13-02-2021 18:00,24 hrs.,SPACs,GRCY,73,0,73,-73,1,20,29,1,NASDAQ
4773,13-02-2021 18:00,24 hrs.,SPACs,GRSV,107,0,107,-107,3,31,33,3,NASDAQ
4773,13-02-2021 18:00,24 hrs.,SPACs,MACU,73,0,73,-73,1,20,29,1,NASDAQ
4773,13-02-2021 18:00,24 hrs.,SPACs,NBAC,53,15,38,-23,3,17,7,3,NASDAQ
4773,13-02-2021 18:00,24 hrs.,stocks,GAN,7,0,7,-7,1,1,1,1,NASDAQ
4773,13-02-2021 18:00,24 hrs.,stocks,GSM,71,0,71,-71,2,22,19,1,NASDAQ
4773,13-02-2021 18:00,24 hrs.,stocks,INO,6,0,6,-6,1,1,0,1,NASDAQ
4773,13-02-2021 18:00,24 hrs.,stocks,NIU,97,97,0,97,1,26,41,1,NASDAQ
4773,13-02-2021 18:00,24 hrs.,stocks,PEP,38,0,38,-38,1,10,14,1,NASDAQ
4773,13-02-2021 18:00,24 hrs.,stocks,REG,6,6,0,6,1,1,0,1,NASDAQ
4773,13-02-2021 18:00,24 hrs.,stocks,SMH,33,0,33,-33,1,5,19,1,NASDAQ
4773,13-02-2021 18:00,24 hrs.,stocks,SPI,6,0,6,-6,1,1,0,1,NASDAQ
4773,13-02-2021 18:00,24 hrs.,stocks,VFF,6,6,0,6,1,1,0,1,NASDAQ
4773,13-02-2021 18:00,24 hrs.,stocks,WBA,22,0,22,-22,1,6,6,1,NASDAQ
4773,13-02-2021 18:00,24 hrs.,stocks,AESE,6,0,6,-6,1,1,0,1,NASDAQ
4773,13-02-2021 18:00,24 hrs.,stocks,AGEN,10,0,10,-10,1,3,0,1,NASDAQ
4773,13-02-2021 18:00,24 hrs.,stocks,AMAT,22,22,0,22,1,3,12,1,NASDAQ
4773,13-02-2021 18:00,24 hrs.,stocks,AMZN,182,0,182,-182,2,54,66,2,NASDAQ
4773,13-02-2021 18:00,24 hrs.,stocks,ANTE,12,12,0,12,2,2,0,1,NASDAQ
4773,13-02-2021 18:00,24 hrs.,stocks,APHA,103,103,0,103,2,27,41,2,NASDAQ
4773,13-02-2021 18:00,24 hrs.,stocks,BIGC,86,86,0,86,1,36,10,1,NASDAQ
4773,13-02-2021 18:00,24 hrs.,stocks,BNGO,18,18,0,18,3,3,0,3,NASDAQ
4773,13-02-2021 18:00,24 hrs.,stocks,BYND,6,0,6,-6,1,1,0,1,NASDAQ
4773,13-02-2021 18:00,24 hrs.,stocks,CCRC,6,6,0,6,1,1,0,1,NASDAQ
4773,13-02-2021 18:00,24 hrs.,stocks,CLVR,17,0,17,-17,1,3,7,1,NASDAQ
4773,13-02-2021 18:00,24 hrs.,stocks,DDD,86,86,0,86,1,36,10,1,NYSE
4773,13-02-2021 18:00,24 hrs.,stocks,DDS,86,86,0,86,1,36,10,1,NYSE
4773,13-02-2021 18:00,24 hrs.,stocks,DPG,13,0,13,-13,1,3,3,1,NYSE
4773,13-02-2021 18:00,24 hrs.,stocks,EFT,11,11,0,11,1,2,3,1,NYSE
4773,13-02-2021 18:00,24 hrs.,stocks,FTI,12,12,0,12,2,2,0,2,NYSE
4773,13-02-2021 18:00,24 hrs.,stocks,GME,1792,98,1694,-1596,12,758,228,11,NYSE
4773,13-02-2021 18:00,24 hrs.,stocks,HPQ,91,91,0,91,1,34,19,1,NYSE
4773,13-02-2021 18:00,24 hrs.,stocks,IBM,1566,1102,464,638,3,702,150,3,NYSE
4773,13-02-2021 18:00,24 hrs.,stocks,IGT,86,86,0,86,1,36,10,1,NYSE
4773,13-02-2021 18:00,24 hrs.,stocks,IRS,9,0,9,-9,1,0,5,1,NYSE
4773,13-02-2021 18:00,24 hrs.,stocks,JNJ,28,22,6,16,2,7,6,2,NYSE
4773,13-02-2021 18:00,24 hrs.,stocks,JPM,22,22,0,22,1,6,6,1,NYSE
4773,13-02-2021 18:00,24 hrs.,stocks,LEG,22,22,0,22,1,6,6,1,NYSE
4773,13-02-2021 18:00,24 hrs.,stocks,LOW,9,0,9,-9,1,0,5,1,NYSE
4773,13-02-2021 18:00,24 hrs.,stocks,LPL,86,86,0,86,1,36,10,1,NYSE
4773,13-02-2021 18:00,24 hrs.,stocks,MAC,53,53,0,53,1,21,7,1,NYSE
4773,13-02-2021 18:00,24 hrs.,stocks,MFA,6,6,0,6,1,1,0,1,NYSE
4773,13-02-2021 18:00,24 hrs.,stocks,MGM,12,0,12,-12,1,1,6,1,NYSE
4773,13-02-2021 18:00,24 hrs.,stocks,MMM,22,22,0,22,1,6,6,1,NYSE
4773,13-02-2021 18:00,24 hrs.,stocks,MTD,86,86,0,86,1,36,10,1,NYSE
4773,13-02-2021 18:00,24 hrs.,stocks,NET,1000,991,9,982,2,421,150,2,NYSE
4773,13-02-2021 18:00,24 hrs.,stocks,NGL,6,6,0,6,1,1,0,1,NYSE
4773,13-02-2021 18:00,24 hrs.,stocks,NIO,205,76,129,-53,8,43,87,5,NYSE
4773,13-02-2021 18:00,24 hrs.,stocks,NOK,6,0,6,-6,1,1,0,1,NYSE
4773,13-02-2021 18:00,24 hrs.,stocks,NSA,1080,1080,0,1080,1,488,100,1,NYSE
4773,13-02-2021 18:00,24 hrs.,stocks,OSK,16,0,16,-16,2,1,6,1,NYSE
4773,13-02-2021 18:00,24 hrs.,stocks,RAD,22,0,22,-22,1,6,6,1,NYSE
4773,13-02-2021 18:00,24 hrs.,stocks,RDY,6,0,6,-6,1,1,0,1,NYSE
4773,13-02-2021 18:00,24 hrs.,stocks,RTX,43,0,43,-43,1,12,15,1,NYSE
4773,13-02-2021 18:00,24 hrs.,stocks,SBE,25,25,0,25,2,4,9,2,NYSE
4773,13-02-2021 18:00,24 hrs.,stocks,SHO,6,6,0,6,1,1,0,1,NYSE
4773,13-02-2021 18:00,24 hrs.,stocks,SKT,86,86,0,86,1,36,10,1,NYSE
4773,13-02-2021 18:00,24 hrs.,stocks,SOS,6,0,6,-6,1,1,0,1,NYSE
4773,13-02-2021 18:00,24 hrs.,stocks,SQZ,7,0,7,-7,1,1,1,1,NYSE
4773,13-02-2021 18:00,24 hrs.,stocks,SUP,6,0,6,-6,1,1,0,1,NYSE
4773,13-02-2021 18:00,24 hrs.,stocks,TDA,9,9,0,9,1,0,5,1,NYSE
4773,13-02-2021 18:00,24 hrs.,stocks,WMT,252,86,166,-80,2,88,68,2,NYSE
4773,13-02-2021 18:00,24 hrs.,stocks,XOM,22,22,0,22,1,6,6,1,NYSE
4773,13-02-2021 18:00,24 hrs.,stocks,AJRD,166,0,166,-166,1,52,58,1,NYSE
4773,13-02-2021 18:00,24 hrs.,stocks,APTV,166,0,166,-166,1,52,58,1,NYSE
4773,13-02-2021 18:00,24 hrs.,stocks,BABA,6,0,6,-6,1,1,0,1,NYSE
4773,13-02-2021 18:00,24 hrs.,stocks,CCIV,18,6,12,-6,3,3,0,3,NYSE
4773,13-02-2021 18:00,24 hrs.,stocks,CHWY,117,91,26,65,2,40,29,2,NYSE
4773,13-02-2021 18:00,24 hrs.,stocks,DRIV,9,9,0,9,1,2,1,1,NASDAQ
4773,13-02-2021 18:00,24 hrs.,stocks,EDIT,216,0,216,-216,3,62,80,3,NASDAQ
4773,13-02-2021 18:00,24 hrs.,stocks,ENPH,166,0,166,-166,1,52,58,1,NASDAQ
4773,13-02-2021 18:00,24 hrs.,stocks,EXPI,35,29,6,23,3,9,5,3,NASDAQ
4773,13-02-2021 18:00,24 hrs.,stocks,FIZZ,86,86,0,86,1,36,10,1,NASDAQ
4773,13-02-2021 18:00,24 hrs.,stocks,FNKO,26,0,26,-26,1,10,2,1,NASDAQ
4773,13-02-2021 18:00,24 hrs.,stocks,FROG,6,6,0,6,1,1,0,1,NASDAQ
4773,13-02-2021 18:00,24 hrs.,stocks,GLUU,6,6,0,6,1,1,0,1,NASDAQ
4773,13-02-2021 18:00,24 hrs.,stocks,GNOG,6,6,0,6,1,1,0,1,NASDAQ
4773,13-02-2021 18:00,24 hrs.,stocks,GOGO,86,86,0,86,1,36,10,1,NASDAQ
4773,13-02-2021 18:00,24 hrs.,stocks,ITRM,15,6,9,-3,2,3,1,2,NASDAQ
4773,13-02-2021 18:00,24 hrs.,stocks,KLIC,19,19,0,19,1,7,1,1,NASDAQ
4773,13-02-2021 18:00,24 hrs.,stocks,LLNW,30,0,30,-30,1,8,10,1,NASDAQ
4773,13-02-2021 18:00,24 hrs.,stocks,LMPX,26,0,26,-26,1,10,2,1,NASDAQ
4773,13-02-2021 18:00,24 hrs.,stocks,MITK,6,0,6,-6,1,1,0,1,NASDAQ
4773,13-02-2021 18:00,24 hrs.,stocks,MOGO,18,0,18,-18,3,3,0,2,NASDAQ
4773,13-02-2021 18:00,24 hrs.,stocks,MRNA,6,0,6,-6,1,1,0,1,NASDAQ
4773,13-02-2021 18:00,24 hrs.,stocks,MSFT,464,0,464,-464,1,208,44,1,NASDAQ
4773,13-02-2021 18:00,24 hrs.,stocks,NBAC,6,0,6,-6,1,1,0,1,NASDAQ
4773,13-02-2021 18:00,24 hrs.,stocks,NCNO,86,86,0,86,1,36,10,1,NASDAQ
4773,13-02-2021 18:00,24 hrs.,stocks,NKLA,6,0,6,-6,1,1,0,1,NASDAQ
4773,13-02-2021 18:00,24 hrs.,stocks,NMTR,9,0,9,-9,1,1,3,1,NASDAQ
4773,13-02-2021 18:00,24 hrs.,stocks,NVDA,51,0,51,-51,2,15,13,2,NASDAQ
4773,13-02-2021 18:00,24 hrs.,stocks,NXTD,6,6,0,6,1,1,0,1,NASDAQ
4773,13-02-2021 18:00,24 hrs.,stocks,OCGN,6,0,6,-6,1,1,0,1,NASDAQ
4773,13-02-2021 18:00,24 hrs.,stocks,OCSL,12,0,12,-12,2,2,0,1,NASDAQ
4773,13-02-2021 18:00,24 hrs.,stocks,ONCR,7,0,7,-7,1,1,1,1,NASDAQ
4773,13-02-2021 18:00,24 hrs.,stocks,PBCT,22,22,0,22,1,6,6,1,NASDAQ
4773,13-02-2021 18:00,24 hrs.,stocks,PLUG,6,0,6,-6,1,1,0,1,NASDAQ
4773,13-02-2021 18:00,24 hrs.,stocks,QDEL,6,0,6,-6,1,1,0,1,NASDAQ
4773,13-02-2021 18:00,24 hrs.,stocks,QFIN,6,0,6,-6,1,1,0,1,NASDAQ
4773,13-02-2021 18:00,24 hrs.,stocks,QQQJ,284,251,33,218,2,87,102,2,NASDAQ
4773,13-02-2021 18:00,24 hrs.,stocks,QQQM,284,251,33,218,2,87,102,2,NASDAQ
4773,13-02-2021 18:00,24 hrs.,stocks,RDFN,23,23,0,23,1,7,5,1,NASDAQ
4773,13-02-2021 18:00,24 hrs.,stocks,REGN,6,6,0,6,1,1,0,1,NASDAQ
4773,13-02-2021 18:00,24 hrs.,stocks,RIOT,12,12,0,12,2,2,0,1,NASDAQ
4773,13-02-2021 18:00,24 hrs.,stocks,ROKU,86,86,0,86,1,36,10,1,NASDAQ
4773,13-02-2021 18:00,24 hrs.,stocks,RRGB,31,31,0,31,1,7,13,1,NASDAQ
4773,13-02-2021 18:00,24 hrs.,stocks,SEDG,166,0,166,-166,1,52,58,1,NASDAQ
4773,13-02-2021 18:00,24 hrs.,stocks,SESN,7,0,7,-7,1,1,1,1,NASDAQ
4773,13-02-2021 18:00,24 hrs.,stocks,SHIP,11,0,11,-11,1,2,3,1,NASDAQ
4773,13-02-2021 18:00,24 hrs.,stocks,SNDL,24,0,24,-24,4,4,0,3,NASDAQ
4773,13-02-2021 18:00,24 hrs.,stocks,SNGX,25,0,25,-25,4,4,1,4,NASDAQ
4773,13-02-2021 18:00,24 hrs.,stocks,SRAC,6,0,6,-6,1,1,0,1,NASDAQ
4773,13-02-2021 18:00,24 hrs.,stocks,SRNE,166,0,166,-166,1,52,58,1,NASDAQ
4773,13-02-2021 18:00,24 hrs.,stocks,TFFP,21,21,0,21,2,3,7,1,NASDAQ
4773,13-02-2021 18:00,24 hrs.,stocks,TIGR,6,0,6,-6,1,1,0,1,NASDAQ
4773,13-02-2021 18:00,24 hrs.,stocks,TLRY,92,92,0,92,2,37,10,2,NASDAQ
4773,13-02-2021 18:00,24 hrs.,stocks,TRCH,20,7,13,-6,3,3,2,3,NASDAQ
4773,13-02-2021 18:00,24 hrs.,stocks,TREE,86,86,0,86,1,36,10,1,NASDAQ
4773,13-02-2021 18:00,24 hrs.,stocks,TRVG,12,0,12,-12,2,2,0,2,NASDAQ
4773,13-02-2021 18:00,24 hrs.,stocks,TSLA,1731,0,1731,-1731,9,650,395,6,NASDAQ
4773,13-02-2021 18:00,24 hrs.,stocks,TTGT,6,0,6,-6,1,1,0,1,NASDAQ
4773,13-02-2021 18:00,24 hrs.,stocks,VGLT,6,6,0,6,1,1,0,1,NASDAQ
4773,13-02-2021 18:00,24 hrs.,stocks,VRNT,14,0,14,-14,1,3,4,1,NASDAQ
4773,13-02-2021 18:00,24 hrs.,wallstreetbets,NKLA,7,0,7,-7,1,1,1,1,NASDAQ
4773,13-02-2021 18:00,24 hrs.,stocks,SPCE,295,97,198,-101,3,85,113,3,NYSE
4773,13-02-2021 18:00,24 hrs.,stocks,TWLO,102,86,16,70,3,37,16,2,NYSE
4773,13-02-2021 18:00,24 hrs.,stocks,TWTR,6,0,6,-6,1,1,0,1,NYSE
4773,13-02-2021 18:00,24 hrs.,stocks,VGAC,6,0,6,-6,1,1,0,1,NYSE
4773,13-02-2021 18:00,24 hrs.,stocks,XPEV,89,0,89,-89,5,13,43,2,NYSE
4773,13-02-2021 18:00,24 hrs.,stocks,AMD,6,0,6,-6,1,1,0,1,NASDAQ
4773,13-02-2021 18:00,24 hrs.,stocks,BLI,86,86,0,86,1,36,10,1,NASDAQ
4773,13-02-2021 18:00,24 hrs.,stocks,CFO,6,6,0,6,1,1,0,1,NASDAQ
4773,13-02-2021 18:00,24 hrs.,wallstreetbets,PGNY,7,0,7,-7,1,1,1,1,NASDAQ
4773,13-02-2021 18:00,24 hrs.,wallstreetbets,PLAY,1420,1420,0,1420,2,643,126,2,NASDAQ
4773,13-02-2021 18:00,24 hrs.,wallstreetbets,PLYA,13,0,13,-13,2,2,1,1,NASDAQ
4773,13-02-2021 18:00,24 hrs.,wallstreetbets,POWW,21,14,7,7,3,3,3,3,NASDAQ
4773,13-02-2021 18:00,24 hrs.,wallstreetbets,PRCH,70,0,70,-70,2,15,32,1,NASDAQ
4773,13-02-2021 18:00,24 hrs.,wallstreetbets,PSEC,6,0,6,-6,1,0,2,1,NASDAQ
4773,13-02-2021 18:00,24 hrs.,wallstreetbets,PTON,7,7,0,7,1,1,1,1,NASDAQ
4773,13-02-2021 18:00,24 hrs.,wallstreetbets,QCOM,13,6,7,-1,2,2,1,2,NASDAQ
4773,13-02-2021 18:00,24 hrs.,wallstreetbets,QDEL,23,23,0,23,1,8,3,1,NASDAQ
4773,13-02-2021 18:00,24 hrs.,wallstreetbets,QQQJ,24,0,24,-24,1,7,6,1,NASDAQ
4773,13-02-2021 18:00,24 hrs.,wallstreetbets,RAVE,14,0,14,-14,2,2,2,2,NASDAQ
4773,13-02-2021 18:00,24 hrs.,wallstreetbets,REAL,227,7,220,-213,4,43,125,4,NASDAQ
4773,13-02-2021 18:00,24 hrs.,wallstreetbets,REGI,7,0,7,-7,1,1,1,1,NASDAQ
4773,13-02-2021 18:00,24 hrs.,wallstreetbets,REGN,14,14,0,14,2,2,2,1,NASDAQ
4773,13-02-2021 18:00,24 hrs.,wallstreetbets,RIDE,69,0,69,-69,10,10,9,7,NASDAQ
4773,13-02-2021 18:00,24 hrs.,wallstreetbets,RIOT,48,14,34,-20,7,7,6,5,NASDAQ
4773,13-02-2021 18:00,24 hrs.,wallstreetbets,ROKU,491,485,6,479,5,198,75,5,NASDAQ
4773,13-02-2021 18:00,24 hrs.,wallstreetbets,SEAC,7,0,7,-7,1,1,1,1,NASDAQ
4773,13-02-2021 18:00,24 hrs.,wallstreetbets,SEDG,23,23,0,23,1,8,3,1,NASDAQ
4773,13-02-2021 18:00,24 hrs.,wallstreetbets,SGEN,7,7,0,7,1,1,1,1,NASDAQ
4773,13-02-2021 18:00,24 hrs.,wallstreetbets,SHIP,95,40,55,-15,9,8,43,8,NASDAQ
4773,13-02-2021 18:00,24 hrs.,wallstreetbets,SNCA,6,0,6,-6,1,1,0,1,NASDAQ
4773,13-02-2021 18:00,24 hrs.,wallstreetbets,SNDL,1733,181,1552,-1371,111,440,409,92,NASDAQ
4773,13-02-2021 18:00,24 hrs.,wallstreetbets,SNGX,40,6,34,-28,6,6,4,5,NASDAQ
4773,13-02-2021 18:00,24 hrs.,wallstreetbets,SQQQ,7,7,0,7,1,1,1,1,NASDAQ
4773,13-02-2021 18:00,24 hrs.,wallstreetbets,SRAC,13,7,6,1,2,2,1,2,NASDAQ
4773,13-02-2021 18:00,24 hrs.,wallstreetbets,SRNE,14,0,14,-14,2,2,2,2,NASDAQ
4773,13-02-2021 18:00,24 hrs.,wallstreetbets,SSRM,6,0,6,-6,1,1,0,1,NASDAQ
4773,13-02-2021 18:00,24 hrs.,wallstreetbets,STAF,13,6,7,-1,2,2,1,2,NASDAQ
4773,13-02-2021 18:00,24 hrs.,wallstreetbets,STAY,6,0,6,-6,1,1,0,1,NASDAQ
4773,13-02-2021 18:00,24 hrs.,wallstreetbets,STMP,23,23,0,23,1,8,3,1,NASDAQ
4773,13-02-2021 18:00,24 hrs.,wallstreetbets,SWBI,35,7,28,-21,5,5,5,4,NASDAQ
4773,13-02-2021 18:00,24 hrs.,wallstreetbets,TECH,7,0,7,-7,1,1,1,1,NASDAQ
4773,13-02-2021 18:00,24 hrs.,wallstreetbets,THCB,6,0,6,-6,1,1,0,1,NASDAQ
4773,13-02-2021 18:00,24 hrs.,wallstreetbets,TLGT,7,0,7,-7,1,1,1,1,NASDAQ
4773,13-02-2021 18:00,24 hrs.,wallstreetbets,TLRY,1416,389,1027,-638,27,468,372,21,NASDAQ
4773,13-02-2021 18:00,24 hrs.,wallstreetbets,TLSA,7,0,7,-7,1,1,1,1,NASDAQ
4773,13-02-2021 18:00,24 hrs.,wallstreetbets,TNXP,70,21,49,-28,10,10,10,5,NASDAQ
4773,13-02-2021 18:00,24 hrs.,wallstreetbets,TOPS,34,0,34,-34,5,5,4,4,NASDAQ
4773,13-02-2021 18:00,24 hrs.,wallstreetbets,TQQQ,35,0,35,-35,5,5,5,1,NASDAQ
4773,13-02-2021 18:00,24 hrs.,wallstreetbets,TRCH,26,19,7,12,4,4,2,4,NASDAQ
4773,13-02-2021 18:00,24 hrs.,wallstreetbets,TREE,317,317,0,317,1,138,37,1,NASDAQ
4773,13-02-2021 18:00,24 hrs.,wallstreetbets,TRIT,26,0,26,-26,4,4,2,3,NASDAQ
4773,13-02-2021 18:00,24 hrs.,wallstreetbets,TRVG,564,12,552,-540,26,160,140,19,NASDAQ
4773,13-02-2021 18:00,24 hrs.,wallstreetbets,TSLA,3232,1311,1921,-610,20,1213,726,16,NASDAQ
4773,13-02-2021 18:00,24 hrs.,wallstreetbets,TTCF,7,0,7,-7,1,1,1,1,NASDAQ
4773,13-02-2021 18:00,24 hrs.,wallstreetbets,TTOO,7,0,7,-7,1,1,1,1,NASDAQ
4773,13-02-2021 18:00,24 hrs.,wallstreetbets,TXMD,6,6,0,6,1,1,0,1,NASDAQ
4773,13-02-2021 18:00,24 hrs.,wallstreetbets,TXRH,23,23,0,23,1,8,3,1,NASDAQ
4773,13-02-2021 18:00,24 hrs.,wallstreetbets,VISL,7,7,0,7,1,1,1,1,NASDAQ
4773,13-02-2021 18:00,24 hrs.,wallstreetbets,VIVO,7,7,0,7,1,1,1,1,NASDAQ
4773,13-02-2021 18:00,24 hrs.,wallstreetbets,VKTX,7,0,7,-7,1,1,1,1,NASDAQ
4773,13-02-2021 18:00,24 hrs.,wallstreetbets,VOXX,6,0,6,-6,1,1,0,1,NASDAQ
4773,13-02-2021 18:00,24 hrs.,wallstreetbets,VSAT,7,0,7,-7,1,1,1,1,NASDAQ
4773,13-02-2021 18:00,24 hrs.,wallstreetbets,VTGN,7,0,7,-7,1,1,1,1,NASDAQ
4773,13-02-2021 18:00,24 hrs.,wallstreetbets,VUZI,28,7,21,-14,4,4,4,2,NASDAQ
4773,13-02-2021 18:00,24 hrs.,stocks,CMPS,6,0,6,-6,1,1,0,1,NASDAQ
4773,13-02-2021 18:00,24 hrs.,stocks,CRBP,7,0,7,-7,1,1,1,1,NASDAQ
4773,13-02-2021 18:00,24 hrs.,stocks,CREG,6,0,6,-6,1,1,0,1,NASDAQ
4773,13-02-2021 18:00,24 hrs.,stocks,CRNC,31,0,31,-31,1,8,11,1,NASDAQ
4773,13-02-2021 18:00,24 hrs.,stocks,CRNT,6,6,0,6,1,1,0,1,NASDAQ
4773,13-02-2021 18:00,24 hrs.,stocks,CRON,82,0,82,-82,1,19,40,1,NASDAQ
4773,13-02-2021 18:00,24 hrs.,stocks,CRSP,166,0,166,-166,1,52,58,1,NASDAQ
4773,13-02-2021 18:00,24 hrs.,stocks,CRWD,166,0,166,-166,1,52,58,1,NASDAQ
4773,13-02-2021 18:00,24 hrs.,trakstocks,INND,10,0,10,-10,1,0,6,1,OTC
4773,13-02-2021 18:00,24 hrs.,trakstocks,DMNXF,54,54,0,54,2,15,16,2,OTC
4773,13-02-2021 18:00,24 hrs.,trakstocks,MGROF,19,0,19,-19,1,5,5,1,OTC
4773,13-02-2021 18:00,24 hrs.,trakstocks,NMGRF,46,0,46,-46,1,17,8,1,OTC
4773,13-02-2021 18:00,24 hrs.,trakstocks,NXTTF,10,0,10,-10,1,3,0,1,OTC
4773,13-02-2021 18:00,24 hrs.,trakstocks,PYRNF,10,0,10,-10,1,2,2,1,OTC
4773,13-02-2021 18:00,24 hrs.,trakstocks,VRYYF,7,0,7,-7,1,1,1,1,OTC
4773,13-02-2021 18:00,24 hrs.,trakstocks,DNN,90,0,90,-90,1,34,18,1,AMEX
4773,13-02-2021 18:00,24 hrs.,trakstocks,DPW,12,0,12,-12,2,2,0,2,AMEX
4773,13-02-2021 18:00,24 hrs.,trakstocks,BFT,6,0,6,-6,1,1,0,1,NYSE
4773,13-02-2021 18:00,24 hrs.,trakstocks,NAT,15,15,0,15,1,4,3,1,NYSE
4773,13-02-2021 18:00,24 hrs.,trakstocks,SOS,24,0,24,-24,1,9,2,1,NYSE
4773,13-02-2021 18:00,24 hrs.,trakstocks,SWN,9,0,9,-9,1,2,1,1,NYSE
4773,13-02-2021 18:00,24 hrs.,trakstocks,PLTR,41,41,0,41,1,16,5,1,NYSE
4773,13-02-2021 18:00,24 hrs.,trakstocks,STPK,114,41,73,-32,4,37,24,3,NYSE
4773,13-02-2021 18:00,24 hrs.,trakstocks,AQB,15,0,15,-15,1,4,3,1,NASDAQ
4773,13-02-2021 18:00,24 hrs.,trakstocks,OEG,29,0,29,-29,1,10,5,1,NASDAQ
4773,13-02-2021 18:00,24 hrs.,trakstocks,AYRO,172,10,162,-152,3,58,44,3,NASDAQ
4773,13-02-2021 18:00,24 hrs.,trakstocks,BHTG,460,0,460,-460,1,167,122,1,NASDAQ
4773,13-02-2021 18:00,24 hrs.,trakstocks,CFII,105,0,105,-105,1,39,23,1,NASDAQ
4773,13-02-2021 18:00,24 hrs.,trakstocks,CLVS,30,19,11,8,2,9,4,2,NASDAQ
4773,13-02-2021 18:00,24 hrs.,trakstocks,CPSH,36,0,36,-36,1,12,8,1,NASDAQ
4773,13-02-2021 18:00,24 hrs.,trakstocks,ENLV,8,8,0,8,1,2,0,1,NASDAQ
4773,13-02-2021 18:00,24 hrs.,trakstocks,EXPC,14,0,14,-14,1,4,2,1,NASDAQ
4773,13-02-2021 18:00,24 hrs.,trakstocks,IMMR,56,0,56,-56,1,21,10,1,NASDAQ
4773,13-02-2021 18:00,24 hrs.,trakstocks,LIFE,12,0,12,-12,1,0,8,1,NASDAQ
4773,13-02-2021 18:00,24 hrs.,trakstocks,MARA,53,0,53,-53,1,22,5,1,NASDAQ
4773,13-02-2021 18:00,24 hrs.,trakstocks,RIOT,63,0,63,-63,2,23,9,2,NASDAQ
4773,13-02-2021 18:00,24 hrs.,trakstocks,SNDL,41,41,0,41,1,16,5,1,NASDAQ
4773,13-02-2021 18:00,24 hrs.,trakstocks,TLRY,41,41,0,41,1,16,5,1,NASDAQ
4773,13-02-2021 18:00,24 hrs.,trakstocks,TRIT,105,0,105,-105,1,39,23,1,NASDAQ
4773,13-02-2021 18:00,24 hrs.,trakstocks,TTCF,24,0,24,-24,2,2,12,2,NASDAQ
4773,13-02-2021 18:00,24 hrs.,StockMarket,ABML,6,0,6,-6,1,1,0,1,OTC
4773,13-02-2021 18:00,24 hrs.,StockMarket,BOTH,9,9,0,9,1,0,5,1,OTC
4773,13-02-2021 18:00,24 hrs.,StockMarket,BOTY,8,8,0,8,1,1,2,1,OTC
4773,13-02-2021 18:00,24 hrs.,StockMarket,GBTC,18,18,0,18,3,2,2,1,OTC
4773,13-02-2021 18:00,24 hrs.,StockMarket,GTEH,6,0,6,-6,1,1,0,1,OTC
4773,13-02-2021 18:00,24 hrs.,StockMarket,KGET,6,0,6,-6,1,1,0,1,OTC
4773,13-02-2021 18:00,24 hrs.,StockMarket,LINK,44,44,0,44,1,18,4,1,OTC
4773,13-02-2021 18:00,24 hrs.,wallstreetbets,VXRT,56,42,14,28,8,8,8,3,NASDAQ
4773,13-02-2021 18:00,24 hrs.,wallstreetbets,WATT,14,7,7,0,2,2,2,2,NASDAQ
4773,13-02-2021 18:00,24 hrs.,wallstreetbets,WIMI,7,7,0,7,1,1,1,1,NASDAQ
4773,13-02-2021 18:00,24 hrs.,wallstreetbets,WING,23,23,0,23,1,8,3,1,NASDAQ
4773,13-02-2021 18:00,24 hrs.,wallstreetbets,WKHS,164,152,12,140,5,54,36,4,NASDAQ
4773,13-02-2021 18:00,24 hrs.,wallstreetbets,WRAP,7,0,7,-7,1,1,1,1,NASDAQ
4773,13-02-2021 18:00,24 hrs.,wallstreetbets,WSBC,8,8,0,8,1,1,2,1,NASDAQ
4773,13-02-2021 18:00,24 hrs.,wallstreetbets,XENE,14,0,14,-14,2,2,2,1,NASDAQ
4773,13-02-2021 18:00,24 hrs.,wallstreetbets,XSPA,37,0,37,-37,6,6,1,6,NASDAQ
4773,13-02-2021 18:00,24 hrs.,wallstreetbets,YNDX,23,23,0,23,1,8,3,1,NASDAQ
4773,13-02-2021 18:00,24 hrs.,wallstreetbets,ZNGA,15,0,15,-15,2,2,3,2,NASDAQ
4773,13-02-2021 18:00,24 hrs.,wallstreetbets,CMCSA,14,7,7,0,2,2,2,2,NASDAQ
4773,13-02-2021 18:00,24 hrs.,wallstreetbets,GOOGL,6,0,6,-6,1,1,0,1,NASDAQ
4773,13-02-2021 18:00,24 hrs.,wallstreetbets,SRACU,6,0,6,-6,1,1,0,1,NASDAQ
4773,13-02-2021 18:00,24 hrs.,wallstreetbets,SRACW,6,0,6,-6,1,1,0,1,NASDAQ
4773,13-02-2021 18:00,24 hrs.,RobinHoodPennyStocks,BGMD,4,0,4,-4,1,0,0,1,OTC
4773,13-02-2021 18:00,24 hrs.,RobinHoodPennyStocks,CRWG,6,0,6,-6,1,1,0,1,OTC
4773,13-02-2021 18:00,24 hrs.,wallstreetbets,NLOK,14,7,7,0,2,2,2,2,NASDAQ
4773,13-02-2021 18:00,24 hrs.,wallstreetbets,NNDM,53,39,14,25,4,3,31,3,NASDAQ
4773,13-02-2021 18:00,24 hrs.,wallstreetbets,NOVN,29,0,29,-29,4,4,5,3,NASDAQ
4773,13-02-2021 18:00,24 hrs.,wallstreetbets,NVAX,13,7,6,1,2,2,1,2,NASDAQ
4773,13-02-2021 18:00,24 hrs.,wallstreetbets,NVDA,7,7,0,7,1,1,1,1,NASDAQ
4773,13-02-2021 18:00,24 hrs.,wallstreetbets,NVIV,7,0,7,-7,1,1,1,1,NASDAQ
4773,13-02-2021 18:00,24 hrs.,wallstreetbets,OCGN,32,6,26,-20,5,5,2,4,NASDAQ
4773,13-02-2021 18:00,24 hrs.,wallstreetbets,ONTX,14,0,14,-14,2,2,2,2,NASDAQ
4773,13-02-2021 18:00,24 hrs.,StockMarket,TRU,44,44,0,44,1,18,4,1,NYSE
4773,13-02-2021 18:00,24 hrs.,StockMarket,VMC,44,44,0,44,1,18,4,1,NYSE
4773,13-02-2021 18:00,24 hrs.,StockMarket,VRT,13,0,13,-13,1,3,3,1,NYSE
4773,13-02-2021 18:00,24 hrs.,StockMarket,WMT,44,44,0,44,1,18,4,1,NYSE
4773,13-02-2021 18:00,24 hrs.,StockMarket,XPO,64,0,64,-64,1,29,2,1,NYSE
4773,13-02-2021 18:00,24 hrs.,StockMarket,ZTS,44,44,0,44,1,18,4,1,NYSE
4773,13-02-2021 18:00,24 hrs.,StockMarket,ABBV,10,10,0,10,1,1,4,1,NYSE
4773,13-02-2021 18:00,24 hrs.,StockMarket,CCIV,31,6,25,-19,2,8,7,2,NYSE
4773,13-02-2021 18:00,24 hrs.,StockMarket,CHWY,6,0,6,-6,1,1,0,1,NYSE
4773,13-02-2021 18:00,24 hrs.,StockMarket,COTY,5,0,5,-5,1,0,1,1,NYSE
4773,13-02-2021 18:00,24 hrs.,StockMarket,DSSI,6,0,6,-6,1,1,0,1,NYSE
4773,13-02-2021 18:00,24 hrs.,StockMarket,FSLY,44,44,0,44,1,18,4,1,NYSE
4773,13-02-2021 18:00,24 hrs.,StockMarket,FVRR,44,44,0,44,1,18,4,1,NYSE
4773,13-02-2021 18:00,24 hrs.,StockMarket,GDDY,64,0,64,-64,1,29,2,1,NYSE
4773,13-02-2021 18:00,24 hrs.,StockMarket,MAXD,50,0,50,-50,3,14,10,3,OTC
4773,13-02-2021 18:00,24 hrs.,StockMarket,MOST,44,44,0,44,1,18,4,1,OTC
4773,13-02-2021 18:00,24 hrs.,StockMarket,PHIL,8,0,8,-8,1,2,0,1,OTC
4773,13-02-2021 18:00,24 hrs.,StockMarket,SGMD,42,0,42,-42,3,12,6,2,OTC
4773,13-02-2021 18:00,24 hrs.,StockMarket,AYRWF,25,0,25,-25,1,8,5,1,OTC
4773,13-02-2021 18:00,24 hrs.,StockMarket,BMWLF,25,0,25,-25,1,8,5,1,OTC
4773,13-02-2021 18:00,24 hrs.,StockMarket,CADMF,6,6,0,6,1,1,0,1,OTC
4773,13-02-2021 18:00,24 hrs.,StockMarket,CRLBF,25,0,25,-25,1,8,5,1,OTC
4773,13-02-2021 18:00,24 hrs.,StockMarket,CURLF,25,0,25,-25,1,8,5,1,OTC
4773,13-02-2021 18:00,24 hrs.,StockMarket,DIGAF,6,0,6,-6,1,1,0,1,OTC
4773,13-02-2021 18:00,24 hrs.,StockMarket,GTBIF,25,0,25,-25,1,8,5,1,OTC
4773,13-02-2021 18:00,24 hrs.,StockMarket,LHSIF,25,0,25,-25,1,8,5,1,OTC
4773,13-02-2021 18:00,24 hrs.,StockMarket,NXTTF,12,12,0,12,2,2,0,1,OTC
4773,13-02-2021 18:00,24 hrs.,StockMarket,RAZFF,6,0,6,-6,1,1,0,1,OTC
4773,13-02-2021 18:00,24 hrs.,StockMarket,RWBYF,25,0,25,-25,1,8,5,1,OTC
4773,13-02-2021 18:00,24 hrs.,StockMarket,RYCEY,6,0,6,-6,1,1,0,1,OTC
4773,13-02-2021 18:00,24 hrs.,StockMarket,TCNNF,25,0,25,-25,1,8,5,1,OTC
4773,13-02-2021 18:00,24 hrs.,StockMarket,TFECY,18,0,18,-18,3,3,0,1,OTC
4773,13-02-2021 18:00,24 hrs.,StockMarket,XJNGF,13,13,0,13,1,1,7,1,OTC
4773,13-02-2021 18:00,24 hrs.,StockMarket,ZBISF,36,0,36,-36,1,12,8,1,OTC
4773,13-02-2021 18:00,24 hrs.,StockMarket,DNN,18,0,18,-18,1,6,2,1,AMEX
4773,13-02-2021 18:00,24 hrs.,StockMarket,DSS,6,0,6,-6,1,1,0,1,AMEX
4773,13-02-2021 18:00,24 hrs.,StockMarket,MXC,9,9,0,9,1,0,5,1,AMEX
4773,13-02-2021 18:00,24 hrs.,StockMarket,TRX,6,0,6,-6,1,1,0,1,AMEX
4773,13-02-2021 18:00,24 hrs.,StockMarket,ZOM,6,6,0,6,1,1,0,1,AMEX
4773,13-02-2021 18:00,24 hrs.,stocks,VUZI,6,0,6,-6,1,1,0,1,NASDAQ
4773,13-02-2021 18:00,24 hrs.,stocks,VXRT,6,0,6,-6,1,1,0,1,NASDAQ
4773,13-02-2021 18:00,24 hrs.,stocks,VXUS,29,0,29,-29,2,7,7,2,NASDAQ
4773,13-02-2021 18:00,24 hrs.,stocks,WDAY,14,0,14,-14,1,3,4,1,NASDAQ
4773,13-02-2021 18:00,24 hrs.,stocks,WIMI,6,6,0,6,1,1,0,1,NASDAQ
4773,13-02-2021 18:00,24 hrs.,stocks,XONE,11,0,11,-11,1,2,3,1,NASDAQ
4773,13-02-2021 18:00,24 hrs.,stocks,ZGNX,6,0,6,-6,1,1,0,1,NASDAQ
4773,13-02-2021 18:00,24 hrs.,stocks,LILAK,12,0,12,-12,2,2,0,1,NASDAQ
4773,13-02-2021 18:00,24 hrs.,stocks,SRACU,6,0,6,-6,1,1,0,1,NASDAQ
4773,13-02-2021 18:00,24 hrs.,stocks,SRACW,6,0,6,-6,1,1,0,1,NASDAQ
4773,13-02-2021 18:00,24 hrs.,Daytrading,SGMD,21,0,21,-21,1,5,7,1,OTC
4773,13-02-2021 18:00,24 hrs.,Daytrading,GTE,7,7,0,7,1,1,1,1,AMEX
4773,13-02-2021 18:00,24 hrs.,Daytrading,AMC,6,0,6,-6,1,1,0,1,NYSE
4773,13-02-2021 18:00,24 hrs.,Daytrading,GME,297,0,297,-297,2,118,53,2,NYSE
4773,13-02-2021 18:00,24 hrs.,Daytrading,NIO,12,12,0,12,1,2,4,1,NYSE
4773,13-02-2021 18:00,24 hrs.,Daytrading,PDT,9,0,9,-9,1,1,3,1,NYSE
4773,13-02-2021 18:00,24 hrs.,Daytrading,AAPL,12,12,0,12,1,2,4,1,NASDAQ
4773,13-02-2021 18:00,24 hrs.,Daytrading,ARTL,15,0,15,-15,2,3,1,2,NASDAQ
4773,13-02-2021 18:00,24 hrs.,Daytrading,BNGO,118,0,118,-118,1,43,28,1,NASDAQ
4773,13-02-2021 18:00,24 hrs.,Daytrading,EBON,6,0,6,-6,1,1,0,1,NASDAQ
4773,13-02-2021 18:00,24 hrs.,Daytrading,SNDL,36,36,0,36,1,5,22,1,NASDAQ
4773,13-02-2021 18:00,24 hrs.,Daytrading,TLRY,7,0,7,-7,1,1,1,1,NASDAQ
4773,13-02-2021 18:00,24 hrs.,Daytrading,TSLA,19,0,19,-19,1,2,11,1,NASDAQ
4773,13-02-2021 18:00,24 hrs.,trakstocks,ALPP,6,0,6,-6,1,1,0,1,OTC
4773,13-02-2021 18:00,24 hrs.,trakstocks,HCMC,10,0,10,-10,1,0,6,1,OTC
4773,13-02-2021 18:00,24 hrs.,wallstreetbets,HAS,6,0,6,-6,1,1,0,1,NASDAQ
4773,13-02-2021 18:00,24 hrs.,wallstreetbets,IEA,7,0,7,-7,1,1,1,1,NASDAQ
4773,13-02-2021 18:00,24 hrs.,wallstreetbets,IIN,6,0,6,-6,1,1,0,1,NASDAQ
4773,13-02-2021 18:00,24 hrs.,wallstreetbets,INO,70,0,70,-70,4,9,36,4,NASDAQ
4773,13-02-2021 18:00,24 hrs.,wallstreetbets,JFU,6,0,6,-6,1,1,0,1,NASDAQ
4773,13-02-2021 18:00,24 hrs.,wallstreetbets,KHC,14,0,14,-14,2,2,2,2,NASDAQ
4773,13-02-2021 18:00,24 hrs.,wallstreetbets,MKD,13,6,7,-1,2,2,1,2,NASDAQ
4773,13-02-2021 18:00,24 hrs.,wallstreetbets,MYT,7,0,7,-7,1,1,1,1,NASDAQ
4773,13-02-2021 18:00,24 hrs.,wallstreetbets,OGI,74,27,47,-20,11,11,8,10,NASDAQ
4773,13-02-2021 18:00,24 hrs.,wallstreetbets,PDD,7,7,0,7,1,1,1,1,NASDAQ
4773,13-02-2021 18:00,24 hrs.,wallstreetbets,QQQ,6,6,0,6,1,1,0,1,NASDAQ
4773,13-02-2021 18:00,24 hrs.,wallstreetbets,RUN,266,7,259,-252,4,79,92,4,NASDAQ
4773,13-02-2021 18:00,24 hrs.,wallstreetbets,RXT,7,0,7,-7,1,1,1,1,NASDAQ
4773,13-02-2021 18:00,24 hrs.,wallstreetbets,SDC,7,0,7,-7,1,1,1,1,NASDAQ
4773,13-02-2021 18:00,24 hrs.,wallstreetbets,SLM,8,0,8,-8,1,1,2,1,NASDAQ
4773,13-02-2021 18:00,24 hrs.,wallstreetbets,SLP,13,13,0,13,2,2,1,2,NASDAQ
4773,13-02-2021 18:00,24 hrs.,wallstreetbets,SMH,7,0,7,-7,1,1,1,1,NASDAQ
4773,13-02-2021 18:00,24 hrs.,wallstreetbets,SND,7,0,7,-7,1,1,1,1,NASDAQ
4773,13-02-2021 18:00,24 hrs.,wallstreetbets,SPT,7,0,7,-7,1,1,1,1,NASDAQ
4773,13-02-2021 18:00,24 hrs.,wallstreetbets,TTD,23,23,0,23,1,8,3,1,NASDAQ
4773,13-02-2021 18:00,24 hrs.,wallstreetbets,VFF,10,0,10,-10,1,1,4,1,NASDAQ
4773,13-02-2021 18:00,24 hrs.,wallstreetbets,WBA,7,0,7,-7,1,1,1,1,NASDAQ
4773,13-02-2021 18:00,24 hrs.,StockMarket,GSAT,24,0,24,-24,4,3,2,1,AMEX
4773,13-02-2021 18:00,24 hrs.,StockMarket,LODE,6,0,6,-6,1,1,0,1,AMEX
4773,13-02-2021 18:00,24 hrs.,StockMarket,UAVS,10,0,10,-10,1,1,4,1,AMEX
4773,13-02-2021 18:00,24 hrs.,StockMarket,AAP,44,44,0,44,1,18,4,1,NYSE
4773,13-02-2021 18:00,24 hrs.,StockMarket,ACB,64,0,64,-64,1,29,2,1,NYSE
4773,13-02-2021 18:00,24 hrs.,StockMarket,AGX,6,0,6,-6,1,1,0,1,NYSE
4773,13-02-2021 18:00,24 hrs.,StockMarket,AMC,22,0,22,-22,2,1,12,2,NYSE
4773,13-02-2021 18:00,24 hrs.,StockMarket,ASX,9,9,0,9,1,0,5,1,NYSE
4773,13-02-2021 18:00,24 hrs.,StockMarket,BKI,44,44,0,44,1,18,4,1,NYSE
4773,13-02-2021 18:00,24 hrs.,StockMarket,CBD,10,10,0,10,1,1,4,1,NYSE
4773,13-02-2021 18:00,24 hrs.,StockMarket,CMA,6,6,0,6,1,1,0,1,NYSE
4773,13-02-2021 18:00,24 hrs.,StockMarket,CMO,41,41,0,41,1,18,1,1,NYSE
4773,13-02-2021 18:00,24 hrs.,StockMarket,CVS,44,44,0,44,1,18,4,1,NYSE
4773,13-02-2021 18:00,24 hrs.,StockMarket,DDD,44,44,0,44,1,18,4,1,NYSE
4773,13-02-2021 18:00,24 hrs.,StockMarket,DDS,44,44,0,44,1,18,4,1,NYSE
4773,13-02-2021 18:00,24 hrs.,StockMarket,DIS,64,0,64,-64,1,29,2,1,NYSE
4773,13-02-2021 18:00,24 hrs.,StockMarket,ECL,44,44,0,44,1,18,4,1,NYSE
4773,13-02-2021 18:00,24 hrs.,StockMarket,FIX,4,4,0,4,1,0,0,1,NYSE
4773,13-02-2021 18:00,24 hrs.,StockMarket,GME,110,44,66,-22,5,29,32,5,NYSE
4773,13-02-2021 18:00,24 hrs.,StockMarket,HLT,44,44,0,44,1,18,4,1,NYSE
4773,13-02-2021 18:00,24 hrs.,StockMarket,IBM,64,0,64,-64,1,29,2,1,NYSE
4773,13-02-2021 18:00,24 hrs.,StockMarket,IGT,44,44,0,44,1,18,4,1,NYSE
4773,13-02-2021 18:00,24 hrs.,StockMarket,JNJ,16,10,6,4,2,2,4,2,NYSE
4773,13-02-2021 18:00,24 hrs.,StockMarket,JPM,28,0,28,-28,1,5,14,1,NYSE
4773,13-02-2021 18:00,24 hrs.,StockMarket,LLY,64,0,64,-64,1,29,2,1,NYSE
4773,13-02-2021 18:00,24 hrs.,StockMarket,LPL,44,44,0,44,1,18,4,1,NYSE
4773,13-02-2021 18:00,24 hrs.,StockMarket,LPX,44,44,0,44,1,18,4,1,NYSE
4773,13-02-2021 18:00,24 hrs.,StockMarket,MRO,44,44,0,44,1,18,4,1,NYSE
4773,13-02-2021 18:00,24 hrs.,StockMarket,MTD,44,44,0,44,1,18,4,1,NYSE
4773,13-02-2021 18:00,24 hrs.,StockMarket,NET,10,10,0,10,1,3,0,1,NYSE
4773,13-02-2021 18:00,24 hrs.,StockMarket,NIO,324,0,324,-324,3,118,76,3,NYSE
4773,13-02-2021 18:00,24 hrs.,StockMarket,NVS,10,10,0,10,1,1,4,1,NYSE
4773,13-02-2021 18:00,24 hrs.,StockMarket,NYC,30,30,0,30,1,10,6,1,NYSE
4773,13-02-2021 18:00,24 hrs.,StockMarket,OXY,44,44,0,44,1,18,4,1,NYSE
4773,13-02-2021 18:00,24 hrs.,StockMarket,PHI,8,0,8,-8,1,2,0,1,NYSE
4773,13-02-2021 18:00,24 hrs.,StockMarket,PMO,12,12,0,12,2,2,0,1,NYSE
4773,13-02-2021 18:00,24 hrs.,StockMarket,PSA,6,0,6,-6,1,1,0,1,NYSE
4773,13-02-2021 18:00,24 hrs.,StockMarket,RNG,44,44,0,44,1,18,4,1,NYSE
4773,13-02-2021 18:00,24 hrs.,StockMarket,SKT,44,44,0,44,1,18,4,1,NYSE
4773,13-02-2021 18:00,24 hrs.,StockMarket,SMG,25,0,25,-25,1,8,5,1,NYSE
4773,13-02-2021 18:00,24 hrs.,StockMarket,SOS,6,6,0,6,1,1,0,1,NYSE
4773,13-02-2021 18:00,24 hrs.,StockMarket,THC,10,10,0,10,1,1,4,1,NYSE
4773,13-02-2021 18:00,24 hrs.,wallstreetbets,AVXL,7,0,7,-7,1,1,1,1,NASDAQ
4773,13-02-2021 18:00,24 hrs.,wallstreetbets,BBBY,145,138,7,131,2,51,35,2,NASDAQ
4773,13-02-2021 18:00,24 hrs.,wallstreetbets,BHTG,7,7,0,7,1,1,1,1,NASDAQ
4773,13-02-2021 18:00,24 hrs.,wallstreetbets,BIDU,23,23,0,23,1,8,3,1,NASDAQ
4773,13-02-2021 18:00,24 hrs.,wallstreetbets,BIGC,317,317,0,317,1,138,37,1,NASDAQ
4773,13-02-2021 18:00,24 hrs.,wallstreetbets,BIVI,6,0,6,-6,1,1,0,1,NASDAQ
4773,13-02-2021 18:00,24 hrs.,wallstreetbets,BLCM,6,0,6,-6,1,1,0,1,NASDAQ
4773,13-02-2021 18:00,24 hrs.,wallstreetbets,BLDP,7,7,0,7,1,1,1,1,NASDAQ
4773,13-02-2021 18:00,24 hrs.,wallstreetbets,BLMN,23,23,0,23,1,8,3,1,NASDAQ
4773,13-02-2021 18:00,24 hrs.,wallstreetbets,BLPH,6,6,0,6,1,1,0,1,NASDAQ
4773,13-02-2021 18:00,24 hrs.,wallstreetbets,BLRX,6,6,0,6,1,1,0,1,NASDAQ
4773,13-02-2021 18:00,24 hrs.,wallstreetbets,BNGO,446,40,406,-366,26,135,72,16,NASDAQ
4773,13-02-2021 18:00,24 hrs.,wallstreetbets,BSQR,7,7,0,7,1,1,1,1,NASDAQ
4773,13-02-2021 18:00,24 hrs.,wallstreetbets,BTWN,7,0,7,-7,1,1,1,1,NASDAQ
4773,13-02-2021 18:00,24 hrs.,wallstreetbets,BWEN,7,0,7,-7,1,1,1,1,NASDAQ
4773,13-02-2021 18:00,24 hrs.,wallstreetbets,CCRC,8,8,0,8,1,2,0,1,NASDAQ
4773,13-02-2021 18:00,24 hrs.,wallstreetbets,CIDM,13,6,7,-1,2,2,1,2,NASDAQ
4773,13-02-2021 18:00,24 hrs.,wallstreetbets,CLBS,14,14,0,14,2,2,2,2,NASDAQ
4773,13-02-2021 18:00,24 hrs.,wallstreetbets,CLEU,7,7,0,7,1,1,1,1,NASDAQ
4773,13-02-2021 18:00,24 hrs.,wallstreetbets,CLGN,7,0,7,-7,1,1,1,1,NASDAQ
4773,13-02-2021 18:00,24 hrs.,wallstreetbets,CLVS,14,14,0,14,2,2,2,1,NASDAQ
4773,13-02-2021 18:00,24 hrs.,wallstreetbets,CMPS,20,6,14,-8,3,3,2,3,NASDAQ
4773,13-02-2021 18:00,24 hrs.,StockMarket,GNRC,64,0,64,-64,1,29,2,1,NYSE
4773,13-02-2021 18:00,24 hrs.,StockMarket,HEXO,11,0,11,-11,1,3,1,1,NYSE
4773,13-02-2021 18:00,24 hrs.,StockMarket,LGVW,18,18,0,18,3,2,2,1,NYSE
4773,13-02-2021 18:00,24 hrs.,StockMarket,PINS,27,0,27,-27,1,5,13,1,NYSE
4773,13-02-2021 18:00,24 hrs.,StockMarket,PLTR,108,44,64,-20,2,47,6,2,NYSE
4773,13-02-2021 18:00,24 hrs.,StockMarket,PSTH,36,36,0,36,2,11,6,2,NYSE
4773,13-02-2021 18:00,24 hrs.,StockMarket,PUMP,6,6,0,6,1,1,0,1,NYSE
4773,13-02-2021 18:00,24 hrs.,StockMarket,SHOP,44,44,0,44,1,18,4,1,NYSE
4773,13-02-2021 18:00,24 hrs.,StockMarket,TRTN,44,44,0,44,1,18,4,1,NYSE
4773,13-02-2021 18:00,24 hrs.,StockMarket,TWLO,44,44,0,44,1,18,4,1,NYSE
4773,13-02-2021 18:00,24 hrs.,StockMarket,UBER,64,0,64,-64,1,29,2,1,NYSE
4773,13-02-2021 18:00,24 hrs.,StockMarket,USFD,44,44,0,44,1,18,4,1,NYSE
4773,13-02-2021 18:00,24 hrs.,StockMarket,VGAC,8,0,8,-8,1,0,4,1,NYSE
4773,13-02-2021 18:00,24 hrs.,StockMarket,ADI,44,44,0,44,1,18,4,1,NASDAQ
4773,13-02-2021 18:00,24 hrs.,StockMarket,AQB,8,0,8,-8,1,2,0,1,NASDAQ
4773,13-02-2021 18:00,24 hrs.,StockMarket,BLI,44,44,0,44,1,18,4,1,NASDAQ
4773,13-02-2021 18:00,24 hrs.,StockMarket,DBX,44,44,0,44,1,18,4,1,NASDAQ
4773,13-02-2021 18:00,24 hrs.,StockMarket,QQQ,99,8,91,-83,3,34,19,3,NASDAQ
4773,13-02-2021 18:00,24 hrs.,StockMarket,TTD,44,44,0,44,1,18,4,1,NASDAQ
4773,13-02-2021 18:00,24 hrs.,StockMarket,VFF,25,0,25,-25,1,8,5,1,NASDAQ
4773,13-02-2021 18:00,24 hrs.,StockMarket,WIX,44,44,0,44,1,18,4,1,NASDAQ
4773,13-02-2021 18:00,24 hrs.,StockMarket,WNW,6,6,0,6,1,1,0,1,NASDAQ
4773,13-02-2021 18:00,24 hrs.,StockMarket,AAPL,27,0,27,-27,1,5,13,1,NASDAQ
4773,13-02-2021 18:00,24 hrs.,StockMarket,AKER,6,6,0,6,1,1,0,1,NASDAQ
4773,13-02-2021 18:00,24 hrs.,StockMarket,AMAT,108,44,64,-20,2,47,6,2,NASDAQ
4773,13-02-2021 18:00,24 hrs.,StockMarket,AMGN,10,10,0,10,1,1,4,1,NASDAQ
4773,13-02-2021 18:00,24 hrs.,StockMarket,AMZN,64,0,64,-64,1,29,2,1,NASDAQ
4773,13-02-2021 18:00,24 hrs.,StockMarket,ATHX,6,0,6,-6,1,1,0,1,NASDAQ
4773,13-02-2021 18:00,24 hrs.,StockMarket,ATNF,10,10,0,10,1,1,4,1,NASDAQ
4773,13-02-2021 18:00,24 hrs.,StockMarket,ATOS,16,0,16,-16,1,6,0,1,NASDAQ
4773,13-02-2021 18:00,24 hrs.,StockMarket,BBBY,6,0,6,-6,1,1,0,1,NASDAQ
4773,13-02-2021 18:00,24 hrs.,StockMarket,BIDU,44,44,0,44,1,18,4,1,NASDAQ
4773,13-02-2021 18:00,24 hrs.,StockMarket,BIGC,44,44,0,44,1,18,4,1,NASDAQ
4773,13-02-2021 18:00,24 hrs.,wallstreetbets,BLI,317,317,0,317,1,138,37,1,NASDAQ
4773,13-02-2021 18:00,24 hrs.,wallstreetbets,BUG,12,0,12,-12,2,2,0,1,NASDAQ
4773,13-02-2021 18:00,24 hrs.,wallstreetbets,CEY,24,24,0,24,3,3,6,1,NASDAQ
4773,13-02-2021 18:00,24 hrs.,wallstreetbets,CFO,6,6,0,6,1,1,0,1,NASDAQ
4773,13-02-2021 18:00,24 hrs.,wallstreetbets,CGC,7,0,7,-7,1,1,1,1,NASDAQ
4773,13-02-2021 18:00,24 hrs.,wallstreetbets,DBX,30,23,7,16,2,9,4,2,NASDAQ
4773,13-02-2021 18:00,24 hrs.,wallstreetbets,FAT,7,0,7,-7,1,1,1,1,NASDAQ
4773,13-02-2021 18:00,24 hrs.,wallstreetbets,GBT,7,0,7,-7,1,1,1,1,NASDAQ
4773,13-02-2021 18:00,24 hrs.,wallstreetbets,GSM,13,0,13,-13,2,2,1,2,NASDAQ
4773,13-02-2021 18:00,24 hrs.,pennystocks,CTLE,43,31,12,19,7,7,1,3,OTC
4773,13-02-2021 18:00,24 hrs.,pennystocks,DIGI,13,13,0,13,1,4,1,1,OTC
4773,13-02-2021 18:00,24 hrs.,pennystocks,DPLS,109,22,87,-65,2,38,25,2,OTC
4773,13-02-2021 18:00,24 hrs.,pennystocks,DSGT,6,0,6,-6,1,1,0,1,OTC
4773,13-02-2021 18:00,24 hrs.,pennystocks,EAWD,6,0,6,-6,1,1,0,1,OTC
4773,13-02-2021 18:00,24 hrs.,StockMarket,BSQR,11,0,11,-11,1,1,5,1,NASDAQ
4773,13-02-2021 18:00,24 hrs.,StockMarket,CLVS,44,44,0,44,1,18,4,1,NASDAQ
4773,13-02-2021 18:00,24 hrs.,StockMarket,CPLP,20,0,20,-20,3,4,0,2,NASDAQ
4773,13-02-2021 18:00,24 hrs.,StockMarket,CRSR,27,0,27,-27,1,5,13,1,NASDAQ
4773,13-02-2021 18:00,24 hrs.,StockMarket,CTRM,6,0,6,-6,1,1,0,1,NASDAQ
4773,13-02-2021 18:00,24 hrs.,StockMarket,CWCO,12,0,12,-12,2,2,0,1,NASDAQ
4773,13-02-2021 18:00,24 hrs.,StockMarket,DDOG,64,0,64,-64,1,29,2,1,NASDAQ
4773,13-02-2021 18:00,24 hrs.,StockMarket,EXPD,44,44,0,44,1,18,4,1,NASDAQ
4773,13-02-2021 18:00,24 hrs.,StockMarket,FIZZ,44,44,0,44,1,18,4,1,NASDAQ
4773,13-02-2021 18:00,24 hrs.,StockMarket,FROG,64,0,64,-64,1,29,2,1,NASDAQ
4773,13-02-2021 18:00,24 hrs.,StockMarket,GOGO,44,44,0,44,1,18,4,1,NASDAQ
4773,13-02-2021 18:00,24 hrs.,StockMarket,GOLD,44,44,0,44,1,18,4,1,NASDAQ
4773,13-02-2021 18:00,24 hrs.,StockMarket,GTHX,66,6,60,-54,2,15,28,2,NASDAQ
4773,13-02-2021 18:00,24 hrs.,StockMarket,HTBX,6,6,0,6,1,1,0,1,NASDAQ
4773,13-02-2021 18:00,24 hrs.,StockMarket,IDEX,6,0,6,-6,1,1,0,1,NASDAQ
4773,13-02-2021 18:00,24 hrs.,StockMarket,INPX,6,0,6,-6,1,1,0,1,NASDAQ
4773,13-02-2021 18:00,24 hrs.,StockMarket,KLIC,9,9,0,9,1,2,1,1,NASDAQ
4773,13-02-2021 18:00,24 hrs.,StockMarket,LGND,44,44,0,44,1,18,4,1,NASDAQ
4773,13-02-2021 18:00,24 hrs.,StockMarket,MSFT,27,0,27,-27,1,5,13,1,NASDAQ
4773,13-02-2021 18:00,24 hrs.,StockMarket,NBIX,10,10,0,10,1,1,4,1,NASDAQ
4773,13-02-2021 18:00,24 hrs.,StockMarket,NCNO,44,44,0,44,1,18,4,1,NASDAQ
4773,13-02-2021 18:00,24 hrs.,StockMarket,NOVN,6,6,0,6,1,1,0,1,NASDAQ
4773,13-02-2021 18:00,24 hrs.,StockMarket,OCGN,6,0,6,-6,1,1,0,1,NASDAQ
4773,13-02-2021 18:00,24 hrs.,StockMarket,PTON,27,0,27,-27,1,5,13,1,NASDAQ
4773,13-02-2021 18:00,24 hrs.,StockMarket,RARE,64,0,64,-64,1,29,2,1,NASDAQ
4773,13-02-2021 18:00,24 hrs.,StockMarket,ROKU,44,44,0,44,1,18,4,1,NASDAQ
4773,13-02-2021 18:00,24 hrs.,StockMarket,SBUX,27,0,27,-27,1,5,13,1,NASDAQ
4773,13-02-2021 18:00,24 hrs.,StockMarket,SEDG,44,44,0,44,1,18,4,1,NASDAQ
4773,13-02-2021 18:00,24 hrs.,StockMarket,SESN,43,0,43,-43,2,15,5,1,NASDAQ
4773,13-02-2021 18:00,24 hrs.,wallstreetbets,WIX,23,23,0,23,1,8,3,1,NASDAQ
4773,13-02-2021 18:00,24 hrs.,wallstreetbets,WNW,45,0,45,-45,6,6,9,5,NASDAQ
4773,13-02-2021 18:00,24 hrs.,wallstreetbets,WWR,6,0,6,-6,1,1,0,1,NASDAQ
4773,13-02-2021 18:00,24 hrs.,wallstreetbets,AAPL,164,145,19,126,5,54,36,5,NASDAQ
4773,13-02-2021 18:00,24 hrs.,wallstreetbets,ABCL,7,0,7,-7,1,1,1,1,NASDAQ
4773,13-02-2021 18:00,24 hrs.,wallstreetbets,ABNB,6,0,6,-6,1,1,0,1,NASDAQ
4773,13-02-2021 18:00,24 hrs.,wallstreetbets,ABUS,7,0,7,-7,1,1,1,1,NASDAQ
4773,13-02-2021 18:00,24 hrs.,wallstreetbets,ACEV,6,0,6,-6,1,1,0,1,NASDAQ
4773,13-02-2021 18:00,24 hrs.,wallstreetbets,ACOR,7,0,7,-7,1,1,1,1,NASDAQ
4773,13-02-2021 18:00,24 hrs.,wallstreetbets,ACST,7,0,7,-7,1,1,1,1,NASDAQ
4773,13-02-2021 18:00,24 hrs.,wallstreetbets,ADMA,7,0,7,-7,1,1,1,1,NASDAQ
4773,13-02-2021 18:00,24 hrs.,wallstreetbets,ADMP,7,0,7,-7,1,1,1,1,NASDAQ
4773,13-02-2021 18:00,24 hrs.,wallstreetbets,AGTC,7,0,7,-7,1,1,1,1,NASDAQ
4773,13-02-2021 18:00,24 hrs.,wallstreetbets,AKBA,7,0,7,-7,1,1,1,1,NASDAQ
4773,13-02-2021 18:00,24 hrs.,wallstreetbets,ALNA,7,7,0,7,1,1,1,1,NASDAQ
4773,13-02-2021 18:00,24 hrs.,wallstreetbets,ALRN,7,0,7,-7,1,1,1,1,NASDAQ
4773,13-02-2021 18:00,24 hrs.,wallstreetbets,AMAT,29,23,6,17,2,9,3,2,NASDAQ
4773,13-02-2021 18:00,24 hrs.,wallstreetbets,AMKR,7,0,7,-7,1,1,1,1,NASDAQ
4773,13-02-2021 18:00,24 hrs.,wallstreetbets,AMZN,28,0,28,-28,4,4,4,3,NASDAQ
4773,13-02-2021 18:00,24 hrs.,wallstreetbets,ANTE,7,7,0,7,1,1,1,1,NASDAQ
4773,13-02-2021 18:00,24 hrs.,wallstreetbets,APEN,7,0,7,-7,1,1,1,1,NASDAQ
4773,13-02-2021 18:00,24 hrs.,wallstreetbets,APHA,1232,38,1194,-1156,20,477,198,9,NASDAQ
4773,13-02-2021 18:00,24 hrs.,wallstreetbets,APPN,23,23,0,23,1,8,3,1,NASDAQ
4773,13-02-2021 18:00,24 hrs.,wallstreetbets,APPS,7,7,0,7,1,1,1,1,NASDAQ
4773,13-02-2021 18:00,24 hrs.,wallstreetbets,ASRT,35,0,35,-35,5,5,5,5,NASDAQ
4773,13-02-2021 18:00,24 hrs.,wallstreetbets,ASTC,7,7,0,7,1,1,1,1,NASDAQ
4773,13-02-2021 18:00,24 hrs.,wallstreetbets,ATHA,7,0,7,-7,1,1,1,1,NASDAQ
4773,13-02-2021 18:00,24 hrs.,wallstreetbets,ATHE,6,0,6,-6,1,1,0,1,NASDAQ
4773,13-02-2021 18:00,24 hrs.,wallstreetbets,ATOS,34,0,34,-34,5,5,4,4,NASDAQ
4773,13-02-2021 18:00,24 hrs.,wallstreetbets,ATVI,37,30,7,23,2,1,27,2,NASDAQ
4773,13-02-2021 18:00,24 hrs.,pennystocks,SGMD,374,301,73,228,8,119,104,8,OTC
4773,13-02-2021 18:00,24 hrs.,pennystocks,SIML,6,0,6,-6,1,1,0,1,OTC
4773,13-02-2021 18:00,24 hrs.,pennystocks,SIRC,61,61,0,61,2,16,21,2,OTC
4773,13-02-2021 18:00,24 hrs.,pennystocks,SNPW,59,53,6,47,2,21,9,2,OTC
4773,13-02-2021 18:00,24 hrs.,pennystocks,SNYR,6,0,6,-6,1,1,0,1,OTC
4773,13-02-2021 18:00,24 hrs.,pennystocks,SOBR,6,6,0,6,1,1,0,1,OTC
4773,13-02-2021 18:00,24 hrs.,pennystocks,ECEZ,7,0,7,-7,1,1,1,1,OTC
4773,13-02-2021 18:00,24 hrs.,pennystocks,EHOS,39,0,39,-39,1,8,19,1,OTC
4773,13-02-2021 18:00,24 hrs.,pennystocks,ERBB,18,0,18,-18,1,3,8,1,OTC
4773,13-02-2021 18:00,24 hrs.,pennystocks,ETFM,230,0,230,-230,4,76,62,3,OTC
4773,13-02-2021 18:00,24 hrs.,StockMarket,SNBR,44,44,0,44,1,18,4,1,NASDAQ
4773,13-02-2021 18:00,24 hrs.,StockMarket,SNDL,209,6,203,-197,3,43,111,3,NASDAQ
4773,13-02-2021 18:00,24 hrs.,StockMarket,SPSC,64,0,64,-64,1,29,2,1,NASDAQ
4773,13-02-2021 18:00,24 hrs.,StockMarket,SPWR,44,44,0,44,1,18,4,1,NASDAQ
4773,13-02-2021 18:00,24 hrs.,StockMarket,SRAC,8,0,8,-8,1,0,4,1,NASDAQ
4773,13-02-2021 18:00,24 hrs.,StockMarket,STMP,44,44,0,44,1,18,4,1,NASDAQ
4773,13-02-2021 18:00,24 hrs.,StockMarket,TEAM,10,10,0,10,1,1,4,1,NASDAQ
4773,13-02-2021 18:00,24 hrs.,StockMarket,TLRY,56,44,12,32,3,20,4,3,NASDAQ
4773,13-02-2021 18:00,24 hrs.,StockMarket,TREE,44,44,0,44,1,18,4,1,NASDAQ
4773,13-02-2021 18:00,24 hrs.,StockMarket,TRVG,6,0,6,-6,1,1,0,1,NASDAQ
4773,13-02-2021 18:00,24 hrs.,StockMarket,TSEM,44,44,0,44,1,18,4,1,NASDAQ
4773,13-02-2021 18:00,24 hrs.,StockMarket,TSLA,4195,0,4195,-4195,1,2031,129,1,NASDAQ
4773,13-02-2021 18:00,24 hrs.,StockMarket,VITL,65,0,65,-65,1,26,9,1,NASDAQ
4773,13-02-2021 18:00,24 hrs.,StockMarket,VUZI,6,0,6,-6,1,1,0,1,NASDAQ
4773,13-02-2021 18:00,24 hrs.,StockMarket,VXRT,6,0,6,-6,1,1,0,1,NASDAQ
4773,13-02-2021 18:00,24 hrs.,StockMarket,WING,44,44,0,44,1,18,4,1,NASDAQ
4773,13-02-2021 18:00,24 hrs.,StockMarket,XONE,18,18,0,18,3,2,2,1,NASDAQ
4773,13-02-2021 18:00,24 hrs.,StockMarket,YNDX,44,44,0,44,1,18,4,1,NASDAQ
4773,13-02-2021 18:00,24 hrs.,StockMarket,ZIOP,6,0,6,-6,1,1,0,1,NASDAQ
4773,13-02-2021 18:00,24 hrs.,StockMarket,SRACU,8,0,8,-8,1,0,4,1,NASDAQ
4773,13-02-2021 18:00,24 hrs.,StockMarket,SRACW,8,0,8,-8,1,0,4,1,NASDAQ
4773,13-02-2021 18:00,24 hrs.,pennystocks,ABML,113,24,89,-65,6,33,23,3,OTC
4773,13-02-2021 18:00,24 hrs.,pennystocks,ADTM,13,0,13,-13,2,2,1,1,OTC
4773,13-02-2021 18:00,24 hrs.,pennystocks,AITX,16,16,0,16,1,5,2,1,OTC
4773,13-02-2021 18:00,24 hrs.,pennystocks,ALPP,115,0,115,-115,1,39,33,1,OTC
4773,13-02-2021 18:00,24 hrs.,pennystocks,ALST,24,0,24,-24,2,2,12,1,OTC
4773,13-02-2021 18:00,24 hrs.,pennystocks,AMAZ,6,6,0,6,1,1,0,1,OTC
4773,13-02-2021 18:00,24 hrs.,pennystocks,ASCK,6,0,6,-6,1,1,0,1,OTC
4773,13-02-2021 18:00,24 hrs.,pennystocks,ATNP,40,0,40,-40,1,5,26,1,OTC
4773,13-02-2021 18:00,24 hrs.,pennystocks,AXXA,28,0,28,-28,1,9,6,1,OTC
4773,13-02-2021 18:00,24 hrs.,pennystocks,BBRW,58,0,58,-58,3,10,26,3,OTC
4773,13-02-2021 18:00,24 hrs.,pennystocks,BFRE,16,0,16,-16,1,0,12,1,OTC
4773,13-02-2021 18:00,24 hrs.,pennystocks,BGMD,6,0,6,-6,1,1,0,1,OTC
4773,13-02-2021 18:00,24 hrs.,pennystocks,BLDV,77,0,77,-77,1,25,23,1,OTC
4773,13-02-2021 18:00,24 hrs.,pennystocks,BMMJ,6,0,6,-6,1,1,0,1,OTC
4773,13-02-2021 18:00,24 hrs.,pennystocks,BOTY,22,22,0,22,2,6,2,2,OTC
4773,13-02-2021 18:00,24 hrs.,pennystocks,BRGO,6,6,0,6,1,1,0,1,OTC
4773,13-02-2021 18:00,24 hrs.,pennystocks,BRRN,10,10,0,10,1,2,2,1,OTC
4773,13-02-2021 18:00,24 hrs.,pennystocks,BRTX,6,0,6,-6,1,1,0,1,OTC
4773,13-02-2021 18:00,24 hrs.,pennystocks,BRZL,6,0,6,-6,1,1,0,1,OTC
4773,13-02-2021 18:00,24 hrs.,pennystocks,BTZI,6,0,6,-6,1,1,0,1,OTC
4773,13-02-2021 18:00,24 hrs.,pennystocks,BZWR,16,0,16,-16,1,0,12,1,OTC
4773,13-02-2021 18:00,24 hrs.,pennystocks,CAFS,7,7,0,7,1,1,1,1,OTC
4773,13-02-2021 18:00,24 hrs.,pennystocks,CANN,6,6,0,6,1,1,0,1,OTC
4773,13-02-2021 18:00,24 hrs.,pennystocks,CATV,140,0,140,-140,1,60,16,1,OTC
4773,13-02-2021 18:00,24 hrs.,pennystocks,CAVR,6,0,6,-6,1,1,0,1,OTC
4773,13-02-2021 18:00,24 hrs.,pennystocks,CBBT,16,16,0,16,1,5,2,1,OTC
4773,13-02-2021 18:00,24 hrs.,pennystocks,CBDL,62,16,46,-30,2,17,20,2,OTC
4773,13-02-2021 18:00,24 hrs.,pennystocks,CCTL,23,0,23,-23,1,8,3,1,OTC
4773,13-02-2021 18:00,24 hrs.,pennystocks,CELZ,6,6,0,6,1,1,0,1,OTC
4773,13-02-2021 18:00,24 hrs.,pennystocks,CHNC,24,0,24,-24,1,6,8,1,OTC
4773,13-02-2021 18:00,24 hrs.,pennystocks,CNNA,86,0,86,-86,1,10,62,1,OTC
4773,13-02-2021 18:00,24 hrs.,pennystocks,COMS,13,0,13,-13,2,2,1,1,OTC
4773,13-02-2021 18:00,24 hrs.,pennystocks,CSLI,51,0,51,-51,1,15,17,1,OTC
4773,13-02-2021 18:00,24 hrs.,pennystocks,XMET,6,0,6,-6,1,1,0,1,OTC
4773,13-02-2021 18:00,24 hrs.,pennystocks,ZHUD,9,0,9,-9,1,1,3,1,OTC
4773,13-02-2021 18:00,24 hrs.,pennystocks,ABEPF,6,6,0,6,1,1,0,1,OTC
4773,13-02-2021 18:00,24 hrs.,pennystocks,AMYZF,24,24,0,24,4,4,0,1,OTC
4773,13-02-2021 18:00,24 hrs.,pennystocks,AQSZF,6,6,0,6,1,1,0,1,OTC
4773,13-02-2021 18:00,24 hrs.,pennystocks,ARBKF,82,58,24,34,2,26,22,2,OTC
4773,13-02-2021 18:00,24 hrs.,pennystocks,FLXT,6,0,6,-6,1,1,0,1,OTC
4773,13-02-2021 18:00,24 hrs.,pennystocks,FTEG,6,0,6,-6,1,1,0,1,OTC
4773,13-02-2021 18:00,24 hrs.,pennystocks,GAXY,282,22,260,-238,2,106,62,2,OTC
4773,13-02-2021 18:00,24 hrs.,pennystocks,GLCO,6,0,6,-6,1,1,0,1,OTC
4773,13-02-2021 18:00,24 hrs.,pennystocks,GPFT,12,0,12,-12,1,3,2,1,OTC
4773,13-02-2021 18:00,24 hrs.,pennystocks,GRCV,7,7,0,7,1,1,1,1,OTC
4773,13-02-2021 18:00,24 hrs.,pennystocks,GRSO,7,7,0,7,1,1,1,1,OTC
4773,13-02-2021 18:00,24 hrs.,pennystocks,GRST,115,0,115,-115,2,36,35,1,OTC
4773,13-02-2021 18:00,24 hrs.,pennystocks,GTBP,17,0,17,-17,1,1,11,1,OTC
4773,13-02-2021 18:00,24 hrs.,pennystocks,GTEH,51,0,51,-51,1,12,23,1,OTC
4773,13-02-2021 18:00,24 hrs.,pennystocks,GTLL,23,0,23,-23,2,5,5,2,OTC
4773,13-02-2021 18:00,24 hrs.,pennystocks,HALB,46,26,20,6,2,12,14,2,OTC
4773,13-02-2021 18:00,24 hrs.,pennystocks,HCMC,80,37,43,-6,13,13,2,11,OTC
4773,13-02-2021 18:00,24 hrs.,pennystocks,HEMP,7,0,7,-7,1,1,1,1,OTC
4773,13-02-2021 18:00,24 hrs.,pennystocks,HENC,17,0,17,-17,1,2,9,1,OTC
4773,13-02-2021 18:00,24 hrs.,pennystocks,HIPH,7,0,7,-7,1,0,3,1,OTC
4773,13-02-2021 18:00,24 hrs.,pennystocks,HMMR,7,0,7,-7,1,1,1,1,OTC
4773,13-02-2021 18:00,24 hrs.,pennystocks,HMNY,6,0,6,-6,1,1,0,1,OTC
4773,13-02-2021 18:00,24 hrs.,pennystocks,ICLD,6,0,6,-6,1,1,0,1,OTC
4773,13-02-2021 18:00,24 hrs.,pennystocks,ICNM,7,7,0,7,1,1,1,1,OTC
4773,13-02-2021 18:00,24 hrs.,pennystocks,ICTY,6,6,0,6,1,1,0,1,OTC
4773,13-02-2021 18:00,24 hrs.,pennystocks,IGEN,24,24,0,24,2,4,8,2,OTC
4773,13-02-2021 18:00,24 hrs.,pennystocks,INKW,12,6,6,0,2,2,0,2,OTC
4773,13-02-2021 18:00,24 hrs.,pennystocks,INND,451,379,72,307,4,171,93,4,OTC
4773,13-02-2021 18:00,24 hrs.,pennystocks,INTV,13,0,13,-13,2,2,1,2,OTC
4773,13-02-2021 18:00,24 hrs.,pennystocks,IPSI,18,0,18,-18,1,5,4,1,OTC
4773,13-02-2021 18:00,24 hrs.,pennystocks,ISBL,7,0,7,-7,1,1,1,1,OTC
4773,13-02-2021 18:00,24 hrs.,pennystocks,KWBT,6,0,6,-6,1,1,0,1,OTC
4773,13-02-2021 18:00,24 hrs.,pennystocks,KYNC,6,0,6,-6,1,1,0,1,OTC
4773,13-02-2021 18:00,24 hrs.,pennystocks,LBTI,6,0,6,-6,1,1,0,1,OTC
4773,13-02-2021 18:00,24 hrs.,pennystocks,LITH,6,0,6,-6,1,1,0,1,OTC
4773,13-02-2021 18:00,24 hrs.,pennystocks,LVVV,42,0,42,-42,1,9,20,1,OTC
4773,13-02-2021 18:00,24 hrs.,pennystocks,MAXD,71,28,43,-15,5,18,15,5,OTC
4773,13-02-2021 18:00,24 hrs.,pennystocks,MGTI,24,0,24,-24,1,7,6,1,OTC
4773,13-02-2021 18:00,24 hrs.,pennystocks,MIHI,6,0,6,-6,1,1,0,1,OTC
4773,13-02-2021 18:00,24 hrs.,pennystocks,MINE,31,0,31,-31,5,5,1,4,OTC
4773,13-02-2021 18:00,24 hrs.,pennystocks,MJNA,37,37,0,37,2,5,19,1,OTC
4773,13-02-2021 18:00,24 hrs.,pennystocks,MLFB,47,0,47,-47,1,18,7,1,OTC
4773,13-02-2021 18:00,24 hrs.,pennystocks,MMEX,68,0,68,-68,1,15,34,1,OTC
4773,13-02-2021 18:00,24 hrs.,pennystocks,MOJO,6,0,6,-6,1,1,0,1,OTC
4773,13-02-2021 18:00,24 hrs.,pennystocks,MRMD,6,0,6,-6,1,0,2,1,OTC
4773,13-02-2021 18:00,24 hrs.,pennystocks,MSPC,6,6,0,6,1,1,0,1,OTC
4773,13-02-2021 18:00,24 hrs.,pennystocks,NSAV,7,0,7,-7,1,1,1,1,OTC
4773,13-02-2021 18:00,24 hrs.,pennystocks,NSPT,23,23,0,23,1,3,13,1,OTC
4773,13-02-2021 18:00,24 hrs.,pennystocks,NSPX,6,6,0,6,1,1,0,1,OTC
4773,13-02-2021 18:00,24 hrs.,pennystocks,NUGS,7,0,7,-7,1,1,1,1,OTC
4773,13-02-2021 18:00,24 hrs.,pennystocks,OZSC,185,114,71,43,4,56,57,4,OTC
4773,13-02-2021 18:00,24 hrs.,pennystocks,PPJE,6,0,6,-6,1,1,0,1,OTC
4773,13-02-2021 18:00,24 hrs.,pennystocks,PUGE,92,84,8,76,2,27,30,2,OTC
4773,13-02-2021 18:00,24 hrs.,pennystocks,PURA,50,0,50,-50,2,8,26,2,OTC
4773,13-02-2021 18:00,24 hrs.,pennystocks,RCRT,22,22,0,22,1,4,10,1,OTC
4773,13-02-2021 18:00,24 hrs.,pennystocks,RDGL,6,0,6,-6,1,1,0,1,OTC
4773,13-02-2021 18:00,24 hrs.,pennystocks,RGBP,19,0,19,-19,2,4,3,1,OTC
4773,13-02-2021 18:00,24 hrs.,pennystocks,RNVA,6,0,6,-6,1,1,0,1,OTC
4773,13-02-2021 18:00,24 hrs.,pennystocks,RSSV,54,47,7,40,2,19,8,2,OTC
4773,13-02-2021 18:00,24 hrs.,pennystocks,RTON,7,0,7,-7,1,1,1,1,OTC
4773,13-02-2021 18:00,24 hrs.,pennystocks,SCNA,6,0,6,-6,1,1,0,1,OTC
4773,13-02-2021 18:00,24 hrs.,pennystocks,SFOR,16,0,16,-16,1,0,12,1,OTC
4773,13-02-2021 18:00,24 hrs.,pennystocks,RSI,293,0,293,-293,1,125,39,1,NYSE
4773,13-02-2021 18:00,24 hrs.,pennystocks,SOS,620,571,49,522,5,213,174,5,NYSE
4773,13-02-2021 18:00,24 hrs.,pennystocks,SUM,293,0,293,-293,1,125,39,1,NYSE
4773,13-02-2021 18:00,24 hrs.,pennystocks,THC,14,14,0,14,1,3,4,1,NYSE
4773,13-02-2021 18:00,24 hrs.,pennystocks,TSM,46,0,46,-46,1,12,18,1,NYSE
4773,13-02-2021 18:00,24 hrs.,pennystocks,VET,7,0,7,-7,1,1,1,1,NYSE
4773,13-02-2021 18:00,24 hrs.,pennystocks,ARGO,58,58,0,58,1,20,14,1,NYSE
4773,13-02-2021 18:00,24 hrs.,pennystocks,CCIV,7,0,7,-7,1,1,1,1,NYSE
4773,13-02-2021 18:00,24 hrs.,pennystocks,DASH,26,26,0,26,1,8,6,1,NYSE
4773,13-02-2021 18:00,24 hrs.,pennystocks,FINV,16,0,16,-16,1,4,4,1,NYSE
4773,13-02-2021 18:00,24 hrs.,pennystocks,HEXO,7,7,0,7,1,1,1,1,NYSE
4773,13-02-2021 18:00,24 hrs.,pennystocks,BDRBF,6,0,6,-6,1,1,0,1,OTC
4773,13-02-2021 18:00,24 hrs.,pennystocks,BFARF,9,0,9,-9,1,0,5,1,OTC
4773,13-02-2021 18:00,24 hrs.,pennystocks,BNCHF,6,0,6,-6,1,1,0,1,OTC
4773,13-02-2021 18:00,24 hrs.,pennystocks,BUROF,6,6,0,6,1,1,0,1,OTC
4773,13-02-2021 18:00,24 hrs.,pennystocks,CBWTF,7,0,7,-7,1,1,1,1,OTC
4773,13-02-2021 18:00,24 hrs.,pennystocks,CIOXY,7,0,7,-7,1,1,1,1,OTC
4773,13-02-2021 18:00,24 hrs.,pennystocks,CLUBQ,27,0,27,-27,2,6,7,1,OTC
4773,13-02-2021 18:00,24 hrs.,pennystocks,CLXPF,106,106,0,106,1,38,26,1,OTC
4773,13-02-2021 18:00,24 hrs.,pennystocks,COCSF,11,11,0,11,1,3,1,1,OTC
4773,13-02-2021 18:00,24 hrs.,pennystocks,CPHRF,6,0,6,-6,1,1,0,1,OTC
4773,13-02-2021 18:00,24 hrs.,pennystocks,CRLBF,86,0,86,-86,1,10,62,1,OTC
4773,13-02-2021 18:00,24 hrs.,pennystocks,CWGYF,6,0,6,-6,1,1,0,1,OTC
4773,13-02-2021 18:00,24 hrs.,pennystocks,CWSFF,6,0,6,-6,1,1,0,1,OTC
4773,13-02-2021 18:00,24 hrs.,pennystocks,DIGAF,7,0,7,-7,1,1,1,1,OTC
4773,13-02-2021 18:00,24 hrs.,pennystocks,EHVVF,16,0,16,-16,1,0,12,1,OTC
4773,13-02-2021 18:00,24 hrs.,pennystocks,ELRRF,6,0,6,-6,1,1,0,1,OTC
4773,13-02-2021 18:00,24 hrs.,pennystocks,EPWCF,14,0,14,-14,1,0,10,1,OTC
4773,13-02-2021 18:00,24 hrs.,pennystocks,ERPNF,43,0,43,-43,1,16,7,1,OTC
4773,13-02-2021 18:00,24 hrs.,pennystocks,HITIF,1591,0,1591,-1591,5,596,379,5,OTC
4773,13-02-2021 18:00,24 hrs.,pennystocks,HRVSF,6,0,6,-6,1,1,0,1,OTC
4773,13-02-2021 18:00,24 hrs.,pennystocks,INTEQ,6,0,6,-6,1,1,0,1,OTC
4773,13-02-2021 18:00,24 hrs.,pennystocks,KCCFF,29,0,29,-29,1,9,7,1,OTC
4773,13-02-2021 18:00,24 hrs.,pennystocks,LLKKF,24,0,24,-24,4,4,0,1,OTC
4773,13-02-2021 18:00,24 hrs.,pennystocks,LTHUQ,31,31,0,31,1,7,13,1,OTC
4773,13-02-2021 18:00,24 hrs.,pennystocks,MMEDF,47,16,31,-15,2,18,3,2,OTC
4773,13-02-2021 18:00,24 hrs.,pennystocks,MSNVF,6,6,0,6,1,1,0,1,OTC
4773,13-02-2021 18:00,24 hrs.,pennystocks,NMGRF,6,0,6,-6,1,1,0,1,OTC
4773,13-02-2021 18:00,24 hrs.,pennystocks,NMTLF,7,7,0,7,1,1,1,1,OTC
4773,13-02-2021 18:00,24 hrs.,pennystocks,NOSUF,42,0,42,-42,2,9,16,2,OTC
4773,13-02-2021 18:00,24 hrs.,pennystocks,NXTTF,80,6,74,-68,3,22,24,3,OTC
4773,13-02-2021 18:00,24 hrs.,pennystocks,PMNXF,6,0,6,-6,1,1,0,1,OTC
4773,13-02-2021 18:00,24 hrs.,pennystocks,RAZFF,7,0,7,-7,1,1,1,1,OTC
4773,13-02-2021 18:00,24 hrs.,pennystocks,SPRWF,6,0,6,-6,1,1,0,1,OTC
4773,13-02-2021 18:00,24 hrs.,pennystocks,TAKOF,54,10,44,-34,2,18,10,2,OTC
4773,13-02-2021 18:00,24 hrs.,pennystocks,TOBAF,40,0,40,-40,1,10,16,1,OTC
4773,13-02-2021 18:00,24 hrs.,pennystocks,TOWTF,12,12,0,12,2,2,0,1,OTC
4773,13-02-2021 18:00,24 hrs.,pennystocks,TRUFF,22,22,0,22,1,4,10,1,OTC
4773,13-02-2021 18:00,24 hrs.,pennystocks,SRMX,6,0,6,-6,1,1,0,1,OTC
4773,13-02-2021 18:00,24 hrs.,pennystocks,SSFT,16,0,16,-16,1,0,12,1,OTC
4773,13-02-2021 18:00,24 hrs.,pennystocks,SSOK,16,0,16,-16,1,0,12,1,OTC
4773,13-02-2021 18:00,24 hrs.,pennystocks,STWC,35,0,35,-35,1,12,7,1,OTC
4773,13-02-2021 18:00,24 hrs.,pennystocks,TAUG,6,6,0,6,1,1,0,1,OTC
4773,13-02-2021 18:00,24 hrs.,pennystocks,TLGN,69,0,69,-69,3,17,23,2,OTC
4773,13-02-2021 18:00,24 hrs.,pennystocks,TPAC,5487,0,5487,-5487,1,2461,561,1,OTC
4773,13-02-2021 18:00,24 hrs.,pennystocks,TSNP,80,53,27,26,3,27,14,3,OTC
4773,13-02-2021 18:00,24 hrs.,pennystocks,TVPC,6,6,0,6,1,1,0,1,OTC
4773,13-02-2021 18:00,24 hrs.,pennystocks,TXTM,7,0,7,-7,1,1,1,1,OTC
4773,13-02-2021 18:00,24 hrs.,pennystocks,UAPC,16,16,0,16,2,1,6,2,OTC
4773,13-02-2021 18:00,24 hrs.,pennystocks,VFRM,6,0,6,-6,1,1,0,1,OTC
4773,13-02-2021 18:00,24 hrs.,pennystocks,VPER,65,0,65,-65,1,11,39,1,OTC
4773,13-02-2021 18:00,24 hrs.,pennystocks,VSPC,6,0,6,-6,1,1,0,1,OTC
4773,13-02-2021 18:00,24 hrs.,pennystocks,XFLS,4,4,0,4,1,0,0,1,OTC
4773,13-02-2021 18:00,24 hrs.,pennystocks,XLPI,172,0,172,-172,1,75,18,1,OTC
4773,13-02-2021 18:00,24 hrs.,pennystocks,FAST,6,0,6,-6,1,1,0,1,NASDAQ
4773,13-02-2021 18:00,24 hrs.,pennystocks,FORD,69,69,0,69,1,31,3,1,NASDAQ
4773,13-02-2021 18:00,24 hrs.,pennystocks,GEVO,6,0,6,-6,1,1,0,1,NASDAQ
4773,13-02-2021 18:00,24 hrs.,pennystocks,GLBS,27,0,27,-27,1,0,23,1,NASDAQ
4773,13-02-2021 18:00,24 hrs.,pennystocks,GNPX,6,0,6,-6,1,0,2,1,NASDAQ
4773,13-02-2021 18:00,24 hrs.,pennystocks,GNUS,12,6,6,0,2,2,0,2,NASDAQ
4773,13-02-2021 18:00,24 hrs.,pennystocks,GOOG,7,0,7,-7,1,0,3,1,NASDAQ
4773,13-02-2021 18:00,24 hrs.,pennystocks,IBKR,7,0,7,-7,1,1,1,1,NASDAQ
4773,13-02-2021 18:00,24 hrs.,pennystocks,ICON,14,14,0,14,1,3,4,1,NASDAQ
4773,13-02-2021 18:00,24 hrs.,pennystocks,IDEX,6,0,6,-6,1,0,2,1,NASDAQ
4773,13-02-2021 18:00,24 hrs.,pennystocks,INOD,71,0,71,-71,1,12,43,1,NASDAQ
4773,13-02-2021 18:00,24 hrs.,pennystocks,INPX,6,0,6,-6,1,1,0,1,NASDAQ
4773,13-02-2021 18:00,24 hrs.,pennystocks,IZEA,6,0,6,-6,1,1,0,1,NASDAQ
4773,13-02-2021 18:00,24 hrs.,pennystocks,KTRA,45,0,45,-45,2,7,23,2,NASDAQ
4773,13-02-2021 18:00,24 hrs.,pennystocks,LIFE,6,0,6,-6,1,1,0,1,NASDAQ
4773,13-02-2021 18:00,24 hrs.,pennystocks,LIVX,6,6,0,6,1,1,0,1,NASDAQ
4773,13-02-2021 18:00,24 hrs.,pennystocks,LLIT,7,0,7,-7,1,1,1,1,NASDAQ
4773,13-02-2021 18:00,24 hrs.,pennystocks,LPTX,51,0,51,-51,1,11,25,1,NASDAQ
4773,13-02-2021 18:00,24 hrs.,pennystocks,MARK,6,0,6,-6,1,1,0,1,NASDAQ
4773,13-02-2021 18:00,24 hrs.,pennystocks,MOGO,57,26,31,-5,2,14,21,2,NASDAQ
4773,13-02-2021 18:00,24 hrs.,pennystocks,MVIS,14,0,14,-14,1,0,10,1,NASDAQ
4773,13-02-2021 18:00,24 hrs.,pennystocks,NAKD,1228,0,1228,-1228,1,538,148,1,NASDAQ
4773,13-02-2021 18:00,24 hrs.,pennystocks,PUMP,13,0,13,-13,2,2,1,1,NYSE
4773,13-02-2021 18:00,24 hrs.,pennystocks,TSCRF,7,0,7,-7,1,1,1,1,OTC
4773,13-02-2021 18:00,24 hrs.,pennystocks,ZBISF,1387,0,1387,-1387,1,562,259,1,OTC
4773,13-02-2021 18:00,24 hrs.,pennystocks,CVM,6,6,0,6,1,1,0,1,AMEX
4773,13-02-2021 18:00,24 hrs.,pennystocks,DNN,44,13,31,-18,7,7,2,7,AMEX
4773,13-02-2021 18:00,24 hrs.,pennystocks,DPW,6,0,6,-6,1,1,0,1,AMEX
4773,13-02-2021 18:00,24 hrs.,pennystocks,DSS,34,6,28,-22,2,9,8,2,AMEX
4773,13-02-2021 18:00,24 hrs.,pennystocks,GSV,7,0,7,-7,1,1,1,1,AMEX
4773,13-02-2021 18:00,24 hrs.,pennystocks,GTE,63,51,12,39,4,11,25,4,AMEX
4773,13-02-2021 18:00,24 hrs.,pennystocks,MCF,6,0,6,-6,1,1,0,1,AMEX
4773,13-02-2021 18:00,24 hrs.,pennystocks,NBY,46,0,46,-46,1,12,18,1,AMEX
4773,13-02-2021 18:00,24 hrs.,pennystocks,NGD,10,10,0,10,1,2,2,1,AMEX
4773,13-02-2021 18:00,24 hrs.,pennystocks,TGB,6,0,6,-6,1,1,0,1,AMEX
4773,13-02-2021 18:00,24 hrs.,pennystocks,ZOM,192,106,86,20,2,48,88,2,AMEX
4773,13-02-2021 18:00,24 hrs.,pennystocks,GSAT,75,0,75,-75,1,19,33,1,AMEX
4773,13-02-2021 18:00,24 hrs.,pennystocks,IBIO,23,0,23,-23,1,8,3,1,AMEX
4773,13-02-2021 18:00,24 hrs.,pennystocks,NSPR,37,19,18,1,3,8,9,3,AMEX
4773,13-02-2021 18:00,24 hrs.,pennystocks,OGEN,32,26,6,20,2,11,2,2,AMEX
4773,13-02-2021 18:00,24 hrs.,pennystocks,SENS,28,17,11,6,2,6,8,2,AMEX
4773,13-02-2021 18:00,24 hrs.,pennystocks,SNMP,19,19,0,19,1,5,5,1,AMEX
4773,13-02-2021 18:00,24 hrs.,pennystocks,TRXC,6,0,6,-6,1,0,2,1,AMEX
4773,13-02-2021 18:00,24 hrs.,pennystocks,ACB,25,0,25,-25,1,1,19,1,NYSE
4773,13-02-2021 18:00,24 hrs.,pennystocks,AMC,39,39,0,39,1,10,15,1,NYSE
4773,13-02-2021 18:00,24 hrs.,pennystocks,ASX,8,8,0,8,1,1,2,1,NYSE
4773,13-02-2021 18:00,24 hrs.,pennystocks,AXL,6,0,6,-6,1,0,2,1,NYSE
4773,13-02-2021 18:00,24 hrs.,pennystocks,CBD,26,0,26,-26,2,8,2,2,NYSE
4773,13-02-2021 18:00,24 hrs.,pennystocks,CLI,65,0,65,-65,1,22,17,1,NYSE
4773,13-02-2021 18:00,24 hrs.,pennystocks,CMD,65,0,65,-65,1,22,17,1,NYSE
4773,13-02-2021 18:00,24 hrs.,pennystocks,FLT,44,0,44,-44,1,16,8,1,NYSE
4773,13-02-2021 18:00,24 hrs.,pennystocks,FSD,11,11,0,11,1,2,3,1,NYSE
4773,13-02-2021 18:00,24 hrs.,pennystocks,GME,24,6,18,-12,4,4,0,3,NYSE
4773,13-02-2021 18:00,24 hrs.,pennystocks,IRR,29,0,29,-29,1,9,7,1,NYSE
4773,13-02-2021 18:00,24 hrs.,pennystocks,KOF,11,11,0,11,1,3,1,1,NYSE
4773,13-02-2021 18:00,24 hrs.,pennystocks,KOS,7,0,7,-7,1,1,1,1,NYSE
4773,13-02-2021 18:00,24 hrs.,pennystocks,LOW,6,0,6,-6,1,1,0,1,NYSE
4773,13-02-2021 18:00,24 hrs.,pennystocks,MED,6,0,6,-6,1,1,0,1,NYSE
4773,13-02-2021 18:00,24 hrs.,pennystocks,MIN,6,0,6,-6,1,1,0,1,NYSE
4773,13-02-2021 18:00,24 hrs.,pennystocks,NOK,112,106,6,100,2,39,26,2,NYSE
4773,13-02-2021 18:00,24 hrs.,pennystocks,NPV,29,0,29,-29,1,9,7,1,NYSE
4773,13-02-2021 18:00,24 hrs.,pennystocks,NYC,10,10,0,10,1,0,6,1,NYSE
4773,13-02-2021 18:00,24 hrs.,pennystocks,PDT,48,48,0,48,1,18,8,1,NYSE
4773,13-02-2021 18:00,24 hrs.,pennystocks,PKG,32,32,0,32,1,11,6,1,NYSE
4773,13-02-2021 18:00,24 hrs.,pennystocks,NMTR,6,0,6,-6,1,1,0,1,NASDAQ
4773,13-02-2021 18:00,24 hrs.,pennystocks,NVCN,18,6,12,-6,3,3,0,2,NASDAQ
4773,13-02-2021 18:00,24 hrs.,pennystocks,OCGN,63,39,24,15,3,16,19,3,NASDAQ
4773,13-02-2021 18:00,24 hrs.,pennystocks,OPTT,12,12,0,12,2,2,0,2,NASDAQ
4773,13-02-2021 18:00,24 hrs.,pennystocks,OTIC,10,0,10,-10,1,1,4,1,NASDAQ
4773,13-02-2021 18:00,24 hrs.,pennystocks,PGEN,6,6,0,6,1,1,0,1,NASDAQ
4773,13-02-2021 18:00,24 hrs.,pennystocks,PLAY,6,0,6,-6,1,1,0,1,NASDAQ
4773,13-02-2021 18:00,24 hrs.,pennystocks,PSEC,6,6,0,6,1,1,0,1,NASDAQ
4773,13-02-2021 18:00,24 hrs.,pennystocks,PSTV,6,6,0,6,1,1,0,1,NASDAQ
4773,13-02-2021 18:00,24 hrs.,pennystocks,PTON,43,0,43,-43,1,16,7,1,NASDAQ
4773,13-02-2021 18:00,24 hrs.,pennystocks,PULM,96,6,90,-84,3,17,50,3,NASDAQ
4773,13-02-2021 18:00,24 hrs.,pennystocks,RIBT,13,0,13,-13,2,2,1,1,NASDAQ
4773,13-02-2021 18:00,24 hrs.,pennystocks,RIDE,6,0,6,-6,1,1,0,1,NASDAQ
4773,13-02-2021 18:00,24 hrs.,pennystocks,SEAC,5,5,0,5,1,0,1,1,NASDAQ
4773,13-02-2021 18:00,24 hrs.,pennystocks,SELB,18,0,18,-18,1,5,4,1,NASDAQ
4773,13-02-2021 18:00,24 hrs.,pennystocks,SESN,69,0,69,-69,1,30,5,1,NASDAQ
4773,13-02-2021 18:00,24 hrs.,pennystocks,SFET,31,0,31,-31,1,7,13,1,NASDAQ
4773,13-02-2021 18:00,24 hrs.,pennystocks,SNDL,38,0,38,-38,6,6,2,5,NASDAQ
4773,13-02-2021 18:00,24 hrs.,pennystocks,SNGX,101,0,101,-101,11,20,17,5,NASDAQ
4773,13-02-2021 18:00,24 hrs.,pennystocks,STCN,6,0,6,-6,1,1,0,1,NASDAQ
4773,13-02-2021 18:00,24 hrs.,pennystocks,TBLT,200,0,200,-200,1,74,48,1,NASDAQ
4773,13-02-2021 18:00,24 hrs.,pennystocks,TNXP,209,6,203,-197,4,71,51,4,NASDAQ
4773,13-02-2021 18:00,24 hrs.,pennystocks,SHOP,12,0,12,-12,2,2,0,1,NYSE
4773,13-02-2021 18:00,24 hrs.,pennystocks,SPCE,43,0,43,-43,1,16,7,1,NYSE
4773,13-02-2021 18:00,24 hrs.,pennystocks,WELL,1784,0,1784,-1784,1,757,266,1,NYSE
4773,13-02-2021 18:00,24 hrs.,pennystocks,GBT,6,0,6,-6,1,1,0,1,NASDAQ
4773,13-02-2021 18:00,24 hrs.,pennystocks,INO,26,26,0,26,1,10,2,1,NASDAQ
4773,13-02-2021 18:00,24 hrs.,pennystocks,OGI,19,0,19,-19,1,6,3,1,NASDAQ
4773,13-02-2021 18:00,24 hrs.,pennystocks,PTE,59,59,0,59,1,20,15,1,NASDAQ
4773,13-02-2021 18:00,24 hrs.,pennystocks,SND,51,0,51,-51,1,11,25,1,NASDAQ
4773,13-02-2021 18:00,24 hrs.,pennystocks,SPI,11,0,11,-11,1,2,3,1,NASDAQ
4773,13-02-2021 18:00,24 hrs.,pennystocks,AGEN,10,0,10,-10,1,3,0,1,NASDAQ
4773,13-02-2021 18:00,24 hrs.,pennystocks,AIKI,6,0,6,-6,1,1,0,1,NASDAQ
4773,13-02-2021 18:00,24 hrs.,pennystocks,ALNA,15,15,0,15,1,2,7,1,NASDAQ
4773,13-02-2021 18:00,24 hrs.,pennystocks,AMTX,77,0,77,-77,1,27,19,1,NASDAQ
4773,13-02-2021 18:00,24 hrs.,pennystocks,ANTE,21,21,0,21,1,6,5,1,NASDAQ
4773,13-02-2021 18:00,24 hrs.,pennystocks,APHA,100,0,100,-100,1,37,22,1,NASDAQ
4773,13-02-2021 18:00,24 hrs.,pennystocks,APRE,6,0,6,-6,1,1,0,1,NASDAQ
4773,13-02-2021 18:00,24 hrs.,pennystocks,ASRT,23,16,7,9,2,6,3,2,NASDAQ
4773,13-02-2021 18:00,24 hrs.,pennystocks,ATOS,6,0,6,-6,1,1,0,1,NASDAQ
4773,13-02-2021 18:00,24 hrs.,pennystocks,AVGR,59,59,0,59,1,20,15,1,NASDAQ
4773,13-02-2021 18:00,24 hrs.,pennystocks,BCLI,6,0,6,-6,1,0,2,1,NASDAQ
4773,13-02-2021 18:00,24 hrs.,pennystocks,BHTG,55,55,0,55,1,20,11,1,NASDAQ
4773,13-02-2021 18:00,24 hrs.,pennystocks,BIOL,57,0,57,-57,2,12,25,2,NASDAQ
4773,13-02-2021 18:00,24 hrs.,pennystocks,BLUE,37,37,0,37,1,8,17,1,NASDAQ
4773,13-02-2021 18:00,24 hrs.,pennystocks,BNGO,102,59,43,16,2,36,22,2,NASDAQ
4773,13-02-2021 18:00,24 hrs.,pennystocks,BWEN,12,0,12,-12,2,2,0,2,NASDAQ
4773,13-02-2021 18:00,24 hrs.,pennystocks,BXRX,12,12,0,12,2,2,0,2,NASDAQ
4773,13-02-2021 18:00,24 hrs.,pennystocks,CFMS,6,0,6,-6,1,1,0,1,NASDAQ
4773,13-02-2021 18:00,24 hrs.,pennystocks,CHEK,59,59,0,59,1,20,15,1,NASDAQ
4773,13-02-2021 18:00,24 hrs.,pennystocks,CIDM,37,0,37,-37,1,12,9,1,NASDAQ
4773,13-02-2021 18:00,24 hrs.,pennystocks,CKPT,21,0,21,-21,2,3,7,2,NASDAQ
4773,13-02-2021 18:00,24 hrs.,pennystocks,CLBS,187,47,140,-93,5,58,51,5,NASDAQ
4773,13-02-2021 18:00,24 hrs.,pennystocks,CMPS,17,17,0,17,1,2,9,1,NASDAQ
4773,13-02-2021 18:00,24 hrs.,pennystocks,COCP,7,0,7,-7,1,1,1,1,NASDAQ
4773,13-02-2021 18:00,24 hrs.,pennystocks,CRBP,88,0,88,-88,1,38,8,1,NASDAQ
4773,13-02-2021 18:00,24 hrs.,pennystocks,CSCW,7,0,7,-7,1,1,1,1,NASDAQ
4773,13-02-2021 18:00,24 hrs.,pennystocks,CTMX,14,0,14,-14,1,2,6,1,NASDAQ
4773,13-02-2021 18:00,24 hrs.,pennystocks,CTRM,172,165,7,158,5,50,52,5,NASDAQ
4773,13-02-2021 18:00,24 hrs.,pennystocks,CTXR,18,0,18,-18,1,5,4,1,NASDAQ
4773,13-02-2021 18:00,24 hrs.,pennystocks,CYTH,8,0,8,-8,1,1,2,1,NASDAQ
4773,13-02-2021 18:00,24 hrs.,pennystocks,DFFN,196,7,189,-182,5,77,22,4,NASDAQ
4773,13-02-2021 18:00,24 hrs.,pennystocks,EDIT,131,131,0,131,1,44,39,1,NASDAQ
4773,13-02-2021 18:00,24 hrs.,pennystocks,EPSN,12,0,12,-12,2,2,0,2,NASDAQ
4749,13-02-2021 14:00,24 hrs.,wallstreetbets,LTC,7,7,0,7,1,1,1,1,NYSE
4749,13-02-2021 14:00,24 hrs.,wallstreetbets,MAC,9,0,9,-9,1,1,3,1,NYSE
4749,13-02-2021 14:00,24 hrs.,wallstreetbets,MBI,14,0,14,-14,2,2,2,2,NYSE
4749,13-02-2021 14:00,24 hrs.,wallstreetbets,MFA,7,0,7,-7,1,1,1,1,NYSE
4749,13-02-2021 14:00,24 hrs.,wallstreetbets,MIN,7,0,7,-7,1,1,1,1,NYSE
4749,13-02-2021 14:00,24 hrs.,wallstreetbets,MRO,6,0,6,-6,1,1,0,1,NYSE
4749,13-02-2021 14:00,24 hrs.,wallstreetbets,NAT,20,0,20,-20,3,2,4,3,NYSE
4749,13-02-2021 14:00,24 hrs.,wallstreetbets,NET,194,0,194,-194,2,63,60,2,NYSE
4749,13-02-2021 14:00,24 hrs.,wallstreetbets,NGA,6,0,6,-6,1,1,0,1,NYSE
4749,13-02-2021 14:00,24 hrs.,wallstreetbets,NIO,760,8,752,-744,12,307,98,11,NYSE
4749,13-02-2021 14:00,24 hrs.,wallstreetbets,NLY,7,0,7,-7,1,1,1,1,NYSE
4749,13-02-2021 14:00,24 hrs.,wallstreetbets,NMR,7,7,0,7,1,1,1,1,NYSE
4749,13-02-2021 14:00,24 hrs.,wallstreetbets,AIR,6,0,6,-6,1,1,0,1,NYSE
4749,13-02-2021 14:00,24 hrs.,wallstreetbets,AIV,6,0,6,-6,1,1,0,1,NYSE
4749,13-02-2021 14:00,24 hrs.,wallstreetbets,AMC,3435,1855,1580,275,169,1074,611,140,NYSE
4749,13-02-2021 14:00,24 hrs.,wallstreetbets,AMP,29,0,29,-29,4,4,5,4,NYSE
4749,13-02-2021 14:00,24 hrs.,wallstreetbets,ATH,43,13,30,-17,5,9,5,5,NYSE
4749,13-02-2021 14:00,24 hrs.,wallstreetbets,AUY,132,0,132,-132,8,28,44,3,NYSE
4749,13-02-2021 14:00,24 hrs.,wallstreetbets,AXP,6143,0,6143,-6143,1,2894,351,1,NYSE
4749,13-02-2021 14:00,24 hrs.,wallstreetbets,BBW,6,0,6,-6,1,1,0,1,NYSE
4749,13-02-2021 14:00,24 hrs.,wallstreetbets,BCH,11,0,11,-11,2,1,1,2,NYSE
4749,13-02-2021 14:00,24 hrs.,wallstreetbets,NVO,80,6,74,-68,2,19,34,2,NYSE
4749,13-02-2021 14:00,24 hrs.,wallstreetbets,NYC,7,0,7,-7,1,1,1,1,NYSE
4749,13-02-2021 14:00,24 hrs.,wallstreetbets,OSK,161,0,161,-161,1,46,65,1,NYSE
4749,13-02-2021 14:00,24 hrs.,wallstreetbets,OVV,5,0,5,-5,1,0,1,1,NYSE
4749,13-02-2021 14:00,24 hrs.,wallstreetbets,PCG,322,322,0,322,1,120,78,1,NYSE
4749,13-02-2021 14:00,24 hrs.,wallstreetbets,PFE,13,0,13,-13,2,2,1,2,NYSE
4749,13-02-2021 14:00,24 hrs.,wallstreetbets,PHT,7,7,0,7,1,1,1,1,NYSE
4749,13-02-2021 14:00,24 hrs.,wallstreetbets,PSA,3350,14,3336,-3322,10,1377,556,7,NYSE
4749,13-02-2021 14:00,24 hrs.,wallstreetbets,PSN,7,7,0,7,1,1,1,1,NYSE
4749,13-02-2021 14:00,24 hrs.,wallstreetbets,PVL,13,0,13,-13,2,2,1,1,NYSE
4749,13-02-2021 14:00,24 hrs.,wallstreetbets,PWR,6,6,0,6,1,1,0,1,NYSE
4749,13-02-2021 14:00,24 hrs.,wallstreetbets,RAD,7,7,0,7,1,1,1,1,NYSE
4749,13-02-2021 14:00,24 hrs.,wallstreetbets,BGS,8,0,8,-8,1,1,2,1,NYSE
4749,13-02-2021 14:00,24 hrs.,wallstreetbets,BTT,40,7,33,-26,6,6,4,6,NYSE
4749,13-02-2021 14:00,24 hrs.,wallstreetbets,BTU,14,0,14,-14,2,2,2,1,NYSE
4749,13-02-2021 14:00,24 hrs.,wallstreetbets,BYD,7,7,0,7,1,1,1,1,NYSE
4749,13-02-2021 14:00,24 hrs.,wallstreetbets,CAT,14,0,14,-14,2,2,2,2,NYSE
4749,13-02-2021 14:00,24 hrs.,wallstreetbets,CCL,20,6,14,-8,3,3,2,2,NYSE
4749,13-02-2021 14:00,24 hrs.,wallstreetbets,CMA,6,0,6,-6,1,1,0,1,NYSE
4749,13-02-2021 14:00,24 hrs.,wallstreetbets,CMC,15,0,15,-15,1,1,9,1,NYSE
4749,13-02-2021 14:00,24 hrs.,wallstreetbets,CPE,7,0,7,-7,1,1,1,1,NYSE
4749,13-02-2021 14:00,24 hrs.,wallstreetbets,CPG,7,0,7,-7,1,1,1,1,NYSE
4749,13-02-2021 14:00,24 hrs.,wallstreetbets,CPS,6,6,0,6,1,1,0,1,NYSE
4749,13-02-2021 14:00,24 hrs.,wallstreetbets,CSV,242,0,242,-242,1,66,106,1,NYSE
4749,13-02-2021 14:00,24 hrs.,wallstreetbets,CVS,14,0,14,-14,2,2,2,2,NYSE
4749,13-02-2021 14:00,24 hrs.,wallstreetbets,DAC,20,0,20,-20,3,3,2,2,NYSE
4749,13-02-2021 14:00,24 hrs.,wallstreetbets,DAL,13,0,13,-13,2,2,1,2,NYSE
4749,13-02-2021 14:00,24 hrs.,wallstreetbets,DAO,12,0,12,-12,2,2,0,1,NYSE
4749,13-02-2021 14:00,24 hrs.,wallstreetbets,DHT,7,0,7,-7,1,1,1,1,NYSE
4749,13-02-2021 14:00,24 hrs.,wallstreetbets,DIS,20,0,20,-20,3,3,2,3,NYSE
4749,13-02-2021 14:00,24 hrs.,wallstreetbets,DTE,167,0,167,-167,1,53,57,1,NYSE
4749,13-02-2021 14:00,24 hrs.,wallstreetbets,DVN,7,0,7,-7,1,1,1,1,NYSE
4749,13-02-2021 14:00,24 hrs.,wallstreetbets,EAT,14,0,14,-14,2,2,2,2,NYSE
4749,13-02-2021 14:00,24 hrs.,wallstreetbets,EPD,47,0,47,-47,2,12,15,1,NYSE
4749,13-02-2021 14:00,24 hrs.,wallstreetbets,ETN,21,0,21,-21,3,3,3,3,NYSE
4749,13-02-2021 14:00,24 hrs.,wallstreetbets,EXP,13,0,13,-13,2,2,1,2,NYSE
4749,13-02-2021 14:00,24 hrs.,wallstreetbets,FDX,7,0,7,-7,1,1,1,1,NYSE
4749,13-02-2021 14:00,24 hrs.,wallstreetbets,FLT,7,0,7,-7,1,1,1,1,NYSE
4749,13-02-2021 14:00,24 hrs.,wallstreetbets,FMC,13,0,13,-13,2,2,1,1,NYSE
4749,13-02-2021 14:00,24 hrs.,wallstreetbets,FRO,13,0,13,-13,2,2,1,1,NYSE
4749,13-02-2021 14:00,24 hrs.,wallstreetbets,FSD,14,0,14,-14,2,2,2,2,NYSE
4749,13-02-2021 14:00,24 hrs.,wallstreetbets,FSR,243,0,243,-243,34,41,25,14,NYSE
4749,13-02-2021 14:00,24 hrs.,wallstreetbets,FTI,20,0,20,-20,3,3,2,1,NYSE
4749,13-02-2021 14:00,24 hrs.,wallstreetbets,FUN,7,7,0,7,1,1,1,1,NYSE
4749,13-02-2021 14:00,24 hrs.,wallstreetbets,GAM,7,0,7,-7,1,1,1,1,NYSE
4749,13-02-2021 14:00,24 hrs.,wallstreetbets,GEO,35,7,28,-21,5,5,5,2,NYSE
4749,13-02-2021 14:00,24 hrs.,wallstreetbets,GLW,7,0,7,-7,1,1,1,1,NYSE
4749,13-02-2021 14:00,24 hrs.,wallstreetbets,GME,192952,39095,153857,-114762,422,88335,14594,309,NYSE
4749,13-02-2021 14:00,24 hrs.,wallstreetbets,GNT,14,14,0,14,2,2,2,1,NYSE
4749,13-02-2021 14:00,24 hrs.,wallstreetbets,HMC,36,0,36,-36,1,10,12,1,NYSE
4749,13-02-2021 14:00,24 hrs.,wallstreetbets,HMI,7,0,7,-7,1,1,1,1,NYSE
4749,13-02-2021 14:00,24 hrs.,wallstreetbets,HSY,8,8,0,8,1,1,2,1,NYSE
4749,13-02-2021 14:00,24 hrs.,wallstreetbets,IAG,7,0,7,-7,1,1,1,1,NYSE
4749,13-02-2021 14:00,24 hrs.,wallstreetbets,IBM,10456,391,10065,-9674,9,4861,698,9,NYSE
4749,13-02-2021 14:00,24 hrs.,wallstreetbets,ICE,173,0,173,-173,1,53,63,1,NYSE
4749,13-02-2021 14:00,24 hrs.,wallstreetbets,IGT,7,0,7,-7,1,1,1,1,NYSE
4749,13-02-2021 14:00,24 hrs.,wallstreetbets,IRS,12,6,6,0,2,2,0,2,NYSE
4749,13-02-2021 14:00,24 hrs.,wallstreetbets,IVR,49,0,49,-49,7,6,9,5,NYSE
4749,13-02-2021 14:00,24 hrs.,wallstreetbets,JNJ,13,6,7,-1,2,2,1,2,NYSE
4749,13-02-2021 14:00,24 hrs.,wallstreetbets,JWS,12,0,12,-12,2,2,0,1,NYSE
4749,13-02-2021 14:00,24 hrs.,wallstreetbets,KMI,47,0,47,-47,2,12,15,1,NYSE
4749,13-02-2021 14:00,24 hrs.,wallstreetbets,KOS,12,0,12,-12,2,2,0,1,NYSE
4749,13-02-2021 14:00,24 hrs.,wallstreetbets,LEE,6,0,6,-6,1,1,0,1,NYSE
4749,13-02-2021 14:00,24 hrs.,wallstreetbets,LOW,22,0,22,-22,3,3,4,2,NYSE
4749,13-02-2021 14:00,24 hrs.,wallstreetbets,SAFE,129,9,120,-111,2,33,55,2,NYSE
4749,13-02-2021 14:00,24 hrs.,wallstreetbets,SPCE,216,21,195,-174,17,48,52,11,NYSE
4749,13-02-2021 14:00,24 hrs.,wallstreetbets,STIC,7,0,7,-7,1,1,1,1,NYSE
4749,13-02-2021 14:00,24 hrs.,wallstreetbets,STPK,6,0,6,-6,1,1,0,1,NYSE
4749,13-02-2021 14:00,24 hrs.,wallstreetbets,TWTR,7,0,7,-7,1,1,1,1,NYSE
4749,13-02-2021 14:00,24 hrs.,wallstreetbets,UBER,7,0,7,-7,1,1,1,1,NYSE
4749,13-02-2021 14:00,24 hrs.,wallstreetbets,VALE,7,0,7,-7,1,1,1,1,NYSE
4749,13-02-2021 14:00,24 hrs.,wallstreetbets,VGAC,12,0,12,-12,2,2,0,2,NYSE
4749,13-02-2021 14:00,24 hrs.,wallstreetbets,VSTO,7,7,0,7,1,1,1,1,NYSE
4749,13-02-2021 14:00,24 hrs.,wallstreetbets,WORK,14,0,14,-14,2,2,2,2,NYSE
4749,13-02-2021 14:00,24 hrs.,wallstreetbets,XPEV,7,0,7,-7,1,1,1,1,NYSE
4749,13-02-2021 14:00,24 hrs.,wallstreetbets,YELP,7,0,7,-7,1,1,1,1,NYSE
4749,13-02-2021 14:00,24 hrs.,wallstreetbets,AAL,7,0,7,-7,1,1,1,1,NASDAQ
4749,13-02-2021 14:00,24 hrs.,wallstreetbets,AMD,1420,206,1214,-1008,22,389,554,19,NASDAQ
4749,13-02-2021 14:00,24 hrs.,wallstreetbets,API,7,7,0,7,1,1,1,1,NASDAQ
4749,13-02-2021 14:00,24 hrs.,wallstreetbets,RDY,7,0,7,-7,1,1,1,1,NYSE
4749,13-02-2021 14:00,24 hrs.,wallstreetbets,RKT,8349,13,8336,-8323,12,3883,535,11,NYSE
4749,13-02-2021 14:00,24 hrs.,wallstreetbets,RMO,27,0,27,-27,4,4,3,3,NYSE
4749,13-02-2021 14:00,24 hrs.,wallstreetbets,RPT,7,0,7,-7,1,1,1,1,NYSE
4749,13-02-2021 14:00,24 hrs.,wallstreetbets,RTP,6,0,6,-6,1,1,0,1,NYSE
4749,13-02-2021 14:00,24 hrs.,wallstreetbets,SBE,6,0,6,-6,1,1,0,1,NYSE
4749,13-02-2021 14:00,24 hrs.,wallstreetbets,SJM,151,151,0,151,2,51,41,2,NYSE
4749,13-02-2021 14:00,24 hrs.,wallstreetbets,SKY,6,0,6,-6,1,1,0,1,NYSE
4749,13-02-2021 14:00,24 hrs.,wallstreetbets,SNE,14,0,14,-14,2,2,2,1,NYSE
4749,13-02-2021 14:00,24 hrs.,wallstreetbets,SNX,6,0,6,-6,1,1,0,1,NYSE
4749,13-02-2021 14:00,24 hrs.,wallstreetbets,SOS,190,42,148,-106,27,26,30,25,NYSE
4749,13-02-2021 14:00,24 hrs.,wallstreetbets,STM,7,0,7,-7,1,1,1,1,NYSE
4749,13-02-2021 14:00,24 hrs.,wallstreetbets,SUP,7,0,7,-7,1,1,1,1,NYSE
4749,13-02-2021 14:00,24 hrs.,wallstreetbets,TAK,7,0,7,-7,1,1,1,1,NYSE
4749,13-02-2021 14:00,24 hrs.,wallstreetbets,TAP,13,0,13,-13,2,2,1,2,NYSE
4749,13-02-2021 14:00,24 hrs.,wallstreetbets,TBC,7,0,7,-7,1,1,1,1,NYSE
4749,13-02-2021 14:00,24 hrs.,wallstreetbets,TDC,32,26,6,20,2,4,16,2,NYSE
4749,13-02-2021 14:00,24 hrs.,wallstreetbets,TFC,7,0,7,-7,1,1,1,1,NYSE
4749,13-02-2021 14:00,24 hrs.,wallstreetbets,THC,7,0,7,-7,1,1,1,1,NYSE
4749,13-02-2021 14:00,24 hrs.,wallstreetbets,TRQ,7,7,0,7,1,1,1,1,NYSE
4749,13-02-2021 14:00,24 hrs.,wallstreetbets,TRU,7,0,7,-7,1,1,1,1,NYSE
4749,13-02-2021 14:00,24 hrs.,wallstreetbets,TSM,529,0,529,-529,2,141,239,2,NYSE
4749,13-02-2021 14:00,24 hrs.,wallstreetbets,TSN,6143,0,6143,-6143,1,2894,351,1,NYSE
4749,13-02-2021 14:00,24 hrs.,wallstreetbets,TTM,6,0,6,-6,1,1,0,1,NYSE
4749,13-02-2021 14:00,24 hrs.,wallstreetbets,TWO,7,0,7,-7,1,1,1,1,NYSE
4749,13-02-2021 14:00,24 hrs.,wallstreetbets,UBS,7,0,7,-7,1,1,1,1,NYSE
4749,13-02-2021 14:00,24 hrs.,wallstreetbets,UNP,7,0,7,-7,1,1,1,1,NYSE
4749,13-02-2021 14:00,24 hrs.,wallstreetbets,UTZ,1056,0,1056,-1056,1,416,220,1,NYSE
4749,13-02-2021 14:00,24 hrs.,wallstreetbets,VGR,7,0,7,-7,1,1,1,1,NYSE
4749,13-02-2021 14:00,24 hrs.,wallstreetbets,VHC,7,0,7,-7,1,1,1,1,NYSE
4749,13-02-2021 14:00,24 hrs.,wallstreetbets,VRT,158,0,158,-158,2,57,36,1,NYSE
4749,13-02-2021 14:00,24 hrs.,wallstreetbets,VST,35,0,35,-35,5,5,5,1,NYSE
4749,13-02-2021 14:00,24 hrs.,wallstreetbets,WFC,7,0,7,-7,1,1,1,1,NYSE
4749,13-02-2021 14:00,24 hrs.,wallstreetbets,WMC,8,0,8,-8,1,1,2,1,NYSE
4749,13-02-2021 14:00,24 hrs.,wallstreetbets,WMT,13,0,13,-13,2,2,1,2,NYSE
4749,13-02-2021 14:00,24 hrs.,wallstreetbets,ABBV,7,7,0,7,1,1,1,1,NYSE
4749,13-02-2021 14:00,24 hrs.,wallstreetbets,ABEV,7,0,7,-7,1,1,1,1,NYSE
4749,13-02-2021 14:00,24 hrs.,wallstreetbets,ACIC,20,7,13,-6,3,3,2,3,NYSE
4749,13-02-2021 14:00,24 hrs.,wallstreetbets,ALLY,7,0,7,-7,1,1,1,1,NYSE
4749,13-02-2021 14:00,24 hrs.,wallstreetbets,APRN,6,0,6,-6,1,1,0,1,NYSE
4749,13-02-2021 14:00,24 hrs.,wallstreetbets,ARGO,6,0,6,-6,1,1,0,1,NYSE
4749,13-02-2021 14:00,24 hrs.,wallstreetbets,BABA,174,0,174,-174,2,54,58,2,NYSE
4749,13-02-2021 14:00,24 hrs.,wallstreetbets,CARS,6,0,6,-6,1,1,0,1,NYSE
4749,13-02-2021 14:00,24 hrs.,wallstreetbets,CCIV,205,42,163,-121,30,30,25,26,NYSE
4749,13-02-2021 14:00,24 hrs.,wallstreetbets,NOK,3434,343,3091,-2748,23,1399,544,22,NYSE
4749,13-02-2021 14:00,24 hrs.,wallstreetbets,NOV,6,0,6,-6,1,1,0,1,NYSE
4749,13-02-2021 14:00,24 hrs.,wallstreetbets,NRG,35,0,35,-35,5,5,5,1,NYSE
4749,13-02-2021 14:00,24 hrs.,wallstreetbets,NSA,372,372,0,372,1,169,30,1,NYSE
4749,13-02-2021 14:00,24 hrs.,wallstreetbets,NUS,7,0,7,-7,1,1,1,1,NYSE
4749,13-02-2021 14:00,24 hrs.,wallstreetbets,AQST,7,0,7,-7,1,1,1,1,NASDAQ
4749,13-02-2021 14:00,24 hrs.,wallstreetbets,ARTL,68,0,68,-68,10,10,8,8,NASDAQ
4749,13-02-2021 14:00,24 hrs.,wallstreetbets,ASRT,41,0,41,-41,6,6,5,6,NASDAQ
4749,13-02-2021 14:00,24 hrs.,wallstreetbets,ASTC,7,7,0,7,1,1,1,1,NASDAQ
4749,13-02-2021 14:00,24 hrs.,wallstreetbets,ATHA,7,0,7,-7,1,1,1,1,NASDAQ
4749,13-02-2021 14:00,24 hrs.,wallstreetbets,ATHE,12,0,12,-12,2,2,0,1,NASDAQ
4749,13-02-2021 14:00,24 hrs.,wallstreetbets,ATOS,41,0,41,-41,6,6,5,5,NASDAQ
4749,13-02-2021 14:00,24 hrs.,wallstreetbets,ATVI,33,26,7,19,2,1,23,2,NASDAQ
4749,13-02-2021 14:00,24 hrs.,wallstreetbets,AUPH,6,0,6,-6,1,1,0,1,NASDAQ
4749,13-02-2021 14:00,24 hrs.,wallstreetbets,AVXL,7,0,7,-7,1,1,1,1,NASDAQ
4749,13-02-2021 14:00,24 hrs.,wallstreetbets,AWRE,7,0,7,-7,1,1,1,1,NASDAQ
4749,13-02-2021 14:00,24 hrs.,wallstreetbets,BBBY,7,0,7,-7,1,1,1,1,NASDAQ
4749,13-02-2021 14:00,24 hrs.,wallstreetbets,BEAT,8,0,8,-8,1,2,0,1,NASDAQ
4749,13-02-2021 14:00,24 hrs.,wallstreetbets,BIVI,6,0,6,-6,1,1,0,1,NASDAQ
4749,13-02-2021 14:00,24 hrs.,wallstreetbets,BLCM,6,0,6,-6,1,1,0,1,NASDAQ
4749,13-02-2021 14:00,24 hrs.,wallstreetbets,AQB,7,7,0,7,1,1,1,1,NASDAQ
4749,13-02-2021 14:00,24 hrs.,wallstreetbets,ASO,6,0,6,-6,1,1,0,1,NASDAQ
4749,13-02-2021 14:00,24 hrs.,wallstreetbets,AZN,14,0,14,-14,2,2,2,2,NASDAQ
4749,13-02-2021 14:00,24 hrs.,wallstreetbets,BLU,14,0,14,-14,2,2,2,1,NASDAQ
4749,13-02-2021 14:00,24 hrs.,wallstreetbets,BUG,12,0,12,-12,2,2,0,1,NASDAQ
4749,13-02-2021 14:00,24 hrs.,wallstreetbets,CFO,6,6,0,6,1,1,0,1,NASDAQ
4749,13-02-2021 14:00,24 hrs.,wallstreetbets,CGC,14,0,14,-14,2,2,2,2,NASDAQ
4749,13-02-2021 14:00,24 hrs.,wallstreetbets,CTG,7,0,7,-7,1,1,1,1,NASDAQ
4749,13-02-2021 14:00,24 hrs.,wallstreetbets,DBX,7,0,7,-7,1,1,1,1,NASDAQ
4749,13-02-2021 14:00,24 hrs.,wallstreetbets,FAT,174,0,174,-174,2,54,58,2,NASDAQ
4749,13-02-2021 14:00,24 hrs.,wallstreetbets,FUV,7,0,7,-7,1,1,1,1,NASDAQ
4749,13-02-2021 14:00,24 hrs.,wallstreetbets,FWP,14,0,14,-14,2,2,2,1,NASDAQ
4749,13-02-2021 14:00,24 hrs.,wallstreetbets,GBT,7,0,7,-7,1,1,1,1,NASDAQ
4749,13-02-2021 14:00,24 hrs.,wallstreetbets,GSM,19,6,13,-7,3,3,1,3,NASDAQ
4749,13-02-2021 14:00,24 hrs.,wallstreetbets,HAS,6,6,0,6,1,1,0,1,NASDAQ
4749,13-02-2021 14:00,24 hrs.,wallstreetbets,IEA,7,0,7,-7,1,1,1,1,NASDAQ
4749,13-02-2021 14:00,24 hrs.,wallstreetbets,IIN,6,0,6,-6,1,1,0,1,NASDAQ
4749,13-02-2021 14:00,24 hrs.,wallstreetbets,INO,95,40,55,-15,9,11,37,9,NASDAQ
4749,13-02-2021 14:00,24 hrs.,wallstreetbets,JFU,6,6,0,6,1,1,0,1,NASDAQ
4749,13-02-2021 14:00,24 hrs.,wallstreetbets,CHWY,7,0,7,-7,1,1,1,1,NYSE
4749,13-02-2021 14:00,24 hrs.,wallstreetbets,CLDR,6,0,6,-6,1,1,0,1,NYSE
4749,13-02-2021 14:00,24 hrs.,wallstreetbets,CLII,7,0,7,-7,1,1,1,1,NYSE
4749,13-02-2021 14:00,24 hrs.,wallstreetbets,DASH,13,7,6,1,2,2,1,2,NYSE
4749,13-02-2021 14:00,24 hrs.,wallstreetbets,EXPR,15,0,15,-15,2,2,3,2,NYSE
4749,13-02-2021 14:00,24 hrs.,wallstreetbets,FEDU,7,0,7,-7,1,1,1,1,NYSE
4749,13-02-2021 14:00,24 hrs.,wallstreetbets,FLOW,7,0,7,-7,1,1,1,1,NYSE
4749,13-02-2021 14:00,24 hrs.,wallstreetbets,FSLY,14,0,14,-14,2,2,2,2,NYSE
4749,13-02-2021 14:00,24 hrs.,wallstreetbets,FUBO,1077,0,1077,-1077,4,419,223,4,NYSE
4749,13-02-2021 14:00,24 hrs.,wallstreetbets,FVRR,7,0,7,-7,1,1,1,1,NYSE
4749,13-02-2021 14:00,24 hrs.,wallstreetbets,GNRC,6,6,0,6,1,1,0,1,NYSE
4749,13-02-2021 14:00,24 hrs.,wallstreetbets,HEXO,27,14,13,1,4,4,3,4,NYSE
4749,13-02-2021 14:00,24 hrs.,wallstreetbets,HUBS,13,0,13,-13,2,2,1,2,NYSE
4749,13-02-2021 14:00,24 hrs.,wallstreetbets,HUYA,14,7,7,0,2,2,2,2,NYSE
4749,13-02-2021 14:00,24 hrs.,wallstreetbets,HYLN,548,0,548,-548,11,154,196,8,NYSE
4749,13-02-2021 14:00,24 hrs.,wallstreetbets,IIPR,20,0,20,-20,3,3,2,2,NYSE
4749,13-02-2021 14:00,24 hrs.,wallstreetbets,IPOE,7,0,7,-7,1,1,1,1,NYSE
4749,13-02-2021 14:00,24 hrs.,wallstreetbets,JMIA,6164,0,6164,-6164,4,2897,354,3,NYSE
4749,13-02-2021 14:00,24 hrs.,wallstreetbets,JNPR,6,0,6,-6,1,1,0,1,NYSE
4749,13-02-2021 14:00,24 hrs.,wallstreetbets,LEAP,6,6,0,6,1,1,0,1,NYSE
4749,13-02-2021 14:00,24 hrs.,wallstreetbets,LGVW,21,14,7,7,3,3,3,2,NYSE
4749,13-02-2021 14:00,24 hrs.,wallstreetbets,LSPD,6,0,6,-6,1,1,0,1,NYSE
4749,13-02-2021 14:00,24 hrs.,wallstreetbets,MAIN,6,6,0,6,1,1,0,1,NYSE
4749,13-02-2021 14:00,24 hrs.,wallstreetbets,MANU,12,0,12,-12,2,2,0,2,NYSE
4749,13-02-2021 14:00,24 hrs.,wallstreetbets,NOVA,7,7,0,7,1,1,1,1,NYSE
4749,13-02-2021 14:00,24 hrs.,wallstreetbets,PACK,15,0,15,-15,2,2,3,1,NYSE
4749,13-02-2021 14:00,24 hrs.,wallstreetbets,PLTR,15191,899,14292,-13393,38,6753,1533,30,NYSE
4749,13-02-2021 14:00,24 hrs.,wallstreetbets,PRTY,14,0,14,-14,2,2,2,2,NYSE
4749,13-02-2021 14:00,24 hrs.,wallstreetbets,PSTH,233,0,233,-233,3,77,67,2,NYSE
4749,13-02-2021 14:00,24 hrs.,wallstreetbets,PUMP,49,0,49,-49,7,7,7,2,NYSE
4749,13-02-2021 14:00,24 hrs.,wallstreetbets,FTFT,14,0,14,-14,2,2,2,2,NASDAQ
4749,13-02-2021 14:00,24 hrs.,wallstreetbets,FUTU,1056,0,1056,-1056,1,416,220,1,NASDAQ
4749,13-02-2021 14:00,24 hrs.,wallstreetbets,GAIN,13,0,13,-13,2,2,1,2,NASDAQ
4749,13-02-2021 14:00,24 hrs.,wallstreetbets,GERN,6,0,6,-6,1,1,0,1,NASDAQ
4749,13-02-2021 14:00,24 hrs.,wallstreetbets,GEVO,209,0,209,-209,9,58,57,7,NASDAQ
4749,13-02-2021 14:00,24 hrs.,wallstreetbets,GILT,14,0,14,-14,2,2,2,2,NASDAQ
4749,13-02-2021 14:00,24 hrs.,wallstreetbets,GLBS,28,7,21,-14,4,4,4,3,NASDAQ
4749,13-02-2021 14:00,24 hrs.,wallstreetbets,GMBL,7,0,7,-7,1,1,1,1,NASDAQ
4749,13-02-2021 14:00,24 hrs.,wallstreetbets,GNOG,7,7,0,7,1,1,1,1,NASDAQ
4749,13-02-2021 14:00,24 hrs.,wallstreetbets,GNUS,27,7,20,-13,4,4,3,4,NASDAQ
4749,13-02-2021 14:00,24 hrs.,wallstreetbets,BLNK,7,0,7,-7,1,1,1,1,NASDAQ
4749,13-02-2021 14:00,24 hrs.,wallstreetbets,BNGO,397,256,141,115,23,118,69,13,NASDAQ
4749,13-02-2021 14:00,24 hrs.,wallstreetbets,BOXL,7,0,7,-7,1,1,1,1,NASDAQ
4749,13-02-2021 14:00,24 hrs.,wallstreetbets,BRQS,6,0,6,-6,1,1,0,1,NASDAQ
4749,13-02-2021 14:00,24 hrs.,wallstreetbets,BSQR,7,7,0,7,1,1,1,1,NASDAQ
4749,13-02-2021 14:00,24 hrs.,wallstreetbets,KHC,14,0,14,-14,2,2,2,2,NASDAQ
4749,13-02-2021 14:00,24 hrs.,wallstreetbets,MKD,13,13,0,13,2,2,1,2,NASDAQ
4749,13-02-2021 14:00,24 hrs.,wallstreetbets,MYT,7,0,7,-7,1,1,1,1,NASDAQ
4749,13-02-2021 14:00,24 hrs.,wallstreetbets,OGI,94,21,73,-52,14,14,10,13,NASDAQ
4749,13-02-2021 14:00,24 hrs.,wallstreetbets,OPK,7,0,7,-7,1,1,1,1,NASDAQ
4749,13-02-2021 14:00,24 hrs.,wallstreetbets,PDD,7,7,0,7,1,1,1,1,NASDAQ
4749,13-02-2021 14:00,24 hrs.,wallstreetbets,QQQ,6,6,0,6,1,1,0,1,NASDAQ
4749,13-02-2021 14:00,24 hrs.,wallstreetbets,RUN,251,7,244,-237,4,73,89,4,NASDAQ
4749,13-02-2021 14:00,24 hrs.,wallstreetbets,RXT,7,0,7,-7,1,1,1,1,NASDAQ
4749,13-02-2021 14:00,24 hrs.,wallstreetbets,SDC,7,0,7,-7,1,1,1,1,NASDAQ
4749,13-02-2021 14:00,24 hrs.,wallstreetbets,SFT,7,0,7,-7,1,1,1,1,NASDAQ
4749,13-02-2021 14:00,24 hrs.,wallstreetbets,SLM,8,0,8,-8,1,1,2,1,NASDAQ
4749,13-02-2021 14:00,24 hrs.,wallstreetbets,SLP,13,13,0,13,2,2,1,2,NASDAQ
4749,13-02-2021 14:00,24 hrs.,wallstreetbets,SMH,7,0,7,-7,1,1,1,1,NASDAQ
4749,13-02-2021 14:00,24 hrs.,wallstreetbets,SND,27,7,20,-13,4,4,3,4,NASDAQ
4749,13-02-2021 14:00,24 hrs.,wallstreetbets,SPI,7,0,7,-7,1,1,1,1,NASDAQ
4749,13-02-2021 14:00,24 hrs.,wallstreetbets,SPT,7,0,7,-7,1,1,1,1,NASDAQ
4749,13-02-2021 14:00,24 hrs.,wallstreetbets,VFF,17,0,17,-17,2,2,5,1,NASDAQ
4749,13-02-2021 14:00,24 hrs.,wallstreetbets,WBA,7,0,7,-7,1,1,1,1,NASDAQ
4749,13-02-2021 14:00,24 hrs.,wallstreetbets,WNW,60,17,43,-26,8,8,12,6,NASDAQ
4749,13-02-2021 14:00,24 hrs.,wallstreetbets,WWR,6,0,6,-6,1,1,0,1,NASDAQ
4749,13-02-2021 14:00,24 hrs.,wallstreetbets,AACG,7,0,7,-7,1,1,1,1,NASDAQ
4749,13-02-2021 14:00,24 hrs.,wallstreetbets,AAPL,39,13,26,-13,6,6,3,6,NASDAQ
4749,13-02-2021 14:00,24 hrs.,wallstreetbets,AAWW,6,0,6,-6,1,1,0,1,NASDAQ
4749,13-02-2021 14:00,24 hrs.,wallstreetbets,ABCL,7,7,0,7,1,1,1,1,NASDAQ
4749,13-02-2021 14:00,24 hrs.,wallstreetbets,ABEO,7,0,7,-7,1,1,1,1,NASDAQ
4749,13-02-2021 14:00,24 hrs.,wallstreetbets,ABNB,14,6,8,-2,2,2,2,2,NASDAQ
4749,13-02-2021 14:00,24 hrs.,wallstreetbets,ABUS,7,0,7,-7,1,1,1,1,NASDAQ
4749,13-02-2021 14:00,24 hrs.,wallstreetbets,ACEV,6,0,6,-6,1,1,0,1,NASDAQ
4749,13-02-2021 14:00,24 hrs.,wallstreetbets,ACIU,7,0,7,-7,1,1,1,1,NASDAQ
4749,13-02-2021 14:00,24 hrs.,wallstreetbets,ACOR,7,0,7,-7,1,1,1,1,NASDAQ
4749,13-02-2021 14:00,24 hrs.,wallstreetbets,ACST,20,0,20,-20,3,3,2,3,NASDAQ
4749,13-02-2021 14:00,24 hrs.,wallstreetbets,ADMA,7,0,7,-7,1,1,1,1,NASDAQ
4749,13-02-2021 14:00,24 hrs.,wallstreetbets,ADMP,7,0,7,-7,1,1,1,1,NASDAQ
4749,13-02-2021 14:00,24 hrs.,wallstreetbets,ADXS,6,0,6,-6,1,1,0,1,NASDAQ
4749,13-02-2021 14:00,24 hrs.,wallstreetbets,AEZS,14,0,14,-14,2,2,2,1,NASDAQ
4749,13-02-2021 14:00,24 hrs.,wallstreetbets,AGEN,7,0,7,-7,1,1,1,1,NASDAQ
4749,13-02-2021 14:00,24 hrs.,wallstreetbets,AGTC,36,0,36,-36,5,5,6,3,NASDAQ
4749,13-02-2021 14:00,24 hrs.,wallstreetbets,AIKI,7,0,7,-7,1,1,1,1,NASDAQ
4749,13-02-2021 14:00,24 hrs.,wallstreetbets,AKBA,7,0,7,-7,1,1,1,1,NASDAQ
4749,13-02-2021 14:00,24 hrs.,wallstreetbets,ALRN,7,0,7,-7,1,1,1,1,NASDAQ
4749,13-02-2021 14:00,24 hrs.,wallstreetbets,AMAT,13,0,13,-13,2,2,1,2,NASDAQ
4749,13-02-2021 14:00,24 hrs.,wallstreetbets,AMKR,21,0,21,-21,3,3,3,3,NASDAQ
4749,13-02-2021 14:00,24 hrs.,wallstreetbets,AMZN,116,0,116,-116,5,4,88,4,NASDAQ
4749,13-02-2021 14:00,24 hrs.,wallstreetbets,ANTE,7,7,0,7,1,1,1,1,NASDAQ
4749,13-02-2021 14:00,24 hrs.,wallstreetbets,APEN,7,0,7,-7,1,1,1,1,NASDAQ
4749,13-02-2021 14:00,24 hrs.,wallstreetbets,APHA,968,740,228,512,39,321,170,26,NASDAQ
4749,13-02-2021 14:00,24 hrs.,wallstreetbets,APPS,7,7,0,7,1,1,1,1,NASDAQ
4749,13-02-2021 14:00,24 hrs.,wallstreetbets,APRE,7,0,7,-7,1,1,1,1,NASDAQ
4749,13-02-2021 14:00,24 hrs.,wallstreetbets,ICLN,6,0,6,-6,1,1,0,1,NASDAQ
4749,13-02-2021 14:00,24 hrs.,wallstreetbets,ICON,7,0,7,-7,1,1,1,1,NASDAQ
4749,13-02-2021 14:00,24 hrs.,wallstreetbets,IDEX,13,0,13,-13,2,2,1,2,NASDAQ
4749,13-02-2021 14:00,24 hrs.,wallstreetbets,IFMK,7,7,0,7,1,1,1,1,NASDAQ
4749,13-02-2021 14:00,24 hrs.,wallstreetbets,ILMN,7,0,7,-7,1,1,1,1,NASDAQ
4749,13-02-2021 14:00,24 hrs.,wallstreetbets,IMGN,21,0,21,-21,3,3,3,3,NASDAQ
4749,13-02-2021 14:00,24 hrs.,wallstreetbets,INPX,14,7,7,0,2,2,2,2,NASDAQ
4749,13-02-2021 14:00,24 hrs.,wallstreetbets,INSG,6,6,0,6,1,1,0,1,NASDAQ
4749,13-02-2021 14:00,24 hrs.,wallstreetbets,INTC,168,20,148,-128,5,7,134,5,NASDAQ
4749,13-02-2021 14:00,24 hrs.,wallstreetbets,IPWR,6,0,6,-6,1,1,0,1,NASDAQ
4749,13-02-2021 14:00,24 hrs.,wallstreetbets,IRBT,6,6,0,6,1,1,0,1,NASDAQ
4749,13-02-2021 14:00,24 hrs.,wallstreetbets,BTWN,7,0,7,-7,1,1,1,1,NASDAQ
4749,13-02-2021 14:00,24 hrs.,wallstreetbets,BWEN,7,0,7,-7,1,1,1,1,NASDAQ
4749,13-02-2021 14:00,24 hrs.,wallstreetbets,CARE,49,0,49,-49,7,7,7,2,NASDAQ
4749,13-02-2021 14:00,24 hrs.,wallstreetbets,CARV,7,0,7,-7,1,1,1,1,NASDAQ
4749,13-02-2021 14:00,24 hrs.,wallstreetbets,CASH,14,0,14,-14,2,2,2,1,NASDAQ
4749,13-02-2021 14:00,24 hrs.,wallstreetbets,CATM,7,0,7,-7,1,1,1,1,NASDAQ
4749,13-02-2021 14:00,24 hrs.,wallstreetbets,CBAT,7,0,7,-7,1,1,1,1,NASDAQ
4749,13-02-2021 14:00,24 hrs.,wallstreetbets,CCRC,12,0,12,-12,2,2,0,1,NASDAQ
4749,13-02-2021 14:00,24 hrs.,wallstreetbets,CIDM,14,0,14,-14,2,2,2,2,NASDAQ
4749,13-02-2021 14:00,24 hrs.,wallstreetbets,CKPT,7,0,7,-7,1,1,1,1,NASDAQ
4749,13-02-2021 14:00,24 hrs.,wallstreetbets,CLBS,21,7,14,-7,3,3,3,2,NASDAQ
4749,13-02-2021 14:00,24 hrs.,wallstreetbets,CLEU,7,7,0,7,1,1,1,1,NASDAQ
4749,13-02-2021 14:00,24 hrs.,wallstreetbets,CLGN,7,0,7,-7,1,1,1,1,NASDAQ
4749,13-02-2021 14:00,24 hrs.,wallstreetbets,CLSN,7,0,7,-7,1,1,1,1,NASDAQ
4749,13-02-2021 14:00,24 hrs.,wallstreetbets,CMPS,40,12,28,-16,6,6,4,5,NASDAQ
4749,13-02-2021 14:00,24 hrs.,wallstreetbets,COCP,7,0,7,-7,1,1,1,1,NASDAQ
4749,13-02-2021 14:00,24 hrs.,wallstreetbets,CRBP,34,13,21,-8,5,5,4,5,NASDAQ
4749,13-02-2021 14:00,24 hrs.,wallstreetbets,CRNT,7,0,7,-7,1,1,1,1,NASDAQ
4749,13-02-2021 14:00,24 hrs.,wallstreetbets,CRON,20,0,20,-20,3,3,2,3,NASDAQ
4749,13-02-2021 14:00,24 hrs.,wallstreetbets,CRSP,75,75,0,75,4,5,49,2,NASDAQ
4749,13-02-2021 14:00,24 hrs.,wallstreetbets,CRSR,623,264,359,-95,14,220,127,10,NASDAQ
4749,13-02-2021 14:00,24 hrs.,wallstreetbets,CTHR,7,0,7,-7,1,1,1,1,NASDAQ
4749,13-02-2021 14:00,24 hrs.,wallstreetbets,CTMX,7,0,7,-7,1,1,1,1,NASDAQ
4749,13-02-2021 14:00,24 hrs.,wallstreetbets,CTRM,186,14,172,-158,27,27,24,22,NASDAQ
4749,13-02-2021 14:00,24 hrs.,wallstreetbets,CVAC,64,0,64,-64,1,21,18,1,NASDAQ
4749,13-02-2021 14:00,24 hrs.,wallstreetbets,DFFN,14,0,14,-14,2,2,2,1,NASDAQ
4749,13-02-2021 14:00,24 hrs.,wallstreetbets,DKNG,21,7,14,-7,3,3,3,3,NASDAQ
4749,13-02-2021 14:00,24 hrs.,wallstreetbets,DOYU,7,0,7,-7,1,1,1,1,NASDAQ
4749,13-02-2021 14:00,24 hrs.,wallstreetbets,DRIV,6,0,6,-6,1,1,0,1,NASDAQ
4749,13-02-2021 14:00,24 hrs.,wallstreetbets,DRRX,7,0,7,-7,1,1,1,1,NASDAQ
4749,13-02-2021 14:00,24 hrs.,wallstreetbets,DSKE,7,0,7,-7,1,1,1,1,NASDAQ
4749,13-02-2021 14:00,24 hrs.,wallstreetbets,DXYN,7,0,7,-7,1,1,1,1,NASDAQ
4749,13-02-2021 14:00,24 hrs.,wallstreetbets,EBON,56,0,56,-56,8,8,8,4,NASDAQ
4749,13-02-2021 14:00,24 hrs.,wallstreetbets,EDIT,9459,0,9459,-9459,2,4420,611,2,NASDAQ
4749,13-02-2021 14:00,24 hrs.,wallstreetbets,ELSE,7,0,7,-7,1,1,1,1,NASDAQ
4749,13-02-2021 14:00,24 hrs.,wallstreetbets,ENLV,7,0,7,-7,1,1,1,1,NASDAQ
4749,13-02-2021 14:00,24 hrs.,wallstreetbets,ENVB,26,0,26,-26,4,4,2,3,NASDAQ
4749,13-02-2021 14:00,24 hrs.,wallstreetbets,EVER,28,0,28,-28,4,4,4,4,NASDAQ
4749,13-02-2021 14:00,24 hrs.,wallstreetbets,EVFM,6,6,0,6,1,1,0,1,NASDAQ
4749,13-02-2021 14:00,24 hrs.,wallstreetbets,EXPC,7,0,7,-7,1,1,1,1,NASDAQ
4749,13-02-2021 14:00,24 hrs.,wallstreetbets,EXPI,6,6,0,6,1,1,0,1,NASDAQ
4749,13-02-2021 14:00,24 hrs.,wallstreetbets,FAMI,6,0,6,-6,1,1,0,1,NASDAQ
4749,13-02-2021 14:00,24 hrs.,wallstreetbets,FARM,7,0,7,-7,1,1,1,1,NASDAQ
4749,13-02-2021 14:00,24 hrs.,wallstreetbets,FAST,7,0,7,-7,1,1,1,1,NASDAQ
4749,13-02-2021 14:00,24 hrs.,wallstreetbets,FCAC,8,0,8,-8,1,1,2,1,NASDAQ
4749,13-02-2021 14:00,24 hrs.,wallstreetbets,FCEL,6,0,6,-6,1,1,0,1,NASDAQ
4749,13-02-2021 14:00,24 hrs.,wallstreetbets,FIZZ,14,14,0,14,2,2,2,1,NASDAQ
4749,13-02-2021 14:00,24 hrs.,wallstreetbets,FLGT,13,0,13,-13,2,2,1,2,NASDAQ
4749,13-02-2021 14:00,24 hrs.,wallstreetbets,FLWR,7,0,7,-7,1,1,1,1,NASDAQ
4749,13-02-2021 14:00,24 hrs.,wallstreetbets,FLWS,15,0,15,-15,2,2,3,2,NASDAQ
4749,13-02-2021 14:00,24 hrs.,wallstreetbets,FOLD,48,0,48,-48,7,7,6,6,NASDAQ
4749,13-02-2021 14:00,24 hrs.,wallstreetbets,FORD,7,0,7,-7,1,1,1,1,NASDAQ
4749,13-02-2021 14:00,24 hrs.,wallstreetbets,FORM,187,0,187,-187,1,72,39,1,NASDAQ
4749,13-02-2021 14:00,24 hrs.,wallstreetbets,NFLX,7,0,7,-7,1,1,1,1,NASDAQ
4749,13-02-2021 14:00,24 hrs.,wallstreetbets,NKLA,7,0,7,-7,1,1,1,1,NASDAQ
4749,13-02-2021 14:00,24 hrs.,SPACs,APEX,35,0,35,-35,1,6,19,1,OTC
4749,13-02-2021 14:00,24 hrs.,SPACs,BRRN,11,0,11,-11,1,2,3,1,OTC
4749,13-02-2021 14:00,24 hrs.,SPACs,CIK,75,0,75,-75,1,24,23,1,AMEX
4749,13-02-2021 14:00,24 hrs.,SPACs,PTK,65,65,0,65,1,19,23,1,AMEX
4749,13-02-2021 14:00,24 hrs.,SPACs,CHAQ,65,65,0,65,1,19,23,1,AMEX
4749,13-02-2021 14:00,24 hrs.,SPACs,AIR,150,0,150,-150,1,55,36,1,NYSE
4749,13-02-2021 14:00,24 hrs.,SPACs,AMC,7,7,0,7,1,0,3,1,NYSE
4749,13-02-2021 14:00,24 hrs.,SPACs,BFT,366,359,7,352,2,30,298,2,NYSE
4749,13-02-2021 14:00,24 hrs.,SPACs,COO,45,0,45,-45,1,7,27,1,NYSE
4749,13-02-2021 14:00,24 hrs.,SPACs,DFS,150,0,150,-150,1,55,36,1,NYSE
4749,13-02-2021 14:00,24 hrs.,SPACs,ELY,18,0,18,-18,1,6,2,1,NYSE
4749,13-02-2021 14:00,24 hrs.,SPACs,EQD,359,359,0,359,1,29,297,1,NYSE
4749,13-02-2021 14:00,24 hrs.,SPACs,FSR,40,34,6,28,2,9,14,2,NYSE
4749,13-02-2021 14:00,24 hrs.,SPACs,GME,7,7,0,7,1,0,3,1,NYSE
4749,13-02-2021 14:00,24 hrs.,SPACs,IRR,88,0,88,-88,1,28,28,1,NYSE
4749,13-02-2021 14:00,24 hrs.,SPACs,JWS,401,365,36,329,7,35,303,3,NYSE
4749,13-02-2021 14:00,24 hrs.,SPACs,NAV,157,55,102,-47,5,46,45,4,NYSE
4749,13-02-2021 14:00,24 hrs.,SPACs,NGA,109,34,75,-41,2,32,37,2,NYSE
4749,13-02-2021 14:00,24 hrs.,SPACs,RBC,7,7,0,7,1,1,1,1,NYSE
4749,13-02-2021 14:00,24 hrs.,SPACs,RMO,6,0,6,-6,1,1,0,1,NYSE
4749,13-02-2021 14:00,24 hrs.,SPACs,RSI,9,0,9,-9,1,0,5,1,NYSE
4749,13-02-2021 14:00,24 hrs.,SPACs,RTP,380,359,21,338,3,30,308,2,NYSE
4749,13-02-2021 14:00,24 hrs.,SPACs,SBE,344,34,310,-276,3,120,92,2,NYSE
4749,13-02-2021 14:00,24 hrs.,SPACs,SOS,7,7,0,7,1,1,1,1,NYSE
4749,13-02-2021 14:00,24 hrs.,SPACs,TDA,7,0,7,-7,1,1,1,1,NYSE
4749,13-02-2021 14:00,24 hrs.,SPACs,YUM,55,0,55,-55,1,17,17,1,NYSE
4749,13-02-2021 14:00,24 hrs.,SPACs,ACIC,365,365,0,365,2,30,297,2,NYSE
4749,13-02-2021 14:00,24 hrs.,SPACs,AVAN,15,15,0,15,1,2,7,1,NYSE
4749,13-02-2021 14:00,24 hrs.,SPACs,BOAC,90,0,90,-90,1,30,26,1,NYSE
4749,13-02-2021 14:00,24 hrs.,SPACs,CCIV,926,470,456,14,11,159,564,11,NYSE
4749,13-02-2021 14:00,24 hrs.,SPACs,DNMR,29,22,7,15,2,8,5,2,NYSE
4749,13-02-2021 14:00,24 hrs.,SPACs,EMPW,359,359,0,359,1,29,297,1,NYSE
4749,13-02-2021 14:00,24 hrs.,SPACs,ENPC,359,359,0,359,1,29,297,1,NYSE
4749,13-02-2021 14:00,24 hrs.,SPACs,FGNA,961,0,961,-961,2,328,297,1,NYSE
4749,13-02-2021 14:00,24 hrs.,SPACs,FUSE,1361,394,967,-573,9,337,651,8,NYSE
4749,13-02-2021 14:00,24 hrs.,SPACs,GSAH,825,0,825,-825,1,279,263,1,NYSE
4749,13-02-2021 14:00,24 hrs.,SPACs,HYLN,34,34,0,34,1,8,14,1,NYSE
4749,13-02-2021 14:00,24 hrs.,SPACs,IPOE,825,0,825,-825,1,279,263,1,NYSE
4749,13-02-2021 14:00,24 hrs.,SPACs,IPOF,11,11,0,11,2,1,1,2,NYSE
4749,13-02-2021 14:00,24 hrs.,SPACs,LGVW,41,41,0,41,2,9,15,2,NYSE
4749,13-02-2021 14:00,24 hrs.,SPACs,PDAC,7,0,7,-7,1,1,1,1,NYSE
4749,13-02-2021 14:00,24 hrs.,SPACs,PSTH,751,32,719,-687,6,207,313,5,NYSE
4749,13-02-2021 14:00,24 hrs.,SPACs,SNPR,345,6,339,-333,7,117,83,5,NYSE
4749,13-02-2021 14:00,24 hrs.,SPACs,STPK,47,34,13,21,3,10,15,3,NYSE
4749,13-02-2021 14:00,24 hrs.,SPACs,TPGY,34,34,0,34,1,8,14,1,NYSE
4749,13-02-2021 14:00,24 hrs.,SPACs,TWND,42,0,42,-42,1,9,20,1,NYSE
4749,13-02-2021 14:00,24 hrs.,SPACs,VTOL,150,0,150,-150,1,55,36,1,NYSE
4749,13-02-2021 14:00,24 hrs.,SPACs,VYGG,61,20,41,-21,5,11,19,3,NYSE
4749,13-02-2021 14:00,24 hrs.,SPACs,ADV,359,359,0,359,1,29,297,1,NASDAQ
4749,13-02-2021 14:00,24 hrs.,wallstreetbets,GOEV,7,0,7,-7,1,1,1,1,NASDAQ
4749,13-02-2021 14:00,24 hrs.,wallstreetbets,GOGO,49,6,43,-37,8,8,1,4,NASDAQ
4749,13-02-2021 14:00,24 hrs.,wallstreetbets,GOLD,13,0,13,-13,2,2,1,2,NASDAQ
4749,13-02-2021 14:00,24 hrs.,wallstreetbets,GRIL,7,0,7,-7,1,1,1,1,NASDAQ
4749,13-02-2021 14:00,24 hrs.,wallstreetbets,GRTS,6,0,6,-6,1,1,0,1,NASDAQ
4749,13-02-2021 14:00,24 hrs.,wallstreetbets,GTEC,8,0,8,-8,1,1,2,1,NASDAQ
4749,13-02-2021 14:00,24 hrs.,wallstreetbets,GTHX,50,6,44,-38,8,8,2,6,NASDAQ
4749,13-02-2021 14:00,24 hrs.,wallstreetbets,HALO,14,0,14,-14,2,2,2,2,NASDAQ
4749,13-02-2021 14:00,24 hrs.,wallstreetbets,HDSN,7,0,7,-7,1,1,1,1,NASDAQ
4749,13-02-2021 14:00,24 hrs.,wallstreetbets,HEAR,13,7,6,1,2,2,1,2,NASDAQ
4749,13-02-2021 14:00,24 hrs.,wallstreetbets,HSTO,19,0,19,-19,3,3,1,2,NASDAQ
4749,13-02-2021 14:00,24 hrs.,wallstreetbets,HTBX,8,0,8,-8,1,1,2,1,NASDAQ
4749,13-02-2021 14:00,24 hrs.,wallstreetbets,HZNP,7,7,0,7,1,1,1,1,NASDAQ
4749,13-02-2021 14:00,24 hrs.,wallstreetbets,SLRX,7,0,7,-7,1,1,1,1,NASDAQ
4749,13-02-2021 14:00,24 hrs.,wallstreetbets,SNCA,6,0,6,-6,1,1,0,1,NASDAQ
4749,13-02-2021 14:00,24 hrs.,SPACs,CFO,205,0,205,-205,2,72,53,2,NASDAQ
4749,13-02-2021 14:00,24 hrs.,SPACs,ESG,18,0,18,-18,1,6,2,1,NASDAQ
4749,13-02-2021 14:00,24 hrs.,SPACs,III,136,0,136,-136,1,49,34,1,NASDAQ
4749,13-02-2021 14:00,24 hrs.,SPACs,NPA,125,0,125,-125,1,44,33,1,NASDAQ
4749,13-02-2021 14:00,24 hrs.,SPACs,AACQ,2327,65,2262,-2197,10,754,779,8,NASDAQ
4749,13-02-2021 14:00,24 hrs.,SPACs,ACTC,34,34,0,34,1,8,14,1,NASDAQ
4749,13-02-2021 14:00,24 hrs.,SPACs,ADOC,65,65,0,65,1,19,23,1,NASDAQ
4749,13-02-2021 14:00,24 hrs.,SPACs,BHSE,65,65,0,65,1,19,23,1,NASDAQ
4749,13-02-2021 14:00,24 hrs.,SPACs,BLNK,45,0,45,-45,1,7,27,1,NASDAQ
4749,13-02-2021 14:00,24 hrs.,SPACs,BRPA,393,393,0,393,2,37,311,2,NASDAQ
4749,13-02-2021 14:00,24 hrs.,SPACs,BTAQ,563,0,563,-563,1,236,87,1,NASDAQ
4749,13-02-2021 14:00,24 hrs.,SPACs,BTWN,9,0,9,-9,1,1,3,1,NASDAQ
4749,13-02-2021 14:00,24 hrs.,SPACs,CIIC,67,67,0,67,2,20,19,1,NASDAQ
4749,13-02-2021 14:00,24 hrs.,SPACs,CMLF,393,393,0,393,2,37,311,2,NASDAQ
4749,13-02-2021 14:00,24 hrs.,SPACs,DFHT,359,359,0,359,1,29,297,1,NASDAQ
4749,13-02-2021 14:00,24 hrs.,SPACs,FCAC,371,359,12,347,3,31,297,2,NASDAQ
4749,13-02-2021 14:00,24 hrs.,SPACs,FTOC,467,314,153,161,6,167,109,5,NASDAQ
4749,13-02-2021 14:00,24 hrs.,SPACs,GRCY,65,65,0,65,1,19,23,1,NASDAQ
4749,13-02-2021 14:00,24 hrs.,SPACs,GRSV,101,0,101,-101,3,28,33,3,NASDAQ
4749,13-02-2021 14:00,24 hrs.,SPACs,KERN,45,0,45,-45,1,7,27,1,NASDAQ
4749,13-02-2021 14:00,24 hrs.,SPACs,MACU,65,65,0,65,1,19,23,1,NASDAQ
4749,13-02-2021 14:00,24 hrs.,SPACs,NBAC,45,9,36,-27,3,13,7,3,NASDAQ
4749,13-02-2021 14:00,24 hrs.,SPACs,NKLA,34,34,0,34,1,8,14,1,NASDAQ
4749,13-02-2021 14:00,24 hrs.,SPACs,OKTA,54,0,54,-54,1,17,16,1,NASDAQ
4749,13-02-2021 14:00,24 hrs.,SPACs,PRCH,38,0,38,-38,1,14,6,1,NASDAQ
4749,13-02-2021 14:00,24 hrs.,SPACs,PYPL,96,0,96,-96,1,35,22,1,NASDAQ
4749,13-02-2021 14:00,24 hrs.,SPACs,QELL,150,0,150,-150,1,55,36,1,NASDAQ
4749,13-02-2021 14:00,24 hrs.,SPACs,RIDE,34,34,0,34,1,8,14,1,NASDAQ
4749,13-02-2021 14:00,24 hrs.,SPACs,ROCH,34,34,0,34,1,8,14,1,NASDAQ
4749,13-02-2021 14:00,24 hrs.,wallstreetbets,ITRM,28,7,21,-14,4,4,4,3,NASDAQ
4749,13-02-2021 14:00,24 hrs.,wallstreetbets,JAGX,45,13,32,-19,7,7,3,3,NASDAQ
4749,13-02-2021 14:00,24 hrs.,wallstreetbets,JNCE,12,6,6,0,2,2,0,2,NASDAQ
4749,13-02-2021 14:00,24 hrs.,wallstreetbets,KOPN,15,0,15,-15,2,2,3,2,NASDAQ
4749,13-02-2021 14:00,24 hrs.,wallstreetbets,KOSS,180,0,180,-180,3,53,62,2,NASDAQ
4749,13-02-2021 14:00,24 hrs.,wallstreetbets,LAZR,8,0,8,-8,1,1,2,1,NASDAQ
4749,13-02-2021 14:00,24 hrs.,wallstreetbets,LEGN,7,0,7,-7,1,1,1,1,NASDAQ
4749,13-02-2021 14:00,24 hrs.,wallstreetbets,LGND,7,0,7,-7,1,1,1,1,NASDAQ
4749,13-02-2021 14:00,24 hrs.,wallstreetbets,LIFE,27,20,7,13,4,4,3,4,NASDAQ
4749,13-02-2021 14:00,24 hrs.,wallstreetbets,LKCO,42,0,42,-42,6,6,6,5,NASDAQ
4749,13-02-2021 14:00,24 hrs.,wallstreetbets,LLIT,7,0,7,-7,1,1,1,1,NASDAQ
4749,13-02-2021 14:00,24 hrs.,wallstreetbets,LLNW,13,0,13,-13,2,2,1,2,NASDAQ
4749,13-02-2021 14:00,24 hrs.,wallstreetbets,LOAN,14,0,14,-14,2,2,2,2,NASDAQ
4749,13-02-2021 14:00,24 hrs.,wallstreetbets,LPCN,7,0,7,-7,1,1,1,1,NASDAQ
4749,13-02-2021 14:00,24 hrs.,wallstreetbets,LRCX,523,0,523,-523,1,140,239,1,NASDAQ
4749,13-02-2021 14:00,24 hrs.,wallstreetbets,LXRX,7,7,0,7,1,1,1,1,NASDAQ
4749,13-02-2021 14:00,24 hrs.,wallstreetbets,MARA,21,7,14,-7,3,3,3,3,NASDAQ
4749,13-02-2021 14:00,24 hrs.,wallstreetbets,MARK,7,0,7,-7,1,1,1,1,NASDAQ
4749,13-02-2021 14:00,24 hrs.,wallstreetbets,MBIO,6,0,6,-6,1,1,0,1,NASDAQ
4749,13-02-2021 14:00,24 hrs.,wallstreetbets,MBRX,26,0,26,-26,4,4,2,4,NASDAQ
4749,13-02-2021 14:00,24 hrs.,wallstreetbets,MESO,7,7,0,7,1,1,1,1,NASDAQ
4749,13-02-2021 14:00,24 hrs.,wallstreetbets,MGNI,14,0,14,-14,2,2,2,2,NASDAQ
4749,13-02-2021 14:00,24 hrs.,wallstreetbets,MOGO,7,7,0,7,1,1,1,1,NASDAQ
4749,13-02-2021 14:00,24 hrs.,wallstreetbets,MRKR,6,6,0,6,1,1,0,1,NASDAQ
4749,13-02-2021 14:00,24 hrs.,wallstreetbets,MRNA,6,0,6,-6,1,1,0,1,NASDAQ
4749,13-02-2021 14:00,24 hrs.,wallstreetbets,MRVL,7,0,7,-7,1,1,1,1,NASDAQ
4749,13-02-2021 14:00,24 hrs.,wallstreetbets,MSFT,9358,0,9358,-9358,1,4390,574,1,NASDAQ
4749,13-02-2021 14:00,24 hrs.,wallstreetbets,MSTR,13,0,13,-13,2,2,1,2,NASDAQ
4749,13-02-2021 14:00,24 hrs.,wallstreetbets,MTCH,7,0,7,-7,1,1,1,1,NASDAQ
4749,13-02-2021 14:00,24 hrs.,wallstreetbets,MVIS,493,0,493,-493,7,162,141,6,NASDAQ
4749,13-02-2021 14:00,24 hrs.,wallstreetbets,NAKD,119,36,83,-47,17,17,17,10,NASDAQ
4749,13-02-2021 14:00,24 hrs.,wallstreetbets,NBAC,14,0,14,-14,2,2,2,1,NASDAQ
4749,13-02-2021 14:00,24 hrs.,wallstreetbets,NCLH,28,0,28,-28,4,4,4,3,NASDAQ
4749,13-02-2021 14:00,24 hrs.,stocks,MINE,24,18,6,12,4,4,0,2,OTC
4749,13-02-2021 14:00,24 hrs.,stocks,MJNA,6,0,6,-6,1,1,0,1,OTC
4749,13-02-2021 14:00,24 hrs.,stocks,NTRR,6,0,6,-6,1,1,0,1,OTC
4749,13-02-2021 14:00,24 hrs.,stocks,OZSC,6,0,6,-6,1,1,0,1,OTC
4749,13-02-2021 14:00,24 hrs.,stocks,RSSV,17,0,17,-17,1,5,3,1,OTC
4749,13-02-2021 14:00,24 hrs.,stocks,SNYR,6,0,6,-6,1,1,0,1,OTC
4749,13-02-2021 14:00,24 hrs.,stocks,SOBR,6,6,0,6,1,1,0,1,OTC
4749,13-02-2021 14:00,24 hrs.,stocks,SSET,7,0,7,-7,1,1,1,1,OTC
4749,13-02-2021 14:00,24 hrs.,stocks,TMRC,6,0,6,-6,1,1,0,1,OTC
4749,13-02-2021 14:00,24 hrs.,stocks,XFLS,4,4,0,4,1,0,0,1,OTC
4749,13-02-2021 14:00,24 hrs.,stocks,BDRBF,6,0,6,-6,1,1,0,1,OTC
4749,13-02-2021 14:00,24 hrs.,stocks,DGTHF,6,0,6,-6,1,1,0,1,OTC
4749,13-02-2021 14:00,24 hrs.,stocks,EMHTF,6,0,6,-6,1,1,0,1,OTC
4749,13-02-2021 14:00,24 hrs.,stocks,HITIF,6,6,0,6,1,1,0,1,OTC
4749,13-02-2021 14:00,24 hrs.,stocks,HRSTW,6,0,6,-6,1,1,0,1,OTC
4749,13-02-2021 14:00,24 hrs.,stocks,ILIKF,6,0,6,-6,1,1,0,1,OTC
4749,13-02-2021 14:00,24 hrs.,stocks,MMEDF,12,0,12,-12,2,2,0,1,OTC
4749,13-02-2021 14:00,24 hrs.,stocks,NXTTF,6,0,6,-6,1,1,0,1,OTC
4749,13-02-2021 14:00,24 hrs.,wallstreetbets,NLOK,7,0,7,-7,1,1,1,1,NASDAQ
4749,13-02-2021 14:00,24 hrs.,wallstreetbets,NMRK,6,0,6,-6,1,1,0,1,NASDAQ
4749,13-02-2021 14:00,24 hrs.,wallstreetbets,NNDM,60,39,21,18,5,4,32,3,NASDAQ
4749,13-02-2021 14:00,24 hrs.,wallstreetbets,NOVN,29,8,21,-13,4,4,5,3,NASDAQ
4749,13-02-2021 14:00,24 hrs.,wallstreetbets,NUAN,686,0,686,-686,1,296,90,1,NASDAQ
4749,13-02-2021 14:00,24 hrs.,wallstreetbets,NVAX,13,7,6,1,2,2,1,2,NASDAQ
4749,13-02-2021 14:00,24 hrs.,wallstreetbets,NVDA,671,0,671,-671,3,144,371,3,NASDAQ
4749,13-02-2021 14:00,24 hrs.,wallstreetbets,NVIV,7,0,7,-7,1,1,1,1,NASDAQ
4749,13-02-2021 14:00,24 hrs.,wallstreetbets,OCGN,45,0,45,-45,7,7,3,6,NASDAQ
4749,13-02-2021 14:00,24 hrs.,wallstreetbets,ONTX,14,7,7,0,2,2,2,2,NASDAQ
4749,13-02-2021 14:00,24 hrs.,wallstreetbets,OPGN,7,0,7,-7,1,1,1,1,NASDAQ
4749,13-02-2021 14:00,24 hrs.,wallstreetbets,OPTT,6,0,6,-6,1,1,0,1,NASDAQ
4749,13-02-2021 14:00,24 hrs.,wallstreetbets,PENN,6150,0,6150,-6150,2,2895,352,2,NASDAQ
4749,13-02-2021 14:00,24 hrs.,wallstreetbets,PGNY,7,0,7,-7,1,1,1,1,NASDAQ
4749,13-02-2021 14:00,24 hrs.,wallstreetbets,PHUN,7,0,7,-7,1,1,1,1,NASDAQ
4749,13-02-2021 14:00,24 hrs.,wallstreetbets,PLAY,7,0,7,-7,1,1,1,1,NASDAQ
4749,13-02-2021 14:00,24 hrs.,wallstreetbets,PLUG,7,0,7,-7,1,1,1,1,NASDAQ
4749,13-02-2021 14:00,24 hrs.,wallstreetbets,PLYA,20,0,20,-20,3,3,2,2,NASDAQ
4749,13-02-2021 14:00,24 hrs.,wallstreetbets,POTX,7,0,7,-7,1,1,1,1,NASDAQ
4749,13-02-2021 14:00,24 hrs.,wallstreetbets,POWW,34,7,27,-20,5,5,4,5,NASDAQ
4749,13-02-2021 14:00,24 hrs.,wallstreetbets,PRCH,72,0,72,-72,3,14,32,1,NASDAQ
4749,13-02-2021 14:00,24 hrs.,wallstreetbets,PRPL,1056,0,1056,-1056,1,416,220,1,NASDAQ
4749,13-02-2021 14:00,24 hrs.,wallstreetbets,PSAC,7,0,7,-7,1,1,1,1,NASDAQ
4749,13-02-2021 14:00,24 hrs.,wallstreetbets,PSEC,6,0,6,-6,1,0,2,1,NASDAQ
4749,13-02-2021 14:00,24 hrs.,wallstreetbets,PTCT,7,0,7,-7,1,1,1,1,NASDAQ
4749,13-02-2021 14:00,24 hrs.,wallstreetbets,PTON,6150,7,6143,-6136,2,2895,352,2,NASDAQ
4749,13-02-2021 14:00,24 hrs.,wallstreetbets,QCOM,7,0,7,-7,1,1,1,1,NASDAQ
4749,13-02-2021 14:00,24 hrs.,wallstreetbets,QFIN,7,0,7,-7,1,1,1,1,NASDAQ
4749,13-02-2021 14:00,24 hrs.,wallstreetbets,QQQJ,22,0,22,-22,1,6,6,1,NASDAQ
4749,13-02-2021 14:00,24 hrs.,wallstreetbets,QUIK,7,0,7,-7,1,1,1,1,NASDAQ
4749,13-02-2021 14:00,24 hrs.,wallstreetbets,RAVE,14,0,14,-14,2,2,2,2,NASDAQ
4749,13-02-2021 14:00,24 hrs.,wallstreetbets,RDHL,13,0,13,-13,2,2,1,2,NASDAQ
4749,13-02-2021 14:00,24 hrs.,wallstreetbets,REAL,217,84,133,-49,4,39,123,4,NASDAQ
4749,13-02-2021 14:00,24 hrs.,wallstreetbets,REGI,7,7,0,7,1,1,1,1,NASDAQ
4749,13-02-2021 14:00,24 hrs.,wallstreetbets,REGN,28,14,14,0,4,4,4,2,NASDAQ
4749,13-02-2021 14:00,24 hrs.,wallstreetbets,RIDE,89,0,89,-89,13,13,11,10,NASDAQ
4749,13-02-2021 14:00,24 hrs.,wallstreetbets,RIOT,6234,14,6220,-6206,14,2907,364,11,NASDAQ
4749,13-02-2021 14:00,24 hrs.,wallstreetbets,RKDA,7,0,7,-7,1,1,1,1,NASDAQ
4749,13-02-2021 14:00,24 hrs.,wallstreetbets,ROKU,13,7,6,1,2,2,1,2,NASDAQ
4749,13-02-2021 14:00,24 hrs.,wallstreetbets,RWLK,21,0,21,-21,3,3,3,3,NASDAQ
4749,13-02-2021 14:00,24 hrs.,wallstreetbets,SAVA,7,0,7,-7,1,1,1,1,NASDAQ
4749,13-02-2021 14:00,24 hrs.,wallstreetbets,SAVE,7,0,7,-7,1,1,1,1,NASDAQ
4749,13-02-2021 14:00,24 hrs.,wallstreetbets,SEAC,7,0,7,-7,1,1,1,1,NASDAQ
4749,13-02-2021 14:00,24 hrs.,wallstreetbets,SEEL,7,0,7,-7,1,1,1,1,NASDAQ
4749,13-02-2021 14:00,24 hrs.,wallstreetbets,SHIP,131,14,117,-103,19,19,17,15,NASDAQ
4749,13-02-2021 14:00,24 hrs.,wallstreetbets,SIRI,7,0,7,-7,1,1,1,1,NASDAQ
4749,13-02-2021 14:00,24 hrs.,stocks,LOW,14,14,0,14,1,1,8,1,NYSE
4749,13-02-2021 14:00,24 hrs.,stocks,MGM,12,0,12,-12,1,1,6,1,NYSE
4749,13-02-2021 14:00,24 hrs.,stocks,NET,25,14,11,3,2,2,13,2,NYSE
4749,13-02-2021 14:00,24 hrs.,stocks,NGL,6,6,0,6,1,1,0,1,NYSE
4749,13-02-2021 14:00,24 hrs.,stocks,NIO,890,19,871,-852,10,267,316,7,NYSE
4749,13-02-2021 14:00,24 hrs.,stocks,NOK,137,0,137,-137,3,21,83,3,NYSE
4749,13-02-2021 14:00,24 hrs.,stocks,NSA,167,167,0,167,1,72,19,1,NYSE
4749,13-02-2021 14:00,24 hrs.,stocks,OSK,16,0,16,-16,2,1,6,1,NYSE
4749,13-02-2021 14:00,24 hrs.,stocks,PEG,603,0,603,-603,1,42,515,1,NYSE
4749,13-02-2021 14:00,24 hrs.,stocks,PFE,7,0,7,-7,1,1,1,1,NYSE
4749,13-02-2021 14:00,24 hrs.,stocks,RAD,24,0,24,-24,1,7,6,1,NYSE
4749,13-02-2021 14:00,24 hrs.,stocks,RDY,6,0,6,-6,1,1,0,1,NYSE
4749,13-02-2021 14:00,24 hrs.,stocks,RTX,42,0,42,-42,1,12,14,1,NYSE
4749,13-02-2021 14:00,24 hrs.,stocks,SOS,6,0,6,-6,1,1,0,1,NYSE
4749,13-02-2021 14:00,24 hrs.,stocks,SQZ,7,7,0,7,1,1,1,1,NYSE
4749,13-02-2021 14:00,24 hrs.,stocks,SUP,6,0,6,-6,1,1,0,1,NYSE
4749,13-02-2021 14:00,24 hrs.,stocks,TDA,8,8,0,8,1,1,2,1,NYSE
4749,13-02-2021 14:00,24 hrs.,stocks,TSM,54,0,54,-54,1,9,32,1,NYSE
4749,13-02-2021 14:00,24 hrs.,stocks,UBS,35754,0,35754,-35754,1,17483,784,1,NYSE
4749,13-02-2021 14:00,24 hrs.,stocks,WMT,145,0,145,-145,1,44,53,1,NYSE
4749,13-02-2021 14:00,24 hrs.,stocks,AJRD,145,0,145,-145,1,44,53,1,NYSE
4749,13-02-2021 14:00,24 hrs.,stocks,APTV,145,0,145,-145,1,44,53,1,NYSE
4749,13-02-2021 14:00,24 hrs.,stocks,BABA,6,6,0,6,1,1,0,1,NYSE
4749,13-02-2021 14:00,24 hrs.,wallstreetbets,SNDL,2327,156,2171,-2015,184,524,543,152,NASDAQ
4749,13-02-2021 14:00,24 hrs.,wallstreetbets,SNGX,40,13,27,-14,6,6,4,5,NASDAQ
4749,13-02-2021 14:00,24 hrs.,wallstreetbets,SQQQ,7,0,7,-7,1,1,1,1,NASDAQ
4749,13-02-2021 14:00,24 hrs.,wallstreetbets,SRAC,13,7,6,1,2,2,1,2,NASDAQ
4749,13-02-2021 14:00,24 hrs.,wallstreetbets,SRGA,7,0,7,-7,1,1,1,1,NASDAQ
4749,13-02-2021 14:00,24 hrs.,wallstreetbets,SRNE,14,0,14,-14,2,2,2,2,NASDAQ
4749,13-02-2021 14:00,24 hrs.,wallstreetbets,SSRM,6,6,0,6,1,1,0,1,NASDAQ
4749,13-02-2021 14:00,24 hrs.,wallstreetbets,STAF,20,6,14,-8,3,3,2,3,NASDAQ
4749,13-02-2021 14:00,24 hrs.,wallstreetbets,STAY,12,6,6,0,2,2,0,2,NASDAQ
4749,13-02-2021 14:00,24 hrs.,wallstreetbets,STEP,16,0,16,-16,1,0,12,1,NASDAQ
4749,13-02-2021 14:00,24 hrs.,wallstreetbets,STLD,7,0,7,-7,1,1,1,1,NASDAQ
4749,13-02-2021 14:00,24 hrs.,wallstreetbets,SWBI,28,0,28,-28,4,4,4,3,NASDAQ
4749,13-02-2021 14:00,24 hrs.,wallstreetbets,SWKS,523,0,523,-523,1,140,239,1,NASDAQ
4749,13-02-2021 14:00,24 hrs.,wallstreetbets,TECH,7,7,0,7,1,1,1,1,NASDAQ
4749,13-02-2021 14:00,24 hrs.,SPACs,SRAC,133,0,133,-133,2,45,35,2,NASDAQ
4749,13-02-2021 14:00,24 hrs.,SPACs,SSPK,34,34,0,34,1,8,14,1,NASDAQ
4749,13-02-2021 14:00,24 hrs.,SPACs,THBR,359,359,0,359,1,29,297,1,NASDAQ
4749,13-02-2021 14:00,24 hrs.,SPACs,THCB,399,393,6,387,3,38,311,3,NASDAQ
4749,13-02-2021 14:00,24 hrs.,SPACs,VTIQ,34,34,0,34,1,8,14,1,NASDAQ
4749,13-02-2021 14:00,24 hrs.,SPACs,CMLFW,359,359,0,359,1,29,297,1,NASDAQ
4749,13-02-2021 14:00,24 hrs.,SPACs,DSACW,359,359,0,359,1,29,297,1,NASDAQ
4749,13-02-2021 14:00,24 hrs.,SPACs,EXPCW,359,359,0,359,1,29,297,1,NASDAQ
4749,13-02-2021 14:00,24 hrs.,SPACs,FCACW,359,359,0,359,1,29,297,1,NASDAQ
4749,13-02-2021 14:00,24 hrs.,SPACs,NBACR,5,0,5,-5,1,0,1,1,NASDAQ
4749,13-02-2021 14:00,24 hrs.,SPACs,NBACW,5,0,5,-5,1,0,1,1,NASDAQ
4749,13-02-2021 14:00,24 hrs.,SPACs,SAIIW,359,359,0,359,1,29,297,1,NASDAQ
4749,13-02-2021 14:00,24 hrs.,SPACs,TWCTW,359,359,0,359,1,29,297,1,NASDAQ
4749,13-02-2021 14:00,24 hrs.,stocks,ABML,20,14,6,8,2,2,8,2,OTC
4749,13-02-2021 14:00,24 hrs.,stocks,BLSP,6,0,6,-6,1,1,0,1,OTC
4749,13-02-2021 14:00,24 hrs.,stocks,BONZ,6,0,6,-6,1,1,0,1,OTC
4749,13-02-2021 14:00,24 hrs.,stocks,CANN,6,0,6,-6,1,1,0,1,OTC
4749,13-02-2021 14:00,24 hrs.,stocks,CAPC,6,0,6,-6,1,1,0,1,OTC
4749,13-02-2021 14:00,24 hrs.,stocks,ETCG,6,0,6,-6,1,1,0,1,OTC
4749,13-02-2021 14:00,24 hrs.,stocks,FRCH,14,0,14,-14,1,5,0,1,OTC
4749,13-02-2021 14:00,24 hrs.,stocks,GRYN,6,0,6,-6,1,1,0,1,OTC
4749,13-02-2021 14:00,24 hrs.,stocks,GTEH,6,0,6,-6,1,1,0,1,OTC
4749,13-02-2021 14:00,24 hrs.,stocks,HCMC,22,0,22,-22,2,2,10,2,OTC
4749,13-02-2021 14:00,24 hrs.,stocks,HEMP,34,34,0,34,1,7,16,1,OTC
4749,13-02-2021 14:00,24 hrs.,stocks,IGEN,6,0,6,-6,1,1,0,1,OTC
4749,13-02-2021 14:00,24 hrs.,stocks,IJJP,6,6,0,6,1,1,0,1,OTC
4749,13-02-2021 14:00,24 hrs.,stocks,MCAP,6,0,6,-6,1,1,0,1,OTC
4749,13-02-2021 14:00,24 hrs.,wallstreetbets,VUZI,21,0,21,-21,3,3,3,1,NASDAQ
4749,13-02-2021 14:00,24 hrs.,wallstreetbets,VXRT,35,14,21,-7,5,5,5,4,NASDAQ
4749,13-02-2021 14:00,24 hrs.,wallstreetbets,WATT,14,7,7,0,2,2,2,2,NASDAQ
4749,13-02-2021 14:00,24 hrs.,wallstreetbets,WKHS,8366,20,8346,-8326,5,3828,690,4,NASDAQ
4749,13-02-2021 14:00,24 hrs.,wallstreetbets,WRAP,7,0,7,-7,1,1,1,1,NASDAQ
4749,13-02-2021 14:00,24 hrs.,wallstreetbets,WSBC,8,8,0,8,1,1,2,1,NASDAQ
4749,13-02-2021 14:00,24 hrs.,wallstreetbets,XENE,14,0,14,-14,2,2,2,1,NASDAQ
4749,13-02-2021 14:00,24 hrs.,wallstreetbets,XERS,7,0,7,-7,1,1,1,1,NASDAQ
4749,13-02-2021 14:00,24 hrs.,wallstreetbets,XNET,14,0,14,-14,2,2,2,1,NASDAQ
4749,13-02-2021 14:00,24 hrs.,wallstreetbets,XSPA,44,6,38,-32,7,7,2,7,NASDAQ
4749,13-02-2021 14:00,24 hrs.,wallstreetbets,ZNGA,15,8,7,1,2,2,3,2,NASDAQ
4749,13-02-2021 14:00,24 hrs.,wallstreetbets,CMCSA,7,0,7,-7,1,1,1,1,NASDAQ
4749,13-02-2021 14:00,24 hrs.,wallstreetbets,GOOGL,6,0,6,-6,1,1,0,1,NASDAQ
4749,13-02-2021 14:00,24 hrs.,wallstreetbets,SRACU,6,0,6,-6,1,1,0,1,NASDAQ
4749,13-02-2021 14:00,24 hrs.,wallstreetbets,SRACW,6,0,6,-6,1,1,0,1,NASDAQ
4749,13-02-2021 14:00,24 hrs.,RobinHoodPennyStocks,BGMD,4,0,4,-4,1,0,0,1,OTC
4749,13-02-2021 14:00,24 hrs.,RobinHoodPennyStocks,BLXX,6,0,6,-6,1,1,0,1,OTC
4749,13-02-2021 14:00,24 hrs.,RobinHoodPennyStocks,CBDD,6,0,6,-6,1,1,0,1,OTC
4749,13-02-2021 14:00,24 hrs.,RobinHoodPennyStocks,CRWG,6,6,0,6,1,1,0,1,OTC
4749,13-02-2021 14:00,24 hrs.,RobinHoodPennyStocks,GLEC,6,0,6,-6,1,1,0,1,OTC
4749,13-02-2021 14:00,24 hrs.,RobinHoodPennyStocks,GPFT,18,0,18,-18,3,3,0,2,OTC
4749,13-02-2021 14:00,24 hrs.,RobinHoodPennyStocks,GSPH,6,0,6,-6,1,1,0,1,OTC
4749,13-02-2021 14:00,24 hrs.,RobinHoodPennyStocks,GTLL,6,6,0,6,1,1,0,1,OTC
4749,13-02-2021 14:00,24 hrs.,RobinHoodPennyStocks,HCMC,6,0,6,-6,1,1,0,1,OTC
4749,13-02-2021 14:00,24 hrs.,RobinHoodPennyStocks,INKW,6,0,6,-6,1,1,0,1,OTC
4749,13-02-2021 14:00,24 hrs.,RobinHoodPennyStocks,NUUU,6,0,6,-6,1,1,0,1,OTC
4749,13-02-2021 14:00,24 hrs.,RobinHoodPennyStocks,PHIL,6,0,6,-6,1,1,0,1,OTC
4749,13-02-2021 14:00,24 hrs.,RobinHoodPennyStocks,ALLIF,6,6,0,6,1,1,0,1,OTC
4749,13-02-2021 14:00,24 hrs.,RobinHoodPennyStocks,BDRBF,6,0,6,-6,1,1,0,1,OTC
4749,13-02-2021 14:00,24 hrs.,RobinHoodPennyStocks,MEDIF,6,6,0,6,1,1,0,1,OTC
4749,13-02-2021 14:00,24 hrs.,RobinHoodPennyStocks,MMEDF,21,21,0,21,1,6,5,1,OTC
4749,13-02-2021 14:00,24 hrs.,RobinHoodPennyStocks,NXTTF,6,0,6,-6,1,1,0,1,OTC
4749,13-02-2021 14:00,24 hrs.,RobinHoodPennyStocks,PMEDF,6,0,6,-6,1,1,0,1,OTC
4749,13-02-2021 14:00,24 hrs.,RobinHoodPennyStocks,RYCEY,18,0,18,-18,3,3,0,3,OTC
4749,13-02-2021 14:00,24 hrs.,RobinHoodPennyStocks,SHCAY,17,0,17,-17,1,6,1,1,OTC
4749,13-02-2021 14:00,24 hrs.,RobinHoodPennyStocks,ZBISF,6,0,6,-6,1,1,0,1,OTC
4749,13-02-2021 14:00,24 hrs.,RobinHoodPennyStocks,DNN,135,0,135,-135,4,48,23,4,AMEX
4749,13-02-2021 14:00,24 hrs.,stocks,OILFF,6,0,6,-6,1,1,0,1,OTC
4749,13-02-2021 14:00,24 hrs.,stocks,RHDGF,6,0,6,-6,1,1,0,1,OTC
4749,13-02-2021 14:00,24 hrs.,stocks,RHHBY,34,0,34,-34,1,11,8,1,OTC
4749,13-02-2021 14:00,24 hrs.,stocks,RLLCF,6,0,6,-6,1,1,0,1,OTC
4749,13-02-2021 14:00,24 hrs.,stocks,RVVTF,13,0,13,-13,2,2,1,2,OTC
4749,13-02-2021 14:00,24 hrs.,stocks,TBUIF,6,0,6,-6,1,1,0,1,OTC
4749,13-02-2021 14:00,24 hrs.,stocks,XJNGF,6,6,0,6,1,1,0,1,OTC
4749,13-02-2021 14:00,24 hrs.,stocks,DNN,31,0,31,-31,1,7,13,1,AMEX
4749,13-02-2021 14:00,24 hrs.,stocks,DSS,6,0,6,-6,1,1,0,1,AMEX
4749,13-02-2021 14:00,24 hrs.,stocks,GTE,13,0,13,-13,2,2,1,2,AMEX
4749,13-02-2021 14:00,24 hrs.,stocks,IGC,6,0,6,-6,1,1,0,1,AMEX
4749,13-02-2021 14:00,24 hrs.,stocks,PLX,13,0,13,-13,1,2,5,1,AMEX
4749,13-02-2021 14:00,24 hrs.,stocks,ZOM,12,6,6,0,2,2,0,2,AMEX
4749,13-02-2021 14:00,24 hrs.,stocks,GSAT,24,0,24,-24,4,4,0,2,AMEX
4749,13-02-2021 14:00,24 hrs.,stocks,SENS,23,23,0,23,3,2,7,2,AMEX
4749,13-02-2021 14:00,24 hrs.,stocks,ADT,6,0,6,-6,1,1,0,1,NYSE
4749,13-02-2021 14:00,24 hrs.,stocks,AMC,122,0,122,-122,5,24,54,5,NYSE
4749,13-02-2021 14:00,24 hrs.,stocks,ASX,13,6,7,-1,2,2,1,2,NYSE
4749,13-02-2021 14:00,24 hrs.,stocks,BEP,224,0,224,-224,5,53,98,5,NYSE
4749,13-02-2021 14:00,24 hrs.,stocks,CBD,6,0,6,-6,1,1,0,1,NYSE
4749,13-02-2021 14:00,24 hrs.,stocks,CVS,41,0,41,-41,3,9,11,3,NYSE
4749,13-02-2021 14:00,24 hrs.,stocks,DPG,12,0,12,-12,1,3,2,1,NYSE
4749,13-02-2021 14:00,24 hrs.,stocks,FSR,6,0,6,-6,1,1,0,1,NYSE
4749,13-02-2021 14:00,24 hrs.,stocks,GME,1416,0,1416,-1416,11,584,204,10,NYSE
4749,13-02-2021 14:00,24 hrs.,stocks,IBM,589,167,422,-255,2,260,61,2,NYSE
4749,13-02-2021 14:00,24 hrs.,stocks,IRS,20,14,6,8,2,2,8,2,NYSE
4749,13-02-2021 14:00,24 hrs.,stocks,JNJ,6,6,0,6,1,1,0,1,NYSE
4749,13-02-2021 14:00,24 hrs.,stocks,CCIV,18,12,6,6,3,3,0,3,NYSE
4749,13-02-2021 14:00,24 hrs.,stocks,CHWY,24,0,24,-24,1,5,10,1,NYSE
4749,13-02-2021 14:00,24 hrs.,stocks,COTY,6,0,6,-6,1,1,0,1,NYSE
4749,13-02-2021 14:00,24 hrs.,stocks,DASH,6,0,6,-6,1,1,0,1,NYSE
4749,13-02-2021 14:00,24 hrs.,stocks,FUSE,6,0,6,-6,1,1,0,1,NYSE
4749,13-02-2021 14:00,24 hrs.,stocks,HEXO,6,0,6,-6,1,1,0,1,NYSE
4749,13-02-2021 14:00,24 hrs.,stocks,HOME,24,0,24,-24,1,5,10,1,NYSE
4749,13-02-2021 14:00,24 hrs.,stocks,HUYA,6,0,6,-6,1,1,0,1,NYSE
4749,13-02-2021 14:00,24 hrs.,stocks,JMIA,6,0,6,-6,1,1,0,1,NYSE
4749,13-02-2021 14:00,24 hrs.,stocks,PLTR,651,19,632,-613,4,227,181,4,NYSE
4749,13-02-2021 14:00,24 hrs.,stocks,SHOP,74,0,74,-74,1,17,36,1,NYSE
4749,13-02-2021 14:00,24 hrs.,stocks,SPCE,211,34,177,-143,3,58,83,3,NYSE
4749,13-02-2021 14:00,24 hrs.,stocks,TWLO,16,0,16,-16,2,1,6,1,NYSE
4749,13-02-2021 14:00,24 hrs.,stocks,TWTR,6,0,6,-6,1,1,0,1,NYSE
4749,13-02-2021 14:00,24 hrs.,stocks,VGAC,6,0,6,-6,1,1,0,1,NYSE
4749,13-02-2021 14:00,24 hrs.,stocks,XPEV,85,0,85,-85,5,12,41,2,NYSE
4749,13-02-2021 14:00,24 hrs.,stocks,AMD,60,0,60,-60,2,10,32,2,NASDAQ
4749,13-02-2021 14:00,24 hrs.,stocks,FTC,33,0,33,-33,1,10,9,1,NASDAQ
4749,13-02-2021 14:00,24 hrs.,stocks,GAN,7,0,7,-7,1,1,1,1,NASDAQ
4749,13-02-2021 14:00,24 hrs.,stocks,GSM,71,0,71,-71,2,22,19,1,NASDAQ
4749,13-02-2021 14:00,24 hrs.,stocks,IEA,22,0,22,-22,1,6,6,1,NASDAQ
4749,13-02-2021 14:00,24 hrs.,stocks,INO,6,0,6,-6,1,1,0,1,NASDAQ
4749,13-02-2021 14:00,24 hrs.,stocks,NIU,34,34,0,34,1,7,16,1,NASDAQ
4749,13-02-2021 14:00,24 hrs.,stocks,OGI,12,0,12,-12,2,2,0,2,NASDAQ
4749,13-02-2021 14:00,24 hrs.,stocks,PEP,32,0,32,-32,1,7,14,1,NASDAQ
4749,13-02-2021 14:00,24 hrs.,stocks,SMH,31,0,31,-31,1,4,19,1,NASDAQ
4749,13-02-2021 14:00,24 hrs.,stocks,SPI,6,0,6,-6,1,1,0,1,NASDAQ
4749,13-02-2021 14:00,24 hrs.,stocks,VFF,6,6,0,6,1,1,0,1,NASDAQ
4749,13-02-2021 14:00,24 hrs.,stocks,WBA,24,0,24,-24,1,7,6,1,NASDAQ
4749,13-02-2021 14:00,24 hrs.,stocks,AESE,6,6,0,6,1,1,0,1,NASDAQ
4749,13-02-2021 14:00,24 hrs.,stocks,AEZS,215,0,215,-215,1,96,19,1,NASDAQ
4749,13-02-2021 14:00,24 hrs.,stocks,AGEN,10,0,10,-10,1,3,0,1,NASDAQ
4749,13-02-2021 14:00,24 hrs.,stocks,AGTC,12,0,12,-12,2,2,0,1,NASDAQ
4749,13-02-2021 14:00,24 hrs.,stocks,AMAT,14,14,0,14,1,1,8,1,NASDAQ
4749,13-02-2021 14:00,24 hrs.,RobinHoodPennyStocks,DPW,22,0,22,-22,1,4,10,1,AMEX
4749,13-02-2021 14:00,24 hrs.,RobinHoodPennyStocks,GSV,12,0,12,-12,2,2,0,2,AMEX
4749,13-02-2021 14:00,24 hrs.,RobinHoodPennyStocks,GTE,624,46,578,-532,13,176,220,13,AMEX
4749,13-02-2021 14:00,24 hrs.,wallstreetbets,TELL,7,0,7,-7,1,1,1,1,NASDAQ
4749,13-02-2021 14:00,24 hrs.,wallstreetbets,THCB,6,0,6,-6,1,1,0,1,NASDAQ
4749,13-02-2021 14:00,24 hrs.,wallstreetbets,THMO,13,0,13,-13,2,2,1,1,NASDAQ
4749,13-02-2021 14:00,24 hrs.,wallstreetbets,TLGT,7,0,7,-7,1,1,1,1,NASDAQ
4749,13-02-2021 14:00,24 hrs.,wallstreetbets,TLRY,1090,55,1035,-980,44,316,282,37,NASDAQ
4749,13-02-2021 14:00,24 hrs.,wallstreetbets,TLSA,7,0,7,-7,1,1,1,1,NASDAQ
4749,13-02-2021 14:00,24 hrs.,wallstreetbets,TNXP,70,7,63,-56,10,10,10,5,NASDAQ
4749,13-02-2021 14:00,24 hrs.,wallstreetbets,TOPS,100,14,86,-72,14,15,14,11,NASDAQ
4749,13-02-2021 14:00,24 hrs.,wallstreetbets,TOWN,167,0,167,-167,1,53,57,1,NASDAQ
4749,13-02-2021 14:00,24 hrs.,wallstreetbets,TQQQ,35,21,14,7,5,5,5,2,NASDAQ
4749,13-02-2021 14:00,24 hrs.,wallstreetbets,TRCH,26,12,14,-2,4,4,2,4,NASDAQ
4749,13-02-2021 14:00,24 hrs.,wallstreetbets,TRIT,52,13,39,-26,8,8,4,6,NASDAQ
4749,13-02-2021 14:00,24 hrs.,wallstreetbets,TRVG,2897,0,2897,-2897,30,1058,661,20,NASDAQ
4749,13-02-2021 14:00,24 hrs.,wallstreetbets,TSLA,9414,582,8832,-8250,22,4127,1072,18,NASDAQ
4749,13-02-2021 14:00,24 hrs.,wallstreetbets,TTCF,7,0,7,-7,1,1,1,1,NASDAQ
4749,13-02-2021 14:00,24 hrs.,wallstreetbets,TTOO,7,0,7,-7,1,1,1,1,NASDAQ
4749,13-02-2021 14:00,24 hrs.,wallstreetbets,TXMD,20,6,14,-8,3,3,2,3,NASDAQ
4749,13-02-2021 14:00,24 hrs.,wallstreetbets,UNFI,374,0,374,-374,1,171,28,1,NASDAQ
4749,13-02-2021 14:00,24 hrs.,wallstreetbets,VEON,6,0,6,-6,1,1,0,1,NASDAQ
4749,13-02-2021 14:00,24 hrs.,wallstreetbets,VERU,7,0,7,-7,1,1,1,1,NASDAQ
4749,13-02-2021 14:00,24 hrs.,wallstreetbets,VISL,7,7,0,7,1,1,1,1,NASDAQ
4749,13-02-2021 14:00,24 hrs.,wallstreetbets,VIVO,7,7,0,7,1,1,1,1,NASDAQ
4749,13-02-2021 14:00,24 hrs.,wallstreetbets,VKTX,7,0,7,-7,1,1,1,1,NASDAQ
4749,13-02-2021 14:00,24 hrs.,wallstreetbets,VLDR,7,0,7,-7,1,1,1,1,NASDAQ
4749,13-02-2021 14:00,24 hrs.,wallstreetbets,VOXX,6,0,6,-6,1,1,0,1,NASDAQ
4749,13-02-2021 14:00,24 hrs.,wallstreetbets,VSAT,14,0,14,-14,2,2,2,1,NASDAQ
4749,13-02-2021 14:00,24 hrs.,wallstreetbets,VTGN,7,0,7,-7,1,1,1,1,NASDAQ
4749,13-02-2021 14:00,24 hrs.,stocks,APHA,124,34,90,-56,4,19,70,4,NASDAQ
4749,13-02-2021 14:00,24 hrs.,stocks,ATOS,215,0,215,-215,1,96,19,1,NASDAQ
4749,13-02-2021 14:00,24 hrs.,stocks,AVGO,6,0,6,-6,1,1,0,1,NASDAQ
4749,13-02-2021 14:00,24 hrs.,stocks,BNGO,12,6,6,0,2,2,0,2,NASDAQ
4749,13-02-2021 14:00,24 hrs.,stocks,BYND,6,0,6,-6,1,1,0,1,NASDAQ
4749,13-02-2021 14:00,24 hrs.,stocks,CLVR,17,0,17,-17,1,3,7,1,NASDAQ
4749,13-02-2021 14:00,24 hrs.,stocks,CMPS,6,6,0,6,1,1,0,1,NASDAQ
4749,13-02-2021 14:00,24 hrs.,stocks,CPST,6,0,6,-6,1,1,0,1,NASDAQ
4749,13-02-2021 14:00,24 hrs.,stocks,CRBP,7,0,7,-7,1,1,1,1,NASDAQ
4749,13-02-2021 14:00,24 hrs.,stocks,CREG,6,6,0,6,1,1,0,1,NASDAQ
4749,13-02-2021 14:00,24 hrs.,stocks,CRNC,30,30,0,30,1,8,10,1,NASDAQ
4749,13-02-2021 14:00,24 hrs.,stocks,CRON,72,0,72,-72,1,19,30,1,NASDAQ
4749,13-02-2021 14:00,24 hrs.,stocks,CRSP,145,0,145,-145,1,44,53,1,NASDAQ
4749,13-02-2021 14:00,24 hrs.,stocks,CRWD,145,0,145,-145,1,44,53,1,NASDAQ
4749,13-02-2021 14:00,24 hrs.,stocks,CTRM,13,0,13,-13,2,2,1,2,NASDAQ
4749,13-02-2021 14:00,24 hrs.,stocks,DFFN,6,0,6,-6,1,1,0,1,NASDAQ
4749,13-02-2021 14:00,24 hrs.,stocks,EDIT,607,53,554,-501,5,197,193,5,NASDAQ
4749,13-02-2021 14:00,24 hrs.,stocks,ENPH,145,0,145,-145,1,44,53,1,NASDAQ
4749,13-02-2021 14:00,24 hrs.,stocks,EXPI,23,17,6,11,3,4,3,3,NASDAQ
4749,13-02-2021 14:00,24 hrs.,stocks,FNKO,26,0,26,-26,1,10,2,1,NASDAQ
4749,13-02-2021 14:00,24 hrs.,stocks,FROG,6,6,0,6,1,1,0,1,NASDAQ
4749,13-02-2021 14:00,24 hrs.,stocks,GILT,6,0,6,-6,1,1,0,1,NASDAQ
4749,13-02-2021 14:00,24 hrs.,stocks,GLUU,13,6,7,-1,2,2,1,2,NASDAQ
4749,13-02-2021 14:00,24 hrs.,stocks,GNOG,6,6,0,6,1,1,0,1,NASDAQ
4749,13-02-2021 14:00,24 hrs.,stocks,GOEV,124,0,124,-124,1,19,82,1,NASDAQ
4749,13-02-2021 14:00,24 hrs.,stocks,ICLN,100,0,100,-100,1,28,40,1,NASDAQ
4749,13-02-2021 14:00,24 hrs.,stocks,ILMN,26,0,26,-26,1,10,2,1,NASDAQ
4749,13-02-2021 14:00,24 hrs.,stocks,INTC,101,0,101,-101,1,31,35,1,NASDAQ
4749,13-02-2021 14:00,24 hrs.,stocks,INVE,7,0,7,-7,1,1,1,1,NASDAQ
4749,13-02-2021 14:00,24 hrs.,stocks,ITRM,15,6,9,-3,2,3,1,2,NASDAQ
4749,13-02-2021 14:00,24 hrs.,stocks,LKCO,12,0,12,-12,2,2,0,1,NASDAQ
4749,13-02-2021 14:00,24 hrs.,stocks,LLNW,30,0,30,-30,1,8,10,1,NASDAQ
4749,13-02-2021 14:00,24 hrs.,stocks,LMPX,26,0,26,-26,1,10,2,1,NASDAQ
4749,13-02-2021 14:00,24 hrs.,stocks,LRCX,54,0,54,-54,1,9,32,1,NASDAQ
4749,13-02-2021 14:00,24 hrs.,stocks,MITK,6,0,6,-6,1,1,0,1,NASDAQ
4749,13-02-2021 14:00,24 hrs.,stocks,MOGO,18,18,0,18,3,3,0,2,NASDAQ
4749,13-02-2021 14:00,24 hrs.,stocks,MRNA,6,0,6,-6,1,1,0,1,NASDAQ
4749,13-02-2021 14:00,24 hrs.,stocks,MSFT,422,0,422,-422,1,188,42,1,NASDAQ
4749,13-02-2021 14:00,24 hrs.,stocks,NBAC,6,0,6,-6,1,1,0,1,NASDAQ
4749,13-02-2021 14:00,24 hrs.,stocks,NCMI,66,0,66,-66,2,25,8,1,NASDAQ
4749,13-02-2021 14:00,24 hrs.,stocks,NKLA,6,0,6,-6,1,1,0,1,NASDAQ
4749,13-02-2021 14:00,24 hrs.,stocks,NMTR,9,0,9,-9,1,1,3,1,NASDAQ
4749,13-02-2021 14:00,24 hrs.,stocks,NVDA,103,0,103,-103,3,23,45,3,NASDAQ
4749,13-02-2021 14:00,24 hrs.,stocks,NXTD,6,6,0,6,1,1,0,1,NASDAQ
4749,13-02-2021 14:00,24 hrs.,stocks,OCGN,6,6,0,6,1,1,0,1,NASDAQ
4749,13-02-2021 14:00,24 hrs.,stocks,OCSL,12,0,12,-12,2,2,0,1,NASDAQ
4749,13-02-2021 14:00,24 hrs.,stocks,ONCR,7,7,0,7,1,1,1,1,NASDAQ
4749,13-02-2021 14:00,24 hrs.,stocks,ONTX,6,0,6,-6,1,1,0,1,NASDAQ
4749,13-02-2021 14:00,24 hrs.,stocks,ONVO,6,0,6,-6,1,1,0,1,NASDAQ
4749,13-02-2021 14:00,24 hrs.,stocks,PAAS,6,0,6,-6,1,1,0,1,NASDAQ
4749,13-02-2021 14:00,24 hrs.,stocks,PHUN,6,0,6,-6,1,1,0,1,NASDAQ
4749,13-02-2021 14:00,24 hrs.,stocks,PLUG,130,0,130,-130,2,20,82,2,NASDAQ
4749,13-02-2021 14:00,24 hrs.,stocks,QCLN,100,0,100,-100,1,28,40,1,NASDAQ
4749,13-02-2021 14:00,24 hrs.,stocks,QDEL,6,0,6,-6,1,1,0,1,NASDAQ
4749,13-02-2021 14:00,24 hrs.,RobinHoodPennyStocks,ITP,6,0,6,-6,1,1,0,1,AMEX
4749,13-02-2021 14:00,24 hrs.,RobinHoodPennyStocks,NAK,81,0,81,-81,5,15,31,5,AMEX
4749,13-02-2021 14:00,24 hrs.,RobinHoodPennyStocks,REI,24,0,24,-24,2,6,4,2,AMEX
4749,13-02-2021 14:00,24 hrs.,RobinHoodPennyStocks,SYN,6,0,6,-6,1,1,0,1,AMEX
4749,13-02-2021 14:00,24 hrs.,RobinHoodPennyStocks,XPL,6,0,6,-6,1,1,0,1,AMEX
4749,13-02-2021 14:00,24 hrs.,RobinHoodPennyStocks,ZOM,616,80,536,-456,8,196,192,8,AMEX
4749,13-02-2021 14:00,24 hrs.,RobinHoodPennyStocks,IBIO,35,0,35,-35,1,13,5,1,AMEX
4749,13-02-2021 14:00,24 hrs.,RobinHoodPennyStocks,NSPR,28,0,28,-28,1,7,10,1,AMEX
4749,13-02-2021 14:00,24 hrs.,stocks,BEPC,34,0,34,-34,2,3,20,2,NYSE
4749,13-02-2021 14:00,24 hrs.,stocks,BORR,48,0,48,-48,2,13,14,2,NYSE
4749,13-02-2021 14:00,24 hrs.,RobinHoodPennyStocks,TRXC,6,0,6,-6,1,1,0,1,AMEX
4749,13-02-2021 14:00,24 hrs.,RobinHoodPennyStocks,AIV,6,0,6,-6,1,1,0,1,NYSE
4749,13-02-2021 14:00,24 hrs.,RobinHoodPennyStocks,DNK,6,0,6,-6,1,1,0,1,NYSE
4749,13-02-2021 14:00,24 hrs.,RobinHoodPennyStocks,ETN,6,6,0,6,1,1,0,1,NYSE
4749,13-02-2021 14:00,24 hrs.,RobinHoodPennyStocks,FSR,6,0,6,-6,1,1,0,1,NYSE
4749,13-02-2021 14:00,24 hrs.,RobinHoodPennyStocks,GME,59,0,59,-59,2,14,23,2,NYSE
4749,13-02-2021 14:00,24 hrs.,RobinHoodPennyStocks,IRS,348,0,348,-348,1,158,28,1,NYSE
4749,13-02-2021 14:00,24 hrs.,RobinHoodPennyStocks,MRO,6,6,0,6,1,1,0,1,NYSE
4749,13-02-2021 14:00,24 hrs.,RobinHoodPennyStocks,MTL,19,0,19,-19,2,2,7,2,NYSE
4749,13-02-2021 14:00,24 hrs.,RobinHoodPennyStocks,NAT,6,0,6,-6,1,1,0,1,NYSE
4749,13-02-2021 14:00,24 hrs.,RobinHoodPennyStocks,NBB,6,0,6,-6,1,1,0,1,NYSE
4749,13-02-2021 14:00,24 hrs.,RobinHoodPennyStocks,PHI,6,0,6,-6,1,1,0,1,NYSE
4749,13-02-2021 14:00,24 hrs.,RobinHoodPennyStocks,SOS,48,0,48,-48,1,8,28,1,NYSE
4749,13-02-2021 14:00,24 hrs.,RobinHoodPennyStocks,PLTR,6,0,6,-6,1,1,0,1,NYSE
4749,13-02-2021 14:00,24 hrs.,RobinHoodPennyStocks,BBI,6,0,6,-6,1,1,0,1,NASDAQ
4749,13-02-2021 14:00,24 hrs.,RobinHoodPennyStocks,JFU,6,6,0,6,1,1,0,1,NASDAQ
4749,13-02-2021 14:00,24 hrs.,RobinHoodPennyStocks,SND,36,0,36,-36,4,8,4,2,NASDAQ
4749,13-02-2021 14:00,24 hrs.,RobinHoodPennyStocks,ABEO,192,0,192,-192,3,64,52,3,NASDAQ
4749,13-02-2021 14:00,24 hrs.,RobinHoodPennyStocks,ACRX,24,0,24,-24,1,8,4,1,NASDAQ
4749,13-02-2021 14:00,24 hrs.,RobinHoodPennyStocks,ADXS,18,0,18,-18,3,3,0,2,NASDAQ
4749,13-02-2021 14:00,24 hrs.,RobinHoodPennyStocks,AEZS,131,0,131,-131,1,52,23,1,NASDAQ
4749,13-02-2021 14:00,24 hrs.,RobinHoodPennyStocks,AGTC,612,74,538,-464,13,180,200,13,NASDAQ
4749,13-02-2021 14:00,24 hrs.,RobinHoodPennyStocks,APHA,6,0,6,-6,1,1,0,1,NASDAQ
4749,13-02-2021 14:00,24 hrs.,RobinHoodPennyStocks,ARTL,18,0,18,-18,3,3,0,3,NASDAQ
4749,13-02-2021 14:00,24 hrs.,RobinHoodPennyStocks,ASRT,87,0,87,-87,4,32,7,3,NASDAQ
4749,13-02-2021 14:00,24 hrs.,RobinHoodPennyStocks,ATOS,502,0,502,-502,9,187,92,9,NASDAQ
4749,13-02-2021 14:00,24 hrs.,RobinHoodPennyStocks,BHTG,67,0,67,-67,2,21,17,2,NASDAQ
4749,13-02-2021 14:00,24 hrs.,RobinHoodPennyStocks,BIOL,6,0,6,-6,1,1,0,1,NASDAQ
4749,13-02-2021 14:00,24 hrs.,RobinHoodPennyStocks,BNGO,46,6,40,-34,4,11,8,4,NASDAQ
4749,13-02-2021 14:00,24 hrs.,RobinHoodPennyStocks,BRQS,6,0,6,-6,1,1,0,1,NASDAQ
4749,13-02-2021 14:00,24 hrs.,RobinHoodPennyStocks,CDTX,6,0,6,-6,1,1,0,1,NASDAQ
4749,13-02-2021 14:00,24 hrs.,RobinHoodPennyStocks,CIDM,102,74,28,46,2,21,52,2,NASDAQ
4749,13-02-2021 14:00,24 hrs.,RobinHoodPennyStocks,CKPT,29,0,29,-29,1,10,5,1,NASDAQ
4749,13-02-2021 14:00,24 hrs.,RobinHoodPennyStocks,CLBS,30,6,24,-18,3,8,2,3,NASDAQ
4749,13-02-2021 14:00,24 hrs.,RobinHoodPennyStocks,CRBP,25,25,0,25,1,8,5,1,NASDAQ
4749,13-02-2021 14:00,24 hrs.,RobinHoodPennyStocks,CTRM,359,102,257,-155,8,71,185,8,NASDAQ
4749,13-02-2021 14:00,24 hrs.,RobinHoodPennyStocks,DFFN,957,45,912,-867,10,358,201,8,NASDAQ
4749,13-02-2021 14:00,24 hrs.,RobinHoodPennyStocks,ENTX,60,0,60,-60,1,23,10,1,NASDAQ
4749,13-02-2021 14:00,24 hrs.,RobinHoodPennyStocks,FCEL,51,0,51,-51,1,9,29,1,NASDAQ
4749,13-02-2021 14:00,24 hrs.,RobinHoodPennyStocks,GAIN,6,0,6,-6,1,1,0,1,NASDAQ
4749,13-02-2021 14:00,24 hrs.,RobinHoodPennyStocks,GLBS,6,0,6,-6,1,1,0,1,NASDAQ
4749,13-02-2021 14:00,24 hrs.,RobinHoodPennyStocks,IDEX,13,0,13,-13,1,2,5,1,NASDAQ
4749,13-02-2021 14:00,24 hrs.,RobinHoodPennyStocks,IMMR,15,0,15,-15,1,4,3,1,NASDAQ
4749,13-02-2021 14:00,24 hrs.,RobinHoodPennyStocks,INPX,12,12,0,12,2,2,0,1,NASDAQ
4749,13-02-2021 14:00,24 hrs.,RobinHoodPennyStocks,ITRM,6,0,6,-6,1,1,0,1,NASDAQ
4749,13-02-2021 14:00,24 hrs.,RobinHoodPennyStocks,KTRA,21,0,21,-21,1,6,5,1,NASDAQ
4749,13-02-2021 14:00,24 hrs.,RobinHoodPennyStocks,LKCO,106,0,106,-106,8,30,14,8,NASDAQ
4749,13-02-2021 14:00,24 hrs.,RobinHoodPennyStocks,MMLP,6,0,6,-6,1,1,0,1,NASDAQ
4749,13-02-2021 14:00,24 hrs.,RobinHoodPennyStocks,NAKD,109,103,6,97,2,41,19,2,NASDAQ
4749,13-02-2021 14:00,24 hrs.,RobinHoodPennyStocks,NMTR,158,0,158,-158,1,53,48,1,NASDAQ
4749,13-02-2021 14:00,24 hrs.,RobinHoodPennyStocks,NVCN,66,0,66,-66,2,17,24,2,NASDAQ
4749,13-02-2021 14:00,24 hrs.,RobinHoodPennyStocks,OPGN,24,0,24,-24,4,4,0,1,NASDAQ
4749,13-02-2021 14:00,24 hrs.,RobinHoodPennyStocks,OPTT,6,0,6,-6,1,1,0,1,NASDAQ
4749,13-02-2021 14:00,24 hrs.,RobinHoodPennyStocks,OVID,6,0,6,-6,1,1,0,1,NASDAQ
4749,13-02-2021 14:00,24 hrs.,RobinHoodPennyStocks,PHUN,6,0,6,-6,1,1,0,1,NASDAQ
4749,13-02-2021 14:00,24 hrs.,RobinHoodPennyStocks,PSEC,51,0,51,-51,3,11,17,2,NASDAQ
4749,13-02-2021 14:00,24 hrs.,RobinHoodPennyStocks,RIOT,9,0,9,-9,1,1,3,1,NASDAQ
4749,13-02-2021 14:00,24 hrs.,RobinHoodPennyStocks,SHIP,48,0,48,-48,8,8,0,5,NASDAQ
4749,13-02-2021 14:00,24 hrs.,RobinHoodPennyStocks,SNDL,245,12,233,-221,17,50,77,16,NASDAQ
4749,13-02-2021 14:00,24 hrs.,RobinHoodPennyStocks,SNGX,9,0,9,-9,1,0,5,1,NASDAQ
4749,13-02-2021 14:00,24 hrs.,RobinHoodPennyStocks,SONM,10,10,0,10,1,1,4,1,NASDAQ
4749,13-02-2021 14:00,24 hrs.,RobinHoodPennyStocks,SRAX,6,0,6,-6,1,1,0,1,NASDAQ
4749,13-02-2021 14:00,24 hrs.,stocks,AMZN,161,0,161,-161,2,46,61,2,NASDAQ
4749,13-02-2021 14:00,24 hrs.,stocks,ANTE,12,12,0,12,2,2,0,1,NASDAQ
4749,13-02-2021 14:00,24 hrs.,Daytrading,GTE,7,7,0,7,1,1,1,1,AMEX
4749,13-02-2021 14:00,24 hrs.,Daytrading,ACB,506,0,506,-506,2,210,78,2,NYSE
4749,13-02-2021 14:00,24 hrs.,Daytrading,ADX,9,0,9,-9,1,2,1,1,NYSE
4749,13-02-2021 14:00,24 hrs.,Daytrading,AMC,6,0,6,-6,1,1,0,1,NYSE
4749,13-02-2021 14:00,24 hrs.,Daytrading,FSR,500,0,500,-500,1,209,78,1,NYSE
4749,13-02-2021 14:00,24 hrs.,Daytrading,GME,273,0,273,-273,2,108,49,2,NYSE
4749,13-02-2021 14:00,24 hrs.,Daytrading,NIO,8,8,0,8,1,1,2,1,NYSE
4749,13-02-2021 14:00,24 hrs.,Daytrading,PDT,29,7,22,-15,2,4,13,2,NYSE
4749,13-02-2021 14:00,24 hrs.,Daytrading,RTP,500,0,500,-500,1,209,78,1,NYSE
4749,13-02-2021 14:00,24 hrs.,Daytrading,CCIV,500,0,500,-500,1,209,78,1,NYSE
4749,13-02-2021 14:00,24 hrs.,Daytrading,CHWY,6,0,6,-6,1,1,0,1,NYSE
4749,13-02-2021 14:00,24 hrs.,Daytrading,SPCE,500,0,500,-500,1,209,78,1,NYSE
4749,13-02-2021 14:00,24 hrs.,Daytrading,API,326,0,326,-326,1,141,40,1,NASDAQ
4749,13-02-2021 14:00,24 hrs.,Daytrading,INO,500,0,500,-500,1,209,78,1,NASDAQ
4749,13-02-2021 14:00,24 hrs.,Daytrading,AAPL,8,8,0,8,1,1,2,1,NASDAQ
4749,13-02-2021 14:00,24 hrs.,Daytrading,ACST,6,0,6,-6,1,1,0,1,NASDAQ
4749,13-02-2021 14:00,24 hrs.,Daytrading,APDN,500,0,500,-500,1,209,78,1,NASDAQ
4749,13-02-2021 14:00,24 hrs.,Daytrading,APHA,500,0,500,-500,1,209,78,1,NASDAQ
4749,13-02-2021 14:00,24 hrs.,Daytrading,ARTL,617,6,611,-605,7,247,95,7,NASDAQ
4749,13-02-2021 14:00,24 hrs.,Daytrading,BNGO,106,0,106,-106,1,40,22,1,NASDAQ
4749,13-02-2021 14:00,24 hrs.,Daytrading,CLEU,563,0,563,-563,2,234,87,2,NASDAQ
4749,13-02-2021 14:00,24 hrs.,Daytrading,CLGN,500,0,500,-500,1,209,78,1,NASDAQ
4749,13-02-2021 14:00,24 hrs.,Daytrading,CLSN,500,0,500,-500,1,209,78,1,NASDAQ
4749,13-02-2021 14:00,24 hrs.,Daytrading,CMLF,500,0,500,-500,1,209,78,1,NASDAQ
4749,13-02-2021 14:00,24 hrs.,Daytrading,CRSR,500,0,500,-500,1,209,78,1,NASDAQ
4749,13-02-2021 14:00,24 hrs.,Daytrading,EBON,6,0,6,-6,1,1,0,1,NASDAQ
4749,13-02-2021 14:00,24 hrs.,Daytrading,FOLD,506,0,506,-506,2,210,78,2,NASDAQ
4749,13-02-2021 14:00,24 hrs.,Daytrading,FTFT,500,0,500,-500,1,209,78,1,NASDAQ
4749,13-02-2021 14:00,24 hrs.,Daytrading,LIVE,137,0,137,-137,2,54,21,1,NASDAQ
4749,13-02-2021 14:00,24 hrs.,Daytrading,MARA,500,0,500,-500,1,209,78,1,NASDAQ
4749,13-02-2021 14:00,24 hrs.,Daytrading,NOVN,500,0,500,-500,1,209,78,1,NASDAQ
4749,13-02-2021 14:00,24 hrs.,Daytrading,OCGN,28,0,28,-28,1,4,16,1,NASDAQ
4749,13-02-2021 14:00,24 hrs.,Daytrading,PYPL,500,0,500,-500,1,209,78,1,NASDAQ
4749,13-02-2021 14:00,24 hrs.,Daytrading,RIDE,500,0,500,-500,1,209,78,1,NASDAQ
4749,13-02-2021 14:00,24 hrs.,Daytrading,RIOT,513,13,500,-487,2,212,81,2,NASDAQ
4749,13-02-2021 14:00,24 hrs.,Daytrading,SNDL,16,16,0,16,1,2,8,1,NASDAQ
4749,13-02-2021 14:00,24 hrs.,Daytrading,TLRY,507,7,500,-493,2,210,79,2,NASDAQ
4749,13-02-2021 14:00,24 hrs.,Daytrading,TSLA,11,11,0,11,1,1,5,1,NASDAQ
4749,13-02-2021 14:00,24 hrs.,Daytrading,WAFU,63,0,63,-63,1,25,9,1,NASDAQ
4749,13-02-2021 14:00,24 hrs.,Daytrading,XERS,500,0,500,-500,1,209,78,1,NASDAQ
4749,13-02-2021 14:00,24 hrs.,trakstocks,ALPP,6,0,6,-6,1,1,0,1,OTC
4749,13-02-2021 14:00,24 hrs.,trakstocks,BRTX,9,0,9,-9,1,2,1,1,OTC
4749,13-02-2021 14:00,24 hrs.,stocks,QFIN,6,0,6,-6,1,1,0,1,NASDAQ
4749,13-02-2021 14:00,24 hrs.,stocks,QQQJ,31,0,31,-31,1,4,19,1,NASDAQ
4749,13-02-2021 14:00,24 hrs.,stocks,QQQM,31,0,31,-31,1,4,19,1,NASDAQ
4749,13-02-2021 14:00,24 hrs.,stocks,RDFN,11,11,0,11,1,2,3,1,NASDAQ
4749,13-02-2021 14:00,24 hrs.,stocks,REGN,6,6,0,6,1,1,0,1,NASDAQ
4749,13-02-2021 14:00,24 hrs.,stocks,RRGB,28,28,0,28,1,6,12,1,NASDAQ
4749,13-02-2021 14:00,24 hrs.,stocks,SEDG,145,0,145,-145,1,44,53,1,NASDAQ
4749,13-02-2021 14:00,24 hrs.,stocks,SESN,7,0,7,-7,1,1,1,1,NASDAQ
4749,13-02-2021 14:00,24 hrs.,stocks,SHIP,11,0,11,-11,1,2,3,1,NASDAQ
4749,13-02-2021 14:00,24 hrs.,stocks,SNDL,24,0,24,-24,4,4,0,3,NASDAQ
4749,13-02-2021 14:00,24 hrs.,stocks,SNGX,25,0,25,-25,4,4,1,4,NASDAQ
4749,13-02-2021 14:00,24 hrs.,stocks,SRAC,6,0,6,-6,1,1,0,1,NASDAQ
4749,13-02-2021 14:00,24 hrs.,stocks,SRNE,145,0,145,-145,1,44,53,1,NASDAQ
4749,13-02-2021 14:00,24 hrs.,stocks,SWKS,54,0,54,-54,1,9,32,1,NASDAQ
4749,13-02-2021 14:00,24 hrs.,stocks,TFFP,19,19,0,19,2,3,5,1,NASDAQ
4749,13-02-2021 14:00,24 hrs.,RobinHoodPennyStocks,SRGA,6,0,6,-6,1,1,0,1,NASDAQ
4749,13-02-2021 14:00,24 hrs.,RobinHoodPennyStocks,TBLT,89,0,89,-89,1,29,27,1,NASDAQ
4749,13-02-2021 14:00,24 hrs.,RobinHoodPennyStocks,TRCH,94,0,94,-94,3,23,36,2,NASDAQ
4749,13-02-2021 14:00,24 hrs.,RobinHoodPennyStocks,TXMD,36,6,30,-24,6,6,0,6,NASDAQ
4749,13-02-2021 14:00,24 hrs.,RobinHoodPennyStocks,TYME,6,6,0,6,1,1,0,1,NASDAQ
4749,13-02-2021 14:00,24 hrs.,RobinHoodPennyStocks,OGEN,6,0,6,-6,1,1,0,1,AMEX
4749,13-02-2021 14:00,24 hrs.,RobinHoodPennyStocks,SENS,61,0,61,-61,3,22,5,3,AMEX
4749,13-02-2021 14:00,24 hrs.,StockMarket,MAXD,48,0,48,-48,3,13,10,3,OTC
4749,13-02-2021 14:00,24 hrs.,StockMarket,PCTL,6,0,6,-6,1,1,0,1,OTC
4749,13-02-2021 14:00,24 hrs.,StockMarket,PHIL,8,0,8,-8,1,2,0,1,OTC
4749,13-02-2021 14:00,24 hrs.,StockMarket,RSSV,25,0,25,-25,1,9,3,1,OTC
4749,13-02-2021 14:00,24 hrs.,StockMarket,SGMD,168,0,168,-168,6,43,58,2,OTC
4749,13-02-2021 14:00,24 hrs.,StockMarket,AYRWF,23,0,23,-23,1,7,5,1,OTC
4749,13-02-2021 14:00,24 hrs.,StockMarket,BMWLF,23,0,23,-23,1,7,5,1,OTC
4749,13-02-2021 14:00,24 hrs.,StockMarket,CRLBF,23,0,23,-23,1,7,5,1,OTC
4749,13-02-2021 14:00,24 hrs.,StockMarket,CURLF,23,0,23,-23,1,7,5,1,OTC
4749,13-02-2021 14:00,24 hrs.,StockMarket,DIGAF,6,0,6,-6,1,1,0,1,OTC
4749,13-02-2021 14:00,24 hrs.,StockMarket,GTBIF,23,0,23,-23,1,7,5,1,OTC
4749,13-02-2021 14:00,24 hrs.,StockMarket,HTZGQ,6,0,6,-6,1,1,0,1,OTC
4749,13-02-2021 14:00,24 hrs.,StockMarket,LHSIF,23,0,23,-23,1,7,5,1,OTC
4749,13-02-2021 14:00,24 hrs.,StockMarket,NMGRF,6,0,6,-6,1,1,0,1,OTC
4749,13-02-2021 14:00,24 hrs.,StockMarket,RAZFF,6,0,6,-6,1,1,0,1,OTC
4749,13-02-2021 14:00,24 hrs.,StockMarket,RHDGF,18,0,18,-18,2,3,4,1,OTC
4749,13-02-2021 14:00,24 hrs.,StockMarket,RWBYF,23,0,23,-23,1,7,5,1,OTC
4749,13-02-2021 14:00,24 hrs.,StockMarket,RYCEY,12,0,12,-12,2,2,0,2,OTC
4749,13-02-2021 14:00,24 hrs.,StockMarket,TCNNF,23,0,23,-23,1,7,5,1,OTC
4749,13-02-2021 14:00,24 hrs.,StockMarket,TFECY,18,0,18,-18,3,3,0,1,OTC
4749,13-02-2021 14:00,24 hrs.,StockMarket,XJNGF,12,12,0,12,1,3,2,1,OTC
4749,13-02-2021 14:00,24 hrs.,StockMarket,ZBISF,36,0,36,-36,1,12,8,1,OTC
4749,13-02-2021 14:00,24 hrs.,StockMarket,DNN,20,0,20,-20,2,5,2,2,AMEX
4749,13-02-2021 14:00,24 hrs.,StockMarket,DSS,6,0,6,-6,1,1,0,1,AMEX
4749,13-02-2021 14:00,24 hrs.,StockMarket,MXC,9,9,0,9,1,0,5,1,AMEX
4749,13-02-2021 14:00,24 hrs.,StockMarket,TRX,6,0,6,-6,1,1,0,1,AMEX
4749,13-02-2021 14:00,24 hrs.,StockMarket,ZOM,6,6,0,6,1,1,0,1,AMEX
4749,13-02-2021 14:00,24 hrs.,trakstocks,VRYYF,7,7,0,7,1,1,1,1,OTC
4749,13-02-2021 14:00,24 hrs.,trakstocks,DNN,81,0,81,-81,1,30,17,1,AMEX
4749,13-02-2021 14:00,24 hrs.,trakstocks,DPW,12,0,12,-12,2,2,0,2,AMEX
4749,13-02-2021 14:00,24 hrs.,trakstocks,HCMC,8,8,0,8,1,0,4,1,OTC
4749,13-02-2021 14:00,24 hrs.,trakstocks,INND,8,8,0,8,1,0,4,1,OTC
4749,13-02-2021 14:00,24 hrs.,trakstocks,MMEX,20,0,20,-20,2,3,6,2,OTC
4749,13-02-2021 14:00,24 hrs.,trakstocks,MOST,6,0,6,-6,1,1,0,1,OTC
4749,13-02-2021 14:00,24 hrs.,trakstocks,ARBKF,6,0,6,-6,1,1,0,1,OTC
4749,13-02-2021 14:00,24 hrs.,trakstocks,BBXIA,6,0,6,-6,1,1,0,1,OTC
4749,13-02-2021 14:00,24 hrs.,trakstocks,MGROF,14,0,14,-14,1,4,2,1,OTC
4749,13-02-2021 14:00,24 hrs.,trakstocks,NMGRF,50,0,50,-50,1,19,8,1,OTC
4749,13-02-2021 14:00,24 hrs.,trakstocks,NXTTF,12,0,12,-12,1,4,0,1,OTC
4749,13-02-2021 14:00,24 hrs.,trakstocks,PYRNF,16,0,16,-16,2,3,2,2,OTC
4749,13-02-2021 14:00,24 hrs.,RobinHoodPennyStocks,XSPA,23,0,23,-23,1,9,1,1,NASDAQ
4749,13-02-2021 14:00,24 hrs.,RobinHoodPennyStocks,ZSAN,6,0,6,-6,1,1,0,1,NASDAQ
4749,13-02-2021 14:00,24 hrs.,stocks,TIGR,6,0,6,-6,1,1,0,1,NASDAQ
4749,13-02-2021 14:00,24 hrs.,stocks,TLRY,6,6,0,6,1,1,0,1,NASDAQ
4749,13-02-2021 14:00,24 hrs.,stocks,TRCH,13,6,7,-1,2,2,1,2,NASDAQ
4749,13-02-2021 14:00,24 hrs.,stocks,TRVG,12,0,12,-12,2,2,0,2,NASDAQ
4749,13-02-2021 14:00,24 hrs.,stocks,TSLA,1340,28,1312,-1284,9,487,330,7,NASDAQ
4749,13-02-2021 14:00,24 hrs.,stocks,TTGT,6,0,6,-6,1,1,0,1,NASDAQ
4749,13-02-2021 14:00,24 hrs.,stocks,VRNT,14,0,14,-14,1,3,4,1,NASDAQ
4749,13-02-2021 14:00,24 hrs.,stocks,VUZI,6,0,6,-6,1,1,0,1,NASDAQ
4749,13-02-2021 14:00,24 hrs.,stocks,VXRT,6,0,6,-6,1,1,0,1,NASDAQ
4749,13-02-2021 14:00,24 hrs.,stocks,VXUS,29,0,29,-29,2,7,7,2,NASDAQ
4749,13-02-2021 14:00,24 hrs.,stocks,WDAY,14,0,14,-14,1,3,4,1,NASDAQ
4749,13-02-2021 14:00,24 hrs.,stocks,WISH,6,0,6,-6,1,1,0,1,NASDAQ
4749,13-02-2021 14:00,24 hrs.,stocks,XONE,12,12,0,12,1,3,2,1,NASDAQ
4749,13-02-2021 14:00,24 hrs.,stocks,ZGNX,6,0,6,-6,1,1,0,1,NASDAQ
4749,13-02-2021 14:00,24 hrs.,stocks,DISCA,12,0,12,-12,2,2,0,2,NASDAQ
4749,13-02-2021 14:00,24 hrs.,stocks,LILAK,12,12,0,12,2,2,0,1,NASDAQ
4749,13-02-2021 14:00,24 hrs.,stocks,SRACU,6,0,6,-6,1,1,0,1,NASDAQ
4749,13-02-2021 14:00,24 hrs.,stocks,SRACW,6,0,6,-6,1,1,0,1,NASDAQ
4749,13-02-2021 14:00,24 hrs.,Daytrading,SGMD,17,0,17,-17,1,3,7,1,OTC
4749,13-02-2021 14:00,24 hrs.,Daytrading,HVBTF,13,13,0,13,1,3,3,1,OTC
4749,13-02-2021 14:00,24 hrs.,Daytrading,DNN,500,0,500,-500,1,209,78,1,AMEX
4749,13-02-2021 14:00,24 hrs.,Daytrading,DSS,500,0,500,-500,1,209,78,1,AMEX
4749,13-02-2021 14:00,24 hrs.,StockMarket,IDEX,6,0,6,-6,1,1,0,1,NASDAQ
4749,13-02-2021 14:00,24 hrs.,StockMarket,INPX,6,0,6,-6,1,1,0,1,NASDAQ
4749,13-02-2021 14:00,24 hrs.,StockMarket,MSFT,23,0,23,-23,1,3,13,1,NASDAQ
4749,13-02-2021 14:00,24 hrs.,StockMarket,MTCH,7,0,7,-7,1,0,3,1,NASDAQ
4749,13-02-2021 14:00,24 hrs.,StockMarket,OCGN,26,0,26,-26,3,2,10,3,NASDAQ
4749,13-02-2021 14:00,24 hrs.,StockMarket,GSAT,114,0,114,-114,5,30,34,2,AMEX
4749,13-02-2021 14:00,24 hrs.,StockMarket,LODE,6,0,6,-6,1,1,0,1,AMEX
4749,13-02-2021 14:00,24 hrs.,StockMarket,NSPR,6,0,6,-6,1,1,0,1,AMEX
4749,13-02-2021 14:00,24 hrs.,StockMarket,UAVS,10,0,10,-10,1,1,4,1,AMEX
4749,13-02-2021 14:00,24 hrs.,StockMarket,ACB,58,0,58,-58,1,26,2,1,NYSE
4749,13-02-2021 14:00,24 hrs.,StockMarket,AFC,6,0,6,-6,1,1,0,1,NYSE
4749,13-02-2021 14:00,24 hrs.,StockMarket,AGX,6,0,6,-6,1,1,0,1,NYSE
4749,13-02-2021 14:00,24 hrs.,StockMarket,AMC,36,0,36,-36,3,1,22,3,NYSE
4749,13-02-2021 14:00,24 hrs.,StockMarket,ASX,9,9,0,9,1,0,5,1,NYSE
4749,13-02-2021 14:00,24 hrs.,StockMarket,DIS,58,0,58,-58,1,26,2,1,NYSE
4749,13-02-2021 14:00,24 hrs.,StockMarket,FIX,4,4,0,4,1,0,0,1,NYSE
4749,13-02-2021 14:00,24 hrs.,StockMarket,GME,76,34,42,-8,5,10,36,5,NYSE
4749,13-02-2021 14:00,24 hrs.,StockMarket,IBM,58,0,58,-58,1,26,2,1,NYSE
4749,13-02-2021 14:00,24 hrs.,StockMarket,JNJ,6,0,6,-6,1,1,0,1,NYSE
4749,13-02-2021 14:00,24 hrs.,StockMarket,JPM,22,22,0,22,1,3,12,1,NYSE
4749,13-02-2021 14:00,24 hrs.,StockMarket,LLY,58,0,58,-58,1,26,2,1,NYSE
4749,13-02-2021 14:00,24 hrs.,StockMarket,NIO,269,0,269,-269,3,98,61,3,NYSE
4749,13-02-2021 14:00,24 hrs.,StockMarket,PHI,8,0,8,-8,1,2,0,1,NYSE
4749,13-02-2021 14:00,24 hrs.,StockMarket,PMO,6,6,0,6,1,1,0,1,NYSE
4749,13-02-2021 14:00,24 hrs.,StockMarket,PSA,6,0,6,-6,1,1,0,1,NYSE
4749,13-02-2021 14:00,24 hrs.,StockMarket,SBE,6,0,6,-6,1,1,0,1,NYSE
4749,13-02-2021 14:00,24 hrs.,StockMarket,SMG,23,0,23,-23,1,7,5,1,NYSE
4749,13-02-2021 14:00,24 hrs.,trakstocks,TRXC,183,0,183,-183,1,66,47,1,AMEX
4749,13-02-2021 14:00,24 hrs.,trakstocks,AMC,25,0,25,-25,1,2,17,1,NYSE
4749,13-02-2021 14:00,24 hrs.,trakstocks,BFT,6,0,6,-6,1,1,0,1,NYSE
4749,13-02-2021 14:00,24 hrs.,trakstocks,GME,25,0,25,-25,1,2,17,1,NYSE
4749,13-02-2021 14:00,24 hrs.,trakstocks,NAT,9,9,0,9,1,2,1,1,NYSE
4749,13-02-2021 14:00,24 hrs.,trakstocks,SOL,8,0,8,-8,1,2,0,1,NYSE
4749,13-02-2021 14:00,24 hrs.,trakstocks,SOS,23,0,23,-23,1,9,1,1,NYSE
4749,13-02-2021 14:00,24 hrs.,trakstocks,SWN,9,9,0,9,1,2,1,1,NYSE
4749,13-02-2021 14:00,24 hrs.,trakstocks,ARGO,6,0,6,-6,1,1,0,1,NYSE
4749,13-02-2021 14:00,24 hrs.,trakstocks,PLTR,22,22,0,22,1,7,4,1,NYSE
4749,13-02-2021 14:00,24 hrs.,trakstocks,STPK,91,22,69,-47,4,27,21,3,NYSE
4749,13-02-2021 14:00,24 hrs.,trakstocks,AQB,13,0,13,-13,1,3,3,1,NASDAQ
4749,13-02-2021 14:00,24 hrs.,trakstocks,OEG,29,0,29,-29,1,10,5,1,NASDAQ
4749,13-02-2021 14:00,24 hrs.,trakstocks,APPS,6,0,6,-6,1,1,0,1,NASDAQ
4749,13-02-2021 14:00,24 hrs.,trakstocks,AYRO,156,14,142,-128,3,52,40,3,NASDAQ
4749,13-02-2021 14:00,24 hrs.,trakstocks,BHTG,440,0,440,-440,1,163,110,1,NASDAQ
4749,13-02-2021 14:00,24 hrs.,trakstocks,CFII,91,0,91,-91,1,32,23,1,NASDAQ
4749,13-02-2021 14:00,24 hrs.,trakstocks,CLVS,16,16,0,16,2,2,4,2,NASDAQ
4749,13-02-2021 14:00,24 hrs.,trakstocks,CPSH,48,0,48,-48,2,14,12,2,NASDAQ
4749,13-02-2021 14:00,24 hrs.,trakstocks,EXPC,12,0,12,-12,1,3,2,1,NASDAQ
4749,13-02-2021 14:00,24 hrs.,trakstocks,GTHX,6,0,6,-6,1,1,0,1,NASDAQ
4749,13-02-2021 14:00,24 hrs.,trakstocks,IMMR,50,0,50,-50,1,18,10,1,NASDAQ
4749,13-02-2021 14:00,24 hrs.,trakstocks,LIFE,12,0,12,-12,1,0,8,1,NASDAQ
4749,13-02-2021 14:00,24 hrs.,trakstocks,MARA,43,0,43,-43,1,17,5,1,NASDAQ
4749,13-02-2021 14:00,24 hrs.,trakstocks,OPRX,12,0,12,-12,1,3,2,1,NASDAQ
4749,13-02-2021 14:00,24 hrs.,trakstocks,RIOT,53,0,53,-53,2,18,9,2,NASDAQ
4749,13-02-2021 14:00,24 hrs.,trakstocks,SNDL,22,22,0,22,1,7,4,1,NASDAQ
4749,13-02-2021 14:00,24 hrs.,trakstocks,TLRY,22,22,0,22,1,7,4,1,NASDAQ
4749,13-02-2021 14:00,24 hrs.,trakstocks,TRIT,61,61,0,61,1,22,13,1,NASDAQ
4749,13-02-2021 14:00,24 hrs.,trakstocks,TTCF,29,17,12,5,2,5,11,2,NASDAQ
4749,13-02-2021 14:00,24 hrs.,StockMarket,ABML,6,0,6,-6,1,1,0,1,OTC
4749,13-02-2021 14:00,24 hrs.,StockMarket,BOTH,9,9,0,9,1,0,5,1,OTC
4749,13-02-2021 14:00,24 hrs.,StockMarket,BOTY,19,7,12,-5,2,5,1,2,OTC
4749,13-02-2021 14:00,24 hrs.,StockMarket,GTEH,6,0,6,-6,1,1,0,1,OTC
4749,13-02-2021 14:00,24 hrs.,StockMarket,HEMP,6,0,6,-6,1,1,0,1,OTC
4749,13-02-2021 14:00,24 hrs.,StockMarket,KGET,6,0,6,-6,1,1,0,1,OTC
4749,13-02-2021 14:00,24 hrs.,StockMarket,KWBT,6,0,6,-6,1,1,0,1,OTC
4749,13-02-2021 14:00,24 hrs.,StockMarket,SRACW,8,0,8,-8,1,0,4,1,NASDAQ
4749,13-02-2021 14:00,24 hrs.,pennystocks,ABML,175,44,131,-87,3,57,49,3,OTC
4749,13-02-2021 14:00,24 hrs.,pennystocks,ADTM,13,0,13,-13,2,2,1,1,OTC
4749,13-02-2021 14:00,24 hrs.,pennystocks,AFPW,6,0,6,-6,1,1,0,1,OTC
4749,13-02-2021 14:00,24 hrs.,pennystocks,AITX,330,0,330,-330,3,119,80,3,OTC
4749,13-02-2021 14:00,24 hrs.,pennystocks,ALKM,7,0,7,-7,1,1,1,1,OTC
4749,13-02-2021 14:00,24 hrs.,pennystocks,ALPP,385,0,385,-385,6,128,105,5,OTC
4749,13-02-2021 14:00,24 hrs.,pennystocks,ALST,28,0,28,-28,2,4,12,1,OTC
4749,13-02-2021 14:00,24 hrs.,pennystocks,ALYI,42,0,42,-42,3,11,8,3,OTC
4749,13-02-2021 14:00,24 hrs.,pennystocks,ASCK,6,0,6,-6,1,1,0,1,OTC
4749,13-02-2021 14:00,24 hrs.,pennystocks,ASTI,18,0,18,-18,3,3,0,3,OTC
4749,13-02-2021 14:00,24 hrs.,pennystocks,ATDS,6,0,6,-6,1,1,0,1,OTC
4749,13-02-2021 14:00,24 hrs.,pennystocks,ATNP,31,0,31,-31,1,5,17,1,OTC
4749,13-02-2021 14:00,24 hrs.,pennystocks,AXXA,27,0,27,-27,1,9,5,1,OTC
4749,13-02-2021 14:00,24 hrs.,pennystocks,BANT,6,0,6,-6,1,1,0,1,OTC
4749,13-02-2021 14:00,24 hrs.,pennystocks,BBRW,160,0,160,-160,4,33,78,4,OTC
4749,13-02-2021 14:00,24 hrs.,StockMarket,SOS,12,6,6,0,2,2,0,2,NYSE
4749,13-02-2021 14:00,24 hrs.,StockMarket,TDA,13,0,13,-13,1,1,7,1,NYSE
4749,13-02-2021 14:00,24 hrs.,StockMarket,VRT,12,12,0,12,1,3,2,1,NYSE
4749,13-02-2021 14:00,24 hrs.,StockMarket,XPO,58,0,58,-58,1,26,2,1,NYSE
4749,13-02-2021 14:00,24 hrs.,StockMarket,CCIV,44,6,38,-32,3,12,8,2,NYSE
4749,13-02-2021 14:00,24 hrs.,StockMarket,CHWY,6,0,6,-6,1,1,0,1,NYSE
4749,13-02-2021 14:00,24 hrs.,StockMarket,COTY,17,0,17,-17,2,2,5,1,NYSE
4749,13-02-2021 14:00,24 hrs.,StockMarket,DSSI,6,0,6,-6,1,1,0,1,NYSE
4749,13-02-2021 14:00,24 hrs.,StockMarket,FUSE,6,0,6,-6,1,1,0,1,NYSE
4749,13-02-2021 14:00,24 hrs.,StockMarket,GDDY,58,0,58,-58,1,26,2,1,NYSE
4749,13-02-2021 14:00,24 hrs.,StockMarket,GNRC,58,0,58,-58,1,26,2,1,NYSE
4749,13-02-2021 14:00,24 hrs.,StockMarket,HEXO,7,0,7,-7,1,1,1,1,NYSE
4749,13-02-2021 14:00,24 hrs.,StockMarket,LAIX,14,0,14,-14,1,0,10,1,NYSE
4749,13-02-2021 14:00,24 hrs.,StockMarket,PINS,23,0,23,-23,1,3,13,1,NYSE
4749,13-02-2021 14:00,24 hrs.,StockMarket,PLTR,58,0,58,-58,1,26,2,1,NYSE
4749,13-02-2021 14:00,24 hrs.,StockMarket,PUMP,6,6,0,6,1,1,0,1,NYSE
4749,13-02-2021 14:00,24 hrs.,StockMarket,UBER,58,0,58,-58,1,26,2,1,NYSE
4749,13-02-2021 14:00,24 hrs.,StockMarket,VGAC,8,0,8,-8,1,0,4,1,NYSE
4749,13-02-2021 14:00,24 hrs.,StockMarket,AMD,6,0,6,-6,1,1,0,1,NASDAQ
4749,13-02-2021 14:00,24 hrs.,StockMarket,AQB,8,8,0,8,1,2,0,1,NASDAQ
4749,13-02-2021 14:00,24 hrs.,StockMarket,JFU,90,0,90,-90,1,27,32,1,NASDAQ
4749,13-02-2021 14:00,24 hrs.,StockMarket,OGI,10,0,10,-10,2,1,0,2,NASDAQ
4749,13-02-2021 14:00,24 hrs.,StockMarket,OPK,6,0,6,-6,1,1,0,1,NASDAQ
4749,13-02-2021 14:00,24 hrs.,StockMarket,QQQ,93,12,81,-69,3,31,19,3,NASDAQ
4749,13-02-2021 14:00,24 hrs.,StockMarket,SFT,6,0,6,-6,1,1,0,1,NASDAQ
4749,13-02-2021 14:00,24 hrs.,StockMarket,VFF,23,0,23,-23,1,7,5,1,NASDAQ
4749,13-02-2021 14:00,24 hrs.,StockMarket,AAPL,23,0,23,-23,1,3,13,1,NASDAQ
4749,13-02-2021 14:00,24 hrs.,StockMarket,AMAT,58,0,58,-58,1,26,2,1,NASDAQ
4749,13-02-2021 14:00,24 hrs.,StockMarket,AMZN,58,0,58,-58,1,26,2,1,NASDAQ
4749,13-02-2021 14:00,24 hrs.,StockMarket,APHA,6,0,6,-6,1,1,0,1,NASDAQ
4749,13-02-2021 14:00,24 hrs.,StockMarket,ARTL,85,0,85,-85,1,20,41,1,NASDAQ
4749,13-02-2021 14:00,24 hrs.,StockMarket,ATHX,6,0,6,-6,1,1,0,1,NASDAQ
4749,13-02-2021 14:00,24 hrs.,StockMarket,ATOS,16,0,16,-16,1,6,0,1,NASDAQ
4749,13-02-2021 14:00,24 hrs.,StockMarket,AVGO,7,0,7,-7,1,1,1,1,NASDAQ
4749,13-02-2021 14:00,24 hrs.,StockMarket,BBBY,6,0,6,-6,1,1,0,1,NASDAQ
4749,13-02-2021 14:00,24 hrs.,StockMarket,BPTH,6,0,6,-6,1,1,0,1,NASDAQ
4749,13-02-2021 14:00,24 hrs.,StockMarket,BSQR,10,0,10,-10,1,1,4,1,NASDAQ
4749,13-02-2021 14:00,24 hrs.,StockMarket,BYND,6,0,6,-6,1,1,0,1,NASDAQ
4749,13-02-2021 14:00,24 hrs.,StockMarket,CLEU,99,0,99,-99,2,20,51,2,NASDAQ
4749,13-02-2021 14:00,24 hrs.,StockMarket,CPLP,20,0,20,-20,3,4,0,2,NASDAQ
4749,13-02-2021 14:00,24 hrs.,StockMarket,CRSR,23,0,23,-23,1,3,13,1,NASDAQ
4749,13-02-2021 14:00,24 hrs.,StockMarket,CTRM,6,0,6,-6,1,1,0,1,NASDAQ
4749,13-02-2021 14:00,24 hrs.,StockMarket,CWCO,12,0,12,-12,2,2,0,1,NASDAQ
4749,13-02-2021 14:00,24 hrs.,StockMarket,DDOG,58,0,58,-58,1,26,2,1,NASDAQ
4749,13-02-2021 14:00,24 hrs.,StockMarket,FROG,58,0,58,-58,1,26,2,1,NASDAQ
4749,13-02-2021 14:00,24 hrs.,StockMarket,GBIO,7,0,7,-7,1,1,1,1,NASDAQ
4749,13-02-2021 14:00,24 hrs.,StockMarket,GTHX,58,0,58,-58,1,14,26,1,NASDAQ
4749,13-02-2021 14:00,24 hrs.,StockMarket,HTBX,96,0,96,-96,2,28,32,2,NASDAQ
4749,13-02-2021 14:00,24 hrs.,pennystocks,HPTY,50,0,50,-50,1,16,14,1,OTC
4749,13-02-2021 14:00,24 hrs.,pennystocks,HYSR,6,0,6,-6,1,1,0,1,OTC
4749,13-02-2021 14:00,24 hrs.,pennystocks,ICBU,6,0,6,-6,1,1,0,1,OTC
4749,13-02-2021 14:00,24 hrs.,pennystocks,ICLD,6,0,6,-6,1,1,0,1,OTC
4749,13-02-2021 14:00,24 hrs.,pennystocks,ICNM,15,0,15,-15,1,3,5,1,OTC
4749,13-02-2021 14:00,24 hrs.,pennystocks,IMJX,96,0,96,-96,1,26,40,1,OTC
4749,13-02-2021 14:00,24 hrs.,pennystocks,IMTL,6,0,6,-6,1,1,0,1,OTC
4749,13-02-2021 14:00,24 hrs.,pennystocks,INKW,56,12,44,-32,9,9,2,8,OTC
4749,13-02-2021 14:00,24 hrs.,pennystocks,INND,343,179,164,15,7,92,131,7,OTC
4749,13-02-2021 14:00,24 hrs.,pennystocks,INTV,19,7,12,-5,3,3,1,3,OTC
4749,13-02-2021 14:00,24 hrs.,pennystocks,IPSI,18,0,18,-18,1,5,4,1,OTC
4749,13-02-2021 14:00,24 hrs.,pennystocks,IQST,18,0,18,-18,3,3,0,2,OTC
4749,13-02-2021 14:00,24 hrs.,pennystocks,ISBL,7,7,0,7,1,1,1,1,OTC
4749,13-02-2021 14:00,24 hrs.,pennystocks,ITCJ,7,0,7,-7,1,1,1,1,OTC
4749,13-02-2021 14:00,24 hrs.,pennystocks,JSDA,6,0,6,-6,1,1,0,1,OTC
4749,13-02-2021 14:00,24 hrs.,pennystocks,KWBT,6,0,6,-6,1,1,0,1,OTC
4749,13-02-2021 14:00,24 hrs.,pennystocks,KYNC,6,0,6,-6,1,1,0,1,OTC
4749,13-02-2021 14:00,24 hrs.,pennystocks,LBTI,6,6,0,6,1,1,0,1,OTC
4749,13-02-2021 14:00,24 hrs.,pennystocks,LITH,6,0,6,-6,1,1,0,1,OTC
4749,13-02-2021 14:00,24 hrs.,pennystocks,LUVU,6,0,6,-6,1,1,0,1,OTC
4749,13-02-2021 14:00,24 hrs.,pennystocks,BDGR,6,0,6,-6,1,1,0,1,OTC
4749,13-02-2021 14:00,24 hrs.,pennystocks,BFRE,16,0,16,-16,1,0,12,1,OTC
4749,13-02-2021 14:00,24 hrs.,pennystocks,BGMD,6,0,6,-6,1,1,0,1,OTC
4749,13-02-2021 14:00,24 hrs.,pennystocks,BIEL,109,0,109,-109,3,28,41,3,OTC
4749,13-02-2021 14:00,24 hrs.,pennystocks,BLDV,76,0,76,-76,1,25,22,1,OTC
4749,13-02-2021 14:00,24 hrs.,pennystocks,BLSP,6,0,6,-6,1,1,0,1,OTC
4749,13-02-2021 14:00,24 hrs.,pennystocks,BMCS,11,0,11,-11,1,2,3,1,OTC
4749,13-02-2021 14:00,24 hrs.,pennystocks,BMMJ,6,0,6,-6,1,1,0,1,OTC
4749,13-02-2021 14:00,24 hrs.,pennystocks,BONZ,6,0,6,-6,1,0,2,1,OTC
4749,13-02-2021 14:00,24 hrs.,pennystocks,BOTY,6,6,0,6,1,1,0,1,OTC
4749,13-02-2021 14:00,24 hrs.,pennystocks,BRLL,48,0,48,-48,2,4,32,2,OTC
4749,13-02-2021 14:00,24 hrs.,pennystocks,BRTX,12,0,12,-12,2,2,0,2,OTC
4749,13-02-2021 14:00,24 hrs.,pennystocks,BRZL,6,0,6,-6,1,1,0,1,OTC
4749,13-02-2021 14:00,24 hrs.,pennystocks,BTZI,6,0,6,-6,1,1,0,1,OTC
4749,13-02-2021 14:00,24 hrs.,pennystocks,BUDZ,13,0,13,-13,2,2,1,2,OTC
4749,13-02-2021 14:00,24 hrs.,pennystocks,BWMG,26,0,26,-26,1,6,10,1,OTC
4749,13-02-2021 14:00,24 hrs.,pennystocks,BZWR,15,0,15,-15,1,0,11,1,OTC
4749,13-02-2021 14:00,24 hrs.,pennystocks,CAFS,7,7,0,7,1,1,1,1,OTC
4749,13-02-2021 14:00,24 hrs.,pennystocks,CANN,6,0,6,-6,1,1,0,1,OTC
4749,13-02-2021 14:00,24 hrs.,pennystocks,CAPC,7,0,7,-7,1,1,1,1,OTC
4749,13-02-2021 14:00,24 hrs.,pennystocks,CATV,146,0,146,-146,1,63,16,1,OTC
4749,13-02-2021 14:00,24 hrs.,pennystocks,CAVR,6,0,6,-6,1,1,0,1,OTC
4749,13-02-2021 14:00,24 hrs.,pennystocks,CBBT,395,0,395,-395,3,157,69,3,OTC
4749,13-02-2021 14:00,24 hrs.,pennystocks,CBDL,286,0,286,-286,3,90,94,3,OTC
4749,13-02-2021 14:00,24 hrs.,pennystocks,CCTL,21,0,21,-21,1,7,3,1,OTC
4749,13-02-2021 14:00,24 hrs.,StockMarket,PTON,23,0,23,-23,1,3,13,1,NASDAQ
4749,13-02-2021 14:00,24 hrs.,StockMarket,RARE,58,0,58,-58,1,26,2,1,NASDAQ
4749,13-02-2021 14:00,24 hrs.,StockMarket,RBBN,6,0,6,-6,1,1,0,1,NASDAQ
4749,13-02-2021 14:00,24 hrs.,StockMarket,REAL,34,0,34,-34,1,0,30,1,NASDAQ
4749,13-02-2021 14:00,24 hrs.,StockMarket,RIDE,6,0,6,-6,1,1,0,1,NASDAQ
4749,13-02-2021 14:00,24 hrs.,StockMarket,SBUX,23,0,23,-23,1,3,13,1,NASDAQ
4749,13-02-2021 14:00,24 hrs.,StockMarket,SESN,36,0,36,-36,2,12,4,1,NASDAQ
4749,13-02-2021 14:00,24 hrs.,StockMarket,SNDL,158,152,6,146,3,38,70,3,NASDAQ
4749,13-02-2021 14:00,24 hrs.,StockMarket,SPSC,58,0,58,-58,1,26,2,1,NASDAQ
4749,13-02-2021 14:00,24 hrs.,StockMarket,SRAC,8,0,8,-8,1,0,4,1,NASDAQ
4749,13-02-2021 14:00,24 hrs.,StockMarket,TLRY,47,0,47,-47,5,9,9,5,NASDAQ
4749,13-02-2021 14:00,24 hrs.,StockMarket,TRVG,6,0,6,-6,1,1,0,1,NASDAQ
4749,13-02-2021 14:00,24 hrs.,StockMarket,TSLA,3325,3319,6,3313,2,1613,91,2,NASDAQ
4749,13-02-2021 14:00,24 hrs.,StockMarket,VITL,58,52,6,46,2,22,6,2,NASDAQ
4749,13-02-2021 14:00,24 hrs.,StockMarket,VUZI,6,0,6,-6,1,1,0,1,NASDAQ
4749,13-02-2021 14:00,24 hrs.,StockMarket,VXRT,6,6,0,6,1,1,0,1,NASDAQ
4749,13-02-2021 14:00,24 hrs.,StockMarket,WAFU,85,0,85,-85,1,20,41,1,NASDAQ
4749,13-02-2021 14:00,24 hrs.,StockMarket,ZIOP,6,0,6,-6,1,1,0,1,NASDAQ
4749,13-02-2021 14:00,24 hrs.,StockMarket,SRACU,8,0,8,-8,1,0,4,1,NASDAQ
4749,13-02-2021 14:00,24 hrs.,pennystocks,BDRBF,6,0,6,-6,1,1,0,1,OTC
4749,13-02-2021 14:00,24 hrs.,pennystocks,BFARF,9,0,9,-9,1,0,5,1,OTC
4749,13-02-2021 14:00,24 hrs.,pennystocks,BKLLF,84,0,84,-84,1,26,28,1,OTC
4749,13-02-2021 14:00,24 hrs.,pennystocks,LVVV,37,0,37,-37,1,7,19,1,OTC
4749,13-02-2021 14:00,24 hrs.,pennystocks,MAXD,77,18,59,-41,7,19,11,7,OTC
4749,13-02-2021 14:00,24 hrs.,pennystocks,MCOA,7,0,7,-7,1,1,1,1,OTC
4749,13-02-2021 14:00,24 hrs.,pennystocks,MDCN,13,0,13,-13,2,2,1,2,OTC
4749,13-02-2021 14:00,24 hrs.,pennystocks,MEDH,81,0,81,-81,1,19,39,1,OTC
4749,13-02-2021 14:00,24 hrs.,pennystocks,MGTI,18,0,18,-18,1,4,6,1,OTC
4749,13-02-2021 14:00,24 hrs.,pennystocks,MIHI,6,0,6,-6,1,1,0,1,OTC
4749,13-02-2021 14:00,24 hrs.,pennystocks,MINE,31,0,31,-31,5,5,1,4,OTC
4749,13-02-2021 14:00,24 hrs.,pennystocks,MJNA,49,24,25,-1,6,6,13,5,OTC
4749,13-02-2021 14:00,24 hrs.,pennystocks,MJTV,7,0,7,-7,1,1,1,1,OTC
4749,13-02-2021 14:00,24 hrs.,pennystocks,MKTY,7,0,7,-7,1,1,1,1,OTC
4749,13-02-2021 14:00,24 hrs.,pennystocks,MLFB,69,0,69,-69,2,21,19,2,OTC
4749,13-02-2021 14:00,24 hrs.,pennystocks,MMEX,141,0,141,-141,3,26,77,2,OTC
4749,13-02-2021 14:00,24 hrs.,pennystocks,MOJO,12,0,12,-12,2,2,0,1,OTC
4749,13-02-2021 14:00,24 hrs.,pennystocks,MRMD,6,0,6,-6,1,0,2,1,OTC
4749,13-02-2021 14:00,24 hrs.,pennystocks,MTVX,6,0,6,-6,1,1,0,1,OTC
4749,13-02-2021 14:00,24 hrs.,pennystocks,NBVG,7,0,7,-7,1,1,1,1,OTC
4749,13-02-2021 14:00,24 hrs.,pennystocks,CELZ,13,6,7,-1,2,2,1,2,OTC
4749,13-02-2021 14:00,24 hrs.,pennystocks,CHNC,26,0,26,-26,1,7,8,1,OTC
4749,13-02-2021 14:00,24 hrs.,pennystocks,CLWD,6,0,6,-6,1,1,0,1,OTC
4749,13-02-2021 14:00,24 hrs.,pennystocks,CNNA,85,0,85,-85,1,10,61,1,OTC
4749,13-02-2021 14:00,24 hrs.,pennystocks,COMS,13,13,0,13,2,2,1,1,OTC
4749,13-02-2021 14:00,24 hrs.,pennystocks,CORG,7,0,7,-7,1,1,1,1,OTC
4749,13-02-2021 14:00,24 hrs.,pennystocks,CRTG,31,0,31,-31,1,9,9,1,OTC
4749,13-02-2021 14:00,24 hrs.,pennystocks,CSLI,49,0,49,-49,1,14,17,1,OTC
4749,13-02-2021 14:00,24 hrs.,pennystocks,CTLE,18,12,6,6,3,3,0,3,OTC
4749,13-02-2021 14:00,24 hrs.,pennystocks,CYDY,7,0,7,-7,1,1,1,1,OTC
4749,13-02-2021 14:00,24 hrs.,pennystocks,DMAN,21,0,21,-21,1,6,5,1,OTC
4749,13-02-2021 14:00,24 hrs.,pennystocks,DPLS,189,81,108,-27,6,64,37,5,OTC
4749,13-02-2021 14:00,24 hrs.,pennystocks,DSGT,6,6,0,6,1,1,0,1,OTC
4749,13-02-2021 14:00,24 hrs.,pennystocks,EAWD,6,6,0,6,1,1,0,1,OTC
4749,13-02-2021 14:00,24 hrs.,pennystocks,ECEZ,7,7,0,7,1,1,1,1,OTC
4749,13-02-2021 14:00,24 hrs.,pennystocks,EHOS,39,0,39,-39,1,8,19,1,OTC
4749,13-02-2021 14:00,24 hrs.,pennystocks,ELTP,14,0,14,-14,1,3,4,1,OTC
4749,13-02-2021 14:00,24 hrs.,pennystocks,ENRT,6,0,6,-6,1,1,0,1,OTC
4749,13-02-2021 14:00,24 hrs.,pennystocks,ENZC,12,0,12,-12,2,2,0,2,OTC
4749,13-02-2021 14:00,24 hrs.,pennystocks,ERBB,16,0,16,-16,1,2,8,1,OTC
4749,13-02-2021 14:00,24 hrs.,pennystocks,ETFM,212,6,206,-200,4,69,58,3,OTC
4749,13-02-2021 14:00,24 hrs.,pennystocks,EWKS,7,0,7,-7,1,1,1,1,OTC
4749,13-02-2021 14:00,24 hrs.,pennystocks,FLXT,6,0,6,-6,1,1,0,1,OTC
4749,13-02-2021 14:00,24 hrs.,pennystocks,FTEG,6,0,6,-6,1,1,0,1,OTC
4749,13-02-2021 14:00,24 hrs.,pennystocks,FUST,7,0,7,-7,1,1,1,1,OTC
4749,13-02-2021 14:00,24 hrs.,pennystocks,GAXY,193,193,0,193,1,79,31,1,OTC
4749,13-02-2021 14:00,24 hrs.,pennystocks,GHMP,48,0,48,-48,3,9,18,2,OTC
4749,13-02-2021 14:00,24 hrs.,pennystocks,GLCO,6,0,6,-6,1,1,0,1,OTC
4749,13-02-2021 14:00,24 hrs.,pennystocks,GLEC,6,0,6,-6,1,1,0,1,OTC
4749,13-02-2021 14:00,24 hrs.,pennystocks,GPFT,12,0,12,-12,1,3,2,1,OTC
4749,13-02-2021 14:00,24 hrs.,pennystocks,GRCU,11,0,11,-11,1,1,5,1,OTC
4749,13-02-2021 14:00,24 hrs.,pennystocks,GRCV,7,7,0,7,1,1,1,1,OTC
4749,13-02-2021 14:00,24 hrs.,pennystocks,GRSO,7,7,0,7,1,1,1,1,OTC
4749,13-02-2021 14:00,24 hrs.,pennystocks,GRST,118,0,118,-118,2,38,34,1,OTC
4749,13-02-2021 14:00,24 hrs.,pennystocks,GTBP,19,0,19,-19,1,2,11,1,OTC
4749,13-02-2021 14:00,24 hrs.,pennystocks,GTEH,52,0,52,-52,1,13,22,1,OTC
4749,13-02-2021 14:00,24 hrs.,pennystocks,GTLL,29,6,23,-17,3,6,5,3,OTC
4749,13-02-2021 14:00,24 hrs.,pennystocks,HALB,39,17,22,-5,2,9,13,2,OTC
4749,13-02-2021 14:00,24 hrs.,pennystocks,HCMC,132,55,77,-22,21,21,6,18,OTC
4749,13-02-2021 14:00,24 hrs.,pennystocks,HEMP,7,0,7,-7,1,1,1,1,OTC
4749,13-02-2021 14:00,24 hrs.,pennystocks,HENC,14,0,14,-14,1,2,6,1,OTC
4749,13-02-2021 14:00,24 hrs.,pennystocks,HIPH,13,0,13,-13,2,1,3,2,OTC
4749,13-02-2021 14:00,24 hrs.,pennystocks,HMMR,7,0,7,-7,1,1,1,1,OTC
4749,13-02-2021 14:00,24 hrs.,pennystocks,HMNY,6,0,6,-6,1,1,0,1,OTC
4749,13-02-2021 14:00,24 hrs.,pennystocks,CIOXY,7,0,7,-7,1,1,1,1,OTC
4749,13-02-2021 14:00,24 hrs.,pennystocks,CLUBQ,27,0,27,-27,2,6,7,1,OTC
4749,13-02-2021 14:00,24 hrs.,pennystocks,CPHRF,6,0,6,-6,1,1,0,1,OTC
4749,13-02-2021 14:00,24 hrs.,pennystocks,NOVC,54,0,54,-54,2,16,14,2,OTC
4749,13-02-2021 14:00,24 hrs.,pennystocks,NSAV,13,0,13,-13,2,2,1,2,OTC
4749,13-02-2021 14:00,24 hrs.,pennystocks,NSPT,24,18,6,12,2,3,10,2,OTC
4749,13-02-2021 14:00,24 hrs.,pennystocks,NUGS,7,7,0,7,1,1,1,1,OTC
4749,13-02-2021 14:00,24 hrs.,pennystocks,OZSC,120,52,68,-16,3,31,46,3,OTC
4749,13-02-2021 14:00,24 hrs.,pennystocks,PAOG,7,0,7,-7,1,1,1,1,OTC
4749,13-02-2021 14:00,24 hrs.,pennystocks,PDXP,7,0,7,-7,1,1,1,1,OTC
4749,13-02-2021 14:00,24 hrs.,pennystocks,PHIL,6,0,6,-6,1,1,0,1,OTC
4749,13-02-2021 14:00,24 hrs.,pennystocks,PPJE,6,0,6,-6,1,1,0,1,OTC
4749,13-02-2021 14:00,24 hrs.,pennystocks,PUGE,41,0,41,-41,2,12,9,1,OTC
4749,13-02-2021 14:00,24 hrs.,pennystocks,PURA,53,40,13,27,3,7,27,3,OTC
4749,13-02-2021 14:00,24 hrs.,pennystocks,PVDG,23,0,23,-23,1,1,17,1,OTC
4749,13-02-2021 14:00,24 hrs.,pennystocks,QOIL,7,0,7,-7,1,1,1,1,OTC
4749,13-02-2021 14:00,24 hrs.,pennystocks,RDGL,6,0,6,-6,1,1,0,1,OTC
4749,13-02-2021 14:00,24 hrs.,pennystocks,RELI,16,0,16,-16,1,0,12,1,OTC
4749,13-02-2021 14:00,24 hrs.,pennystocks,RGBP,21,0,21,-21,2,5,3,1,OTC
4749,13-02-2021 14:00,24 hrs.,pennystocks,RNVA,6,0,6,-6,1,1,0,1,OTC
4749,13-02-2021 14:00,24 hrs.,pennystocks,RSHN,19,0,19,-19,1,2,11,1,OTC
4749,13-02-2021 14:00,24 hrs.,pennystocks,RSSV,314,0,314,-314,2,115,76,2,OTC
4749,13-02-2021 14:00,24 hrs.,pennystocks,RTON,13,0,13,-13,2,2,1,2,OTC
4749,13-02-2021 14:00,24 hrs.,pennystocks,SCNA,6,0,6,-6,1,1,0,1,OTC
4749,13-02-2021 14:00,24 hrs.,pennystocks,SFOR,15,0,15,-15,1,0,11,1,OTC
4749,13-02-2021 14:00,24 hrs.,pennystocks,SGMD,498,132,366,-234,13,161,124,13,OTC
4749,13-02-2021 14:00,24 hrs.,pennystocks,SHWZ,7,0,7,-7,1,1,1,1,OTC
4749,13-02-2021 14:00,24 hrs.,pennystocks,SIML,102,0,102,-102,2,27,40,2,OTC
4749,13-02-2021 14:00,24 hrs.,pennystocks,SING,34,0,34,-34,2,5,16,2,OTC
4749,13-02-2021 14:00,24 hrs.,pennystocks,SIRC,37,37,0,37,2,8,13,2,OTC
4749,13-02-2021 14:00,24 hrs.,pennystocks,SNPW,91,58,33,25,4,30,15,4,OTC
4749,13-02-2021 14:00,24 hrs.,pennystocks,SNRS,14,0,14,-14,2,2,2,2,OTC
4749,13-02-2021 14:00,24 hrs.,pennystocks,SNWV,12,0,12,-12,2,2,0,1,OTC
4749,13-02-2021 14:00,24 hrs.,pennystocks,SNYR,6,0,6,-6,1,1,0,1,OTC
4749,13-02-2021 14:00,24 hrs.,pennystocks,SOBR,6,6,0,6,1,1,0,1,OTC
4749,13-02-2021 14:00,24 hrs.,pennystocks,SRMX,73,0,73,-73,6,20,9,6,OTC
4749,13-02-2021 14:00,24 hrs.,pennystocks,SRNA,6,0,6,-6,1,1,0,1,OTC
4749,13-02-2021 14:00,24 hrs.,pennystocks,SSFT,15,0,15,-15,1,0,11,1,OTC
4749,13-02-2021 14:00,24 hrs.,pennystocks,SSOK,15,0,15,-15,1,0,11,1,OTC
4749,13-02-2021 14:00,24 hrs.,pennystocks,STEV,14,0,14,-14,1,4,2,1,OTC
4749,13-02-2021 14:00,24 hrs.,pennystocks,STWC,35,35,0,35,1,12,7,1,OTC
4749,13-02-2021 14:00,24 hrs.,pennystocks,TAUG,6,6,0,6,1,1,0,1,OTC
4749,13-02-2021 14:00,24 hrs.,pennystocks,TCHH,7,0,7,-7,1,1,1,1,OTC
4749,13-02-2021 14:00,24 hrs.,pennystocks,TGHI,11,0,11,-11,1,2,3,1,OTC
4749,13-02-2021 14:00,24 hrs.,pennystocks,TLGN,73,0,73,-73,3,19,23,2,OTC
4749,13-02-2021 14:00,24 hrs.,pennystocks,TLSS,90,0,90,-90,2,27,28,2,OTC
4749,13-02-2021 14:00,24 hrs.,pennystocks,TPAC,5374,0,5374,-5374,1,2416,538,1,OTC
4749,13-02-2021 14:00,24 hrs.,pennystocks,TSNP,85,52,33,19,4,28,13,4,OTC
4749,13-02-2021 14:00,24 hrs.,pennystocks,TXTM,7,7,0,7,1,1,1,1,OTC
4749,13-02-2021 14:00,24 hrs.,pennystocks,UAPC,13,13,0,13,2,2,1,2,OTC
4749,13-02-2021 14:00,24 hrs.,pennystocks,USMJ,44,0,44,-44,2,10,16,2,OTC
4749,13-02-2021 14:00,24 hrs.,pennystocks,VFRM,6,0,6,-6,1,1,0,1,OTC
4749,13-02-2021 14:00,24 hrs.,pennystocks,VPER,62,0,62,-62,1,10,38,1,OTC
4749,13-02-2021 14:00,24 hrs.,pennystocks,VSPC,6,6,0,6,1,1,0,1,OTC
4749,13-02-2021 14:00,24 hrs.,pennystocks,WCVC,96,0,96,-96,1,26,40,1,OTC
4749,13-02-2021 14:00,24 hrs.,pennystocks,WIZD,18,0,18,-18,1,5,4,1,OTC
4749,13-02-2021 14:00,24 hrs.,pennystocks,XFLS,4,4,0,4,1,0,0,1,OTC
4749,13-02-2021 14:00,24 hrs.,pennystocks,XLPI,176,176,0,176,1,77,18,1,OTC
4749,13-02-2021 14:00,24 hrs.,pennystocks,XMET,6,0,6,-6,1,1,0,1,OTC
4749,13-02-2021 14:00,24 hrs.,pennystocks,ZHUD,8,0,8,-8,1,1,2,1,OTC
4749,13-02-2021 14:00,24 hrs.,pennystocks,ABEPF,6,6,0,6,1,1,0,1,OTC
4749,13-02-2021 14:00,24 hrs.,pennystocks,AGGHF,25,0,25,-25,1,7,7,1,OTC
4749,13-02-2021 14:00,24 hrs.,pennystocks,AQSZF,6,6,0,6,1,1,0,1,OTC
4749,13-02-2021 14:00,24 hrs.,pennystocks,ARBKF,53,29,24,5,2,15,15,2,OTC
4749,13-02-2021 14:00,24 hrs.,pennystocks,PDT,23,23,0,23,1,8,3,1,NYSE
4749,13-02-2021 14:00,24 hrs.,pennystocks,PKG,21,21,0,21,1,7,3,1,NYSE
4749,13-02-2021 14:00,24 hrs.,pennystocks,RKT,84,0,84,-84,1,26,28,1,NYSE
4749,13-02-2021 14:00,24 hrs.,pennystocks,RSI,289,0,289,-289,1,123,39,1,NYSE
4749,13-02-2021 14:00,24 hrs.,pennystocks,SOS,179,128,51,77,5,49,61,5,NYSE
4749,13-02-2021 14:00,24 hrs.,pennystocks,CRLBF,106,0,106,-106,2,11,76,2,OTC
4749,13-02-2021 14:00,24 hrs.,pennystocks,CWGYF,6,0,6,-6,1,1,0,1,OTC
4749,13-02-2021 14:00,24 hrs.,pennystocks,CWSFF,6,0,6,-6,1,1,0,1,OTC
4749,13-02-2021 14:00,24 hrs.,pennystocks,DIGAF,7,7,0,7,1,1,1,1,OTC
4749,13-02-2021 14:00,24 hrs.,pennystocks,EHVVF,15,0,15,-15,1,0,11,1,OTC
4749,13-02-2021 14:00,24 hrs.,pennystocks,ELRRF,12,0,12,-12,2,2,0,2,OTC
4749,13-02-2021 14:00,24 hrs.,pennystocks,EMHTF,6,0,6,-6,1,1,0,1,OTC
4749,13-02-2021 14:00,24 hrs.,pennystocks,EPWCF,14,0,14,-14,1,0,10,1,OTC
4749,13-02-2021 14:00,24 hrs.,pennystocks,ERPNF,44,44,0,44,1,17,6,1,OTC
4749,13-02-2021 14:00,24 hrs.,pennystocks,EVKIF,31,0,31,-31,1,9,9,1,OTC
4749,13-02-2021 14:00,24 hrs.,pennystocks,FLWPF,24,0,24,-24,1,5,10,1,OTC
4749,13-02-2021 14:00,24 hrs.,pennystocks,FUNFF,12,0,12,-12,1,3,2,1,OTC
4749,13-02-2021 14:00,24 hrs.,pennystocks,GLDFF,6,0,6,-6,1,1,0,1,OTC
4749,13-02-2021 14:00,24 hrs.,pennystocks,HITIF,1765,6,1759,-1753,10,617,491,10,OTC
4749,13-02-2021 14:00,24 hrs.,pennystocks,HRVSF,6,0,6,-6,1,1,0,1,OTC
4749,13-02-2021 14:00,24 hrs.,pennystocks,INTEQ,6,0,6,-6,1,1,0,1,OTC
4749,13-02-2021 14:00,24 hrs.,pennystocks,KCCFF,30,0,30,-30,1,10,6,1,OTC
4749,13-02-2021 14:00,24 hrs.,pennystocks,LLKKF,24,0,24,-24,4,4,0,1,OTC
4749,13-02-2021 14:00,24 hrs.,pennystocks,LTHUQ,26,26,0,26,1,6,10,1,OTC
4749,13-02-2021 14:00,24 hrs.,pennystocks,LXXGF,98,0,98,-98,1,21,52,1,OTC
4749,13-02-2021 14:00,24 hrs.,pennystocks,MMEDF,33,0,33,-33,1,14,1,1,OTC
4749,13-02-2021 14:00,24 hrs.,pennystocks,MSNVF,6,6,0,6,1,1,0,1,OTC
4749,13-02-2021 14:00,24 hrs.,pennystocks,NMGRF,12,0,12,-12,2,2,0,2,OTC
4749,13-02-2021 14:00,24 hrs.,pennystocks,NOSUF,46,0,46,-46,2,11,16,2,OTC
4749,13-02-2021 14:00,24 hrs.,pennystocks,NXTTF,75,63,12,51,3,20,23,3,OTC
4749,13-02-2021 14:00,24 hrs.,pennystocks,OILFF,6,0,6,-6,1,1,0,1,OTC
4749,13-02-2021 14:00,24 hrs.,pennystocks,PFWIQ,96,0,96,-96,1,26,40,1,OTC
4749,13-02-2021 14:00,24 hrs.,pennystocks,PMNXF,6,0,6,-6,1,1,0,1,OTC
4749,13-02-2021 14:00,24 hrs.,pennystocks,RAZFF,7,0,7,-7,1,1,1,1,OTC
4749,13-02-2021 14:00,24 hrs.,pennystocks,RHDGF,9,0,9,-9,1,1,3,1,OTC
4749,13-02-2021 14:00,24 hrs.,pennystocks,RLLCF,65,0,65,-65,7,12,13,6,OTC
4749,13-02-2021 14:00,24 hrs.,pennystocks,RVVTF,7,0,7,-7,1,1,1,1,OTC
4749,13-02-2021 14:00,24 hrs.,pennystocks,SPMTF,20,0,20,-20,1,2,12,1,OTC
4749,13-02-2021 14:00,24 hrs.,pennystocks,SPRWF,58,0,58,-58,2,17,16,2,OTC
4749,13-02-2021 14:00,24 hrs.,pennystocks,TAKOF,40,0,40,-40,1,14,8,1,OTC
4749,13-02-2021 14:00,24 hrs.,pennystocks,TOBAF,38,0,38,-38,1,9,16,1,OTC
4749,13-02-2021 14:00,24 hrs.,pennystocks,TRUFF,20,20,0,20,1,4,8,1,OTC
4749,13-02-2021 14:00,24 hrs.,pennystocks,TSCRF,82,0,82,-82,3,23,24,3,OTC
4749,13-02-2021 14:00,24 hrs.,pennystocks,VRNDF,18,0,18,-18,1,5,4,1,OTC
4749,13-02-2021 14:00,24 hrs.,pennystocks,ZBISF,1370,0,1370,-1370,2,556,250,2,OTC
4749,13-02-2021 14:00,24 hrs.,pennystocks,DNN,55,12,43,-31,9,9,1,8,AMEX
4749,13-02-2021 14:00,24 hrs.,pennystocks,DPW,6,0,6,-6,1,1,0,1,AMEX
4749,13-02-2021 14:00,24 hrs.,pennystocks,DSS,36,6,30,-24,2,10,8,2,AMEX
4749,13-02-2021 14:00,24 hrs.,pennystocks,GSV,7,7,0,7,1,1,1,1,AMEX
4749,13-02-2021 14:00,24 hrs.,pennystocks,GTE,51,39,12,27,4,10,15,4,AMEX
4749,13-02-2021 14:00,24 hrs.,pennystocks,MCF,6,0,6,-6,1,1,0,1,AMEX
4749,13-02-2021 14:00,24 hrs.,pennystocks,NAK,37,0,37,-37,1,9,15,1,AMEX
4749,13-02-2021 14:00,24 hrs.,pennystocks,NBY,52,0,52,-52,1,16,16,1,AMEX
4749,13-02-2021 14:00,24 hrs.,pennystocks,NGD,7,7,0,7,1,1,1,1,AMEX
4749,13-02-2021 14:00,24 hrs.,pennystocks,TGB,35,6,29,-23,2,10,7,2,AMEX
4749,13-02-2021 14:00,24 hrs.,pennystocks,ZOM,92,0,92,-92,2,11,62,2,AMEX
4749,13-02-2021 14:00,24 hrs.,pennystocks,GSAT,72,0,72,-72,1,18,32,1,AMEX
4749,13-02-2021 14:00,24 hrs.,pennystocks,IBIO,21,0,21,-21,1,7,3,1,AMEX
4749,13-02-2021 14:00,24 hrs.,pennystocks,NSPR,20,0,20,-20,1,6,4,1,AMEX
4749,13-02-2021 14:00,24 hrs.,pennystocks,BNCHF,6,0,6,-6,1,1,0,1,OTC
4749,13-02-2021 14:00,24 hrs.,pennystocks,BVNNF,7,0,7,-7,1,1,1,1,OTC
4749,13-02-2021 14:00,24 hrs.,pennystocks,CANSF,5,0,5,-5,1,0,1,1,OTC
4749,13-02-2021 14:00,24 hrs.,pennystocks,CBULF,6,0,6,-6,1,1,0,1,OTC
4749,13-02-2021 14:00,24 hrs.,pennystocks,CBWTF,13,0,13,-13,2,2,1,2,OTC
4749,13-02-2021 14:00,24 hrs.,pennystocks,LLIT,7,0,7,-7,1,1,1,1,NASDAQ
4749,13-02-2021 14:00,24 hrs.,pennystocks,LPTH,70,0,70,-70,1,27,12,1,NASDAQ
4749,13-02-2021 14:00,24 hrs.,pennystocks,LPTX,43,43,0,43,1,10,19,1,NASDAQ
4749,13-02-2021 14:00,24 hrs.,pennystocks,MARK,6,0,6,-6,1,1,0,1,NASDAQ
4749,13-02-2021 14:00,24 hrs.,pennystocks,MOGO,28,28,0,28,1,8,8,1,NASDAQ
4749,13-02-2021 14:00,24 hrs.,pennystocks,MVIS,14,0,14,-14,1,0,10,1,NASDAQ
4749,13-02-2021 14:00,24 hrs.,pennystocks,NAKD,1255,1218,37,1181,2,544,159,2,NASDAQ
4749,13-02-2021 14:00,24 hrs.,pennystocks,SUM,289,0,289,-289,1,123,39,1,NYSE
4749,13-02-2021 14:00,24 hrs.,pennystocks,TSM,46,0,46,-46,1,12,18,1,NYSE
4749,13-02-2021 14:00,24 hrs.,pennystocks,VET,7,0,7,-7,1,1,1,1,NYSE
4749,13-02-2021 14:00,24 hrs.,pennystocks,ARGO,29,29,0,29,1,9,7,1,NYSE
4749,13-02-2021 14:00,24 hrs.,pennystocks,CCIV,7,0,7,-7,1,1,1,1,NYSE
4749,13-02-2021 14:00,24 hrs.,pennystocks,DASH,22,22,0,22,1,6,6,1,NYSE
4749,13-02-2021 14:00,24 hrs.,pennystocks,FINV,16,0,16,-16,1,4,4,1,NYSE
4749,13-02-2021 14:00,24 hrs.,pennystocks,HEXO,21,0,21,-21,1,1,15,1,NYSE
4749,13-02-2021 14:00,24 hrs.,pennystocks,PUMP,13,0,13,-13,2,2,1,1,NYSE
4749,13-02-2021 14:00,24 hrs.,pennystocks,SHOP,12,0,12,-12,2,2,0,1,NYSE
4749,13-02-2021 14:00,24 hrs.,pennystocks,SPCE,44,44,0,44,1,17,6,1,NYSE
4749,13-02-2021 14:00,24 hrs.,pennystocks,WELL,1760,0,1760,-1760,1,747,262,1,NYSE
4749,13-02-2021 14:00,24 hrs.,pennystocks,FWP,10,0,10,-10,1,0,6,1,NASDAQ
4749,13-02-2021 14:00,24 hrs.,pennystocks,GBT,6,0,6,-6,1,1,0,1,NASDAQ
4749,13-02-2021 14:00,24 hrs.,pennystocks,OGI,19,0,19,-19,1,6,3,1,NASDAQ
4749,13-02-2021 14:00,24 hrs.,pennystocks,SND,43,43,0,43,1,10,19,1,NASDAQ
4749,13-02-2021 14:00,24 hrs.,pennystocks,SPI,13,0,13,-13,1,3,3,1,NASDAQ
4749,13-02-2021 14:00,24 hrs.,pennystocks,SSB,7,7,0,7,1,1,1,1,NASDAQ
4749,13-02-2021 14:00,24 hrs.,pennystocks,ABEO,7,0,7,-7,1,1,1,1,NASDAQ
4749,13-02-2021 14:00,24 hrs.,pennystocks,ACST,6,0,6,-6,1,1,0,1,NASDAQ
4749,13-02-2021 14:00,24 hrs.,pennystocks,AGEN,10,0,10,-10,1,3,0,1,NASDAQ
4749,13-02-2021 14:00,24 hrs.,pennystocks,AGTC,14,0,14,-14,2,2,2,2,NASDAQ
4749,13-02-2021 14:00,24 hrs.,pennystocks,AIKI,6,6,0,6,1,1,0,1,NASDAQ
4749,13-02-2021 14:00,24 hrs.,pennystocks,ALNA,13,13,0,13,1,2,5,1,NASDAQ
4749,13-02-2021 14:00,24 hrs.,pennystocks,AMTX,75,0,75,-75,1,26,19,1,NASDAQ
4749,13-02-2021 14:00,24 hrs.,pennystocks,APHA,93,0,93,-93,3,30,21,3,NASDAQ
4749,13-02-2021 14:00,24 hrs.,pennystocks,APRE,6,6,0,6,1,1,0,1,NASDAQ
4749,13-02-2021 14:00,24 hrs.,pennystocks,OGEN,6,0,6,-6,1,1,0,1,AMEX
4749,13-02-2021 14:00,24 hrs.,pennystocks,SDPI,6,0,6,-6,1,1,0,1,AMEX
4749,13-02-2021 14:00,24 hrs.,pennystocks,SENS,34,0,34,-34,3,5,12,3,AMEX
4749,13-02-2021 14:00,24 hrs.,pennystocks,TRXC,12,0,12,-12,2,1,2,2,AMEX
4749,13-02-2021 14:00,24 hrs.,pennystocks,UAVS,110,0,110,-110,1,36,34,1,AMEX
4749,13-02-2021 14:00,24 hrs.,pennystocks,XXII,6,0,6,-6,1,0,2,1,AMEX
4749,13-02-2021 14:00,24 hrs.,pennystocks,ACB,19,0,19,-19,1,1,13,1,NYSE
4749,13-02-2021 14:00,24 hrs.,pennystocks,AHT,6,0,6,-6,1,1,0,1,NYSE
4749,13-02-2021 14:00,24 hrs.,pennystocks,AMC,86,0,86,-86,5,16,34,5,NYSE
4749,13-02-2021 14:00,24 hrs.,pennystocks,ASX,24,0,24,-24,4,4,0,2,NYSE
4749,13-02-2021 14:00,24 hrs.,pennystocks,ATH,14,0,14,-14,1,4,2,1,NYSE
4749,13-02-2021 14:00,24 hrs.,pennystocks,AXL,6,0,6,-6,1,0,2,1,NYSE
4749,13-02-2021 14:00,24 hrs.,pennystocks,BTU,6,0,6,-6,1,1,0,1,NYSE
4749,13-02-2021 14:00,24 hrs.,pennystocks,CBD,39,28,11,17,3,10,7,3,NYSE
4749,13-02-2021 14:00,24 hrs.,pennystocks,CHS,31,0,31,-31,1,9,9,1,NYSE
4749,13-02-2021 14:00,24 hrs.,pennystocks,CLI,67,0,67,-67,1,23,17,1,NYSE
4749,13-02-2021 14:00,24 hrs.,pennystocks,CMD,67,0,67,-67,1,23,17,1,NYSE
4749,13-02-2021 14:00,24 hrs.,pennystocks,CVX,33,0,33,-33,1,11,7,1,NYSE
4749,13-02-2021 14:00,24 hrs.,pennystocks,ETH,6,0,6,-6,1,1,0,1,NYSE
4749,13-02-2021 14:00,24 hrs.,pennystocks,FLT,40,0,40,-40,1,14,8,1,NYSE
4749,13-02-2021 14:00,24 hrs.,pennystocks,GME,24,0,24,-24,4,4,0,3,NYSE
4749,13-02-2021 14:00,24 hrs.,pennystocks,IRR,30,0,30,-30,1,10,6,1,NYSE
4749,13-02-2021 14:00,24 hrs.,pennystocks,KOS,7,0,7,-7,1,1,1,1,NYSE
4749,13-02-2021 14:00,24 hrs.,pennystocks,LOW,6,6,0,6,1,1,0,1,NYSE
4749,13-02-2021 14:00,24 hrs.,pennystocks,MDC,17,0,17,-17,1,5,3,1,NYSE
4749,13-02-2021 14:00,24 hrs.,pennystocks,MED,6,6,0,6,1,1,0,1,NYSE
4749,13-02-2021 14:00,24 hrs.,pennystocks,MIN,6,6,0,6,1,1,0,1,NYSE
4749,13-02-2021 14:00,24 hrs.,pennystocks,NAT,7,0,7,-7,1,1,1,1,NYSE
4749,13-02-2021 14:00,24 hrs.,pennystocks,NOK,6,0,6,-6,1,1,0,1,NYSE
4749,13-02-2021 14:00,24 hrs.,pennystocks,NPV,30,0,30,-30,1,10,6,1,NYSE
4749,13-02-2021 14:00,24 hrs.,wallstreetbets,BOTY,12,6,6,0,2,2,0,2,OTC
4749,13-02-2021 14:00,24 hrs.,wallstreetbets,BRLL,7,0,7,-7,1,1,1,1,OTC
4749,13-02-2021 14:00,24 hrs.,wallstreetbets,BTCS,21,0,21,-21,3,3,3,1,OTC
4749,13-02-2021 14:00,24 hrs.,wallstreetbets,BTSC,7,0,7,-7,1,1,1,1,OTC
4749,13-02-2021 14:00,24 hrs.,wallstreetbets,BTZI,13,0,13,-13,2,2,1,2,OTC
4749,13-02-2021 14:00,24 hrs.,wallstreetbets,BUDZ,6,0,6,-6,1,1,0,1,OTC
4749,13-02-2021 14:00,24 hrs.,wallstreetbets,CBDD,7,0,7,-7,1,1,1,1,OTC
4749,13-02-2021 14:00,24 hrs.,wallstreetbets,CBDL,55,0,55,-55,8,8,7,5,OTC
4749,13-02-2021 14:00,24 hrs.,wallstreetbets,CCTC,7,0,7,-7,1,1,1,1,OTC
4749,13-02-2021 14:00,24 hrs.,wallstreetbets,CGLD,7,0,7,-7,1,1,1,1,OTC
4749,13-02-2021 14:00,24 hrs.,wallstreetbets,CLIS,14,0,14,-14,2,2,2,1,OTC
4749,13-02-2021 14:00,24 hrs.,pennystocks,ARTL,41,0,41,-41,2,13,7,2,NASDAQ
4749,13-02-2021 14:00,24 hrs.,pennystocks,ASRT,174,0,174,-174,5,34,86,5,NASDAQ
4749,13-02-2021 14:00,24 hrs.,pennystocks,ATOS,126,0,126,-126,3,43,28,3,NASDAQ
4749,13-02-2021 14:00,24 hrs.,pennystocks,BCLI,6,0,6,-6,1,0,2,1,NASDAQ
4749,13-02-2021 14:00,24 hrs.,pennystocks,BHTG,14,14,0,14,1,4,2,1,NASDAQ
4749,13-02-2021 14:00,24 hrs.,pennystocks,BIOL,49,43,6,37,2,11,19,2,NASDAQ
4749,13-02-2021 14:00,24 hrs.,pennystocks,BLUE,36,36,0,36,1,8,16,1,NASDAQ
4749,13-02-2021 14:00,24 hrs.,pennystocks,BNGO,62,44,18,26,3,21,8,3,NASDAQ
4749,13-02-2021 14:00,24 hrs.,pennystocks,BWEN,12,0,12,-12,2,2,0,2,NASDAQ
4749,13-02-2021 14:00,24 hrs.,pennystocks,CFMS,12,0,12,-12,2,2,0,2,NASDAQ
4749,13-02-2021 14:00,24 hrs.,pennystocks,CIDM,133,0,133,-133,2,32,61,2,NASDAQ
4749,13-02-2021 14:00,24 hrs.,pennystocks,CKPT,27,0,27,-27,3,4,7,3,NASDAQ
4749,13-02-2021 14:00,24 hrs.,pennystocks,CLBS,259,0,259,-259,5,88,63,5,NASDAQ
4749,13-02-2021 14:00,24 hrs.,pennystocks,CLEU,7,0,7,-7,1,1,1,1,NASDAQ
4749,13-02-2021 14:00,24 hrs.,pennystocks,CMPS,18,18,0,18,1,4,6,1,NASDAQ
4749,13-02-2021 14:00,24 hrs.,pennystocks,COCP,37,0,37,-37,2,13,3,2,NASDAQ
4749,13-02-2021 14:00,24 hrs.,pennystocks,CPLP,20,0,20,-20,2,1,10,1,NASDAQ
4749,13-02-2021 14:00,24 hrs.,pennystocks,CRBP,84,0,84,-84,1,36,8,1,NASDAQ
4749,13-02-2021 14:00,24 hrs.,pennystocks,CRWS,6,0,6,-6,1,1,0,1,NASDAQ
4749,13-02-2021 14:00,24 hrs.,pennystocks,CSCW,7,0,7,-7,1,1,1,1,NASDAQ
4749,13-02-2021 14:00,24 hrs.,pennystocks,CSTR,6,0,6,-6,1,1,0,1,NASDAQ
4749,13-02-2021 14:00,24 hrs.,pennystocks,CTHR,20,0,20,-20,1,6,4,1,NASDAQ
4749,13-02-2021 14:00,24 hrs.,pennystocks,CTMX,12,0,12,-12,1,1,6,1,NASDAQ
4749,13-02-2021 14:00,24 hrs.,pennystocks,CTRM,101,47,54,-7,7,23,27,7,NASDAQ
4749,13-02-2021 14:00,24 hrs.,pennystocks,CTXR,20,0,20,-20,1,6,4,1,NASDAQ
4749,13-02-2021 14:00,24 hrs.,pennystocks,CYTH,8,0,8,-8,1,1,2,1,NASDAQ
4749,13-02-2021 14:00,24 hrs.,pennystocks,DFFN,308,0,308,-308,7,120,40,6,NASDAQ
4749,13-02-2021 14:00,24 hrs.,pennystocks,EBON,6,0,6,-6,1,1,0,1,NASDAQ
4749,13-02-2021 14:00,24 hrs.,pennystocks,EDIT,75,75,0,75,1,27,17,1,NASDAQ
4749,13-02-2021 14:00,24 hrs.,pennystocks,ENTX,28,0,28,-28,1,10,4,1,NASDAQ
4749,13-02-2021 14:00,24 hrs.,pennystocks,EPSN,12,0,12,-12,2,2,0,2,NASDAQ
4749,13-02-2021 14:00,24 hrs.,pennystocks,FAMI,13,0,13,-13,2,2,1,2,NASDAQ
4749,13-02-2021 14:00,24 hrs.,pennystocks,FAST,6,0,6,-6,1,1,0,1,NASDAQ
4749,13-02-2021 14:00,24 hrs.,pennystocks,GAIN,7,0,7,-7,1,1,1,1,NASDAQ
4749,13-02-2021 14:00,24 hrs.,pennystocks,GALT,7,0,7,-7,1,1,1,1,NASDAQ
4749,13-02-2021 14:00,24 hrs.,pennystocks,GEVO,6,0,6,-6,1,1,0,1,NASDAQ
4749,13-02-2021 14:00,24 hrs.,pennystocks,GHSI,105,0,105,-105,1,49,3,1,NASDAQ
4749,13-02-2021 14:00,24 hrs.,pennystocks,GLBS,27,0,27,-27,1,0,23,1,NASDAQ
4749,13-02-2021 14:00,24 hrs.,pennystocks,GNPX,6,0,6,-6,1,0,2,1,NASDAQ
4749,13-02-2021 14:00,24 hrs.,pennystocks,GNUS,6,0,6,-6,1,1,0,1,NASDAQ
4749,13-02-2021 14:00,24 hrs.,pennystocks,GOEV,91,0,91,-91,2,27,29,2,NASDAQ
4749,13-02-2021 14:00,24 hrs.,pennystocks,GOOG,7,7,0,7,1,0,3,1,NASDAQ
4749,13-02-2021 14:00,24 hrs.,pennystocks,HRTX,15,0,15,-15,1,2,7,1,NASDAQ
4749,13-02-2021 14:00,24 hrs.,pennystocks,HSTO,6,0,6,-6,1,1,0,1,NASDAQ
4749,13-02-2021 14:00,24 hrs.,pennystocks,IBKR,7,0,7,-7,1,1,1,1,NASDAQ
4749,13-02-2021 14:00,24 hrs.,pennystocks,IDEX,6,0,6,-6,1,0,2,1,NASDAQ
4749,13-02-2021 14:00,24 hrs.,pennystocks,INFI,12,0,12,-12,1,1,6,1,NASDAQ
4749,13-02-2021 14:00,24 hrs.,pennystocks,INOD,67,0,67,-67,1,10,43,1,NASDAQ
4749,13-02-2021 14:00,24 hrs.,pennystocks,INPX,6,6,0,6,1,1,0,1,NASDAQ
4749,13-02-2021 14:00,24 hrs.,pennystocks,IZEA,6,0,6,-6,1,1,0,1,NASDAQ
4749,13-02-2021 14:00,24 hrs.,pennystocks,KTRA,51,0,51,-51,3,8,23,3,NASDAQ
4749,13-02-2021 14:00,24 hrs.,pennystocks,LIFE,6,6,0,6,1,1,0,1,NASDAQ
4749,13-02-2021 14:00,24 hrs.,pennystocks,LIVX,6,6,0,6,1,1,0,1,NASDAQ
4749,13-02-2021 14:00,24 hrs.,wallstreetbets,EWKS,6,0,6,-6,1,1,0,1,OTC
4749,13-02-2021 14:00,24 hrs.,wallstreetbets,FNMA,7,7,0,7,1,1,1,1,OTC
4749,13-02-2021 14:00,24 hrs.,wallstreetbets,FTEG,14,0,14,-14,2,2,2,1,OTC
4749,13-02-2021 14:00,24 hrs.,wallstreetbets,FTPM,7,0,7,-7,1,1,1,1,OTC
4749,13-02-2021 14:00,24 hrs.,wallstreetbets,GAHC,14,0,14,-14,2,2,2,1,OTC
4749,13-02-2021 14:00,24 hrs.,wallstreetbets,GARB,7,0,7,-7,1,1,1,1,OTC
4749,13-02-2021 14:00,24 hrs.,wallstreetbets,GBTC,6150,0,6150,-6150,2,2895,352,2,OTC
4749,13-02-2021 14:00,24 hrs.,wallstreetbets,GMEV,14,0,14,-14,2,2,2,2,OTC
4749,13-02-2021 14:00,24 hrs.,wallstreetbets,GPFT,27,0,27,-27,4,4,3,4,OTC
4749,13-02-2021 14:00,24 hrs.,wallstreetbets,GRNH,7,7,0,7,1,1,1,1,OTC
4749,13-02-2021 14:00,24 hrs.,wallstreetbets,GTCH,7,0,7,-7,1,1,1,1,OTC
4749,13-02-2021 14:00,24 hrs.,wallstreetbets,GTEH,20,0,20,-20,3,3,2,2,OTC
4749,13-02-2021 14:00,24 hrs.,wallstreetbets,GTLL,6,6,0,6,1,1,0,1,OTC
4749,13-02-2021 14:00,24 hrs.,wallstreetbets,GTXO,14,0,14,-14,2,2,2,1,OTC
4749,13-02-2021 14:00,24 hrs.,wallstreetbets,HCMC,313,82,231,-149,46,46,37,42,OTC
4749,13-02-2021 14:00,24 hrs.,pennystocks,NAOV,6,0,6,-6,1,1,0,1,NASDAQ
4749,13-02-2021 14:00,24 hrs.,pennystocks,NCMI,17,0,17,-17,1,5,3,1,NASDAQ
4749,13-02-2021 14:00,24 hrs.,pennystocks,NMTR,6,6,0,6,1,1,0,1,NASDAQ
4749,13-02-2021 14:00,24 hrs.,pennystocks,NVCN,61,6,55,-49,4,16,13,3,NASDAQ
4749,13-02-2021 14:00,24 hrs.,pennystocks,OCGN,68,6,62,-56,4,17,18,4,NASDAQ
4749,13-02-2021 14:00,24 hrs.,pennystocks,OPTT,26,0,26,-26,1,9,4,1,NASDAQ
4749,13-02-2021 14:00,24 hrs.,pennystocks,OTIC,10,0,10,-10,1,1,4,1,NASDAQ
4749,13-02-2021 14:00,24 hrs.,pennystocks,PLAY,6,0,6,-6,1,1,0,1,NASDAQ
4749,13-02-2021 14:00,24 hrs.,pennystocks,PSEC,6,6,0,6,1,1,0,1,NASDAQ
4749,13-02-2021 14:00,24 hrs.,pennystocks,PTON,44,44,0,44,1,17,6,1,NASDAQ
4749,13-02-2021 14:00,24 hrs.,pennystocks,PULM,194,0,194,-194,4,38,102,4,NASDAQ
4749,13-02-2021 14:00,24 hrs.,pennystocks,RIBT,13,0,13,-13,2,2,1,1,NASDAQ
4749,13-02-2021 14:00,24 hrs.,pennystocks,RIDE,6,0,6,-6,1,1,0,1,NASDAQ
4749,13-02-2021 14:00,24 hrs.,pennystocks,SEAC,5,5,0,5,1,0,1,1,NASDAQ
4749,13-02-2021 14:00,24 hrs.,pennystocks,SELB,20,0,20,-20,1,6,4,1,NASDAQ
4749,13-02-2021 14:00,24 hrs.,pennystocks,SESN,69,0,69,-69,1,30,5,1,NASDAQ
4749,13-02-2021 14:00,24 hrs.,pennystocks,SFET,37,0,37,-37,2,8,13,2,NASDAQ
4749,13-02-2021 14:00,24 hrs.,pennystocks,SHIP,14,0,14,-14,2,2,2,1,NASDAQ
4749,13-02-2021 14:00,24 hrs.,pennystocks,SNDL,63,6,57,-51,10,10,3,9,NASDAQ
4749,13-02-2021 14:00,24 hrs.,pennystocks,SNGX,645,13,632,-619,15,229,127,7,NASDAQ
4749,13-02-2021 14:00,24 hrs.,pennystocks,SRGA,6,0,6,-6,1,1,0,1,NASDAQ
4749,13-02-2021 14:00,24 hrs.,pennystocks,STCN,6,0,6,-6,1,1,0,1,NASDAQ
4749,13-02-2021 14:00,24 hrs.,pennystocks,TBLT,191,185,6,179,2,68,47,2,NASDAQ
4749,13-02-2021 14:00,24 hrs.,pennystocks,TLRY,7,0,7,-7,1,1,1,1,NASDAQ
4749,13-02-2021 14:00,24 hrs.,pennystocks,TNXP,246,6,240,-234,10,77,52,6,NASDAQ
4749,13-02-2021 14:00,24 hrs.,pennystocks,TRCH,250,191,59,132,5,81,68,5,NASDAQ
4749,13-02-2021 14:00,24 hrs.,pennystocks,TRIP,20,20,0,20,1,4,8,1,NASDAQ
4749,13-02-2021 14:00,24 hrs.,pennystocks,TRVG,19,0,19,-19,3,3,1,2,NASDAQ
4749,13-02-2021 14:00,24 hrs.,pennystocks,TXMD,13,6,7,-1,2,2,1,2,NASDAQ
4749,13-02-2021 14:00,24 hrs.,pennystocks,TYME,20,0,20,-20,1,6,4,1,NASDAQ
4749,13-02-2021 14:00,24 hrs.,pennystocks,VEON,7,0,7,-7,1,1,1,1,NASDAQ
4749,13-02-2021 14:00,24 hrs.,pennystocks,VETS,1760,0,1760,-1760,1,747,262,1,NASDAQ
4749,13-02-2021 14:00,24 hrs.,pennystocks,VTGN,7,0,7,-7,1,1,1,1,NASDAQ
4749,13-02-2021 14:00,24 hrs.,pennystocks,VUZI,6,0,6,-6,1,0,2,1,NASDAQ
4749,13-02-2021 14:00,24 hrs.,pennystocks,XSPA,38,0,38,-38,1,15,4,1,NASDAQ
4749,13-02-2021 14:00,24 hrs.,pennystocks,ZSAN,90,0,90,-90,2,27,28,2,NASDAQ
4749,13-02-2021 14:00,24 hrs.,wallstreetbets,ABML,7,0,7,-7,1,1,1,1,OTC
4749,13-02-2021 14:00,24 hrs.,wallstreetbets,ACRL,6,0,6,-6,1,1,0,1,OTC
4749,13-02-2021 14:00,24 hrs.,wallstreetbets,ACTX,8,0,8,-8,1,1,2,1,OTC
4749,13-02-2021 14:00,24 hrs.,wallstreetbets,AITX,23,23,0,23,2,1,13,2,OTC
4749,13-02-2021 14:00,24 hrs.,wallstreetbets,ALPP,7,0,7,-7,1,1,1,1,OTC
4749,13-02-2021 14:00,24 hrs.,wallstreetbets,ALYI,7,0,7,-7,1,1,1,1,OTC
4749,13-02-2021 14:00,24 hrs.,wallstreetbets,AMNE,13,0,13,-13,2,2,1,1,OTC
4749,13-02-2021 14:00,24 hrs.,wallstreetbets,APCX,7,0,7,-7,1,1,1,1,OTC
4749,13-02-2021 14:00,24 hrs.,wallstreetbets,ASTI,7,7,0,7,1,1,1,1,OTC
4749,13-02-2021 14:00,24 hrs.,wallstreetbets,BANT,13,0,13,-13,2,2,1,2,OTC
4749,13-02-2021 14:00,24 hrs.,wallstreetbets,BBRW,20,6,14,-8,3,3,2,2,OTC
4749,13-02-2021 14:00,24 hrs.,wallstreetbets,BLSP,28,7,21,-14,4,4,4,2,OTC
4749,13-02-2021 14:00,24 hrs.,wallstreetbets,BOTH,7,0,7,-7,1,1,1,1,OTC
4749,13-02-2021 14:00,24 hrs.,wallstreetbets,TRTC,21,0,21,-21,3,3,3,2,OTC
4749,13-02-2021 14:00,24 hrs.,wallstreetbets,TSNP,21,7,14,-7,3,3,3,3,OTC
4749,13-02-2021 14:00,24 hrs.,wallstreetbets,UBQU,7,0,7,-7,1,1,1,1,OTC
4749,13-02-2021 14:00,24 hrs.,wallstreetbets,USDC,21,13,8,5,3,3,3,3,OTC
4749,13-02-2021 14:00,24 hrs.,wallstreetbets,USMJ,13,0,13,-13,2,2,1,2,OTC
4749,13-02-2021 14:00,24 hrs.,wallstreetbets,USPS,6,6,0,6,1,1,0,1,OTC
4749,13-02-2021 14:00,24 hrs.,wallstreetbets,UVSE,7,0,7,-7,1,1,1,1,OTC
4749,13-02-2021 14:00,24 hrs.,wallstreetbets,VYST,6,0,6,-6,1,1,0,1,OTC
4749,13-02-2021 14:00,24 hrs.,wallstreetbets,WDDD,7,0,7,-7,1,1,1,1,OTC
4749,13-02-2021 14:00,24 hrs.,wallstreetbets,WDLF,7,0,7,-7,1,1,1,1,OTC
4749,13-02-2021 14:00,24 hrs.,wallstreetbets,WHEN,13,7,6,1,2,2,1,2,OTC
4749,13-02-2021 14:00,24 hrs.,wallstreetbets,WSSE,7,0,7,-7,1,1,1,1,OTC
4749,13-02-2021 14:00,24 hrs.,wallstreetbets,XFLS,4,4,0,4,1,0,0,1,OTC
4749,13-02-2021 14:00,24 hrs.,wallstreetbets,YRIV,21,0,21,-21,1,4,9,1,OTC
4749,13-02-2021 14:00,24 hrs.,wallstreetbets,ZMRK,7,0,7,-7,1,1,1,1,OTC
4749,13-02-2021 14:00,24 hrs.,wallstreetbets,ZNOG,7,0,7,-7,1,1,1,1,OTC
4749,13-02-2021 14:00,24 hrs.,wallstreetbets,AGFAF,7,7,0,7,1,1,1,1,OTC
4749,13-02-2021 14:00,24 hrs.,wallstreetbets,AGUNF,6,0,6,-6,1,1,0,1,OTC
4749,13-02-2021 14:00,24 hrs.,wallstreetbets,AMYZF,23,0,23,-23,3,3,5,2,OTC
4749,13-02-2021 14:00,24 hrs.,wallstreetbets,ARBKF,6,0,6,-6,1,1,0,1,OTC
4749,13-02-2021 14:00,24 hrs.,wallstreetbets,AZKLF,18,0,18,-18,3,3,0,1,OTC
4749,13-02-2021 14:00,24 hrs.,wallstreetbets,BABYF,6,6,0,6,1,1,0,1,OTC
4749,13-02-2021 14:00,24 hrs.,wallstreetbets,BBKCF,6,0,6,-6,1,1,0,1,OTC
4749,13-02-2021 14:00,24 hrs.,wallstreetbets,BDRBF,14,0,14,-14,2,2,2,2,OTC
4749,13-02-2021 14:00,24 hrs.,wallstreetbets,HEMP,27,6,21,-15,4,4,3,3,OTC
4749,13-02-2021 14:00,24 hrs.,wallstreetbets,HGLC,14,0,14,-14,2,2,2,1,OTC
4749,13-02-2021 14:00,24 hrs.,wallstreetbets,HMNY,42,0,42,-42,6,6,6,3,OTC
4749,13-02-2021 14:00,24 hrs.,wallstreetbets,HMPQ,7,0,7,-7,1,1,1,1,OTC
4749,13-02-2021 14:00,24 hrs.,wallstreetbets,HQGE,35,0,35,-35,5,5,5,3,OTC
4749,13-02-2021 14:00,24 hrs.,wallstreetbets,HRBR,6,0,6,-6,1,1,0,1,OTC
4749,13-02-2021 14:00,24 hrs.,wallstreetbets,HTRE,7,0,7,-7,1,1,1,1,OTC
4749,13-02-2021 14:00,24 hrs.,wallstreetbets,HYSR,20,7,13,-6,3,3,2,3,OTC
4749,13-02-2021 14:00,24 hrs.,wallstreetbets,ICBU,7,0,7,-7,1,1,1,1,OTC
4749,13-02-2021 14:00,24 hrs.,wallstreetbets,INCT,21,0,21,-21,3,3,3,2,OTC
4749,13-02-2021 14:00,24 hrs.,wallstreetbets,INKW,7,0,7,-7,1,1,1,1,OTC
4749,13-02-2021 14:00,24 hrs.,wallstreetbets,INND,14,0,14,-14,2,2,2,1,OTC
4749,13-02-2021 14:00,24 hrs.,wallstreetbets,INTV,28,7,21,-14,4,4,4,3,OTC
4749,13-02-2021 14:00,24 hrs.,wallstreetbets,IPIX,12,0,12,-12,1,4,0,1,OTC
4749,13-02-2021 14:00,24 hrs.,wallstreetbets,IQST,13,0,13,-13,2,2,1,1,OTC
4749,13-02-2021 14:00,24 hrs.,wallstreetbets,ITCJ,6,0,6,-6,1,1,0,1,OTC
4749,13-02-2021 14:00,24 hrs.,wallstreetbets,KALY,7,0,7,-7,1,1,1,1,OTC
4749,13-02-2021 14:00,24 hrs.,wallstreetbets,LBCC,7,0,7,-7,1,1,1,1,OTC
4749,13-02-2021 14:00,24 hrs.,wallstreetbets,LINK,26,0,26,-26,4,4,2,4,OTC
4749,13-02-2021 14:00,24 hrs.,wallstreetbets,LITH,7,0,7,-7,1,1,1,1,OTC
4749,13-02-2021 14:00,24 hrs.,wallstreetbets,LQMT,7,7,0,7,1,1,1,1,OTC
4749,13-02-2021 14:00,24 hrs.,wallstreetbets,LRDG,14,14,0,14,2,2,2,1,OTC
4749,13-02-2021 14:00,24 hrs.,wallstreetbets,LTNC,14,0,14,-14,2,2,2,2,OTC
4749,13-02-2021 14:00,24 hrs.,wallstreetbets,LTUM,6,0,6,-6,1,1,0,1,OTC
4749,13-02-2021 14:00,24 hrs.,wallstreetbets,MAXD,22,0,22,-22,3,3,4,3,OTC
4749,13-02-2021 14:00,24 hrs.,wallstreetbets,MCOA,20,0,20,-20,3,3,2,3,OTC
4749,13-02-2021 14:00,24 hrs.,wallstreetbets,MEDH,7,0,7,-7,1,1,1,1,OTC
4749,13-02-2021 14:00,24 hrs.,wallstreetbets,MGNT,7,0,7,-7,1,1,1,1,OTC
4749,13-02-2021 14:00,24 hrs.,wallstreetbets,CLWD,7,0,7,-7,1,1,1,1,OTC
4749,13-02-2021 14:00,24 hrs.,wallstreetbets,COMS,19,0,19,-19,3,3,1,2,OTC
4749,13-02-2021 14:00,24 hrs.,wallstreetbets,CYDY,7,0,7,-7,1,1,1,1,OTC
4749,13-02-2021 14:00,24 hrs.,wallstreetbets,CYLC,7,0,7,-7,1,1,1,1,OTC
4749,13-02-2021 14:00,24 hrs.,wallstreetbets,DGWR,7,0,7,-7,1,1,1,1,OTC
4749,13-02-2021 14:00,24 hrs.,wallstreetbets,DPLS,13,0,13,-13,2,2,1,2,OTC
4749,13-02-2021 14:00,24 hrs.,wallstreetbets,DPWW,7,0,7,-7,1,1,1,1,OTC
4749,13-02-2021 14:00,24 hrs.,wallstreetbets,EFIR,7,7,0,7,1,1,1,1,OTC
4749,13-02-2021 14:00,24 hrs.,wallstreetbets,ELCR,7,0,7,-7,1,1,1,1,OTC
4749,13-02-2021 14:00,24 hrs.,wallstreetbets,ELTP,31,0,31,-31,4,4,7,4,OTC
4749,13-02-2021 14:00,24 hrs.,wallstreetbets,EPOR,8,0,8,-8,1,1,2,1,OTC
4749,13-02-2021 14:00,24 hrs.,wallstreetbets,ETFM,17,0,17,-17,2,2,5,1,OTC
4749,13-02-2021 14:00,24 hrs.,wallstreetbets,RAZFF,7,0,7,-7,1,1,1,1,OTC
4749,13-02-2021 14:00,24 hrs.,wallstreetbets,RLLCF,72,0,72,-72,10,10,12,10,OTC
4749,13-02-2021 14:00,24 hrs.,wallstreetbets,RYCEY,71,7,64,-57,10,10,11,9,OTC
4749,13-02-2021 14:00,24 hrs.,wallstreetbets,SBSAA,7,0,7,-7,1,1,1,1,OTC
4749,13-02-2021 14:00,24 hrs.,wallstreetbets,SHRMF,6,0,6,-6,1,1,0,1,OTC
4749,13-02-2021 14:00,24 hrs.,wallstreetbets,SPRWF,28,0,28,-28,4,4,4,3,OTC
4749,13-02-2021 14:00,24 hrs.,wallstreetbets,TBUIF,13,0,13,-13,2,2,1,1,OTC
4749,13-02-2021 14:00,24 hrs.,wallstreetbets,TCNNF,6149,6,6143,-6137,2,2895,351,2,OTC
4749,13-02-2021 14:00,24 hrs.,wallstreetbets,TGODF,7,0,7,-7,1,1,1,1,OTC
4749,13-02-2021 14:00,24 hrs.,wallstreetbets,TOWTF,12,12,0,12,2,2,0,1,OTC
4749,13-02-2021 14:00,24 hrs.,wallstreetbets,TSCRF,56,0,56,-56,3,5,34,2,OTC
4749,13-02-2021 14:00,24 hrs.,wallstreetbets,TXLZF,7,0,7,-7,1,1,1,1,OTC
4749,13-02-2021 14:00,24 hrs.,wallstreetbets,VALPQ,10,0,10,-10,1,2,2,1,OTC
4749,13-02-2021 14:00,24 hrs.,wallstreetbets,VRYYF,7,7,0,7,1,1,1,1,OTC
4749,13-02-2021 14:00,24 hrs.,wallstreetbets,VVCIF,6,0,6,-6,1,1,0,1,OTC
4749,13-02-2021 14:00,24 hrs.,wallstreetbets,VYGVF,6,6,0,6,1,1,0,1,OTC
4749,13-02-2021 14:00,24 hrs.,wallstreetbets,XJNGF,6,6,0,6,1,1,0,1,OTC
4749,13-02-2021 14:00,24 hrs.,wallstreetbets,ZBISF,7,0,7,-7,1,1,1,1,OTC
4749,13-02-2021 14:00,24 hrs.,wallstreetbets,AAU,14,0,14,-14,2,2,2,2,AMEX
4749,13-02-2021 14:00,24 hrs.,wallstreetbets,BTN,15,0,15,-15,2,2,3,1,AMEX
4749,13-02-2021 14:00,24 hrs.,wallstreetbets,DIT,6,0,6,-6,1,1,0,1,AMEX
4749,13-02-2021 14:00,24 hrs.,wallstreetbets,DNN,166,35,131,-96,24,24,22,19,AMEX
4749,13-02-2021 14:00,24 hrs.,wallstreetbets,DPW,14,0,14,-14,2,2,2,2,AMEX
4749,13-02-2021 14:00,24 hrs.,wallstreetbets,GDP,183,0,183,-183,2,53,69,2,AMEX
4749,13-02-2021 14:00,24 hrs.,wallstreetbets,GLU,7,0,7,-7,1,1,1,1,AMEX
4749,13-02-2021 14:00,24 hrs.,wallstreetbets,MGTI,7,0,7,-7,1,1,1,1,OTC
4749,13-02-2021 14:00,24 hrs.,wallstreetbets,MINE,48,0,48,-48,7,7,6,4,OTC
4749,13-02-2021 14:00,24 hrs.,wallstreetbets,MJNA,34,7,27,-20,5,5,4,5,OTC
4749,13-02-2021 14:00,24 hrs.,wallstreetbets,MKTY,28,7,21,-14,4,4,4,3,OTC
4749,13-02-2021 14:00,24 hrs.,wallstreetbets,MLFB,7,7,0,7,1,1,1,1,OTC
4749,13-02-2021 14:00,24 hrs.,wallstreetbets,MNGG,6,0,6,-6,1,1,0,1,OTC
4749,13-02-2021 14:00,24 hrs.,wallstreetbets,MOJO,13,0,13,-13,2,2,1,1,OTC
4749,13-02-2021 14:00,24 hrs.,wallstreetbets,MOST,57,0,57,-57,4,18,5,4,OTC
4749,13-02-2021 14:00,24 hrs.,wallstreetbets,MRMD,8,8,0,8,1,1,2,1,OTC
4749,13-02-2021 14:00,24 hrs.,wallstreetbets,NBVG,6,0,6,-6,1,1,0,1,OTC
4749,13-02-2021 14:00,24 hrs.,wallstreetbets,NEOM,28,0,28,-28,4,4,4,2,OTC
4749,13-02-2021 14:00,24 hrs.,wallstreetbets,NOVC,28,0,28,-28,4,4,4,2,OTC
4749,13-02-2021 14:00,24 hrs.,wallstreetbets,NPHC,7,0,7,-7,1,1,1,1,OTC
4749,13-02-2021 14:00,24 hrs.,wallstreetbets,NWPN,6,0,6,-6,1,1,0,1,OTC
4749,13-02-2021 14:00,24 hrs.,wallstreetbets,ONPH,6,0,6,-6,1,1,0,1,OTC
4749,13-02-2021 14:00,24 hrs.,wallstreetbets,OTTV,14,0,14,-14,2,2,2,1,OTC
4749,13-02-2021 14:00,24 hrs.,wallstreetbets,OWPC,6,0,6,-6,1,1,0,1,OTC
4749,13-02-2021 14:00,24 hrs.,wallstreetbets,OZSC,14,0,14,-14,2,2,2,2,OTC
4749,13-02-2021 14:00,24 hrs.,wallstreetbets,PAOG,7,0,7,-7,1,1,1,1,OTC
4749,13-02-2021 14:00,24 hrs.,wallstreetbets,PHBI,14,0,14,-14,2,2,2,1,OTC
4749,13-02-2021 14:00,24 hrs.,wallstreetbets,QOIL,6,0,6,-6,1,1,0,1,OTC
4749,13-02-2021 14:00,24 hrs.,wallstreetbets,REFG,7,0,7,-7,1,1,1,1,OTC
4749,13-02-2021 14:00,24 hrs.,wallstreetbets,RELI,6,0,6,-6,1,1,0,1,OTC
4749,13-02-2021 14:00,24 hrs.,wallstreetbets,RSSV,9,0,9,-9,1,2,1,1,OTC
4749,13-02-2021 14:00,24 hrs.,wallstreetbets,RTON,14,0,14,-14,2,2,2,2,OTC
4749,13-02-2021 14:00,24 hrs.,wallstreetbets,SBFM,7,7,0,7,1,1,1,1,OTC
4749,13-02-2021 14:00,24 hrs.,wallstreetbets,SFOR,7,7,0,7,1,1,1,1,OTC
4749,13-02-2021 14:00,24 hrs.,wallstreetbets,SHMP,7,0,7,-7,1,1,1,1,OTC
4749,13-02-2021 14:00,24 hrs.,wallstreetbets,SHWZ,7,0,7,-7,1,1,1,1,OTC
4749,13-02-2021 14:00,24 hrs.,wallstreetbets,SIGN,28,0,28,-28,4,4,4,3,OTC
4749,13-02-2021 14:00,24 hrs.,wallstreetbets,SIMP,7,0,7,-7,1,1,1,1,OTC
4749,13-02-2021 14:00,24 hrs.,wallstreetbets,SIRR,7,0,7,-7,1,1,1,1,OTC
4749,13-02-2021 14:00,24 hrs.,wallstreetbets,SNDD,7,7,0,7,1,1,1,1,OTC
4749,13-02-2021 14:00,24 hrs.,wallstreetbets,SNRS,7,7,0,7,1,1,1,1,OTC
4749,13-02-2021 14:00,24 hrs.,wallstreetbets,SNYR,14,0,14,-14,2,2,2,1,OTC
4749,13-02-2021 14:00,24 hrs.,wallstreetbets,SRMX,13,0,13,-13,2,2,1,2,OTC
4749,13-02-2021 14:00,24 hrs.,wallstreetbets,SUIC,6,0,6,-6,1,1,0,1,OTC
4749,13-02-2021 14:00,24 hrs.,wallstreetbets,TCHH,12,6,6,0,2,2,0,2,OTC
4749,13-02-2021 14:00,24 hrs.,wallstreetbets,TGLO,7,0,7,-7,1,1,1,1,OTC
4749,13-02-2021 14:00,24 hrs.,wallstreetbets,GTE,73,6,67,-61,11,11,7,8,AMEX
4749,13-02-2021 14:00,24 hrs.,wallstreetbets,ITP,7,0,7,-7,1,1,1,1,AMEX
4749,13-02-2021 14:00,24 hrs.,wallstreetbets,MSN,7,0,7,-7,1,1,1,1,AMEX
4749,13-02-2021 14:00,24 hrs.,wallstreetbets,MYO,7,0,7,-7,1,1,1,1,AMEX
4749,13-02-2021 14:00,24 hrs.,wallstreetbets,NAK,51,0,51,-51,8,8,3,7,AMEX
4749,13-02-2021 14:00,24 hrs.,wallstreetbets,NBY,6,6,0,6,1,1,0,1,AMEX
4749,13-02-2021 14:00,24 hrs.,wallstreetbets,PTN,7,0,7,-7,1,1,1,1,AMEX
4749,13-02-2021 14:00,24 hrs.,wallstreetbets,REI,7,0,7,-7,1,1,1,1,AMEX
4749,13-02-2021 14:00,24 hrs.,wallstreetbets,SYN,14,0,14,-14,2,2,2,1,AMEX
4749,13-02-2021 14:00,24 hrs.,wallstreetbets,TGB,6,0,6,-6,1,1,0,1,AMEX
4749,13-02-2021 14:00,24 hrs.,wallstreetbets,TRX,42,7,35,-28,6,6,6,4,AMEX
4749,13-02-2021 14:00,24 hrs.,wallstreetbets,UUU,6,0,6,-6,1,1,0,1,AMEX
4749,13-02-2021 14:00,24 hrs.,wallstreetbets,ZOM,241,26,215,-189,18,61,47,17,AMEX
4749,13-02-2021 14:00,24 hrs.,wallstreetbets,AMPE,34,0,34,-34,5,5,4,3,AMEX
4749,13-02-2021 14:00,24 hrs.,wallstreetbets,CRMD,7,0,7,-7,1,1,1,1,AMEX
4749,13-02-2021 14:00,24 hrs.,wallstreetbets,EMAN,7,0,7,-7,1,1,1,1,AMEX
4749,13-02-2021 14:00,24 hrs.,wallstreetbets,GOED,13,0,13,-13,2,2,1,2,AMEX
4749,13-02-2021 14:00,24 hrs.,wallstreetbets,GSAT,33,7,26,-19,5,5,3,4,AMEX
4749,13-02-2021 14:00,24 hrs.,wallstreetbets,LODE,13,0,13,-13,2,2,1,2,AMEX
4749,13-02-2021 14:00,24 hrs.,wallstreetbets,OGEN,20,0,20,-20,3,3,2,3,AMEX
4749,13-02-2021 14:00,24 hrs.,wallstreetbets,SENS,362,14,348,-334,17,97,100,13,AMEX
4749,13-02-2021 14:00,24 hrs.,wallstreetbets,TMBR,34,0,34,-34,5,5,4,1,AMEX
4749,13-02-2021 14:00,24 hrs.,wallstreetbets,TRXC,13,0,13,-13,2,2,1,2,AMEX
4749,13-02-2021 14:00,24 hrs.,wallstreetbets,UAVS,34,13,21,-8,5,5,4,3,AMEX
4749,13-02-2021 14:00,24 hrs.,wallstreetbets,UUUU,14,0,14,-14,2,2,2,1,AMEX
4749,13-02-2021 14:00,24 hrs.,wallstreetbets,XXII,7,0,7,-7,1,1,1,1,AMEX
4749,13-02-2021 14:00,24 hrs.,wallstreetbets,YCBD,14,0,14,-14,2,2,2,2,AMEX
4749,13-02-2021 14:00,24 hrs.,wallstreetbets,ABT,6,0,6,-6,1,1,0,1,NYSE
4749,13-02-2021 14:00,24 hrs.,wallstreetbets,ACB,160,28,132,-104,23,23,22,19,NYSE
4749,13-02-2021 14:00,24 hrs.,wallstreetbets,ACI,7,0,7,-7,1,1,1,1,NYSE
4749,13-02-2021 14:00,24 hrs.,wallstreetbets,AEM,8,0,8,-8,1,1,2,1,NYSE
4749,13-02-2021 14:00,24 hrs.,wallstreetbets,AFC,7,0,7,-7,1,1,1,1,NYSE
4749,13-02-2021 14:00,24 hrs.,wallstreetbets,CLXPF,7,0,7,-7,1,1,1,1,OTC
4749,13-02-2021 14:00,24 hrs.,wallstreetbets,CNPOF,7,7,0,7,1,1,1,1,OTC
4749,13-02-2021 14:00,24 hrs.,wallstreetbets,CRLBF,12,6,6,0,2,2,0,2,OTC
4749,13-02-2021 14:00,24 hrs.,wallstreetbets,CTTAY,36,0,36,-36,1,10,12,1,OTC
4749,13-02-2021 14:00,24 hrs.,wallstreetbets,CURLF,6,6,0,6,1,1,0,1,OTC
4749,13-02-2021 14:00,24 hrs.,wallstreetbets,CXRXF,7,7,0,7,1,1,1,1,OTC
4749,13-02-2021 14:00,24 hrs.,wallstreetbets,DIAAF,7,0,7,-7,1,1,1,1,OTC
4749,13-02-2021 14:00,24 hrs.,wallstreetbets,EPWCF,7,0,7,-7,1,1,1,1,OTC
4749,13-02-2021 14:00,24 hrs.,wallstreetbets,FDVRF,6,0,6,-6,1,1,0,1,OTC
4749,13-02-2021 14:00,24 hrs.,wallstreetbets,FUNFF,7,7,0,7,1,1,1,1,OTC
4749,13-02-2021 14:00,24 hrs.,wallstreetbets,GAYMF,13,7,6,1,2,2,1,2,OTC
4749,13-02-2021 14:00,24 hrs.,wallstreetbets,GGTTF,7,0,7,-7,1,1,1,1,OTC
4749,13-02-2021 14:00,24 hrs.,wallstreetbets,GTBIF,13,6,7,-1,2,2,1,2,OTC
4749,13-02-2021 14:00,24 hrs.,wallstreetbets,HITIF,48,48,0,48,3,10,16,2,OTC
4749,13-02-2021 14:00,24 hrs.,wallstreetbets,HRSTW,11,0,11,-11,2,1,1,1,OTC
4749,13-02-2021 14:00,24 hrs.,wallstreetbets,HTZGQ,13,13,0,13,2,2,1,2,OTC
4749,13-02-2021 14:00,24 hrs.,wallstreetbets,HUTMF,6,0,6,-6,1,1,0,1,OTC
4749,13-02-2021 14:00,24 hrs.,wallstreetbets,HVBTF,15,0,15,-15,2,2,3,2,OTC
4749,13-02-2021 14:00,24 hrs.,wallstreetbets,IGCIW,49,0,49,-49,7,7,7,2,OTC
4749,13-02-2021 14:00,24 hrs.,wallstreetbets,ISCNF,14,0,14,-14,2,2,2,2,OTC
4749,13-02-2021 14:00,24 hrs.,wallstreetbets,KBEVF,7,0,7,-7,1,1,1,1,OTC
4749,13-02-2021 14:00,24 hrs.,wallstreetbets,LHSIF,7,0,7,-7,1,1,1,1,OTC
4749,13-02-2021 14:00,24 hrs.,wallstreetbets,LKNCY,219,0,219,-219,2,6,199,2,OTC
4749,13-02-2021 14:00,24 hrs.,wallstreetbets,MMEDF,65,0,65,-65,4,19,11,3,OTC
4749,13-02-2021 14:00,24 hrs.,wallstreetbets,MOTNF,7,0,7,-7,1,1,1,1,OTC
4749,13-02-2021 14:00,24 hrs.,wallstreetbets,NONOF,7,7,0,7,1,1,1,1,OTC
4749,13-02-2021 14:00,24 hrs.,wallstreetbets,NTDOY,15,0,15,-15,2,2,3,2,OTC
4749,13-02-2021 14:00,24 hrs.,wallstreetbets,NXGWF,13,0,13,-13,2,2,1,1,OTC
4749,13-02-2021 14:00,24 hrs.,wallstreetbets,NXTTF,14,0,14,-14,2,2,2,1,OTC
4749,13-02-2021 14:00,24 hrs.,wallstreetbets,PCLOF,13,0,13,-13,2,2,1,1,OTC
4749,13-02-2021 14:00,24 hrs.,wallstreetbets,PDYPF,7,0,7,-7,1,1,1,1,OTC
4749,13-02-2021 14:00,24 hrs.,wallstreetbets,PMNXF,6,0,6,-6,1,1,0,1,OTC
4737,13-02-2021 12:00,24 hrs.,stocks,SESN,7,0,7,-7,1,1,1,1,NASDAQ
4737,13-02-2021 12:00,24 hrs.,stocks,SHIP,11,0,11,-11,1,2,3,1,NASDAQ
4737,13-02-2021 12:00,24 hrs.,stocks,SNDL,30,0,30,-30,5,5,0,4,NASDAQ
4737,13-02-2021 12:00,24 hrs.,stocks,SNGX,25,13,12,1,4,4,1,4,NASDAQ
4737,13-02-2021 12:00,24 hrs.,stocks,SRAC,6,0,6,-6,1,1,0,1,NASDAQ
4737,13-02-2021 12:00,24 hrs.,stocks,SRNE,142,0,142,-142,1,43,52,1,NASDAQ
4737,13-02-2021 12:00,24 hrs.,stocks,SVMK,10,0,10,-10,1,2,2,1,NASDAQ
4737,13-02-2021 12:00,24 hrs.,stocks,SWKS,57,0,57,-57,1,11,31,1,NASDAQ
4737,13-02-2021 12:00,24 hrs.,stocks,TIGR,6,0,6,-6,1,1,0,1,NASDAQ
4737,13-02-2021 12:00,24 hrs.,stocks,TLRY,834,6,828,-822,2,227,372,2,NASDAQ
4737,13-02-2021 12:00,24 hrs.,stocks,TRCH,13,6,7,-1,2,2,1,2,NASDAQ
4737,13-02-2021 12:00,24 hrs.,stocks,TRVG,12,0,12,-12,2,2,0,2,NASDAQ
4737,13-02-2021 12:00,24 hrs.,stocks,TSLA,1190,41,1149,-1108,9,433,288,7,NASDAQ
4737,13-02-2021 12:00,24 hrs.,stocks,TTGT,6,0,6,-6,1,1,0,1,NASDAQ
4737,13-02-2021 12:00,24 hrs.,stocks,VRNT,14,0,14,-14,1,3,4,1,NASDAQ
4737,13-02-2021 12:00,24 hrs.,stocks,VRSN,10,0,10,-10,1,2,2,1,NASDAQ
4737,13-02-2021 12:00,24 hrs.,stocks,VUZI,6,0,6,-6,1,1,0,1,NASDAQ
4737,13-02-2021 12:00,24 hrs.,stocks,VXRT,6,0,6,-6,1,1,0,1,NASDAQ
4737,13-02-2021 12:00,24 hrs.,stocks,VXUS,31,21,10,11,2,8,7,2,NASDAQ
4737,13-02-2021 12:00,24 hrs.,stocks,WDAY,14,0,14,-14,1,3,4,1,NASDAQ
4737,13-02-2021 12:00,24 hrs.,stocks,WISH,6,0,6,-6,1,1,0,1,NASDAQ
4737,13-02-2021 12:00,24 hrs.,stocks,AVGO,6,0,6,-6,1,1,0,1,NASDAQ
4737,13-02-2021 12:00,24 hrs.,stocks,BNGO,12,6,6,0,2,2,0,2,NASDAQ
4737,13-02-2021 12:00,24 hrs.,stocks,BYND,6,0,6,-6,1,1,0,1,NASDAQ
4737,13-02-2021 12:00,24 hrs.,stocks,CLVR,15,15,0,15,1,2,7,1,NASDAQ
4737,13-02-2021 12:00,24 hrs.,stocks,CMPS,6,6,0,6,1,1,0,1,NASDAQ
4737,13-02-2021 12:00,24 hrs.,stocks,COHR,10,0,10,-10,1,2,2,1,NASDAQ
4737,13-02-2021 12:00,24 hrs.,stocks,CPST,6,0,6,-6,1,1,0,1,NASDAQ
4737,13-02-2021 12:00,24 hrs.,stocks,CRBP,7,0,7,-7,1,1,1,1,NASDAQ
4737,13-02-2021 12:00,24 hrs.,stocks,CREG,6,6,0,6,1,1,0,1,NASDAQ
4737,13-02-2021 12:00,24 hrs.,stocks,CRNC,23,23,0,23,1,5,9,1,NASDAQ
4737,13-02-2021 12:00,24 hrs.,stocks,CRON,70,0,70,-70,1,18,30,1,NASDAQ
4737,13-02-2021 12:00,24 hrs.,stocks,CRSP,142,0,142,-142,1,43,52,1,NASDAQ
4737,13-02-2021 12:00,24 hrs.,stocks,CRWD,142,0,142,-142,1,43,52,1,NASDAQ
4737,13-02-2021 12:00,24 hrs.,stocks,CTRM,13,0,13,-13,2,2,1,2,NASDAQ
4737,13-02-2021 12:00,24 hrs.,stocks,DDOG,10,0,10,-10,1,2,2,1,NASDAQ
4737,13-02-2021 12:00,24 hrs.,stocks,DFFN,6,0,6,-6,1,1,0,1,NASDAQ
4737,13-02-2021 12:00,24 hrs.,stocks,DOCU,6,0,6,-6,1,1,0,1,NASDAQ
4737,13-02-2021 12:00,24 hrs.,stocks,EDIT,587,55,532,-477,5,189,189,5,NASDAQ
4737,13-02-2021 12:00,24 hrs.,stocks,ENPH,142,0,142,-142,1,43,52,1,NASDAQ
4737,13-02-2021 12:00,24 hrs.,stocks,EXPE,10,0,10,-10,1,2,2,1,NASDAQ
4737,13-02-2021 12:00,24 hrs.,stocks,EXPI,21,15,6,9,3,4,1,3,NASDAQ
4737,13-02-2021 12:00,24 hrs.,stocks,FNKO,26,0,26,-26,1,10,2,1,NASDAQ
4737,13-02-2021 12:00,24 hrs.,stocks,GILT,6,0,6,-6,1,1,0,1,NASDAQ
4737,13-02-2021 12:00,24 hrs.,stocks,GLUU,13,6,7,-1,2,2,1,2,NASDAQ
4737,13-02-2021 12:00,24 hrs.,stocks,GOEV,122,0,122,-122,1,18,82,1,NASDAQ
4737,13-02-2021 12:00,24 hrs.,wallstreetbets,ONTX,14,7,7,0,2,2,2,2,NASDAQ
4737,13-02-2021 12:00,24 hrs.,wallstreetbets,OPGN,7,0,7,-7,1,1,1,1,NASDAQ
4737,13-02-2021 12:00,24 hrs.,wallstreetbets,OPTT,6,0,6,-6,1,1,0,1,NASDAQ
4737,13-02-2021 12:00,24 hrs.,wallstreetbets,PENN,6107,0,6107,-6107,6,2865,353,2,NASDAQ
4737,13-02-2021 12:00,24 hrs.,wallstreetbets,PGNY,7,0,7,-7,1,1,1,1,NASDAQ
4737,13-02-2021 12:00,24 hrs.,wallstreetbets,PHUN,7,0,7,-7,1,1,1,1,NASDAQ
4737,13-02-2021 12:00,24 hrs.,wallstreetbets,PLAY,7,0,7,-7,1,1,1,1,NASDAQ
4737,13-02-2021 12:00,24 hrs.,wallstreetbets,PLUG,7,0,7,-7,1,1,1,1,NASDAQ
4737,13-02-2021 12:00,24 hrs.,wallstreetbets,PLYA,20,0,20,-20,3,3,2,2,NASDAQ
4737,13-02-2021 12:00,24 hrs.,wallstreetbets,POTX,7,0,7,-7,1,1,1,1,NASDAQ
4737,13-02-2021 12:00,24 hrs.,wallstreetbets,POWW,34,7,27,-20,5,5,4,5,NASDAQ
4737,13-02-2021 12:00,24 hrs.,wallstreetbets,PRCH,74,0,74,-74,3,15,32,1,NASDAQ
4737,13-02-2021 12:00,24 hrs.,wallstreetbets,PRPL,1050,0,1050,-1050,1,414,218,1,NASDAQ
4737,13-02-2021 12:00,24 hrs.,wallstreetbets,PRTS,15,0,15,-15,2,2,3,1,NASDAQ
4737,13-02-2021 12:00,24 hrs.,wallstreetbets,PSAC,7,0,7,-7,1,1,1,1,NASDAQ
4737,13-02-2021 12:00,24 hrs.,wallstreetbets,PSEC,6,0,6,-6,1,0,2,1,NASDAQ
4737,13-02-2021 12:00,24 hrs.,wallstreetbets,PTCT,7,0,7,-7,1,1,1,1,NASDAQ
4737,13-02-2021 12:00,24 hrs.,wallstreetbets,PTON,6107,7,6100,-6093,6,2865,353,2,NASDAQ
4737,13-02-2021 12:00,24 hrs.,wallstreetbets,QCOM,7,0,7,-7,1,1,1,1,NASDAQ
4737,13-02-2021 12:00,24 hrs.,wallstreetbets,QFIN,7,0,7,-7,1,1,1,1,NASDAQ
4737,13-02-2021 12:00,24 hrs.,wallstreetbets,QQQJ,20,0,20,-20,1,5,6,1,NASDAQ
4737,13-02-2021 12:00,24 hrs.,stocks,ICLN,102,0,102,-102,1,29,40,1,NASDAQ
4737,13-02-2021 12:00,24 hrs.,stocks,IIVI,10,0,10,-10,1,2,2,1,NASDAQ
4737,13-02-2021 12:00,24 hrs.,stocks,ILMN,22,0,22,-22,1,8,2,1,NASDAQ
4737,13-02-2021 12:00,24 hrs.,stocks,INTC,115,0,115,-115,1,38,35,1,NASDAQ
4737,13-02-2021 12:00,24 hrs.,stocks,INVE,7,0,7,-7,1,1,1,1,NASDAQ
4737,13-02-2021 12:00,24 hrs.,stocks,ITRM,15,6,9,-3,2,3,1,2,NASDAQ
4737,13-02-2021 12:00,24 hrs.,stocks,LITE,10,0,10,-10,1,2,2,1,NASDAQ
4737,13-02-2021 12:00,24 hrs.,stocks,LIVE,10,0,10,-10,1,2,2,1,NASDAQ
4737,13-02-2021 12:00,24 hrs.,stocks,LKCO,12,0,12,-12,2,2,0,1,NASDAQ
4737,13-02-2021 12:00,24 hrs.,stocks,LLNW,26,0,26,-26,1,6,10,1,NASDAQ
4737,13-02-2021 12:00,24 hrs.,stocks,LMPX,26,0,26,-26,1,10,2,1,NASDAQ
4737,13-02-2021 12:00,24 hrs.,stocks,LRCX,57,0,57,-57,1,11,31,1,NASDAQ
4737,13-02-2021 12:00,24 hrs.,stocks,MITK,6,0,6,-6,1,1,0,1,NASDAQ
4737,13-02-2021 12:00,24 hrs.,stocks,MKSI,10,0,10,-10,1,2,2,1,NASDAQ
4737,13-02-2021 12:00,24 hrs.,stocks,MOGO,18,18,0,18,3,3,0,2,NASDAQ
4737,13-02-2021 12:00,24 hrs.,stocks,MRNA,6,6,0,6,1,1,0,1,NASDAQ
4737,13-02-2021 12:00,24 hrs.,stocks,MSFT,395,0,395,-395,1,175,41,1,NASDAQ
4737,13-02-2021 12:00,24 hrs.,stocks,NAKD,6,0,6,-6,1,1,0,1,NASDAQ
4737,13-02-2021 12:00,24 hrs.,stocks,NBAC,6,0,6,-6,1,1,0,1,NASDAQ
4737,13-02-2021 12:00,24 hrs.,stocks,NCMI,60,0,60,-60,2,22,8,1,NASDAQ
4737,13-02-2021 12:00,24 hrs.,stocks,NKLA,6,0,6,-6,1,1,0,1,NASDAQ
4737,13-02-2021 12:00,24 hrs.,stocks,NMTR,9,0,9,-9,1,1,3,1,NASDAQ
4737,13-02-2021 12:00,24 hrs.,stocks,NVDA,108,0,108,-108,3,26,44,3,NASDAQ
4737,13-02-2021 12:00,24 hrs.,stocks,NXTD,6,6,0,6,1,1,0,1,NASDAQ
4737,13-02-2021 12:00,24 hrs.,stocks,OCGN,6,6,0,6,1,1,0,1,NASDAQ
4737,13-02-2021 12:00,24 hrs.,stocks,OCSL,12,0,12,-12,2,2,0,1,NASDAQ
4737,13-02-2021 12:00,24 hrs.,stocks,OLED,121,0,121,-121,1,53,11,1,NASDAQ
4737,13-02-2021 12:00,24 hrs.,stocks,ONCR,7,7,0,7,1,1,1,1,NASDAQ
4737,13-02-2021 12:00,24 hrs.,stocks,ONTX,6,0,6,-6,1,1,0,1,NASDAQ
4737,13-02-2021 12:00,24 hrs.,stocks,ONVO,6,0,6,-6,1,1,0,1,NASDAQ
4737,13-02-2021 12:00,24 hrs.,stocks,PAAS,6,0,6,-6,1,1,0,1,NASDAQ
4737,13-02-2021 12:00,24 hrs.,stocks,PHUN,6,0,6,-6,1,1,0,1,NASDAQ
4737,13-02-2021 12:00,24 hrs.,stocks,PLUG,128,0,128,-128,2,19,82,2,NASDAQ
4737,13-02-2021 12:00,24 hrs.,stocks,PSTV,6,0,6,-6,1,1,0,1,NASDAQ
4737,13-02-2021 12:00,24 hrs.,stocks,QCLN,102,0,102,-102,1,29,40,1,NASDAQ
4737,13-02-2021 12:00,24 hrs.,stocks,QDEL,6,6,0,6,1,1,0,1,NASDAQ
4737,13-02-2021 12:00,24 hrs.,stocks,QFIN,6,0,6,-6,1,1,0,1,NASDAQ
4737,13-02-2021 12:00,24 hrs.,stocks,QQQJ,33,33,0,33,1,5,19,1,NASDAQ
4737,13-02-2021 12:00,24 hrs.,stocks,QQQM,33,33,0,33,1,5,19,1,NASDAQ
4737,13-02-2021 12:00,24 hrs.,stocks,RDFN,9,9,0,9,1,2,1,1,NASDAQ
4737,13-02-2021 12:00,24 hrs.,stocks,REGN,6,6,0,6,1,1,0,1,NASDAQ
4737,13-02-2021 12:00,24 hrs.,stocks,RRGB,29,29,0,29,1,7,11,1,NASDAQ
4737,13-02-2021 12:00,24 hrs.,stocks,SEDG,142,0,142,-142,1,43,52,1,NASDAQ
4737,13-02-2021 12:00,24 hrs.,trakstocks,NXTTF,14,0,14,-14,1,5,0,1,OTC
4737,13-02-2021 12:00,24 hrs.,wallstreetbets,QUIK,7,0,7,-7,1,1,1,1,NASDAQ
4737,13-02-2021 12:00,24 hrs.,wallstreetbets,RAVE,14,0,14,-14,2,2,2,2,NASDAQ
4737,13-02-2021 12:00,24 hrs.,wallstreetbets,RDHL,13,0,13,-13,2,2,1,2,NASDAQ
4737,13-02-2021 12:00,24 hrs.,wallstreetbets,REAL,222,89,133,-44,4,43,120,4,NASDAQ
4737,13-02-2021 12:00,24 hrs.,wallstreetbets,REGI,7,7,0,7,1,1,1,1,NASDAQ
4737,13-02-2021 12:00,24 hrs.,wallstreetbets,REGN,28,14,14,0,4,4,4,2,NASDAQ
4737,13-02-2021 12:00,24 hrs.,wallstreetbets,RIDE,89,0,89,-89,13,13,11,10,NASDAQ
4737,13-02-2021 12:00,24 hrs.,wallstreetbets,RIOT,6199,14,6185,-6171,19,2878,367,14,NASDAQ
4737,13-02-2021 12:00,24 hrs.,wallstreetbets,RKDA,7,0,7,-7,1,1,1,1,NASDAQ
4737,13-02-2021 12:00,24 hrs.,wallstreetbets,ROKU,13,7,6,1,2,2,1,2,NASDAQ
4737,13-02-2021 12:00,24 hrs.,wallstreetbets,ROOT,14,0,14,-14,2,2,2,1,NASDAQ
4737,13-02-2021 12:00,24 hrs.,wallstreetbets,RWLK,21,0,21,-21,3,3,3,3,NASDAQ
4737,13-02-2021 12:00,24 hrs.,wallstreetbets,SAVA,7,0,7,-7,1,1,1,1,NASDAQ
4737,13-02-2021 12:00,24 hrs.,wallstreetbets,SAVE,7,0,7,-7,1,1,1,1,NASDAQ
4737,13-02-2021 12:00,24 hrs.,wallstreetbets,SBUX,7,0,7,-7,1,1,1,1,NASDAQ
4737,13-02-2021 12:00,24 hrs.,wallstreetbets,SEAC,7,0,7,-7,1,1,1,1,NASDAQ
4737,13-02-2021 12:00,24 hrs.,wallstreetbets,SEEL,7,0,7,-7,1,1,1,1,NASDAQ
4737,13-02-2021 12:00,24 hrs.,wallstreetbets,SHIP,138,14,124,-110,20,20,18,16,NASDAQ
4737,13-02-2021 12:00,24 hrs.,wallstreetbets,SIRI,7,0,7,-7,1,1,1,1,NASDAQ
4737,13-02-2021 12:00,24 hrs.,wallstreetbets,SLRX,7,0,7,-7,1,1,1,1,NASDAQ
4737,13-02-2021 12:00,24 hrs.,stocks,XONE,11,11,0,11,1,3,1,1,NASDAQ
4737,13-02-2021 12:00,24 hrs.,stocks,ZGNX,6,0,6,-6,1,1,0,1,NASDAQ
4737,13-02-2021 12:00,24 hrs.,wallstreetbets,LGND,7,0,7,-7,1,1,1,1,NASDAQ
4737,13-02-2021 12:00,24 hrs.,wallstreetbets,LIFE,20,13,7,6,3,3,2,3,NASDAQ
4737,13-02-2021 12:00,24 hrs.,wallstreetbets,LITE,433,0,433,-433,1,177,75,1,NASDAQ
4737,13-02-2021 12:00,24 hrs.,wallstreetbets,LIVE,440,0,440,-440,2,178,76,2,NASDAQ
4737,13-02-2021 12:00,24 hrs.,wallstreetbets,LKCO,42,0,42,-42,6,6,6,5,NASDAQ
4737,13-02-2021 12:00,24 hrs.,wallstreetbets,LLIT,7,0,7,-7,1,1,1,1,NASDAQ
4737,13-02-2021 12:00,24 hrs.,wallstreetbets,LLNW,20,0,20,-20,3,3,2,3,NASDAQ
4737,13-02-2021 12:00,24 hrs.,wallstreetbets,LOAN,14,0,14,-14,2,2,2,2,NASDAQ
4737,13-02-2021 12:00,24 hrs.,wallstreetbets,LPCN,7,0,7,-7,1,1,1,1,NASDAQ
4737,13-02-2021 12:00,24 hrs.,wallstreetbets,LRCX,523,0,523,-523,1,140,239,1,NASDAQ
4737,13-02-2021 12:00,24 hrs.,wallstreetbets,LXRX,7,7,0,7,1,1,1,1,NASDAQ
4737,13-02-2021 12:00,24 hrs.,wallstreetbets,MARA,28,14,14,0,4,4,4,4,NASDAQ
4737,13-02-2021 12:00,24 hrs.,wallstreetbets,MARK,7,0,7,-7,1,1,1,1,NASDAQ
4737,13-02-2021 12:00,24 hrs.,wallstreetbets,MBIO,6,0,6,-6,1,1,0,1,NASDAQ
4737,13-02-2021 12:00,24 hrs.,wallstreetbets,MBRX,26,7,19,-12,4,4,2,4,NASDAQ
4737,13-02-2021 12:00,24 hrs.,wallstreetbets,MESO,7,7,0,7,1,1,1,1,NASDAQ
4737,13-02-2021 12:00,24 hrs.,wallstreetbets,MGNI,14,0,14,-14,2,2,2,2,NASDAQ
4737,13-02-2021 12:00,24 hrs.,wallstreetbets,MKSI,433,0,433,-433,1,177,75,1,NASDAQ
4737,13-02-2021 12:00,24 hrs.,wallstreetbets,MOGO,7,7,0,7,1,1,1,1,NASDAQ
4737,13-02-2021 12:00,24 hrs.,wallstreetbets,MRKR,6,6,0,6,1,1,0,1,NASDAQ
4737,13-02-2021 12:00,24 hrs.,wallstreetbets,MRNA,6,0,6,-6,1,1,0,1,NASDAQ
4737,13-02-2021 12:00,24 hrs.,wallstreetbets,MRVL,7,0,7,-7,1,1,1,1,NASDAQ
4737,13-02-2021 12:00,24 hrs.,wallstreetbets,MSFT,8935,0,8935,-8935,1,4189,553,1,NASDAQ
4737,13-02-2021 12:00,24 hrs.,wallstreetbets,MSTR,13,0,13,-13,2,2,1,2,NASDAQ
4737,13-02-2021 12:00,24 hrs.,wallstreetbets,MTCH,7,0,7,-7,1,1,1,1,NASDAQ
4737,13-02-2021 12:00,24 hrs.,wallstreetbets,MVIS,490,0,490,-490,7,162,138,6,NASDAQ
4737,13-02-2021 12:00,24 hrs.,wallstreetbets,NAKD,132,36,96,-60,19,19,18,12,NASDAQ
4737,13-02-2021 12:00,24 hrs.,wallstreetbets,NBAC,14,0,14,-14,2,2,2,1,NASDAQ
4737,13-02-2021 12:00,24 hrs.,wallstreetbets,NCLH,28,0,28,-28,4,4,4,3,NASDAQ
4737,13-02-2021 12:00,24 hrs.,wallstreetbets,NEOS,7,0,7,-7,1,1,1,1,NASDAQ
4737,13-02-2021 12:00,24 hrs.,wallstreetbets,NFLX,7,0,7,-7,1,1,1,1,NASDAQ
4737,13-02-2021 12:00,24 hrs.,wallstreetbets,NKLA,7,7,0,7,1,1,1,1,NASDAQ
4737,13-02-2021 12:00,24 hrs.,wallstreetbets,NLOK,7,0,7,-7,1,1,1,1,NASDAQ
4737,13-02-2021 12:00,24 hrs.,wallstreetbets,NMRK,6,0,6,-6,1,1,0,1,NASDAQ
4737,13-02-2021 12:00,24 hrs.,wallstreetbets,NNDM,51,30,21,9,4,3,29,2,NASDAQ
4737,13-02-2021 12:00,24 hrs.,wallstreetbets,NOVN,29,15,14,1,4,4,5,3,NASDAQ
4737,13-02-2021 12:00,24 hrs.,wallstreetbets,NUAN,687,0,687,-687,1,297,89,1,NASDAQ
4737,13-02-2021 12:00,24 hrs.,wallstreetbets,NVAX,13,13,0,13,2,2,1,2,NASDAQ
4737,13-02-2021 12:00,24 hrs.,wallstreetbets,NVDA,663,0,663,-663,3,141,369,3,NASDAQ
4737,13-02-2021 12:00,24 hrs.,wallstreetbets,NVIV,7,7,0,7,1,1,1,1,NASDAQ
4737,13-02-2021 12:00,24 hrs.,wallstreetbets,OCGN,45,0,45,-45,7,7,3,6,NASDAQ
4737,13-02-2021 12:00,24 hrs.,wallstreetbets,UNFI,372,0,372,-372,1,170,28,1,NASDAQ
4737,13-02-2021 12:00,24 hrs.,wallstreetbets,VEON,6,0,6,-6,1,1,0,1,NASDAQ
4737,13-02-2021 12:00,24 hrs.,wallstreetbets,VERU,7,0,7,-7,1,1,1,1,NASDAQ
4737,13-02-2021 12:00,24 hrs.,wallstreetbets,VISL,14,7,7,0,2,2,2,2,NASDAQ
4737,13-02-2021 12:00,24 hrs.,stocks,DISCA,12,0,12,-12,2,2,0,2,NASDAQ
4737,13-02-2021 12:00,24 hrs.,stocks,LILAK,12,12,0,12,2,2,0,1,NASDAQ
4737,13-02-2021 12:00,24 hrs.,stocks,SRACU,6,0,6,-6,1,1,0,1,NASDAQ
4737,13-02-2021 12:00,24 hrs.,stocks,SRACW,6,0,6,-6,1,1,0,1,NASDAQ
4737,13-02-2021 12:00,24 hrs.,Daytrading,SGMD,17,0,17,-17,1,3,7,1,OTC
4737,13-02-2021 12:00,24 hrs.,Daytrading,HVBTF,10,10,0,10,1,2,2,1,OTC
4737,13-02-2021 12:00,24 hrs.,Daytrading,DNN,506,0,506,-506,2,210,78,2,AMEX
4737,13-02-2021 12:00,24 hrs.,Daytrading,DSS,500,0,500,-500,1,209,78,1,AMEX
4737,13-02-2021 12:00,24 hrs.,Daytrading,GTE,7,7,0,7,1,1,1,1,AMEX
4737,13-02-2021 12:00,24 hrs.,Daytrading,ACB,506,0,506,-506,2,210,78,2,NYSE
4737,13-02-2021 12:00,24 hrs.,Daytrading,ADX,9,0,9,-9,1,2,1,1,NYSE
4737,13-02-2021 12:00,24 hrs.,Daytrading,AMC,6,0,6,-6,1,1,0,1,NYSE
4737,13-02-2021 12:00,24 hrs.,Daytrading,BDX,7,0,7,-7,1,1,1,1,NYSE
4737,13-02-2021 12:00,24 hrs.,Daytrading,FSR,500,0,500,-500,1,209,78,1,NYSE
4737,13-02-2021 12:00,24 hrs.,Daytrading,GME,262,0,262,-262,2,104,46,2,NYSE
4737,13-02-2021 12:00,24 hrs.,Daytrading,NIO,8,8,0,8,1,1,2,1,NYSE
4737,13-02-2021 12:00,24 hrs.,Daytrading,PDT,31,7,24,-17,2,5,13,2,NYSE
4737,13-02-2021 12:00,24 hrs.,Daytrading,RTP,500,0,500,-500,1,209,78,1,NYSE
4737,13-02-2021 12:00,24 hrs.,Daytrading,WLL,6,0,6,-6,1,1,0,1,NYSE
4737,13-02-2021 12:00,24 hrs.,Daytrading,CCIV,500,0,500,-500,1,209,78,1,NYSE
4737,13-02-2021 12:00,24 hrs.,Daytrading,CHWY,6,0,6,-6,1,1,0,1,NYSE
4737,13-02-2021 12:00,24 hrs.,Daytrading,SPCE,500,0,500,-500,1,209,78,1,NYSE
4737,13-02-2021 12:00,24 hrs.,Daytrading,API,326,0,326,-326,1,141,40,1,NASDAQ
4737,13-02-2021 12:00,24 hrs.,Daytrading,INO,500,0,500,-500,1,209,78,1,NASDAQ
4737,13-02-2021 12:00,24 hrs.,Daytrading,AAPL,8,8,0,8,1,1,2,1,NASDAQ
4737,13-02-2021 12:00,24 hrs.,Daytrading,ACST,6,0,6,-6,1,1,0,1,NASDAQ
4737,13-02-2021 12:00,24 hrs.,Daytrading,APDN,500,0,500,-500,1,209,78,1,NASDAQ
4737,13-02-2021 12:00,24 hrs.,Daytrading,APHA,500,0,500,-500,1,209,78,1,NASDAQ
4737,13-02-2021 12:00,24 hrs.,Daytrading,ARTL,617,6,611,-605,7,247,95,7,NASDAQ
4737,13-02-2021 12:00,24 hrs.,Daytrading,BNGO,105,0,105,-105,1,40,21,1,NASDAQ
4737,13-02-2021 12:00,24 hrs.,Daytrading,CLEU,561,0,561,-561,2,233,87,2,NASDAQ
4737,13-02-2021 12:00,24 hrs.,Daytrading,CLGN,500,0,500,-500,1,209,78,1,NASDAQ
4737,13-02-2021 12:00,24 hrs.,Daytrading,CLSN,500,0,500,-500,1,209,78,1,NASDAQ
4737,13-02-2021 12:00,24 hrs.,Daytrading,CMLF,500,0,500,-500,1,209,78,1,NASDAQ
4737,13-02-2021 12:00,24 hrs.,Daytrading,CRSR,500,0,500,-500,1,209,78,1,NASDAQ
4737,13-02-2021 12:00,24 hrs.,Daytrading,EBON,6,0,6,-6,1,1,0,1,NASDAQ
4737,13-02-2021 12:00,24 hrs.,Daytrading,FOLD,506,0,506,-506,2,210,78,2,NASDAQ
4737,13-02-2021 12:00,24 hrs.,Daytrading,FTFT,500,0,500,-500,1,209,78,1,NASDAQ
4737,13-02-2021 12:00,24 hrs.,Daytrading,LIVE,130,0,130,-130,2,51,20,1,NASDAQ
4737,13-02-2021 12:00,24 hrs.,Daytrading,MARA,500,0,500,-500,1,209,78,1,NASDAQ
4737,13-02-2021 12:00,24 hrs.,Daytrading,NOVN,500,0,500,-500,1,209,78,1,NASDAQ
4737,13-02-2021 12:00,24 hrs.,Daytrading,OCGN,26,0,26,-26,1,3,16,1,NASDAQ
4737,13-02-2021 12:00,24 hrs.,Daytrading,PYPL,500,0,500,-500,1,209,78,1,NASDAQ
4737,13-02-2021 12:00,24 hrs.,Daytrading,RIDE,500,0,500,-500,1,209,78,1,NASDAQ
4737,13-02-2021 12:00,24 hrs.,Daytrading,RIOT,510,10,500,-490,2,211,80,2,NASDAQ
4737,13-02-2021 12:00,24 hrs.,Daytrading,STAY,41,0,41,-41,1,18,1,1,NASDAQ
4737,13-02-2021 12:00,24 hrs.,Daytrading,TLRY,507,7,500,-493,2,210,79,2,NASDAQ
4737,13-02-2021 12:00,24 hrs.,Daytrading,TSLA,11,11,0,11,1,1,5,1,NASDAQ
4737,13-02-2021 12:00,24 hrs.,Daytrading,WAFU,61,0,61,-61,1,24,9,1,NASDAQ
4737,13-02-2021 12:00,24 hrs.,Daytrading,XERS,500,0,500,-500,1,209,78,1,NASDAQ
4737,13-02-2021 12:00,24 hrs.,trakstocks,ALPP,6,0,6,-6,1,1,0,1,OTC
4737,13-02-2021 12:00,24 hrs.,trakstocks,BRTX,9,0,9,-9,1,2,1,1,OTC
4737,13-02-2021 12:00,24 hrs.,trakstocks,HCMC,7,7,0,7,1,0,3,1,OTC
4737,13-02-2021 12:00,24 hrs.,trakstocks,INND,7,7,0,7,1,0,3,1,OTC
4737,13-02-2021 12:00,24 hrs.,trakstocks,MMEX,20,0,20,-20,2,3,6,2,OTC
4737,13-02-2021 12:00,24 hrs.,trakstocks,MOST,6,0,6,-6,1,1,0,1,OTC
4737,13-02-2021 12:00,24 hrs.,trakstocks,ARBKF,6,0,6,-6,1,1,0,1,OTC
4737,13-02-2021 12:00,24 hrs.,trakstocks,BBXIA,6,0,6,-6,1,1,0,1,OTC
4737,13-02-2021 12:00,24 hrs.,trakstocks,MGROF,14,14,0,14,1,4,2,1,OTC
4737,13-02-2021 12:00,24 hrs.,trakstocks,NMGRF,46,0,46,-46,1,17,8,1,OTC
4737,13-02-2021 12:00,24 hrs.,RobinHoodPennyStocks,NXTTF,6,0,6,-6,1,1,0,1,OTC
4737,13-02-2021 12:00,24 hrs.,RobinHoodPennyStocks,PMEDF,6,0,6,-6,1,1,0,1,OTC
4737,13-02-2021 12:00,24 hrs.,RobinHoodPennyStocks,RYCEY,18,0,18,-18,3,3,0,3,OTC
4737,13-02-2021 12:00,24 hrs.,RobinHoodPennyStocks,SHCAY,21,0,21,-21,1,8,1,1,OTC
4737,13-02-2021 12:00,24 hrs.,trakstocks,PYRNF,16,0,16,-16,2,3,2,2,OTC
4737,13-02-2021 12:00,24 hrs.,trakstocks,VRYYF,7,7,0,7,1,1,1,1,OTC
4737,13-02-2021 12:00,24 hrs.,trakstocks,DNN,83,0,83,-83,1,31,17,1,AMEX
4737,13-02-2021 12:00,24 hrs.,trakstocks,DPW,12,6,6,0,2,2,0,2,AMEX
4737,13-02-2021 12:00,24 hrs.,trakstocks,TRXC,170,0,170,-170,1,60,46,1,AMEX
4737,13-02-2021 12:00,24 hrs.,trakstocks,AMC,25,0,25,-25,1,2,17,1,NYSE
4737,13-02-2021 12:00,24 hrs.,trakstocks,BFT,6,6,0,6,1,1,0,1,NYSE
4737,13-02-2021 12:00,24 hrs.,trakstocks,GME,25,0,25,-25,1,2,17,1,NYSE
4737,13-02-2021 12:00,24 hrs.,trakstocks,SOL,8,0,8,-8,1,2,0,1,NYSE
4737,13-02-2021 12:00,24 hrs.,trakstocks,SOS,23,0,23,-23,1,9,1,1,NYSE
4737,13-02-2021 12:00,24 hrs.,trakstocks,SWN,9,9,0,9,1,2,1,1,NYSE
4737,13-02-2021 12:00,24 hrs.,trakstocks,ARGO,6,0,6,-6,1,1,0,1,NYSE
4737,13-02-2021 12:00,24 hrs.,trakstocks,PLTR,19,19,0,19,1,6,3,1,NYSE
4737,13-02-2021 12:00,24 hrs.,trakstocks,STPK,83,60,23,37,4,25,17,3,NYSE
4737,13-02-2021 12:00,24 hrs.,trakstocks,AQB,13,0,13,-13,1,3,3,1,NASDAQ
4737,13-02-2021 12:00,24 hrs.,trakstocks,OEG,29,0,29,-29,1,10,5,1,NASDAQ
4737,13-02-2021 12:00,24 hrs.,trakstocks,APPS,6,0,6,-6,1,1,0,1,NASDAQ
4737,13-02-2021 12:00,24 hrs.,trakstocks,AYRO,152,12,140,-128,3,51,38,3,NASDAQ
4737,13-02-2021 12:00,24 hrs.,trakstocks,BHTG,440,0,440,-440,1,164,108,1,NASDAQ
4737,13-02-2021 12:00,24 hrs.,trakstocks,CFII,83,0,83,-83,1,28,23,1,NASDAQ
4737,13-02-2021 12:00,24 hrs.,trakstocks,CLVS,13,13,0,13,1,3,3,1,NASDAQ
4737,13-02-2021 12:00,24 hrs.,trakstocks,CPSH,46,0,46,-46,2,13,12,2,NASDAQ
4737,13-02-2021 12:00,24 hrs.,trakstocks,EXPC,10,0,10,-10,1,2,2,1,NASDAQ
4737,13-02-2021 12:00,24 hrs.,trakstocks,GTHX,6,0,6,-6,1,1,0,1,NASDAQ
4737,13-02-2021 12:00,24 hrs.,trakstocks,IMMR,46,0,46,-46,1,16,10,1,NASDAQ
4737,13-02-2021 12:00,24 hrs.,trakstocks,LIFE,12,12,0,12,1,0,8,1,NASDAQ
4737,13-02-2021 12:00,24 hrs.,trakstocks,MARA,37,0,37,-37,1,14,5,1,NASDAQ
4737,13-02-2021 12:00,24 hrs.,wallstreetbets,SNCA,6,0,6,-6,1,1,0,1,NASDAQ
4737,13-02-2021 12:00,24 hrs.,wallstreetbets,SNDL,2495,213,2282,-2069,203,550,583,167,NASDAQ
4737,13-02-2021 12:00,24 hrs.,wallstreetbets,SNGX,40,25,15,10,6,6,4,6,NASDAQ
4737,13-02-2021 12:00,24 hrs.,wallstreetbets,SQQQ,7,0,7,-7,1,1,1,1,NASDAQ
4737,13-02-2021 12:00,24 hrs.,wallstreetbets,SRAC,13,7,6,1,2,2,1,2,NASDAQ
4737,13-02-2021 12:00,24 hrs.,wallstreetbets,SRGA,7,0,7,-7,1,1,1,1,NASDAQ
4737,13-02-2021 12:00,24 hrs.,wallstreetbets,SRNE,14,7,7,0,2,2,2,2,NASDAQ
4737,13-02-2021 12:00,24 hrs.,wallstreetbets,SSRM,6,6,0,6,1,1,0,1,NASDAQ
4737,13-02-2021 12:00,24 hrs.,wallstreetbets,STAF,20,13,7,6,3,3,2,3,NASDAQ
4737,13-02-2021 12:00,24 hrs.,wallstreetbets,STAY,12,6,6,0,2,2,0,2,NASDAQ
4737,13-02-2021 12:00,24 hrs.,wallstreetbets,STEP,16,0,16,-16,1,0,12,1,NASDAQ
4737,13-02-2021 12:00,24 hrs.,wallstreetbets,STLD,7,0,7,-7,1,1,1,1,NASDAQ
4737,13-02-2021 12:00,24 hrs.,wallstreetbets,SVMK,433,0,433,-433,1,177,75,1,NASDAQ
4737,13-02-2021 12:00,24 hrs.,wallstreetbets,SWBI,28,21,7,14,4,4,4,3,NASDAQ
4737,13-02-2021 12:00,24 hrs.,wallstreetbets,SWKS,523,0,523,-523,1,140,239,1,NASDAQ
4737,13-02-2021 12:00,24 hrs.,wallstreetbets,TECH,7,7,0,7,1,1,1,1,NASDAQ
4737,13-02-2021 12:00,24 hrs.,wallstreetbets,TELL,7,0,7,-7,1,1,1,1,NASDAQ
4737,13-02-2021 12:00,24 hrs.,wallstreetbets,THCB,6,0,6,-6,1,1,0,1,NASDAQ
4737,13-02-2021 12:00,24 hrs.,wallstreetbets,THMO,13,0,13,-13,2,2,1,1,NASDAQ
4737,13-02-2021 12:00,24 hrs.,wallstreetbets,TLGT,7,0,7,-7,1,1,1,1,NASDAQ
4737,13-02-2021 12:00,24 hrs.,wallstreetbets,TLRY,1184,832,352,480,53,331,310,46,NASDAQ
4737,13-02-2021 12:00,24 hrs.,wallstreetbets,TLSA,7,0,7,-7,1,1,1,1,NASDAQ
4737,13-02-2021 12:00,24 hrs.,wallstreetbets,TNXP,70,14,56,-42,10,10,10,5,NASDAQ
4737,13-02-2021 12:00,24 hrs.,wallstreetbets,TOPS,100,14,86,-72,14,15,14,11,NASDAQ
4737,13-02-2021 12:00,24 hrs.,wallstreetbets,TOWN,173,0,173,-173,1,56,57,1,NASDAQ
4737,13-02-2021 12:00,24 hrs.,wallstreetbets,TQQQ,35,21,14,7,5,5,5,2,NASDAQ
4737,13-02-2021 12:00,24 hrs.,wallstreetbets,TRCH,26,12,14,-2,4,4,2,4,NASDAQ
4737,13-02-2021 12:00,24 hrs.,wallstreetbets,TRIT,52,13,39,-26,8,8,4,6,NASDAQ
4737,13-02-2021 12:00,24 hrs.,wallstreetbets,TRVG,2884,0,2884,-2884,29,1054,660,19,NASDAQ
4737,13-02-2021 12:00,24 hrs.,wallstreetbets,TSLA,9343,444,8899,-8455,28,4085,1061,20,NASDAQ
4737,13-02-2021 12:00,24 hrs.,wallstreetbets,TTCF,7,0,7,-7,1,1,1,1,NASDAQ
4737,13-02-2021 12:00,24 hrs.,wallstreetbets,TTOO,7,0,7,-7,1,1,1,1,NASDAQ
4737,13-02-2021 12:00,24 hrs.,wallstreetbets,TXMD,14,0,14,-14,2,2,2,2,NASDAQ
4737,13-02-2021 12:00,24 hrs.,StockMarket,MAXD,48,0,48,-48,3,13,10,3,OTC
4737,13-02-2021 12:00,24 hrs.,StockMarket,MOST,15,0,15,-15,1,4,3,1,OTC
4737,13-02-2021 12:00,24 hrs.,StockMarket,PCTL,6,0,6,-6,1,1,0,1,OTC
4737,13-02-2021 12:00,24 hrs.,StockMarket,PHIL,8,0,8,-8,1,2,0,1,OTC
4737,13-02-2021 12:00,24 hrs.,StockMarket,RSSV,23,0,23,-23,1,8,3,1,OTC
4737,13-02-2021 12:00,24 hrs.,StockMarket,SGMD,168,0,168,-168,6,43,58,2,OTC
4737,13-02-2021 12:00,24 hrs.,StockMarket,AYRWF,21,0,21,-21,1,6,5,1,OTC
4737,13-02-2021 12:00,24 hrs.,StockMarket,BMWLF,21,0,21,-21,1,6,5,1,OTC
4737,13-02-2021 12:00,24 hrs.,StockMarket,CRLBF,21,0,21,-21,1,6,5,1,OTC
4737,13-02-2021 12:00,24 hrs.,StockMarket,CURLF,21,0,21,-21,1,6,5,1,OTC
4737,13-02-2021 12:00,24 hrs.,StockMarket,DIGAF,6,0,6,-6,1,1,0,1,OTC
4737,13-02-2021 12:00,24 hrs.,StockMarket,GTBIF,21,0,21,-21,1,6,5,1,OTC
4737,13-02-2021 12:00,24 hrs.,StockMarket,HTZGQ,6,0,6,-6,1,1,0,1,OTC
4737,13-02-2021 12:00,24 hrs.,StockMarket,LHSIF,21,0,21,-21,1,6,5,1,OTC
4737,13-02-2021 12:00,24 hrs.,StockMarket,NMGRF,6,0,6,-6,1,1,0,1,OTC
4737,13-02-2021 12:00,24 hrs.,StockMarket,RAZFF,6,0,6,-6,1,1,0,1,OTC
4737,13-02-2021 12:00,24 hrs.,StockMarket,RHDGF,18,0,18,-18,2,3,4,1,OTC
4737,13-02-2021 12:00,24 hrs.,StockMarket,RWBYF,21,0,21,-21,1,6,5,1,OTC
4737,13-02-2021 12:00,24 hrs.,StockMarket,RYCEY,12,0,12,-12,2,2,0,2,OTC
4737,13-02-2021 12:00,24 hrs.,StockMarket,TCNNF,21,0,21,-21,1,6,5,1,OTC
4737,13-02-2021 12:00,24 hrs.,StockMarket,TFECY,18,0,18,-18,3,3,0,1,OTC
4737,13-02-2021 12:00,24 hrs.,StockMarket,ZBISF,30,0,30,-30,1,9,8,1,OTC
4737,13-02-2021 12:00,24 hrs.,StockMarket,DNN,20,0,20,-20,2,5,2,2,AMEX
4737,13-02-2021 12:00,24 hrs.,wallstreetbets,VIVO,7,7,0,7,1,1,1,1,NASDAQ
4737,13-02-2021 12:00,24 hrs.,wallstreetbets,VKTX,7,0,7,-7,1,1,1,1,NASDAQ
4737,13-02-2021 12:00,24 hrs.,wallstreetbets,VLDR,7,0,7,-7,1,1,1,1,NASDAQ
4737,13-02-2021 12:00,24 hrs.,wallstreetbets,VOXX,6,6,0,6,1,1,0,1,NASDAQ
4737,13-02-2021 12:00,24 hrs.,wallstreetbets,VRSN,433,0,433,-433,1,177,75,1,NASDAQ
4737,13-02-2021 12:00,24 hrs.,wallstreetbets,VSAT,14,0,14,-14,2,2,2,1,NASDAQ
4737,13-02-2021 12:00,24 hrs.,wallstreetbets,VTGN,7,7,0,7,1,1,1,1,NASDAQ
4737,13-02-2021 12:00,24 hrs.,wallstreetbets,VUZI,21,21,0,21,3,3,3,1,NASDAQ
4737,13-02-2021 12:00,24 hrs.,wallstreetbets,VXRT,28,7,21,-14,4,4,4,4,NASDAQ
4737,13-02-2021 12:00,24 hrs.,wallstreetbets,WATT,14,7,7,0,2,2,2,2,NASDAQ
4737,13-02-2021 12:00,24 hrs.,wallstreetbets,WKHS,8162,20,8142,-8122,5,3732,678,4,NASDAQ
4737,13-02-2021 12:00,24 hrs.,wallstreetbets,WRAP,7,0,7,-7,1,1,1,1,NASDAQ
4737,13-02-2021 12:00,24 hrs.,wallstreetbets,WSBC,8,8,0,8,1,1,2,1,NASDAQ
4737,13-02-2021 12:00,24 hrs.,wallstreetbets,XENE,14,0,14,-14,2,2,2,1,NASDAQ
4737,13-02-2021 12:00,24 hrs.,wallstreetbets,XERS,7,0,7,-7,1,1,1,1,NASDAQ
4737,13-02-2021 12:00,24 hrs.,wallstreetbets,XNET,14,0,14,-14,2,2,2,1,NASDAQ
4737,13-02-2021 12:00,24 hrs.,wallstreetbets,XSPA,58,6,52,-46,9,9,4,8,NASDAQ
4737,13-02-2021 12:00,24 hrs.,wallstreetbets,ZNGA,15,8,7,1,2,2,3,2,NASDAQ
4737,13-02-2021 12:00,24 hrs.,wallstreetbets,ZYNE,7,0,7,-7,1,1,1,1,NASDAQ
4737,13-02-2021 12:00,24 hrs.,wallstreetbets,CMCSA,7,0,7,-7,1,1,1,1,NASDAQ
4737,13-02-2021 12:00,24 hrs.,wallstreetbets,GOOGL,6,0,6,-6,1,1,0,1,NASDAQ
4737,13-02-2021 12:00,24 hrs.,wallstreetbets,SRACU,6,0,6,-6,1,1,0,1,NASDAQ
4737,13-02-2021 12:00,24 hrs.,wallstreetbets,SRACW,6,0,6,-6,1,1,0,1,NASDAQ
4737,13-02-2021 12:00,24 hrs.,RobinHoodPennyStocks,BGMD,4,0,4,-4,1,0,0,1,OTC
4737,13-02-2021 12:00,24 hrs.,RobinHoodPennyStocks,BLXX,6,0,6,-6,1,1,0,1,OTC
4737,13-02-2021 12:00,24 hrs.,RobinHoodPennyStocks,CBDD,6,0,6,-6,1,1,0,1,OTC
4737,13-02-2021 12:00,24 hrs.,RobinHoodPennyStocks,CRWG,6,6,0,6,1,1,0,1,OTC
4737,13-02-2021 12:00,24 hrs.,RobinHoodPennyStocks,GLEC,6,0,6,-6,1,1,0,1,OTC
4737,13-02-2021 12:00,24 hrs.,RobinHoodPennyStocks,GPFT,24,0,24,-24,4,4,0,2,OTC
4737,13-02-2021 12:00,24 hrs.,RobinHoodPennyStocks,GSPH,6,0,6,-6,1,1,0,1,OTC
4737,13-02-2021 12:00,24 hrs.,RobinHoodPennyStocks,GTLL,6,6,0,6,1,1,0,1,OTC
4737,13-02-2021 12:00,24 hrs.,RobinHoodPennyStocks,HCMC,12,0,12,-12,2,2,0,2,OTC
4737,13-02-2021 12:00,24 hrs.,RobinHoodPennyStocks,INKW,6,0,6,-6,1,1,0,1,OTC
4737,13-02-2021 12:00,24 hrs.,RobinHoodPennyStocks,LTUM,6,0,6,-6,1,1,0,1,OTC
4737,13-02-2021 12:00,24 hrs.,RobinHoodPennyStocks,MJNA,6,0,6,-6,1,1,0,1,OTC
4737,13-02-2021 12:00,24 hrs.,RobinHoodPennyStocks,NUUU,6,0,6,-6,1,1,0,1,OTC
4737,13-02-2021 12:00,24 hrs.,RobinHoodPennyStocks,PHIL,6,0,6,-6,1,1,0,1,OTC
4737,13-02-2021 12:00,24 hrs.,RobinHoodPennyStocks,ALLIF,6,6,0,6,1,1,0,1,OTC
4737,13-02-2021 12:00,24 hrs.,RobinHoodPennyStocks,BDRBF,12,0,12,-12,2,2,0,2,OTC
4737,13-02-2021 12:00,24 hrs.,RobinHoodPennyStocks,MEDIF,6,6,0,6,1,1,0,1,OTC
4737,13-02-2021 12:00,24 hrs.,RobinHoodPennyStocks,MMEDF,17,17,0,17,1,4,5,1,OTC
4737,13-02-2021 12:00,24 hrs.,StockMarket,FSR,15,0,15,-15,1,4,3,1,NYSE
4737,13-02-2021 12:00,24 hrs.,StockMarket,GME,80,36,44,-8,5,12,36,5,NYSE
4737,13-02-2021 12:00,24 hrs.,StockMarket,IBM,50,0,50,-50,1,22,2,1,NYSE
4737,13-02-2021 12:00,24 hrs.,StockMarket,JNJ,6,0,6,-6,1,1,0,1,NYSE
4737,13-02-2021 12:00,24 hrs.,StockMarket,JPM,14,14,0,14,1,1,8,1,NYSE
4737,13-02-2021 12:00,24 hrs.,StockMarket,LLY,50,0,50,-50,1,22,2,1,NYSE
4737,13-02-2021 12:00,24 hrs.,StockMarket,MCO,15,0,15,-15,1,4,3,1,NYSE
4737,13-02-2021 12:00,24 hrs.,StockMarket,MRO,15,0,15,-15,1,4,3,1,NYSE
4737,13-02-2021 12:00,24 hrs.,StockMarket,NIO,261,0,261,-261,3,96,57,3,NYSE
4737,13-02-2021 12:00,24 hrs.,StockMarket,PHI,8,0,8,-8,1,2,0,1,NYSE
4737,13-02-2021 12:00,24 hrs.,StockMarket,PMO,6,6,0,6,1,1,0,1,NYSE
4737,13-02-2021 12:00,24 hrs.,StockMarket,PSA,6,0,6,-6,1,1,0,1,NYSE
4737,13-02-2021 12:00,24 hrs.,StockMarket,SBE,6,0,6,-6,1,1,0,1,NYSE
4737,13-02-2021 12:00,24 hrs.,StockMarket,SMG,21,0,21,-21,1,6,5,1,NYSE
4737,13-02-2021 12:00,24 hrs.,StockMarket,SOS,27,6,21,-15,3,6,3,3,NYSE
4737,13-02-2021 12:00,24 hrs.,StockMarket,TDA,13,0,13,-13,1,1,7,1,NYSE
4737,13-02-2021 12:00,24 hrs.,StockMarket,VRT,12,12,0,12,1,3,2,1,NYSE
4737,13-02-2021 12:00,24 hrs.,StockMarket,XPO,50,0,50,-50,1,22,2,1,NYSE
4737,13-02-2021 12:00,24 hrs.,StockMarket,CCIV,41,6,35,-29,3,11,7,2,NYSE
4737,13-02-2021 12:00,24 hrs.,StockMarket,CHWY,6,0,6,-6,1,1,0,1,NYSE
4737,13-02-2021 12:00,24 hrs.,StockMarket,COTY,17,0,17,-17,2,2,5,1,NYSE
4737,13-02-2021 12:00,24 hrs.,StockMarket,DSSI,6,0,6,-6,1,1,0,1,NYSE
4737,13-02-2021 12:00,24 hrs.,StockMarket,FUSE,12,0,12,-12,2,2,0,2,NYSE
4737,13-02-2021 12:00,24 hrs.,StockMarket,GDDY,50,0,50,-50,1,22,2,1,NYSE
4737,13-02-2021 12:00,24 hrs.,StockMarket,GNRC,50,0,50,-50,1,22,2,1,NYSE
4737,13-02-2021 12:00,24 hrs.,StockMarket,HEXO,11,0,11,-11,1,3,1,1,NYSE
4737,13-02-2021 12:00,24 hrs.,StockMarket,HYLN,15,0,15,-15,1,4,3,1,NYSE
4737,13-02-2021 12:00,24 hrs.,StockMarket,LAIX,14,0,14,-14,1,0,10,1,NYSE
4737,13-02-2021 12:00,24 hrs.,StockMarket,PINS,25,0,25,-25,1,4,13,1,NYSE
4737,13-02-2021 12:00,24 hrs.,StockMarket,PLTR,50,0,50,-50,1,22,2,1,NYSE
4737,13-02-2021 12:00,24 hrs.,StockMarket,PUMP,6,6,0,6,1,1,0,1,NYSE
4737,13-02-2021 12:00,24 hrs.,StockMarket,UBER,50,0,50,-50,1,22,2,1,NYSE
4737,13-02-2021 12:00,24 hrs.,StockMarket,VGAC,8,0,8,-8,1,0,4,1,NYSE
4737,13-02-2021 12:00,24 hrs.,StockMarket,AMD,6,0,6,-6,1,1,0,1,NASDAQ
4737,13-02-2021 12:00,24 hrs.,StockMarket,AQB,8,8,0,8,1,2,0,1,NASDAQ
4737,13-02-2021 12:00,24 hrs.,StockMarket,AZN,15,0,15,-15,1,4,3,1,NASDAQ
4737,13-02-2021 12:00,24 hrs.,RobinHoodPennyStocks,ZBISF,6,0,6,-6,1,1,0,1,OTC
4737,13-02-2021 12:00,24 hrs.,RobinHoodPennyStocks,DNN,131,0,131,-131,4,47,21,4,AMEX
4737,13-02-2021 12:00,24 hrs.,RobinHoodPennyStocks,DPW,23,23,0,23,1,5,9,1,AMEX
4737,13-02-2021 12:00,24 hrs.,RobinHoodPennyStocks,GSV,12,6,6,0,2,2,0,2,AMEX
4737,13-02-2021 12:00,24 hrs.,RobinHoodPennyStocks,GTE,667,45,622,-577,15,188,231,15,AMEX
4737,13-02-2021 12:00,24 hrs.,RobinHoodPennyStocks,ITP,6,0,6,-6,1,1,0,1,AMEX
4737,13-02-2021 12:00,24 hrs.,RobinHoodPennyStocks,NAK,87,0,87,-87,6,16,31,6,AMEX
4737,13-02-2021 12:00,24 hrs.,RobinHoodPennyStocks,REI,24,0,24,-24,2,6,4,2,AMEX
4737,13-02-2021 12:00,24 hrs.,RobinHoodPennyStocks,SYN,6,0,6,-6,1,1,0,1,AMEX
4737,13-02-2021 12:00,24 hrs.,RobinHoodPennyStocks,TRX,38,0,38,-38,1,9,16,1,AMEX
4737,13-02-2021 12:00,24 hrs.,RobinHoodPennyStocks,XPL,6,6,0,6,1,1,0,1,AMEX
4737,13-02-2021 12:00,24 hrs.,RobinHoodPennyStocks,ZOM,1337,64,1273,-1209,11,498,297,10,AMEX
4737,13-02-2021 12:00,24 hrs.,RobinHoodPennyStocks,IBIO,37,0,37,-37,1,14,5,1,AMEX
4737,13-02-2021 12:00,24 hrs.,trakstocks,OPRX,12,0,12,-12,1,3,2,1,NASDAQ
4737,13-02-2021 12:00,24 hrs.,trakstocks,RIOT,47,0,47,-47,2,15,9,2,NASDAQ
4737,13-02-2021 12:00,24 hrs.,trakstocks,SNDL,19,19,0,19,1,6,3,1,NASDAQ
4737,13-02-2021 12:00,24 hrs.,trakstocks,TLRY,19,19,0,19,1,6,3,1,NASDAQ
4737,13-02-2021 12:00,24 hrs.,trakstocks,TRIT,50,50,0,50,1,17,12,1,NASDAQ
4737,13-02-2021 12:00,24 hrs.,trakstocks,TTCF,24,24,0,24,2,3,10,2,NASDAQ
4737,13-02-2021 12:00,24 hrs.,StockMarket,ABML,6,0,6,-6,1,1,0,1,OTC
4737,13-02-2021 12:00,24 hrs.,StockMarket,BOTH,9,9,0,9,1,0,5,1,OTC
4737,13-02-2021 12:00,24 hrs.,StockMarket,BOTY,17,7,10,-3,2,4,1,2,OTC
4737,13-02-2021 12:00,24 hrs.,StockMarket,GTEH,6,0,6,-6,1,1,0,1,OTC
4737,13-02-2021 12:00,24 hrs.,StockMarket,GTVH,6,0,6,-6,1,1,0,1,OTC
4737,13-02-2021 12:00,24 hrs.,StockMarket,HEMP,6,0,6,-6,1,1,0,1,OTC
4737,13-02-2021 12:00,24 hrs.,StockMarket,KGET,6,0,6,-6,1,1,0,1,OTC
4737,13-02-2021 12:00,24 hrs.,StockMarket,KWBT,6,0,6,-6,1,1,0,1,OTC
4737,13-02-2021 12:00,24 hrs.,StockMarket,LINK,15,0,15,-15,1,4,3,1,OTC
4737,13-02-2021 12:00,24 hrs.,RobinHoodPennyStocks,SOS,74,0,74,-74,2,17,32,2,NYSE
4737,13-02-2021 12:00,24 hrs.,RobinHoodPennyStocks,CCIV,40,0,40,-40,1,11,14,1,NYSE
4737,13-02-2021 12:00,24 hrs.,RobinHoodPennyStocks,PLTR,6,0,6,-6,1,1,0,1,NYSE
4737,13-02-2021 12:00,24 hrs.,RobinHoodPennyStocks,BBI,6,0,6,-6,1,1,0,1,NASDAQ
4737,13-02-2021 12:00,24 hrs.,RobinHoodPennyStocks,JFU,6,6,0,6,1,1,0,1,NASDAQ
4737,13-02-2021 12:00,24 hrs.,RobinHoodPennyStocks,OGI,6,0,6,-6,1,1,0,1,NASDAQ
4737,13-02-2021 12:00,24 hrs.,RobinHoodPennyStocks,SND,36,0,36,-36,4,8,4,2,NASDAQ
4737,13-02-2021 12:00,24 hrs.,RobinHoodPennyStocks,ABEO,196,0,196,-196,3,66,52,3,NASDAQ
4737,13-02-2021 12:00,24 hrs.,RobinHoodPennyStocks,ACRX,22,0,22,-22,1,7,4,1,NASDAQ
4737,13-02-2021 12:00,24 hrs.,RobinHoodPennyStocks,ACST,6,0,6,-6,1,1,0,1,NASDAQ
4737,13-02-2021 12:00,24 hrs.,RobinHoodPennyStocks,ADXS,18,0,18,-18,3,3,0,2,NASDAQ
4737,13-02-2021 12:00,24 hrs.,RobinHoodPennyStocks,AEZS,133,0,133,-133,1,53,23,1,NASDAQ
4737,13-02-2021 12:00,24 hrs.,RobinHoodPennyStocks,AGTC,1335,68,1267,-1199,16,484,303,15,NASDAQ
4737,13-02-2021 12:00,24 hrs.,RobinHoodPennyStocks,APHA,6,0,6,-6,1,1,0,1,NASDAQ
4737,13-02-2021 12:00,24 hrs.,RobinHoodPennyStocks,ARTL,18,0,18,-18,3,3,0,3,NASDAQ
4737,13-02-2021 12:00,24 hrs.,RobinHoodPennyStocks,ASRT,85,0,85,-85,4,31,7,3,NASDAQ
4737,13-02-2021 12:00,24 hrs.,RobinHoodPennyStocks,ATOS,508,0,508,-508,11,186,92,11,NASDAQ
4737,13-02-2021 12:00,24 hrs.,RobinHoodPennyStocks,BHTG,67,0,67,-67,2,21,17,2,NASDAQ
4737,13-02-2021 12:00,24 hrs.,RobinHoodPennyStocks,BIOL,6,0,6,-6,1,1,0,1,NASDAQ
4737,13-02-2021 12:00,24 hrs.,RobinHoodPennyStocks,BNGO,46,6,40,-34,4,11,8,4,NASDAQ
4737,13-02-2021 12:00,24 hrs.,RobinHoodPennyStocks,BRQS,6,0,6,-6,1,1,0,1,NASDAQ
4737,13-02-2021 12:00,24 hrs.,RobinHoodPennyStocks,CDTX,6,0,6,-6,1,1,0,1,NASDAQ
4737,13-02-2021 12:00,24 hrs.,RobinHoodPennyStocks,CIDM,104,68,36,32,2,23,50,2,NASDAQ
4737,13-02-2021 12:00,24 hrs.,RobinHoodPennyStocks,CKPT,69,0,69,-69,2,23,15,2,NASDAQ
4737,13-02-2021 12:00,24 hrs.,RobinHoodPennyStocks,CLBS,32,6,26,-20,3,9,2,3,NASDAQ
4737,13-02-2021 12:00,24 hrs.,RobinHoodPennyStocks,CRBP,23,23,0,23,1,7,5,1,NASDAQ
4737,13-02-2021 12:00,24 hrs.,RobinHoodPennyStocks,CTRM,368,97,271,-174,10,73,182,10,NASDAQ
4737,13-02-2021 12:00,24 hrs.,RobinHoodPennyStocks,DFFN,920,35,885,-850,10,349,182,9,NASDAQ
4737,13-02-2021 12:00,24 hrs.,RobinHoodPennyStocks,ENTX,60,0,60,-60,1,23,10,1,NASDAQ
4737,13-02-2021 12:00,24 hrs.,RobinHoodPennyStocks,FCEL,51,0,51,-51,1,9,29,1,NASDAQ
4737,13-02-2021 12:00,24 hrs.,RobinHoodPennyStocks,GAIN,6,6,0,6,1,1,0,1,NASDAQ
4737,13-02-2021 12:00,24 hrs.,RobinHoodPennyStocks,GLBS,6,0,6,-6,1,1,0,1,NASDAQ
4737,13-02-2021 12:00,24 hrs.,RobinHoodPennyStocks,IDEX,13,0,13,-13,1,2,5,1,NASDAQ
4737,13-02-2021 12:00,24 hrs.,RobinHoodPennyStocks,IMMR,15,15,0,15,1,4,3,1,NASDAQ
4737,13-02-2021 12:00,24 hrs.,RobinHoodPennyStocks,INPX,12,12,0,12,2,2,0,1,NASDAQ
4737,13-02-2021 12:00,24 hrs.,RobinHoodPennyStocks,ITRM,6,0,6,-6,1,1,0,1,NASDAQ
4737,13-02-2021 12:00,24 hrs.,RobinHoodPennyStocks,KTRA,19,0,19,-19,1,5,5,1,NASDAQ
4737,13-02-2021 12:00,24 hrs.,RobinHoodPennyStocks,LKCO,103,0,103,-103,8,28,15,8,NASDAQ
4737,13-02-2021 12:00,24 hrs.,RobinHoodPennyStocks,MMLP,6,0,6,-6,1,1,0,1,NASDAQ
4737,13-02-2021 12:00,24 hrs.,RobinHoodPennyStocks,NAKD,101,95,6,89,2,37,19,2,NASDAQ
4737,13-02-2021 12:00,24 hrs.,RobinHoodPennyStocks,NMTR,156,0,156,-156,1,52,48,1,NASDAQ
4737,13-02-2021 12:00,24 hrs.,RobinHoodPennyStocks,NVCN,64,0,64,-64,2,16,24,2,NASDAQ
4737,13-02-2021 12:00,24 hrs.,RobinHoodPennyStocks,OCGN,40,0,40,-40,1,11,14,1,NASDAQ
4737,13-02-2021 12:00,24 hrs.,RobinHoodPennyStocks,OPGN,24,0,24,-24,4,4,0,1,NASDAQ
4737,13-02-2021 12:00,24 hrs.,RobinHoodPennyStocks,OPTT,6,0,6,-6,1,1,0,1,NASDAQ
4737,13-02-2021 12:00,24 hrs.,RobinHoodPennyStocks,OVID,6,0,6,-6,1,1,0,1,NASDAQ
4737,13-02-2021 12:00,24 hrs.,RobinHoodPennyStocks,PHUN,6,0,6,-6,1,1,0,1,NASDAQ
4737,13-02-2021 12:00,24 hrs.,RobinHoodPennyStocks,PSEC,53,0,53,-53,3,12,17,2,NASDAQ
4737,13-02-2021 12:00,24 hrs.,RobinHoodPennyStocks,RIOT,9,0,9,-9,1,1,3,1,NASDAQ
4737,13-02-2021 12:00,24 hrs.,StockMarket,DSS,6,0,6,-6,1,1,0,1,AMEX
4737,13-02-2021 12:00,24 hrs.,StockMarket,MXC,9,9,0,9,1,0,5,1,AMEX
4737,13-02-2021 12:00,24 hrs.,StockMarket,TRX,6,0,6,-6,1,1,0,1,AMEX
4737,13-02-2021 12:00,24 hrs.,StockMarket,ZOM,6,6,0,6,1,1,0,1,AMEX
4737,13-02-2021 12:00,24 hrs.,StockMarket,GSAT,108,24,84,-60,5,27,34,2,AMEX
4737,13-02-2021 12:00,24 hrs.,StockMarket,LODE,6,0,6,-6,1,1,0,1,AMEX
4737,13-02-2021 12:00,24 hrs.,StockMarket,NSPR,6,0,6,-6,1,1,0,1,AMEX
4737,13-02-2021 12:00,24 hrs.,StockMarket,UAVS,10,0,10,-10,1,1,4,1,AMEX
4737,13-02-2021 12:00,24 hrs.,StockMarket,ACB,50,0,50,-50,1,22,2,1,NYSE
4737,13-02-2021 12:00,24 hrs.,StockMarket,AFC,6,0,6,-6,1,1,0,1,NYSE
4737,13-02-2021 12:00,24 hrs.,StockMarket,AGX,6,0,6,-6,1,1,0,1,NYSE
4737,13-02-2021 12:00,24 hrs.,StockMarket,AMC,36,0,36,-36,3,1,22,3,NYSE
4737,13-02-2021 12:00,24 hrs.,StockMarket,ASX,9,9,0,9,1,0,5,1,NYSE
4737,13-02-2021 12:00,24 hrs.,StockMarket,BHC,15,0,15,-15,1,4,3,1,NYSE
4737,13-02-2021 12:00,24 hrs.,StockMarket,DIS,65,0,65,-65,2,26,5,2,NYSE
4737,13-02-2021 12:00,24 hrs.,StockMarket,TRVG,6,0,6,-6,1,1,0,1,NASDAQ
4737,13-02-2021 12:00,24 hrs.,StockMarket,TSLA,2480,2474,6,2468,2,1196,80,2,NASDAQ
4737,13-02-2021 12:00,24 hrs.,StockMarket,VITL,60,54,6,48,2,24,4,2,NASDAQ
4737,13-02-2021 12:00,24 hrs.,StockMarket,VRSN,15,0,15,-15,1,4,3,1,NASDAQ
4737,13-02-2021 12:00,24 hrs.,StockMarket,VUZI,6,0,6,-6,1,1,0,1,NASDAQ
4737,13-02-2021 12:00,24 hrs.,StockMarket,VXRT,6,6,0,6,1,1,0,1,NASDAQ
4737,13-02-2021 12:00,24 hrs.,StockMarket,WAFU,87,0,87,-87,1,22,39,1,NASDAQ
4737,13-02-2021 12:00,24 hrs.,StockMarket,ZIOP,6,0,6,-6,1,1,0,1,NASDAQ
4737,13-02-2021 12:00,24 hrs.,StockMarket,SRACU,8,0,8,-8,1,0,4,1,NASDAQ
4737,13-02-2021 12:00,24 hrs.,StockMarket,SRACW,8,0,8,-8,1,0,4,1,NASDAQ
4737,13-02-2021 12:00,24 hrs.,pennystocks,ABML,165,38,127,-89,3,52,49,3,OTC
4737,13-02-2021 12:00,24 hrs.,pennystocks,ADTM,13,0,13,-13,2,2,1,1,OTC
4737,13-02-2021 12:00,24 hrs.,pennystocks,AFPW,6,0,6,-6,1,1,0,1,OTC
4737,13-02-2021 12:00,24 hrs.,pennystocks,AITX,320,0,320,-320,3,114,80,3,OTC
4737,13-02-2021 12:00,24 hrs.,pennystocks,ALKM,7,0,7,-7,1,1,1,1,OTC
4737,13-02-2021 12:00,24 hrs.,pennystocks,ALPP,399,0,399,-399,6,135,105,5,OTC
4737,13-02-2021 12:00,24 hrs.,pennystocks,ALST,24,0,24,-24,2,2,12,1,OTC
4737,13-02-2021 12:00,24 hrs.,pennystocks,ALYI,46,0,46,-46,3,13,8,3,OTC
4737,13-02-2021 12:00,24 hrs.,pennystocks,APPZ,7,0,7,-7,1,1,1,1,OTC
4737,13-02-2021 12:00,24 hrs.,pennystocks,ASCK,6,0,6,-6,1,1,0,1,OTC
4737,13-02-2021 12:00,24 hrs.,pennystocks,ASTI,18,0,18,-18,3,3,0,3,OTC
4737,13-02-2021 12:00,24 hrs.,pennystocks,ATDS,6,0,6,-6,1,1,0,1,OTC
4737,13-02-2021 12:00,24 hrs.,pennystocks,ATNP,31,0,31,-31,1,5,17,1,OTC
4737,13-02-2021 12:00,24 hrs.,pennystocks,AXXA,29,0,29,-29,1,10,5,1,OTC
4737,13-02-2021 12:00,24 hrs.,pennystocks,AZFL,36,0,36,-36,1,4,24,1,OTC
4737,13-02-2021 12:00,24 hrs.,pennystocks,BANT,6,0,6,-6,1,1,0,1,OTC
4737,13-02-2021 12:00,24 hrs.,pennystocks,BBRW,162,0,162,-162,4,34,78,4,OTC
4737,13-02-2021 12:00,24 hrs.,pennystocks,BDGR,6,0,6,-6,1,1,0,1,OTC
4737,13-02-2021 12:00,24 hrs.,StockMarket,CDC,15,0,15,-15,1,4,3,1,NASDAQ
4737,13-02-2021 12:00,24 hrs.,StockMarket,INO,15,0,15,-15,1,4,3,1,NASDAQ
4737,13-02-2021 12:00,24 hrs.,StockMarket,JFU,84,0,84,-84,1,24,32,1,NASDAQ
4737,13-02-2021 12:00,24 hrs.,StockMarket,NWL,15,0,15,-15,1,4,3,1,NASDAQ
4737,13-02-2021 12:00,24 hrs.,StockMarket,OGI,10,0,10,-10,2,1,0,2,NASDAQ
4737,13-02-2021 12:00,24 hrs.,StockMarket,OPK,6,0,6,-6,1,1,0,1,NASDAQ
4737,13-02-2021 12:00,24 hrs.,StockMarket,QQQ,86,11,75,-64,3,28,18,3,NASDAQ
4737,13-02-2021 12:00,24 hrs.,StockMarket,SFT,6,0,6,-6,1,1,0,1,NASDAQ
4737,13-02-2021 12:00,24 hrs.,StockMarket,VFF,21,0,21,-21,1,6,5,1,NASDAQ
4737,13-02-2021 12:00,24 hrs.,StockMarket,AAPL,25,0,25,-25,1,4,13,1,NASDAQ
4737,13-02-2021 12:00,24 hrs.,StockMarket,AMAT,50,0,50,-50,1,22,2,1,NASDAQ
4737,13-02-2021 12:00,24 hrs.,StockMarket,AMZN,50,0,50,-50,1,22,2,1,NASDAQ
4737,13-02-2021 12:00,24 hrs.,StockMarket,APHA,6,0,6,-6,1,1,0,1,NASDAQ
4737,13-02-2021 12:00,24 hrs.,StockMarket,ARTL,87,0,87,-87,1,22,39,1,NASDAQ
4737,13-02-2021 12:00,24 hrs.,StockMarket,ATHX,6,0,6,-6,1,1,0,1,NASDAQ
4737,13-02-2021 12:00,24 hrs.,StockMarket,ATOS,14,0,14,-14,1,5,0,1,NASDAQ
4737,13-02-2021 12:00,24 hrs.,StockMarket,AVGO,7,0,7,-7,1,1,1,1,NASDAQ
4737,13-02-2021 12:00,24 hrs.,StockMarket,BBBY,6,0,6,-6,1,1,0,1,NASDAQ
4737,13-02-2021 12:00,24 hrs.,StockMarket,BPTH,6,0,6,-6,1,1,0,1,NASDAQ
4737,13-02-2021 12:00,24 hrs.,StockMarket,BSQR,10,0,10,-10,1,1,4,1,NASDAQ
4737,13-02-2021 12:00,24 hrs.,RobinHoodPennyStocks,SHIP,48,6,42,-36,8,8,0,6,NASDAQ
4737,13-02-2021 12:00,24 hrs.,RobinHoodPennyStocks,NSPR,28,0,28,-28,1,7,10,1,AMEX
4737,13-02-2021 12:00,24 hrs.,RobinHoodPennyStocks,OGEN,18,0,18,-18,3,3,0,3,AMEX
4737,13-02-2021 12:00,24 hrs.,RobinHoodPennyStocks,SENS,61,0,61,-61,3,22,5,3,AMEX
4737,13-02-2021 12:00,24 hrs.,RobinHoodPennyStocks,TRXC,6,0,6,-6,1,1,0,1,AMEX
4737,13-02-2021 12:00,24 hrs.,RobinHoodPennyStocks,AIV,6,0,6,-6,1,1,0,1,NYSE
4737,13-02-2021 12:00,24 hrs.,RobinHoodPennyStocks,DNK,6,0,6,-6,1,1,0,1,NYSE
4737,13-02-2021 12:00,24 hrs.,RobinHoodPennyStocks,ETN,6,6,0,6,1,1,0,1,NYSE
4737,13-02-2021 12:00,24 hrs.,RobinHoodPennyStocks,FSR,6,0,6,-6,1,1,0,1,NYSE
4737,13-02-2021 12:00,24 hrs.,RobinHoodPennyStocks,GME,57,0,57,-57,2,13,23,2,NYSE
4737,13-02-2021 12:00,24 hrs.,RobinHoodPennyStocks,IRS,344,0,344,-344,1,156,28,1,NYSE
4737,13-02-2021 12:00,24 hrs.,RobinHoodPennyStocks,MRO,6,6,0,6,1,1,0,1,NYSE
4737,13-02-2021 12:00,24 hrs.,RobinHoodPennyStocks,MTL,19,0,19,-19,2,2,7,2,NYSE
4737,13-02-2021 12:00,24 hrs.,RobinHoodPennyStocks,NAT,6,0,6,-6,1,1,0,1,NYSE
4737,13-02-2021 12:00,24 hrs.,RobinHoodPennyStocks,NBB,6,0,6,-6,1,1,0,1,NYSE
4737,13-02-2021 12:00,24 hrs.,RobinHoodPennyStocks,PHI,6,0,6,-6,1,1,0,1,NYSE
4737,13-02-2021 12:00,24 hrs.,pennystocks,HEMP,7,0,7,-7,1,1,1,1,OTC
4737,13-02-2021 12:00,24 hrs.,pennystocks,HENC,13,13,0,13,1,2,5,1,OTC
4737,13-02-2021 12:00,24 hrs.,pennystocks,HIPH,14,8,6,2,2,2,2,2,OTC
4737,13-02-2021 12:00,24 hrs.,pennystocks,HMMR,7,0,7,-7,1,1,1,1,OTC
4737,13-02-2021 12:00,24 hrs.,pennystocks,HMNY,6,0,6,-6,1,1,0,1,OTC
4737,13-02-2021 12:00,24 hrs.,pennystocks,HPTY,46,0,46,-46,1,14,14,1,OTC
4737,13-02-2021 12:00,24 hrs.,pennystocks,HYSR,6,0,6,-6,1,1,0,1,OTC
4737,13-02-2021 12:00,24 hrs.,pennystocks,BLDV,78,0,78,-78,1,26,22,1,OTC
4737,13-02-2021 12:00,24 hrs.,pennystocks,BLSP,6,0,6,-6,1,1,0,1,OTC
4737,13-02-2021 12:00,24 hrs.,pennystocks,BMCS,11,0,11,-11,1,2,3,1,OTC
4737,13-02-2021 12:00,24 hrs.,pennystocks,BMMJ,6,0,6,-6,1,1,0,1,OTC
4737,13-02-2021 12:00,24 hrs.,pennystocks,BONZ,6,0,6,-6,1,0,2,1,OTC
4737,13-02-2021 12:00,24 hrs.,pennystocks,BOTY,6,6,0,6,1,1,0,1,OTC
4737,13-02-2021 12:00,24 hrs.,pennystocks,BFRE,16,0,16,-16,1,0,12,1,OTC
4737,13-02-2021 12:00,24 hrs.,pennystocks,BGMD,6,0,6,-6,1,1,0,1,OTC
4737,13-02-2021 12:00,24 hrs.,pennystocks,BIEL,113,0,113,-113,4,28,41,3,OTC
4737,13-02-2021 12:00,24 hrs.,RobinHoodPennyStocks,SNDL,1474,18,1456,-1438,22,539,308,21,NASDAQ
4737,13-02-2021 12:00,24 hrs.,RobinHoodPennyStocks,SNGX,141,0,141,-141,2,57,19,2,NASDAQ
4737,13-02-2021 12:00,24 hrs.,RobinHoodPennyStocks,SRAX,6,0,6,-6,1,1,0,1,NASDAQ
4737,13-02-2021 12:00,24 hrs.,RobinHoodPennyStocks,SRGA,6,0,6,-6,1,1,0,1,NASDAQ
4737,13-02-2021 12:00,24 hrs.,RobinHoodPennyStocks,TBLT,89,0,89,-89,1,29,27,1,NASDAQ
4737,13-02-2021 12:00,24 hrs.,RobinHoodPennyStocks,TNXP,56,0,56,-56,2,15,18,2,NASDAQ
4737,13-02-2021 12:00,24 hrs.,RobinHoodPennyStocks,TRCH,94,0,94,-94,3,23,36,2,NASDAQ
4737,13-02-2021 12:00,24 hrs.,RobinHoodPennyStocks,TTOO,36,0,36,-36,1,13,6,1,NASDAQ
4737,13-02-2021 12:00,24 hrs.,RobinHoodPennyStocks,TXMD,36,12,24,-12,6,6,0,6,NASDAQ
4737,13-02-2021 12:00,24 hrs.,RobinHoodPennyStocks,TYME,6,6,0,6,1,1,0,1,NASDAQ
4737,13-02-2021 12:00,24 hrs.,RobinHoodPennyStocks,XSPA,23,0,23,-23,1,9,1,1,NASDAQ
4737,13-02-2021 12:00,24 hrs.,RobinHoodPennyStocks,ZSAN,703,0,703,-703,3,299,93,3,NASDAQ
4737,13-02-2021 12:00,24 hrs.,StockMarket,BYND,6,0,6,-6,1,1,0,1,NASDAQ
4737,13-02-2021 12:00,24 hrs.,StockMarket,CLEU,101,0,101,-101,2,22,49,2,NASDAQ
4737,13-02-2021 12:00,24 hrs.,StockMarket,COHR,15,0,15,-15,1,4,3,1,NASDAQ
4737,13-02-2021 12:00,24 hrs.,StockMarket,CPLP,20,0,20,-20,3,4,0,2,NASDAQ
4737,13-02-2021 12:00,24 hrs.,StockMarket,CRSR,25,0,25,-25,1,4,13,1,NASDAQ
4737,13-02-2021 12:00,24 hrs.,StockMarket,CTRM,6,0,6,-6,1,1,0,1,NASDAQ
4737,13-02-2021 12:00,24 hrs.,StockMarket,CWCO,12,0,12,-12,2,2,0,1,NASDAQ
4737,13-02-2021 12:00,24 hrs.,StockMarket,DDOG,65,0,65,-65,2,26,5,2,NASDAQ
4737,13-02-2021 12:00,24 hrs.,StockMarket,EXPE,15,0,15,-15,1,4,3,1,NASDAQ
4737,13-02-2021 12:00,24 hrs.,StockMarket,FROG,50,0,50,-50,1,22,2,1,NASDAQ
4737,13-02-2021 12:00,24 hrs.,StockMarket,GBIO,7,0,7,-7,1,1,1,1,NASDAQ
4737,13-02-2021 12:00,24 hrs.,StockMarket,GTHX,59,59,0,59,1,15,25,1,NASDAQ
4737,13-02-2021 12:00,24 hrs.,StockMarket,HTBX,90,0,90,-90,2,25,32,2,NASDAQ
4737,13-02-2021 12:00,24 hrs.,StockMarket,IDEX,6,0,6,-6,1,1,0,1,NASDAQ
4737,13-02-2021 12:00,24 hrs.,StockMarket,IIVI,15,0,15,-15,1,4,3,1,NASDAQ
4737,13-02-2021 12:00,24 hrs.,StockMarket,INPX,6,0,6,-6,1,1,0,1,NASDAQ
4737,13-02-2021 12:00,24 hrs.,StockMarket,LITE,15,0,15,-15,1,4,3,1,NASDAQ
4737,13-02-2021 12:00,24 hrs.,StockMarket,LIVE,15,0,15,-15,1,4,3,1,NASDAQ
4737,13-02-2021 12:00,24 hrs.,StockMarket,LLNW,13,0,13,-13,2,2,1,1,NASDAQ
4737,13-02-2021 12:00,24 hrs.,StockMarket,MKSI,15,0,15,-15,1,4,3,1,NASDAQ
4737,13-02-2021 12:00,24 hrs.,StockMarket,MSFT,25,0,25,-25,1,4,13,1,NASDAQ
4737,13-02-2021 12:00,24 hrs.,StockMarket,MTCH,7,0,7,-7,1,0,3,1,NASDAQ
4737,13-02-2021 12:00,24 hrs.,StockMarket,OCGN,26,0,26,-26,3,2,10,3,NASDAQ
4737,13-02-2021 12:00,24 hrs.,StockMarket,PTON,25,0,25,-25,1,4,13,1,NASDAQ
4737,13-02-2021 12:00,24 hrs.,StockMarket,RARE,50,0,50,-50,1,22,2,1,NASDAQ
4737,13-02-2021 12:00,24 hrs.,StockMarket,RBBN,6,0,6,-6,1,1,0,1,NASDAQ
4737,13-02-2021 12:00,24 hrs.,StockMarket,REAL,34,0,34,-34,1,0,30,1,NASDAQ
4737,13-02-2021 12:00,24 hrs.,StockMarket,RIDE,21,0,21,-21,2,5,3,2,NASDAQ
4737,13-02-2021 12:00,24 hrs.,StockMarket,SBUX,25,0,25,-25,1,4,13,1,NASDAQ
4737,13-02-2021 12:00,24 hrs.,StockMarket,SESN,38,0,38,-38,2,13,4,1,NASDAQ
4737,13-02-2021 12:00,24 hrs.,StockMarket,SNDL,158,146,12,134,4,37,68,4,NASDAQ
4737,13-02-2021 12:00,24 hrs.,StockMarket,SPSC,50,0,50,-50,1,22,2,1,NASDAQ
4737,13-02-2021 12:00,24 hrs.,StockMarket,SRAC,8,0,8,-8,1,0,4,1,NASDAQ
4737,13-02-2021 12:00,24 hrs.,StockMarket,SVMK,15,0,15,-15,1,4,3,1,NASDAQ
4737,13-02-2021 12:00,24 hrs.,StockMarket,TLRY,62,0,62,-62,6,13,12,6,NASDAQ
4737,13-02-2021 12:00,24 hrs.,StockMarket,TNXP,6,0,6,-6,1,1,0,1,NASDAQ
4737,13-02-2021 12:00,24 hrs.,pennystocks,ITCJ,7,0,7,-7,1,1,1,1,OTC
4737,13-02-2021 12:00,24 hrs.,pennystocks,JSDA,6,0,6,-6,1,1,0,1,OTC
4737,13-02-2021 12:00,24 hrs.,pennystocks,KWBT,6,0,6,-6,1,1,0,1,OTC
4737,13-02-2021 12:00,24 hrs.,pennystocks,KYNC,6,0,6,-6,1,1,0,1,OTC
4737,13-02-2021 12:00,24 hrs.,pennystocks,LBTI,6,6,0,6,1,1,0,1,OTC
4737,13-02-2021 12:00,24 hrs.,pennystocks,LITH,6,0,6,-6,1,1,0,1,OTC
4737,13-02-2021 12:00,24 hrs.,pennystocks,LQMT,6,0,6,-6,1,1,0,1,OTC
4737,13-02-2021 12:00,24 hrs.,pennystocks,BRLL,46,0,46,-46,2,3,32,2,OTC
4737,13-02-2021 12:00,24 hrs.,pennystocks,BRTX,12,0,12,-12,2,2,0,2,OTC
4737,13-02-2021 12:00,24 hrs.,pennystocks,BRZL,6,0,6,-6,1,1,0,1,OTC
4737,13-02-2021 12:00,24 hrs.,pennystocks,BTZI,6,0,6,-6,1,1,0,1,OTC
4737,13-02-2021 12:00,24 hrs.,pennystocks,BUDZ,13,0,13,-13,2,2,1,2,OTC
4737,13-02-2021 12:00,24 hrs.,pennystocks,BWMG,53,0,53,-53,2,12,21,2,OTC
4737,13-02-2021 12:00,24 hrs.,pennystocks,BZWR,15,0,15,-15,1,0,11,1,OTC
4737,13-02-2021 12:00,24 hrs.,pennystocks,CAFS,7,7,0,7,1,1,1,1,OTC
4737,13-02-2021 12:00,24 hrs.,pennystocks,CANN,6,0,6,-6,1,1,0,1,OTC
4737,13-02-2021 12:00,24 hrs.,pennystocks,CAPC,7,0,7,-7,1,1,1,1,OTC
4737,13-02-2021 12:00,24 hrs.,pennystocks,CATV,142,0,142,-142,1,61,16,1,OTC
4737,13-02-2021 12:00,24 hrs.,pennystocks,CAVR,6,0,6,-6,1,1,0,1,OTC
4737,13-02-2021 12:00,24 hrs.,pennystocks,CBBT,396,0,396,-396,3,158,68,3,OTC
4737,13-02-2021 12:00,24 hrs.,pennystocks,CBDL,288,0,288,-288,4,89,94,4,OTC
4737,13-02-2021 12:00,24 hrs.,pennystocks,CCTL,23,0,23,-23,1,8,3,1,OTC
4737,13-02-2021 12:00,24 hrs.,pennystocks,CELZ,13,6,7,-1,2,2,1,2,OTC
4737,13-02-2021 12:00,24 hrs.,pennystocks,CHNC,28,0,28,-28,1,8,8,1,OTC
4737,13-02-2021 12:00,24 hrs.,pennystocks,CLWD,6,0,6,-6,1,1,0,1,OTC
4737,13-02-2021 12:00,24 hrs.,pennystocks,CNNA,85,85,0,85,1,10,61,1,OTC
4737,13-02-2021 12:00,24 hrs.,pennystocks,COMS,13,13,0,13,2,2,1,1,OTC
4737,13-02-2021 12:00,24 hrs.,pennystocks,CORG,39,0,39,-39,3,4,19,3,OTC
4737,13-02-2021 12:00,24 hrs.,pennystocks,CRTG,35,0,35,-35,1,11,9,1,OTC
4737,13-02-2021 12:00,24 hrs.,pennystocks,CRWG,6,0,6,-6,1,1,0,1,OTC
4737,13-02-2021 12:00,24 hrs.,pennystocks,CSLI,47,0,47,-47,1,13,17,1,OTC
4737,13-02-2021 12:00,24 hrs.,pennystocks,CTLE,18,12,6,6,3,3,0,3,OTC
4737,13-02-2021 12:00,24 hrs.,pennystocks,CYDY,7,0,7,-7,1,1,1,1,OTC
4737,13-02-2021 12:00,24 hrs.,pennystocks,DMAN,19,0,19,-19,1,5,5,1,OTC
4737,13-02-2021 12:00,24 hrs.,pennystocks,DPLS,193,77,116,-39,6,68,33,5,OTC
4737,13-02-2021 12:00,24 hrs.,pennystocks,DSGT,6,6,0,6,1,1,0,1,OTC
4737,13-02-2021 12:00,24 hrs.,pennystocks,EAWD,6,6,0,6,1,1,0,1,OTC
4737,13-02-2021 12:00,24 hrs.,pennystocks,ECEZ,7,7,0,7,1,1,1,1,OTC
4737,13-02-2021 12:00,24 hrs.,pennystocks,EHOS,41,41,0,41,1,9,19,1,OTC
4737,13-02-2021 12:00,24 hrs.,pennystocks,ELTP,16,0,16,-16,1,4,4,1,OTC
4737,13-02-2021 12:00,24 hrs.,pennystocks,ENRT,6,0,6,-6,1,1,0,1,OTC
4737,13-02-2021 12:00,24 hrs.,pennystocks,ENZC,12,0,12,-12,2,2,0,2,OTC
4737,13-02-2021 12:00,24 hrs.,pennystocks,ERBB,30,14,16,-2,2,3,16,2,OTC
4737,13-02-2021 12:00,24 hrs.,pennystocks,ETFM,212,6,206,-200,4,69,58,3,OTC
4737,13-02-2021 12:00,24 hrs.,pennystocks,ETHE,40,0,40,-40,1,5,26,1,OTC
4737,13-02-2021 12:00,24 hrs.,pennystocks,EWKS,7,0,7,-7,1,1,1,1,OTC
4737,13-02-2021 12:00,24 hrs.,pennystocks,FLXT,6,0,6,-6,1,1,0,1,OTC
4737,13-02-2021 12:00,24 hrs.,pennystocks,FTEG,6,0,6,-6,1,1,0,1,OTC
4737,13-02-2021 12:00,24 hrs.,pennystocks,FUST,7,0,7,-7,1,1,1,1,OTC
4737,13-02-2021 12:00,24 hrs.,pennystocks,GAXY,160,160,0,160,1,65,26,1,OTC
4737,13-02-2021 12:00,24 hrs.,pennystocks,GBTC,40,0,40,-40,1,5,26,1,OTC
4737,13-02-2021 12:00,24 hrs.,pennystocks,GHMP,50,0,50,-50,3,10,18,2,OTC
4737,13-02-2021 12:00,24 hrs.,pennystocks,GLCO,6,0,6,-6,1,1,0,1,OTC
4737,13-02-2021 12:00,24 hrs.,pennystocks,GLEC,6,0,6,-6,1,1,0,1,OTC
4737,13-02-2021 12:00,24 hrs.,pennystocks,GPFT,10,10,0,10,1,2,2,1,OTC
4737,13-02-2021 12:00,24 hrs.,pennystocks,GRCU,9,0,9,-9,1,0,5,1,OTC
4737,13-02-2021 12:00,24 hrs.,pennystocks,GRCV,7,7,0,7,1,1,1,1,OTC
4737,13-02-2021 12:00,24 hrs.,pennystocks,GRSO,7,7,0,7,1,1,1,1,OTC
4737,13-02-2021 12:00,24 hrs.,pennystocks,GRST,111,0,111,-111,2,35,33,1,OTC
4737,13-02-2021 12:00,24 hrs.,pennystocks,GTBP,21,0,21,-21,1,3,11,1,OTC
4737,13-02-2021 12:00,24 hrs.,pennystocks,GTEH,50,50,0,50,1,12,22,1,OTC
4737,13-02-2021 12:00,24 hrs.,pennystocks,GTLL,77,6,71,-65,4,25,11,4,OTC
4737,13-02-2021 12:00,24 hrs.,pennystocks,HALB,33,0,33,-33,2,9,7,1,OTC
4737,13-02-2021 12:00,24 hrs.,pennystocks,HCMC,139,55,84,-29,22,22,7,19,OTC
4737,13-02-2021 12:00,24 hrs.,pennystocks,MJNA,25,0,25,-25,4,4,1,4,OTC
4737,13-02-2021 12:00,24 hrs.,pennystocks,MJTV,7,0,7,-7,1,1,1,1,OTC
4737,13-02-2021 12:00,24 hrs.,pennystocks,MKTY,7,0,7,-7,1,1,1,1,OTC
4737,13-02-2021 12:00,24 hrs.,pennystocks,MLFB,153,0,153,-153,3,46,49,3,OTC
4737,13-02-2021 12:00,24 hrs.,pennystocks,MMEX,139,0,139,-139,3,25,77,2,OTC
4737,13-02-2021 12:00,24 hrs.,pennystocks,MOJO,12,0,12,-12,2,2,0,1,OTC
4737,13-02-2021 12:00,24 hrs.,pennystocks,MRMD,6,6,0,6,1,0,2,1,OTC
4737,13-02-2021 12:00,24 hrs.,pennystocks,MTVX,6,0,6,-6,1,1,0,1,OTC
4737,13-02-2021 12:00,24 hrs.,pennystocks,NBVG,7,0,7,-7,1,1,1,1,OTC
4737,13-02-2021 12:00,24 hrs.,pennystocks,NOVC,56,0,56,-56,2,17,14,2,OTC
4737,13-02-2021 12:00,24 hrs.,pennystocks,NSAV,13,0,13,-13,2,2,1,2,OTC
4737,13-02-2021 12:00,24 hrs.,pennystocks,NSPT,23,17,6,11,2,3,9,2,OTC
4737,13-02-2021 12:00,24 hrs.,pennystocks,NUGS,7,7,0,7,1,1,1,1,OTC
4737,13-02-2021 12:00,24 hrs.,pennystocks,OZSC,114,108,6,102,3,28,46,3,OTC
4737,13-02-2021 12:00,24 hrs.,pennystocks,PAOG,7,0,7,-7,1,1,1,1,OTC
4737,13-02-2021 12:00,24 hrs.,pennystocks,PDXP,7,0,7,-7,1,1,1,1,OTC
4737,13-02-2021 12:00,24 hrs.,pennystocks,PHIL,6,0,6,-6,1,1,0,1,OTC
4737,13-02-2021 12:00,24 hrs.,pennystocks,PMCB,6,0,6,-6,1,1,0,1,OTC
4737,13-02-2021 12:00,24 hrs.,pennystocks,PPJE,6,0,6,-6,1,1,0,1,OTC
4737,13-02-2021 12:00,24 hrs.,pennystocks,PUGE,43,0,43,-43,2,13,9,1,OTC
4737,13-02-2021 12:00,24 hrs.,pennystocks,PURA,50,37,13,24,3,6,26,3,OTC
4737,13-02-2021 12:00,24 hrs.,pennystocks,PVDG,23,0,23,-23,1,1,17,1,OTC
4737,13-02-2021 12:00,24 hrs.,pennystocks,QOIL,7,0,7,-7,1,1,1,1,OTC
4737,13-02-2021 12:00,24 hrs.,pennystocks,RDGL,6,0,6,-6,1,1,0,1,OTC
4737,13-02-2021 12:00,24 hrs.,pennystocks,RELI,16,0,16,-16,1,0,12,1,OTC
4737,13-02-2021 12:00,24 hrs.,pennystocks,RGBP,23,0,23,-23,2,6,3,1,OTC
4737,13-02-2021 12:00,24 hrs.,pennystocks,RNVA,6,0,6,-6,1,1,0,1,OTC
4737,13-02-2021 12:00,24 hrs.,pennystocks,RSHN,19,0,19,-19,1,2,11,1,OTC
4737,13-02-2021 12:00,24 hrs.,pennystocks,RSSV,304,0,304,-304,2,110,76,2,OTC
4737,13-02-2021 12:00,24 hrs.,pennystocks,RTON,13,0,13,-13,2,2,1,2,OTC
4737,13-02-2021 12:00,24 hrs.,pennystocks,SCNA,6,6,0,6,1,1,0,1,OTC
4737,13-02-2021 12:00,24 hrs.,pennystocks,SFOR,15,0,15,-15,1,0,11,1,OTC
4737,13-02-2021 12:00,24 hrs.,pennystocks,SGMD,396,51,345,-294,11,123,106,11,OTC
4737,13-02-2021 12:00,24 hrs.,pennystocks,SHMP,6,0,6,-6,1,1,0,1,OTC
4737,13-02-2021 12:00,24 hrs.,pennystocks,SHWZ,7,0,7,-7,1,1,1,1,OTC
4737,13-02-2021 12:00,24 hrs.,pennystocks,SIML,100,0,100,-100,2,26,40,2,OTC
4737,13-02-2021 12:00,24 hrs.,pennystocks,SING,34,0,34,-34,2,5,16,2,OTC
4737,13-02-2021 12:00,24 hrs.,pennystocks,SNPW,85,54,31,23,4,27,15,4,OTC
4737,13-02-2021 12:00,24 hrs.,pennystocks,SNRS,14,0,14,-14,2,2,2,2,OTC
4737,13-02-2021 12:00,24 hrs.,pennystocks,SNWV,12,0,12,-12,2,2,0,1,OTC
4737,13-02-2021 12:00,24 hrs.,pennystocks,SNYR,6,0,6,-6,1,1,0,1,OTC
4737,13-02-2021 12:00,24 hrs.,pennystocks,SOBR,6,6,0,6,1,1,0,1,OTC
4737,13-02-2021 12:00,24 hrs.,pennystocks,SRMX,73,6,67,-61,6,20,9,6,OTC
4737,13-02-2021 12:00,24 hrs.,pennystocks,SRNA,6,0,6,-6,1,1,0,1,OTC
4737,13-02-2021 12:00,24 hrs.,pennystocks,SSFT,15,0,15,-15,1,0,11,1,OTC
4737,13-02-2021 12:00,24 hrs.,pennystocks,SSOK,15,0,15,-15,1,0,11,1,OTC
4737,13-02-2021 12:00,24 hrs.,pennystocks,STEV,16,0,16,-16,1,5,2,1,OTC
4737,13-02-2021 12:00,24 hrs.,pennystocks,STWC,32,32,0,32,1,11,6,1,OTC
4737,13-02-2021 12:00,24 hrs.,pennystocks,TAUG,6,6,0,6,1,1,0,1,OTC
4737,13-02-2021 12:00,24 hrs.,pennystocks,TCHH,7,0,7,-7,1,1,1,1,OTC
4737,13-02-2021 12:00,24 hrs.,pennystocks,TGHI,11,0,11,-11,1,2,3,1,OTC
4737,13-02-2021 12:00,24 hrs.,pennystocks,TLGN,71,0,71,-71,3,18,23,2,OTC
4737,13-02-2021 12:00,24 hrs.,pennystocks,ICBU,6,0,6,-6,1,1,0,1,OTC
4737,13-02-2021 12:00,24 hrs.,pennystocks,ICLD,6,0,6,-6,1,1,0,1,OTC
4737,13-02-2021 12:00,24 hrs.,pennystocks,ICNM,15,0,15,-15,1,3,5,1,OTC
4737,13-02-2021 12:00,24 hrs.,pennystocks,IMJX,94,0,94,-94,1,25,40,1,OTC
4737,13-02-2021 12:00,24 hrs.,pennystocks,IMTL,6,0,6,-6,1,1,0,1,OTC
4737,13-02-2021 12:00,24 hrs.,pennystocks,INKW,56,6,50,-44,9,9,2,7,OTC
4737,13-02-2021 12:00,24 hrs.,pennystocks,INND,216,48,168,-120,6,50,92,6,OTC
4737,13-02-2021 12:00,24 hrs.,pennystocks,INTV,19,7,12,-5,3,3,1,3,OTC
4737,13-02-2021 12:00,24 hrs.,pennystocks,IPIX,6,0,6,-6,1,1,0,1,OTC
4737,13-02-2021 12:00,24 hrs.,pennystocks,IPSI,18,0,18,-18,1,5,4,1,OTC
4737,13-02-2021 12:00,24 hrs.,pennystocks,IQST,18,0,18,-18,3,3,0,2,OTC
4737,13-02-2021 12:00,24 hrs.,pennystocks,ISBL,7,7,0,7,1,1,1,1,OTC
4737,13-02-2021 12:00,24 hrs.,pennystocks,EPWCF,14,14,0,14,1,0,10,1,OTC
4737,13-02-2021 12:00,24 hrs.,pennystocks,ERPNF,38,38,0,38,1,14,6,1,OTC
4737,13-02-2021 12:00,24 hrs.,pennystocks,EVKIF,35,0,35,-35,1,11,9,1,OTC
4737,13-02-2021 12:00,24 hrs.,pennystocks,FLWPF,22,0,22,-22,1,4,10,1,OTC
4737,13-02-2021 12:00,24 hrs.,pennystocks,FUNFF,12,0,12,-12,1,3,2,1,OTC
4737,13-02-2021 12:00,24 hrs.,pennystocks,GLDFF,6,0,6,-6,1,1,0,1,OTC
4737,13-02-2021 12:00,24 hrs.,pennystocks,HITIF,2854,91,2763,-2672,12,1049,708,11,OTC
4737,13-02-2021 12:00,24 hrs.,pennystocks,HRVSF,6,0,6,-6,1,1,0,1,OTC
4737,13-02-2021 12:00,24 hrs.,pennystocks,INTEQ,6,0,6,-6,1,1,0,1,OTC
4737,13-02-2021 12:00,24 hrs.,pennystocks,KCCFF,28,0,28,-28,1,9,6,1,OTC
4737,13-02-2021 12:00,24 hrs.,pennystocks,LLKKF,24,0,24,-24,4,4,0,1,OTC
4737,13-02-2021 12:00,24 hrs.,pennystocks,LTHUQ,25,25,0,25,1,6,9,1,OTC
4737,13-02-2021 12:00,24 hrs.,pennystocks,LXXGF,94,0,94,-94,1,19,52,1,OTC
4737,13-02-2021 12:00,24 hrs.,pennystocks,MEDIF,6,0,6,-6,1,1,0,1,OTC
4737,13-02-2021 12:00,24 hrs.,pennystocks,MMEDF,33,0,33,-33,1,14,1,1,OTC
4737,13-02-2021 12:00,24 hrs.,pennystocks,MNXXF,14,0,14,-14,2,2,2,1,OTC
4737,13-02-2021 12:00,24 hrs.,pennystocks,NMGRF,12,0,12,-12,2,2,0,2,OTC
4737,13-02-2021 12:00,24 hrs.,pennystocks,NOSUF,47,0,47,-47,2,12,15,2,OTC
4737,13-02-2021 12:00,24 hrs.,pennystocks,NXTTF,67,55,12,43,3,16,23,3,OTC
4737,13-02-2021 12:00,24 hrs.,pennystocks,OILFF,6,0,6,-6,1,1,0,1,OTC
4737,13-02-2021 12:00,24 hrs.,pennystocks,PFWIQ,94,0,94,-94,1,25,40,1,OTC
4737,13-02-2021 12:00,24 hrs.,pennystocks,PMNXF,6,0,6,-6,1,1,0,1,OTC
4737,13-02-2021 12:00,24 hrs.,pennystocks,QYOUF,6,0,6,-6,1,1,0,1,OTC
4737,13-02-2021 12:00,24 hrs.,pennystocks,RAZFF,7,0,7,-7,1,1,1,1,OTC
4737,13-02-2021 12:00,24 hrs.,pennystocks,RHDGF,9,0,9,-9,1,1,3,1,OTC
4737,13-02-2021 12:00,24 hrs.,pennystocks,RLFTF,6,0,6,-6,1,1,0,1,OTC
4737,13-02-2021 12:00,24 hrs.,pennystocks,RLLCF,67,0,67,-67,8,11,13,7,OTC
4737,13-02-2021 12:00,24 hrs.,pennystocks,TLSS,88,0,88,-88,2,26,28,2,OTC
4737,13-02-2021 12:00,24 hrs.,pennystocks,TPAC,5313,0,5313,-5313,1,2391,527,1,OTC
4737,13-02-2021 12:00,24 hrs.,pennystocks,TSNP,81,69,12,57,4,26,13,3,OTC
4737,13-02-2021 12:00,24 hrs.,pennystocks,TXTM,7,7,0,7,1,1,1,1,OTC
4737,13-02-2021 12:00,24 hrs.,pennystocks,UAPC,6,6,0,6,1,1,0,1,OTC
4737,13-02-2021 12:00,24 hrs.,pennystocks,USMJ,40,0,40,-40,2,8,16,2,OTC
4737,13-02-2021 12:00,24 hrs.,pennystocks,VFRM,6,0,6,-6,1,1,0,1,OTC
4737,13-02-2021 12:00,24 hrs.,pennystocks,VPER,60,60,0,60,1,9,38,1,OTC
4737,13-02-2021 12:00,24 hrs.,pennystocks,VPLM,6,0,6,-6,1,1,0,1,OTC
4737,13-02-2021 12:00,24 hrs.,pennystocks,VSPC,6,6,0,6,1,1,0,1,OTC
4737,13-02-2021 12:00,24 hrs.,pennystocks,WCVC,94,0,94,-94,1,25,40,1,OTC
4737,13-02-2021 12:00,24 hrs.,pennystocks,WIZD,20,0,20,-20,1,6,4,1,OTC
4737,13-02-2021 12:00,24 hrs.,pennystocks,WTII,33,0,33,-33,1,9,11,1,OTC
4737,13-02-2021 12:00,24 hrs.,pennystocks,XFLS,6,6,0,6,1,1,0,1,OTC
4737,13-02-2021 12:00,24 hrs.,pennystocks,XLPI,165,165,0,165,1,72,17,1,OTC
4737,13-02-2021 12:00,24 hrs.,pennystocks,XMET,6,0,6,-6,1,1,0,1,OTC
4737,13-02-2021 12:00,24 hrs.,pennystocks,ZHUD,8,0,8,-8,1,1,2,1,OTC
4737,13-02-2021 12:00,24 hrs.,pennystocks,AGGHF,21,0,21,-21,1,5,7,1,OTC
4737,13-02-2021 12:00,24 hrs.,pennystocks,AQSZF,6,6,0,6,1,1,0,1,OTC
4737,13-02-2021 12:00,24 hrs.,pennystocks,ARBKF,88,42,46,-4,4,17,38,4,OTC
4737,13-02-2021 12:00,24 hrs.,pennystocks,BDRBF,6,0,6,-6,1,1,0,1,OTC
4737,13-02-2021 12:00,24 hrs.,pennystocks,BFARF,9,0,9,-9,1,0,5,1,OTC
4737,13-02-2021 12:00,24 hrs.,pennystocks,BKLLF,82,0,82,-82,1,25,28,1,OTC
4737,13-02-2021 12:00,24 hrs.,pennystocks,BNCHF,6,0,6,-6,1,1,0,1,OTC
4737,13-02-2021 12:00,24 hrs.,pennystocks,BRPHF,40,0,40,-40,1,5,26,1,OTC
4737,13-02-2021 12:00,24 hrs.,pennystocks,BVNNF,7,0,7,-7,1,1,1,1,OTC
4737,13-02-2021 12:00,24 hrs.,pennystocks,CANSF,5,0,5,-5,1,0,1,1,OTC
4737,13-02-2021 12:00,24 hrs.,pennystocks,CBULF,6,0,6,-6,1,1,0,1,OTC
4737,13-02-2021 12:00,24 hrs.,pennystocks,LUVU,14,0,14,-14,2,3,0,2,OTC
4737,13-02-2021 12:00,24 hrs.,pennystocks,LVVV,39,39,0,39,1,8,19,1,OTC
4737,13-02-2021 12:00,24 hrs.,pennystocks,MAXD,74,13,61,-48,7,19,8,7,OTC
4737,13-02-2021 12:00,24 hrs.,pennystocks,MCOA,7,0,7,-7,1,1,1,1,OTC
4737,13-02-2021 12:00,24 hrs.,pennystocks,MDCN,13,0,13,-13,2,2,1,2,OTC
4737,13-02-2021 12:00,24 hrs.,pennystocks,MEDH,81,0,81,-81,1,19,39,1,OTC
4737,13-02-2021 12:00,24 hrs.,pennystocks,MGTI,24,0,24,-24,1,8,4,1,OTC
4737,13-02-2021 12:00,24 hrs.,pennystocks,MIHI,6,0,6,-6,1,1,0,1,OTC
4737,13-02-2021 12:00,24 hrs.,pennystocks,MINE,67,0,67,-67,6,9,25,5,OTC
4737,13-02-2021 12:00,24 hrs.,pennystocks,WELL,1740,0,1740,-1740,1,738,260,1,NYSE
4737,13-02-2021 12:00,24 hrs.,pennystocks,FWP,10,0,10,-10,1,0,6,1,NASDAQ
4737,13-02-2021 12:00,24 hrs.,pennystocks,RVVTF,7,0,7,-7,1,1,1,1,OTC
4737,13-02-2021 12:00,24 hrs.,pennystocks,SNNAF,12,0,12,-12,1,3,2,1,OTC
4737,13-02-2021 12:00,24 hrs.,pennystocks,SPFYF,9,0,9,-9,1,1,3,1,OTC
4737,13-02-2021 12:00,24 hrs.,pennystocks,SPMTF,22,0,22,-22,1,3,12,1,OTC
4737,13-02-2021 12:00,24 hrs.,pennystocks,SPRWF,60,0,60,-60,3,16,16,3,OTC
4737,13-02-2021 12:00,24 hrs.,pennystocks,TAKOF,40,0,40,-40,1,14,8,1,OTC
4737,13-02-2021 12:00,24 hrs.,pennystocks,TOBAF,34,0,34,-34,1,8,14,1,OTC
4737,13-02-2021 12:00,24 hrs.,pennystocks,TRUFF,16,16,0,16,1,2,8,1,OTC
4737,13-02-2021 12:00,24 hrs.,pennystocks,TSCRF,82,0,82,-82,3,23,24,3,OTC
4737,13-02-2021 12:00,24 hrs.,pennystocks,VRNDF,20,0,20,-20,1,6,4,1,OTC
4737,13-02-2021 12:00,24 hrs.,pennystocks,ZBISF,62,0,62,-62,1,23,12,1,OTC
4737,13-02-2021 12:00,24 hrs.,pennystocks,DNN,56,19,37,-18,9,9,2,8,AMEX
4737,13-02-2021 12:00,24 hrs.,pennystocks,DPW,6,6,0,6,1,1,0,1,AMEX
4737,13-02-2021 12:00,24 hrs.,pennystocks,DSS,26,0,26,-26,1,7,8,1,AMEX
4737,13-02-2021 12:00,24 hrs.,pennystocks,GSV,7,7,0,7,1,1,1,1,AMEX
4737,13-02-2021 12:00,24 hrs.,pennystocks,GTE,46,40,6,34,4,9,12,4,AMEX
4737,13-02-2021 12:00,24 hrs.,pennystocks,MCF,6,0,6,-6,1,1,0,1,AMEX
4737,13-02-2021 12:00,24 hrs.,pennystocks,NAK,33,0,33,-33,1,7,15,1,AMEX
4737,13-02-2021 12:00,24 hrs.,pennystocks,NBY,46,0,46,-46,1,13,16,1,AMEX
4737,13-02-2021 12:00,24 hrs.,pennystocks,PTN,22,0,22,-22,1,6,6,1,AMEX
4737,13-02-2021 12:00,24 hrs.,pennystocks,TGB,37,6,31,-25,2,11,7,2,AMEX
4737,13-02-2021 12:00,24 hrs.,pennystocks,TRX,8,0,8,-8,1,1,2,1,AMEX
4737,13-02-2021 12:00,24 hrs.,pennystocks,ZOM,98,85,13,72,3,12,62,3,AMEX
4737,13-02-2021 12:00,24 hrs.,pennystocks,GSAT,72,0,72,-72,1,18,32,1,AMEX
4737,13-02-2021 12:00,24 hrs.,pennystocks,IBIO,23,0,23,-23,1,8,3,1,AMEX
4737,13-02-2021 12:00,24 hrs.,pennystocks,NSPR,22,0,22,-22,1,7,4,1,AMEX
4737,13-02-2021 12:00,24 hrs.,pennystocks,OGEN,6,6,0,6,1,1,0,1,AMEX
4737,13-02-2021 12:00,24 hrs.,pennystocks,SDPI,6,0,6,-6,1,1,0,1,AMEX
4737,13-02-2021 12:00,24 hrs.,pennystocks,SENS,30,0,30,-30,3,3,12,3,AMEX
4737,13-02-2021 12:00,24 hrs.,pennystocks,TRXC,12,6,6,0,2,1,2,2,AMEX
4737,13-02-2021 12:00,24 hrs.,pennystocks,UAVS,114,0,114,-114,1,38,34,1,AMEX
4737,13-02-2021 12:00,24 hrs.,pennystocks,XXII,6,0,6,-6,1,0,2,1,AMEX
4737,13-02-2021 12:00,24 hrs.,pennystocks,ACB,19,0,19,-19,1,1,13,1,NYSE
4737,13-02-2021 12:00,24 hrs.,pennystocks,AHT,6,0,6,-6,1,1,0,1,NYSE
4737,13-02-2021 12:00,24 hrs.,pennystocks,AMC,86,0,86,-86,5,16,34,5,NYSE
4737,13-02-2021 12:00,24 hrs.,pennystocks,ASX,24,0,24,-24,4,4,0,2,NYSE
4737,13-02-2021 12:00,24 hrs.,pennystocks,ATH,16,0,16,-16,1,5,2,1,NYSE
4737,13-02-2021 12:00,24 hrs.,pennystocks,AXL,6,6,0,6,1,0,2,1,NYSE
4737,13-02-2021 12:00,24 hrs.,pennystocks,BTU,6,0,6,-6,1,1,0,1,NYSE
4737,13-02-2021 12:00,24 hrs.,pennystocks,CBD,35,26,9,17,3,8,7,3,NYSE
4737,13-02-2021 12:00,24 hrs.,pennystocks,CHS,35,0,35,-35,1,11,9,1,NYSE
4737,13-02-2021 12:00,24 hrs.,pennystocks,CLI,66,0,66,-66,1,23,16,1,NYSE
4737,13-02-2021 12:00,24 hrs.,pennystocks,CMD,66,0,66,-66,1,23,16,1,NYSE
4737,13-02-2021 12:00,24 hrs.,pennystocks,CVE,18,0,18,-18,3,3,0,1,NYSE
4737,13-02-2021 12:00,24 hrs.,pennystocks,CVX,35,0,35,-35,1,12,7,1,NYSE
4737,13-02-2021 12:00,24 hrs.,pennystocks,ETH,6,0,6,-6,1,1,0,1,NYSE
4737,13-02-2021 12:00,24 hrs.,pennystocks,FLT,40,0,40,-40,1,14,8,1,NYSE
4737,13-02-2021 12:00,24 hrs.,pennystocks,GME,24,0,24,-24,4,4,0,3,NYSE
4737,13-02-2021 12:00,24 hrs.,pennystocks,IRR,28,0,28,-28,1,9,6,1,NYSE
4737,13-02-2021 12:00,24 hrs.,pennystocks,CBWTF,13,0,13,-13,2,2,1,2,OTC
4737,13-02-2021 12:00,24 hrs.,pennystocks,CIOXY,7,0,7,-7,1,1,1,1,OTC
4737,13-02-2021 12:00,24 hrs.,pennystocks,CLUBQ,26,0,26,-26,2,6,6,1,OTC
4737,13-02-2021 12:00,24 hrs.,pennystocks,CPHRF,6,0,6,-6,1,1,0,1,OTC
4737,13-02-2021 12:00,24 hrs.,pennystocks,CRLBF,108,85,23,62,2,12,76,2,OTC
4737,13-02-2021 12:00,24 hrs.,pennystocks,CWGYF,6,0,6,-6,1,1,0,1,OTC
4737,13-02-2021 12:00,24 hrs.,pennystocks,CWSFF,6,0,6,-6,1,1,0,1,OTC
4737,13-02-2021 12:00,24 hrs.,pennystocks,DFODQ,24,0,24,-24,1,4,12,1,OTC
4737,13-02-2021 12:00,24 hrs.,pennystocks,DIGAF,7,7,0,7,1,1,1,1,OTC
4737,13-02-2021 12:00,24 hrs.,pennystocks,DMGGF,40,0,40,-40,1,5,26,1,OTC
4737,13-02-2021 12:00,24 hrs.,pennystocks,EHVVF,15,0,15,-15,1,0,11,1,OTC
4737,13-02-2021 12:00,24 hrs.,pennystocks,ELRRF,12,0,12,-12,2,2,0,2,OTC
4737,13-02-2021 12:00,24 hrs.,pennystocks,EMHTF,6,0,6,-6,1,1,0,1,OTC
4737,13-02-2021 12:00,24 hrs.,pennystocks,BNGO,73,38,35,3,4,24,9,4,NASDAQ
4737,13-02-2021 12:00,24 hrs.,pennystocks,BWEN,12,12,0,12,2,2,0,2,NASDAQ
4737,13-02-2021 12:00,24 hrs.,pennystocks,CFMS,12,0,12,-12,2,2,0,2,NASDAQ
4737,13-02-2021 12:00,24 hrs.,pennystocks,CIDM,128,0,128,-128,2,30,60,2,NASDAQ
4737,13-02-2021 12:00,24 hrs.,pennystocks,CKPT,27,0,27,-27,3,4,7,3,NASDAQ
4737,13-02-2021 12:00,24 hrs.,pennystocks,CLBS,253,35,218,-183,5,86,61,5,NASDAQ
4737,13-02-2021 12:00,24 hrs.,pennystocks,CLEU,7,0,7,-7,1,1,1,1,NASDAQ
4737,13-02-2021 12:00,24 hrs.,pennystocks,CMPS,16,16,0,16,1,4,4,1,NASDAQ
4737,13-02-2021 12:00,24 hrs.,pennystocks,COCP,37,0,37,-37,2,13,3,2,NASDAQ
4737,13-02-2021 12:00,24 hrs.,pennystocks,CPLP,22,0,22,-22,2,2,10,1,NASDAQ
4737,13-02-2021 12:00,24 hrs.,pennystocks,CRBP,76,0,76,-76,1,32,8,1,NASDAQ
4737,13-02-2021 12:00,24 hrs.,pennystocks,CRWS,6,0,6,-6,1,1,0,1,NASDAQ
4737,13-02-2021 12:00,24 hrs.,pennystocks,CSCW,7,0,7,-7,1,1,1,1,NASDAQ
4737,13-02-2021 12:00,24 hrs.,pennystocks,CSTR,6,0,6,-6,1,1,0,1,NASDAQ
4737,13-02-2021 12:00,24 hrs.,pennystocks,CTHR,20,0,20,-20,1,6,4,1,NASDAQ
4737,13-02-2021 12:00,24 hrs.,pennystocks,CTMX,14,0,14,-14,1,2,6,1,NASDAQ
4737,13-02-2021 12:00,24 hrs.,pennystocks,CTRM,94,43,51,-8,7,21,24,7,NASDAQ
4737,13-02-2021 12:00,24 hrs.,pennystocks,CTXR,22,0,22,-22,1,7,4,1,NASDAQ
4737,13-02-2021 12:00,24 hrs.,pennystocks,CYTH,8,0,8,-8,1,1,2,1,NASDAQ
4737,13-02-2021 12:00,24 hrs.,pennystocks,DFFN,306,21,285,-264,7,119,40,7,NASDAQ
4737,13-02-2021 12:00,24 hrs.,pennystocks,EBON,6,0,6,-6,1,1,0,1,NASDAQ
4737,13-02-2021 12:00,24 hrs.,pennystocks,EDIT,45,45,0,45,1,15,11,1,NASDAQ
4737,13-02-2021 12:00,24 hrs.,pennystocks,ENTX,26,0,26,-26,1,9,4,1,NASDAQ
4737,13-02-2021 12:00,24 hrs.,pennystocks,ENVB,6,0,6,-6,1,1,0,1,NASDAQ
4737,13-02-2021 12:00,24 hrs.,pennystocks,EPSN,12,0,12,-12,2,2,0,2,NASDAQ
4737,13-02-2021 12:00,24 hrs.,pennystocks,FAMI,13,0,13,-13,2,2,1,2,NASDAQ
4737,13-02-2021 12:00,24 hrs.,pennystocks,FAST,6,0,6,-6,1,1,0,1,NASDAQ
4737,13-02-2021 12:00,24 hrs.,pennystocks,FATE,17,0,17,-17,1,6,1,1,NASDAQ
4737,13-02-2021 12:00,24 hrs.,pennystocks,GAIN,7,0,7,-7,1,1,1,1,NASDAQ
4737,13-02-2021 12:00,24 hrs.,pennystocks,GALT,7,0,7,-7,1,1,1,1,NASDAQ
4737,13-02-2021 12:00,24 hrs.,pennystocks,GEVO,6,0,6,-6,1,1,0,1,NASDAQ
4737,13-02-2021 12:00,24 hrs.,pennystocks,GHSI,99,0,99,-99,1,46,3,1,NASDAQ
4737,13-02-2021 12:00,24 hrs.,pennystocks,GLBS,27,0,27,-27,1,0,23,1,NASDAQ
4737,13-02-2021 12:00,24 hrs.,pennystocks,GNPX,6,6,0,6,1,0,2,1,NASDAQ
4737,13-02-2021 12:00,24 hrs.,pennystocks,GNUS,6,6,0,6,1,1,0,1,NASDAQ
4737,13-02-2021 12:00,24 hrs.,pennystocks,GOEV,89,0,89,-89,2,26,29,2,NASDAQ
4737,13-02-2021 12:00,24 hrs.,pennystocks,GOOG,7,7,0,7,1,0,3,1,NASDAQ
4737,13-02-2021 12:00,24 hrs.,pennystocks,HRTX,15,0,15,-15,1,2,7,1,NASDAQ
4737,13-02-2021 12:00,24 hrs.,pennystocks,HSTO,6,0,6,-6,1,1,0,1,NASDAQ
4737,13-02-2021 12:00,24 hrs.,pennystocks,IBKR,7,0,7,-7,1,1,1,1,NASDAQ
4737,13-02-2021 12:00,24 hrs.,pennystocks,KOS,7,0,7,-7,1,1,1,1,NYSE
4737,13-02-2021 12:00,24 hrs.,pennystocks,LOW,6,6,0,6,1,1,0,1,NYSE
4737,13-02-2021 12:00,24 hrs.,pennystocks,MDC,15,0,15,-15,1,4,3,1,NYSE
4737,13-02-2021 12:00,24 hrs.,pennystocks,MED,6,6,0,6,1,1,0,1,NYSE
4737,13-02-2021 12:00,24 hrs.,pennystocks,MIN,6,6,0,6,1,1,0,1,NYSE
4737,13-02-2021 12:00,24 hrs.,pennystocks,NAT,7,0,7,-7,1,1,1,1,NYSE
4737,13-02-2021 12:00,24 hrs.,pennystocks,NOK,6,0,6,-6,1,1,0,1,NYSE
4737,13-02-2021 12:00,24 hrs.,pennystocks,NPV,28,0,28,-28,1,9,6,1,NYSE
4737,13-02-2021 12:00,24 hrs.,pennystocks,RKT,82,0,82,-82,1,25,28,1,NYSE
4737,13-02-2021 12:00,24 hrs.,pennystocks,RSI,283,0,283,-283,1,122,35,1,NYSE
4737,13-02-2021 12:00,24 hrs.,pennystocks,SOS,53,0,53,-53,4,9,19,4,NYSE
4737,13-02-2021 12:00,24 hrs.,pennystocks,SUM,283,0,283,-283,1,122,35,1,NYSE
4737,13-02-2021 12:00,24 hrs.,pennystocks,TSM,48,0,48,-48,1,13,18,1,NYSE
4737,13-02-2021 12:00,24 hrs.,pennystocks,VET,7,0,7,-7,1,1,1,1,NYSE
4737,13-02-2021 12:00,24 hrs.,pennystocks,WEI,17,0,17,-17,1,6,1,1,NYSE
4737,13-02-2021 12:00,24 hrs.,pennystocks,WLL,6,0,6,-6,1,1,0,1,NYSE
4737,13-02-2021 12:00,24 hrs.,pennystocks,ARGO,58,18,40,-22,2,10,30,2,NYSE
4737,13-02-2021 12:00,24 hrs.,pennystocks,CCIV,7,0,7,-7,1,1,1,1,NYSE
4737,13-02-2021 12:00,24 hrs.,pennystocks,DASH,24,24,0,24,1,7,6,1,NYSE
4737,13-02-2021 12:00,24 hrs.,pennystocks,FINV,16,0,16,-16,1,4,4,1,NYSE
4737,13-02-2021 12:00,24 hrs.,pennystocks,HEXO,23,0,23,-23,1,2,15,1,NYSE
4737,13-02-2021 12:00,24 hrs.,pennystocks,PUMP,13,0,13,-13,2,2,1,1,NYSE
4737,13-02-2021 12:00,24 hrs.,pennystocks,SHOP,12,0,12,-12,2,2,0,1,NYSE
4737,13-02-2021 12:00,24 hrs.,pennystocks,SPCE,38,38,0,38,1,14,6,1,NYSE
4737,13-02-2021 12:00,24 hrs.,pennystocks,TBLT,200,194,6,188,2,73,46,2,NASDAQ
4737,13-02-2021 12:00,24 hrs.,pennystocks,TLRY,7,0,7,-7,1,1,1,1,NASDAQ
4737,13-02-2021 12:00,24 hrs.,pennystocks,TNXP,244,159,85,74,9,78,52,5,NASDAQ
4737,13-02-2021 12:00,24 hrs.,pennystocks,TRCH,257,200,57,143,5,85,67,5,NASDAQ
4737,13-02-2021 12:00,24 hrs.,pennystocks,TRIP,16,16,0,16,1,2,8,1,NASDAQ
4737,13-02-2021 12:00,24 hrs.,pennystocks,TRVG,19,0,19,-19,3,3,1,2,NASDAQ
4737,13-02-2021 12:00,24 hrs.,pennystocks,TXMD,13,6,7,-1,2,2,1,2,NASDAQ
4737,13-02-2021 12:00,24 hrs.,pennystocks,TYME,22,0,22,-22,1,7,4,1,NASDAQ
4737,13-02-2021 12:00,24 hrs.,pennystocks,VEON,7,0,7,-7,1,1,1,1,NASDAQ
4737,13-02-2021 12:00,24 hrs.,pennystocks,VETS,1740,0,1740,-1740,1,738,260,1,NASDAQ
4737,13-02-2021 12:00,24 hrs.,pennystocks,VTGN,7,7,0,7,1,1,1,1,NASDAQ
4737,13-02-2021 12:00,24 hrs.,pennystocks,VUZI,6,6,0,6,1,0,2,1,NASDAQ
4737,13-02-2021 12:00,24 hrs.,pennystocks,XSPA,38,0,38,-38,1,15,4,1,NASDAQ
4737,13-02-2021 12:00,24 hrs.,pennystocks,ZSAN,88,0,88,-88,2,26,28,2,NASDAQ
4737,13-02-2021 12:00,24 hrs.,wallstreetbets,ABML,7,0,7,-7,1,1,1,1,OTC
4737,13-02-2021 12:00,24 hrs.,wallstreetbets,ACRL,6,0,6,-6,1,1,0,1,OTC
4737,13-02-2021 12:00,24 hrs.,wallstreetbets,ACTX,8,0,8,-8,1,1,2,1,OTC
4737,13-02-2021 12:00,24 hrs.,wallstreetbets,AITX,23,23,0,23,2,1,13,2,OTC
4737,13-02-2021 12:00,24 hrs.,wallstreetbets,ALPP,14,0,14,-14,2,2,2,2,OTC
4737,13-02-2021 12:00,24 hrs.,wallstreetbets,ALYI,7,0,7,-7,1,1,1,1,OTC
4737,13-02-2021 12:00,24 hrs.,wallstreetbets,AMNE,13,0,13,-13,2,2,1,1,OTC
4737,13-02-2021 12:00,24 hrs.,wallstreetbets,APCX,7,0,7,-7,1,1,1,1,OTC
4737,13-02-2021 12:00,24 hrs.,wallstreetbets,ASTI,7,7,0,7,1,1,1,1,OTC
4737,13-02-2021 12:00,24 hrs.,wallstreetbets,BANT,13,7,6,1,2,2,1,2,OTC
4737,13-02-2021 12:00,24 hrs.,wallstreetbets,BBRW,20,20,0,20,3,3,2,1,OTC
4737,13-02-2021 12:00,24 hrs.,wallstreetbets,BLSP,28,7,21,-14,4,4,4,2,OTC
4737,13-02-2021 12:00,24 hrs.,wallstreetbets,BOTH,7,0,7,-7,1,1,1,1,OTC
4737,13-02-2021 12:00,24 hrs.,wallstreetbets,BOTY,12,6,6,0,2,2,0,2,OTC
4737,13-02-2021 12:00,24 hrs.,wallstreetbets,BRLL,7,0,7,-7,1,1,1,1,OTC
4737,13-02-2021 12:00,24 hrs.,wallstreetbets,BTCS,21,0,21,-21,3,3,3,1,OTC
4737,13-02-2021 12:00,24 hrs.,wallstreetbets,BTSC,7,0,7,-7,1,1,1,1,OTC
4737,13-02-2021 12:00,24 hrs.,wallstreetbets,BTZI,13,0,13,-13,2,2,1,2,OTC
4737,13-02-2021 12:00,24 hrs.,pennystocks,IDEX,6,6,0,6,1,0,2,1,NASDAQ
4737,13-02-2021 12:00,24 hrs.,pennystocks,INFI,12,0,12,-12,1,1,6,1,NASDAQ
4737,13-02-2021 12:00,24 hrs.,pennystocks,INOD,73,0,73,-73,1,13,43,1,NASDAQ
4737,13-02-2021 12:00,24 hrs.,pennystocks,INPX,6,6,0,6,1,1,0,1,NASDAQ
4737,13-02-2021 12:00,24 hrs.,pennystocks,IRDM,17,0,17,-17,1,6,1,1,NASDAQ
4737,13-02-2021 12:00,24 hrs.,pennystocks,IZEA,6,0,6,-6,1,1,0,1,NASDAQ
4737,13-02-2021 12:00,24 hrs.,pennystocks,KTRA,51,0,51,-51,3,8,23,3,NASDAQ
4737,13-02-2021 12:00,24 hrs.,pennystocks,KXIN,17,0,17,-17,1,6,1,1,NASDAQ
4737,13-02-2021 12:00,24 hrs.,pennystocks,LIFE,6,6,0,6,1,1,0,1,NASDAQ
4737,13-02-2021 12:00,24 hrs.,pennystocks,LIVX,6,6,0,6,1,1,0,1,NASDAQ
4737,13-02-2021 12:00,24 hrs.,pennystocks,LLIT,7,7,0,7,1,1,1,1,NASDAQ
4737,13-02-2021 12:00,24 hrs.,pennystocks,GBT,6,0,6,-6,1,1,0,1,NASDAQ
4737,13-02-2021 12:00,24 hrs.,pennystocks,MKD,29,0,29,-29,1,9,7,1,NASDAQ
4737,13-02-2021 12:00,24 hrs.,pennystocks,MYT,11,0,11,-11,1,1,5,1,NASDAQ
4737,13-02-2021 12:00,24 hrs.,pennystocks,OGI,19,19,0,19,1,6,3,1,NASDAQ
4737,13-02-2021 12:00,24 hrs.,pennystocks,SND,45,45,0,45,1,12,17,1,NASDAQ
4737,13-02-2021 12:00,24 hrs.,pennystocks,SPI,11,11,0,11,1,2,3,1,NASDAQ
4737,13-02-2021 12:00,24 hrs.,pennystocks,ABEO,7,0,7,-7,1,1,1,1,NASDAQ
4737,13-02-2021 12:00,24 hrs.,pennystocks,ACST,6,0,6,-6,1,1,0,1,NASDAQ
4737,13-02-2021 12:00,24 hrs.,pennystocks,AGEN,10,0,10,-10,1,3,0,1,NASDAQ
4737,13-02-2021 12:00,24 hrs.,pennystocks,AGTC,14,0,14,-14,2,2,2,2,NASDAQ
4737,13-02-2021 12:00,24 hrs.,pennystocks,AIKI,6,6,0,6,1,1,0,1,NASDAQ
4737,13-02-2021 12:00,24 hrs.,pennystocks,ALNA,9,9,0,9,1,1,3,1,NASDAQ
4737,13-02-2021 12:00,24 hrs.,pennystocks,AMTX,83,0,83,-83,1,30,19,1,NASDAQ
4737,13-02-2021 12:00,24 hrs.,pennystocks,APHA,85,0,85,-85,3,27,19,3,NASDAQ
4737,13-02-2021 12:00,24 hrs.,pennystocks,APRE,6,6,0,6,1,1,0,1,NASDAQ
4737,13-02-2021 12:00,24 hrs.,pennystocks,ARTL,53,0,53,-53,5,13,7,3,NASDAQ
4737,13-02-2021 12:00,24 hrs.,pennystocks,ASRT,473,0,473,-473,6,165,119,6,NASDAQ
4737,13-02-2021 12:00,24 hrs.,pennystocks,ATOS,122,0,122,-122,3,41,28,3,NASDAQ
4737,13-02-2021 12:00,24 hrs.,pennystocks,BCLI,6,6,0,6,1,0,2,1,NASDAQ
4737,13-02-2021 12:00,24 hrs.,pennystocks,BIOL,51,45,6,39,2,13,17,2,NASDAQ
4737,13-02-2021 12:00,24 hrs.,pennystocks,BLUE,21,21,0,21,1,5,7,1,NASDAQ
4737,13-02-2021 12:00,24 hrs.,wallstreetbets,HIHI,7,0,7,-7,1,1,1,1,OTC
4737,13-02-2021 12:00,24 hrs.,wallstreetbets,HMNY,42,0,42,-42,6,6,6,3,OTC
4737,13-02-2021 12:00,24 hrs.,wallstreetbets,HMPQ,7,0,7,-7,1,1,1,1,OTC
4737,13-02-2021 12:00,24 hrs.,wallstreetbets,HQGE,35,0,35,-35,5,5,5,3,OTC
4737,13-02-2021 12:00,24 hrs.,wallstreetbets,HRBR,6,0,6,-6,1,1,0,1,OTC
4737,13-02-2021 12:00,24 hrs.,wallstreetbets,HTRE,7,7,0,7,1,1,1,1,OTC
4737,13-02-2021 12:00,24 hrs.,wallstreetbets,HYSR,20,7,13,-6,3,3,2,3,OTC
4737,13-02-2021 12:00,24 hrs.,wallstreetbets,ICBU,7,0,7,-7,1,1,1,1,OTC
4737,13-02-2021 12:00,24 hrs.,wallstreetbets,INCT,21,0,21,-21,3,3,3,2,OTC
4737,13-02-2021 12:00,24 hrs.,wallstreetbets,INKW,7,0,7,-7,1,1,1,1,OTC
4737,13-02-2021 12:00,24 hrs.,wallstreetbets,INND,14,0,14,-14,2,2,2,1,OTC
4737,13-02-2021 12:00,24 hrs.,wallstreetbets,INTV,28,7,21,-14,4,4,4,3,OTC
4737,13-02-2021 12:00,24 hrs.,wallstreetbets,IPIX,10,0,10,-10,1,3,0,1,OTC
4737,13-02-2021 12:00,24 hrs.,wallstreetbets,IQST,13,0,13,-13,2,2,1,1,OTC
4737,13-02-2021 12:00,24 hrs.,wallstreetbets,ITCJ,6,0,6,-6,1,1,0,1,OTC
4737,13-02-2021 12:00,24 hrs.,wallstreetbets,KALY,7,0,7,-7,1,1,1,1,OTC
4737,13-02-2021 12:00,24 hrs.,wallstreetbets,KYNC,7,0,7,-7,1,1,1,1,OTC
4737,13-02-2021 12:00,24 hrs.,wallstreetbets,LBCC,7,0,7,-7,1,1,1,1,OTC
4737,13-02-2021 12:00,24 hrs.,wallstreetbets,LINK,459,0,459,-459,5,181,77,5,OTC
4737,13-02-2021 12:00,24 hrs.,wallstreetbets,LITH,7,0,7,-7,1,1,1,1,OTC
4737,13-02-2021 12:00,24 hrs.,wallstreetbets,LQMT,7,7,0,7,1,1,1,1,OTC
4737,13-02-2021 12:00,24 hrs.,wallstreetbets,BUDZ,6,0,6,-6,1,1,0,1,OTC
4737,13-02-2021 12:00,24 hrs.,wallstreetbets,CBDD,7,0,7,-7,1,1,1,1,OTC
4737,13-02-2021 12:00,24 hrs.,wallstreetbets,CBDL,55,0,55,-55,8,8,7,5,OTC
4737,13-02-2021 12:00,24 hrs.,wallstreetbets,CCTC,7,0,7,-7,1,1,1,1,OTC
4737,13-02-2021 12:00,24 hrs.,wallstreetbets,CGLD,7,0,7,-7,1,1,1,1,OTC
4737,13-02-2021 12:00,24 hrs.,wallstreetbets,CLIS,14,0,14,-14,2,2,2,1,OTC
4737,13-02-2021 12:00,24 hrs.,wallstreetbets,CLWD,7,0,7,-7,1,1,1,1,OTC
4737,13-02-2021 12:00,24 hrs.,wallstreetbets,COMS,19,0,19,-19,3,3,1,2,OTC
4737,13-02-2021 12:00,24 hrs.,wallstreetbets,CYDY,7,0,7,-7,1,1,1,1,OTC
4737,13-02-2021 12:00,24 hrs.,wallstreetbets,CYLC,7,0,7,-7,1,1,1,1,OTC
4737,13-02-2021 12:00,24 hrs.,wallstreetbets,DGWR,7,0,7,-7,1,1,1,1,OTC
4737,13-02-2021 12:00,24 hrs.,pennystocks,LPTH,76,0,76,-76,1,30,12,1,NASDAQ
4737,13-02-2021 12:00,24 hrs.,pennystocks,LPTX,45,45,0,45,1,12,17,1,NASDAQ
4737,13-02-2021 12:00,24 hrs.,pennystocks,MARK,6,0,6,-6,1,1,0,1,NASDAQ
4737,13-02-2021 12:00,24 hrs.,pennystocks,MOGO,27,27,0,27,1,8,7,1,NASDAQ
4737,13-02-2021 12:00,24 hrs.,pennystocks,MVIS,14,14,0,14,1,0,10,1,NASDAQ
4737,13-02-2021 12:00,24 hrs.,pennystocks,NAKD,1222,1182,40,1142,3,526,158,3,NASDAQ
4737,13-02-2021 12:00,24 hrs.,pennystocks,NAOV,6,0,6,-6,1,1,0,1,NASDAQ
4737,13-02-2021 12:00,24 hrs.,pennystocks,NCMI,15,0,15,-15,1,4,3,1,NASDAQ
4737,13-02-2021 12:00,24 hrs.,pennystocks,NDAQ,17,0,17,-17,1,6,1,1,NASDAQ
4737,13-02-2021 12:00,24 hrs.,pennystocks,NMTR,6,6,0,6,1,1,0,1,NASDAQ
4737,13-02-2021 12:00,24 hrs.,pennystocks,NOVN,6,0,6,-6,1,1,0,1,NASDAQ
4737,13-02-2021 12:00,24 hrs.,pennystocks,NVCN,61,6,55,-49,3,18,13,3,NASDAQ
4737,13-02-2021 12:00,24 hrs.,pennystocks,OCGN,68,6,62,-56,4,17,18,4,NASDAQ
4737,13-02-2021 12:00,24 hrs.,pennystocks,ONTX,6,0,6,-6,1,1,0,1,NASDAQ
4737,13-02-2021 12:00,24 hrs.,pennystocks,OPTT,26,0,26,-26,1,9,4,1,NASDAQ
4737,13-02-2021 12:00,24 hrs.,pennystocks,OTIC,10,0,10,-10,1,1,4,1,NASDAQ
4737,13-02-2021 12:00,24 hrs.,pennystocks,PLAY,6,0,6,-6,1,1,0,1,NASDAQ
4737,13-02-2021 12:00,24 hrs.,pennystocks,PLUG,17,0,17,-17,1,6,1,1,NASDAQ
4737,13-02-2021 12:00,24 hrs.,pennystocks,PTON,38,38,0,38,1,14,6,1,NASDAQ
4737,13-02-2021 12:00,24 hrs.,pennystocks,PULM,190,0,190,-190,4,36,102,4,NASDAQ
4737,13-02-2021 12:00,24 hrs.,pennystocks,RIBT,13,6,7,-1,2,2,1,2,NASDAQ
4737,13-02-2021 12:00,24 hrs.,pennystocks,RIDE,6,0,6,-6,1,1,0,1,NASDAQ
4737,13-02-2021 12:00,24 hrs.,pennystocks,SEAC,5,5,0,5,1,0,1,1,NASDAQ
4737,13-02-2021 12:00,24 hrs.,pennystocks,SELB,22,0,22,-22,1,7,4,1,NASDAQ
4737,13-02-2021 12:00,24 hrs.,pennystocks,SESN,71,0,71,-71,1,31,5,1,NASDAQ
4737,13-02-2021 12:00,24 hrs.,pennystocks,SFET,33,0,33,-33,2,6,13,2,NASDAQ
4737,13-02-2021 12:00,24 hrs.,pennystocks,SHIP,14,0,14,-14,2,2,2,1,NASDAQ
4737,13-02-2021 12:00,24 hrs.,pennystocks,SNDL,112,6,106,-100,18,18,4,15,NASDAQ
4737,13-02-2021 12:00,24 hrs.,pennystocks,SNGX,2035,19,2016,-1997,16,794,383,8,NASDAQ
4737,13-02-2021 12:00,24 hrs.,pennystocks,SOLO,17,0,17,-17,1,6,1,1,NASDAQ
4737,13-02-2021 12:00,24 hrs.,pennystocks,SRGA,6,0,6,-6,1,1,0,1,NASDAQ
4737,13-02-2021 12:00,24 hrs.,pennystocks,STCN,6,0,6,-6,1,1,0,1,NASDAQ
4737,13-02-2021 12:00,24 hrs.,wallstreetbets,LTNC,14,0,14,-14,2,2,2,2,OTC
4737,13-02-2021 12:00,24 hrs.,wallstreetbets,LTUM,6,0,6,-6,1,1,0,1,OTC
4737,13-02-2021 12:00,24 hrs.,wallstreetbets,MAXD,22,0,22,-22,3,3,4,3,OTC
4737,13-02-2021 12:00,24 hrs.,wallstreetbets,MCOA,20,0,20,-20,3,3,2,3,OTC
4737,13-02-2021 12:00,24 hrs.,wallstreetbets,MEDH,7,0,7,-7,1,1,1,1,OTC
4737,13-02-2021 12:00,24 hrs.,wallstreetbets,MGNT,7,0,7,-7,1,1,1,1,OTC
4737,13-02-2021 12:00,24 hrs.,wallstreetbets,MGTI,7,0,7,-7,1,1,1,1,OTC
4737,13-02-2021 12:00,24 hrs.,wallstreetbets,MINE,48,0,48,-48,7,7,6,4,OTC
4737,13-02-2021 12:00,24 hrs.,wallstreetbets,MJNA,34,7,27,-20,5,5,4,5,OTC
4737,13-02-2021 12:00,24 hrs.,wallstreetbets,MKTY,21,0,21,-21,3,3,3,2,OTC
4737,13-02-2021 12:00,24 hrs.,wallstreetbets,MLFB,7,7,0,7,1,1,1,1,OTC
4737,13-02-2021 12:00,24 hrs.,wallstreetbets,MNGG,6,6,0,6,1,1,0,1,OTC
4737,13-02-2021 12:00,24 hrs.,wallstreetbets,MOJO,13,0,13,-13,2,2,1,1,OTC
4737,13-02-2021 12:00,24 hrs.,wallstreetbets,MOST,53,0,53,-53,4,16,5,4,OTC
4737,13-02-2021 12:00,24 hrs.,wallstreetbets,NBVG,6,0,6,-6,1,1,0,1,OTC
4737,13-02-2021 12:00,24 hrs.,wallstreetbets,NEOM,28,0,28,-28,4,4,4,2,OTC
4737,13-02-2021 12:00,24 hrs.,wallstreetbets,NOVC,34,0,34,-34,5,5,4,3,OTC
4737,13-02-2021 12:00,24 hrs.,wallstreetbets,NPHC,7,0,7,-7,1,1,1,1,OTC
4737,13-02-2021 12:00,24 hrs.,wallstreetbets,NWPN,6,0,6,-6,1,1,0,1,OTC
4737,13-02-2021 12:00,24 hrs.,wallstreetbets,ONPH,6,0,6,-6,1,1,0,1,OTC
4737,13-02-2021 12:00,24 hrs.,wallstreetbets,OTTV,14,0,14,-14,2,2,2,1,OTC
4737,13-02-2021 12:00,24 hrs.,wallstreetbets,OWPC,6,0,6,-6,1,1,0,1,OTC
4737,13-02-2021 12:00,24 hrs.,wallstreetbets,OZSC,14,0,14,-14,2,2,2,2,OTC
4737,13-02-2021 12:00,24 hrs.,wallstreetbets,PAOG,7,0,7,-7,1,1,1,1,OTC
4737,13-02-2021 12:00,24 hrs.,wallstreetbets,PHBI,14,0,14,-14,2,2,2,1,OTC
4737,13-02-2021 12:00,24 hrs.,wallstreetbets,QOIL,6,0,6,-6,1,1,0,1,OTC
4737,13-02-2021 12:00,24 hrs.,wallstreetbets,RBDC,7,0,7,-7,1,1,1,1,OTC
4737,13-02-2021 12:00,24 hrs.,wallstreetbets,RBNW,6,0,6,-6,1,1,0,1,OTC
4737,13-02-2021 12:00,24 hrs.,wallstreetbets,REFG,7,0,7,-7,1,1,1,1,OTC
4737,13-02-2021 12:00,24 hrs.,wallstreetbets,RELI,6,0,6,-6,1,1,0,1,OTC
4737,13-02-2021 12:00,24 hrs.,wallstreetbets,RSSV,9,0,9,-9,1,2,1,1,OTC
4737,13-02-2021 12:00,24 hrs.,wallstreetbets,RTON,14,6,8,-2,2,2,2,2,OTC
4737,13-02-2021 12:00,24 hrs.,wallstreetbets,SBFM,7,7,0,7,1,1,1,1,OTC
4737,13-02-2021 12:00,24 hrs.,wallstreetbets,SFOR,7,7,0,7,1,1,1,1,OTC
4737,13-02-2021 12:00,24 hrs.,wallstreetbets,SHMP,14,0,14,-14,2,2,2,2,OTC
4737,13-02-2021 12:00,24 hrs.,wallstreetbets,SHWZ,7,7,0,7,1,1,1,1,OTC
4737,13-02-2021 12:00,24 hrs.,wallstreetbets,SIGN,28,14,14,0,4,4,4,3,OTC
4737,13-02-2021 12:00,24 hrs.,wallstreetbets,SIMP,7,0,7,-7,1,1,1,1,OTC
4737,13-02-2021 12:00,24 hrs.,wallstreetbets,DPLS,13,0,13,-13,2,2,1,2,OTC
4737,13-02-2021 12:00,24 hrs.,wallstreetbets,DPWW,7,0,7,-7,1,1,1,1,OTC
4737,13-02-2021 12:00,24 hrs.,wallstreetbets,EFIR,7,7,0,7,1,1,1,1,OTC
4737,13-02-2021 12:00,24 hrs.,wallstreetbets,ELCR,7,0,7,-7,1,1,1,1,OTC
4737,13-02-2021 12:00,24 hrs.,wallstreetbets,ELTP,31,7,24,-17,4,4,7,4,OTC
4737,13-02-2021 12:00,24 hrs.,wallstreetbets,ENZN,7,0,7,-7,1,1,1,1,OTC
4737,13-02-2021 12:00,24 hrs.,wallstreetbets,EPOR,8,8,0,8,1,1,2,1,OTC
4737,13-02-2021 12:00,24 hrs.,wallstreetbets,ETFM,17,0,17,-17,2,2,5,1,OTC
4737,13-02-2021 12:00,24 hrs.,wallstreetbets,EWKS,6,0,6,-6,1,1,0,1,OTC
4737,13-02-2021 12:00,24 hrs.,wallstreetbets,FNMA,7,7,0,7,1,1,1,1,OTC
4737,13-02-2021 12:00,24 hrs.,wallstreetbets,FTEG,14,0,14,-14,2,2,2,1,OTC
4737,13-02-2021 12:00,24 hrs.,wallstreetbets,FTPM,7,0,7,-7,1,1,1,1,OTC
4737,13-02-2021 12:00,24 hrs.,wallstreetbets,GAHC,14,14,0,14,2,2,2,1,OTC
4737,13-02-2021 12:00,24 hrs.,wallstreetbets,GARB,7,0,7,-7,1,1,1,1,OTC
4737,13-02-2021 12:00,24 hrs.,wallstreetbets,GBTC,6086,0,6086,-6086,3,2862,350,2,OTC
4737,13-02-2021 12:00,24 hrs.,wallstreetbets,GMEV,14,0,14,-14,2,2,2,2,OTC
4737,13-02-2021 12:00,24 hrs.,wallstreetbets,GMSC,14,0,14,-14,2,2,2,1,OTC
4737,13-02-2021 12:00,24 hrs.,wallstreetbets,GPFT,27,0,27,-27,4,4,3,4,OTC
4737,13-02-2021 12:00,24 hrs.,wallstreetbets,GRNH,7,7,0,7,1,1,1,1,OTC
4737,13-02-2021 12:00,24 hrs.,wallstreetbets,GTCH,7,0,7,-7,1,1,1,1,OTC
4737,13-02-2021 12:00,24 hrs.,wallstreetbets,GTEH,20,0,20,-20,3,3,2,2,OTC
4737,13-02-2021 12:00,24 hrs.,wallstreetbets,GTLL,12,6,6,0,2,2,0,2,OTC
4737,13-02-2021 12:00,24 hrs.,wallstreetbets,GTXO,14,0,14,-14,2,2,2,1,OTC
4737,13-02-2021 12:00,24 hrs.,wallstreetbets,HCMC,320,61,259,-198,47,47,38,42,OTC
4737,13-02-2021 12:00,24 hrs.,wallstreetbets,HEMP,27,6,21,-15,4,4,3,3,OTC
4737,13-02-2021 12:00,24 hrs.,wallstreetbets,HGLC,14,14,0,14,2,2,2,1,OTC
4737,13-02-2021 12:00,24 hrs.,wallstreetbets,PDYPF,7,0,7,-7,1,1,1,1,OTC
4737,13-02-2021 12:00,24 hrs.,wallstreetbets,PMNXF,6,0,6,-6,1,1,0,1,OTC
4737,13-02-2021 12:00,24 hrs.,wallstreetbets,RAZFF,7,0,7,-7,1,1,1,1,OTC
4737,13-02-2021 12:00,24 hrs.,wallstreetbets,RLLCF,72,0,72,-72,10,10,12,10,OTC
4737,13-02-2021 12:00,24 hrs.,wallstreetbets,RYCEY,78,7,71,-64,11,11,12,10,OTC
4737,13-02-2021 12:00,24 hrs.,wallstreetbets,SBSAA,7,0,7,-7,1,1,1,1,OTC
4737,13-02-2021 12:00,24 hrs.,wallstreetbets,SHRMF,6,6,0,6,1,1,0,1,OTC
4737,13-02-2021 12:00,24 hrs.,wallstreetbets,SPRWF,28,0,28,-28,4,4,4,3,OTC
4737,13-02-2021 12:00,24 hrs.,wallstreetbets,TBUIF,13,0,13,-13,2,2,1,1,OTC
4737,13-02-2021 12:00,24 hrs.,wallstreetbets,TCNNF,6106,6,6100,-6094,6,2865,352,2,OTC
4737,13-02-2021 12:00,24 hrs.,wallstreetbets,TGODF,7,0,7,-7,1,1,1,1,OTC
4737,13-02-2021 12:00,24 hrs.,wallstreetbets,TPPRF,14,0,14,-14,2,2,2,1,OTC
4737,13-02-2021 12:00,24 hrs.,wallstreetbets,TSCRF,64,0,64,-64,3,9,34,2,OTC
4737,13-02-2021 12:00,24 hrs.,wallstreetbets,TXLZF,7,0,7,-7,1,1,1,1,OTC
4737,13-02-2021 12:00,24 hrs.,wallstreetbets,VALPQ,10,0,10,-10,1,2,2,1,OTC
4737,13-02-2021 12:00,24 hrs.,wallstreetbets,VVCIF,6,0,6,-6,1,1,0,1,OTC
4737,13-02-2021 12:00,24 hrs.,wallstreetbets,VYGVF,6,6,0,6,1,1,0,1,OTC
4737,13-02-2021 12:00,24 hrs.,wallstreetbets,ZBISF,7,7,0,7,1,1,1,1,OTC
4737,13-02-2021 12:00,24 hrs.,wallstreetbets,AAU,14,0,14,-14,2,2,2,2,AMEX
4737,13-02-2021 12:00,24 hrs.,wallstreetbets,BTN,15,0,15,-15,2,2,3,1,AMEX
4737,13-02-2021 12:00,24 hrs.,wallstreetbets,DIT,6,0,6,-6,1,1,0,1,AMEX
4737,13-02-2021 12:00,24 hrs.,wallstreetbets,DNN,199,55,144,-89,29,29,25,23,AMEX
4737,13-02-2021 12:00,24 hrs.,wallstreetbets,DPW,14,0,14,-14,2,2,2,2,AMEX
4737,13-02-2021 12:00,24 hrs.,wallstreetbets,GDP,189,0,189,-189,2,56,69,2,AMEX
4737,13-02-2021 12:00,24 hrs.,wallstreetbets,SIRR,7,0,7,-7,1,1,1,1,OTC
4737,13-02-2021 12:00,24 hrs.,wallstreetbets,SNDD,7,7,0,7,1,1,1,1,OTC
4737,13-02-2021 12:00,24 hrs.,wallstreetbets,SNRS,7,7,0,7,1,1,1,1,OTC
4737,13-02-2021 12:00,24 hrs.,wallstreetbets,SNYR,14,0,14,-14,2,2,2,1,OTC
4737,13-02-2021 12:00,24 hrs.,wallstreetbets,SRMX,13,0,13,-13,2,2,1,2,OTC
4737,13-02-2021 12:00,24 hrs.,wallstreetbets,SUIC,6,0,6,-6,1,1,0,1,OTC
4737,13-02-2021 12:00,24 hrs.,wallstreetbets,TCHH,12,6,6,0,2,2,0,2,OTC
4737,13-02-2021 12:00,24 hrs.,wallstreetbets,TGLO,7,0,7,-7,1,1,1,1,OTC
4737,13-02-2021 12:00,24 hrs.,wallstreetbets,TRTC,21,0,21,-21,3,3,3,2,OTC
4737,13-02-2021 12:00,24 hrs.,wallstreetbets,TSNP,21,7,14,-7,3,3,3,3,OTC
4737,13-02-2021 12:00,24 hrs.,wallstreetbets,UBQU,7,0,7,-7,1,1,1,1,OTC
4737,13-02-2021 12:00,24 hrs.,wallstreetbets,USDC,21,13,8,5,3,3,3,3,OTC
4737,13-02-2021 12:00,24 hrs.,wallstreetbets,USMJ,13,0,13,-13,2,2,1,2,OTC
4737,13-02-2021 12:00,24 hrs.,wallstreetbets,USPS,6,6,0,6,1,1,0,1,OTC
4737,13-02-2021 12:00,24 hrs.,wallstreetbets,UVSE,7,0,7,-7,1,1,1,1,OTC
4737,13-02-2021 12:00,24 hrs.,wallstreetbets,VTLR,7,0,7,-7,1,1,1,1,OTC
4737,13-02-2021 12:00,24 hrs.,wallstreetbets,VYST,6,0,6,-6,1,1,0,1,OTC
4737,13-02-2021 12:00,24 hrs.,wallstreetbets,WDDD,7,0,7,-7,1,1,1,1,OTC
4737,13-02-2021 12:00,24 hrs.,wallstreetbets,WDLF,7,0,7,-7,1,1,1,1,OTC
4737,13-02-2021 12:00,24 hrs.,wallstreetbets,WHEN,13,7,6,1,2,2,1,2,OTC
4737,13-02-2021 12:00,24 hrs.,wallstreetbets,WSSE,7,0,7,-7,1,1,1,1,OTC
4737,13-02-2021 12:00,24 hrs.,wallstreetbets,XFLS,6,6,0,6,1,1,0,1,OTC
4737,13-02-2021 12:00,24 hrs.,wallstreetbets,YRIV,19,0,19,-19,1,3,9,1,OTC
4737,13-02-2021 12:00,24 hrs.,wallstreetbets,ZMRK,7,0,7,-7,1,1,1,1,OTC
4737,13-02-2021 12:00,24 hrs.,wallstreetbets,ZNOG,7,0,7,-7,1,1,1,1,OTC
4737,13-02-2021 12:00,24 hrs.,wallstreetbets,AGUNF,6,0,6,-6,1,1,0,1,OTC
4737,13-02-2021 12:00,24 hrs.,wallstreetbets,AMYZF,23,0,23,-23,3,3,5,2,OTC
4737,13-02-2021 12:00,24 hrs.,wallstreetbets,ARBKF,6,0,6,-6,1,1,0,1,OTC
4737,13-02-2021 12:00,24 hrs.,wallstreetbets,ATURF,7,0,7,-7,1,1,1,1,OTC
4737,13-02-2021 12:00,24 hrs.,wallstreetbets,AZKLF,18,0,18,-18,3,3,0,1,OTC
4737,13-02-2021 12:00,24 hrs.,wallstreetbets,BBKCF,6,0,6,-6,1,1,0,1,OTC
4737,13-02-2021 12:00,24 hrs.,wallstreetbets,BDRBF,14,0,14,-14,2,2,2,2,OTC
4737,13-02-2021 12:00,24 hrs.,wallstreetbets,CLXPF,7,0,7,-7,1,1,1,1,OTC
4737,13-02-2021 12:00,24 hrs.,wallstreetbets,CNPOF,7,7,0,7,1,1,1,1,OTC
4737,13-02-2021 12:00,24 hrs.,wallstreetbets,CRLBF,18,6,12,-6,3,3,0,3,OTC
4737,13-02-2021 12:00,24 hrs.,wallstreetbets,CTTAY,40,0,40,-40,1,13,10,1,OTC
4737,13-02-2021 12:00,24 hrs.,wallstreetbets,CURLF,6,6,0,6,1,1,0,1,OTC
4737,13-02-2021 12:00,24 hrs.,wallstreetbets,DIAAF,7,0,7,-7,1,1,1,1,OTC
4737,13-02-2021 12:00,24 hrs.,wallstreetbets,EPWCF,7,0,7,-7,1,1,1,1,OTC
4737,13-02-2021 12:00,24 hrs.,wallstreetbets,LRDG,14,14,0,14,2,2,2,1,OTC
4737,13-02-2021 12:00,24 hrs.,wallstreetbets,BYD,7,7,0,7,1,1,1,1,NYSE
4737,13-02-2021 12:00,24 hrs.,wallstreetbets,CAT,14,7,7,0,2,2,2,2,NYSE
4737,13-02-2021 12:00,24 hrs.,wallstreetbets,CCL,20,6,14,-8,3,3,2,2,NYSE
4737,13-02-2021 12:00,24 hrs.,wallstreetbets,CMA,6,6,0,6,1,1,0,1,NYSE
4737,13-02-2021 12:00,24 hrs.,wallstreetbets,CMC,15,0,15,-15,1,1,9,1,NYSE
4737,13-02-2021 12:00,24 hrs.,wallstreetbets,CPE,7,0,7,-7,1,1,1,1,NYSE
4737,13-02-2021 12:00,24 hrs.,wallstreetbets,CPG,7,0,7,-7,1,1,1,1,NYSE
4737,13-02-2021 12:00,24 hrs.,wallstreetbets,CPS,6,6,0,6,1,1,0,1,NYSE
4737,13-02-2021 12:00,24 hrs.,wallstreetbets,CSV,236,236,0,236,1,63,106,1,NYSE
4737,13-02-2021 12:00,24 hrs.,wallstreetbets,CVS,14,7,7,0,2,2,2,2,NYSE
4737,13-02-2021 12:00,24 hrs.,wallstreetbets,DAC,20,0,20,-20,3,3,2,2,NYSE
4737,13-02-2021 12:00,24 hrs.,wallstreetbets,DAL,13,0,13,-13,2,2,1,2,NYSE
4737,13-02-2021 12:00,24 hrs.,wallstreetbets,DAO,12,0,12,-12,2,2,0,1,NYSE
4737,13-02-2021 12:00,24 hrs.,wallstreetbets,DHT,7,0,7,-7,1,1,1,1,NYSE
4737,13-02-2021 12:00,24 hrs.,wallstreetbets,DIS,453,0,453,-453,4,180,77,4,NYSE
4737,13-02-2021 12:00,24 hrs.,wallstreetbets,DTE,173,0,173,-173,1,56,57,1,NYSE
4737,13-02-2021 12:00,24 hrs.,wallstreetbets,DVN,7,0,7,-7,1,1,1,1,NYSE
4737,13-02-2021 12:00,24 hrs.,wallstreetbets,EAT,14,0,14,-14,2,2,2,2,NYSE
4737,13-02-2021 12:00,24 hrs.,wallstreetbets,EPD,47,0,47,-47,2,12,15,1,NYSE
4737,13-02-2021 12:00,24 hrs.,wallstreetbets,ETN,21,7,14,-7,3,3,3,3,NYSE
4737,13-02-2021 12:00,24 hrs.,wallstreetbets,EXP,13,0,13,-13,2,2,1,2,NYSE
4737,13-02-2021 12:00,24 hrs.,wallstreetbets,FDX,7,0,7,-7,1,1,1,1,NYSE
4737,13-02-2021 12:00,24 hrs.,wallstreetbets,FLT,7,0,7,-7,1,1,1,1,NYSE
4737,13-02-2021 12:00,24 hrs.,wallstreetbets,FMC,13,0,13,-13,2,2,1,1,NYSE
4737,13-02-2021 12:00,24 hrs.,wallstreetbets,FRO,19,0,19,-19,3,3,1,2,NYSE
4737,13-02-2021 12:00,24 hrs.,wallstreetbets,FSD,14,0,14,-14,2,2,2,2,NYSE
4737,13-02-2021 12:00,24 hrs.,wallstreetbets,FSR,246,0,246,-246,35,40,26,15,NYSE
4737,13-02-2021 12:00,24 hrs.,wallstreetbets,FTI,20,0,20,-20,3,3,2,1,NYSE
4737,13-02-2021 12:00,24 hrs.,wallstreetbets,FUN,7,7,0,7,1,1,1,1,NYSE
4737,13-02-2021 12:00,24 hrs.,wallstreetbets,GLU,7,0,7,-7,1,1,1,1,AMEX
4737,13-02-2021 12:00,24 hrs.,wallstreetbets,GTE,73,13,60,-47,11,11,7,9,AMEX
4737,13-02-2021 12:00,24 hrs.,wallstreetbets,ITP,7,0,7,-7,1,1,1,1,AMEX
4737,13-02-2021 12:00,24 hrs.,wallstreetbets,MSN,7,0,7,-7,1,1,1,1,AMEX
4737,13-02-2021 12:00,24 hrs.,wallstreetbets,MYO,7,0,7,-7,1,1,1,1,AMEX
4737,13-02-2021 12:00,24 hrs.,wallstreetbets,NAK,57,0,57,-57,9,9,3,8,AMEX
4737,13-02-2021 12:00,24 hrs.,wallstreetbets,PTN,7,0,7,-7,1,1,1,1,AMEX
4737,13-02-2021 12:00,24 hrs.,wallstreetbets,REI,7,0,7,-7,1,1,1,1,AMEX
4737,13-02-2021 12:00,24 hrs.,wallstreetbets,SYN,14,0,14,-14,2,2,2,1,AMEX
4737,13-02-2021 12:00,24 hrs.,wallstreetbets,TGB,6,0,6,-6,1,1,0,1,AMEX
4737,13-02-2021 12:00,24 hrs.,wallstreetbets,TRX,42,7,35,-28,6,6,6,4,AMEX
4737,13-02-2021 12:00,24 hrs.,wallstreetbets,UUU,6,0,6,-6,1,1,0,1,AMEX
4737,13-02-2021 12:00,24 hrs.,wallstreetbets,FDVRF,6,0,6,-6,1,1,0,1,OTC
4737,13-02-2021 12:00,24 hrs.,wallstreetbets,FUNFF,7,7,0,7,1,1,1,1,OTC
4737,13-02-2021 12:00,24 hrs.,wallstreetbets,GAYMF,13,7,6,1,2,2,1,2,OTC
4737,13-02-2021 12:00,24 hrs.,wallstreetbets,GGTTF,7,0,7,-7,1,1,1,1,OTC
4737,13-02-2021 12:00,24 hrs.,wallstreetbets,GTBIF,13,6,7,-1,2,2,1,2,OTC
4737,13-02-2021 12:00,24 hrs.,wallstreetbets,HITIF,55,48,7,41,4,11,17,3,OTC
4737,13-02-2021 12:00,24 hrs.,wallstreetbets,HRSTW,11,0,11,-11,2,1,1,1,OTC
4737,13-02-2021 12:00,24 hrs.,wallstreetbets,HTZGQ,7,7,0,7,1,1,1,1,OTC
4737,13-02-2021 12:00,24 hrs.,wallstreetbets,HUTMF,13,0,13,-13,2,2,1,2,OTC
4737,13-02-2021 12:00,24 hrs.,wallstreetbets,HVBTF,15,0,15,-15,2,2,3,2,OTC
4737,13-02-2021 12:00,24 hrs.,wallstreetbets,IGCIW,49,0,49,-49,7,7,7,2,OTC
4737,13-02-2021 12:00,24 hrs.,wallstreetbets,ISCNF,14,0,14,-14,2,2,2,2,OTC
4737,13-02-2021 12:00,24 hrs.,wallstreetbets,ITHUF,7,0,7,-7,1,1,1,1,OTC
4737,13-02-2021 12:00,24 hrs.,wallstreetbets,KBEVF,7,0,7,-7,1,1,1,1,OTC
4737,13-02-2021 12:00,24 hrs.,wallstreetbets,LHSIF,7,0,7,-7,1,1,1,1,OTC
4737,13-02-2021 12:00,24 hrs.,wallstreetbets,LKNCY,218,8,210,-202,2,6,198,2,OTC
4737,13-02-2021 12:00,24 hrs.,wallstreetbets,MMEDF,63,0,63,-63,4,18,11,3,OTC
4737,13-02-2021 12:00,24 hrs.,wallstreetbets,MOTNF,7,0,7,-7,1,1,1,1,OTC
4737,13-02-2021 12:00,24 hrs.,wallstreetbets,NONOF,7,7,0,7,1,1,1,1,OTC
4737,13-02-2021 12:00,24 hrs.,wallstreetbets,NTDOY,15,0,15,-15,2,2,3,2,OTC
4737,13-02-2021 12:00,24 hrs.,wallstreetbets,NXGWF,13,0,13,-13,2,2,1,1,OTC
4737,13-02-2021 12:00,24 hrs.,wallstreetbets,NXTTF,14,0,14,-14,2,2,2,1,OTC
4737,13-02-2021 12:00,24 hrs.,wallstreetbets,PCLOF,13,0,13,-13,2,2,1,1,OTC
4737,13-02-2021 12:00,24 hrs.,SPACs,DFS,151,0,151,-151,1,56,35,1,NYSE
4737,13-02-2021 12:00,24 hrs.,SPACs,ELY,18,18,0,18,1,6,2,1,NYSE
4737,13-02-2021 12:00,24 hrs.,SPACs,EQD,633,298,335,-37,2,119,387,2,NYSE
4737,13-02-2021 12:00,24 hrs.,SPACs,FSR,43,37,6,31,2,11,13,2,NYSE
4737,13-02-2021 12:00,24 hrs.,SPACs,GIX,335,0,335,-335,1,95,141,1,NYSE
4737,13-02-2021 12:00,24 hrs.,SPACs,HPX,335,0,335,-335,1,95,141,1,NYSE
4737,13-02-2021 12:00,24 hrs.,SPACs,ICE,42,0,42,-42,1,14,10,1,NYSE
4737,13-02-2021 12:00,24 hrs.,SPACs,IRR,82,0,82,-82,1,25,28,1,NYSE
4737,13-02-2021 12:00,24 hrs.,SPACs,JWS,340,304,36,268,7,30,252,3,NYSE
4737,13-02-2021 12:00,24 hrs.,SPACs,NAV,158,9,149,-140,5,48,42,4,NYSE
4737,13-02-2021 12:00,24 hrs.,SPACs,NGA,112,37,75,-38,2,34,36,2,NYSE
4737,13-02-2021 12:00,24 hrs.,SPACs,NSH,335,0,335,-335,1,95,141,1,NYSE
4737,13-02-2021 12:00,24 hrs.,SPACs,RBC,7,7,0,7,1,1,1,1,NYSE
4737,13-02-2021 12:00,24 hrs.,SPACs,RMO,6,6,0,6,1,1,0,1,NYSE
4737,13-02-2021 12:00,24 hrs.,SPACs,RSI,9,0,9,-9,1,0,5,1,NYSE
4737,13-02-2021 12:00,24 hrs.,SPACs,RTP,717,298,419,-121,4,199,303,3,NYSE
4737,13-02-2021 12:00,24 hrs.,SPACs,SBE,338,37,301,-264,3,120,86,2,NYSE
4737,13-02-2021 12:00,24 hrs.,SPACs,SBG,335,0,335,-335,1,95,141,1,NYSE
4737,13-02-2021 12:00,24 hrs.,SPACs,SOS,7,7,0,7,1,1,1,1,NYSE
4737,13-02-2021 12:00,24 hrs.,wallstreetbets,GAM,7,0,7,-7,1,1,1,1,NYSE
4737,13-02-2021 12:00,24 hrs.,wallstreetbets,GEO,28,0,28,-28,4,4,4,1,NYSE
4737,13-02-2021 12:00,24 hrs.,wallstreetbets,GLW,7,0,7,-7,1,1,1,1,NYSE
4737,13-02-2021 12:00,24 hrs.,wallstreetbets,GME,176418,24208,152210,-128002,440,80428,13802,323,NYSE
4737,13-02-2021 12:00,24 hrs.,wallstreetbets,GNT,14,14,0,14,2,2,2,1,NYSE
4737,13-02-2021 12:00,24 hrs.,wallstreetbets,HMC,40,0,40,-40,1,13,10,1,NYSE
4737,13-02-2021 12:00,24 hrs.,wallstreetbets,HMI,7,0,7,-7,1,1,1,1,NYSE
4737,13-02-2021 12:00,24 hrs.,wallstreetbets,HSY,8,8,0,8,1,1,2,1,NYSE
4737,13-02-2021 12:00,24 hrs.,wallstreetbets,IAG,7,0,7,-7,1,1,1,1,NYSE
4737,13-02-2021 12:00,24 hrs.,wallstreetbets,IBM,9814,171,9643,-9472,9,4558,662,9,NYSE
4737,13-02-2021 12:00,24 hrs.,wallstreetbets,ZOM,257,33,224,-191,20,64,49,19,AMEX
4737,13-02-2021 12:00,24 hrs.,wallstreetbets,AMPE,34,0,34,-34,5,5,4,3,AMEX
4737,13-02-2021 12:00,24 hrs.,wallstreetbets,CRMD,7,0,7,-7,1,1,1,1,AMEX
4737,13-02-2021 12:00,24 hrs.,wallstreetbets,EMAN,7,0,7,-7,1,1,1,1,AMEX
4737,13-02-2021 12:00,24 hrs.,wallstreetbets,GOED,13,0,13,-13,2,2,1,2,AMEX
4737,13-02-2021 12:00,24 hrs.,wallstreetbets,GSAT,33,7,26,-19,5,5,3,4,AMEX
4737,13-02-2021 12:00,24 hrs.,wallstreetbets,HUSA,7,0,7,-7,1,1,1,1,AMEX
4737,13-02-2021 12:00,24 hrs.,wallstreetbets,LODE,13,0,13,-13,2,2,1,2,AMEX
4737,13-02-2021 12:00,24 hrs.,wallstreetbets,OGEN,20,0,20,-20,3,3,2,3,AMEX
4737,13-02-2021 12:00,24 hrs.,wallstreetbets,SENS,495,275,220,55,18,134,155,14,AMEX
4737,13-02-2021 12:00,24 hrs.,wallstreetbets,TMBR,34,0,34,-34,5,5,4,1,AMEX
4737,13-02-2021 12:00,24 hrs.,wallstreetbets,TRXC,13,0,13,-13,2,2,1,2,AMEX
4737,13-02-2021 12:00,24 hrs.,wallstreetbets,UAVS,34,13,21,-8,5,5,4,3,AMEX
4737,13-02-2021 12:00,24 hrs.,wallstreetbets,UUUU,14,0,14,-14,2,2,2,1,AMEX
4737,13-02-2021 12:00,24 hrs.,wallstreetbets,XXII,7,7,0,7,1,1,1,1,AMEX
4737,13-02-2021 12:00,24 hrs.,wallstreetbets,YCBD,14,7,7,0,2,2,2,2,AMEX
4737,13-02-2021 12:00,24 hrs.,wallstreetbets,ABT,6,0,6,-6,1,1,0,1,NYSE
4737,13-02-2021 12:00,24 hrs.,wallstreetbets,ACB,166,28,138,-110,24,24,22,20,NYSE
4737,13-02-2021 12:00,24 hrs.,wallstreetbets,ACI,7,0,7,-7,1,1,1,1,NYSE
4737,13-02-2021 12:00,24 hrs.,wallstreetbets,AEM,8,0,8,-8,1,1,2,1,NYSE
4737,13-02-2021 12:00,24 hrs.,wallstreetbets,AFC,7,0,7,-7,1,1,1,1,NYSE
4737,13-02-2021 12:00,24 hrs.,wallstreetbets,AIR,6,0,6,-6,1,1,0,1,NYSE
4737,13-02-2021 12:00,24 hrs.,wallstreetbets,AIV,6,0,6,-6,1,1,0,1,NYSE
4737,13-02-2021 12:00,24 hrs.,wallstreetbets,AMC,3292,2132,1160,972,175,1002,588,146,NYSE
4737,13-02-2021 12:00,24 hrs.,wallstreetbets,AMP,29,0,29,-29,4,4,5,4,NYSE
4737,13-02-2021 12:00,24 hrs.,wallstreetbets,ASX,7,0,7,-7,1,1,1,1,NYSE
4737,13-02-2021 12:00,24 hrs.,wallstreetbets,ATH,39,13,26,-13,5,7,5,5,NYSE
4737,13-02-2021 12:00,24 hrs.,wallstreetbets,AUY,135,0,135,-135,9,27,45,4,NYSE
4737,13-02-2021 12:00,24 hrs.,wallstreetbets,AXP,6079,0,6079,-6079,2,2861,349,1,NYSE
4737,13-02-2021 12:00,24 hrs.,wallstreetbets,BBW,6,0,6,-6,1,1,0,1,NYSE
4737,13-02-2021 12:00,24 hrs.,wallstreetbets,BCH,11,4,7,-3,2,1,1,2,NYSE
4737,13-02-2021 12:00,24 hrs.,wallstreetbets,BGS,8,0,8,-8,1,1,2,1,NYSE
4737,13-02-2021 12:00,24 hrs.,wallstreetbets,BHC,440,0,440,-440,2,178,76,2,NYSE
4737,13-02-2021 12:00,24 hrs.,wallstreetbets,BTT,40,7,33,-26,6,6,4,6,NYSE
4737,13-02-2021 12:00,24 hrs.,wallstreetbets,BTU,14,0,14,-14,2,2,2,1,NYSE
4737,13-02-2021 12:00,24 hrs.,SPACs,AVAN,344,9,335,-326,2,95,146,2,NYSE
4737,13-02-2021 12:00,24 hrs.,SPACs,BOAC,429,0,429,-429,2,127,167,2,NYSE
4737,13-02-2021 12:00,24 hrs.,SPACs,CCIV,819,357,462,-105,11,139,497,11,NYSE
4737,13-02-2021 12:00,24 hrs.,SPACs,CPSR,335,0,335,-335,1,95,141,1,NYSE
4737,13-02-2021 12:00,24 hrs.,wallstreetbets,ICE,160,160,0,160,1,47,62,1,NYSE
4737,13-02-2021 12:00,24 hrs.,wallstreetbets,IGT,7,0,7,-7,1,1,1,1,NYSE
4737,13-02-2021 12:00,24 hrs.,wallstreetbets,IRS,12,6,6,0,2,2,0,2,NYSE
4737,13-02-2021 12:00,24 hrs.,wallstreetbets,IVR,49,0,49,-49,7,6,9,5,NYSE
4737,13-02-2021 12:00,24 hrs.,wallstreetbets,JNJ,13,6,7,-1,2,2,1,2,NYSE
4737,13-02-2021 12:00,24 hrs.,wallstreetbets,JWS,12,0,12,-12,2,2,0,1,NYSE
4737,13-02-2021 12:00,24 hrs.,wallstreetbets,KMI,47,0,47,-47,2,12,15,1,NYSE
4737,13-02-2021 12:00,24 hrs.,wallstreetbets,KOS,12,0,12,-12,2,2,0,1,NYSE
4737,13-02-2021 12:00,24 hrs.,wallstreetbets,LEE,6,6,0,6,1,1,0,1,NYSE
4737,13-02-2021 12:00,24 hrs.,wallstreetbets,LOW,22,0,22,-22,3,3,4,2,NYSE
4737,13-02-2021 12:00,24 hrs.,wallstreetbets,LTC,7,7,0,7,1,1,1,1,NYSE
4737,13-02-2021 12:00,24 hrs.,wallstreetbets,MAC,9,0,9,-9,1,1,3,1,NYSE
4737,13-02-2021 12:00,24 hrs.,wallstreetbets,MBI,14,0,14,-14,2,2,2,2,NYSE
4737,13-02-2021 12:00,24 hrs.,wallstreetbets,MCO,433,0,433,-433,1,177,75,1,NYSE
4737,13-02-2021 12:00,24 hrs.,wallstreetbets,MFA,7,0,7,-7,1,1,1,1,NYSE
4737,13-02-2021 12:00,24 hrs.,wallstreetbets,MIN,7,0,7,-7,1,1,1,1,NYSE
4737,13-02-2021 12:00,24 hrs.,wallstreetbets,MRO,439,0,439,-439,2,178,75,2,NYSE
4737,13-02-2021 12:00,24 hrs.,wallstreetbets,MSM,7,0,7,-7,1,1,1,1,NYSE
4737,13-02-2021 12:00,24 hrs.,wallstreetbets,NAT,20,0,20,-20,3,2,4,3,NYSE
4737,13-02-2021 12:00,24 hrs.,wallstreetbets,NET,194,0,194,-194,2,64,58,2,NYSE
4737,13-02-2021 12:00,24 hrs.,wallstreetbets,NGA,6,0,6,-6,1,1,0,1,NYSE
4737,13-02-2021 12:00,24 hrs.,wallstreetbets,NIO,761,8,753,-745,12,308,97,11,NYSE
4737,13-02-2021 12:00,24 hrs.,wallstreetbets,NLY,7,0,7,-7,1,1,1,1,NYSE
4737,13-02-2021 12:00,24 hrs.,wallstreetbets,NMR,7,7,0,7,1,1,1,1,NYSE
4737,13-02-2021 12:00,24 hrs.,wallstreetbets,NOK,3350,290,3060,-2770,24,1363,528,23,NYSE
4737,13-02-2021 12:00,24 hrs.,wallstreetbets,NOV,6,0,6,-6,1,1,0,1,NYSE
4737,13-02-2021 12:00,24 hrs.,wallstreetbets,NRG,35,0,35,-35,5,5,5,1,NYSE
4737,13-02-2021 12:00,24 hrs.,wallstreetbets,NSA,152,152,0,152,1,66,16,1,NYSE
4737,13-02-2021 12:00,24 hrs.,wallstreetbets,NUS,7,0,7,-7,1,1,1,1,NYSE
4737,13-02-2021 12:00,24 hrs.,wallstreetbets,NVO,81,6,75,-69,2,20,33,2,NYSE
4737,13-02-2021 12:00,24 hrs.,wallstreetbets,NYC,14,7,7,0,2,2,2,2,NYSE
4737,13-02-2021 12:00,24 hrs.,wallstreetbets,OSK,151,0,151,-151,1,42,63,1,NYSE
4737,13-02-2021 12:00,24 hrs.,wallstreetbets,OVV,5,0,5,-5,1,0,1,1,NYSE
4737,13-02-2021 12:00,24 hrs.,wallstreetbets,PCG,418,269,149,120,2,140,130,2,NYSE
4737,13-02-2021 12:00,24 hrs.,wallstreetbets,PFE,13,0,13,-13,2,2,1,2,NYSE
4737,13-02-2021 12:00,24 hrs.,wallstreetbets,PHT,7,7,0,7,1,1,1,1,NYSE
4737,13-02-2021 12:00,24 hrs.,wallstreetbets,PSA,3088,21,3067,-3046,10,1258,532,8,NYSE
4737,13-02-2021 12:00,24 hrs.,wallstreetbets,PSN,7,7,0,7,1,1,1,1,NYSE
4737,13-02-2021 12:00,24 hrs.,wallstreetbets,PVL,13,0,13,-13,2,2,1,1,NYSE
4737,13-02-2021 12:00,24 hrs.,wallstreetbets,PWR,6,6,0,6,1,1,0,1,NYSE
4737,13-02-2021 12:00,24 hrs.,wallstreetbets,RAD,7,7,0,7,1,1,1,1,NYSE
4737,13-02-2021 12:00,24 hrs.,wallstreetbets,RDY,7,0,7,-7,1,1,1,1,NYSE
4737,13-02-2021 12:00,24 hrs.,wallstreetbets,RKT,7994,19,7975,-7956,13,3713,516,12,NYSE
4737,13-02-2021 12:00,24 hrs.,wallstreetbets,RMO,69,0,69,-69,10,10,9,6,NYSE
4737,13-02-2021 12:00,24 hrs.,wallstreetbets,RPT,7,0,7,-7,1,1,1,1,NYSE
4737,13-02-2021 12:00,24 hrs.,wallstreetbets,RSI,6,0,6,-6,1,1,0,1,NYSE
4737,13-02-2021 12:00,24 hrs.,wallstreetbets,RTP,6,0,6,-6,1,1,0,1,NYSE
4737,13-02-2021 12:00,24 hrs.,wallstreetbets,SBE,6,0,6,-6,1,1,0,1,NYSE
4737,13-02-2021 12:00,24 hrs.,SPACs,APEX,33,0,33,-33,1,5,19,1,OTC
4737,13-02-2021 12:00,24 hrs.,SPACs,BRRN,11,0,11,-11,1,2,3,1,OTC
4737,13-02-2021 12:00,24 hrs.,SPACs,CIK,75,0,75,-75,1,24,23,1,AMEX
4737,13-02-2021 12:00,24 hrs.,SPACs,NBA,335,0,335,-335,1,95,141,1,AMEX
4737,13-02-2021 12:00,24 hrs.,SPACs,PTK,387,52,335,-283,2,113,153,2,AMEX
4737,13-02-2021 12:00,24 hrs.,SPACs,CHAQ,387,52,335,-283,2,113,153,2,AMEX
4737,13-02-2021 12:00,24 hrs.,SPACs,AIR,151,0,151,-151,1,56,35,1,NYSE
4737,13-02-2021 12:00,24 hrs.,SPACs,BFT,305,305,0,305,2,25,247,2,NYSE
4737,13-02-2021 12:00,24 hrs.,SPACs,BSN,335,0,335,-335,1,95,141,1,NYSE
4737,13-02-2021 12:00,24 hrs.,SPACs,CCX,335,0,335,-335,1,95,141,1,NYSE
4737,13-02-2021 12:00,24 hrs.,SPACs,COO,45,0,45,-45,1,7,27,1,NYSE
4737,13-02-2021 12:00,24 hrs.,SPACs,DEH,335,0,335,-335,1,95,141,1,NYSE
4737,13-02-2021 12:00,24 hrs.,SPACs,RBAC,335,0,335,-335,1,95,141,1,NYSE
4737,13-02-2021 12:00,24 hrs.,SPACs,RPLA,335,0,335,-335,1,95,141,1,NYSE
4737,13-02-2021 12:00,24 hrs.,SPACs,SCPE,335,0,335,-335,1,95,141,1,NYSE
4737,13-02-2021 12:00,24 hrs.,SPACs,SCVX,335,0,335,-335,1,95,141,1,NYSE
4737,13-02-2021 12:00,24 hrs.,SPACs,SEAH,335,0,335,-335,1,95,141,1,NYSE
4737,13-02-2021 12:00,24 hrs.,SPACs,SFTW,335,0,335,-335,1,95,141,1,NYSE
4737,13-02-2021 12:00,24 hrs.,SPACs,SNPR,352,13,339,-326,8,117,86,7,NYSE
4737,13-02-2021 12:00,24 hrs.,SPACs,STPK,50,43,7,36,3,12,14,3,NYSE
4737,13-02-2021 12:00,24 hrs.,SPACs,TPGY,37,37,0,37,1,10,13,1,NYSE
4737,13-02-2021 12:00,24 hrs.,SPACs,TWND,38,0,38,-38,1,7,20,1,NYSE
4737,13-02-2021 12:00,24 hrs.,SPACs,VTOL,151,0,151,-151,1,56,35,1,NYSE
4737,13-02-2021 12:00,24 hrs.,SPACs,VYGG,59,20,39,-19,5,10,19,3,NYSE
4737,13-02-2021 12:00,24 hrs.,SPACs,ADV,633,298,335,-37,2,119,387,2,NASDAQ
4737,13-02-2021 12:00,24 hrs.,SPACs,CFO,202,0,202,-202,2,71,52,2,NASDAQ
4737,13-02-2021 12:00,24 hrs.,SPACs,ESG,18,18,0,18,1,6,2,1,NASDAQ
4737,13-02-2021 12:00,24 hrs.,wallstreetbets,SJM,131,131,0,131,2,43,37,2,NYSE
4737,13-02-2021 12:00,24 hrs.,wallstreetbets,SKY,6,0,6,-6,1,1,0,1,NYSE
4737,13-02-2021 12:00,24 hrs.,wallstreetbets,SNE,14,0,14,-14,2,2,2,1,NYSE
4737,13-02-2021 12:00,24 hrs.,wallstreetbets,SNX,6,0,6,-6,1,1,0,1,NYSE
4737,13-02-2021 12:00,24 hrs.,wallstreetbets,SOS,190,49,141,-92,27,26,30,25,NYSE
4737,13-02-2021 12:00,24 hrs.,wallstreetbets,STM,7,0,7,-7,1,1,1,1,NYSE
4737,13-02-2021 12:00,24 hrs.,wallstreetbets,SUP,7,0,7,-7,1,1,1,1,NYSE
4737,13-02-2021 12:00,24 hrs.,wallstreetbets,TAK,14,0,14,-14,2,2,2,2,NYSE
4737,13-02-2021 12:00,24 hrs.,wallstreetbets,TAP,13,0,13,-13,2,2,1,2,NYSE
4737,13-02-2021 12:00,24 hrs.,wallstreetbets,TBC,7,0,7,-7,1,1,1,1,NYSE
4737,13-02-2021 12:00,24 hrs.,wallstreetbets,TDC,32,26,6,20,2,4,16,2,NYSE
4737,13-02-2021 12:00,24 hrs.,wallstreetbets,TFC,7,0,7,-7,1,1,1,1,NYSE
4737,13-02-2021 12:00,24 hrs.,wallstreetbets,THC,7,0,7,-7,1,1,1,1,NYSE
4737,13-02-2021 12:00,24 hrs.,wallstreetbets,TRQ,7,7,0,7,1,1,1,1,NYSE
4737,13-02-2021 12:00,24 hrs.,wallstreetbets,TRU,7,0,7,-7,1,1,1,1,NYSE
4737,13-02-2021 12:00,24 hrs.,wallstreetbets,TSM,529,0,529,-529,2,141,239,2,NYSE
4737,13-02-2021 12:00,24 hrs.,wallstreetbets,TSN,6079,0,6079,-6079,2,2861,349,1,NYSE
4737,13-02-2021 12:00,24 hrs.,wallstreetbets,TTM,6,0,6,-6,1,1,0,1,NYSE
4737,13-02-2021 12:00,24 hrs.,wallstreetbets,TWO,7,0,7,-7,1,1,1,1,NYSE
4737,13-02-2021 12:00,24 hrs.,wallstreetbets,UBS,7,0,7,-7,1,1,1,1,NYSE
4737,13-02-2021 12:00,24 hrs.,wallstreetbets,UNP,7,0,7,-7,1,1,1,1,NYSE
4737,13-02-2021 12:00,24 hrs.,wallstreetbets,UTZ,1050,0,1050,-1050,1,414,218,1,NYSE
4737,13-02-2021 12:00,24 hrs.,wallstreetbets,VGR,7,0,7,-7,1,1,1,1,NYSE
4737,13-02-2021 12:00,24 hrs.,wallstreetbets,VHC,7,0,7,-7,1,1,1,1,NYSE
4737,13-02-2021 12:00,24 hrs.,wallstreetbets,VRT,156,0,156,-156,2,56,36,1,NYSE
4737,13-02-2021 12:00,24 hrs.,wallstreetbets,VST,35,0,35,-35,5,5,5,1,NYSE
4737,13-02-2021 12:00,24 hrs.,wallstreetbets,WFC,7,0,7,-7,1,1,1,1,NYSE
4737,13-02-2021 12:00,24 hrs.,wallstreetbets,WLL,6,0,6,-6,1,1,0,1,NYSE
4737,13-02-2021 12:00,24 hrs.,wallstreetbets,WMC,8,0,8,-8,1,1,2,1,NYSE
4737,13-02-2021 12:00,24 hrs.,wallstreetbets,WMT,13,0,13,-13,2,2,1,2,NYSE
4737,13-02-2021 12:00,24 hrs.,wallstreetbets,ABBV,7,7,0,7,1,1,1,1,NYSE
4737,13-02-2021 12:00,24 hrs.,wallstreetbets,ABEV,7,0,7,-7,1,1,1,1,NYSE
4737,13-02-2021 12:00,24 hrs.,wallstreetbets,ACIC,27,7,20,-13,4,4,3,4,NYSE
4737,13-02-2021 12:00,24 hrs.,wallstreetbets,ALLY,7,7,0,7,1,1,1,1,NYSE
4737,13-02-2021 12:00,24 hrs.,wallstreetbets,APRN,6,0,6,-6,1,1,0,1,NYSE
4737,13-02-2021 12:00,24 hrs.,wallstreetbets,ARGO,6,0,6,-6,1,1,0,1,NYSE
4737,13-02-2021 12:00,24 hrs.,wallstreetbets,ATUS,14,0,14,-14,2,2,2,1,NYSE
4737,13-02-2021 12:00,24 hrs.,SPACs,TDA,7,0,7,-7,1,1,1,1,NYSE
4737,13-02-2021 12:00,24 hrs.,SPACs,WPF,335,0,335,-335,1,95,141,1,NYSE
4737,13-02-2021 12:00,24 hrs.,SPACs,YAC,335,0,335,-335,1,95,141,1,NYSE
4737,13-02-2021 12:00,24 hrs.,SPACs,YUM,51,0,51,-51,1,15,17,1,NYSE
4737,13-02-2021 12:00,24 hrs.,SPACs,ACIC,304,304,0,304,2,25,246,2,NYSE
4737,13-02-2021 12:00,24 hrs.,SPACs,ACND,335,0,335,-335,1,95,141,1,NYSE
4737,13-02-2021 12:00,24 hrs.,SPACs,ALUS,52,0,52,-52,1,10,28,1,NYSE
4737,13-02-2021 12:00,24 hrs.,SPACs,AONE,335,0,335,-335,1,95,141,1,NYSE
4737,13-02-2021 12:00,24 hrs.,SPACs,APSG,335,0,335,-335,1,95,141,1,NYSE
4737,13-02-2021 12:00,24 hrs.,SPACs,ASAQ,335,0,335,-335,1,95,141,1,NYSE
4737,13-02-2021 12:00,24 hrs.,SPACs,ASPL,335,0,335,-335,1,95,141,1,NYSE
4737,13-02-2021 12:00,24 hrs.,SPACs,ATAC,335,0,335,-335,1,95,141,1,NYSE
4737,13-02-2021 12:00,24 hrs.,SPACs,DBDR,335,0,335,-335,1,95,141,1,NASDAQ
4737,13-02-2021 12:00,24 hrs.,SPACs,DFHT,298,298,0,298,1,24,246,1,NASDAQ
4737,13-02-2021 12:00,24 hrs.,SPACs,DFPH,335,0,335,-335,1,95,141,1,NASDAQ
4737,13-02-2021 12:00,24 hrs.,SPACs,DGNS,398,0,398,-398,1,174,46,1,NASDAQ
4737,13-02-2021 12:00,24 hrs.,SPACs,DSAC,335,0,335,-335,1,95,141,1,NASDAQ
4737,13-02-2021 12:00,24 hrs.,SPACs,ERES,335,0,335,-335,1,95,141,1,NASDAQ
4737,13-02-2021 12:00,24 hrs.,SPACs,ESSC,335,0,335,-335,1,95,141,1,NASDAQ
4737,13-02-2021 12:00,24 hrs.,SPACs,ETAC,335,0,335,-335,1,95,141,1,NASDAQ
4737,13-02-2021 12:00,24 hrs.,SPACs,EUCR,335,0,335,-335,1,95,141,1,NASDAQ
4737,13-02-2021 12:00,24 hrs.,SPACs,FCAC,708,298,410,-112,4,200,292,3,NASDAQ
4737,13-02-2021 12:00,24 hrs.,SPACs,FTOC,426,273,153,120,6,149,104,5,NASDAQ
4737,13-02-2021 12:00,24 hrs.,SPACs,FVAM,335,0,335,-335,1,95,141,1,NASDAQ
4737,13-02-2021 12:00,24 hrs.,SPACs,GNRS,335,0,335,-335,1,95,141,1,NASDAQ
4737,13-02-2021 12:00,24 hrs.,SPACs,GRCY,387,52,335,-283,2,113,153,2,NASDAQ
4737,13-02-2021 12:00,24 hrs.,SPACs,GRNV,335,0,335,-335,1,95,141,1,NASDAQ
4737,13-02-2021 12:00,24 hrs.,SPACs,GRSV,434,0,434,-434,4,122,174,4,NASDAQ
4737,13-02-2021 12:00,24 hrs.,SPACs,GWAC,335,0,335,-335,1,95,141,1,NASDAQ
4737,13-02-2021 12:00,24 hrs.,SPACs,GXGX,335,0,335,-335,1,95,141,1,NASDAQ
4737,13-02-2021 12:00,24 hrs.,SPACs,IGAC,335,0,335,-335,1,95,141,1,NASDAQ
4737,13-02-2021 12:00,24 hrs.,SPACs,ITAC,335,0,335,-335,1,95,141,1,NASDAQ
4737,13-02-2021 12:00,24 hrs.,SPACs,JYAC,335,0,335,-335,1,95,141,1,NASDAQ
4737,13-02-2021 12:00,24 hrs.,wallstreetbets,BABA,180,0,180,-180,2,57,58,2,NYSE
4737,13-02-2021 12:00,24 hrs.,wallstreetbets,BNED,6,0,6,-6,1,1,0,1,NYSE
4737,13-02-2021 12:00,24 hrs.,wallstreetbets,CARS,6,0,6,-6,1,1,0,1,NYSE
4737,13-02-2021 12:00,24 hrs.,wallstreetbets,CCIV,232,28,204,-176,34,34,28,28,NYSE
4737,13-02-2021 12:00,24 hrs.,wallstreetbets,CHWY,7,0,7,-7,1,1,1,1,NYSE
4737,13-02-2021 12:00,24 hrs.,wallstreetbets,CLDR,6,0,6,-6,1,1,0,1,NYSE
4737,13-02-2021 12:00,24 hrs.,wallstreetbets,CLII,7,0,7,-7,1,1,1,1,NYSE
4737,13-02-2021 12:00,24 hrs.,wallstreetbets,DASH,13,7,6,1,2,2,1,2,NYSE
4737,13-02-2021 12:00,24 hrs.,wallstreetbets,EXPR,15,0,15,-15,2,2,3,2,NYSE
4737,13-02-2021 12:00,24 hrs.,wallstreetbets,FEDU,7,0,7,-7,1,1,1,1,NYSE
4737,13-02-2021 12:00,24 hrs.,wallstreetbets,FLOW,7,0,7,-7,1,1,1,1,NYSE
4737,13-02-2021 12:00,24 hrs.,wallstreetbets,FSLY,14,0,14,-14,2,2,2,2,NYSE
4737,13-02-2021 12:00,24 hrs.,wallstreetbets,FUBO,1071,7,1064,-1057,4,417,221,4,NYSE
4737,13-02-2021 12:00,24 hrs.,wallstreetbets,FUSE,30,0,30,-30,4,4,6,2,NYSE
4737,13-02-2021 12:00,24 hrs.,wallstreetbets,FVRR,7,0,7,-7,1,1,1,1,NYSE
4737,13-02-2021 12:00,24 hrs.,wallstreetbets,GNRC,6,6,0,6,1,1,0,1,NYSE
4737,13-02-2021 12:00,24 hrs.,SPACs,CTAC,335,0,335,-335,1,95,141,1,NYSE
4737,13-02-2021 12:00,24 hrs.,SPACs,DFNS,388,0,388,-388,2,116,148,2,NYSE
4737,13-02-2021 12:00,24 hrs.,SPACs,DGNR,398,0,398,-398,1,174,46,1,NYSE
4737,13-02-2021 12:00,24 hrs.,SPACs,DMYD,398,0,398,-398,1,174,46,1,NYSE
4737,13-02-2021 12:00,24 hrs.,SPACs,DNMR,7,7,0,7,1,1,1,1,NYSE
4737,13-02-2021 12:00,24 hrs.,SPACs,EMPW,633,298,335,-37,2,119,387,2,NYSE
4737,13-02-2021 12:00,24 hrs.,SPACs,ENPC,298,298,0,298,1,24,246,1,NYSE
4737,13-02-2021 12:00,24 hrs.,SPACs,FGNA,907,777,130,647,2,311,277,2,NYSE
4737,13-02-2021 12:00,24 hrs.,SPACs,FUSE,3084,1108,1976,-868,18,986,1040,15,NYSE
4737,13-02-2021 12:00,24 hrs.,SPACs,GLEO,335,0,335,-335,1,95,141,1,NYSE
4737,13-02-2021 12:00,24 hrs.,SPACs,GOAC,335,0,335,-335,1,95,141,1,NYSE
4737,13-02-2021 12:00,24 hrs.,SPACs,GSAH,1175,777,398,379,2,439,289,2,NYSE
4737,13-02-2021 12:00,24 hrs.,SPACs,HIGA,335,0,335,-335,1,95,141,1,NYSE
4737,13-02-2021 12:00,24 hrs.,SPACs,HYLN,37,37,0,37,1,10,13,1,NYSE
4737,13-02-2021 12:00,24 hrs.,SPACs,HZAC,335,0,335,-335,1,95,141,1,NYSE
4737,13-02-2021 12:00,24 hrs.,SPACs,HZON,335,0,335,-335,1,95,141,1,NYSE
4737,13-02-2021 12:00,24 hrs.,SPACs,IMPX,335,0,335,-335,1,95,141,1,NYSE
4737,13-02-2021 12:00,24 hrs.,SPACs,IPOE,777,777,0,777,1,265,243,1,NYSE
4737,13-02-2021 12:00,24 hrs.,SPACs,IPOF,5,5,0,5,1,0,1,1,NYSE
4737,13-02-2021 12:00,24 hrs.,SPACs,LGVW,435,37,398,-361,2,184,59,2,NYSE
4737,13-02-2021 12:00,24 hrs.,SPACs,OACB,335,0,335,-335,1,95,141,1,NYSE
4737,13-02-2021 12:00,24 hrs.,SPACs,PANA,335,0,335,-335,1,95,141,1,NYSE
4737,13-02-2021 12:00,24 hrs.,SPACs,PCPL,335,0,335,-335,1,95,141,1,NYSE
4737,13-02-2021 12:00,24 hrs.,SPACs,PDAC,7,0,7,-7,1,1,1,1,NYSE
4737,13-02-2021 12:00,24 hrs.,SPACs,PIAI,335,0,335,-335,1,95,141,1,NYSE
4737,13-02-2021 12:00,24 hrs.,SPACs,PRPB,335,0,335,-335,1,95,141,1,NYSE
4737,13-02-2021 12:00,24 hrs.,SPACs,PSTH,707,7,700,-693,3,203,289,3,NYSE
4737,13-02-2021 12:00,24 hrs.,wallstreetbets,VALE,7,0,7,-7,1,1,1,1,NYSE
4737,13-02-2021 12:00,24 hrs.,wallstreetbets,VGAC,19,0,19,-19,3,3,1,3,NYSE
4737,13-02-2021 12:00,24 hrs.,wallstreetbets,VSTO,7,7,0,7,1,1,1,1,NYSE
4737,13-02-2021 12:00,24 hrs.,wallstreetbets,WORK,14,0,14,-14,2,2,2,2,NYSE
4737,13-02-2021 12:00,24 hrs.,wallstreetbets,XPEV,7,0,7,-7,1,1,1,1,NYSE
4737,13-02-2021 12:00,24 hrs.,wallstreetbets,YELP,7,0,7,-7,1,1,1,1,NYSE
4737,13-02-2021 12:00,24 hrs.,wallstreetbets,AAL,13,0,13,-13,2,2,1,2,NASDAQ
4737,13-02-2021 12:00,24 hrs.,wallstreetbets,AMD,2600,136,2464,-2328,24,891,722,20,NASDAQ
4737,13-02-2021 12:00,24 hrs.,wallstreetbets,API,7,7,0,7,1,1,1,1,NASDAQ
4737,13-02-2021 12:00,24 hrs.,wallstreetbets,AQB,7,7,0,7,1,1,1,1,NASDAQ
4737,13-02-2021 12:00,24 hrs.,wallstreetbets,ASO,6,0,6,-6,1,1,0,1,NASDAQ
4737,13-02-2021 12:00,24 hrs.,wallstreetbets,AZN,447,0,447,-447,3,179,77,3,NASDAQ
4737,13-02-2021 12:00,24 hrs.,wallstreetbets,BFI,14,0,14,-14,2,2,2,1,NASDAQ
4737,13-02-2021 12:00,24 hrs.,wallstreetbets,BLU,14,0,14,-14,2,2,2,1,NASDAQ
4737,13-02-2021 12:00,24 hrs.,wallstreetbets,BUG,12,0,12,-12,2,2,0,1,NASDAQ
4737,13-02-2021 12:00,24 hrs.,wallstreetbets,CDC,433,0,433,-433,1,177,75,1,NASDAQ
4737,13-02-2021 12:00,24 hrs.,wallstreetbets,CFO,6,6,0,6,1,1,0,1,NASDAQ
4737,13-02-2021 12:00,24 hrs.,wallstreetbets,CGC,82,7,75,-68,3,20,30,3,NASDAQ
4737,13-02-2021 12:00,24 hrs.,wallstreetbets,CTG,7,0,7,-7,1,1,1,1,NASDAQ
4737,13-02-2021 12:00,24 hrs.,wallstreetbets,DBX,7,0,7,-7,1,1,1,1,NASDAQ
4737,13-02-2021 12:00,24 hrs.,wallstreetbets,FAT,180,0,180,-180,2,57,58,2,NASDAQ
4737,13-02-2021 12:00,24 hrs.,wallstreetbets,FUV,7,0,7,-7,1,1,1,1,NASDAQ
4737,13-02-2021 12:00,24 hrs.,wallstreetbets,FWP,14,0,14,-14,2,2,2,1,NASDAQ
4737,13-02-2021 12:00,24 hrs.,wallstreetbets,GBT,7,0,7,-7,1,1,1,1,NASDAQ
4737,13-02-2021 12:00,24 hrs.,wallstreetbets,GSM,19,6,13,-7,3,3,1,3,NASDAQ
4737,13-02-2021 12:00,24 hrs.,wallstreetbets,HAS,6,6,0,6,1,1,0,1,NASDAQ
4737,13-02-2021 12:00,24 hrs.,wallstreetbets,IEA,7,0,7,-7,1,1,1,1,NASDAQ
4737,13-02-2021 12:00,24 hrs.,wallstreetbets,IIN,6,0,6,-6,1,1,0,1,NASDAQ
4737,13-02-2021 12:00,24 hrs.,wallstreetbets,INO,132,50,82,-32,13,20,40,13,NASDAQ
4737,13-02-2021 12:00,24 hrs.,wallstreetbets,JFU,6,6,0,6,1,1,0,1,NASDAQ
4737,13-02-2021 12:00,24 hrs.,wallstreetbets,KHC,14,7,7,0,2,2,2,2,NASDAQ
4737,13-02-2021 12:00,24 hrs.,wallstreetbets,MKD,13,13,0,13,2,2,1,2,NASDAQ
4737,13-02-2021 12:00,24 hrs.,wallstreetbets,MYT,7,7,0,7,1,1,1,1,NASDAQ
4737,13-02-2021 12:00,24 hrs.,wallstreetbets,NPA,6,0,6,-6,1,1,0,1,NASDAQ
4737,13-02-2021 12:00,24 hrs.,wallstreetbets,NWL,433,0,433,-433,1,177,75,1,NASDAQ
4737,13-02-2021 12:00,24 hrs.,wallstreetbets,OGI,80,14,66,-52,12,12,8,12,NASDAQ
4737,13-02-2021 12:00,24 hrs.,wallstreetbets,OPK,7,0,7,-7,1,1,1,1,NASDAQ
4737,13-02-2021 12:00,24 hrs.,SPACs,III,130,0,130,-130,1,46,34,1,NASDAQ
4737,13-02-2021 12:00,24 hrs.,SPACs,LCY,335,0,335,-335,1,95,141,1,NASDAQ
4737,13-02-2021 12:00,24 hrs.,SPACs,NPA,118,0,118,-118,1,41,32,1,NASDAQ
4737,13-02-2021 12:00,24 hrs.,SPACs,VIH,42,0,42,-42,1,14,10,1,NASDAQ
4737,13-02-2021 12:00,24 hrs.,SPACs,AACQ,2229,886,1343,-457,10,722,745,8,NASDAQ
4737,13-02-2021 12:00,24 hrs.,SPACs,ACEV,43,0,43,-43,1,3,33,1,NASDAQ
4737,13-02-2021 12:00,24 hrs.,SPACs,ACTC,37,37,0,37,1,10,13,1,NASDAQ
4737,13-02-2021 12:00,24 hrs.,SPACs,ADOC,387,52,335,-283,2,113,153,2,NASDAQ
4737,13-02-2021 12:00,24 hrs.,SPACs,AGBA,335,0,335,-335,1,95,141,1,NASDAQ
4737,13-02-2021 12:00,24 hrs.,SPACs,AHAC,335,0,335,-335,1,95,141,1,NASDAQ
4737,13-02-2021 12:00,24 hrs.,SPACs,AMHC,335,0,335,-335,1,95,141,1,NASDAQ
4737,13-02-2021 12:00,24 hrs.,SPACs,BHSE,387,52,335,-283,2,113,153,2,NASDAQ
4737,13-02-2021 12:00,24 hrs.,SPACs,BLNK,45,0,45,-45,1,7,27,1,NASDAQ
4737,13-02-2021 12:00,24 hrs.,SPACs,BOWX,335,0,335,-335,1,95,141,1,NASDAQ
4737,13-02-2021 12:00,24 hrs.,SPACs,BREZ,335,0,335,-335,1,95,141,1,NASDAQ
4737,13-02-2021 12:00,24 hrs.,SPACs,BRLI,335,0,335,-335,1,95,141,1,NASDAQ
4737,13-02-2021 12:00,24 hrs.,SPACs,BRPA,335,335,0,335,2,34,259,2,NASDAQ
4737,13-02-2021 12:00,24 hrs.,SPACs,BTAQ,898,0,898,-898,3,330,226,3,NASDAQ
4737,13-02-2021 12:00,24 hrs.,SPACs,BTWN,11,0,11,-11,1,2,3,1,NASDAQ
4737,13-02-2021 12:00,24 hrs.,SPACs,BWAC,335,0,335,-335,1,95,141,1,NASDAQ
4737,13-02-2021 12:00,24 hrs.,SPACs,CAPA,335,0,335,-335,1,95,141,1,NASDAQ
4737,13-02-2021 12:00,24 hrs.,SPACs,CFII,335,0,335,-335,1,95,141,1,NASDAQ
4737,13-02-2021 12:00,24 hrs.,SPACs,CHPM,335,0,335,-335,1,95,141,1,NASDAQ
4737,13-02-2021 12:00,24 hrs.,SPACs,CIIC,69,69,0,69,2,22,17,1,NASDAQ
4737,13-02-2021 12:00,24 hrs.,SPACs,CMLF,335,335,0,335,2,34,259,2,NASDAQ
4737,13-02-2021 12:00,24 hrs.,SPACs,CONX,335,0,335,-335,1,95,141,1,NASDAQ
4737,13-02-2021 12:00,24 hrs.,SPACs,CRSA,335,0,335,-335,1,95,141,1,NASDAQ
4737,13-02-2021 12:00,24 hrs.,stocks,GTEH,6,0,6,-6,1,1,0,1,OTC
4737,13-02-2021 12:00,24 hrs.,stocks,HCMC,22,16,6,10,2,2,10,2,OTC
4737,13-02-2021 12:00,24 hrs.,stocks,HEMP,36,36,0,36,1,8,16,1,OTC
4737,13-02-2021 12:00,24 hrs.,stocks,IGEN,6,0,6,-6,1,1,0,1,OTC
4737,13-02-2021 12:00,24 hrs.,stocks,IJJP,6,6,0,6,1,1,0,1,OTC
4737,13-02-2021 12:00,24 hrs.,stocks,LINK,10,0,10,-10,1,2,2,1,OTC
4737,13-02-2021 12:00,24 hrs.,stocks,MCAP,6,0,6,-6,1,1,0,1,OTC
4737,13-02-2021 12:00,24 hrs.,stocks,MINE,6,0,6,-6,1,1,0,1,OTC
4737,13-02-2021 12:00,24 hrs.,stocks,MJNA,6,0,6,-6,1,1,0,1,OTC
4737,13-02-2021 12:00,24 hrs.,stocks,MOJO,6,0,6,-6,1,1,0,1,OTC
4737,13-02-2021 12:00,24 hrs.,stocks,NTRR,6,0,6,-6,1,1,0,1,OTC
4737,13-02-2021 12:00,24 hrs.,stocks,OZSC,6,0,6,-6,1,1,0,1,OTC
4737,13-02-2021 12:00,24 hrs.,stocks,RSSV,17,0,17,-17,1,5,3,1,OTC
4737,13-02-2021 12:00,24 hrs.,stocks,SNYR,6,0,6,-6,1,1,0,1,OTC
4737,13-02-2021 12:00,24 hrs.,stocks,SOBR,6,6,0,6,1,1,0,1,OTC
4737,13-02-2021 12:00,24 hrs.,stocks,SSET,7,0,7,-7,1,1,1,1,OTC
4737,13-02-2021 12:00,24 hrs.,stocks,TMRC,6,0,6,-6,1,1,0,1,OTC
4737,13-02-2021 12:00,24 hrs.,stocks,XFLS,6,6,0,6,1,1,0,1,OTC
4737,13-02-2021 12:00,24 hrs.,stocks,ACRDF,6,0,6,-6,1,1,0,1,OTC
4737,13-02-2021 12:00,24 hrs.,stocks,ACRHF,6,0,6,-6,1,1,0,1,OTC
4737,13-02-2021 12:00,24 hrs.,stocks,BDRBF,6,0,6,-6,1,1,0,1,OTC
4737,13-02-2021 12:00,24 hrs.,SPACs,KERN,45,0,45,-45,1,7,27,1,NASDAQ
4737,13-02-2021 12:00,24 hrs.,SPACs,KSMT,335,0,335,-335,1,95,141,1,NASDAQ
4737,13-02-2021 12:00,24 hrs.,SPACs,LATN,335,0,335,-335,1,95,141,1,NASDAQ
4737,13-02-2021 12:00,24 hrs.,SPACs,LCAP,335,0,335,-335,1,95,141,1,NASDAQ
4737,13-02-2021 12:00,24 hrs.,SPACs,LFTR,335,0,335,-335,1,95,141,1,NASDAQ
4737,13-02-2021 12:00,24 hrs.,SPACs,LIVK,335,0,335,-335,1,95,141,1,NASDAQ
4737,13-02-2021 12:00,24 hrs.,SPACs,MAAC,335,0,335,-335,1,95,141,1,NASDAQ
4737,13-02-2021 12:00,24 hrs.,SPACs,MACU,387,52,335,-283,2,113,153,2,NASDAQ
4737,13-02-2021 12:00,24 hrs.,SPACs,MCMJ,335,0,335,-335,1,95,141,1,NASDAQ
4737,13-02-2021 12:00,24 hrs.,SPACs,MLAC,335,0,335,-335,1,95,141,1,NASDAQ
4737,13-02-2021 12:00,24 hrs.,SPACs,MOTN,335,0,335,-335,1,95,141,1,NASDAQ
4737,13-02-2021 12:00,24 hrs.,SPACs,NBAC,36,0,36,-36,2,11,6,2,NASDAQ
4737,13-02-2021 12:00,24 hrs.,wallstreetbets,PDD,7,7,0,7,1,1,1,1,NASDAQ
4737,13-02-2021 12:00,24 hrs.,wallstreetbets,QQQ,6,6,0,6,1,1,0,1,NASDAQ
4737,13-02-2021 12:00,24 hrs.,wallstreetbets,RUN,263,7,256,-249,4,79,89,4,NASDAQ
4737,13-02-2021 12:00,24 hrs.,wallstreetbets,RXT,7,0,7,-7,1,1,1,1,NASDAQ
4737,13-02-2021 12:00,24 hrs.,wallstreetbets,GPRK,7,0,7,-7,1,1,1,1,NYSE
4737,13-02-2021 12:00,24 hrs.,wallstreetbets,HEXO,27,14,13,1,4,4,3,4,NYSE
4737,13-02-2021 12:00,24 hrs.,wallstreetbets,HUBS,13,0,13,-13,2,2,1,2,NYSE
4737,13-02-2021 12:00,24 hrs.,wallstreetbets,HUYA,21,7,14,-7,3,3,3,3,NYSE
4737,13-02-2021 12:00,24 hrs.,wallstreetbets,HYLN,543,0,543,-543,11,152,195,8,NYSE
4737,13-02-2021 12:00,24 hrs.,wallstreetbets,IIPR,20,0,20,-20,3,3,2,2,NYSE
4737,13-02-2021 12:00,24 hrs.,wallstreetbets,IPOE,7,0,7,-7,1,1,1,1,NYSE
4737,13-02-2021 12:00,24 hrs.,wallstreetbets,JMIA,6121,0,6121,-6121,8,2867,355,3,NYSE
4737,13-02-2021 12:00,24 hrs.,wallstreetbets,JNPR,6,0,6,-6,1,1,0,1,NYSE
4737,13-02-2021 12:00,24 hrs.,wallstreetbets,KODK,13,0,13,-13,2,2,1,1,NYSE
4737,13-02-2021 12:00,24 hrs.,wallstreetbets,LEAP,6,6,0,6,1,1,0,1,NYSE
4737,13-02-2021 12:00,24 hrs.,wallstreetbets,LGVW,21,14,7,7,3,3,3,2,NYSE
4737,13-02-2021 12:00,24 hrs.,wallstreetbets,LSPD,6,0,6,-6,1,1,0,1,NYSE
4737,13-02-2021 12:00,24 hrs.,wallstreetbets,MAIN,6,6,0,6,1,1,0,1,NYSE
4737,13-02-2021 12:00,24 hrs.,wallstreetbets,MANU,12,0,12,-12,2,2,0,2,NYSE
4737,13-02-2021 12:00,24 hrs.,wallstreetbets,PACK,15,0,15,-15,2,2,3,1,NYSE
4737,13-02-2021 12:00,24 hrs.,wallstreetbets,PLTR,14256,614,13642,-13028,39,6353,1394,31,NYSE
4737,13-02-2021 12:00,24 hrs.,wallstreetbets,PRTY,14,0,14,-14,2,2,2,2,NYSE
4737,13-02-2021 12:00,24 hrs.,wallstreetbets,PSTH,235,235,0,235,3,78,67,2,NYSE
4737,13-02-2021 12:00,24 hrs.,wallstreetbets,PUMP,49,0,49,-49,7,7,7,2,NYSE
4737,13-02-2021 12:00,24 hrs.,wallstreetbets,SAFE,133,9,124,-115,2,35,55,2,NYSE
4737,13-02-2021 12:00,24 hrs.,wallstreetbets,SPCE,230,34,196,-162,19,51,52,13,NYSE
4737,13-02-2021 12:00,24 hrs.,wallstreetbets,STIC,7,0,7,-7,1,1,1,1,NYSE
4737,13-02-2021 12:00,24 hrs.,wallstreetbets,STPK,6,6,0,6,1,1,0,1,NYSE
4737,13-02-2021 12:00,24 hrs.,wallstreetbets,STWD,149,0,149,-149,1,41,63,1,NYSE
4737,13-02-2021 12:00,24 hrs.,wallstreetbets,TWTR,7,0,7,-7,1,1,1,1,NYSE
4737,13-02-2021 12:00,24 hrs.,wallstreetbets,UBER,7,0,7,-7,1,1,1,1,NYSE
4737,13-02-2021 12:00,24 hrs.,wallstreetbets,AEZS,14,0,14,-14,2,2,2,1,NASDAQ
4737,13-02-2021 12:00,24 hrs.,wallstreetbets,AGEN,7,0,7,-7,1,1,1,1,NASDAQ
4737,13-02-2021 12:00,24 hrs.,wallstreetbets,AGTC,36,0,36,-36,5,5,6,3,NASDAQ
4737,13-02-2021 12:00,24 hrs.,wallstreetbets,AIKI,7,0,7,-7,1,1,1,1,NASDAQ
4737,13-02-2021 12:00,24 hrs.,wallstreetbets,AKBA,7,0,7,-7,1,1,1,1,NASDAQ
4737,13-02-2021 12:00,24 hrs.,wallstreetbets,ALRN,7,0,7,-7,1,1,1,1,NASDAQ
4737,13-02-2021 12:00,24 hrs.,wallstreetbets,AMAT,13,0,13,-13,2,2,1,2,NASDAQ
4737,13-02-2021 12:00,24 hrs.,wallstreetbets,AMBC,8,0,8,-8,1,1,2,1,NASDAQ
4737,13-02-2021 12:00,24 hrs.,wallstreetbets,AMKR,21,0,21,-21,3,3,3,3,NASDAQ
4737,13-02-2021 12:00,24 hrs.,wallstreetbets,AMZN,116,0,116,-116,5,4,88,4,NASDAQ
4737,13-02-2021 12:00,24 hrs.,wallstreetbets,ANCN,7,0,7,-7,1,1,1,1,NASDAQ
4737,13-02-2021 12:00,24 hrs.,wallstreetbets,ANTE,7,7,0,7,1,1,1,1,NASDAQ
4737,13-02-2021 12:00,24 hrs.,wallstreetbets,APEN,7,0,7,-7,1,1,1,1,NASDAQ
4737,13-02-2021 12:00,24 hrs.,wallstreetbets,APHA,896,608,288,320,42,273,182,29,NASDAQ
4737,13-02-2021 12:00,24 hrs.,wallstreetbets,APPS,7,7,0,7,1,1,1,1,NASDAQ
4737,13-02-2021 12:00,24 hrs.,wallstreetbets,APRE,7,0,7,-7,1,1,1,1,NASDAQ
4737,13-02-2021 12:00,24 hrs.,wallstreetbets,AQST,7,0,7,-7,1,1,1,1,NASDAQ
4737,13-02-2021 12:00,24 hrs.,wallstreetbets,ARTL,82,0,82,-82,12,12,10,10,NASDAQ
4737,13-02-2021 12:00,24 hrs.,wallstreetbets,ASRT,48,7,41,-34,7,7,6,7,NASDAQ
4737,13-02-2021 12:00,24 hrs.,wallstreetbets,ASTC,7,7,0,7,1,1,1,1,NASDAQ
4737,13-02-2021 12:00,24 hrs.,wallstreetbets,ASYS,6,0,6,-6,1,1,0,1,NASDAQ
4737,13-02-2021 12:00,24 hrs.,SPACs,NKLA,37,37,0,37,1,10,13,1,NASDAQ
4737,13-02-2021 12:00,24 hrs.,SPACs,OKTA,52,0,52,-52,1,17,14,1,NASDAQ
4737,13-02-2021 12:00,24 hrs.,SPACs,OTRA,335,0,335,-335,1,95,141,1,NASDAQ
4737,13-02-2021 12:00,24 hrs.,SPACs,PAIC,335,0,335,-335,1,95,141,1,NASDAQ
4737,13-02-2021 12:00,24 hrs.,SPACs,PRCH,36,0,36,-36,1,13,6,1,NASDAQ
4737,13-02-2021 12:00,24 hrs.,SPACs,PYPL,94,0,94,-94,1,34,22,1,NASDAQ
4737,13-02-2021 12:00,24 hrs.,SPACs,QELL,549,0,549,-549,2,230,81,2,NASDAQ
4737,13-02-2021 12:00,24 hrs.,SPACs,RCHG,335,0,335,-335,1,95,141,1,NASDAQ
4737,13-02-2021 12:00,24 hrs.,SPACs,RIDE,37,37,0,37,1,10,13,1,NASDAQ
4737,13-02-2021 12:00,24 hrs.,SPACs,ROCH,37,37,0,37,1,10,13,1,NASDAQ
4737,13-02-2021 12:00,24 hrs.,SPACs,SGAM,335,0,335,-335,1,95,141,1,NASDAQ
4737,13-02-2021 12:00,24 hrs.,SPACs,SRAC,126,0,126,-126,2,42,34,2,NASDAQ
4737,13-02-2021 12:00,24 hrs.,SPACs,SSPK,37,37,0,37,1,10,13,1,NASDAQ
4737,13-02-2021 12:00,24 hrs.,SPACs,STWO,335,0,335,-335,1,95,141,1,NASDAQ
4737,13-02-2021 12:00,24 hrs.,SPACs,SVAC,335,0,335,-335,1,95,141,1,NASDAQ
4737,13-02-2021 12:00,24 hrs.,SPACs,TEKK,335,0,335,-335,1,95,141,1,NASDAQ
4737,13-02-2021 12:00,24 hrs.,SPACs,THBR,330,298,32,266,2,28,266,2,NASDAQ
4737,13-02-2021 12:00,24 hrs.,SPACs,THCA,335,0,335,-335,1,95,141,1,NASDAQ
4737,13-02-2021 12:00,24 hrs.,SPACs,THCB,341,335,6,329,3,35,259,3,NASDAQ
4737,13-02-2021 12:00,24 hrs.,SPACs,TMPM,335,0,335,-335,1,95,141,1,NASDAQ
4737,13-02-2021 12:00,24 hrs.,SPACs,TMTS,335,0,335,-335,1,95,141,1,NASDAQ
4737,13-02-2021 12:00,24 hrs.,SPACs,TWCT,335,0,335,-335,1,95,141,1,NASDAQ
4737,13-02-2021 12:00,24 hrs.,SPACs,VACQ,335,0,335,-335,1,95,141,1,NASDAQ
4737,13-02-2021 12:00,24 hrs.,SPACs,VMAC,335,0,335,-335,1,95,141,1,NASDAQ
4737,13-02-2021 12:00,24 hrs.,SPACs,VTIQ,53,37,16,21,2,12,21,2,NASDAQ
4737,13-02-2021 12:00,24 hrs.,SPACs,YSAC,335,0,335,-335,1,95,141,1,NASDAQ
4737,13-02-2021 12:00,24 hrs.,SPACs,ZGYH,335,0,335,-335,1,95,141,1,NASDAQ
4737,13-02-2021 12:00,24 hrs.,SPACs,CMLFW,298,298,0,298,1,24,246,1,NASDAQ
4737,13-02-2021 12:00,24 hrs.,SPACs,DSACW,298,298,0,298,1,24,246,1,NASDAQ
4737,13-02-2021 12:00,24 hrs.,SPACs,EXPCW,298,298,0,298,1,24,246,1,NASDAQ
4737,13-02-2021 12:00,24 hrs.,SPACs,FCACW,298,298,0,298,1,24,246,1,NASDAQ
4737,13-02-2021 12:00,24 hrs.,SPACs,NBACR,5,0,5,-5,1,0,1,1,NASDAQ
4737,13-02-2021 12:00,24 hrs.,SPACs,NBACW,5,0,5,-5,1,0,1,1,NASDAQ
4737,13-02-2021 12:00,24 hrs.,SPACs,SAIIW,298,298,0,298,1,24,246,1,NASDAQ
4737,13-02-2021 12:00,24 hrs.,SPACs,TWCTW,298,298,0,298,1,24,246,1,NASDAQ
4737,13-02-2021 12:00,24 hrs.,stocks,ABML,20,14,6,8,2,2,8,2,OTC
4737,13-02-2021 12:00,24 hrs.,stocks,BLSP,6,0,6,-6,1,1,0,1,OTC
4737,13-02-2021 12:00,24 hrs.,stocks,BONZ,6,0,6,-6,1,1,0,1,OTC
4737,13-02-2021 12:00,24 hrs.,stocks,CANN,6,0,6,-6,1,1,0,1,OTC
4737,13-02-2021 12:00,24 hrs.,stocks,CAPC,6,0,6,-6,1,1,0,1,OTC
4737,13-02-2021 12:00,24 hrs.,stocks,ETCG,6,0,6,-6,1,1,0,1,OTC
4737,13-02-2021 12:00,24 hrs.,stocks,FRCH,12,12,0,12,1,4,0,1,OTC
4737,13-02-2021 12:00,24 hrs.,stocks,GRYN,6,0,6,-6,1,1,0,1,OTC
4737,13-02-2021 12:00,24 hrs.,wallstreetbets,BRQS,6,0,6,-6,1,1,0,1,NASDAQ
4737,13-02-2021 12:00,24 hrs.,wallstreetbets,BTWN,7,0,7,-7,1,1,1,1,NASDAQ
4737,13-02-2021 12:00,24 hrs.,wallstreetbets,BWEN,7,7,0,7,1,1,1,1,NASDAQ
4737,13-02-2021 12:00,24 hrs.,wallstreetbets,CARE,49,0,49,-49,7,7,7,2,NASDAQ
4737,13-02-2021 12:00,24 hrs.,wallstreetbets,CARV,7,0,7,-7,1,1,1,1,NASDAQ
4737,13-02-2021 12:00,24 hrs.,wallstreetbets,CASH,14,0,14,-14,2,2,2,1,NASDAQ
4737,13-02-2021 12:00,24 hrs.,wallstreetbets,CATM,7,0,7,-7,1,1,1,1,NASDAQ
4737,13-02-2021 12:00,24 hrs.,wallstreetbets,CBAT,7,0,7,-7,1,1,1,1,NASDAQ
4737,13-02-2021 12:00,24 hrs.,wallstreetbets,CCRC,12,0,12,-12,2,2,0,1,NASDAQ
4737,13-02-2021 12:00,24 hrs.,wallstreetbets,CIDM,21,0,21,-21,3,3,3,3,NASDAQ
4737,13-02-2021 12:00,24 hrs.,wallstreetbets,CKPT,7,0,7,-7,1,1,1,1,NASDAQ
4737,13-02-2021 12:00,24 hrs.,wallstreetbets,CLBS,21,7,14,-7,3,3,3,2,NASDAQ
4737,13-02-2021 12:00,24 hrs.,wallstreetbets,CLGN,7,0,7,-7,1,1,1,1,NASDAQ
4737,13-02-2021 12:00,24 hrs.,wallstreetbets,CLSN,7,0,7,-7,1,1,1,1,NASDAQ
4737,13-02-2021 12:00,24 hrs.,wallstreetbets,CMPS,40,12,28,-16,6,6,4,5,NASDAQ
4737,13-02-2021 12:00,24 hrs.,wallstreetbets,CNDT,6,0,6,-6,1,1,0,1,NASDAQ
4737,13-02-2021 12:00,24 hrs.,wallstreetbets,COCP,7,0,7,-7,1,1,1,1,NASDAQ
4737,13-02-2021 12:00,24 hrs.,wallstreetbets,COHR,433,0,433,-433,1,177,75,1,NASDAQ
4737,13-02-2021 12:00,24 hrs.,wallstreetbets,CRBP,34,13,21,-8,5,5,4,5,NASDAQ
4737,13-02-2021 12:00,24 hrs.,wallstreetbets,CRNT,7,0,7,-7,1,1,1,1,NASDAQ
4737,13-02-2021 12:00,24 hrs.,wallstreetbets,CRON,20,0,20,-20,3,3,2,3,NASDAQ
4737,13-02-2021 12:00,24 hrs.,stocks,DGTHF,6,0,6,-6,1,1,0,1,OTC
4737,13-02-2021 12:00,24 hrs.,stocks,EMHTF,6,0,6,-6,1,1,0,1,OTC
4737,13-02-2021 12:00,24 hrs.,stocks,HITIF,6,6,0,6,1,1,0,1,OTC
4737,13-02-2021 12:00,24 hrs.,stocks,HRSTW,6,0,6,-6,1,1,0,1,OTC
4737,13-02-2021 12:00,24 hrs.,stocks,ILIKF,6,6,0,6,1,1,0,1,OTC
4737,13-02-2021 12:00,24 hrs.,stocks,MMEDF,12,0,12,-12,2,2,0,1,OTC
4737,13-02-2021 12:00,24 hrs.,stocks,NXTTF,6,0,6,-6,1,1,0,1,OTC
4737,13-02-2021 12:00,24 hrs.,stocks,OILFF,6,0,6,-6,1,1,0,1,OTC
4737,13-02-2021 12:00,24 hrs.,stocks,RHDGF,6,0,6,-6,1,1,0,1,OTC
4737,13-02-2021 12:00,24 hrs.,stocks,RHHBY,32,0,32,-32,1,10,8,1,OTC
4737,13-02-2021 12:00,24 hrs.,stocks,RLLCF,6,0,6,-6,1,1,0,1,OTC
4737,13-02-2021 12:00,24 hrs.,stocks,RVVTF,13,0,13,-13,2,2,1,2,OTC
4737,13-02-2021 12:00,24 hrs.,stocks,TBUIF,6,0,6,-6,1,1,0,1,OTC
4737,13-02-2021 12:00,24 hrs.,stocks,DNN,31,0,31,-31,1,7,13,1,AMEX
4737,13-02-2021 12:00,24 hrs.,stocks,DSS,6,0,6,-6,1,1,0,1,AMEX
4737,13-02-2021 12:00,24 hrs.,stocks,GTE,13,7,6,1,2,2,1,2,AMEX
4737,13-02-2021 12:00,24 hrs.,stocks,IGC,6,0,6,-6,1,1,0,1,AMEX
4737,13-02-2021 12:00,24 hrs.,wallstreetbets,SDC,7,0,7,-7,1,1,1,1,NASDAQ
4737,13-02-2021 12:00,24 hrs.,wallstreetbets,SFT,7,0,7,-7,1,1,1,1,NASDAQ
4737,13-02-2021 12:00,24 hrs.,wallstreetbets,SLM,8,0,8,-8,1,1,2,1,NASDAQ
4737,13-02-2021 12:00,24 hrs.,wallstreetbets,SLP,7,7,0,7,1,1,1,1,NASDAQ
4737,13-02-2021 12:00,24 hrs.,wallstreetbets,SMH,7,0,7,-7,1,1,1,1,NASDAQ
4737,13-02-2021 12:00,24 hrs.,wallstreetbets,SND,27,7,20,-13,4,4,3,4,NASDAQ
4737,13-02-2021 12:00,24 hrs.,wallstreetbets,SPI,7,0,7,-7,1,1,1,1,NASDAQ
4737,13-02-2021 12:00,24 hrs.,wallstreetbets,SPT,7,0,7,-7,1,1,1,1,NASDAQ
4737,13-02-2021 12:00,24 hrs.,wallstreetbets,VFF,24,0,24,-24,3,3,6,2,NASDAQ
4737,13-02-2021 12:00,24 hrs.,wallstreetbets,WBA,7,0,7,-7,1,1,1,1,NASDAQ
4737,13-02-2021 12:00,24 hrs.,wallstreetbets,WNW,60,17,43,-26,8,8,12,6,NASDAQ
4737,13-02-2021 12:00,24 hrs.,wallstreetbets,WWR,6,0,6,-6,1,1,0,1,NASDAQ
4737,13-02-2021 12:00,24 hrs.,wallstreetbets,AACG,7,0,7,-7,1,1,1,1,NASDAQ
4737,13-02-2021 12:00,24 hrs.,wallstreetbets,AAPL,32,6,26,-20,5,5,2,5,NASDAQ
4737,13-02-2021 12:00,24 hrs.,wallstreetbets,AAWW,6,0,6,-6,1,1,0,1,NASDAQ
4737,13-02-2021 12:00,24 hrs.,wallstreetbets,ABCL,7,7,0,7,1,1,1,1,NASDAQ
4737,13-02-2021 12:00,24 hrs.,wallstreetbets,ABEO,7,0,7,-7,1,1,1,1,NASDAQ
4737,13-02-2021 12:00,24 hrs.,wallstreetbets,ABNB,21,6,15,-9,3,3,3,2,NASDAQ
4737,13-02-2021 12:00,24 hrs.,wallstreetbets,ABUS,7,0,7,-7,1,1,1,1,NASDAQ
4737,13-02-2021 12:00,24 hrs.,wallstreetbets,ACEV,6,0,6,-6,1,1,0,1,NASDAQ
4737,13-02-2021 12:00,24 hrs.,wallstreetbets,ACIU,7,0,7,-7,1,1,1,1,NASDAQ
4737,13-02-2021 12:00,24 hrs.,wallstreetbets,ACOR,7,7,0,7,1,1,1,1,NASDAQ
4737,13-02-2021 12:00,24 hrs.,wallstreetbets,ACST,20,0,20,-20,3,3,2,3,NASDAQ
4737,13-02-2021 12:00,24 hrs.,wallstreetbets,ADMA,7,0,7,-7,1,1,1,1,NASDAQ
4737,13-02-2021 12:00,24 hrs.,wallstreetbets,ADMP,7,0,7,-7,1,1,1,1,NASDAQ
4737,13-02-2021 12:00,24 hrs.,wallstreetbets,ADXS,6,0,6,-6,1,1,0,1,NASDAQ
4737,13-02-2021 12:00,24 hrs.,wallstreetbets,CVAC,64,64,0,64,1,22,16,1,NASDAQ
4737,13-02-2021 12:00,24 hrs.,wallstreetbets,DDOG,433,0,433,-433,1,177,75,1,NASDAQ
4737,13-02-2021 12:00,24 hrs.,wallstreetbets,DFFN,14,0,14,-14,2,2,2,1,NASDAQ
4737,13-02-2021 12:00,24 hrs.,wallstreetbets,DKNG,21,7,14,-7,3,3,3,3,NASDAQ
4737,13-02-2021 12:00,24 hrs.,wallstreetbets,DOYU,7,0,7,-7,1,1,1,1,NASDAQ
4737,13-02-2021 12:00,24 hrs.,wallstreetbets,DRIV,6,6,0,6,1,1,0,1,NASDAQ
4737,13-02-2021 12:00,24 hrs.,wallstreetbets,DRRX,7,0,7,-7,1,1,1,1,NASDAQ
4737,13-02-2021 12:00,24 hrs.,stocks,PLX,13,0,13,-13,1,2,5,1,AMEX
4737,13-02-2021 12:00,24 hrs.,stocks,ZOM,12,6,6,0,2,2,0,2,AMEX
4737,13-02-2021 12:00,24 hrs.,stocks,GSAT,24,18,6,12,4,4,0,2,AMEX
4737,13-02-2021 12:00,24 hrs.,stocks,SENS,20,20,0,20,3,2,4,2,AMEX
4737,13-02-2021 12:00,24 hrs.,stocks,TMBR,6,0,6,-6,1,1,0,1,AMEX
4737,13-02-2021 12:00,24 hrs.,stocks,ADT,6,0,6,-6,1,1,0,1,NYSE
4737,13-02-2021 12:00,24 hrs.,stocks,AMC,117,0,117,-117,5,22,53,5,NYSE
4737,13-02-2021 12:00,24 hrs.,stocks,ASX,13,6,7,-1,2,2,1,2,NYSE
4737,13-02-2021 12:00,24 hrs.,stocks,BEP,217,0,217,-217,5,50,97,5,NYSE
4737,13-02-2021 12:00,24 hrs.,stocks,BHC,10,0,10,-10,1,2,2,1,NYSE
4737,13-02-2021 12:00,24 hrs.,stocks,CBD,6,0,6,-6,1,1,0,1,NYSE
4737,13-02-2021 12:00,24 hrs.,stocks,CRM,6,0,6,-6,1,1,0,1,NYSE
4737,13-02-2021 12:00,24 hrs.,stocks,CVE,6,0,6,-6,1,1,0,1,NYSE
4737,13-02-2021 12:00,24 hrs.,stocks,CVS,38,0,38,-38,3,8,10,3,NYSE
4737,13-02-2021 12:00,24 hrs.,stocks,DIS,10,0,10,-10,1,2,2,1,NYSE
4737,13-02-2021 12:00,24 hrs.,stocks,DPG,11,11,0,11,1,3,1,1,NYSE
4737,13-02-2021 12:00,24 hrs.,stocks,ETH,6,0,6,-6,1,1,0,1,NYSE
4737,13-02-2021 12:00,24 hrs.,stocks,FSR,6,0,6,-6,1,1,0,1,NYSE
4737,13-02-2021 12:00,24 hrs.,stocks,GME,1388,51,1337,-1286,12,565,210,11,NYSE
4737,13-02-2021 12:00,24 hrs.,stocks,IBM,432,37,395,-358,2,189,46,2,NYSE
4737,13-02-2021 12:00,24 hrs.,stocks,IRS,20,14,6,8,2,2,8,2,NYSE
4737,13-02-2021 12:00,24 hrs.,stocks,JNJ,6,6,0,6,1,1,0,1,NYSE
4737,13-02-2021 12:00,24 hrs.,stocks,LOW,14,14,0,14,1,1,8,1,NYSE
4737,13-02-2021 12:00,24 hrs.,stocks,MCO,10,0,10,-10,1,2,2,1,NYSE
4737,13-02-2021 12:00,24 hrs.,stocks,MGM,11,0,11,-11,1,1,5,1,NYSE
4737,13-02-2021 12:00,24 hrs.,stocks,MRO,10,0,10,-10,1,2,2,1,NYSE
4737,13-02-2021 12:00,24 hrs.,stocks,NET,25,14,11,3,2,2,13,2,NYSE
4737,13-02-2021 12:00,24 hrs.,stocks,NGL,6,0,6,-6,1,1,0,1,NYSE
4737,13-02-2021 12:00,24 hrs.,stocks,NIO,866,0,866,-866,9,262,306,6,NYSE
4737,13-02-2021 12:00,24 hrs.,stocks,NOK,135,0,135,-135,3,20,83,3,NYSE
4737,13-02-2021 12:00,24 hrs.,stocks,NOM,76,0,76,-76,1,27,18,1,NYSE
4737,13-02-2021 12:00,24 hrs.,stocks,NSA,37,37,0,37,1,14,5,1,NYSE
4737,13-02-2021 12:00,24 hrs.,stocks,OSK,16,0,16,-16,2,1,6,1,NYSE
4737,13-02-2021 12:00,24 hrs.,stocks,PEG,591,0,591,-591,1,41,505,1,NYSE
4737,13-02-2021 12:00,24 hrs.,stocks,PFE,7,0,7,-7,1,1,1,1,NYSE
4737,13-02-2021 12:00,24 hrs.,stocks,RAD,21,0,21,-21,1,6,5,1,NYSE
4737,13-02-2021 12:00,24 hrs.,stocks,RDY,6,0,6,-6,1,1,0,1,NYSE
4737,13-02-2021 12:00,24 hrs.,stocks,RTX,40,0,40,-40,1,11,14,1,NYSE
4737,13-02-2021 12:00,24 hrs.,stocks,SOS,6,0,6,-6,1,1,0,1,NYSE
4737,13-02-2021 12:00,24 hrs.,stocks,SQZ,7,7,0,7,1,1,1,1,NYSE
4737,13-02-2021 12:00,24 hrs.,stocks,SUP,6,0,6,-6,1,1,0,1,NYSE
4737,13-02-2021 12:00,24 hrs.,stocks,TDA,5,5,0,5,1,0,1,1,NYSE
4737,13-02-2021 12:00,24 hrs.,wallstreetbets,ATHA,7,0,7,-7,1,1,1,1,NASDAQ
4737,13-02-2021 12:00,24 hrs.,wallstreetbets,ATHE,12,0,12,-12,2,2,0,1,NASDAQ
4737,13-02-2021 12:00,24 hrs.,wallstreetbets,ATOS,41,7,34,-27,6,6,5,5,NASDAQ
4737,13-02-2021 12:00,24 hrs.,wallstreetbets,ATVI,19,12,7,5,2,1,9,2,NASDAQ
4737,13-02-2021 12:00,24 hrs.,wallstreetbets,AUPH,6,0,6,-6,1,1,0,1,NASDAQ
4737,13-02-2021 12:00,24 hrs.,wallstreetbets,AVXL,7,0,7,-7,1,1,1,1,NASDAQ
4737,13-02-2021 12:00,24 hrs.,wallstreetbets,AWRE,7,0,7,-7,1,1,1,1,NASDAQ
4737,13-02-2021 12:00,24 hrs.,wallstreetbets,BBBY,7,0,7,-7,1,1,1,1,NASDAQ
4737,13-02-2021 12:00,24 hrs.,wallstreetbets,BEAT,8,0,8,-8,1,2,0,1,NASDAQ
4737,13-02-2021 12:00,24 hrs.,wallstreetbets,BIVI,6,0,6,-6,1,1,0,1,NASDAQ
4737,13-02-2021 12:00,24 hrs.,wallstreetbets,BLCM,6,0,6,-6,1,1,0,1,NASDAQ
4737,13-02-2021 12:00,24 hrs.,wallstreetbets,BLNK,7,0,7,-7,1,1,1,1,NASDAQ
4737,13-02-2021 12:00,24 hrs.,wallstreetbets,BNGO,383,242,141,101,22,113,69,13,NASDAQ
4737,13-02-2021 12:00,24 hrs.,wallstreetbets,BNTX,13,0,13,-13,2,2,1,1,NASDAQ
4737,13-02-2021 12:00,24 hrs.,wallstreetbets,BOXL,7,0,7,-7,1,1,1,1,NASDAQ
4737,13-02-2021 12:00,24 hrs.,wallstreetbets,ILMN,7,0,7,-7,1,1,1,1,NASDAQ
4737,13-02-2021 12:00,24 hrs.,wallstreetbets,IMGN,21,0,21,-21,3,3,3,3,NASDAQ
4737,13-02-2021 12:00,24 hrs.,wallstreetbets,INPX,14,7,7,0,2,2,2,2,NASDAQ
4737,13-02-2021 12:00,24 hrs.,wallstreetbets,INSG,6,6,0,6,1,1,0,1,NASDAQ
4737,13-02-2021 12:00,24 hrs.,wallstreetbets,INTC,160,20,140,-120,5,4,132,5,NASDAQ
4737,13-02-2021 12:00,24 hrs.,wallstreetbets,IPWR,6,0,6,-6,1,1,0,1,NASDAQ
4737,13-02-2021 12:00,24 hrs.,wallstreetbets,IRBT,6,6,0,6,1,1,0,1,NASDAQ
4737,13-02-2021 12:00,24 hrs.,stocks,TSM,57,0,57,-57,1,11,31,1,NYSE
4737,13-02-2021 12:00,24 hrs.,stocks,UBS,33665,0,33665,-33665,1,16459,743,1,NYSE
4737,13-02-2021 12:00,24 hrs.,stocks,WLL,6,0,6,-6,1,1,0,1,NYSE
4737,13-02-2021 12:00,24 hrs.,stocks,WMT,142,0,142,-142,1,43,52,1,NYSE
4737,13-02-2021 12:00,24 hrs.,stocks,AJRD,142,0,142,-142,1,43,52,1,NYSE
4737,13-02-2021 12:00,24 hrs.,stocks,APTV,142,0,142,-142,1,43,52,1,NYSE
4737,13-02-2021 12:00,24 hrs.,stocks,BABA,6,6,0,6,1,1,0,1,NYSE
4737,13-02-2021 12:00,24 hrs.,stocks,BEPC,36,0,36,-36,2,4,20,2,NYSE
4737,13-02-2021 12:00,24 hrs.,stocks,BORR,52,0,52,-52,3,13,14,3,NYSE
4737,13-02-2021 12:00,24 hrs.,stocks,CCIV,18,12,6,6,3,3,0,3,NYSE
4737,13-02-2021 12:00,24 hrs.,stocks,CHWY,28,0,28,-28,1,7,10,1,NYSE
4737,13-02-2021 12:00,24 hrs.,stocks,COTY,6,0,6,-6,1,1,0,1,NYSE
4737,13-02-2021 12:00,24 hrs.,stocks,DASH,6,6,0,6,1,1,0,1,NYSE
4737,13-02-2021 12:00,24 hrs.,stocks,FUSE,6,0,6,-6,1,1,0,1,NYSE
4737,13-02-2021 12:00,24 hrs.,stocks,HEXO,6,0,6,-6,1,1,0,1,NYSE
4737,13-02-2021 12:00,24 hrs.,stocks,HOME,28,0,28,-28,1,7,10,1,NYSE
4737,13-02-2021 12:00,24 hrs.,stocks,HUYA,6,0,6,-6,1,1,0,1,NYSE
4737,13-02-2021 12:00,24 hrs.,stocks,JMIA,6,0,6,-6,1,1,0,1,NYSE
4737,13-02-2021 12:00,24 hrs.,stocks,PLTR,602,0,602,-602,3,210,170,3,NYSE
4737,13-02-2021 12:00,24 hrs.,stocks,SHOP,74,74,0,74,1,17,36,1,NYSE
4737,13-02-2021 12:00,24 hrs.,stocks,SPCE,171,0,171,-171,2,49,65,2,NYSE
4737,13-02-2021 12:00,24 hrs.,stocks,TWLO,16,0,16,-16,2,1,6,1,NYSE
4737,13-02-2021 12:00,24 hrs.,stocks,TWTR,6,0,6,-6,1,1,0,1,NYSE
4737,13-02-2021 12:00,24 hrs.,stocks,VGAC,6,0,6,-6,1,1,0,1,NYSE
4737,13-02-2021 12:00,24 hrs.,stocks,XPEV,89,0,89,-89,5,14,41,2,NYSE
4737,13-02-2021 12:00,24 hrs.,stocks,AMD,63,6,57,-51,2,12,31,2,NASDAQ
4737,13-02-2021 12:00,24 hrs.,stocks,AZN,10,0,10,-10,1,2,2,1,NASDAQ
4737,13-02-2021 12:00,24 hrs.,stocks,CDC,10,0,10,-10,1,2,2,1,NASDAQ
4737,13-02-2021 12:00,24 hrs.,stocks,FTC,33,0,33,-33,1,10,9,1,NASDAQ
4737,13-02-2021 12:00,24 hrs.,stocks,GAN,7,0,7,-7,1,1,1,1,NASDAQ
4737,13-02-2021 12:00,24 hrs.,stocks,GSM,67,0,67,-67,2,20,19,1,NASDAQ
4737,13-02-2021 12:00,24 hrs.,stocks,IEA,20,0,20,-20,1,5,6,1,NASDAQ
4737,13-02-2021 12:00,24 hrs.,stocks,INO,6,0,6,-6,1,1,0,1,NASDAQ
4737,13-02-2021 12:00,24 hrs.,stocks,NWL,10,0,10,-10,1,2,2,1,NASDAQ
4737,13-02-2021 12:00,24 hrs.,stocks,OGI,12,0,12,-12,2,2,0,2,NASDAQ
4737,13-02-2021 12:00,24 hrs.,stocks,PEP,34,0,34,-34,1,8,14,1,NASDAQ
4737,13-02-2021 12:00,24 hrs.,stocks,SMH,33,33,0,33,1,5,19,1,NASDAQ
4737,13-02-2021 12:00,24 hrs.,stocks,SPI,6,6,0,6,1,1,0,1,NASDAQ
4737,13-02-2021 12:00,24 hrs.,stocks,VFF,6,6,0,6,1,1,0,1,NASDAQ
4737,13-02-2021 12:00,24 hrs.,stocks,WBA,21,0,21,-21,1,6,5,1,NASDAQ
4737,13-02-2021 12:00,24 hrs.,stocks,ABUS,6,0,6,-6,1,1,0,1,NASDAQ
4737,13-02-2021 12:00,24 hrs.,stocks,AESE,6,6,0,6,1,1,0,1,NASDAQ
4737,13-02-2021 12:00,24 hrs.,stocks,AEZS,201,0,201,-201,1,89,19,1,NASDAQ
4737,13-02-2021 12:00,24 hrs.,stocks,AGEN,10,0,10,-10,1,3,0,1,NASDAQ
4737,13-02-2021 12:00,24 hrs.,stocks,AGTC,12,0,12,-12,2,2,0,1,NASDAQ
4737,13-02-2021 12:00,24 hrs.,stocks,AMAT,14,14,0,14,1,1,8,1,NASDAQ
4737,13-02-2021 12:00,24 hrs.,stocks,AMZN,158,16,142,-126,2,45,60,2,NASDAQ
4737,13-02-2021 12:00,24 hrs.,stocks,ANTE,12,12,0,12,2,2,0,1,NASDAQ
4737,13-02-2021 12:00,24 hrs.,stocks,APHA,912,0,912,-912,4,235,426,4,NASDAQ
4737,13-02-2021 12:00,24 hrs.,stocks,ARTL,18,0,18,-18,3,3,0,2,NASDAQ
4737,13-02-2021 12:00,24 hrs.,stocks,ASYS,6,0,6,-6,1,1,0,1,NASDAQ
4737,13-02-2021 12:00,24 hrs.,stocks,ATOS,201,0,201,-201,1,89,19,1,NASDAQ
4737,13-02-2021 12:00,24 hrs.,wallstreetbets,CRSP,82,82,0,82,4,9,48,2,NASDAQ
4737,13-02-2021 12:00,24 hrs.,wallstreetbets,CRSR,630,256,374,-118,15,221,128,11,NASDAQ
4737,13-02-2021 12:00,24 hrs.,wallstreetbets,CTHR,7,0,7,-7,1,1,1,1,NASDAQ
4737,13-02-2021 12:00,24 hrs.,wallstreetbets,CTMX,7,0,7,-7,1,1,1,1,NASDAQ
4737,13-02-2021 12:00,24 hrs.,wallstreetbets,CTRM,219,7,212,-205,32,32,27,25,NASDAQ
4737,13-02-2021 12:00,24 hrs.,wallstreetbets,ITRM,42,7,35,-28,6,6,6,4,NASDAQ
4737,13-02-2021 12:00,24 hrs.,wallstreetbets,JAGX,45,13,32,-19,7,7,3,3,NASDAQ
4737,13-02-2021 12:00,24 hrs.,wallstreetbets,JNCE,12,6,6,0,2,2,0,2,NASDAQ
4737,13-02-2021 12:00,24 hrs.,wallstreetbets,KOPN,15,0,15,-15,2,2,3,2,NASDAQ
4737,13-02-2021 12:00,24 hrs.,wallstreetbets,KOSS,178,7,171,-164,3,52,62,3,NASDAQ
4737,13-02-2021 12:00,24 hrs.,wallstreetbets,LAZR,8,0,8,-8,1,1,2,1,NASDAQ
4737,13-02-2021 12:00,24 hrs.,wallstreetbets,LEGN,7,0,7,-7,1,1,1,1,NASDAQ
4737,13-02-2021 12:00,24 hrs.,wallstreetbets,DSKE,7,0,7,-7,1,1,1,1,NASDAQ
4737,13-02-2021 12:00,24 hrs.,wallstreetbets,DXYN,7,0,7,-7,1,1,1,1,NASDAQ
4737,13-02-2021 12:00,24 hrs.,wallstreetbets,EBON,56,0,56,-56,8,8,8,4,NASDAQ
4737,13-02-2021 12:00,24 hrs.,wallstreetbets,EDIT,9036,101,8935,-8834,2,4219,590,2,NASDAQ
4737,13-02-2021 12:00,24 hrs.,wallstreetbets,EDSA,6,0,6,-6,1,1,0,1,NASDAQ
4737,13-02-2021 12:00,24 hrs.,wallstreetbets,EHTH,7,0,7,-7,1,1,1,1,NASDAQ
4737,13-02-2021 12:00,24 hrs.,wallstreetbets,ELSE,7,0,7,-7,1,1,1,1,NASDAQ
4737,13-02-2021 12:00,24 hrs.,wallstreetbets,ENLV,7,0,7,-7,1,1,1,1,NASDAQ
4737,13-02-2021 12:00,24 hrs.,wallstreetbets,ENVB,26,0,26,-26,4,4,2,3,NASDAQ
4737,13-02-2021 12:00,24 hrs.,wallstreetbets,EVER,28,7,21,-14,4,4,4,4,NASDAQ
4737,13-02-2021 12:00,24 hrs.,wallstreetbets,EXPC,7,0,7,-7,1,1,1,1,NASDAQ
4737,13-02-2021 12:00,24 hrs.,wallstreetbets,EXPE,433,0,433,-433,1,177,75,1,NASDAQ
4737,13-02-2021 12:00,24 hrs.,wallstreetbets,EXPI,6,6,0,6,1,1,0,1,NASDAQ
4737,13-02-2021 12:00,24 hrs.,wallstreetbets,FAMI,6,0,6,-6,1,1,0,1,NASDAQ
4737,13-02-2021 12:00,24 hrs.,wallstreetbets,FARM,7,0,7,-7,1,1,1,1,NASDAQ
4737,13-02-2021 12:00,24 hrs.,wallstreetbets,FAST,7,0,7,-7,1,1,1,1,NASDAQ
4737,13-02-2021 12:00,24 hrs.,wallstreetbets,FCAC,8,0,8,-8,1,1,2,1,NASDAQ
4737,13-02-2021 12:00,24 hrs.,wallstreetbets,FCEL,6,0,6,-6,1,1,0,1,NASDAQ
4737,13-02-2021 12:00,24 hrs.,wallstreetbets,FIZZ,14,14,0,14,2,2,2,1,NASDAQ
4737,13-02-2021 12:00,24 hrs.,wallstreetbets,FLGT,13,0,13,-13,2,2,1,2,NASDAQ
4737,13-02-2021 12:00,24 hrs.,wallstreetbets,FLWR,7,7,0,7,1,1,1,1,NASDAQ
4737,13-02-2021 12:00,24 hrs.,wallstreetbets,FLWS,15,0,15,-15,2,2,3,2,NASDAQ
4737,13-02-2021 12:00,24 hrs.,wallstreetbets,FOLD,48,0,48,-48,7,7,6,6,NASDAQ
4737,13-02-2021 12:00,24 hrs.,wallstreetbets,FORD,7,0,7,-7,1,1,1,1,NASDAQ
4737,13-02-2021 12:00,24 hrs.,wallstreetbets,FORM,177,0,177,-177,1,68,37,1,NASDAQ
4737,13-02-2021 12:00,24 hrs.,wallstreetbets,FTFT,14,0,14,-14,2,2,2,2,NASDAQ
4737,13-02-2021 12:00,24 hrs.,wallstreetbets,FUTU,1050,0,1050,-1050,1,414,218,1,NASDAQ
4737,13-02-2021 12:00,24 hrs.,wallstreetbets,GAIN,13,0,13,-13,2,2,1,2,NASDAQ
4737,13-02-2021 12:00,24 hrs.,wallstreetbets,GERN,6,0,6,-6,1,1,0,1,NASDAQ
4737,13-02-2021 12:00,24 hrs.,wallstreetbets,GEVO,209,0,209,-209,9,58,57,7,NASDAQ
4737,13-02-2021 12:00,24 hrs.,wallstreetbets,GILT,14,0,14,-14,2,2,2,2,NASDAQ
4737,13-02-2021 12:00,24 hrs.,wallstreetbets,GLBS,28,7,21,-14,4,4,4,3,NASDAQ
4737,13-02-2021 12:00,24 hrs.,wallstreetbets,GLMD,14,0,14,-14,2,2,2,1,NASDAQ
4737,13-02-2021 12:00,24 hrs.,wallstreetbets,GLUU,30,0,30,-30,2,1,20,1,NASDAQ
4737,13-02-2021 12:00,24 hrs.,wallstreetbets,GMBL,7,0,7,-7,1,1,1,1,NASDAQ
4737,13-02-2021 12:00,24 hrs.,wallstreetbets,GNRS,14,0,14,-14,2,2,2,1,NASDAQ
4737,13-02-2021 12:00,24 hrs.,wallstreetbets,GNUS,27,14,13,1,4,4,3,4,NASDAQ
4737,13-02-2021 12:00,24 hrs.,wallstreetbets,GOEV,7,0,7,-7,1,1,1,1,NASDAQ
4737,13-02-2021 12:00,24 hrs.,wallstreetbets,GOGO,49,18,31,-13,8,8,1,5,NASDAQ
4737,13-02-2021 12:00,24 hrs.,wallstreetbets,GOLD,13,0,13,-13,2,2,1,2,NASDAQ
4737,13-02-2021 12:00,24 hrs.,wallstreetbets,GRIL,7,0,7,-7,1,1,1,1,NASDAQ
4737,13-02-2021 12:00,24 hrs.,wallstreetbets,GRTS,6,0,6,-6,1,1,0,1,NASDAQ
4737,13-02-2021 12:00,24 hrs.,wallstreetbets,GTEC,8,0,8,-8,1,1,2,1,NASDAQ
4737,13-02-2021 12:00,24 hrs.,wallstreetbets,GTHX,50,13,37,-24,8,8,2,6,NASDAQ
4737,13-02-2021 12:00,24 hrs.,wallstreetbets,HALO,14,0,14,-14,2,2,2,2,NASDAQ
4737,13-02-2021 12:00,24 hrs.,wallstreetbets,HDSN,7,0,7,-7,1,1,1,1,NASDAQ
4737,13-02-2021 12:00,24 hrs.,wallstreetbets,HEAR,13,7,6,1,2,2,1,2,NASDAQ
4737,13-02-2021 12:00,24 hrs.,wallstreetbets,HJLI,7,0,7,-7,1,1,1,1,NASDAQ
4737,13-02-2021 12:00,24 hrs.,wallstreetbets,HSTO,19,0,19,-19,3,3,1,2,NASDAQ
4737,13-02-2021 12:00,24 hrs.,wallstreetbets,HTBX,8,0,8,-8,1,1,2,1,NASDAQ
4737,13-02-2021 12:00,24 hrs.,wallstreetbets,HZNP,7,7,0,7,1,1,1,1,NASDAQ
4737,13-02-2021 12:00,24 hrs.,wallstreetbets,ICLN,6,0,6,-6,1,1,0,1,NASDAQ
4737,13-02-2021 12:00,24 hrs.,wallstreetbets,ICON,7,0,7,-7,1,1,1,1,NASDAQ
4737,13-02-2021 12:00,24 hrs.,wallstreetbets,ICPT,7,0,7,-7,1,1,1,1,NASDAQ
4737,13-02-2021 12:00,24 hrs.,wallstreetbets,IDEX,162,0,162,-162,3,43,64,3,NASDAQ
4737,13-02-2021 12:00,24 hrs.,wallstreetbets,IFMK,7,7,0,7,1,1,1,1,NASDAQ
4737,13-02-2021 12:00,24 hrs.,wallstreetbets,IIVI,433,0,433,-433,1,177,75,1,NASDAQ
4726,13-02-2021 10:00,24 hrs.,pennystocks,NAK,33,0,33,-33,1,7,15,1,AMEX
4726,13-02-2021 10:00,24 hrs.,pennystocks,NBY,43,43,0,43,1,12,15,1,AMEX
4726,13-02-2021 10:00,24 hrs.,pennystocks,PTN,24,0,24,-24,1,7,6,1,AMEX
4726,13-02-2021 10:00,24 hrs.,pennystocks,TGB,39,6,33,-27,2,12,7,2,AMEX
4726,13-02-2021 10:00,24 hrs.,pennystocks,TRX,8,0,8,-8,1,1,2,1,AMEX
4726,13-02-2021 10:00,24 hrs.,pennystocks,ZOM,90,77,13,64,3,10,58,3,AMEX
4726,13-02-2021 10:00,24 hrs.,pennystocks,GSAT,70,70,0,70,1,17,32,1,AMEX
4726,13-02-2021 10:00,24 hrs.,pennystocks,IBIO,21,0,21,-21,1,7,3,1,AMEX
4726,13-02-2021 10:00,24 hrs.,pennystocks,INUV,61,0,61,-61,1,21,15,1,AMEX
4726,13-02-2021 10:00,24 hrs.,pennystocks,NSPR,20,0,20,-20,1,6,4,1,AMEX
4726,13-02-2021 10:00,24 hrs.,pennystocks,OGEN,6,6,0,6,1,1,0,1,AMEX
4726,13-02-2021 10:00,24 hrs.,pennystocks,SDPI,6,0,6,-6,1,1,0,1,AMEX
4726,13-02-2021 10:00,24 hrs.,pennystocks,SENS,36,0,36,-36,3,6,12,3,AMEX
4726,13-02-2021 10:00,24 hrs.,pennystocks,TRXC,18,6,12,-6,3,2,2,3,AMEX
4726,13-02-2021 10:00,24 hrs.,pennystocks,UAVS,118,0,118,-118,1,40,34,1,AMEX
4726,13-02-2021 10:00,24 hrs.,pennystocks,XXII,6,0,6,-6,1,0,2,1,AMEX
4726,13-02-2021 10:00,24 hrs.,pennystocks,ACB,21,0,21,-21,1,2,13,1,NYSE
4726,13-02-2021 10:00,24 hrs.,pennystocks,AHT,6,0,6,-6,1,1,0,1,NYSE
4726,13-02-2021 10:00,24 hrs.,pennystocks,AMC,82,0,82,-82,5,14,34,5,NYSE
4726,13-02-2021 10:00,24 hrs.,pennystocks,ASX,24,0,24,-24,4,4,0,2,NYSE
4726,13-02-2021 10:00,24 hrs.,pennystocks,ATH,12,0,12,-12,1,3,2,1,NYSE
4726,13-02-2021 10:00,24 hrs.,pennystocks,AXL,6,6,0,6,1,0,2,1,NYSE
4726,13-02-2021 10:00,24 hrs.,pennystocks,BTU,6,0,6,-6,1,1,0,1,NYSE
4726,13-02-2021 10:00,24 hrs.,pennystocks,CBD,39,28,11,17,3,10,7,3,NYSE
4726,13-02-2021 10:00,24 hrs.,pennystocks,CHS,35,0,35,-35,1,11,9,1,NYSE
4726,13-02-2021 10:00,24 hrs.,pennystocks,BRPHF,44,0,44,-44,1,7,26,1,OTC
4726,13-02-2021 10:00,24 hrs.,pennystocks,BVNNF,7,0,7,-7,1,1,1,1,OTC
4726,13-02-2021 10:00,24 hrs.,pennystocks,CANSF,5,0,5,-5,1,0,1,1,OTC
4726,13-02-2021 10:00,24 hrs.,pennystocks,CBULF,6,0,6,-6,1,1,0,1,OTC
4726,13-02-2021 10:00,24 hrs.,pennystocks,CBWTF,13,0,13,-13,2,2,1,2,OTC
4726,13-02-2021 10:00,24 hrs.,pennystocks,CIOXY,7,0,7,-7,1,1,1,1,OTC
4726,13-02-2021 10:00,24 hrs.,pennystocks,CLUBQ,24,18,6,12,2,5,6,2,OTC
4726,13-02-2021 10:00,24 hrs.,pennystocks,CPHRF,6,6,0,6,1,1,0,1,OTC
4726,13-02-2021 10:00,24 hrs.,pennystocks,CRLBF,100,77,23,54,2,10,72,2,OTC
4726,13-02-2021 10:00,24 hrs.,pennystocks,CWGYF,6,0,6,-6,1,1,0,1,OTC
4726,13-02-2021 10:00,24 hrs.,pennystocks,CWSFF,6,0,6,-6,1,1,0,1,OTC
4726,13-02-2021 10:00,24 hrs.,pennystocks,DFODQ,22,0,22,-22,1,4,10,1,OTC
4726,13-02-2021 10:00,24 hrs.,pennystocks,DIGAF,7,7,0,7,1,1,1,1,OTC
4726,13-02-2021 10:00,24 hrs.,pennystocks,DMGGF,44,0,44,-44,1,7,26,1,OTC
4726,13-02-2021 10:00,24 hrs.,pennystocks,EHVVF,15,0,15,-15,1,0,11,1,OTC
4726,13-02-2021 10:00,24 hrs.,pennystocks,ELRRF,12,0,12,-12,2,2,0,2,OTC
4726,13-02-2021 10:00,24 hrs.,pennystocks,EMHTF,6,0,6,-6,1,1,0,1,OTC
4726,13-02-2021 10:00,24 hrs.,pennystocks,EPWCF,14,14,0,14,1,0,10,1,OTC
4726,13-02-2021 10:00,24 hrs.,pennystocks,ERPNF,33,33,0,33,1,12,5,1,OTC
4726,13-02-2021 10:00,24 hrs.,pennystocks,EVKIF,35,0,35,-35,1,11,9,1,OTC
4726,13-02-2021 10:00,24 hrs.,pennystocks,FLWPF,24,0,24,-24,1,5,10,1,OTC
4726,13-02-2021 10:00,24 hrs.,pennystocks,FUNFF,12,0,12,-12,1,3,2,1,OTC
4726,13-02-2021 10:00,24 hrs.,pennystocks,GLDFF,6,0,6,-6,1,1,0,1,OTC
4726,13-02-2021 10:00,24 hrs.,pennystocks,HITIF,2772,83,2689,-2606,12,1019,686,11,OTC
4726,13-02-2021 10:00,24 hrs.,pennystocks,HRVSF,6,0,6,-6,1,1,0,1,OTC
4726,13-02-2021 10:00,24 hrs.,pennystocks,IDXAF,6,0,6,-6,1,1,0,1,OTC
4726,13-02-2021 10:00,24 hrs.,pennystocks,INTEQ,6,0,6,-6,1,1,0,1,OTC
4726,13-02-2021 10:00,24 hrs.,pennystocks,KCCFF,26,0,26,-26,1,8,6,1,OTC
4726,13-02-2021 10:00,24 hrs.,pennystocks,LLKKF,24,0,24,-24,4,4,0,1,OTC
4726,13-02-2021 10:00,24 hrs.,pennystocks,LXXGF,94,0,94,-94,1,19,52,1,OTC
4726,13-02-2021 10:00,24 hrs.,pennystocks,MEDIF,6,0,6,-6,1,1,0,1,OTC
4726,13-02-2021 10:00,24 hrs.,pennystocks,MMEDF,31,0,31,-31,1,13,1,1,OTC
4726,13-02-2021 10:00,24 hrs.,pennystocks,MNXXF,59,0,59,-59,3,12,23,2,OTC
4726,13-02-2021 10:00,24 hrs.,pennystocks,NMGRF,12,6,6,0,2,2,0,2,OTC
4726,13-02-2021 10:00,24 hrs.,pennystocks,NOSUF,45,20,25,-5,2,11,15,2,OTC
4726,13-02-2021 10:00,24 hrs.,pennystocks,NXTTF,63,51,12,39,3,14,23,3,OTC
4726,13-02-2021 10:00,24 hrs.,pennystocks,OILFF,6,0,6,-6,1,1,0,1,OTC
4726,13-02-2021 10:00,24 hrs.,pennystocks,PFWIQ,98,0,98,-98,1,27,40,1,OTC
4726,13-02-2021 10:00,24 hrs.,pennystocks,PMNXF,6,0,6,-6,1,1,0,1,OTC
4726,13-02-2021 10:00,24 hrs.,pennystocks,QYOUF,6,0,6,-6,1,1,0,1,OTC
4726,13-02-2021 10:00,24 hrs.,pennystocks,RAZFF,7,0,7,-7,1,1,1,1,OTC
4726,13-02-2021 10:00,24 hrs.,pennystocks,RHDGF,9,0,9,-9,1,1,3,1,OTC
4726,13-02-2021 10:00,24 hrs.,pennystocks,RLFTF,6,0,6,-6,1,1,0,1,OTC
4726,13-02-2021 10:00,24 hrs.,pennystocks,RLLCF,67,0,67,-67,8,11,13,7,OTC
4726,13-02-2021 10:00,24 hrs.,pennystocks,RVVTF,7,0,7,-7,1,1,1,1,OTC
4726,13-02-2021 10:00,24 hrs.,pennystocks,SNNAF,14,0,14,-14,1,4,2,1,OTC
4726,13-02-2021 10:00,24 hrs.,pennystocks,SPFYF,9,0,9,-9,1,1,3,1,OTC
4726,13-02-2021 10:00,24 hrs.,pennystocks,SPMTF,22,0,22,-22,1,3,12,1,OTC
4726,13-02-2021 10:00,24 hrs.,pennystocks,SPRWF,72,0,72,-72,4,20,16,4,OTC
4726,13-02-2021 10:00,24 hrs.,pennystocks,TAKOF,42,0,42,-42,1,15,8,1,OTC
4726,13-02-2021 10:00,24 hrs.,pennystocks,TOBAF,27,27,0,27,1,5,13,1,OTC
4726,13-02-2021 10:00,24 hrs.,pennystocks,TSCRF,82,0,82,-82,3,23,24,3,OTC
4726,13-02-2021 10:00,24 hrs.,pennystocks,VRNDF,16,0,16,-16,1,4,4,1,OTC
4726,13-02-2021 10:00,24 hrs.,pennystocks,XELAW,202,0,202,-202,1,90,18,1,OTC
4726,13-02-2021 10:00,24 hrs.,pennystocks,ZBISF,63,0,63,-63,1,24,11,1,OTC
4726,13-02-2021 10:00,24 hrs.,pennystocks,AIM,8,0,8,-8,1,1,2,1,AMEX
4726,13-02-2021 10:00,24 hrs.,pennystocks,DNN,56,19,37,-18,9,9,2,8,AMEX
4726,13-02-2021 10:00,24 hrs.,pennystocks,DPW,6,6,0,6,1,1,0,1,AMEX
4726,13-02-2021 10:00,24 hrs.,pennystocks,DSS,30,0,30,-30,1,9,8,1,AMEX
4726,13-02-2021 10:00,24 hrs.,pennystocks,GSV,7,7,0,7,1,1,1,1,AMEX
4726,13-02-2021 10:00,24 hrs.,pennystocks,GTE,27,21,6,15,4,5,1,4,AMEX
4726,13-02-2021 10:00,24 hrs.,pennystocks,ITP,12,0,12,-12,1,0,8,1,AMEX
4726,13-02-2021 10:00,24 hrs.,pennystocks,MCF,6,0,6,-6,1,1,0,1,AMEX
4726,13-02-2021 10:00,24 hrs.,pennystocks,MXC,7,0,7,-7,1,1,1,1,AMEX
4726,13-02-2021 10:00,24 hrs.,pennystocks,PMCB,6,0,6,-6,1,1,0,1,OTC
4726,13-02-2021 10:00,24 hrs.,pennystocks,PPJE,6,0,6,-6,1,1,0,1,OTC
4726,13-02-2021 10:00,24 hrs.,pennystocks,PUGE,43,6,37,-31,2,13,9,2,OTC
4726,13-02-2021 10:00,24 hrs.,pennystocks,PURA,50,37,13,24,3,6,26,3,OTC
4726,13-02-2021 10:00,24 hrs.,pennystocks,PVDG,23,0,23,-23,1,1,17,1,OTC
4726,13-02-2021 10:00,24 hrs.,pennystocks,QOIL,7,0,7,-7,1,1,1,1,OTC
4726,13-02-2021 10:00,24 hrs.,pennystocks,RDGL,6,0,6,-6,1,1,0,1,OTC
4726,13-02-2021 10:00,24 hrs.,pennystocks,RELI,16,0,16,-16,1,0,12,1,OTC
4726,13-02-2021 10:00,24 hrs.,pennystocks,RGBP,21,0,21,-21,2,5,3,1,OTC
4726,13-02-2021 10:00,24 hrs.,pennystocks,RLBD,18,0,18,-18,1,5,4,1,OTC
4726,13-02-2021 10:00,24 hrs.,pennystocks,RMTD,6,0,6,-6,1,1,0,1,OTC
4726,13-02-2021 10:00,24 hrs.,pennystocks,RNVA,6,6,0,6,1,1,0,1,OTC
4726,13-02-2021 10:00,24 hrs.,pennystocks,RSHN,19,0,19,-19,1,2,11,1,OTC
4726,13-02-2021 10:00,24 hrs.,pennystocks,RSSV,306,0,306,-306,2,111,76,2,OTC
4726,13-02-2021 10:00,24 hrs.,pennystocks,RTON,13,0,13,-13,2,2,1,2,OTC
4726,13-02-2021 10:00,24 hrs.,pennystocks,SCIE,6,0,6,-6,1,1,0,1,OTC
4726,13-02-2021 10:00,24 hrs.,pennystocks,SCNA,6,6,0,6,1,1,0,1,OTC
4726,13-02-2021 10:00,24 hrs.,pennystocks,SFOR,15,0,15,-15,1,0,11,1,OTC
4726,13-02-2021 10:00,24 hrs.,pennystocks,SGMD,369,6,363,-357,10,117,95,10,OTC
4726,13-02-2021 10:00,24 hrs.,pennystocks,SHMP,6,0,6,-6,1,1,0,1,OTC
4726,13-02-2021 10:00,24 hrs.,pennystocks,SHWZ,7,0,7,-7,1,1,1,1,OTC
4726,13-02-2021 10:00,24 hrs.,pennystocks,SIML,104,0,104,-104,2,28,40,2,OTC
4726,13-02-2021 10:00,24 hrs.,pennystocks,SING,36,0,36,-36,2,6,16,2,OTC
4726,13-02-2021 10:00,24 hrs.,pennystocks,SNPW,80,51,29,22,4,25,14,4,OTC
4726,13-02-2021 10:00,24 hrs.,pennystocks,SNRS,14,0,14,-14,2,2,2,2,OTC
4726,13-02-2021 10:00,24 hrs.,pennystocks,SNWV,12,0,12,-12,2,2,0,1,OTC
4726,13-02-2021 10:00,24 hrs.,pennystocks,SNYR,6,0,6,-6,1,1,0,1,OTC
4726,13-02-2021 10:00,24 hrs.,pennystocks,SOBR,6,6,0,6,1,1,0,1,OTC
4726,13-02-2021 10:00,24 hrs.,pennystocks,SRMX,69,6,63,-57,6,18,9,6,OTC
4726,13-02-2021 10:00,24 hrs.,pennystocks,SRNA,6,0,6,-6,1,1,0,1,OTC
4726,13-02-2021 10:00,24 hrs.,pennystocks,SSFT,15,0,15,-15,1,0,11,1,OTC
4726,13-02-2021 10:00,24 hrs.,pennystocks,SSOK,15,0,15,-15,1,0,11,1,OTC
4726,13-02-2021 10:00,24 hrs.,pennystocks,STEV,12,0,12,-12,1,3,2,1,OTC
4726,13-02-2021 10:00,24 hrs.,pennystocks,STWC,30,30,0,30,1,10,6,1,OTC
4726,13-02-2021 10:00,24 hrs.,pennystocks,TAUG,6,6,0,6,1,1,0,1,OTC
4726,13-02-2021 10:00,24 hrs.,pennystocks,TCHH,7,0,7,-7,1,1,1,1,OTC
4726,13-02-2021 10:00,24 hrs.,pennystocks,TGHI,11,0,11,-11,1,2,3,1,OTC
4726,13-02-2021 10:00,24 hrs.,pennystocks,TLGN,65,0,65,-65,3,15,23,2,OTC
4726,13-02-2021 10:00,24 hrs.,pennystocks,TLSS,92,0,92,-92,2,28,28,2,OTC
4726,13-02-2021 10:00,24 hrs.,pennystocks,TPAC,5278,0,5278,-5278,1,2375,524,1,OTC
4726,13-02-2021 10:00,24 hrs.,pennystocks,TSNP,76,64,12,52,4,24,12,3,OTC
4726,13-02-2021 10:00,24 hrs.,pennystocks,TXTM,7,7,0,7,1,1,1,1,OTC
4726,13-02-2021 10:00,24 hrs.,pennystocks,USMJ,42,0,42,-42,2,9,16,2,OTC
4726,13-02-2021 10:00,24 hrs.,pennystocks,VFRM,6,0,6,-6,1,1,0,1,OTC
4726,13-02-2021 10:00,24 hrs.,pennystocks,VPER,57,57,0,57,1,8,37,1,OTC
4726,13-02-2021 10:00,24 hrs.,pennystocks,VPLM,6,0,6,-6,1,1,0,1,OTC
4726,13-02-2021 10:00,24 hrs.,pennystocks,VSPC,6,6,0,6,1,1,0,1,OTC
4726,13-02-2021 10:00,24 hrs.,pennystocks,VTLR,6,0,6,-6,1,1,0,1,OTC
4726,13-02-2021 10:00,24 hrs.,pennystocks,WCVC,98,0,98,-98,1,27,40,1,OTC
4726,13-02-2021 10:00,24 hrs.,pennystocks,WIZD,18,0,18,-18,1,5,4,1,OTC
4726,13-02-2021 10:00,24 hrs.,pennystocks,WTII,35,0,35,-35,1,10,11,1,OTC
4726,13-02-2021 10:00,24 hrs.,pennystocks,XFLS,6,6,0,6,1,1,0,1,OTC
4726,13-02-2021 10:00,24 hrs.,pennystocks,XLPI,175,175,0,175,1,77,17,1,OTC
4726,13-02-2021 10:00,24 hrs.,pennystocks,XMET,6,0,6,-6,1,1,0,1,OTC
4726,13-02-2021 10:00,24 hrs.,pennystocks,ZHUD,8,0,8,-8,1,1,2,1,OTC
4726,13-02-2021 10:00,24 hrs.,pennystocks,AGGHF,19,0,19,-19,1,4,7,1,OTC
4726,13-02-2021 10:00,24 hrs.,pennystocks,ARBKF,72,22,50,-28,3,13,34,3,OTC
4726,13-02-2021 10:00,24 hrs.,pennystocks,BDRBF,6,0,6,-6,1,1,0,1,OTC
4726,13-02-2021 10:00,24 hrs.,pennystocks,BFARF,9,9,0,9,1,0,5,1,OTC
4726,13-02-2021 10:00,24 hrs.,pennystocks,BKLLF,86,0,86,-86,1,27,28,1,OTC
4726,13-02-2021 10:00,24 hrs.,pennystocks,BNCHF,6,0,6,-6,1,1,0,1,OTC
4726,13-02-2021 10:00,24 hrs.,pennystocks,LBTI,6,6,0,6,1,1,0,1,OTC
4726,13-02-2021 10:00,24 hrs.,pennystocks,LITH,6,0,6,-6,1,1,0,1,OTC
4726,13-02-2021 10:00,24 hrs.,pennystocks,LQMT,6,0,6,-6,1,1,0,1,OTC
4726,13-02-2021 10:00,24 hrs.,pennystocks,LUVU,14,0,14,-14,2,3,0,2,OTC
4726,13-02-2021 10:00,24 hrs.,pennystocks,LVVV,41,41,0,41,1,9,19,1,OTC
4726,13-02-2021 10:00,24 hrs.,pennystocks,MAXD,77,16,61,-45,7,21,7,7,OTC
4726,13-02-2021 10:00,24 hrs.,pennystocks,MCOA,7,0,7,-7,1,1,1,1,OTC
4726,13-02-2021 10:00,24 hrs.,pennystocks,MDCN,13,0,13,-13,2,2,1,2,OTC
4726,13-02-2021 10:00,24 hrs.,pennystocks,MEDH,79,0,79,-79,1,18,39,1,OTC
4726,13-02-2021 10:00,24 hrs.,pennystocks,MGTI,24,0,24,-24,1,8,4,1,OTC
4726,13-02-2021 10:00,24 hrs.,pennystocks,MIHI,6,0,6,-6,1,1,0,1,OTC
4726,13-02-2021 10:00,24 hrs.,pennystocks,MINE,71,0,71,-71,6,11,25,5,OTC
4726,13-02-2021 10:00,24 hrs.,pennystocks,MJNA,25,0,25,-25,4,4,1,4,OTC
4726,13-02-2021 10:00,24 hrs.,pennystocks,MJTV,7,0,7,-7,1,1,1,1,OTC
4726,13-02-2021 10:00,24 hrs.,pennystocks,MKTY,7,0,7,-7,1,1,1,1,OTC
4726,13-02-2021 10:00,24 hrs.,pennystocks,MLFB,157,0,157,-157,3,48,49,3,OTC
4726,13-02-2021 10:00,24 hrs.,pennystocks,MMEX,137,0,137,-137,3,24,77,2,OTC
4726,13-02-2021 10:00,24 hrs.,pennystocks,MOJO,12,0,12,-12,2,2,0,1,OTC
4726,13-02-2021 10:00,24 hrs.,pennystocks,MRMD,6,6,0,6,1,0,2,1,OTC
4726,13-02-2021 10:00,24 hrs.,pennystocks,MTVX,6,0,6,-6,1,1,0,1,OTC
4726,13-02-2021 10:00,24 hrs.,pennystocks,NBVG,7,0,7,-7,1,1,1,1,OTC
4726,13-02-2021 10:00,24 hrs.,pennystocks,NOVC,56,0,56,-56,2,17,14,2,OTC
4726,13-02-2021 10:00,24 hrs.,pennystocks,NSAV,13,0,13,-13,2,2,1,2,OTC
4726,13-02-2021 10:00,24 hrs.,pennystocks,NSPT,23,17,6,11,2,5,5,2,OTC
4726,13-02-2021 10:00,24 hrs.,pennystocks,NUGS,7,7,0,7,1,1,1,1,OTC
4726,13-02-2021 10:00,24 hrs.,pennystocks,OZSC,108,108,0,108,3,26,44,3,OTC
4726,13-02-2021 10:00,24 hrs.,pennystocks,PAOG,7,0,7,-7,1,1,1,1,OTC
4726,13-02-2021 10:00,24 hrs.,pennystocks,PDXP,7,0,7,-7,1,1,1,1,OTC
4726,13-02-2021 10:00,24 hrs.,pennystocks,PHIL,6,0,6,-6,1,1,0,1,OTC
4726,13-02-2021 10:00,24 hrs.,pennystocks,EWKS,7,0,7,-7,1,1,1,1,OTC
4726,13-02-2021 10:00,24 hrs.,pennystocks,FBEC,6,0,6,-6,1,1,0,1,OTC
4726,13-02-2021 10:00,24 hrs.,pennystocks,FLXT,6,0,6,-6,1,1,0,1,OTC
4726,13-02-2021 10:00,24 hrs.,pennystocks,FTEG,6,6,0,6,1,1,0,1,OTC
4726,13-02-2021 10:00,24 hrs.,pennystocks,FUST,7,0,7,-7,1,1,1,1,OTC
4726,13-02-2021 10:00,24 hrs.,pennystocks,GAXY,119,119,0,119,1,46,23,1,OTC
4726,13-02-2021 10:00,24 hrs.,pennystocks,GBTC,44,0,44,-44,1,7,26,1,OTC
4726,13-02-2021 10:00,24 hrs.,pennystocks,GHMP,44,0,44,-44,3,7,18,2,OTC
4726,13-02-2021 10:00,24 hrs.,pennystocks,GLCO,6,0,6,-6,1,1,0,1,OTC
4726,13-02-2021 10:00,24 hrs.,pennystocks,GLEC,6,0,6,-6,1,1,0,1,OTC
4726,13-02-2021 10:00,24 hrs.,pennystocks,GPFT,12,12,0,12,1,3,2,1,OTC
4726,13-02-2021 10:00,24 hrs.,pennystocks,GRCU,11,0,11,-11,1,1,5,1,OTC
4726,13-02-2021 10:00,24 hrs.,pennystocks,GRCV,7,7,0,7,1,1,1,1,OTC
4726,13-02-2021 10:00,24 hrs.,pennystocks,GRST,105,0,105,-105,2,32,33,1,OTC
4726,13-02-2021 10:00,24 hrs.,pennystocks,GTBP,17,0,17,-17,1,1,11,1,OTC
4726,13-02-2021 10:00,24 hrs.,pennystocks,GTEH,47,47,0,47,1,11,21,1,OTC
4726,13-02-2021 10:00,24 hrs.,pennystocks,GTLL,81,6,75,-69,4,27,11,4,OTC
4726,13-02-2021 10:00,24 hrs.,pennystocks,HALB,29,0,29,-29,2,7,7,1,OTC
4726,13-02-2021 10:00,24 hrs.,pennystocks,HCMC,121,37,84,-47,19,19,7,17,OTC
4726,13-02-2021 10:00,24 hrs.,pennystocks,HEMP,7,0,7,-7,1,1,1,1,OTC
4726,13-02-2021 10:00,24 hrs.,pennystocks,HENC,13,13,0,13,1,2,5,1,OTC
4726,13-02-2021 10:00,24 hrs.,pennystocks,HIPH,14,8,6,2,2,2,2,2,OTC
4726,13-02-2021 10:00,24 hrs.,pennystocks,HMMR,7,0,7,-7,1,1,1,1,OTC
4726,13-02-2021 10:00,24 hrs.,pennystocks,HMNY,6,0,6,-6,1,1,0,1,OTC
4726,13-02-2021 10:00,24 hrs.,pennystocks,HPTY,50,0,50,-50,1,16,14,1,OTC
4726,13-02-2021 10:00,24 hrs.,pennystocks,HYSR,6,0,6,-6,1,1,0,1,OTC
4726,13-02-2021 10:00,24 hrs.,pennystocks,ICBU,6,0,6,-6,1,1,0,1,OTC
4726,13-02-2021 10:00,24 hrs.,pennystocks,ICLD,6,0,6,-6,1,1,0,1,OTC
4726,13-02-2021 10:00,24 hrs.,pennystocks,ICNM,15,0,15,-15,1,3,5,1,OTC
4726,13-02-2021 10:00,24 hrs.,pennystocks,IMJX,98,0,98,-98,1,27,40,1,OTC
4726,13-02-2021 10:00,24 hrs.,pennystocks,IMTL,6,0,6,-6,1,1,0,1,OTC
4726,13-02-2021 10:00,24 hrs.,pennystocks,INKW,56,6,50,-44,9,9,2,7,OTC
4726,13-02-2021 10:00,24 hrs.,pennystocks,INND,209,45,164,-119,6,47,91,6,OTC
4726,13-02-2021 10:00,24 hrs.,pennystocks,INTV,19,7,12,-5,3,3,1,3,OTC
4726,13-02-2021 10:00,24 hrs.,pennystocks,IPIX,6,0,6,-6,1,1,0,1,OTC
4726,13-02-2021 10:00,24 hrs.,pennystocks,IPSI,20,0,20,-20,1,6,4,1,OTC
4726,13-02-2021 10:00,24 hrs.,pennystocks,IQST,18,0,18,-18,3,3,0,2,OTC
4726,13-02-2021 10:00,24 hrs.,pennystocks,ISBL,7,7,0,7,1,1,1,1,OTC
4726,13-02-2021 10:00,24 hrs.,pennystocks,ITCJ,7,0,7,-7,1,1,1,1,OTC
4726,13-02-2021 10:00,24 hrs.,pennystocks,JSDA,6,0,6,-6,1,1,0,1,OTC
4726,13-02-2021 10:00,24 hrs.,pennystocks,KWBT,13,6,7,-1,2,2,1,2,OTC
4726,13-02-2021 10:00,24 hrs.,pennystocks,KYNC,6,0,6,-6,1,1,0,1,OTC
4726,13-02-2021 10:00,24 hrs.,pennystocks,BFRE,16,0,16,-16,1,0,12,1,OTC
4726,13-02-2021 10:00,24 hrs.,pennystocks,BGMD,6,0,6,-6,1,1,0,1,OTC
4726,13-02-2021 10:00,24 hrs.,pennystocks,BIEL,117,0,117,-117,4,30,41,3,OTC
4726,13-02-2021 10:00,24 hrs.,pennystocks,BLDV,77,0,77,-77,1,26,21,1,OTC
4726,13-02-2021 10:00,24 hrs.,pennystocks,BLSP,6,0,6,-6,1,1,0,1,OTC
4726,13-02-2021 10:00,24 hrs.,pennystocks,BMCS,11,0,11,-11,1,2,3,1,OTC
4726,13-02-2021 10:00,24 hrs.,pennystocks,BMIX,6,0,6,-6,1,1,0,1,OTC
4726,13-02-2021 10:00,24 hrs.,pennystocks,BMMJ,6,6,0,6,1,1,0,1,OTC
4726,13-02-2021 10:00,24 hrs.,pennystocks,BONZ,6,0,6,-6,1,0,2,1,OTC
4726,13-02-2021 10:00,24 hrs.,pennystocks,BOTY,6,6,0,6,1,1,0,1,OTC
4726,13-02-2021 10:00,24 hrs.,pennystocks,BRLL,46,0,46,-46,2,3,32,2,OTC
4726,13-02-2021 10:00,24 hrs.,pennystocks,BRTX,12,0,12,-12,2,2,0,2,OTC
4726,13-02-2021 10:00,24 hrs.,pennystocks,BRZL,6,0,6,-6,1,1,0,1,OTC
4726,13-02-2021 10:00,24 hrs.,pennystocks,BTZI,6,6,0,6,1,1,0,1,OTC
4726,13-02-2021 10:00,24 hrs.,pennystocks,BUDZ,24,0,24,-24,3,4,4,3,OTC
4726,13-02-2021 10:00,24 hrs.,pennystocks,BWMG,57,0,57,-57,2,14,21,2,OTC
4726,13-02-2021 10:00,24 hrs.,pennystocks,BZWR,15,0,15,-15,1,0,11,1,OTC
4726,13-02-2021 10:00,24 hrs.,pennystocks,CAFS,7,7,0,7,1,1,1,1,OTC
4726,13-02-2021 10:00,24 hrs.,pennystocks,CANN,6,0,6,-6,1,1,0,1,OTC
4726,13-02-2021 10:00,24 hrs.,pennystocks,CAPC,7,0,7,-7,1,1,1,1,OTC
4726,13-02-2021 10:00,24 hrs.,pennystocks,CATV,133,0,133,-133,1,57,15,1,OTC
4726,13-02-2021 10:00,24 hrs.,pennystocks,CAVR,6,0,6,-6,1,1,0,1,OTC
4726,13-02-2021 10:00,24 hrs.,pennystocks,CBBT,398,0,398,-398,3,159,68,3,OTC
4726,13-02-2021 10:00,24 hrs.,pennystocks,CBDL,289,0,289,-289,4,90,93,4,OTC
4726,13-02-2021 10:00,24 hrs.,pennystocks,CCTL,23,0,23,-23,1,8,3,1,OTC
4726,13-02-2021 10:00,24 hrs.,pennystocks,CELZ,13,6,7,-1,2,2,1,2,OTC
4726,13-02-2021 10:00,24 hrs.,pennystocks,CHNC,22,0,22,-22,1,5,8,1,OTC
4726,13-02-2021 10:00,24 hrs.,pennystocks,CLWD,6,0,6,-6,1,1,0,1,OTC
4726,13-02-2021 10:00,24 hrs.,pennystocks,CNNA,77,77,0,77,1,8,57,1,OTC
4726,13-02-2021 10:00,24 hrs.,pennystocks,COMS,13,13,0,13,2,2,1,1,OTC
4726,13-02-2021 10:00,24 hrs.,pennystocks,CORG,37,0,37,-37,3,3,19,3,OTC
4726,13-02-2021 10:00,24 hrs.,pennystocks,CRTG,35,0,35,-35,1,11,9,1,OTC
4726,13-02-2021 10:00,24 hrs.,pennystocks,CRWG,6,0,6,-6,1,1,0,1,OTC
4726,13-02-2021 10:00,24 hrs.,pennystocks,CSLI,48,0,48,-48,1,14,16,1,OTC
4726,13-02-2021 10:00,24 hrs.,pennystocks,CTLE,18,12,6,6,3,3,0,3,OTC
4726,13-02-2021 10:00,24 hrs.,pennystocks,CYDY,7,0,7,-7,1,1,1,1,OTC
4726,13-02-2021 10:00,24 hrs.,pennystocks,DMAN,17,0,17,-17,1,4,5,1,OTC
4726,13-02-2021 10:00,24 hrs.,pennystocks,DPLS,180,62,118,-56,7,60,32,5,OTC
4726,13-02-2021 10:00,24 hrs.,pennystocks,DSGT,6,6,0,6,1,1,0,1,OTC
4726,13-02-2021 10:00,24 hrs.,pennystocks,EAWD,6,6,0,6,1,1,0,1,OTC
4726,13-02-2021 10:00,24 hrs.,pennystocks,ECEZ,7,7,0,7,1,1,1,1,OTC
4726,13-02-2021 10:00,24 hrs.,pennystocks,EHOS,41,41,0,41,1,9,19,1,OTC
4726,13-02-2021 10:00,24 hrs.,pennystocks,ELTP,14,0,14,-14,1,3,4,1,OTC
4726,13-02-2021 10:00,24 hrs.,pennystocks,ENRT,6,0,6,-6,1,1,0,1,OTC
4726,13-02-2021 10:00,24 hrs.,pennystocks,ENZC,12,0,12,-12,2,2,0,2,OTC
4726,13-02-2021 10:00,24 hrs.,pennystocks,ERBB,26,14,12,2,2,1,16,2,OTC
4726,13-02-2021 10:00,24 hrs.,pennystocks,ETFM,206,6,200,-194,4,67,56,3,OTC
4726,13-02-2021 10:00,24 hrs.,pennystocks,ETHE,44,0,44,-44,1,7,26,1,OTC
4726,13-02-2021 10:00,24 hrs.,pennystocks,ALPP,379,0,379,-379,6,125,105,5,OTC
4726,13-02-2021 10:00,24 hrs.,pennystocks,ALST,26,0,26,-26,2,3,12,1,OTC
4726,13-02-2021 10:00,24 hrs.,pennystocks,ALYI,42,0,42,-42,3,11,8,3,OTC
4726,13-02-2021 10:00,24 hrs.,pennystocks,ANDI,7,0,7,-7,1,1,1,1,OTC
4726,13-02-2021 10:00,24 hrs.,pennystocks,APPZ,7,0,7,-7,1,1,1,1,OTC
4726,13-02-2021 10:00,24 hrs.,pennystocks,ASCK,6,0,6,-6,1,1,0,1,OTC
4726,13-02-2021 10:00,24 hrs.,pennystocks,ASTI,18,0,18,-18,3,3,0,3,OTC
4726,13-02-2021 10:00,24 hrs.,pennystocks,ATDS,6,0,6,-6,1,1,0,1,OTC
4726,13-02-2021 10:00,24 hrs.,pennystocks,ATNP,31,0,31,-31,1,5,17,1,OTC
4726,13-02-2021 10:00,24 hrs.,pennystocks,AXXA,29,0,29,-29,1,10,5,1,OTC
4726,13-02-2021 10:00,24 hrs.,pennystocks,AZFL,40,0,40,-40,1,6,24,1,OTC
4726,13-02-2021 10:00,24 hrs.,pennystocks,BANT,6,0,6,-6,1,1,0,1,OTC
4726,13-02-2021 10:00,24 hrs.,pennystocks,BBRW,172,0,172,-172,4,39,78,4,OTC
4726,13-02-2021 10:00,24 hrs.,pennystocks,BDGR,6,0,6,-6,1,1,0,1,OTC
4726,13-02-2021 10:00,24 hrs.,StockMarket,VFF,18,18,0,18,1,5,4,1,NASDAQ
4726,13-02-2021 10:00,24 hrs.,StockMarket,AAPL,27,27,0,27,1,5,13,1,NASDAQ
4726,13-02-2021 10:00,24 hrs.,StockMarket,AMAT,50,50,0,50,1,22,2,1,NASDAQ
4726,13-02-2021 10:00,24 hrs.,StockMarket,AMZN,50,50,0,50,1,22,2,1,NASDAQ
4726,13-02-2021 10:00,24 hrs.,StockMarket,APHA,6,0,6,-6,1,1,0,1,NASDAQ
4726,13-02-2021 10:00,24 hrs.,StockMarket,ARTL,87,0,87,-87,1,22,39,1,NASDAQ
4726,13-02-2021 10:00,24 hrs.,StockMarket,ATHX,6,0,6,-6,1,1,0,1,NASDAQ
4726,13-02-2021 10:00,24 hrs.,StockMarket,ATOS,14,0,14,-14,1,5,0,1,NASDAQ
4726,13-02-2021 10:00,24 hrs.,StockMarket,AVGO,7,0,7,-7,1,1,1,1,NASDAQ
4726,13-02-2021 10:00,24 hrs.,StockMarket,BBBY,6,0,6,-6,1,1,0,1,NASDAQ
4726,13-02-2021 10:00,24 hrs.,StockMarket,BPTH,6,0,6,-6,1,1,0,1,NASDAQ
4726,13-02-2021 10:00,24 hrs.,StockMarket,BSQR,9,9,0,9,1,1,3,1,NASDAQ
4726,13-02-2021 10:00,24 hrs.,StockMarket,BYND,6,0,6,-6,1,1,0,1,NASDAQ
4726,13-02-2021 10:00,24 hrs.,StockMarket,CLEU,101,0,101,-101,2,22,49,2,NASDAQ
4726,13-02-2021 10:00,24 hrs.,StockMarket,COHR,11,0,11,-11,1,2,3,1,NASDAQ
4726,13-02-2021 10:00,24 hrs.,StockMarket,CPLP,20,0,20,-20,3,4,0,2,NASDAQ
4726,13-02-2021 10:00,24 hrs.,StockMarket,CRSR,27,27,0,27,1,5,13,1,NASDAQ
4726,13-02-2021 10:00,24 hrs.,StockMarket,CTRM,6,6,0,6,1,1,0,1,NASDAQ
4726,13-02-2021 10:00,24 hrs.,StockMarket,CWCO,12,0,12,-12,2,2,0,1,NASDAQ
4726,13-02-2021 10:00,24 hrs.,StockMarket,DDOG,61,50,11,39,2,24,5,2,NASDAQ
4726,13-02-2021 10:00,24 hrs.,StockMarket,EXPE,11,0,11,-11,1,2,3,1,NASDAQ
4726,13-02-2021 10:00,24 hrs.,StockMarket,FROG,50,50,0,50,1,22,2,1,NASDAQ
4726,13-02-2021 10:00,24 hrs.,StockMarket,GBIO,7,0,7,-7,1,1,1,1,NASDAQ
4726,13-02-2021 10:00,24 hrs.,StockMarket,GTHX,54,54,0,54,1,13,24,1,NASDAQ
4726,13-02-2021 10:00,24 hrs.,StockMarket,HTBX,92,0,92,-92,2,26,32,2,NASDAQ
4726,13-02-2021 10:00,24 hrs.,StockMarket,IDEX,6,0,6,-6,1,1,0,1,NASDAQ
4726,13-02-2021 10:00,24 hrs.,StockMarket,IIVI,11,0,11,-11,1,2,3,1,NASDAQ
4726,13-02-2021 10:00,24 hrs.,StockMarket,INPX,6,0,6,-6,1,1,0,1,NASDAQ
4726,13-02-2021 10:00,24 hrs.,StockMarket,INTZ,4,0,4,-4,1,0,0,1,NASDAQ
4726,13-02-2021 10:00,24 hrs.,StockMarket,LITE,11,0,11,-11,1,2,3,1,NASDAQ
4726,13-02-2021 10:00,24 hrs.,StockMarket,LIVE,11,0,11,-11,1,2,3,1,NASDAQ
4726,13-02-2021 10:00,24 hrs.,StockMarket,LLNW,25,0,25,-25,4,4,1,1,NASDAQ
4726,13-02-2021 10:00,24 hrs.,StockMarket,MKSI,11,0,11,-11,1,2,3,1,NASDAQ
4726,13-02-2021 10:00,24 hrs.,StockMarket,MSFT,27,27,0,27,1,5,13,1,NASDAQ
4726,13-02-2021 10:00,24 hrs.,StockMarket,MTCH,7,0,7,-7,1,0,3,1,NASDAQ
4726,13-02-2021 10:00,24 hrs.,StockMarket,OCGN,26,0,26,-26,3,2,10,3,NASDAQ
4726,13-02-2021 10:00,24 hrs.,StockMarket,PTON,27,27,0,27,1,5,13,1,NASDAQ
4726,13-02-2021 10:00,24 hrs.,StockMarket,RARE,50,50,0,50,1,22,2,1,NASDAQ
4726,13-02-2021 10:00,24 hrs.,StockMarket,RBBN,6,0,6,-6,1,1,0,1,NASDAQ
4726,13-02-2021 10:00,24 hrs.,StockMarket,REAL,34,0,34,-34,1,0,30,1,NASDAQ
4726,13-02-2021 10:00,24 hrs.,StockMarket,RIDE,17,0,17,-17,2,3,3,2,NASDAQ
4726,13-02-2021 10:00,24 hrs.,StockMarket,SBUX,27,27,0,27,1,5,13,1,NASDAQ
4726,13-02-2021 10:00,24 hrs.,StockMarket,SESN,36,36,0,36,2,12,4,1,NASDAQ
4726,13-02-2021 10:00,24 hrs.,StockMarket,SNDL,143,131,12,119,4,31,65,4,NASDAQ
4726,13-02-2021 10:00,24 hrs.,StockMarket,SPSC,50,50,0,50,1,22,2,1,NASDAQ
4726,13-02-2021 10:00,24 hrs.,StockMarket,SRAC,8,0,8,-8,1,0,4,1,NASDAQ
4726,13-02-2021 10:00,24 hrs.,StockMarket,SVMK,11,0,11,-11,1,2,3,1,NASDAQ
4726,13-02-2021 10:00,24 hrs.,StockMarket,TLRY,58,0,58,-58,6,11,12,6,NASDAQ
4726,13-02-2021 10:00,24 hrs.,StockMarket,TNXP,6,0,6,-6,1,1,0,1,NASDAQ
4726,13-02-2021 10:00,24 hrs.,StockMarket,TRVG,6,0,6,-6,1,1,0,1,NASDAQ
4726,13-02-2021 10:00,24 hrs.,StockMarket,TSLA,1830,1824,6,1818,2,879,64,2,NASDAQ
4726,13-02-2021 10:00,24 hrs.,StockMarket,VITL,55,49,6,43,2,22,3,2,NASDAQ
4726,13-02-2021 10:00,24 hrs.,StockMarket,VRSN,11,0,11,-11,1,2,3,1,NASDAQ
4726,13-02-2021 10:00,24 hrs.,StockMarket,VUZI,6,6,0,6,1,1,0,1,NASDAQ
4726,13-02-2021 10:00,24 hrs.,StockMarket,VXRT,6,6,0,6,1,1,0,1,NASDAQ
4726,13-02-2021 10:00,24 hrs.,StockMarket,WAFU,87,0,87,-87,1,22,39,1,NASDAQ
4726,13-02-2021 10:00,24 hrs.,StockMarket,ZIOP,6,0,6,-6,1,1,0,1,NASDAQ
4726,13-02-2021 10:00,24 hrs.,StockMarket,SRACU,8,0,8,-8,1,0,4,1,NASDAQ
4726,13-02-2021 10:00,24 hrs.,StockMarket,SRACW,8,0,8,-8,1,0,4,1,NASDAQ
4726,13-02-2021 10:00,24 hrs.,pennystocks,ABML,162,33,129,-96,3,51,48,3,OTC
4726,13-02-2021 10:00,24 hrs.,pennystocks,ADTM,13,0,13,-13,2,2,1,1,OTC
4726,13-02-2021 10:00,24 hrs.,pennystocks,AFPW,6,0,6,-6,1,1,0,1,OTC
4726,13-02-2021 10:00,24 hrs.,pennystocks,AITX,336,0,336,-336,3,122,80,3,OTC
4726,13-02-2021 10:00,24 hrs.,pennystocks,ALKM,7,0,7,-7,1,1,1,1,OTC
4726,13-02-2021 10:00,24 hrs.,StockMarket,AZN,11,0,11,-11,1,2,3,1,NASDAQ
4726,13-02-2021 10:00,24 hrs.,StockMarket,CDC,11,0,11,-11,1,2,3,1,NASDAQ
4726,13-02-2021 10:00,24 hrs.,StockMarket,INO,11,0,11,-11,1,2,3,1,NASDAQ
4726,13-02-2021 10:00,24 hrs.,StockMarket,JFU,86,0,86,-86,1,25,32,1,NASDAQ
4726,13-02-2021 10:00,24 hrs.,StockMarket,NWL,11,0,11,-11,1,2,3,1,NASDAQ
4726,13-02-2021 10:00,24 hrs.,StockMarket,OGI,10,0,10,-10,2,1,0,2,NASDAQ
4726,13-02-2021 10:00,24 hrs.,StockMarket,OPK,6,0,6,-6,1,1,0,1,NASDAQ
4726,13-02-2021 10:00,24 hrs.,StockMarket,QQQ,88,88,0,88,3,30,16,3,NASDAQ
4726,13-02-2021 10:00,24 hrs.,StockMarket,SFT,6,0,6,-6,1,1,0,1,NASDAQ
4726,13-02-2021 10:00,24 hrs.,wallstreetbets,DAO,12,0,12,-12,2,2,0,1,NYSE
4726,13-02-2021 10:00,24 hrs.,wallstreetbets,DHT,7,0,7,-7,1,1,1,1,NYSE
4726,13-02-2021 10:00,24 hrs.,wallstreetbets,DIS,456,0,456,-456,5,179,78,5,NYSE
4726,13-02-2021 10:00,24 hrs.,wallstreetbets,DTE,169,0,169,-169,1,54,57,1,NYSE
4726,13-02-2021 10:00,24 hrs.,wallstreetbets,DVN,7,0,7,-7,1,1,1,1,NYSE
4726,13-02-2021 10:00,24 hrs.,wallstreetbets,EAT,14,0,14,-14,2,2,2,2,NYSE
4726,13-02-2021 10:00,24 hrs.,wallstreetbets,EPD,47,0,47,-47,2,12,15,1,NYSE
4726,13-02-2021 10:00,24 hrs.,wallstreetbets,ETN,21,7,14,-7,3,3,3,3,NYSE
4726,13-02-2021 10:00,24 hrs.,wallstreetbets,EXP,13,0,13,-13,2,2,1,2,NYSE
4726,13-02-2021 10:00,24 hrs.,wallstreetbets,DIT,6,0,6,-6,1,1,0,1,AMEX
4726,13-02-2021 10:00,24 hrs.,wallstreetbets,DNN,206,62,144,-82,30,30,26,23,AMEX
4726,13-02-2021 10:00,24 hrs.,wallstreetbets,DPW,14,0,14,-14,2,2,2,2,AMEX
4726,13-02-2021 10:00,24 hrs.,wallstreetbets,GDP,185,0,185,-185,2,54,69,2,AMEX
4726,13-02-2021 10:00,24 hrs.,wallstreetbets,GTE,73,26,47,-21,11,11,7,8,AMEX
4726,13-02-2021 10:00,24 hrs.,wallstreetbets,ITP,7,0,7,-7,1,1,1,1,AMEX
4726,13-02-2021 10:00,24 hrs.,wallstreetbets,MSN,7,0,7,-7,1,1,1,1,AMEX
4726,13-02-2021 10:00,24 hrs.,wallstreetbets,MXC,14,0,14,-14,2,2,2,2,AMEX
4726,13-02-2021 10:00,24 hrs.,wallstreetbets,MYO,7,0,7,-7,1,1,1,1,AMEX
4726,13-02-2021 10:00,24 hrs.,wallstreetbets,NAK,57,7,50,-43,9,9,3,8,AMEX
4726,13-02-2021 10:00,24 hrs.,wallstreetbets,PTN,7,0,7,-7,1,1,1,1,AMEX
4726,13-02-2021 10:00,24 hrs.,wallstreetbets,REI,7,0,7,-7,1,1,1,1,AMEX
4726,13-02-2021 10:00,24 hrs.,wallstreetbets,SYN,14,0,14,-14,2,2,2,1,AMEX
4726,13-02-2021 10:00,24 hrs.,wallstreetbets,TGB,6,0,6,-6,1,1,0,1,AMEX
4726,13-02-2021 10:00,24 hrs.,wallstreetbets,TRX,49,14,35,-21,7,7,7,5,AMEX
4726,13-02-2021 10:00,24 hrs.,wallstreetbets,UUU,6,0,6,-6,1,1,0,1,AMEX
4726,13-02-2021 10:00,24 hrs.,wallstreetbets,ZOM,257,33,224,-191,20,64,49,19,AMEX
4726,13-02-2021 10:00,24 hrs.,wallstreetbets,AMPE,41,0,41,-41,6,6,5,4,AMEX
4726,13-02-2021 10:00,24 hrs.,wallstreetbets,CRMD,7,0,7,-7,1,1,1,1,AMEX
4726,13-02-2021 10:00,24 hrs.,wallstreetbets,EMAN,7,0,7,-7,1,1,1,1,AMEX
4726,13-02-2021 10:00,24 hrs.,wallstreetbets,GOED,13,0,13,-13,2,2,1,2,AMEX
4726,13-02-2021 10:00,24 hrs.,wallstreetbets,GSAT,33,13,20,-7,5,5,3,4,AMEX
4726,13-02-2021 10:00,24 hrs.,wallstreetbets,HUSA,7,0,7,-7,1,1,1,1,AMEX
4726,13-02-2021 10:00,24 hrs.,wallstreetbets,LODE,13,0,13,-13,2,2,1,2,AMEX
4726,13-02-2021 10:00,24 hrs.,wallstreetbets,OGEN,20,0,20,-20,3,3,2,3,AMEX
4726,13-02-2021 10:00,24 hrs.,wallstreetbets,SENS,476,258,218,40,17,127,154,13,AMEX
4726,13-02-2021 10:00,24 hrs.,wallstreetbets,TMBR,41,34,7,27,6,6,5,2,AMEX
4726,13-02-2021 10:00,24 hrs.,wallstreetbets,TRXC,19,0,19,-19,3,3,1,3,AMEX
4726,13-02-2021 10:00,24 hrs.,wallstreetbets,UAVS,34,13,21,-8,5,5,4,3,AMEX
4726,13-02-2021 10:00,24 hrs.,wallstreetbets,UUUU,21,0,21,-21,3,3,3,2,AMEX
4726,13-02-2021 10:00,24 hrs.,wallstreetbets,XXII,7,7,0,7,1,1,1,1,AMEX
4726,13-02-2021 10:00,24 hrs.,wallstreetbets,YCBD,14,7,7,0,2,2,2,2,AMEX
4726,13-02-2021 10:00,24 hrs.,wallstreetbets,ABT,13,0,13,-13,2,2,1,2,NYSE
4726,13-02-2021 10:00,24 hrs.,wallstreetbets,ACB,166,35,131,-96,24,24,22,20,NYSE
4726,13-02-2021 10:00,24 hrs.,wallstreetbets,ACI,7,0,7,-7,1,1,1,1,NYSE
4726,13-02-2021 10:00,24 hrs.,wallstreetbets,AEM,8,0,8,-8,1,1,2,1,NYSE
4726,13-02-2021 10:00,24 hrs.,wallstreetbets,AFC,7,0,7,-7,1,1,1,1,NYSE
4726,13-02-2021 10:00,24 hrs.,wallstreetbets,AIR,6,0,6,-6,1,1,0,1,NYSE
4726,13-02-2021 10:00,24 hrs.,wallstreetbets,AIV,6,0,6,-6,1,1,0,1,NYSE
4726,13-02-2021 10:00,24 hrs.,wallstreetbets,AMC,7009,1987,5022,-3035,184,2635,1003,154,NYSE
4726,13-02-2021 10:00,24 hrs.,wallstreetbets,AMP,29,8,21,-13,4,4,5,4,NYSE
4726,13-02-2021 10:00,24 hrs.,wallstreetbets,ASX,7,0,7,-7,1,1,1,1,NYSE
4726,13-02-2021 10:00,24 hrs.,wallstreetbets,ATH,41,13,28,-15,5,8,5,5,NYSE
4726,13-02-2021 10:00,24 hrs.,wallstreetbets,AUY,131,0,131,-131,9,25,45,4,NYSE
4726,13-02-2021 10:00,24 hrs.,wallstreetbets,AXP,6002,0,6002,-6002,2,2825,344,1,NYSE
4726,13-02-2021 10:00,24 hrs.,wallstreetbets,BBW,6,0,6,-6,1,1,0,1,NYSE
4726,13-02-2021 10:00,24 hrs.,wallstreetbets,BCH,11,4,7,-3,2,1,1,2,NYSE
4726,13-02-2021 10:00,24 hrs.,wallstreetbets,BGS,8,0,8,-8,1,1,2,1,NYSE
4726,13-02-2021 10:00,24 hrs.,wallstreetbets,BHC,436,0,436,-436,2,176,76,2,NYSE
4726,13-02-2021 10:00,24 hrs.,wallstreetbets,BTT,40,21,19,2,6,6,4,6,NYSE
4726,13-02-2021 10:00,24 hrs.,wallstreetbets,BTU,14,0,14,-14,2,2,2,1,NYSE
4726,13-02-2021 10:00,24 hrs.,wallstreetbets,BYD,7,7,0,7,1,1,1,1,NYSE
4726,13-02-2021 10:00,24 hrs.,wallstreetbets,CAT,14,7,7,0,2,2,2,2,NYSE
4726,13-02-2021 10:00,24 hrs.,wallstreetbets,CBD,7,0,7,-7,1,1,1,1,NYSE
4726,13-02-2021 10:00,24 hrs.,wallstreetbets,CCL,20,6,14,-8,3,3,2,2,NYSE
4726,13-02-2021 10:00,24 hrs.,wallstreetbets,CMA,6,6,0,6,1,1,0,1,NYSE
4726,13-02-2021 10:00,24 hrs.,wallstreetbets,CMC,15,0,15,-15,1,1,9,1,NYSE
4726,13-02-2021 10:00,24 hrs.,wallstreetbets,CPE,7,0,7,-7,1,1,1,1,NYSE
4726,13-02-2021 10:00,24 hrs.,wallstreetbets,CPG,7,0,7,-7,1,1,1,1,NYSE
4726,13-02-2021 10:00,24 hrs.,wallstreetbets,CPS,6,6,0,6,1,1,0,1,NYSE
4726,13-02-2021 10:00,24 hrs.,wallstreetbets,CSV,231,231,0,231,1,61,105,1,NYSE
4726,13-02-2021 10:00,24 hrs.,wallstreetbets,CVS,14,14,0,14,2,2,2,2,NYSE
4726,13-02-2021 10:00,24 hrs.,wallstreetbets,DAC,20,0,20,-20,3,3,2,2,NYSE
4726,13-02-2021 10:00,24 hrs.,wallstreetbets,DAL,13,0,13,-13,2,2,1,2,NYSE
4726,13-02-2021 10:00,24 hrs.,StockMarket,ZBISF,34,0,34,-34,1,11,8,1,OTC
4726,13-02-2021 10:00,24 hrs.,StockMarket,DNN,18,12,6,6,2,4,2,2,AMEX
4726,13-02-2021 10:00,24 hrs.,StockMarket,DSS,6,0,6,-6,1,1,0,1,AMEX
4726,13-02-2021 10:00,24 hrs.,StockMarket,MXC,6,6,0,6,1,0,2,1,AMEX
4726,13-02-2021 10:00,24 hrs.,StockMarket,TRX,6,0,6,-6,1,1,0,1,AMEX
4726,13-02-2021 10:00,24 hrs.,StockMarket,ZOM,6,6,0,6,1,1,0,1,AMEX
4726,13-02-2021 10:00,24 hrs.,StockMarket,GSAT,110,24,86,-62,5,28,34,2,AMEX
4726,13-02-2021 10:00,24 hrs.,StockMarket,LODE,6,0,6,-6,1,1,0,1,AMEX
4726,13-02-2021 10:00,24 hrs.,StockMarket,NSPR,6,0,6,-6,1,1,0,1,AMEX
4726,13-02-2021 10:00,24 hrs.,StockMarket,UAVS,10,0,10,-10,1,1,4,1,AMEX
4726,13-02-2021 10:00,24 hrs.,StockMarket,ACB,50,50,0,50,1,22,2,1,NYSE
4726,13-02-2021 10:00,24 hrs.,StockMarket,AFC,6,0,6,-6,1,1,0,1,NYSE
4726,13-02-2021 10:00,24 hrs.,StockMarket,AGX,6,0,6,-6,1,1,0,1,NYSE
4726,13-02-2021 10:00,24 hrs.,StockMarket,AMC,36,0,36,-36,3,1,22,3,NYSE
4726,13-02-2021 10:00,24 hrs.,StockMarket,ASX,6,6,0,6,1,0,2,1,NYSE
4726,13-02-2021 10:00,24 hrs.,StockMarket,BHC,11,0,11,-11,1,2,3,1,NYSE
4726,13-02-2021 10:00,24 hrs.,StockMarket,DIS,61,50,11,39,2,24,5,2,NYSE
4726,13-02-2021 10:00,24 hrs.,StockMarket,FSR,11,0,11,-11,1,2,3,1,NYSE
4726,13-02-2021 10:00,24 hrs.,StockMarket,GME,81,39,42,-3,6,10,37,6,NYSE
4726,13-02-2021 10:00,24 hrs.,StockMarket,IBM,50,50,0,50,1,22,2,1,NYSE
4726,13-02-2021 10:00,24 hrs.,StockMarket,JNJ,6,0,6,-6,1,1,0,1,NYSE
4726,13-02-2021 10:00,24 hrs.,StockMarket,JPM,18,18,0,18,1,3,8,1,NYSE
4726,13-02-2021 10:00,24 hrs.,StockMarket,LLY,50,50,0,50,1,22,2,1,NYSE
4726,13-02-2021 10:00,24 hrs.,StockMarket,MCO,11,0,11,-11,1,2,3,1,NYSE
4726,13-02-2021 10:00,24 hrs.,StockMarket,MRO,11,0,11,-11,1,2,3,1,NYSE
4726,13-02-2021 10:00,24 hrs.,StockMarket,NIO,240,6,234,-228,3,86,56,3,NYSE
4726,13-02-2021 10:00,24 hrs.,StockMarket,PHI,8,0,8,-8,1,2,0,1,NYSE
4726,13-02-2021 10:00,24 hrs.,StockMarket,PMO,6,6,0,6,1,1,0,1,NYSE
4726,13-02-2021 10:00,24 hrs.,StockMarket,PSA,6,0,6,-6,1,1,0,1,NYSE
4726,13-02-2021 10:00,24 hrs.,StockMarket,SBE,6,0,6,-6,1,1,0,1,NYSE
4726,13-02-2021 10:00,24 hrs.,StockMarket,SMG,18,18,0,18,1,5,4,1,NYSE
4726,13-02-2021 10:00,24 hrs.,StockMarket,SOS,29,6,23,-17,4,5,3,4,NYSE
4726,13-02-2021 10:00,24 hrs.,StockMarket,TDA,13,0,13,-13,1,1,7,1,NYSE
4726,13-02-2021 10:00,24 hrs.,StockMarket,VRT,12,12,0,12,1,3,2,1,NYSE
4726,13-02-2021 10:00,24 hrs.,StockMarket,XPO,50,50,0,50,1,22,2,1,NYSE
4726,13-02-2021 10:00,24 hrs.,StockMarket,CCIV,37,6,31,-25,3,9,7,2,NYSE
4726,13-02-2021 10:00,24 hrs.,StockMarket,CHWY,6,0,6,-6,1,1,0,1,NYSE
4726,13-02-2021 10:00,24 hrs.,StockMarket,COTY,17,5,12,-7,2,2,5,2,NYSE
4726,13-02-2021 10:00,24 hrs.,StockMarket,DSSI,6,0,6,-6,1,1,0,1,NYSE
4726,13-02-2021 10:00,24 hrs.,StockMarket,FUSE,12,0,12,-12,2,2,0,2,NYSE
4726,13-02-2021 10:00,24 hrs.,StockMarket,GDDY,50,50,0,50,1,22,2,1,NYSE
4726,13-02-2021 10:00,24 hrs.,StockMarket,GNRC,50,50,0,50,1,22,2,1,NYSE
4726,13-02-2021 10:00,24 hrs.,StockMarket,HEXO,7,7,0,7,1,1,1,1,NYSE
4726,13-02-2021 10:00,24 hrs.,StockMarket,HYLN,11,0,11,-11,1,2,3,1,NYSE
4726,13-02-2021 10:00,24 hrs.,StockMarket,LAIX,14,0,14,-14,1,0,10,1,NYSE
4726,13-02-2021 10:00,24 hrs.,StockMarket,PINS,27,27,0,27,1,5,13,1,NYSE
4726,13-02-2021 10:00,24 hrs.,StockMarket,PLTR,50,50,0,50,1,22,2,1,NYSE
4726,13-02-2021 10:00,24 hrs.,StockMarket,PUMP,6,6,0,6,1,1,0,1,NYSE
4726,13-02-2021 10:00,24 hrs.,StockMarket,UBER,50,50,0,50,1,22,2,1,NYSE
4726,13-02-2021 10:00,24 hrs.,StockMarket,VGAC,8,0,8,-8,1,0,4,1,NYSE
4726,13-02-2021 10:00,24 hrs.,StockMarket,AMD,6,0,6,-6,1,1,0,1,NASDAQ
4726,13-02-2021 10:00,24 hrs.,StockMarket,AQB,8,8,0,8,1,2,0,1,NASDAQ
4726,13-02-2021 10:00,24 hrs.,wallstreetbets,TCNNF,6029,6,6023,-6017,6,2829,347,2,OTC
4726,13-02-2021 10:00,24 hrs.,wallstreetbets,TGODF,7,0,7,-7,1,1,1,1,OTC
4726,13-02-2021 10:00,24 hrs.,wallstreetbets,TPPRF,14,0,14,-14,2,2,2,1,OTC
4726,13-02-2021 10:00,24 hrs.,wallstreetbets,TSCRF,52,0,52,-52,3,3,34,2,OTC
4726,13-02-2021 10:00,24 hrs.,wallstreetbets,TXLZF,7,0,7,-7,1,1,1,1,OTC
4726,13-02-2021 10:00,24 hrs.,wallstreetbets,VALPQ,10,0,10,-10,1,2,2,1,OTC
4726,13-02-2021 10:00,24 hrs.,wallstreetbets,VVCIF,6,6,0,6,1,1,0,1,OTC
4726,13-02-2021 10:00,24 hrs.,wallstreetbets,VYGVF,6,6,0,6,1,1,0,1,OTC
4726,13-02-2021 10:00,24 hrs.,wallstreetbets,WDDMF,7,0,7,-7,1,1,1,1,OTC
4726,13-02-2021 10:00,24 hrs.,wallstreetbets,ZBISF,7,7,0,7,1,1,1,1,OTC
4726,13-02-2021 10:00,24 hrs.,wallstreetbets,AAU,14,0,14,-14,2,2,2,2,AMEX
4726,13-02-2021 10:00,24 hrs.,wallstreetbets,BTN,15,0,15,-15,2,2,3,1,AMEX
4726,13-02-2021 10:00,24 hrs.,trakstocks,MARA,37,0,37,-37,1,14,5,1,NASDAQ
4726,13-02-2021 10:00,24 hrs.,trakstocks,OPRX,12,0,12,-12,1,3,2,1,NASDAQ
4726,13-02-2021 10:00,24 hrs.,trakstocks,RIOT,47,0,47,-47,2,15,9,2,NASDAQ
4726,13-02-2021 10:00,24 hrs.,trakstocks,SNDL,16,16,0,16,1,5,2,1,NASDAQ
4726,13-02-2021 10:00,24 hrs.,trakstocks,TLRY,16,16,0,16,1,5,2,1,NASDAQ
4726,13-02-2021 10:00,24 hrs.,trakstocks,TRIT,36,36,0,36,1,13,6,1,NASDAQ
4726,13-02-2021 10:00,24 hrs.,trakstocks,TTCF,30,30,0,30,2,6,10,2,NASDAQ
4726,13-02-2021 10:00,24 hrs.,StockMarket,ABML,6,0,6,-6,1,1,0,1,OTC
4726,13-02-2021 10:00,24 hrs.,StockMarket,BOTH,6,6,0,6,1,0,2,1,OTC
4726,13-02-2021 10:00,24 hrs.,StockMarket,BOTY,17,7,10,-3,2,4,1,2,OTC
4726,13-02-2021 10:00,24 hrs.,StockMarket,GTEH,6,6,0,6,1,1,0,1,OTC
4726,13-02-2021 10:00,24 hrs.,StockMarket,GTVH,6,0,6,-6,1,1,0,1,OTC
4726,13-02-2021 10:00,24 hrs.,StockMarket,HEMP,6,0,6,-6,1,1,0,1,OTC
4726,13-02-2021 10:00,24 hrs.,StockMarket,KGET,6,0,6,-6,1,1,0,1,OTC
4726,13-02-2021 10:00,24 hrs.,StockMarket,KWBT,6,0,6,-6,1,1,0,1,OTC
4726,13-02-2021 10:00,24 hrs.,StockMarket,LINK,11,0,11,-11,1,2,3,1,OTC
4726,13-02-2021 10:00,24 hrs.,StockMarket,MAXD,52,0,52,-52,3,15,10,3,OTC
4726,13-02-2021 10:00,24 hrs.,StockMarket,MOST,11,0,11,-11,1,2,3,1,OTC
4726,13-02-2021 10:00,24 hrs.,StockMarket,PCTL,6,0,6,-6,1,1,0,1,OTC
4726,13-02-2021 10:00,24 hrs.,StockMarket,PHIL,8,0,8,-8,1,2,0,1,OTC
4726,13-02-2021 10:00,24 hrs.,StockMarket,RSSV,21,0,21,-21,1,7,3,1,OTC
4726,13-02-2021 10:00,24 hrs.,StockMarket,SGMD,168,0,168,-168,6,43,58,2,OTC
4726,13-02-2021 10:00,24 hrs.,StockMarket,AYRWF,18,18,0,18,1,5,4,1,OTC
4726,13-02-2021 10:00,24 hrs.,StockMarket,BMWLF,18,18,0,18,1,5,4,1,OTC
4726,13-02-2021 10:00,24 hrs.,StockMarket,CRLBF,18,18,0,18,1,5,4,1,OTC
4726,13-02-2021 10:00,24 hrs.,StockMarket,CURLF,18,18,0,18,1,5,4,1,OTC
4726,13-02-2021 10:00,24 hrs.,StockMarket,DIGAF,6,0,6,-6,1,1,0,1,OTC
4726,13-02-2021 10:00,24 hrs.,StockMarket,GTBIF,18,18,0,18,1,5,4,1,OTC
4726,13-02-2021 10:00,24 hrs.,StockMarket,HTZGQ,6,0,6,-6,1,1,0,1,OTC
4726,13-02-2021 10:00,24 hrs.,StockMarket,LHSIF,18,18,0,18,1,5,4,1,OTC
4726,13-02-2021 10:00,24 hrs.,StockMarket,NMGRF,6,0,6,-6,1,1,0,1,OTC
4726,13-02-2021 10:00,24 hrs.,StockMarket,RAZFF,6,0,6,-6,1,1,0,1,OTC
4726,13-02-2021 10:00,24 hrs.,StockMarket,RHDGF,18,0,18,-18,2,3,4,1,OTC
4726,13-02-2021 10:00,24 hrs.,StockMarket,RWBYF,18,18,0,18,1,5,4,1,OTC
4726,13-02-2021 10:00,24 hrs.,StockMarket,RYCEY,12,6,6,0,2,2,0,2,OTC
4726,13-02-2021 10:00,24 hrs.,StockMarket,TCNNF,18,18,0,18,1,5,4,1,OTC
4726,13-02-2021 10:00,24 hrs.,StockMarket,TFECY,18,0,18,-18,3,3,0,1,OTC
4726,13-02-2021 10:00,24 hrs.,wallstreetbets,EDSA,6,0,6,-6,1,1,0,1,NASDAQ
4726,13-02-2021 10:00,24 hrs.,wallstreetbets,EHTH,7,0,7,-7,1,1,1,1,NASDAQ
4726,13-02-2021 10:00,24 hrs.,wallstreetbets,ELSE,7,0,7,-7,1,1,1,1,NASDAQ
4726,13-02-2021 10:00,24 hrs.,wallstreetbets,ENLV,7,0,7,-7,1,1,1,1,NASDAQ
4726,13-02-2021 10:00,24 hrs.,wallstreetbets,ENVB,26,0,26,-26,4,4,2,3,NASDAQ
4726,13-02-2021 10:00,24 hrs.,wallstreetbets,ESPR,7,0,7,-7,1,1,1,1,NASDAQ
4726,13-02-2021 10:00,24 hrs.,wallstreetbets,EVER,28,7,21,-14,4,4,4,4,NASDAQ
4726,13-02-2021 10:00,24 hrs.,wallstreetbets,EXPC,7,0,7,-7,1,1,1,1,NASDAQ
4726,13-02-2021 10:00,24 hrs.,wallstreetbets,EXPE,429,0,429,-429,1,175,75,1,NASDAQ
4726,13-02-2021 10:00,24 hrs.,wallstreetbets,EXPI,6,6,0,6,1,1,0,1,NASDAQ
4726,13-02-2021 10:00,24 hrs.,wallstreetbets,FAMI,6,0,6,-6,1,1,0,1,NASDAQ
4726,13-02-2021 10:00,24 hrs.,wallstreetbets,FARM,7,0,7,-7,1,1,1,1,NASDAQ
4726,13-02-2021 10:00,24 hrs.,wallstreetbets,FAST,7,0,7,-7,1,1,1,1,NASDAQ
4726,13-02-2021 10:00,24 hrs.,wallstreetbets,FCAC,8,0,8,-8,1,1,2,1,NASDAQ
4726,13-02-2021 10:00,24 hrs.,wallstreetbets,FCEL,6,0,6,-6,1,1,0,1,NASDAQ
4726,13-02-2021 10:00,24 hrs.,wallstreetbets,FLGT,13,0,13,-13,2,2,1,2,NASDAQ
4726,13-02-2021 10:00,24 hrs.,wallstreetbets,FLWR,7,7,0,7,1,1,1,1,NASDAQ
4726,13-02-2021 10:00,24 hrs.,wallstreetbets,FLWS,15,0,15,-15,2,2,3,2,NASDAQ
4726,13-02-2021 10:00,24 hrs.,wallstreetbets,FOLD,48,7,41,-34,7,7,6,6,NASDAQ
4726,13-02-2021 10:00,24 hrs.,wallstreetbets,FORD,7,0,7,-7,1,1,1,1,NASDAQ
4726,13-02-2021 10:00,24 hrs.,wallstreetbets,FORM,173,0,173,-173,1,68,33,1,NASDAQ
4726,13-02-2021 10:00,24 hrs.,wallstreetbets,FTFT,14,0,14,-14,2,2,2,2,NASDAQ
4726,13-02-2021 10:00,24 hrs.,wallstreetbets,FUTU,1045,0,1045,-1045,1,412,217,1,NASDAQ
4726,13-02-2021 10:00,24 hrs.,wallstreetbets,GAIN,13,6,7,-1,2,2,1,2,NASDAQ
4726,13-02-2021 10:00,24 hrs.,wallstreetbets,GERN,6,0,6,-6,1,1,0,1,NASDAQ
4726,13-02-2021 10:00,24 hrs.,wallstreetbets,GEVO,211,0,211,-211,9,59,57,7,NASDAQ
4726,13-02-2021 10:00,24 hrs.,wallstreetbets,GILT,14,0,14,-14,2,2,2,2,NASDAQ
4726,13-02-2021 10:00,24 hrs.,wallstreetbets,GLBS,28,7,21,-14,4,4,4,3,NASDAQ
4726,13-02-2021 10:00,24 hrs.,wallstreetbets,GLMD,21,0,21,-21,3,3,3,1,NASDAQ
4726,13-02-2021 10:00,24 hrs.,wallstreetbets,GLPG,7,0,7,-7,1,1,1,1,NASDAQ
4726,13-02-2021 10:00,24 hrs.,wallstreetbets,GLUU,30,0,30,-30,2,1,20,1,NASDAQ
4726,13-02-2021 10:00,24 hrs.,wallstreetbets,GMBL,7,0,7,-7,1,1,1,1,NASDAQ
4726,13-02-2021 10:00,24 hrs.,wallstreetbets,GNRS,14,0,14,-14,2,2,2,1,NASDAQ
4726,13-02-2021 10:00,24 hrs.,wallstreetbets,GNUS,27,14,13,1,4,4,3,4,NASDAQ
4726,13-02-2021 10:00,24 hrs.,wallstreetbets,GOEV,7,7,0,7,1,1,1,1,NASDAQ
4726,13-02-2021 10:00,24 hrs.,wallstreetbets,GOGO,49,36,13,23,8,8,1,5,NASDAQ
4726,13-02-2021 10:00,24 hrs.,wallstreetbets,GOLD,13,0,13,-13,2,2,1,2,NASDAQ
4726,13-02-2021 10:00,24 hrs.,wallstreetbets,GRIL,7,0,7,-7,1,1,1,1,NASDAQ
4726,13-02-2021 10:00,24 hrs.,wallstreetbets,GRTS,6,0,6,-6,1,1,0,1,NASDAQ
4726,13-02-2021 10:00,24 hrs.,wallstreetbets,GTEC,8,0,8,-8,1,1,2,1,NASDAQ
4726,13-02-2021 10:00,24 hrs.,wallstreetbets,GTHX,50,25,25,0,8,8,2,5,NASDAQ
4726,13-02-2021 10:00,24 hrs.,wallstreetbets,GWPH,13,0,13,-13,1,0,9,1,NASDAQ
4726,13-02-2021 10:00,24 hrs.,wallstreetbets,HALO,14,0,14,-14,2,2,2,2,NASDAQ
4726,13-02-2021 10:00,24 hrs.,wallstreetbets,HDSN,7,0,7,-7,1,1,1,1,NASDAQ
4726,13-02-2021 10:00,24 hrs.,trakstocks,PYRNF,16,10,6,4,2,3,2,2,OTC
4726,13-02-2021 10:00,24 hrs.,trakstocks,VRYYF,7,7,0,7,1,1,1,1,OTC
4726,13-02-2021 10:00,24 hrs.,trakstocks,DNN,84,0,84,-84,1,32,16,1,AMEX
4726,13-02-2021 10:00,24 hrs.,trakstocks,DPW,12,12,0,12,2,2,0,2,AMEX
4726,13-02-2021 10:00,24 hrs.,trakstocks,TRXC,172,0,172,-172,1,61,46,1,AMEX
4726,13-02-2021 10:00,24 hrs.,trakstocks,AMC,25,0,25,-25,1,2,17,1,NYSE
4726,13-02-2021 10:00,24 hrs.,trakstocks,BFT,6,6,0,6,1,1,0,1,NYSE
4726,13-02-2021 10:00,24 hrs.,trakstocks,GME,25,0,25,-25,1,2,17,1,NYSE
4726,13-02-2021 10:00,24 hrs.,trakstocks,SOL,8,0,8,-8,1,2,0,1,NYSE
4726,13-02-2021 10:00,24 hrs.,trakstocks,SOS,25,0,25,-25,1,10,1,1,NYSE
4726,13-02-2021 10:00,24 hrs.,trakstocks,SWN,9,9,0,9,1,2,1,1,NYSE
4726,13-02-2021 10:00,24 hrs.,trakstocks,ARGO,6,0,6,-6,1,1,0,1,NYSE
4726,13-02-2021 10:00,24 hrs.,trakstocks,PLTR,16,16,0,16,1,5,2,1,NYSE
4726,13-02-2021 10:00,24 hrs.,trakstocks,STPK,79,79,0,79,4,24,15,3,NYSE
4726,13-02-2021 10:00,24 hrs.,trakstocks,AQB,16,0,16,-16,1,5,2,1,NASDAQ
4726,13-02-2021 10:00,24 hrs.,trakstocks,OEG,31,0,31,-31,1,11,5,1,NASDAQ
4726,13-02-2021 10:00,24 hrs.,trakstocks,APPS,6,0,6,-6,1,1,0,1,NASDAQ
4726,13-02-2021 10:00,24 hrs.,trakstocks,AYRO,140,72,68,4,3,46,36,3,NASDAQ
4726,13-02-2021 10:00,24 hrs.,trakstocks,BHTG,431,0,431,-431,1,160,107,1,NASDAQ
4726,13-02-2021 10:00,24 hrs.,trakstocks,CFII,87,0,87,-87,1,30,23,1,NASDAQ
4726,13-02-2021 10:00,24 hrs.,trakstocks,CLVS,11,11,0,11,1,2,3,1,NASDAQ
4726,13-02-2021 10:00,24 hrs.,trakstocks,CPSH,44,0,44,-44,2,12,12,2,NASDAQ
4726,13-02-2021 10:00,24 hrs.,trakstocks,EXPC,12,12,0,12,1,3,2,1,NASDAQ
4726,13-02-2021 10:00,24 hrs.,trakstocks,GTHX,6,0,6,-6,1,1,0,1,NASDAQ
4726,13-02-2021 10:00,24 hrs.,trakstocks,IMMR,44,44,0,44,1,16,8,1,NASDAQ
4726,13-02-2021 10:00,24 hrs.,trakstocks,LIFE,16,16,0,16,1,2,8,1,NASDAQ
4726,13-02-2021 10:00,24 hrs.,wallstreetbets,BRQS,6,0,6,-6,1,1,0,1,NASDAQ
4726,13-02-2021 10:00,24 hrs.,wallstreetbets,BTWN,7,0,7,-7,1,1,1,1,NASDAQ
4726,13-02-2021 10:00,24 hrs.,wallstreetbets,BWEN,7,7,0,7,1,1,1,1,NASDAQ
4726,13-02-2021 10:00,24 hrs.,wallstreetbets,CARE,49,0,49,-49,7,7,7,2,NASDAQ
4726,13-02-2021 10:00,24 hrs.,wallstreetbets,CARV,7,0,7,-7,1,1,1,1,NASDAQ
4726,13-02-2021 10:00,24 hrs.,wallstreetbets,CASH,14,0,14,-14,2,2,2,1,NASDAQ
4726,13-02-2021 10:00,24 hrs.,wallstreetbets,CATM,7,0,7,-7,1,1,1,1,NASDAQ
4726,13-02-2021 10:00,24 hrs.,wallstreetbets,CBAT,7,0,7,-7,1,1,1,1,NASDAQ
4726,13-02-2021 10:00,24 hrs.,wallstreetbets,CCRC,12,0,12,-12,2,2,0,1,NASDAQ
4726,13-02-2021 10:00,24 hrs.,wallstreetbets,CIDM,21,7,14,-7,3,3,3,3,NASDAQ
4726,13-02-2021 10:00,24 hrs.,wallstreetbets,CKPT,14,0,14,-14,2,2,2,2,NASDAQ
4726,13-02-2021 10:00,24 hrs.,wallstreetbets,CLBS,21,7,14,-7,3,3,3,2,NASDAQ
4726,13-02-2021 10:00,24 hrs.,wallstreetbets,CLEU,7,0,7,-7,1,1,1,1,NASDAQ
4726,13-02-2021 10:00,24 hrs.,wallstreetbets,CLGN,7,0,7,-7,1,1,1,1,NASDAQ
4726,13-02-2021 10:00,24 hrs.,wallstreetbets,CLSN,7,0,7,-7,1,1,1,1,NASDAQ
4726,13-02-2021 10:00,24 hrs.,wallstreetbets,CMPS,3194,12,3182,-3170,7,1325,516,6,NASDAQ
4726,13-02-2021 10:00,24 hrs.,wallstreetbets,CNDT,6,0,6,-6,1,1,0,1,NASDAQ
4726,13-02-2021 10:00,24 hrs.,wallstreetbets,COCP,7,0,7,-7,1,1,1,1,NASDAQ
4726,13-02-2021 10:00,24 hrs.,wallstreetbets,COHR,429,0,429,-429,1,175,75,1,NASDAQ
4726,13-02-2021 10:00,24 hrs.,wallstreetbets,CRBP,28,7,21,-14,4,4,4,4,NASDAQ
4726,13-02-2021 10:00,24 hrs.,wallstreetbets,CRNT,13,0,13,-13,2,2,1,2,NASDAQ
4726,13-02-2021 10:00,24 hrs.,wallstreetbets,CRON,20,14,6,8,3,3,2,3,NASDAQ
4726,13-02-2021 10:00,24 hrs.,wallstreetbets,CRSP,82,82,0,82,4,10,46,2,NASDAQ
4726,13-02-2021 10:00,24 hrs.,wallstreetbets,CRSR,604,239,365,-126,15,209,126,11,NASDAQ
4726,13-02-2021 10:00,24 hrs.,wallstreetbets,CTHR,7,0,7,-7,1,1,1,1,NASDAQ
4726,13-02-2021 10:00,24 hrs.,wallstreetbets,CTMX,7,0,7,-7,1,1,1,1,NASDAQ
4726,13-02-2021 10:00,24 hrs.,wallstreetbets,CTRM,239,21,218,-197,35,35,29,28,NASDAQ
4726,13-02-2021 10:00,24 hrs.,wallstreetbets,CVAC,62,62,0,62,1,21,16,1,NASDAQ
4726,13-02-2021 10:00,24 hrs.,wallstreetbets,DDOG,429,0,429,-429,1,175,75,1,NASDAQ
4726,13-02-2021 10:00,24 hrs.,wallstreetbets,DFFN,14,0,14,-14,2,2,2,1,NASDAQ
4726,13-02-2021 10:00,24 hrs.,wallstreetbets,DKNG,21,7,14,-7,3,3,3,3,NASDAQ
4726,13-02-2021 10:00,24 hrs.,wallstreetbets,DOYU,7,0,7,-7,1,1,1,1,NASDAQ
4726,13-02-2021 10:00,24 hrs.,wallstreetbets,DRIV,6,6,0,6,1,1,0,1,NASDAQ
4726,13-02-2021 10:00,24 hrs.,wallstreetbets,DRRX,7,0,7,-7,1,1,1,1,NASDAQ
4726,13-02-2021 10:00,24 hrs.,wallstreetbets,DSKE,7,0,7,-7,1,1,1,1,NASDAQ
4726,13-02-2021 10:00,24 hrs.,wallstreetbets,DXYN,7,0,7,-7,1,1,1,1,NASDAQ
4726,13-02-2021 10:00,24 hrs.,wallstreetbets,EBON,56,7,49,-42,8,8,8,4,NASDAQ
4726,13-02-2021 10:00,24 hrs.,wallstreetbets,EDIT,8672,96,8576,-8480,2,4046,572,2,NASDAQ
4726,13-02-2021 10:00,24 hrs.,stocks,DISCA,12,0,12,-12,2,2,0,2,NASDAQ
4726,13-02-2021 10:00,24 hrs.,stocks,LILAK,12,12,0,12,2,2,0,1,NASDAQ
4726,13-02-2021 10:00,24 hrs.,stocks,SRACU,6,0,6,-6,1,1,0,1,NASDAQ
4726,13-02-2021 10:00,24 hrs.,stocks,SRACW,6,0,6,-6,1,1,0,1,NASDAQ
4726,13-02-2021 10:00,24 hrs.,Daytrading,SGMD,17,17,0,17,1,3,7,1,OTC
4726,13-02-2021 10:00,24 hrs.,Daytrading,HVBTF,9,9,0,9,1,2,1,1,OTC
4726,13-02-2021 10:00,24 hrs.,Daytrading,DNN,510,0,510,-510,2,212,78,2,AMEX
4726,13-02-2021 10:00,24 hrs.,Daytrading,DSS,504,0,504,-504,1,211,78,1,AMEX
4726,13-02-2021 10:00,24 hrs.,Daytrading,GTE,7,7,0,7,1,1,1,1,AMEX
4726,13-02-2021 10:00,24 hrs.,Daytrading,MXC,6,0,6,-6,1,1,0,1,AMEX
4726,13-02-2021 10:00,24 hrs.,Daytrading,ACB,510,0,510,-510,2,212,78,2,NYSE
4726,13-02-2021 10:00,24 hrs.,Daytrading,ADX,9,0,9,-9,1,2,1,1,NYSE
4726,13-02-2021 10:00,24 hrs.,Daytrading,AMC,6,0,6,-6,1,1,0,1,NYSE
4726,13-02-2021 10:00,24 hrs.,Daytrading,BDX,7,0,7,-7,1,1,1,1,NYSE
4726,13-02-2021 10:00,24 hrs.,Daytrading,FSR,504,0,504,-504,1,211,78,1,NYSE
4726,13-02-2021 10:00,24 hrs.,Daytrading,GME,246,246,0,246,2,96,46,2,NYSE
4726,13-02-2021 10:00,24 hrs.,Daytrading,NIO,8,8,0,8,1,1,2,1,NYSE
4726,13-02-2021 10:00,24 hrs.,Daytrading,PDT,29,7,22,-15,2,4,13,2,NYSE
4726,13-02-2021 10:00,24 hrs.,Daytrading,RTP,504,0,504,-504,1,211,78,1,NYSE
4726,13-02-2021 10:00,24 hrs.,Daytrading,WLL,6,0,6,-6,1,1,0,1,NYSE
4726,13-02-2021 10:00,24 hrs.,Daytrading,CCIV,504,0,504,-504,1,211,78,1,NYSE
4726,13-02-2021 10:00,24 hrs.,Daytrading,CHWY,6,0,6,-6,1,1,0,1,NYSE
4726,13-02-2021 10:00,24 hrs.,Daytrading,SPCE,504,0,504,-504,1,211,78,1,NYSE
4726,13-02-2021 10:00,24 hrs.,Daytrading,API,326,0,326,-326,1,141,40,1,NASDAQ
4726,13-02-2021 10:00,24 hrs.,Daytrading,INO,504,0,504,-504,1,211,78,1,NASDAQ
4726,13-02-2021 10:00,24 hrs.,Daytrading,AAPL,8,8,0,8,1,1,2,1,NASDAQ
4726,13-02-2021 10:00,24 hrs.,Daytrading,ACST,6,0,6,-6,1,1,0,1,NASDAQ
4726,13-02-2021 10:00,24 hrs.,Daytrading,APDN,504,0,504,-504,1,211,78,1,NASDAQ
4726,13-02-2021 10:00,24 hrs.,Daytrading,APHA,504,0,504,-504,1,211,78,1,NASDAQ
4726,13-02-2021 10:00,24 hrs.,Daytrading,ARTL,621,6,615,-609,7,249,95,7,NASDAQ
4726,13-02-2021 10:00,24 hrs.,Daytrading,BNGO,104,0,104,-104,1,40,20,1,NASDAQ
4726,13-02-2021 10:00,24 hrs.,Daytrading,CLEU,567,0,567,-567,2,236,87,2,NASDAQ
4726,13-02-2021 10:00,24 hrs.,Daytrading,CLGN,504,0,504,-504,1,211,78,1,NASDAQ
4726,13-02-2021 10:00,24 hrs.,Daytrading,CLSN,504,0,504,-504,1,211,78,1,NASDAQ
4726,13-02-2021 10:00,24 hrs.,Daytrading,CMLF,504,0,504,-504,1,211,78,1,NASDAQ
4726,13-02-2021 10:00,24 hrs.,Daytrading,CRSR,504,0,504,-504,1,211,78,1,NASDAQ
4726,13-02-2021 10:00,24 hrs.,Daytrading,EBON,6,0,6,-6,1,1,0,1,NASDAQ
4726,13-02-2021 10:00,24 hrs.,Daytrading,FOLD,510,0,510,-510,2,212,78,2,NASDAQ
4726,13-02-2021 10:00,24 hrs.,Daytrading,FTFT,504,0,504,-504,1,211,78,1,NASDAQ
4726,13-02-2021 10:00,24 hrs.,Daytrading,LIVE,128,0,128,-128,2,50,20,1,NASDAQ
4726,13-02-2021 10:00,24 hrs.,Daytrading,MARA,504,0,504,-504,1,211,78,1,NASDAQ
4726,13-02-2021 10:00,24 hrs.,Daytrading,NOVN,504,0,504,-504,1,211,78,1,NASDAQ
4726,13-02-2021 10:00,24 hrs.,Daytrading,OCGN,24,0,24,-24,1,2,16,1,NASDAQ
4726,13-02-2021 10:00,24 hrs.,Daytrading,PYPL,504,0,504,-504,1,211,78,1,NASDAQ
4726,13-02-2021 10:00,24 hrs.,Daytrading,RIDE,504,0,504,-504,1,211,78,1,NASDAQ
4726,13-02-2021 10:00,24 hrs.,Daytrading,RIOT,513,9,504,-495,2,213,79,2,NASDAQ
4726,13-02-2021 10:00,24 hrs.,Daytrading,STAY,43,0,43,-43,1,19,1,1,NASDAQ
4726,13-02-2021 10:00,24 hrs.,Daytrading,TLRY,511,7,504,-497,2,212,79,2,NASDAQ
4726,13-02-2021 10:00,24 hrs.,Daytrading,TSLA,11,11,0,11,1,1,5,1,NASDAQ
4726,13-02-2021 10:00,24 hrs.,Daytrading,WAFU,63,0,63,-63,1,25,9,1,NASDAQ
4726,13-02-2021 10:00,24 hrs.,Daytrading,XERS,504,0,504,-504,1,211,78,1,NASDAQ
4726,13-02-2021 10:00,24 hrs.,trakstocks,ALPP,6,0,6,-6,1,1,0,1,OTC
4726,13-02-2021 10:00,24 hrs.,trakstocks,BRTX,9,0,9,-9,1,2,1,1,OTC
4726,13-02-2021 10:00,24 hrs.,trakstocks,HCMC,7,7,0,7,1,0,3,1,OTC
4726,13-02-2021 10:00,24 hrs.,trakstocks,INND,7,7,0,7,1,0,3,1,OTC
4726,13-02-2021 10:00,24 hrs.,trakstocks,MMEX,20,0,20,-20,2,3,6,2,OTC
4726,13-02-2021 10:00,24 hrs.,trakstocks,MOST,6,0,6,-6,1,1,0,1,OTC
4726,13-02-2021 10:00,24 hrs.,trakstocks,ARBKF,6,0,6,-6,1,1,0,1,OTC
4726,13-02-2021 10:00,24 hrs.,trakstocks,BBXIA,6,0,6,-6,1,1,0,1,OTC
4726,13-02-2021 10:00,24 hrs.,trakstocks,MGROF,11,11,0,11,1,3,1,1,OTC
4726,13-02-2021 10:00,24 hrs.,trakstocks,NMGRF,48,0,48,-48,1,18,8,1,OTC
4726,13-02-2021 10:00,24 hrs.,trakstocks,NXTTF,12,0,12,-12,1,4,0,1,OTC
4726,13-02-2021 10:00,24 hrs.,wallstreetbets,AAL,19,0,19,-19,3,3,1,3,NASDAQ
4726,13-02-2021 10:00,24 hrs.,wallstreetbets,AMD,2484,49,2435,-2386,22,852,692,18,NASDAQ
4726,13-02-2021 10:00,24 hrs.,wallstreetbets,API,7,7,0,7,1,1,1,1,NASDAQ
4726,13-02-2021 10:00,24 hrs.,wallstreetbets,AQB,7,7,0,7,1,1,1,1,NASDAQ
4726,13-02-2021 10:00,24 hrs.,wallstreetbets,ASO,6,0,6,-6,1,1,0,1,NASDAQ
4726,13-02-2021 10:00,24 hrs.,wallstreetbets,AZN,443,7,436,-429,3,177,77,3,NASDAQ
4726,13-02-2021 10:00,24 hrs.,wallstreetbets,BFI,14,0,14,-14,2,2,2,1,NASDAQ
4726,13-02-2021 10:00,24 hrs.,wallstreetbets,BLU,14,0,14,-14,2,2,2,1,NASDAQ
4726,13-02-2021 10:00,24 hrs.,wallstreetbets,BUG,12,0,12,-12,2,2,0,1,NASDAQ
4726,13-02-2021 10:00,24 hrs.,wallstreetbets,CDC,429,0,429,-429,1,175,75,1,NASDAQ
4726,13-02-2021 10:00,24 hrs.,wallstreetbets,CFO,6,6,0,6,1,1,0,1,NASDAQ
4726,13-02-2021 10:00,24 hrs.,wallstreetbets,CGC,89,7,82,-75,4,21,31,4,NASDAQ
4726,13-02-2021 10:00,24 hrs.,wallstreetbets,CTG,7,0,7,-7,1,1,1,1,NASDAQ
4726,13-02-2021 10:00,24 hrs.,wallstreetbets,DBX,7,0,7,-7,1,1,1,1,NASDAQ
4726,13-02-2021 10:00,24 hrs.,wallstreetbets,FAT,176,0,176,-176,2,55,58,2,NASDAQ
4726,13-02-2021 10:00,24 hrs.,wallstreetbets,FUV,7,0,7,-7,1,1,1,1,NASDAQ
4726,13-02-2021 10:00,24 hrs.,wallstreetbets,FWP,14,0,14,-14,2,2,2,1,NASDAQ
4726,13-02-2021 10:00,24 hrs.,wallstreetbets,UTZ,1045,0,1045,-1045,1,412,217,1,NYSE
4726,13-02-2021 10:00,24 hrs.,wallstreetbets,VGR,7,0,7,-7,1,1,1,1,NYSE
4726,13-02-2021 10:00,24 hrs.,wallstreetbets,VHC,7,0,7,-7,1,1,1,1,NYSE
4726,13-02-2021 10:00,24 hrs.,wallstreetbets,VRT,160,0,160,-160,2,58,36,1,NYSE
4726,13-02-2021 10:00,24 hrs.,wallstreetbets,VST,35,0,35,-35,5,5,5,1,NYSE
4726,13-02-2021 10:00,24 hrs.,wallstreetbets,WFC,7,0,7,-7,1,1,1,1,NYSE
4726,13-02-2021 10:00,24 hrs.,wallstreetbets,WLL,6,0,6,-6,1,1,0,1,NYSE
4726,13-02-2021 10:00,24 hrs.,wallstreetbets,WMC,8,0,8,-8,1,1,2,1,NYSE
4726,13-02-2021 10:00,24 hrs.,wallstreetbets,WMT,13,0,13,-13,2,2,1,2,NYSE
4726,13-02-2021 10:00,24 hrs.,wallstreetbets,ABBV,7,7,0,7,1,1,1,1,NYSE
4726,13-02-2021 10:00,24 hrs.,wallstreetbets,ABEV,7,0,7,-7,1,1,1,1,NYSE
4726,13-02-2021 10:00,24 hrs.,wallstreetbets,ACIC,27,7,20,-13,4,4,3,4,NYSE
4726,13-02-2021 10:00,24 hrs.,wallstreetbets,ALLY,7,7,0,7,1,1,1,1,NYSE
4726,13-02-2021 10:00,24 hrs.,wallstreetbets,APRN,6,0,6,-6,1,1,0,1,NYSE
4726,13-02-2021 10:00,24 hrs.,wallstreetbets,ARGO,6,0,6,-6,1,1,0,1,NYSE
4726,13-02-2021 10:00,24 hrs.,wallstreetbets,ATUS,14,0,14,-14,2,2,2,1,NYSE
4726,13-02-2021 10:00,24 hrs.,wallstreetbets,BABA,183,0,183,-183,3,56,59,3,NYSE
4726,13-02-2021 10:00,24 hrs.,wallstreetbets,BNED,6,0,6,-6,1,1,0,1,NYSE
4726,13-02-2021 10:00,24 hrs.,wallstreetbets,CARS,6,0,6,-6,1,1,0,1,NYSE
4726,13-02-2021 10:00,24 hrs.,wallstreetbets,CCIV,232,55,177,-122,34,34,28,28,NYSE
4726,13-02-2021 10:00,24 hrs.,wallstreetbets,CHWY,7,0,7,-7,1,1,1,1,NYSE
4726,13-02-2021 10:00,24 hrs.,wallstreetbets,CLDR,6,0,6,-6,1,1,0,1,NYSE
4726,13-02-2021 10:00,24 hrs.,wallstreetbets,CLII,7,0,7,-7,1,1,1,1,NYSE
4726,13-02-2021 10:00,24 hrs.,wallstreetbets,DASH,13,13,0,13,2,2,1,2,NYSE
4726,13-02-2021 10:00,24 hrs.,wallstreetbets,EXPR,15,0,15,-15,2,2,3,2,NYSE
4726,13-02-2021 10:00,24 hrs.,wallstreetbets,FEDU,7,0,7,-7,1,1,1,1,NYSE
4726,13-02-2021 10:00,24 hrs.,wallstreetbets,FLOW,7,0,7,-7,1,1,1,1,NYSE
4726,13-02-2021 10:00,24 hrs.,wallstreetbets,FSLY,14,0,14,-14,2,2,2,2,NYSE
4726,13-02-2021 10:00,24 hrs.,wallstreetbets,FUBO,1066,7,1059,-1052,4,415,220,4,NYSE
4726,13-02-2021 10:00,24 hrs.,wallstreetbets,FUSE,30,0,30,-30,4,4,6,2,NYSE
4726,13-02-2021 10:00,24 hrs.,wallstreetbets,FVRR,7,0,7,-7,1,1,1,1,NYSE
4726,13-02-2021 10:00,24 hrs.,wallstreetbets,GNRC,6,6,0,6,1,1,0,1,NYSE
4726,13-02-2021 10:00,24 hrs.,wallstreetbets,GPRK,7,0,7,-7,1,1,1,1,NYSE
4726,13-02-2021 10:00,24 hrs.,wallstreetbets,HEXO,27,20,7,13,4,4,3,3,NYSE
4726,13-02-2021 10:00,24 hrs.,wallstreetbets,HUBS,13,0,13,-13,2,2,1,2,NYSE
4726,13-02-2021 10:00,24 hrs.,wallstreetbets,HUYA,35,14,21,-7,5,5,5,4,NYSE
4726,13-02-2021 10:00,24 hrs.,wallstreetbets,HYLN,537,0,537,-537,11,150,193,8,NYSE
4726,13-02-2021 10:00,24 hrs.,wallstreetbets,IIPR,20,0,20,-20,3,3,2,2,NYSE
4726,13-02-2021 10:00,24 hrs.,wallstreetbets,IPOE,7,0,7,-7,1,1,1,1,NYSE
4726,13-02-2021 10:00,24 hrs.,wallstreetbets,JMIA,6044,0,6044,-6044,8,2831,350,3,NYSE
4726,13-02-2021 10:00,24 hrs.,wallstreetbets,JNPR,6,0,6,-6,1,1,0,1,NYSE
4726,13-02-2021 10:00,24 hrs.,wallstreetbets,KODK,13,0,13,-13,2,2,1,1,NYSE
4726,13-02-2021 10:00,24 hrs.,wallstreetbets,LGVW,21,14,7,7,3,3,3,2,NYSE
4726,13-02-2021 10:00,24 hrs.,wallstreetbets,LSPD,6,0,6,-6,1,1,0,1,NYSE
4726,13-02-2021 10:00,24 hrs.,wallstreetbets,MAIN,6,6,0,6,1,1,0,1,NYSE
4726,13-02-2021 10:00,24 hrs.,wallstreetbets,MANU,12,0,12,-12,2,2,0,2,NYSE
4726,13-02-2021 10:00,24 hrs.,wallstreetbets,PACK,15,0,15,-15,2,2,3,1,NYSE
4726,13-02-2021 10:00,24 hrs.,wallstreetbets,PLTR,13545,3089,10456,-7367,38,6029,1335,30,NYSE
4726,13-02-2021 10:00,24 hrs.,wallstreetbets,PRTY,14,0,14,-14,2,2,2,2,NYSE
4726,13-02-2021 10:00,24 hrs.,wallstreetbets,PSTH,226,226,0,226,3,75,64,2,NYSE
4726,13-02-2021 10:00,24 hrs.,wallstreetbets,PUMP,49,0,49,-49,7,7,7,2,NYSE
4726,13-02-2021 10:00,24 hrs.,wallstreetbets,SAFE,131,9,122,-113,2,34,55,2,NYSE
4726,13-02-2021 10:00,24 hrs.,wallstreetbets,SPCE,230,41,189,-148,20,49,52,13,NYSE
4726,13-02-2021 10:00,24 hrs.,wallstreetbets,STIC,7,7,0,7,1,1,1,1,NYSE
4726,13-02-2021 10:00,24 hrs.,wallstreetbets,STPK,6,6,0,6,1,1,0,1,NYSE
4726,13-02-2021 10:00,24 hrs.,wallstreetbets,STWD,147,0,147,-147,1,40,63,1,NYSE
4726,13-02-2021 10:00,24 hrs.,wallstreetbets,TWTR,7,0,7,-7,1,1,1,1,NYSE
4726,13-02-2021 10:00,24 hrs.,wallstreetbets,UBER,7,0,7,-7,1,1,1,1,NYSE
4726,13-02-2021 10:00,24 hrs.,wallstreetbets,VALE,7,0,7,-7,1,1,1,1,NYSE
4726,13-02-2021 10:00,24 hrs.,wallstreetbets,VGAC,19,0,19,-19,3,3,1,3,NYSE
4726,13-02-2021 10:00,24 hrs.,wallstreetbets,VSTO,7,7,0,7,1,1,1,1,NYSE
4726,13-02-2021 10:00,24 hrs.,wallstreetbets,WORK,3168,7,3161,-3154,3,1321,514,3,NYSE
4726,13-02-2021 10:00,24 hrs.,wallstreetbets,XPEV,7,0,7,-7,1,1,1,1,NYSE
4726,13-02-2021 10:00,24 hrs.,wallstreetbets,YELP,7,0,7,-7,1,1,1,1,NYSE
4726,13-02-2021 10:00,24 hrs.,stocks,ITRM,15,6,9,-3,2,3,1,2,NASDAQ
4726,13-02-2021 10:00,24 hrs.,stocks,LITE,10,0,10,-10,1,2,2,1,NASDAQ
4726,13-02-2021 10:00,24 hrs.,stocks,LIVE,10,0,10,-10,1,2,2,1,NASDAQ
4726,13-02-2021 10:00,24 hrs.,stocks,LKCO,12,0,12,-12,2,2,0,1,NASDAQ
4726,13-02-2021 10:00,24 hrs.,stocks,LLNW,24,0,24,-24,1,5,10,1,NASDAQ
4726,13-02-2021 10:00,24 hrs.,stocks,LMPX,28,0,28,-28,1,11,2,1,NASDAQ
4726,13-02-2021 10:00,24 hrs.,stocks,LRCX,55,0,55,-55,1,10,31,1,NASDAQ
4726,13-02-2021 10:00,24 hrs.,stocks,MITK,6,6,0,6,1,1,0,1,NASDAQ
4726,13-02-2021 10:00,24 hrs.,stocks,MKSI,10,0,10,-10,1,2,2,1,NASDAQ
4726,13-02-2021 10:00,24 hrs.,stocks,MOGO,18,18,0,18,3,3,0,2,NASDAQ
4726,13-02-2021 10:00,24 hrs.,stocks,MRNA,6,6,0,6,1,1,0,1,NASDAQ
4726,13-02-2021 10:00,24 hrs.,stocks,MSFT,373,0,373,-373,1,164,41,1,NASDAQ
4726,13-02-2021 10:00,24 hrs.,stocks,NAKD,6,0,6,-6,1,1,0,1,NASDAQ
4726,13-02-2021 10:00,24 hrs.,stocks,NBAC,6,0,6,-6,1,1,0,1,NASDAQ
4726,13-02-2021 10:00,24 hrs.,stocks,NCMI,60,0,60,-60,2,22,8,1,NASDAQ
4726,13-02-2021 10:00,24 hrs.,stocks,NKLA,6,6,0,6,1,1,0,1,NASDAQ
4726,13-02-2021 10:00,24 hrs.,stocks,NMTR,9,0,9,-9,1,1,3,1,NASDAQ
4726,13-02-2021 10:00,24 hrs.,stocks,NVDA,102,6,96,-90,3,23,44,3,NASDAQ
4726,13-02-2021 10:00,24 hrs.,stocks,NXTD,12,0,12,-12,2,2,0,1,NASDAQ
4726,13-02-2021 10:00,24 hrs.,stocks,OCGN,6,6,0,6,1,1,0,1,NASDAQ
4726,13-02-2021 10:00,24 hrs.,stocks,OCSL,12,0,12,-12,2,2,0,1,NASDAQ
4726,13-02-2021 10:00,24 hrs.,stocks,OLED,117,0,117,-117,1,51,11,1,NASDAQ
4726,13-02-2021 10:00,24 hrs.,stocks,ONCR,7,7,0,7,1,1,1,1,NASDAQ
4726,13-02-2021 10:00,24 hrs.,stocks,ONTX,6,0,6,-6,1,1,0,1,NASDAQ
4726,13-02-2021 10:00,24 hrs.,stocks,ONVO,6,0,6,-6,1,1,0,1,NASDAQ
4726,13-02-2021 10:00,24 hrs.,stocks,PAAS,6,0,6,-6,1,1,0,1,NASDAQ
4726,13-02-2021 10:00,24 hrs.,stocks,PHUN,6,0,6,-6,1,1,0,1,NASDAQ
4726,13-02-2021 10:00,24 hrs.,stocks,PLUG,132,0,132,-132,2,21,82,2,NASDAQ
4726,13-02-2021 10:00,24 hrs.,stocks,PSTV,6,0,6,-6,1,1,0,1,NASDAQ
4726,13-02-2021 10:00,24 hrs.,stocks,QCLN,106,0,106,-106,1,31,40,1,NASDAQ
4726,13-02-2021 10:00,24 hrs.,stocks,QDEL,6,6,0,6,1,1,0,1,NASDAQ
4726,13-02-2021 10:00,24 hrs.,stocks,QFIN,6,6,0,6,1,1,0,1,NASDAQ
4726,13-02-2021 10:00,24 hrs.,stocks,QQQJ,31,31,0,31,1,4,19,1,NASDAQ
4726,13-02-2021 10:00,24 hrs.,stocks,QQQM,31,31,0,31,1,4,19,1,NASDAQ
4726,13-02-2021 10:00,24 hrs.,stocks,REGN,6,6,0,6,1,1,0,1,NASDAQ
4726,13-02-2021 10:00,24 hrs.,stocks,RRGB,25,25,0,25,1,6,9,1,NASDAQ
4726,13-02-2021 10:00,24 hrs.,stocks,SEDG,141,0,141,-141,1,43,51,1,NASDAQ
4726,13-02-2021 10:00,24 hrs.,stocks,SESN,7,0,7,-7,1,1,1,1,NASDAQ
4726,13-02-2021 10:00,24 hrs.,stocks,SHIP,11,0,11,-11,1,2,3,1,NASDAQ
4726,13-02-2021 10:00,24 hrs.,stocks,SNDL,30,0,30,-30,5,5,0,4,NASDAQ
4726,13-02-2021 10:00,24 hrs.,stocks,SNGX,25,13,12,1,4,4,1,4,NASDAQ
4726,13-02-2021 10:00,24 hrs.,stocks,SRAC,6,0,6,-6,1,1,0,1,NASDAQ
4726,13-02-2021 10:00,24 hrs.,stocks,SRNE,141,0,141,-141,1,43,51,1,NASDAQ
4726,13-02-2021 10:00,24 hrs.,stocks,SVMK,10,0,10,-10,1,2,2,1,NASDAQ
4726,13-02-2021 10:00,24 hrs.,stocks,SWKS,55,0,55,-55,1,10,31,1,NASDAQ
4726,13-02-2021 10:00,24 hrs.,stocks,TIGR,6,6,0,6,1,1,0,1,NASDAQ
4726,13-02-2021 10:00,24 hrs.,stocks,TLRY,822,0,822,-822,1,224,370,1,NASDAQ
4726,13-02-2021 10:00,24 hrs.,stocks,TRCH,13,6,7,-1,2,2,1,2,NASDAQ
4726,13-02-2021 10:00,24 hrs.,stocks,TRVG,12,6,6,0,2,2,0,2,NASDAQ
4726,13-02-2021 10:00,24 hrs.,stocks,TSLA,1085,41,1044,-1003,9,387,275,7,NASDAQ
4726,13-02-2021 10:00,24 hrs.,stocks,TTGT,6,6,0,6,1,1,0,1,NASDAQ
4726,13-02-2021 10:00,24 hrs.,stocks,VRNT,14,0,14,-14,1,3,4,1,NASDAQ
4726,13-02-2021 10:00,24 hrs.,stocks,VRSN,10,0,10,-10,1,2,2,1,NASDAQ
4726,13-02-2021 10:00,24 hrs.,stocks,VUZI,6,0,6,-6,1,1,0,1,NASDAQ
4726,13-02-2021 10:00,24 hrs.,stocks,VXRT,6,6,0,6,1,1,0,1,NASDAQ
4726,13-02-2021 10:00,24 hrs.,stocks,VXUS,31,21,10,11,2,8,7,2,NASDAQ
4726,13-02-2021 10:00,24 hrs.,stocks,WDAY,14,14,0,14,1,3,4,1,NASDAQ
4726,13-02-2021 10:00,24 hrs.,stocks,WISH,6,0,6,-6,1,1,0,1,NASDAQ
4726,13-02-2021 10:00,24 hrs.,stocks,XERS,6,0,6,-6,1,1,0,1,NASDAQ
4726,13-02-2021 10:00,24 hrs.,stocks,XONE,11,11,0,11,1,3,1,1,NASDAQ
4726,13-02-2021 10:00,24 hrs.,stocks,ZGNX,6,0,6,-6,1,1,0,1,NASDAQ
4726,13-02-2021 10:00,24 hrs.,wallstreetbets,TWO,7,0,7,-7,1,1,1,1,NYSE
4726,13-02-2021 10:00,24 hrs.,wallstreetbets,UBS,14,7,7,0,2,2,2,2,NYSE
4726,13-02-2021 10:00,24 hrs.,wallstreetbets,UNP,7,0,7,-7,1,1,1,1,NYSE
4726,13-02-2021 10:00,24 hrs.,stocks,AVGO,6,0,6,-6,1,1,0,1,NASDAQ
4726,13-02-2021 10:00,24 hrs.,stocks,BNGO,12,6,6,0,2,2,0,2,NASDAQ
4726,13-02-2021 10:00,24 hrs.,stocks,BYND,6,0,6,-6,1,1,0,1,NASDAQ
4726,13-02-2021 10:00,24 hrs.,stocks,CLVR,19,19,0,19,1,4,7,1,NASDAQ
4726,13-02-2021 10:00,24 hrs.,stocks,CMPS,6,6,0,6,1,1,0,1,NASDAQ
4726,13-02-2021 10:00,24 hrs.,stocks,COHR,10,0,10,-10,1,2,2,1,NASDAQ
4726,13-02-2021 10:00,24 hrs.,stocks,CPST,6,0,6,-6,1,1,0,1,NASDAQ
4726,13-02-2021 10:00,24 hrs.,stocks,CRBP,7,7,0,7,1,1,1,1,NASDAQ
4726,13-02-2021 10:00,24 hrs.,stocks,CREG,6,6,0,6,1,1,0,1,NASDAQ
4726,13-02-2021 10:00,24 hrs.,stocks,CRNC,19,19,0,19,1,3,9,1,NASDAQ
4726,13-02-2021 10:00,24 hrs.,stocks,CRON,76,76,0,76,1,22,28,1,NASDAQ
4726,13-02-2021 10:00,24 hrs.,stocks,CRSP,141,0,141,-141,1,43,51,1,NASDAQ
4726,13-02-2021 10:00,24 hrs.,stocks,CRWD,141,0,141,-141,1,43,51,1,NASDAQ
4726,13-02-2021 10:00,24 hrs.,stocks,CTRM,13,0,13,-13,2,2,1,2,NASDAQ
4726,13-02-2021 10:00,24 hrs.,stocks,CVLB,6,0,6,-6,1,1,0,1,NASDAQ
4726,13-02-2021 10:00,24 hrs.,stocks,DDOG,10,0,10,-10,1,2,2,1,NASDAQ
4726,13-02-2021 10:00,24 hrs.,stocks,DFFN,6,0,6,-6,1,1,0,1,NASDAQ
4726,13-02-2021 10:00,24 hrs.,stocks,DOCU,6,0,6,-6,1,1,0,1,NASDAQ
4726,13-02-2021 10:00,24 hrs.,stocks,EDIT,569,48,521,-473,5,183,183,5,NASDAQ
4726,13-02-2021 10:00,24 hrs.,stocks,ENPH,141,0,141,-141,1,43,51,1,NASDAQ
4726,13-02-2021 10:00,24 hrs.,stocks,EXPE,10,0,10,-10,1,2,2,1,NASDAQ
4726,13-02-2021 10:00,24 hrs.,stocks,EXPI,12,6,6,0,2,2,0,2,NASDAQ
4726,13-02-2021 10:00,24 hrs.,stocks,FNKO,28,0,28,-28,1,11,2,1,NASDAQ
4726,13-02-2021 10:00,24 hrs.,stocks,GILT,6,0,6,-6,1,1,0,1,NASDAQ
4726,13-02-2021 10:00,24 hrs.,stocks,GLUU,13,6,7,-1,2,2,1,2,NASDAQ
4726,13-02-2021 10:00,24 hrs.,stocks,GOEV,126,0,126,-126,1,20,82,1,NASDAQ
4726,13-02-2021 10:00,24 hrs.,stocks,ICLN,106,0,106,-106,1,31,40,1,NASDAQ
4726,13-02-2021 10:00,24 hrs.,stocks,IIVI,10,0,10,-10,1,2,2,1,NASDAQ
4726,13-02-2021 10:00,24 hrs.,stocks,ILMN,22,0,22,-22,1,8,2,1,NASDAQ
4726,13-02-2021 10:00,24 hrs.,stocks,INTC,104,0,104,-104,1,33,34,1,NASDAQ
4726,13-02-2021 10:00,24 hrs.,stocks,INVE,7,0,7,-7,1,1,1,1,NASDAQ
4726,13-02-2021 10:00,24 hrs.,RobinHoodPennyStocks,TRX,38,0,38,-38,1,9,16,1,AMEX
4726,13-02-2021 10:00,24 hrs.,RobinHoodPennyStocks,XPL,6,6,0,6,1,1,0,1,AMEX
4726,13-02-2021 10:00,24 hrs.,RobinHoodPennyStocks,ZOM,1315,100,1215,-1115,11,489,293,10,AMEX
4726,13-02-2021 10:00,24 hrs.,RobinHoodPennyStocks,IBIO,39,0,39,-39,1,15,5,1,AMEX
4726,13-02-2021 10:00,24 hrs.,RobinHoodPennyStocks,NSPR,28,0,28,-28,1,7,10,1,AMEX
4726,13-02-2021 10:00,24 hrs.,RobinHoodPennyStocks,OGEN,18,0,18,-18,3,3,0,3,AMEX
4726,13-02-2021 10:00,24 hrs.,RobinHoodPennyStocks,SENS,61,0,61,-61,3,22,5,3,AMEX
4726,13-02-2021 10:00,24 hrs.,RobinHoodPennyStocks,TRXC,6,0,6,-6,1,1,0,1,AMEX
4726,13-02-2021 10:00,24 hrs.,RobinHoodPennyStocks,AIV,6,0,6,-6,1,1,0,1,NYSE
4726,13-02-2021 10:00,24 hrs.,RobinHoodPennyStocks,DNK,6,6,0,6,1,1,0,1,NYSE
4726,13-02-2021 10:00,24 hrs.,RobinHoodPennyStocks,ETN,6,6,0,6,1,1,0,1,NYSE
4726,13-02-2021 10:00,24 hrs.,RobinHoodPennyStocks,FSR,6,0,6,-6,1,1,0,1,NYSE
4726,13-02-2021 10:00,24 hrs.,RobinHoodPennyStocks,GME,59,13,46,-33,2,14,23,2,NYSE
4726,13-02-2021 10:00,24 hrs.,RobinHoodPennyStocks,IRS,334,0,334,-334,1,151,28,1,NYSE
4726,13-02-2021 10:00,24 hrs.,RobinHoodPennyStocks,MRO,6,6,0,6,1,1,0,1,NYSE
4726,13-02-2021 10:00,24 hrs.,RobinHoodPennyStocks,MTL,19,0,19,-19,2,2,7,2,NYSE
4726,13-02-2021 10:00,24 hrs.,RobinHoodPennyStocks,NAT,6,0,6,-6,1,1,0,1,NYSE
4726,13-02-2021 10:00,24 hrs.,RobinHoodPennyStocks,NBB,6,6,0,6,1,1,0,1,NYSE
4726,13-02-2021 10:00,24 hrs.,RobinHoodPennyStocks,PHI,6,0,6,-6,1,1,0,1,NYSE
4726,13-02-2021 10:00,24 hrs.,RobinHoodPennyStocks,SOS,98,43,55,-12,3,21,44,3,NYSE
4726,13-02-2021 10:00,24 hrs.,RobinHoodPennyStocks,CCIV,42,0,42,-42,1,12,14,1,NYSE
4726,13-02-2021 10:00,24 hrs.,RobinHoodPennyStocks,PLTR,6,0,6,-6,1,1,0,1,NYSE
4726,13-02-2021 10:00,24 hrs.,RobinHoodPennyStocks,BBI,6,0,6,-6,1,1,0,1,NASDAQ
4726,13-02-2021 10:00,24 hrs.,RobinHoodPennyStocks,JFU,6,6,0,6,1,1,0,1,NASDAQ
4726,13-02-2021 10:00,24 hrs.,RobinHoodPennyStocks,OGI,6,0,6,-6,1,1,0,1,NASDAQ
4726,13-02-2021 10:00,24 hrs.,RobinHoodPennyStocks,SND,36,0,36,-36,4,8,4,2,NASDAQ
4726,13-02-2021 10:00,24 hrs.,RobinHoodPennyStocks,ABEO,190,0,190,-190,3,63,52,3,NASDAQ
4726,13-02-2021 10:00,24 hrs.,RobinHoodPennyStocks,ACRX,24,0,24,-24,1,8,4,1,NASDAQ
4726,13-02-2021 10:00,24 hrs.,RobinHoodPennyStocks,ACST,6,0,6,-6,1,1,0,1,NASDAQ
4726,13-02-2021 10:00,24 hrs.,RobinHoodPennyStocks,ADXS,18,0,18,-18,3,3,0,2,NASDAQ
4726,13-02-2021 10:00,24 hrs.,RobinHoodPennyStocks,AEZS,139,139,0,139,1,56,23,1,NASDAQ
4726,13-02-2021 10:00,24 hrs.,RobinHoodPennyStocks,AGTC,1321,130,1191,-1061,16,478,301,15,NASDAQ
4726,13-02-2021 10:00,24 hrs.,RobinHoodPennyStocks,APHA,12,0,12,-12,2,2,0,1,NASDAQ
4726,13-02-2021 10:00,24 hrs.,RobinHoodPennyStocks,ARPO,6,0,6,-6,1,1,0,1,NASDAQ
4726,13-02-2021 10:00,24 hrs.,RobinHoodPennyStocks,ARTL,18,0,18,-18,3,3,0,3,NASDAQ
4726,13-02-2021 10:00,24 hrs.,RobinHoodPennyStocks,ASRT,87,42,45,-3,4,32,7,3,NASDAQ
4726,13-02-2021 10:00,24 hrs.,RobinHoodPennyStocks,ATOS,520,0,520,-520,12,190,92,12,NASDAQ
4726,13-02-2021 10:00,24 hrs.,RobinHoodPennyStocks,BHTG,65,0,65,-65,2,20,17,2,NASDAQ
4726,13-02-2021 10:00,24 hrs.,RobinHoodPennyStocks,BIOL,6,0,6,-6,1,1,0,1,NASDAQ
4726,13-02-2021 10:00,24 hrs.,RobinHoodPennyStocks,BNGO,48,6,42,-36,4,12,8,4,NASDAQ
4726,13-02-2021 10:00,24 hrs.,RobinHoodPennyStocks,BRQS,33,0,33,-33,2,6,13,2,NASDAQ
4726,13-02-2021 10:00,24 hrs.,RobinHoodPennyStocks,CDTX,6,0,6,-6,1,1,0,1,NASDAQ
4726,13-02-2021 10:00,24 hrs.,RobinHoodPennyStocks,CIDM,98,98,0,98,2,20,50,2,NASDAQ
4726,13-02-2021 10:00,24 hrs.,RobinHoodPennyStocks,CKPT,65,0,65,-65,2,21,15,2,NASDAQ
4726,13-02-2021 10:00,24 hrs.,RobinHoodPennyStocks,CLBS,32,26,6,20,3,9,2,3,NASDAQ
4726,13-02-2021 10:00,24 hrs.,RobinHoodPennyStocks,CRBP,21,21,0,21,1,6,5,1,NASDAQ
4726,13-02-2021 10:00,24 hrs.,stocks,SPCE,171,30,141,-111,2,50,63,2,NYSE
4726,13-02-2021 10:00,24 hrs.,stocks,TWLO,16,16,0,16,2,1,6,1,NYSE
4726,13-02-2021 10:00,24 hrs.,stocks,TWTR,6,6,0,6,1,1,0,1,NYSE
4726,13-02-2021 10:00,24 hrs.,stocks,VGAC,6,0,6,-6,1,1,0,1,NYSE
4726,13-02-2021 10:00,24 hrs.,stocks,XPEV,85,0,85,-85,5,12,41,2,NYSE
4726,13-02-2021 10:00,24 hrs.,stocks,AMD,61,6,55,-49,2,11,31,2,NASDAQ
4726,13-02-2021 10:00,24 hrs.,stocks,AZN,10,0,10,-10,1,2,2,1,NASDAQ
4726,13-02-2021 10:00,24 hrs.,stocks,CDC,10,0,10,-10,1,2,2,1,NASDAQ
4726,13-02-2021 10:00,24 hrs.,stocks,FTC,31,0,31,-31,1,9,9,1,NASDAQ
4726,13-02-2021 10:00,24 hrs.,stocks,GAN,7,0,7,-7,1,1,1,1,NASDAQ
4726,13-02-2021 10:00,24 hrs.,stocks,GSM,67,0,67,-67,2,20,19,1,NASDAQ
4726,13-02-2021 10:00,24 hrs.,stocks,IEA,16,0,16,-16,1,3,6,1,NASDAQ
4726,13-02-2021 10:00,24 hrs.,stocks,INO,6,0,6,-6,1,1,0,1,NASDAQ
4726,13-02-2021 10:00,24 hrs.,stocks,NWL,10,0,10,-10,1,2,2,1,NASDAQ
4726,13-02-2021 10:00,24 hrs.,stocks,OGI,12,0,12,-12,2,2,0,2,NASDAQ
4726,13-02-2021 10:00,24 hrs.,stocks,PEP,34,0,34,-34,1,8,14,1,NASDAQ
4726,13-02-2021 10:00,24 hrs.,stocks,SMH,31,31,0,31,1,4,19,1,NASDAQ
4726,13-02-2021 10:00,24 hrs.,stocks,SPI,6,6,0,6,1,1,0,1,NASDAQ
4726,13-02-2021 10:00,24 hrs.,stocks,WBA,21,0,21,-21,1,6,5,1,NASDAQ
4726,13-02-2021 10:00,24 hrs.,stocks,ABUS,6,0,6,-6,1,1,0,1,NASDAQ
4726,13-02-2021 10:00,24 hrs.,stocks,AESE,6,6,0,6,1,1,0,1,NASDAQ
4726,13-02-2021 10:00,24 hrs.,stocks,AEZS,195,0,195,-195,1,86,19,1,NASDAQ
4726,13-02-2021 10:00,24 hrs.,stocks,AGEN,10,0,10,-10,1,3,0,1,NASDAQ
4726,13-02-2021 10:00,24 hrs.,stocks,AGTC,12,0,12,-12,2,2,0,1,NASDAQ
4726,13-02-2021 10:00,24 hrs.,stocks,AMAT,11,11,0,11,1,1,5,1,NASDAQ
4726,13-02-2021 10:00,24 hrs.,stocks,AMZN,157,16,141,-125,2,45,59,2,NASDAQ
4726,13-02-2021 10:00,24 hrs.,stocks,ANTE,12,12,0,12,2,2,0,1,NASDAQ
4726,13-02-2021 10:00,24 hrs.,stocks,APHA,912,0,912,-912,4,236,424,4,NASDAQ
4726,13-02-2021 10:00,24 hrs.,stocks,ARTL,18,0,18,-18,3,3,0,2,NASDAQ
4726,13-02-2021 10:00,24 hrs.,stocks,ASYS,6,0,6,-6,1,1,0,1,NASDAQ
4726,13-02-2021 10:00,24 hrs.,stocks,ATOS,195,0,195,-195,1,86,19,1,NASDAQ
4726,13-02-2021 10:00,24 hrs.,wallstreetbets,GOOGL,6,0,6,-6,1,1,0,1,NASDAQ
4726,13-02-2021 10:00,24 hrs.,wallstreetbets,SRACU,6,0,6,-6,1,1,0,1,NASDAQ
4726,13-02-2021 10:00,24 hrs.,wallstreetbets,SRACW,6,0,6,-6,1,1,0,1,NASDAQ
4726,13-02-2021 10:00,24 hrs.,RobinHoodPennyStocks,BGMD,4,0,4,-4,1,0,0,1,OTC
4726,13-02-2021 10:00,24 hrs.,RobinHoodPennyStocks,BLXX,6,0,6,-6,1,1,0,1,OTC
4726,13-02-2021 10:00,24 hrs.,RobinHoodPennyStocks,CBDD,6,0,6,-6,1,1,0,1,OTC
4726,13-02-2021 10:00,24 hrs.,RobinHoodPennyStocks,CRWG,6,6,0,6,1,1,0,1,OTC
4726,13-02-2021 10:00,24 hrs.,RobinHoodPennyStocks,GLEC,6,0,6,-6,1,1,0,1,OTC
4726,13-02-2021 10:00,24 hrs.,RobinHoodPennyStocks,GPFT,34,6,28,-22,5,5,4,3,OTC
4726,13-02-2021 10:00,24 hrs.,RobinHoodPennyStocks,GSPH,6,0,6,-6,1,1,0,1,OTC
4726,13-02-2021 10:00,24 hrs.,RobinHoodPennyStocks,GTLL,6,6,0,6,1,1,0,1,OTC
4726,13-02-2021 10:00,24 hrs.,RobinHoodPennyStocks,HCMC,12,0,12,-12,2,2,0,2,OTC
4726,13-02-2021 10:00,24 hrs.,RobinHoodPennyStocks,INKW,6,0,6,-6,1,1,0,1,OTC
4726,13-02-2021 10:00,24 hrs.,RobinHoodPennyStocks,LTUM,6,0,6,-6,1,1,0,1,OTC
4726,13-02-2021 10:00,24 hrs.,RobinHoodPennyStocks,MJNA,6,0,6,-6,1,1,0,1,OTC
4726,13-02-2021 10:00,24 hrs.,RobinHoodPennyStocks,NUUU,6,6,0,6,1,1,0,1,OTC
4726,13-02-2021 10:00,24 hrs.,RobinHoodPennyStocks,PHIL,6,0,6,-6,1,1,0,1,OTC
4726,13-02-2021 10:00,24 hrs.,RobinHoodPennyStocks,ALLIF,6,6,0,6,1,1,0,1,OTC
4726,13-02-2021 10:00,24 hrs.,RobinHoodPennyStocks,BDRBF,12,0,12,-12,2,2,0,2,OTC
4726,13-02-2021 10:00,24 hrs.,RobinHoodPennyStocks,MMEDF,19,19,0,19,1,5,5,1,OTC
4726,13-02-2021 10:00,24 hrs.,RobinHoodPennyStocks,NXTTF,6,0,6,-6,1,1,0,1,OTC
4726,13-02-2021 10:00,24 hrs.,RobinHoodPennyStocks,PMEDF,6,0,6,-6,1,1,0,1,OTC
4726,13-02-2021 10:00,24 hrs.,RobinHoodPennyStocks,RYCEY,18,0,18,-18,3,3,0,3,OTC
4726,13-02-2021 10:00,24 hrs.,RobinHoodPennyStocks,SHCAY,19,0,19,-19,1,7,1,1,OTC
4726,13-02-2021 10:00,24 hrs.,RobinHoodPennyStocks,ZBISF,6,0,6,-6,1,1,0,1,OTC
4726,13-02-2021 10:00,24 hrs.,RobinHoodPennyStocks,DNN,126,114,12,102,4,45,20,4,AMEX
4726,13-02-2021 10:00,24 hrs.,RobinHoodPennyStocks,DPW,23,23,0,23,1,5,9,1,AMEX
4726,13-02-2021 10:00,24 hrs.,RobinHoodPennyStocks,GSV,12,6,6,0,2,2,0,2,AMEX
4726,13-02-2021 10:00,24 hrs.,RobinHoodPennyStocks,GTE,663,56,607,-551,15,186,231,15,AMEX
4726,13-02-2021 10:00,24 hrs.,RobinHoodPennyStocks,ITP,6,0,6,-6,1,1,0,1,AMEX
4726,13-02-2021 10:00,24 hrs.,RobinHoodPennyStocks,NAK,89,0,89,-89,6,17,31,6,AMEX
4726,13-02-2021 10:00,24 hrs.,RobinHoodPennyStocks,REI,24,6,18,-12,2,6,4,2,AMEX
4726,13-02-2021 10:00,24 hrs.,RobinHoodPennyStocks,SYN,6,0,6,-6,1,1,0,1,AMEX
4726,13-02-2021 10:00,24 hrs.,stocks,IGC,6,0,6,-6,1,1,0,1,AMEX
4726,13-02-2021 10:00,24 hrs.,stocks,MXC,6,0,6,-6,1,1,0,1,AMEX
4726,13-02-2021 10:00,24 hrs.,stocks,PLX,13,0,13,-13,1,2,5,1,AMEX
4726,13-02-2021 10:00,24 hrs.,stocks,ZOM,12,6,6,0,2,2,0,2,AMEX
4726,13-02-2021 10:00,24 hrs.,stocks,GSAT,24,18,6,12,4,4,0,2,AMEX
4726,13-02-2021 10:00,24 hrs.,stocks,SENS,6,6,0,6,1,1,0,1,AMEX
4726,13-02-2021 10:00,24 hrs.,stocks,TMBR,6,0,6,-6,1,1,0,1,AMEX
4726,13-02-2021 10:00,24 hrs.,stocks,ADT,6,0,6,-6,1,1,0,1,NYSE
4726,13-02-2021 10:00,24 hrs.,stocks,AMC,118,0,118,-118,5,23,52,5,NYSE
4726,13-02-2021 10:00,24 hrs.,stocks,ASX,13,6,7,-1,2,2,1,2,NYSE
4726,13-02-2021 10:00,24 hrs.,stocks,BEP,212,0,212,-212,5,48,96,5,NYSE
4726,13-02-2021 10:00,24 hrs.,stocks,BHC,10,0,10,-10,1,2,2,1,NYSE
4726,13-02-2021 10:00,24 hrs.,stocks,CBD,6,0,6,-6,1,1,0,1,NYSE
4726,13-02-2021 10:00,24 hrs.,stocks,CRM,6,0,6,-6,1,1,0,1,NYSE
4726,13-02-2021 10:00,24 hrs.,stocks,CVE,6,0,6,-6,1,1,0,1,NYSE
4726,13-02-2021 10:00,24 hrs.,stocks,CVS,38,0,38,-38,3,8,10,3,NYSE
4726,13-02-2021 10:00,24 hrs.,stocks,DIS,10,0,10,-10,1,2,2,1,NYSE
4726,13-02-2021 10:00,24 hrs.,stocks,DPG,11,11,0,11,1,3,1,1,NYSE
4726,13-02-2021 10:00,24 hrs.,stocks,ETH,6,0,6,-6,1,1,0,1,NYSE
4726,13-02-2021 10:00,24 hrs.,stocks,FSR,6,0,6,-6,1,1,0,1,NYSE
4726,13-02-2021 10:00,24 hrs.,stocks,GME,1294,57,1237,-1180,12,521,204,12,NYSE
4726,13-02-2021 10:00,24 hrs.,stocks,IBM,373,0,373,-373,1,164,41,1,NYSE
4726,13-02-2021 10:00,24 hrs.,stocks,IRS,20,14,6,8,2,2,8,2,NYSE
4726,13-02-2021 10:00,24 hrs.,stocks,JNJ,6,6,0,6,1,1,0,1,NYSE
4726,13-02-2021 10:00,24 hrs.,stocks,LOW,14,14,0,14,1,1,8,1,NYSE
4726,13-02-2021 10:00,24 hrs.,stocks,MCO,10,0,10,-10,1,2,2,1,NYSE
4726,13-02-2021 10:00,24 hrs.,stocks,MGM,11,0,11,-11,1,1,5,1,NYSE
4726,13-02-2021 10:00,24 hrs.,stocks,MRO,10,0,10,-10,1,2,2,1,NYSE
4726,13-02-2021 10:00,24 hrs.,stocks,NET,25,14,11,3,2,2,13,2,NYSE
4726,13-02-2021 10:00,24 hrs.,stocks,NGL,6,0,6,-6,1,1,0,1,NYSE
4726,13-02-2021 10:00,24 hrs.,stocks,NIO,868,36,832,-796,9,265,302,6,NYSE
4726,13-02-2021 10:00,24 hrs.,stocks,NOK,139,0,139,-139,3,22,83,3,NYSE
4726,13-02-2021 10:00,24 hrs.,stocks,NOM,70,0,70,-70,1,24,18,1,NYSE
4726,13-02-2021 10:00,24 hrs.,stocks,OSK,16,16,0,16,2,1,6,1,NYSE
4726,13-02-2021 10:00,24 hrs.,stocks,PEG,572,0,572,-572,1,39,490,1,NYSE
4726,13-02-2021 10:00,24 hrs.,stocks,PFE,7,0,7,-7,1,1,1,1,NYSE
4726,13-02-2021 10:00,24 hrs.,stocks,RAD,21,0,21,-21,1,6,5,1,NYSE
4726,13-02-2021 10:00,24 hrs.,stocks,RDY,6,0,6,-6,1,1,0,1,NYSE
4726,13-02-2021 10:00,24 hrs.,stocks,RTX,40,0,40,-40,1,11,14,1,NYSE
4726,13-02-2021 10:00,24 hrs.,stocks,SOS,12,0,12,-12,2,2,0,2,NYSE
4726,13-02-2021 10:00,24 hrs.,stocks,SQZ,7,7,0,7,1,1,1,1,NYSE
4726,13-02-2021 10:00,24 hrs.,stocks,SUP,6,0,6,-6,1,1,0,1,NYSE
4726,13-02-2021 10:00,24 hrs.,stocks,TDA,7,7,0,7,1,1,1,1,NYSE
4726,13-02-2021 10:00,24 hrs.,stocks,TSM,55,0,55,-55,1,10,31,1,NYSE
4726,13-02-2021 10:00,24 hrs.,stocks,UBS,32255,0,32255,-32255,1,15765,721,1,NYSE
4726,13-02-2021 10:00,24 hrs.,stocks,WLL,6,0,6,-6,1,1,0,1,NYSE
4726,13-02-2021 10:00,24 hrs.,stocks,WMT,141,0,141,-141,1,43,51,1,NYSE
4726,13-02-2021 10:00,24 hrs.,stocks,AJRD,141,0,141,-141,1,43,51,1,NYSE
4726,13-02-2021 10:00,24 hrs.,stocks,APTV,141,0,141,-141,1,43,51,1,NYSE
4726,13-02-2021 10:00,24 hrs.,stocks,BABA,6,6,0,6,1,1,0,1,NYSE
4726,13-02-2021 10:00,24 hrs.,stocks,BEPC,38,0,38,-38,2,5,20,2,NYSE
4726,13-02-2021 10:00,24 hrs.,stocks,BORR,52,0,52,-52,3,13,14,3,NYSE
4726,13-02-2021 10:00,24 hrs.,stocks,CCIV,18,12,6,6,3,3,0,3,NYSE
4726,13-02-2021 10:00,24 hrs.,stocks,CHWY,24,0,24,-24,1,5,10,1,NYSE
4726,13-02-2021 10:00,24 hrs.,stocks,COTY,6,0,6,-6,1,1,0,1,NYSE
4726,13-02-2021 10:00,24 hrs.,stocks,DASH,6,6,0,6,1,1,0,1,NYSE
4726,13-02-2021 10:00,24 hrs.,stocks,FUSE,6,0,6,-6,1,1,0,1,NYSE
4726,13-02-2021 10:00,24 hrs.,stocks,HEXO,6,0,6,-6,1,1,0,1,NYSE
4726,13-02-2021 10:00,24 hrs.,stocks,HOME,24,0,24,-24,1,5,10,1,NYSE
4726,13-02-2021 10:00,24 hrs.,stocks,HUYA,95,6,89,-83,2,32,23,2,NYSE
4726,13-02-2021 10:00,24 hrs.,stocks,JMIA,6,0,6,-6,1,1,0,1,NYSE
4726,13-02-2021 10:00,24 hrs.,stocks,PLTR,599,135,464,-329,3,209,169,3,NYSE
4726,13-02-2021 10:00,24 hrs.,stocks,SHOP,74,74,0,74,1,17,36,1,NYSE
4726,13-02-2021 10:00,24 hrs.,wallstreetbets,TXMD,29,0,29,-29,4,4,5,4,NASDAQ
4726,13-02-2021 10:00,24 hrs.,wallstreetbets,UNFI,368,0,368,-368,1,168,28,1,NASDAQ
4726,13-02-2021 10:00,24 hrs.,wallstreetbets,VEON,6,0,6,-6,1,1,0,1,NASDAQ
4726,13-02-2021 10:00,24 hrs.,wallstreetbets,VERU,7,0,7,-7,1,1,1,1,NASDAQ
4726,13-02-2021 10:00,24 hrs.,wallstreetbets,VISL,7,0,7,-7,1,1,1,1,NASDAQ
4726,13-02-2021 10:00,24 hrs.,wallstreetbets,VIVO,7,7,0,7,1,1,1,1,NASDAQ
4726,13-02-2021 10:00,24 hrs.,wallstreetbets,VKTX,7,0,7,-7,1,1,1,1,NASDAQ
4726,13-02-2021 10:00,24 hrs.,wallstreetbets,VLDR,7,0,7,-7,1,1,1,1,NASDAQ
4726,13-02-2021 10:00,24 hrs.,wallstreetbets,VOXX,6,6,0,6,1,1,0,1,NASDAQ
4726,13-02-2021 10:00,24 hrs.,wallstreetbets,VRSN,429,0,429,-429,1,175,75,1,NASDAQ
4726,13-02-2021 10:00,24 hrs.,wallstreetbets,VSAT,14,0,14,-14,2,2,2,1,NASDAQ
4726,13-02-2021 10:00,24 hrs.,wallstreetbets,VTGN,7,7,0,7,1,1,1,1,NASDAQ
4726,13-02-2021 10:00,24 hrs.,wallstreetbets,VUZI,21,21,0,21,3,3,3,1,NASDAQ
4726,13-02-2021 10:00,24 hrs.,wallstreetbets,VXRT,28,7,21,-14,4,4,4,4,NASDAQ
4726,13-02-2021 10:00,24 hrs.,wallstreetbets,WATT,7,0,7,-7,1,1,1,1,NASDAQ
4726,13-02-2021 10:00,24 hrs.,wallstreetbets,WKHS,7998,20,7978,-7958,5,3654,670,4,NASDAQ
4726,13-02-2021 10:00,24 hrs.,wallstreetbets,WRAP,7,0,7,-7,1,1,1,1,NASDAQ
4726,13-02-2021 10:00,24 hrs.,wallstreetbets,WSBC,8,8,0,8,1,1,2,1,NASDAQ
4726,13-02-2021 10:00,24 hrs.,wallstreetbets,XENE,14,0,14,-14,2,2,2,1,NASDAQ
4726,13-02-2021 10:00,24 hrs.,wallstreetbets,XERS,15,0,15,-15,2,2,3,2,NASDAQ
4726,13-02-2021 10:00,24 hrs.,wallstreetbets,XNET,14,0,14,-14,2,2,2,1,NASDAQ
4726,13-02-2021 10:00,24 hrs.,wallstreetbets,XSPA,58,24,34,-10,9,9,4,8,NASDAQ
4726,13-02-2021 10:00,24 hrs.,wallstreetbets,ZNGA,15,8,7,1,2,2,3,2,NASDAQ
4726,13-02-2021 10:00,24 hrs.,wallstreetbets,ZYNE,7,0,7,-7,1,1,1,1,NASDAQ
4726,13-02-2021 10:00,24 hrs.,wallstreetbets,CMCSA,7,0,7,-7,1,1,1,1,NASDAQ
4726,13-02-2021 10:00,24 hrs.,stocks,RHHBY,34,0,34,-34,1,11,8,1,OTC
4726,13-02-2021 10:00,24 hrs.,stocks,RLLCF,6,0,6,-6,1,1,0,1,OTC
4726,13-02-2021 10:00,24 hrs.,stocks,RVVTF,13,0,13,-13,2,2,1,2,OTC
4726,13-02-2021 10:00,24 hrs.,stocks,TBUIF,6,6,0,6,1,1,0,1,OTC
4726,13-02-2021 10:00,24 hrs.,stocks,DNN,33,33,0,33,1,8,13,1,AMEX
4726,13-02-2021 10:00,24 hrs.,stocks,DSS,6,0,6,-6,1,1,0,1,AMEX
4726,13-02-2021 10:00,24 hrs.,stocks,GTE,13,7,6,1,2,2,1,2,AMEX
4726,13-02-2021 10:00,24 hrs.,wallstreetbets,PTCT,7,0,7,-7,1,1,1,1,NASDAQ
4726,13-02-2021 10:00,24 hrs.,wallstreetbets,PTON,6023,0,6023,-6023,5,2828,347,1,NASDAQ
4726,13-02-2021 10:00,24 hrs.,wallstreetbets,QCOM,7,0,7,-7,1,1,1,1,NASDAQ
4726,13-02-2021 10:00,24 hrs.,wallstreetbets,QFIN,7,7,0,7,1,1,1,1,NASDAQ
4726,13-02-2021 10:00,24 hrs.,wallstreetbets,QQQJ,22,0,22,-22,1,6,6,1,NASDAQ
4726,13-02-2021 10:00,24 hrs.,wallstreetbets,QUIK,13,0,13,-13,2,2,1,2,NASDAQ
4726,13-02-2021 10:00,24 hrs.,wallstreetbets,RAVE,14,0,14,-14,2,2,2,2,NASDAQ
4726,13-02-2021 10:00,24 hrs.,wallstreetbets,RDHL,13,0,13,-13,2,2,1,2,NASDAQ
4726,13-02-2021 10:00,24 hrs.,wallstreetbets,REAL,223,88,135,-47,4,44,119,4,NASDAQ
4726,13-02-2021 10:00,24 hrs.,wallstreetbets,REGI,7,7,0,7,1,1,1,1,NASDAQ
4726,13-02-2021 10:00,24 hrs.,wallstreetbets,REGN,35,14,21,-7,5,5,5,3,NASDAQ
4726,13-02-2021 10:00,24 hrs.,wallstreetbets,RIDE,89,0,89,-89,13,13,11,10,NASDAQ
4726,13-02-2021 10:00,24 hrs.,wallstreetbets,RIOT,6114,12,6102,-6090,18,2841,360,13,NASDAQ
4726,13-02-2021 10:00,24 hrs.,wallstreetbets,RKDA,7,0,7,-7,1,1,1,1,NASDAQ
4726,13-02-2021 10:00,24 hrs.,wallstreetbets,ROKU,13,7,6,1,2,2,1,2,NASDAQ
4726,13-02-2021 10:00,24 hrs.,wallstreetbets,ROOT,14,0,14,-14,2,2,2,1,NASDAQ
4726,13-02-2021 10:00,24 hrs.,wallstreetbets,RWLK,21,0,21,-21,3,3,3,3,NASDAQ
4726,13-02-2021 10:00,24 hrs.,wallstreetbets,SAVA,7,0,7,-7,1,1,1,1,NASDAQ
4726,13-02-2021 10:00,24 hrs.,wallstreetbets,SAVE,7,0,7,-7,1,1,1,1,NASDAQ
4726,13-02-2021 10:00,24 hrs.,wallstreetbets,SBUX,7,0,7,-7,1,1,1,1,NASDAQ
4726,13-02-2021 10:00,24 hrs.,wallstreetbets,SEAC,7,0,7,-7,1,1,1,1,NASDAQ
4726,13-02-2021 10:00,24 hrs.,wallstreetbets,SEEL,7,0,7,-7,1,1,1,1,NASDAQ
4726,13-02-2021 10:00,24 hrs.,wallstreetbets,SHIP,151,20,131,-111,22,22,19,17,NASDAQ
4726,13-02-2021 10:00,24 hrs.,wallstreetbets,SIRI,7,0,7,-7,1,1,1,1,NASDAQ
4726,13-02-2021 10:00,24 hrs.,wallstreetbets,SLRX,7,0,7,-7,1,1,1,1,NASDAQ
4726,13-02-2021 10:00,24 hrs.,wallstreetbets,SNCA,6,0,6,-6,1,1,0,1,NASDAQ
4726,13-02-2021 10:00,24 hrs.,wallstreetbets,SNDL,2491,252,2239,-1987,206,543,581,168,NASDAQ
4726,13-02-2021 10:00,24 hrs.,wallstreetbets,SNGX,34,26,8,18,5,5,4,4,NASDAQ
4726,13-02-2021 10:00,24 hrs.,wallstreetbets,SQQQ,7,0,7,-7,1,1,1,1,NASDAQ
4726,13-02-2021 10:00,24 hrs.,wallstreetbets,SRAC,13,7,6,1,2,2,1,2,NASDAQ
4726,13-02-2021 10:00,24 hrs.,wallstreetbets,SRGA,7,0,7,-7,1,1,1,1,NASDAQ
4726,13-02-2021 10:00,24 hrs.,wallstreetbets,SRNE,14,7,7,0,2,2,2,2,NASDAQ
4726,13-02-2021 10:00,24 hrs.,wallstreetbets,SSRM,6,6,0,6,1,1,0,1,NASDAQ
4726,13-02-2021 10:00,24 hrs.,wallstreetbets,STAF,20,13,7,6,3,3,2,3,NASDAQ
4726,13-02-2021 10:00,24 hrs.,wallstreetbets,STAY,12,6,6,0,2,2,0,2,NASDAQ
4726,13-02-2021 10:00,24 hrs.,wallstreetbets,STEP,16,0,16,-16,1,0,12,1,NASDAQ
4726,13-02-2021 10:00,24 hrs.,wallstreetbets,STLD,7,0,7,-7,1,1,1,1,NASDAQ
4726,13-02-2021 10:00,24 hrs.,wallstreetbets,SVMK,429,0,429,-429,1,175,75,1,NASDAQ
4726,13-02-2021 10:00,24 hrs.,wallstreetbets,SWBI,28,21,7,14,4,4,4,3,NASDAQ
4726,13-02-2021 10:00,24 hrs.,wallstreetbets,SWKS,513,0,513,-513,1,135,239,1,NASDAQ
4726,13-02-2021 10:00,24 hrs.,wallstreetbets,TECH,7,7,0,7,1,1,1,1,NASDAQ
4726,13-02-2021 10:00,24 hrs.,wallstreetbets,TELL,13,0,13,-13,2,2,1,2,NASDAQ
4726,13-02-2021 10:00,24 hrs.,wallstreetbets,THCB,6,0,6,-6,1,1,0,1,NASDAQ
4726,13-02-2021 10:00,24 hrs.,wallstreetbets,THMO,13,0,13,-13,2,2,1,1,NASDAQ
4726,13-02-2021 10:00,24 hrs.,wallstreetbets,TLGT,7,7,0,7,1,1,1,1,NASDAQ
4726,13-02-2021 10:00,24 hrs.,wallstreetbets,TLRY,1159,790,369,421,57,312,307,47,NASDAQ
4726,13-02-2021 10:00,24 hrs.,wallstreetbets,TLSA,7,7,0,7,1,1,1,1,NASDAQ
4726,13-02-2021 10:00,24 hrs.,wallstreetbets,TNXP,63,7,56,-49,9,9,9,4,NASDAQ
4726,13-02-2021 10:00,24 hrs.,wallstreetbets,TOPS,100,14,86,-72,14,15,14,11,NASDAQ
4726,13-02-2021 10:00,24 hrs.,wallstreetbets,TOWN,169,0,169,-169,1,54,57,1,NASDAQ
4726,13-02-2021 10:00,24 hrs.,wallstreetbets,TQQQ,35,35,0,35,5,5,5,1,NASDAQ
4726,13-02-2021 10:00,24 hrs.,wallstreetbets,TRCH,20,6,14,-8,3,3,2,3,NASDAQ
4726,13-02-2021 10:00,24 hrs.,wallstreetbets,TRIT,52,13,39,-26,8,8,4,6,NASDAQ
4726,13-02-2021 10:00,24 hrs.,wallstreetbets,TRVG,2864,7,2857,-2850,30,1043,658,20,NASDAQ
4726,13-02-2021 10:00,24 hrs.,wallstreetbets,TSLA,9162,408,8754,-8346,30,4004,1034,21,NASDAQ
4726,13-02-2021 10:00,24 hrs.,wallstreetbets,TTCF,7,0,7,-7,1,1,1,1,NASDAQ
4726,13-02-2021 10:00,24 hrs.,wallstreetbets,TTOO,7,0,7,-7,1,1,1,1,NASDAQ
4726,13-02-2021 10:00,24 hrs.,SPACs,SGAM,336,0,336,-336,1,96,140,1,NASDAQ
4726,13-02-2021 10:00,24 hrs.,SPACs,SRAC,126,8,118,-110,2,42,34,2,NASDAQ
4726,13-02-2021 10:00,24 hrs.,SPACs,SSPK,25,25,0,25,1,6,9,1,NASDAQ
4726,13-02-2021 10:00,24 hrs.,SPACs,STWO,336,0,336,-336,1,96,140,1,NASDAQ
4726,13-02-2021 10:00,24 hrs.,SPACs,SVAC,336,0,336,-336,1,96,140,1,NASDAQ
4726,13-02-2021 10:00,24 hrs.,SPACs,TEKK,336,0,336,-336,1,96,140,1,NASDAQ
4726,13-02-2021 10:00,24 hrs.,SPACs,THBR,293,257,36,221,2,27,231,2,NASDAQ
4726,13-02-2021 10:00,24 hrs.,SPACs,THCA,336,0,336,-336,1,96,140,1,NASDAQ
4726,13-02-2021 10:00,24 hrs.,SPACs,THCB,288,282,6,276,3,28,220,3,NASDAQ
4726,13-02-2021 10:00,24 hrs.,SPACs,TMPM,336,0,336,-336,1,96,140,1,NASDAQ
4726,13-02-2021 10:00,24 hrs.,SPACs,TMTS,336,0,336,-336,1,96,140,1,NASDAQ
4726,13-02-2021 10:00,24 hrs.,SPACs,TWCT,336,0,336,-336,1,96,140,1,NASDAQ
4726,13-02-2021 10:00,24 hrs.,SPACs,VACQ,336,0,336,-336,1,96,140,1,NASDAQ
4726,13-02-2021 10:00,24 hrs.,SPACs,VMAC,343,0,343,-343,2,97,141,2,NASDAQ
4726,13-02-2021 10:00,24 hrs.,SPACs,VTIQ,41,25,16,9,2,8,17,2,NASDAQ
4726,13-02-2021 10:00,24 hrs.,SPACs,YSAC,336,0,336,-336,1,96,140,1,NASDAQ
4726,13-02-2021 10:00,24 hrs.,SPACs,ZGYH,336,0,336,-336,1,96,140,1,NASDAQ
4726,13-02-2021 10:00,24 hrs.,SPACs,CMLFW,257,257,0,257,1,21,211,1,NASDAQ
4726,13-02-2021 10:00,24 hrs.,SPACs,DSACW,257,257,0,257,1,21,211,1,NASDAQ
4726,13-02-2021 10:00,24 hrs.,SPACs,EXPCW,257,257,0,257,1,21,211,1,NASDAQ
4726,13-02-2021 10:00,24 hrs.,SPACs,FCACW,257,257,0,257,1,21,211,1,NASDAQ
4726,13-02-2021 10:00,24 hrs.,SPACs,NBACR,5,0,5,-5,1,0,1,1,NASDAQ
4726,13-02-2021 10:00,24 hrs.,SPACs,NBACW,5,0,5,-5,1,0,1,1,NASDAQ
4726,13-02-2021 10:00,24 hrs.,SPACs,SAIIW,257,257,0,257,1,21,211,1,NASDAQ
4726,13-02-2021 10:00,24 hrs.,SPACs,TWCTW,257,257,0,257,1,21,211,1,NASDAQ
4726,13-02-2021 10:00,24 hrs.,stocks,ABML,6,0,6,-6,1,1,0,1,OTC
4726,13-02-2021 10:00,24 hrs.,stocks,APTY,6,0,6,-6,1,1,0,1,OTC
4726,13-02-2021 10:00,24 hrs.,stocks,BLSP,6,0,6,-6,1,1,0,1,OTC
4726,13-02-2021 10:00,24 hrs.,stocks,BONZ,6,6,0,6,1,1,0,1,OTC
4726,13-02-2021 10:00,24 hrs.,stocks,CANN,6,0,6,-6,1,1,0,1,OTC
4726,13-02-2021 10:00,24 hrs.,stocks,CAPC,6,0,6,-6,1,1,0,1,OTC
4726,13-02-2021 10:00,24 hrs.,stocks,ETCG,6,0,6,-6,1,1,0,1,OTC
4726,13-02-2021 10:00,24 hrs.,stocks,FRCH,14,14,0,14,1,5,0,1,OTC
4726,13-02-2021 10:00,24 hrs.,stocks,GRYN,6,0,6,-6,1,1,0,1,OTC
4726,13-02-2021 10:00,24 hrs.,stocks,GTEH,6,0,6,-6,1,1,0,1,OTC
4726,13-02-2021 10:00,24 hrs.,stocks,HCMC,22,16,6,10,2,2,10,2,OTC
4726,13-02-2021 10:00,24 hrs.,stocks,HEMP,36,36,0,36,1,8,16,1,OTC
4726,13-02-2021 10:00,24 hrs.,stocks,IGEN,6,0,6,-6,1,1,0,1,OTC
4726,13-02-2021 10:00,24 hrs.,stocks,IJJP,6,6,0,6,1,1,0,1,OTC
4726,13-02-2021 10:00,24 hrs.,stocks,LINK,10,0,10,-10,1,2,2,1,OTC
4726,13-02-2021 10:00,24 hrs.,stocks,MCAP,6,0,6,-6,1,1,0,1,OTC
4726,13-02-2021 10:00,24 hrs.,stocks,MINE,6,0,6,-6,1,1,0,1,OTC
4726,13-02-2021 10:00,24 hrs.,stocks,MJNA,6,0,6,-6,1,1,0,1,OTC
4726,13-02-2021 10:00,24 hrs.,stocks,MOJO,6,0,6,-6,1,1,0,1,OTC
4726,13-02-2021 10:00,24 hrs.,stocks,NTRR,6,0,6,-6,1,1,0,1,OTC
4726,13-02-2021 10:00,24 hrs.,stocks,OZSC,6,0,6,-6,1,1,0,1,OTC
4726,13-02-2021 10:00,24 hrs.,stocks,RSSV,17,0,17,-17,1,5,3,1,OTC
4726,13-02-2021 10:00,24 hrs.,stocks,SNYR,6,0,6,-6,1,1,0,1,OTC
4726,13-02-2021 10:00,24 hrs.,stocks,SOBR,6,6,0,6,1,1,0,1,OTC
4726,13-02-2021 10:00,24 hrs.,stocks,SSET,7,0,7,-7,1,1,1,1,OTC
4726,13-02-2021 10:00,24 hrs.,stocks,TMRC,6,0,6,-6,1,1,0,1,OTC
4726,13-02-2021 10:00,24 hrs.,stocks,XFLS,6,6,0,6,1,1,0,1,OTC
4726,13-02-2021 10:00,24 hrs.,stocks,ACRDF,6,0,6,-6,1,1,0,1,OTC
4726,13-02-2021 10:00,24 hrs.,stocks,ACRHF,6,0,6,-6,1,1,0,1,OTC
4726,13-02-2021 10:00,24 hrs.,stocks,BDRBF,6,0,6,-6,1,1,0,1,OTC
4726,13-02-2021 10:00,24 hrs.,stocks,DGTHF,6,0,6,-6,1,1,0,1,OTC
4726,13-02-2021 10:00,24 hrs.,stocks,EMHTF,6,0,6,-6,1,1,0,1,OTC
4726,13-02-2021 10:00,24 hrs.,stocks,HITIF,6,6,0,6,1,1,0,1,OTC
4726,13-02-2021 10:00,24 hrs.,stocks,HRSTW,6,0,6,-6,1,1,0,1,OTC
4726,13-02-2021 10:00,24 hrs.,stocks,ILIKF,6,6,0,6,1,1,0,1,OTC
4726,13-02-2021 10:00,24 hrs.,stocks,MMEDF,12,0,12,-12,2,2,0,1,OTC
4726,13-02-2021 10:00,24 hrs.,stocks,NXTTF,6,0,6,-6,1,1,0,1,OTC
4726,13-02-2021 10:00,24 hrs.,stocks,OILFF,6,0,6,-6,1,1,0,1,OTC
4726,13-02-2021 10:00,24 hrs.,stocks,RHDGF,6,0,6,-6,1,1,0,1,OTC
4726,13-02-2021 10:00,24 hrs.,SPACs,KERN,41,0,41,-41,1,5,27,1,NASDAQ
4726,13-02-2021 10:00,24 hrs.,SPACs,KSMT,336,0,336,-336,1,96,140,1,NASDAQ
4726,13-02-2021 10:00,24 hrs.,SPACs,LATN,336,0,336,-336,1,96,140,1,NASDAQ
4726,13-02-2021 10:00,24 hrs.,SPACs,LCAP,336,0,336,-336,1,96,140,1,NASDAQ
4726,13-02-2021 10:00,24 hrs.,SPACs,LFTR,336,0,336,-336,1,96,140,1,NASDAQ
4726,13-02-2021 10:00,24 hrs.,SPACs,LIVK,336,0,336,-336,1,96,140,1,NASDAQ
4726,13-02-2021 10:00,24 hrs.,SPACs,MAAC,336,0,336,-336,1,96,140,1,NASDAQ
4726,13-02-2021 10:00,24 hrs.,SPACs,MACU,369,33,336,-303,2,105,151,2,NASDAQ
4726,13-02-2021 10:00,24 hrs.,SPACs,MCMJ,336,0,336,-336,1,96,140,1,NASDAQ
4726,13-02-2021 10:00,24 hrs.,SPACs,MLAC,336,0,336,-336,1,96,140,1,NASDAQ
4726,13-02-2021 10:00,24 hrs.,SPACs,MOTN,336,0,336,-336,1,96,140,1,NASDAQ
4726,13-02-2021 10:00,24 hrs.,SPACs,NBAC,38,0,38,-38,2,12,6,2,NASDAQ
4726,13-02-2021 10:00,24 hrs.,SPACs,NKLA,25,25,0,25,1,6,9,1,NASDAQ
4726,13-02-2021 10:00,24 hrs.,SPACs,OKTA,52,52,0,52,1,17,14,1,NASDAQ
4726,13-02-2021 10:00,24 hrs.,SPACs,OTRA,336,0,336,-336,1,96,140,1,NASDAQ
4726,13-02-2021 10:00,24 hrs.,SPACs,PAIC,336,0,336,-336,1,96,140,1,NASDAQ
4726,13-02-2021 10:00,24 hrs.,SPACs,PRCH,36,0,36,-36,1,13,6,1,NASDAQ
4726,13-02-2021 10:00,24 hrs.,SPACs,PYPL,92,0,92,-92,1,33,22,1,NASDAQ
4726,13-02-2021 10:00,24 hrs.,SPACs,QELL,536,0,536,-536,2,225,78,2,NASDAQ
4726,13-02-2021 10:00,24 hrs.,SPACs,RCHG,336,0,336,-336,1,96,140,1,NASDAQ
4726,13-02-2021 10:00,24 hrs.,SPACs,RIDE,25,25,0,25,1,6,9,1,NASDAQ
4726,13-02-2021 10:00,24 hrs.,SPACs,ROCH,25,25,0,25,1,6,9,1,NASDAQ
4726,13-02-2021 10:00,24 hrs.,wallstreetbets,THC,7,0,7,-7,1,1,1,1,NYSE
4726,13-02-2021 10:00,24 hrs.,wallstreetbets,TRQ,13,7,6,1,2,2,1,2,NYSE
4726,13-02-2021 10:00,24 hrs.,wallstreetbets,TRU,7,0,7,-7,1,1,1,1,NYSE
4726,13-02-2021 10:00,24 hrs.,wallstreetbets,TSM,519,0,519,-519,2,136,239,2,NYSE
4726,13-02-2021 10:00,24 hrs.,wallstreetbets,TSN,6002,0,6002,-6002,2,2825,344,1,NYSE
4726,13-02-2021 10:00,24 hrs.,wallstreetbets,TTM,6,0,6,-6,1,1,0,1,NYSE
4726,13-02-2021 10:00,24 hrs.,wallstreetbets,HSY,8,8,0,8,1,1,2,1,NYSE
4726,13-02-2021 10:00,24 hrs.,wallstreetbets,IAG,7,0,7,-7,1,1,1,1,NYSE
4726,13-02-2021 10:00,24 hrs.,wallstreetbets,IBM,9282,12,9270,-9258,7,4313,628,7,NYSE
4726,13-02-2021 10:00,24 hrs.,wallstreetbets,ICE,158,158,0,158,1,46,62,1,NYSE
4726,13-02-2021 10:00,24 hrs.,wallstreetbets,IGT,7,7,0,7,1,1,1,1,NYSE
4726,13-02-2021 10:00,24 hrs.,wallstreetbets,IRS,12,12,0,12,2,2,0,2,NYSE
4726,13-02-2021 10:00,24 hrs.,wallstreetbets,IVR,49,0,49,-49,7,6,9,5,NYSE
4726,13-02-2021 10:00,24 hrs.,wallstreetbets,JNJ,13,6,7,-1,2,2,1,2,NYSE
4726,13-02-2021 10:00,24 hrs.,wallstreetbets,JWS,12,12,0,12,2,2,0,1,NYSE
4726,13-02-2021 10:00,24 hrs.,wallstreetbets,KMI,47,0,47,-47,2,12,15,1,NYSE
4726,13-02-2021 10:00,24 hrs.,wallstreetbets,KOS,12,0,12,-12,2,2,0,1,NYSE
4726,13-02-2021 10:00,24 hrs.,wallstreetbets,LEE,6,6,0,6,1,1,0,1,NYSE
4726,13-02-2021 10:00,24 hrs.,wallstreetbets,LOW,22,0,22,-22,3,3,4,2,NYSE
4726,13-02-2021 10:00,24 hrs.,wallstreetbets,LTC,7,7,0,7,1,1,1,1,NYSE
4726,13-02-2021 10:00,24 hrs.,wallstreetbets,MAC,9,0,9,-9,1,1,3,1,NYSE
4726,13-02-2021 10:00,24 hrs.,wallstreetbets,MBI,14,0,14,-14,2,2,2,2,NYSE
4726,13-02-2021 10:00,24 hrs.,wallstreetbets,MCO,429,0,429,-429,1,175,75,1,NYSE
4726,13-02-2021 10:00,24 hrs.,wallstreetbets,MFA,7,0,7,-7,1,1,1,1,NYSE
4726,13-02-2021 10:00,24 hrs.,wallstreetbets,MIN,7,0,7,-7,1,1,1,1,NYSE
4726,13-02-2021 10:00,24 hrs.,wallstreetbets,MRO,435,0,435,-435,2,176,75,2,NYSE
4726,13-02-2021 10:00,24 hrs.,wallstreetbets,MSM,7,0,7,-7,1,1,1,1,NYSE
4726,13-02-2021 10:00,24 hrs.,wallstreetbets,NAT,20,0,20,-20,3,2,4,3,NYSE
4726,13-02-2021 10:00,24 hrs.,wallstreetbets,NET,173,166,7,159,2,56,53,2,NYSE
4726,13-02-2021 10:00,24 hrs.,wallstreetbets,NGA,6,0,6,-6,1,1,0,1,NYSE
4726,13-02-2021 10:00,24 hrs.,wallstreetbets,NIO,739,13,726,-713,11,300,95,10,NYSE
4726,13-02-2021 10:00,24 hrs.,wallstreetbets,NLY,7,0,7,-7,1,1,1,1,NYSE
4726,13-02-2021 10:00,24 hrs.,wallstreetbets,NMR,7,7,0,7,1,1,1,1,NYSE
4726,13-02-2021 10:00,24 hrs.,wallstreetbets,NOK,3274,240,3034,-2794,23,1331,520,22,NYSE
4726,13-02-2021 10:00,24 hrs.,wallstreetbets,NOV,6,0,6,-6,1,1,0,1,NYSE
4726,13-02-2021 10:00,24 hrs.,wallstreetbets,NRG,35,0,35,-35,5,5,5,1,NYSE
4726,13-02-2021 10:00,24 hrs.,wallstreetbets,NSA,27,27,0,27,1,10,3,1,NYSE
4726,13-02-2021 10:00,24 hrs.,wallstreetbets,NUS,7,0,7,-7,1,1,1,1,NYSE
4726,13-02-2021 10:00,24 hrs.,wallstreetbets,NVO,69,6,63,-57,2,14,33,2,NYSE
4726,13-02-2021 10:00,24 hrs.,wallstreetbets,NYC,14,7,7,0,2,2,2,2,NYSE
4726,13-02-2021 10:00,24 hrs.,wallstreetbets,OSK,150,0,150,-150,1,42,62,1,NYSE
4726,13-02-2021 10:00,24 hrs.,wallstreetbets,OVV,5,0,5,-5,1,0,1,1,NYSE
4726,13-02-2021 10:00,24 hrs.,wallstreetbets,PCG,366,219,147,72,2,117,124,2,NYSE
4726,13-02-2021 10:00,24 hrs.,wallstreetbets,PFE,13,0,13,-13,2,2,1,2,NYSE
4726,13-02-2021 10:00,24 hrs.,wallstreetbets,PHT,7,7,0,7,1,1,1,1,NYSE
4726,13-02-2021 10:00,24 hrs.,wallstreetbets,PSA,2891,2821,70,2751,10,1160,531,8,NYSE
4726,13-02-2021 10:00,24 hrs.,wallstreetbets,PSN,7,7,0,7,1,1,1,1,NYSE
4726,13-02-2021 10:00,24 hrs.,wallstreetbets,PVL,13,0,13,-13,2,2,1,1,NYSE
4726,13-02-2021 10:00,24 hrs.,wallstreetbets,PWR,6,6,0,6,1,1,0,1,NYSE
4726,13-02-2021 10:00,24 hrs.,wallstreetbets,RAD,7,7,0,7,1,1,1,1,NYSE
4726,13-02-2021 10:00,24 hrs.,wallstreetbets,RDY,7,0,7,-7,1,1,1,1,NYSE
4726,13-02-2021 10:00,24 hrs.,wallstreetbets,RKT,7701,477,7224,-6747,14,3570,505,13,NYSE
4726,13-02-2021 10:00,24 hrs.,wallstreetbets,RMO,69,0,69,-69,10,10,9,6,NYSE
4726,13-02-2021 10:00,24 hrs.,wallstreetbets,RPT,7,0,7,-7,1,1,1,1,NYSE
4726,13-02-2021 10:00,24 hrs.,wallstreetbets,RSI,6,0,6,-6,1,1,0,1,NYSE
4726,13-02-2021 10:00,24 hrs.,wallstreetbets,RTP,6,0,6,-6,1,1,0,1,NYSE
4726,13-02-2021 10:00,24 hrs.,wallstreetbets,SBE,6,0,6,-6,1,1,0,1,NYSE
4726,13-02-2021 10:00,24 hrs.,wallstreetbets,SJM,126,126,0,126,2,41,36,2,NYSE
4726,13-02-2021 10:00,24 hrs.,wallstreetbets,SKY,6,0,6,-6,1,1,0,1,NYSE
4726,13-02-2021 10:00,24 hrs.,wallstreetbets,SNE,14,0,14,-14,2,2,2,1,NYSE
4726,13-02-2021 10:00,24 hrs.,wallstreetbets,SNX,6,6,0,6,1,1,0,1,NYSE
4726,13-02-2021 10:00,24 hrs.,wallstreetbets,SOS,191,50,141,-91,27,26,31,25,NYSE
4726,13-02-2021 10:00,24 hrs.,wallstreetbets,STM,7,0,7,-7,1,1,1,1,NYSE
4726,13-02-2021 10:00,24 hrs.,wallstreetbets,SUN,6,0,6,-6,1,1,0,1,NYSE
4726,13-02-2021 10:00,24 hrs.,wallstreetbets,SUP,7,0,7,-7,1,1,1,1,NYSE
4726,13-02-2021 10:00,24 hrs.,wallstreetbets,TAK,14,0,14,-14,2,2,2,2,NYSE
4726,13-02-2021 10:00,24 hrs.,wallstreetbets,TAP,13,0,13,-13,2,2,1,2,NYSE
4726,13-02-2021 10:00,24 hrs.,wallstreetbets,TBC,7,7,0,7,1,1,1,1,NYSE
4726,13-02-2021 10:00,24 hrs.,wallstreetbets,TDC,30,24,6,18,2,3,16,2,NYSE
4726,13-02-2021 10:00,24 hrs.,wallstreetbets,TFC,7,0,7,-7,1,1,1,1,NYSE
4726,13-02-2021 10:00,24 hrs.,SPACs,III,126,126,0,126,1,44,34,1,NASDAQ
4726,13-02-2021 10:00,24 hrs.,SPACs,LCY,336,0,336,-336,1,96,140,1,NASDAQ
4726,13-02-2021 10:00,24 hrs.,SPACs,NPA,118,0,118,-118,1,41,32,1,NASDAQ
4726,13-02-2021 10:00,24 hrs.,SPACs,VIH,46,0,46,-46,1,16,10,1,NASDAQ
4726,13-02-2021 10:00,24 hrs.,SPACs,AACQ,2147,2147,0,2147,10,701,705,8,NASDAQ
4726,13-02-2021 10:00,24 hrs.,SPACs,ACEV,41,0,41,-41,1,2,33,1,NASDAQ
4726,13-02-2021 10:00,24 hrs.,SPACs,ACTC,25,25,0,25,1,6,9,1,NASDAQ
4726,13-02-2021 10:00,24 hrs.,SPACs,ADOC,369,33,336,-303,2,105,151,2,NASDAQ
4726,13-02-2021 10:00,24 hrs.,SPACs,AGBA,336,0,336,-336,1,96,140,1,NASDAQ
4726,13-02-2021 10:00,24 hrs.,SPACs,AHAC,336,0,336,-336,1,96,140,1,NASDAQ
4726,13-02-2021 10:00,24 hrs.,SPACs,AMHC,336,0,336,-336,1,96,140,1,NASDAQ
4726,13-02-2021 10:00,24 hrs.,SPACs,BHSE,369,33,336,-303,2,105,151,2,NASDAQ
4726,13-02-2021 10:00,24 hrs.,SPACs,BLNK,41,0,41,-41,1,5,27,1,NASDAQ
4726,13-02-2021 10:00,24 hrs.,SPACs,BOWX,336,0,336,-336,1,96,140,1,NASDAQ
4726,13-02-2021 10:00,24 hrs.,SPACs,BREZ,336,0,336,-336,1,96,140,1,NASDAQ
4726,13-02-2021 10:00,24 hrs.,SPACs,BRLI,336,0,336,-336,1,96,140,1,NASDAQ
4726,13-02-2021 10:00,24 hrs.,SPACs,BRPA,282,282,0,282,2,27,220,2,NASDAQ
4726,13-02-2021 10:00,24 hrs.,SPACs,BTAQ,882,0,882,-882,3,323,224,3,NASDAQ
4726,13-02-2021 10:00,24 hrs.,SPACs,BTWN,11,0,11,-11,1,2,3,1,NASDAQ
4726,13-02-2021 10:00,24 hrs.,SPACs,BWAC,336,0,336,-336,1,96,140,1,NASDAQ
4726,13-02-2021 10:00,24 hrs.,SPACs,CAPA,336,0,336,-336,1,96,140,1,NASDAQ
4726,13-02-2021 10:00,24 hrs.,SPACs,CFII,336,0,336,-336,1,96,140,1,NASDAQ
4726,13-02-2021 10:00,24 hrs.,SPACs,CHPM,336,0,336,-336,1,96,140,1,NASDAQ
4726,13-02-2021 10:00,24 hrs.,SPACs,CIIC,69,53,16,37,3,20,17,2,NASDAQ
4726,13-02-2021 10:00,24 hrs.,SPACs,CMLF,282,282,0,282,2,27,220,2,NASDAQ
4726,13-02-2021 10:00,24 hrs.,SPACs,CONX,336,0,336,-336,1,96,140,1,NASDAQ
4726,13-02-2021 10:00,24 hrs.,SPACs,CRSA,336,0,336,-336,1,96,140,1,NASDAQ
4726,13-02-2021 10:00,24 hrs.,SPACs,DBDR,336,0,336,-336,1,96,140,1,NASDAQ
4726,13-02-2021 10:00,24 hrs.,SPACs,DCRB,16,0,16,-16,1,4,4,1,NASDAQ
4726,13-02-2021 10:00,24 hrs.,SPACs,DFHT,257,257,0,257,1,21,211,1,NASDAQ
4726,13-02-2021 10:00,24 hrs.,SPACs,DFPH,336,0,336,-336,1,96,140,1,NASDAQ
4726,13-02-2021 10:00,24 hrs.,SPACs,DGNS,396,0,396,-396,1,174,44,1,NASDAQ
4726,13-02-2021 10:00,24 hrs.,SPACs,DSAC,336,0,336,-336,1,96,140,1,NASDAQ
4726,13-02-2021 10:00,24 hrs.,SPACs,ERES,336,0,336,-336,1,96,140,1,NASDAQ
4726,13-02-2021 10:00,24 hrs.,SPACs,ESSC,336,0,336,-336,1,96,140,1,NASDAQ
4726,13-02-2021 10:00,24 hrs.,SPACs,ETAC,336,0,336,-336,1,96,140,1,NASDAQ
4726,13-02-2021 10:00,24 hrs.,SPACs,EUCR,336,0,336,-336,1,96,140,1,NASDAQ
4726,13-02-2021 10:00,24 hrs.,SPACs,FCAC,733,257,476,-219,5,222,269,4,NASDAQ
4726,13-02-2021 10:00,24 hrs.,SPACs,FTOC,383,270,113,157,6,132,95,5,NASDAQ
4726,13-02-2021 10:00,24 hrs.,SPACs,FVAM,336,0,336,-336,1,96,140,1,NASDAQ
4726,13-02-2021 10:00,24 hrs.,SPACs,GNRS,336,0,336,-336,1,96,140,1,NASDAQ
4726,13-02-2021 10:00,24 hrs.,SPACs,GRCY,369,33,336,-303,2,105,151,2,NASDAQ
4726,13-02-2021 10:00,24 hrs.,SPACs,GRNV,336,0,336,-336,1,96,140,1,NASDAQ
4726,13-02-2021 10:00,24 hrs.,SPACs,GRSV,435,0,435,-435,4,123,173,4,NASDAQ
4726,13-02-2021 10:00,24 hrs.,SPACs,GWAC,336,0,336,-336,1,96,140,1,NASDAQ
4726,13-02-2021 10:00,24 hrs.,SPACs,GXGX,336,0,336,-336,1,96,140,1,NASDAQ
4726,13-02-2021 10:00,24 hrs.,SPACs,IGAC,336,0,336,-336,1,96,140,1,NASDAQ
4726,13-02-2021 10:00,24 hrs.,SPACs,ITAC,336,0,336,-336,1,96,140,1,NASDAQ
4726,13-02-2021 10:00,24 hrs.,SPACs,JYAC,336,0,336,-336,1,96,140,1,NASDAQ
4726,13-02-2021 10:00,24 hrs.,wallstreetbets,FDX,7,0,7,-7,1,1,1,1,NYSE
4726,13-02-2021 10:00,24 hrs.,wallstreetbets,FLT,7,0,7,-7,1,1,1,1,NYSE
4726,13-02-2021 10:00,24 hrs.,wallstreetbets,FMC,13,0,13,-13,2,2,1,1,NYSE
4726,13-02-2021 10:00,24 hrs.,wallstreetbets,FRO,19,0,19,-19,3,3,1,2,NYSE
4726,13-02-2021 10:00,24 hrs.,wallstreetbets,FSD,14,0,14,-14,2,2,2,2,NYSE
4726,13-02-2021 10:00,24 hrs.,wallstreetbets,FSR,248,7,241,-234,35,41,26,16,NYSE
4726,13-02-2021 10:00,24 hrs.,wallstreetbets,FTI,20,0,20,-20,3,3,2,1,NYSE
4726,13-02-2021 10:00,24 hrs.,wallstreetbets,FUN,7,7,0,7,1,1,1,1,NYSE
4726,13-02-2021 10:00,24 hrs.,wallstreetbets,GAM,7,0,7,-7,1,1,1,1,NYSE
4726,13-02-2021 10:00,24 hrs.,wallstreetbets,GEO,28,0,28,-28,4,4,4,1,NYSE
4726,13-02-2021 10:00,24 hrs.,wallstreetbets,GLW,7,0,7,-7,1,1,1,1,NYSE
4726,13-02-2021 10:00,24 hrs.,wallstreetbets,GME,167225,26483,140742,-114259,451,76071,13279,336,NYSE
4726,13-02-2021 10:00,24 hrs.,wallstreetbets,GNT,14,14,0,14,2,2,2,1,NYSE
4726,13-02-2021 10:00,24 hrs.,wallstreetbets,HMC,34,34,0,34,1,10,10,1,NYSE
4726,13-02-2021 10:00,24 hrs.,wallstreetbets,HMI,7,0,7,-7,1,1,1,1,NYSE
4726,13-02-2021 10:00,24 hrs.,SPACs,DFNS,389,0,389,-389,2,117,147,2,NYSE
4726,13-02-2021 10:00,24 hrs.,SPACs,DGNR,396,0,396,-396,1,174,44,1,NYSE
4726,13-02-2021 10:00,24 hrs.,SPACs,DMYD,396,0,396,-396,1,174,44,1,NYSE
4726,13-02-2021 10:00,24 hrs.,SPACs,DNMR,7,7,0,7,1,1,1,1,NYSE
4726,13-02-2021 10:00,24 hrs.,SPACs,EMPW,593,257,336,-79,2,117,351,2,NYSE
4726,13-02-2021 10:00,24 hrs.,SPACs,ENPC,257,257,0,257,1,21,211,1,NYSE
4726,13-02-2021 10:00,24 hrs.,SPACs,FGNA,871,871,0,871,2,300,263,1,NYSE
4726,13-02-2021 10:00,24 hrs.,SPACs,FUSE,3001,1031,1970,-939,18,972,985,15,NYSE
4726,13-02-2021 10:00,24 hrs.,SPACs,GLEO,336,0,336,-336,1,96,140,1,NYSE
4726,13-02-2021 10:00,24 hrs.,SPACs,GOAC,336,0,336,-336,1,96,140,1,NYSE
4726,13-02-2021 10:00,24 hrs.,SPACs,GSAH,1141,745,396,349,2,430,273,2,NYSE
4726,13-02-2021 10:00,24 hrs.,SPACs,HIGA,336,0,336,-336,1,96,140,1,NYSE
4726,13-02-2021 10:00,24 hrs.,SPACs,HYLN,25,25,0,25,1,6,9,1,NYSE
4726,13-02-2021 10:00,24 hrs.,SPACs,HZAC,336,0,336,-336,1,96,140,1,NYSE
4726,13-02-2021 10:00,24 hrs.,SPACs,HZON,336,0,336,-336,1,96,140,1,NYSE
4726,13-02-2021 10:00,24 hrs.,SPACs,IMPX,336,0,336,-336,1,96,140,1,NYSE
4726,13-02-2021 10:00,24 hrs.,SPACs,IPOE,745,745,0,745,1,256,229,1,NYSE
4726,13-02-2021 10:00,24 hrs.,SPACs,IPOF,5,5,0,5,1,0,1,1,NYSE
4726,13-02-2021 10:00,24 hrs.,SPACs,LGVW,421,25,396,-371,2,180,53,2,NYSE
4726,13-02-2021 10:00,24 hrs.,SPACs,OACB,336,0,336,-336,1,96,140,1,NYSE
4726,13-02-2021 10:00,24 hrs.,SPACs,PANA,336,0,336,-336,1,96,140,1,NYSE
4726,13-02-2021 10:00,24 hrs.,SPACs,PCPL,336,0,336,-336,1,96,140,1,NYSE
4726,13-02-2021 10:00,24 hrs.,SPACs,PDAC,7,0,7,-7,1,1,1,1,NYSE
4726,13-02-2021 10:00,24 hrs.,SPACs,PIAI,336,0,336,-336,1,96,140,1,NYSE
4726,13-02-2021 10:00,24 hrs.,SPACs,PRPB,336,0,336,-336,1,96,140,1,NYSE
4726,13-02-2021 10:00,24 hrs.,SPACs,PSTH,674,674,0,674,3,196,270,3,NYSE
4726,13-02-2021 10:00,24 hrs.,SPACs,RBAC,336,0,336,-336,1,96,140,1,NYSE
4726,13-02-2021 10:00,24 hrs.,SPACs,RPLA,336,0,336,-336,1,96,140,1,NYSE
4726,13-02-2021 10:00,24 hrs.,SPACs,SCPE,336,0,336,-336,1,96,140,1,NYSE
4726,13-02-2021 10:00,24 hrs.,SPACs,SCVX,336,0,336,-336,1,96,140,1,NYSE
4726,13-02-2021 10:00,24 hrs.,SPACs,SEAH,336,0,336,-336,1,96,140,1,NYSE
4726,13-02-2021 10:00,24 hrs.,SPACs,SFTW,336,0,336,-336,1,96,140,1,NYSE
4726,13-02-2021 10:00,24 hrs.,SPACs,SNPR,327,289,38,251,8,106,83,7,NYSE
4726,13-02-2021 10:00,24 hrs.,SPACs,STPK,38,38,0,38,3,8,10,3,NYSE
4726,13-02-2021 10:00,24 hrs.,SPACs,TPGY,25,25,0,25,1,6,9,1,NYSE
4726,13-02-2021 10:00,24 hrs.,SPACs,TWND,42,0,42,-42,1,9,20,1,NYSE
4726,13-02-2021 10:00,24 hrs.,SPACs,VTOL,140,0,140,-140,1,51,34,1,NYSE
4726,13-02-2021 10:00,24 hrs.,SPACs,VYGG,57,20,37,-17,5,9,19,3,NYSE
4726,13-02-2021 10:00,24 hrs.,SPACs,ADV,593,257,336,-79,2,117,351,2,NASDAQ
4726,13-02-2021 10:00,24 hrs.,SPACs,CFO,193,0,193,-193,2,67,51,2,NASDAQ
4726,13-02-2021 10:00,24 hrs.,SPACs,ESG,148,18,130,-112,2,46,48,2,NASDAQ
4726,13-02-2021 10:00,24 hrs.,wallstreetbets,LLNW,27,0,27,-27,4,4,3,4,NASDAQ
4726,13-02-2021 10:00,24 hrs.,wallstreetbets,LOAN,14,0,14,-14,2,2,2,2,NASDAQ
4726,13-02-2021 10:00,24 hrs.,wallstreetbets,LPCN,7,0,7,-7,1,1,1,1,NASDAQ
4726,13-02-2021 10:00,24 hrs.,wallstreetbets,LRCX,513,0,513,-513,1,135,239,1,NASDAQ
4726,13-02-2021 10:00,24 hrs.,wallstreetbets,LXRX,7,7,0,7,1,1,1,1,NASDAQ
4726,13-02-2021 10:00,24 hrs.,wallstreetbets,MARA,28,14,14,0,4,4,4,4,NASDAQ
4726,13-02-2021 10:00,24 hrs.,wallstreetbets,MARK,14,0,14,-14,2,2,2,2,NASDAQ
4726,13-02-2021 10:00,24 hrs.,wallstreetbets,MBIO,6,6,0,6,1,1,0,1,NASDAQ
4726,13-02-2021 10:00,24 hrs.,wallstreetbets,MBRX,26,7,19,-12,4,4,2,4,NASDAQ
4726,13-02-2021 10:00,24 hrs.,wallstreetbets,MESO,7,7,0,7,1,1,1,1,NASDAQ
4726,13-02-2021 10:00,24 hrs.,wallstreetbets,MGNI,14,0,14,-14,2,2,2,2,NASDAQ
4726,13-02-2021 10:00,24 hrs.,wallstreetbets,MKSI,429,0,429,-429,1,175,75,1,NASDAQ
4726,13-02-2021 10:00,24 hrs.,wallstreetbets,MOGO,7,7,0,7,1,1,1,1,NASDAQ
4726,13-02-2021 10:00,24 hrs.,wallstreetbets,MRKR,6,6,0,6,1,1,0,1,NASDAQ
4726,13-02-2021 10:00,24 hrs.,wallstreetbets,MRNA,6,0,6,-6,1,1,0,1,NASDAQ
4726,13-02-2021 10:00,24 hrs.,wallstreetbets,MRVL,7,0,7,-7,1,1,1,1,NASDAQ
4726,13-02-2021 10:00,24 hrs.,wallstreetbets,MSFT,8576,0,8576,-8576,1,4018,536,1,NASDAQ
4726,13-02-2021 10:00,24 hrs.,wallstreetbets,MSTR,13,7,6,1,2,2,1,2,NASDAQ
4726,13-02-2021 10:00,24 hrs.,wallstreetbets,MTCH,7,0,7,-7,1,1,1,1,NASDAQ
4726,13-02-2021 10:00,24 hrs.,wallstreetbets,MVIS,492,0,492,-492,7,163,138,6,NASDAQ
4726,13-02-2021 10:00,24 hrs.,wallstreetbets,NAKD,140,36,104,-68,20,20,20,13,NASDAQ
4726,13-02-2021 10:00,24 hrs.,wallstreetbets,NBAC,14,0,14,-14,2,2,2,1,NASDAQ
4726,13-02-2021 10:00,24 hrs.,wallstreetbets,NCLH,28,14,14,0,4,4,4,3,NASDAQ
4726,13-02-2021 10:00,24 hrs.,wallstreetbets,NEOS,7,0,7,-7,1,1,1,1,NASDAQ
4726,13-02-2021 10:00,24 hrs.,wallstreetbets,NFLX,7,0,7,-7,1,1,1,1,NASDAQ
4726,13-02-2021 10:00,24 hrs.,wallstreetbets,NKLA,7,7,0,7,1,1,1,1,NASDAQ
4726,13-02-2021 10:00,24 hrs.,wallstreetbets,NLOK,7,0,7,-7,1,1,1,1,NASDAQ
4726,13-02-2021 10:00,24 hrs.,wallstreetbets,NMRK,6,0,6,-6,1,1,0,1,NASDAQ
4726,13-02-2021 10:00,24 hrs.,wallstreetbets,NNDM,49,28,21,7,4,3,27,2,NASDAQ
4726,13-02-2021 10:00,24 hrs.,wallstreetbets,NOVN,29,29,0,29,4,4,5,3,NASDAQ
4726,13-02-2021 10:00,24 hrs.,wallstreetbets,NUAN,673,0,673,-673,1,290,89,1,NASDAQ
4726,13-02-2021 10:00,24 hrs.,wallstreetbets,NVAX,13,13,0,13,2,2,1,2,NASDAQ
4726,13-02-2021 10:00,24 hrs.,wallstreetbets,NVDA,653,0,653,-653,3,136,369,3,NASDAQ
4726,13-02-2021 10:00,24 hrs.,wallstreetbets,NVIV,7,7,0,7,1,1,1,1,NASDAQ
4726,13-02-2021 10:00,24 hrs.,wallstreetbets,OCGN,45,7,38,-31,7,7,3,6,NASDAQ
4726,13-02-2021 10:00,24 hrs.,wallstreetbets,ONTX,14,7,7,0,2,2,2,2,NASDAQ
4726,13-02-2021 10:00,24 hrs.,wallstreetbets,OPGN,14,0,14,-14,2,2,2,1,NASDAQ
4726,13-02-2021 10:00,24 hrs.,wallstreetbets,OPTT,6,0,6,-6,1,1,0,1,NASDAQ
4726,13-02-2021 10:00,24 hrs.,wallstreetbets,PENN,6030,0,6030,-6030,6,2829,348,2,NASDAQ
4726,13-02-2021 10:00,24 hrs.,wallstreetbets,PGNY,7,0,7,-7,1,1,1,1,NASDAQ
4726,13-02-2021 10:00,24 hrs.,wallstreetbets,PHUN,7,0,7,-7,1,1,1,1,NASDAQ
4726,13-02-2021 10:00,24 hrs.,wallstreetbets,PLAY,7,0,7,-7,1,1,1,1,NASDAQ
4726,13-02-2021 10:00,24 hrs.,wallstreetbets,PLUG,7,0,7,-7,1,1,1,1,NASDAQ
4726,13-02-2021 10:00,24 hrs.,wallstreetbets,PLYA,20,0,20,-20,3,3,2,2,NASDAQ
4726,13-02-2021 10:00,24 hrs.,wallstreetbets,POTX,7,0,7,-7,1,1,1,1,NASDAQ
4726,13-02-2021 10:00,24 hrs.,wallstreetbets,POWW,27,0,27,-27,4,4,3,4,NASDAQ
4726,13-02-2021 10:00,24 hrs.,wallstreetbets,PRCH,72,0,72,-72,3,14,32,1,NASDAQ
4726,13-02-2021 10:00,24 hrs.,wallstreetbets,PRPL,1045,0,1045,-1045,1,412,217,1,NASDAQ
4726,13-02-2021 10:00,24 hrs.,wallstreetbets,PRTS,15,0,15,-15,2,2,3,1,NASDAQ
4726,13-02-2021 10:00,24 hrs.,wallstreetbets,PSAC,7,0,7,-7,1,1,1,1,NASDAQ
4726,13-02-2021 10:00,24 hrs.,wallstreetbets,PSEC,6,6,0,6,1,0,2,1,NASDAQ
4726,13-02-2021 10:00,24 hrs.,SPACs,FSR,31,25,6,19,2,7,9,2,NYSE
4726,13-02-2021 10:00,24 hrs.,SPACs,GIX,336,0,336,-336,1,96,140,1,NYSE
4726,13-02-2021 10:00,24 hrs.,SPACs,HPX,336,0,336,-336,1,96,140,1,NYSE
4726,13-02-2021 10:00,24 hrs.,SPACs,ICE,46,0,46,-46,1,16,10,1,NYSE
4726,13-02-2021 10:00,24 hrs.,SPACs,IRR,80,0,80,-80,1,24,28,1,NYSE
4726,13-02-2021 10:00,24 hrs.,SPACs,JWS,299,299,0,299,7,27,217,3,NYSE
4726,13-02-2021 10:00,24 hrs.,SPACs,NAV,155,22,133,-111,5,47,41,4,NYSE
4726,13-02-2021 10:00,24 hrs.,SPACs,NGA,98,25,73,-48,2,29,32,2,NYSE
4726,13-02-2021 10:00,24 hrs.,SPACs,NSH,336,0,336,-336,1,96,140,1,NYSE
4726,13-02-2021 10:00,24 hrs.,SPACs,RBC,7,7,0,7,1,1,1,1,NYSE
4726,13-02-2021 10:00,24 hrs.,SPACs,RMO,6,6,0,6,1,1,0,1,NYSE
4726,13-02-2021 10:00,24 hrs.,SPACs,RSI,9,0,9,-9,1,0,5,1,NYSE
4726,13-02-2021 10:00,24 hrs.,SPACs,RTP,674,257,417,-160,4,196,266,3,NYSE
4726,13-02-2021 10:00,24 hrs.,SPACs,SBE,301,301,0,301,3,105,79,2,NYSE
4726,13-02-2021 10:00,24 hrs.,SPACs,SBG,336,0,336,-336,1,96,140,1,NYSE
4726,13-02-2021 10:00,24 hrs.,SPACs,SOS,7,7,0,7,1,1,1,1,NYSE
4726,13-02-2021 10:00,24 hrs.,SPACs,TDA,7,0,7,-7,1,1,1,1,NYSE
4726,13-02-2021 10:00,24 hrs.,SPACs,WPF,336,0,336,-336,1,96,140,1,NYSE
4726,13-02-2021 10:00,24 hrs.,SPACs,YAC,336,0,336,-336,1,96,140,1,NYSE
4726,13-02-2021 10:00,24 hrs.,SPACs,YUM,53,0,53,-53,1,16,17,1,NYSE
4726,13-02-2021 10:00,24 hrs.,SPACs,ACIC,263,263,0,263,2,22,211,2,NYSE
4726,13-02-2021 10:00,24 hrs.,SPACs,ACND,336,0,336,-336,1,96,140,1,NYSE
4726,13-02-2021 10:00,24 hrs.,SPACs,ALUS,54,0,54,-54,1,11,28,1,NYSE
4726,13-02-2021 10:00,24 hrs.,SPACs,AONE,336,0,336,-336,1,96,140,1,NYSE
4726,13-02-2021 10:00,24 hrs.,SPACs,APSG,336,0,336,-336,1,96,140,1,NYSE
4726,13-02-2021 10:00,24 hrs.,SPACs,ASAQ,336,0,336,-336,1,96,140,1,NYSE
4726,13-02-2021 10:00,24 hrs.,SPACs,ASPL,336,0,336,-336,1,96,140,1,NYSE
4726,13-02-2021 10:00,24 hrs.,SPACs,ATAC,336,0,336,-336,1,96,140,1,NYSE
4726,13-02-2021 10:00,24 hrs.,SPACs,AVAN,344,8,336,-328,2,96,144,2,NYSE
4726,13-02-2021 10:00,24 hrs.,SPACs,BOAC,432,0,432,-432,2,129,166,2,NYSE
4726,13-02-2021 10:00,24 hrs.,SPACs,CCIV,1572,297,1275,-978,13,437,646,13,NYSE
4726,13-02-2021 10:00,24 hrs.,SPACs,CPSR,336,0,336,-336,1,96,140,1,NYSE
4726,13-02-2021 10:00,24 hrs.,SPACs,CTAC,336,0,336,-336,1,96,140,1,NYSE
4726,13-02-2021 10:00,24 hrs.,wallstreetbets,HEAR,13,13,0,13,2,2,1,2,NASDAQ
4726,13-02-2021 10:00,24 hrs.,wallstreetbets,HJLI,14,0,14,-14,2,2,2,1,NASDAQ
4726,13-02-2021 10:00,24 hrs.,wallstreetbets,HSTO,19,0,19,-19,3,3,1,2,NASDAQ
4726,13-02-2021 10:00,24 hrs.,wallstreetbets,HTBX,8,0,8,-8,1,1,2,1,NASDAQ
4726,13-02-2021 10:00,24 hrs.,wallstreetbets,HZNP,7,7,0,7,1,1,1,1,NASDAQ
4726,13-02-2021 10:00,24 hrs.,wallstreetbets,ICLN,6,0,6,-6,1,1,0,1,NASDAQ
4726,13-02-2021 10:00,24 hrs.,wallstreetbets,ICON,7,0,7,-7,1,1,1,1,NASDAQ
4726,13-02-2021 10:00,24 hrs.,wallstreetbets,ICPT,7,0,7,-7,1,1,1,1,NASDAQ
4726,13-02-2021 10:00,24 hrs.,wallstreetbets,IDEX,160,0,160,-160,3,42,64,3,NASDAQ
4726,13-02-2021 10:00,24 hrs.,wallstreetbets,IFMK,7,7,0,7,1,1,1,1,NASDAQ
4726,13-02-2021 10:00,24 hrs.,wallstreetbets,IIVI,429,0,429,-429,1,175,75,1,NASDAQ
4726,13-02-2021 10:00,24 hrs.,wallstreetbets,ILMN,7,0,7,-7,1,1,1,1,NASDAQ
4726,13-02-2021 10:00,24 hrs.,wallstreetbets,IMGN,21,0,21,-21,3,3,3,3,NASDAQ
4726,13-02-2021 10:00,24 hrs.,wallstreetbets,INPX,14,7,7,0,2,2,2,2,NASDAQ
4726,13-02-2021 10:00,24 hrs.,wallstreetbets,INSG,6,6,0,6,1,1,0,1,NASDAQ
4726,13-02-2021 10:00,24 hrs.,wallstreetbets,INTC,153,13,140,-127,4,3,131,4,NASDAQ
4726,13-02-2021 10:00,24 hrs.,wallstreetbets,IPWR,6,0,6,-6,1,1,0,1,NASDAQ
4726,13-02-2021 10:00,24 hrs.,wallstreetbets,IRBT,6,6,0,6,1,1,0,1,NASDAQ
4726,13-02-2021 10:00,24 hrs.,wallstreetbets,ITRM,42,7,35,-28,6,6,6,4,NASDAQ
4726,13-02-2021 10:00,24 hrs.,wallstreetbets,JAGX,45,25,20,5,7,7,3,3,NASDAQ
4726,13-02-2021 10:00,24 hrs.,wallstreetbets,JNCE,12,6,6,0,2,2,0,2,NASDAQ
4726,13-02-2021 10:00,24 hrs.,wallstreetbets,KOPN,15,0,15,-15,2,2,3,2,NASDAQ
4726,13-02-2021 10:00,24 hrs.,wallstreetbets,KOSS,172,7,165,-158,3,49,62,3,NASDAQ
4726,13-02-2021 10:00,24 hrs.,wallstreetbets,LAZR,8,8,0,8,1,1,2,1,NASDAQ
4726,13-02-2021 10:00,24 hrs.,wallstreetbets,LEGN,7,0,7,-7,1,1,1,1,NASDAQ
4726,13-02-2021 10:00,24 hrs.,wallstreetbets,LGND,7,0,7,-7,1,1,1,1,NASDAQ
4726,13-02-2021 10:00,24 hrs.,wallstreetbets,LIFE,20,13,7,6,3,3,2,3,NASDAQ
4726,13-02-2021 10:00,24 hrs.,wallstreetbets,LITE,429,0,429,-429,1,175,75,1,NASDAQ
4726,13-02-2021 10:00,24 hrs.,wallstreetbets,LIVE,436,0,436,-436,2,176,76,2,NASDAQ
4726,13-02-2021 10:00,24 hrs.,wallstreetbets,LKCO,42,0,42,-42,6,6,6,5,NASDAQ
4726,13-02-2021 10:00,24 hrs.,wallstreetbets,LLIT,7,0,7,-7,1,1,1,1,NASDAQ
4726,13-02-2021 10:00,24 hrs.,SPACs,APEX,31,0,31,-31,1,4,19,1,OTC
4726,13-02-2021 10:00,24 hrs.,SPACs,BRRN,11,11,0,11,1,2,3,1,OTC
4726,13-02-2021 10:00,24 hrs.,SPACs,CIK,73,0,73,-73,1,23,23,1,AMEX
4726,13-02-2021 10:00,24 hrs.,SPACs,NBA,336,0,336,-336,1,96,140,1,AMEX
4726,13-02-2021 10:00,24 hrs.,SPACs,PTK,369,33,336,-303,2,105,151,2,AMEX
4726,13-02-2021 10:00,24 hrs.,SPACs,CHAQ,369,33,336,-303,2,105,151,2,AMEX
4726,13-02-2021 10:00,24 hrs.,SPACs,AIR,140,0,140,-140,1,51,34,1,NYSE
4726,13-02-2021 10:00,24 hrs.,SPACs,BFT,264,264,0,264,2,22,212,2,NYSE
4726,13-02-2021 10:00,24 hrs.,SPACs,BSN,336,0,336,-336,1,96,140,1,NYSE
4726,13-02-2021 10:00,24 hrs.,SPACs,CCX,336,0,336,-336,1,96,140,1,NYSE
4726,13-02-2021 10:00,24 hrs.,SPACs,COO,41,0,41,-41,1,5,27,1,NYSE
4726,13-02-2021 10:00,24 hrs.,SPACs,DEH,336,0,336,-336,1,96,140,1,NYSE
4726,13-02-2021 10:00,24 hrs.,SPACs,DFS,140,0,140,-140,1,51,34,1,NYSE
4726,13-02-2021 10:00,24 hrs.,SPACs,ELY,18,18,0,18,1,6,2,1,NYSE
4726,13-02-2021 10:00,24 hrs.,SPACs,EQD,593,257,336,-79,2,117,351,2,NYSE
4726,13-02-2021 10:00,24 hrs.,wallstreetbets,AKBA,7,0,7,-7,1,1,1,1,NASDAQ
4726,13-02-2021 10:00,24 hrs.,wallstreetbets,ALRN,7,7,0,7,1,1,1,1,NASDAQ
4726,13-02-2021 10:00,24 hrs.,wallstreetbets,AMAT,13,0,13,-13,2,2,1,2,NASDAQ
4726,13-02-2021 10:00,24 hrs.,wallstreetbets,AMBC,8,0,8,-8,1,1,2,1,NASDAQ
4726,13-02-2021 10:00,24 hrs.,wallstreetbets,AMKR,21,0,21,-21,3,3,3,3,NASDAQ
4726,13-02-2021 10:00,24 hrs.,wallstreetbets,AMZN,116,7,109,-102,5,4,88,4,NASDAQ
4726,13-02-2021 10:00,24 hrs.,wallstreetbets,ANCN,7,0,7,-7,1,1,1,1,NASDAQ
4726,13-02-2021 10:00,24 hrs.,wallstreetbets,ANTE,7,7,0,7,1,1,1,1,NASDAQ
4726,13-02-2021 10:00,24 hrs.,wallstreetbets,APEN,7,7,0,7,1,1,1,1,NASDAQ
4726,13-02-2021 10:00,24 hrs.,wallstreetbets,APHA,759,471,288,183,43,211,165,30,NASDAQ
4726,13-02-2021 10:00,24 hrs.,wallstreetbets,APPS,7,7,0,7,1,1,1,1,NASDAQ
4726,13-02-2021 10:00,24 hrs.,wallstreetbets,APRE,7,0,7,-7,1,1,1,1,NASDAQ
4726,13-02-2021 10:00,24 hrs.,wallstreetbets,AQST,7,0,7,-7,1,1,1,1,NASDAQ
4726,13-02-2021 10:00,24 hrs.,wallstreetbets,ARTL,89,0,89,-89,13,13,11,11,NASDAQ
4726,13-02-2021 10:00,24 hrs.,wallstreetbets,ASRT,48,7,41,-34,7,7,6,7,NASDAQ
4726,13-02-2021 10:00,24 hrs.,wallstreetbets,ASYS,6,0,6,-6,1,1,0,1,NASDAQ
4726,13-02-2021 10:00,24 hrs.,wallstreetbets,ATHA,7,0,7,-7,1,1,1,1,NASDAQ
4726,13-02-2021 10:00,24 hrs.,wallstreetbets,ATHE,12,0,12,-12,2,2,0,1,NASDAQ
4726,13-02-2021 10:00,24 hrs.,wallstreetbets,ATOS,41,7,34,-27,6,6,5,5,NASDAQ
4726,13-02-2021 10:00,24 hrs.,wallstreetbets,ATVI,7,7,0,7,1,1,1,1,NASDAQ
4726,13-02-2021 10:00,24 hrs.,wallstreetbets,AUPH,6,0,6,-6,1,1,0,1,NASDAQ
4726,13-02-2021 10:00,24 hrs.,wallstreetbets,AVXL,7,0,7,-7,1,1,1,1,NASDAQ
4726,13-02-2021 10:00,24 hrs.,wallstreetbets,AWRE,7,0,7,-7,1,1,1,1,NASDAQ
4726,13-02-2021 10:00,24 hrs.,wallstreetbets,AYRO,7,0,7,-7,1,1,1,1,NASDAQ
4726,13-02-2021 10:00,24 hrs.,wallstreetbets,BBBY,7,7,0,7,1,1,1,1,NASDAQ
4726,13-02-2021 10:00,24 hrs.,wallstreetbets,BEAT,8,0,8,-8,1,2,0,1,NASDAQ
4726,13-02-2021 10:00,24 hrs.,wallstreetbets,BIOC,7,0,7,-7,1,1,1,1,NASDAQ
4726,13-02-2021 10:00,24 hrs.,wallstreetbets,BIVI,6,0,6,-6,1,1,0,1,NASDAQ
4726,13-02-2021 10:00,24 hrs.,wallstreetbets,BLCM,6,0,6,-6,1,1,0,1,NASDAQ
4726,13-02-2021 10:00,24 hrs.,wallstreetbets,BLNK,7,0,7,-7,1,1,1,1,NASDAQ
4726,13-02-2021 10:00,24 hrs.,wallstreetbets,BNGO,366,239,127,112,22,105,68,13,NASDAQ
4726,13-02-2021 10:00,24 hrs.,wallstreetbets,BNTX,13,0,13,-13,2,2,1,1,NASDAQ
4726,13-02-2021 10:00,24 hrs.,wallstreetbets,BOXL,7,0,7,-7,1,1,1,1,NASDAQ
4726,13-02-2021 10:00,24 hrs.,wallstreetbets,BPTH,7,0,7,-7,1,1,1,1,NASDAQ
4726,13-02-2021 10:00,24 hrs.,wallstreetbets,GBT,7,0,7,-7,1,1,1,1,NASDAQ
4726,13-02-2021 10:00,24 hrs.,wallstreetbets,GSM,19,6,13,-7,3,3,1,3,NASDAQ
4726,13-02-2021 10:00,24 hrs.,wallstreetbets,HAS,6,6,0,6,1,1,0,1,NASDAQ
4726,13-02-2021 10:00,24 hrs.,wallstreetbets,IEA,7,0,7,-7,1,1,1,1,NASDAQ
4726,13-02-2021 10:00,24 hrs.,wallstreetbets,IIN,6,0,6,-6,1,1,0,1,NASDAQ
4726,13-02-2021 10:00,24 hrs.,wallstreetbets,INO,136,48,88,-40,14,20,40,14,NASDAQ
4726,13-02-2021 10:00,24 hrs.,wallstreetbets,JFU,6,6,0,6,1,1,0,1,NASDAQ
4726,13-02-2021 10:00,24 hrs.,wallstreetbets,KHC,14,7,7,0,2,2,2,2,NASDAQ
4726,13-02-2021 10:00,24 hrs.,wallstreetbets,KOD,6,0,6,-6,1,1,0,1,NASDAQ
4726,13-02-2021 10:00,24 hrs.,wallstreetbets,MKD,13,13,0,13,2,2,1,2,NASDAQ
4726,13-02-2021 10:00,24 hrs.,wallstreetbets,MYT,7,7,0,7,1,1,1,1,NASDAQ
4726,13-02-2021 10:00,24 hrs.,wallstreetbets,NPA,6,0,6,-6,1,1,0,1,NASDAQ
4726,13-02-2021 10:00,24 hrs.,wallstreetbets,NWL,429,0,429,-429,1,175,75,1,NASDAQ
4726,13-02-2021 10:00,24 hrs.,wallstreetbets,OGI,80,28,52,-24,12,12,8,12,NASDAQ
4726,13-02-2021 10:00,24 hrs.,wallstreetbets,OPK,7,0,7,-7,1,1,1,1,NASDAQ
4726,13-02-2021 10:00,24 hrs.,wallstreetbets,PDD,7,7,0,7,1,1,1,1,NASDAQ
4726,13-02-2021 10:00,24 hrs.,wallstreetbets,QQQ,6,6,0,6,1,1,0,1,NASDAQ
4726,13-02-2021 10:00,24 hrs.,wallstreetbets,RUN,243,229,14,215,3,73,85,3,NASDAQ
4726,13-02-2021 10:00,24 hrs.,wallstreetbets,RXT,7,0,7,-7,1,1,1,1,NASDAQ
4726,13-02-2021 10:00,24 hrs.,wallstreetbets,SDC,7,0,7,-7,1,1,1,1,NASDAQ
4726,13-02-2021 10:00,24 hrs.,wallstreetbets,SFT,7,0,7,-7,1,1,1,1,NASDAQ
4726,13-02-2021 10:00,24 hrs.,wallstreetbets,SLM,8,0,8,-8,1,1,2,1,NASDAQ
4726,13-02-2021 10:00,24 hrs.,wallstreetbets,SLP,7,7,0,7,1,1,1,1,NASDAQ
4726,13-02-2021 10:00,24 hrs.,wallstreetbets,SMH,7,0,7,-7,1,1,1,1,NASDAQ
4726,13-02-2021 10:00,24 hrs.,wallstreetbets,SND,34,7,27,-20,5,5,4,5,NASDAQ
4726,13-02-2021 10:00,24 hrs.,wallstreetbets,SPI,7,0,7,-7,1,1,1,1,NASDAQ
4726,13-02-2021 10:00,24 hrs.,wallstreetbets,SPT,7,0,7,-7,1,1,1,1,NASDAQ
4726,13-02-2021 10:00,24 hrs.,wallstreetbets,VFF,24,10,14,-4,3,3,6,3,NASDAQ
4726,13-02-2021 10:00,24 hrs.,wallstreetbets,WBA,7,0,7,-7,1,1,1,1,NASDAQ
4726,13-02-2021 10:00,24 hrs.,wallstreetbets,WNW,60,24,36,-12,8,8,12,6,NASDAQ
4726,13-02-2021 10:00,24 hrs.,wallstreetbets,WWR,6,0,6,-6,1,1,0,1,NASDAQ
4726,13-02-2021 10:00,24 hrs.,wallstreetbets,AACG,7,0,7,-7,1,1,1,1,NASDAQ
4726,13-02-2021 10:00,24 hrs.,wallstreetbets,AAPL,32,6,26,-20,5,5,2,5,NASDAQ
4726,13-02-2021 10:00,24 hrs.,wallstreetbets,AAWW,6,0,6,-6,1,1,0,1,NASDAQ
4726,13-02-2021 10:00,24 hrs.,wallstreetbets,ABCL,7,7,0,7,1,1,1,1,NASDAQ
4726,13-02-2021 10:00,24 hrs.,wallstreetbets,ABEO,7,0,7,-7,1,1,1,1,NASDAQ
4726,13-02-2021 10:00,24 hrs.,wallstreetbets,ABNB,21,6,15,-9,3,3,3,2,NASDAQ
4726,13-02-2021 10:00,24 hrs.,wallstreetbets,ABUS,7,0,7,-7,1,1,1,1,NASDAQ
4726,13-02-2021 10:00,24 hrs.,wallstreetbets,ACEV,6,0,6,-6,1,1,0,1,NASDAQ
4726,13-02-2021 10:00,24 hrs.,wallstreetbets,ACIU,7,0,7,-7,1,1,1,1,NASDAQ
4726,13-02-2021 10:00,24 hrs.,wallstreetbets,ACOR,7,7,0,7,1,1,1,1,NASDAQ
4726,13-02-2021 10:00,24 hrs.,wallstreetbets,ACST,20,0,20,-20,3,3,2,3,NASDAQ
4726,13-02-2021 10:00,24 hrs.,wallstreetbets,ADMA,7,7,0,7,1,1,1,1,NASDAQ
4726,13-02-2021 10:00,24 hrs.,wallstreetbets,ADMP,7,0,7,-7,1,1,1,1,NASDAQ
4726,13-02-2021 10:00,24 hrs.,wallstreetbets,ADXS,6,0,6,-6,1,1,0,1,NASDAQ
4726,13-02-2021 10:00,24 hrs.,wallstreetbets,AEZS,14,0,14,-14,2,2,2,1,NASDAQ
4726,13-02-2021 10:00,24 hrs.,wallstreetbets,AGEN,7,0,7,-7,1,1,1,1,NASDAQ
4726,13-02-2021 10:00,24 hrs.,wallstreetbets,AGTC,36,0,36,-36,5,5,6,3,NASDAQ
4726,13-02-2021 10:00,24 hrs.,wallstreetbets,AIKI,7,0,7,-7,1,1,1,1,NASDAQ
4726,13-02-2021 10:00,24 hrs.,wallstreetbets,IGCIW,49,0,49,-49,7,7,7,2,OTC
4726,13-02-2021 10:00,24 hrs.,wallstreetbets,ISCNF,14,0,14,-14,2,2,2,2,OTC
4726,13-02-2021 10:00,24 hrs.,wallstreetbets,ITHUF,7,0,7,-7,1,1,1,1,OTC
4726,13-02-2021 10:00,24 hrs.,wallstreetbets,KBEVF,7,0,7,-7,1,1,1,1,OTC
4726,13-02-2021 10:00,24 hrs.,wallstreetbets,LHSIF,7,0,7,-7,1,1,1,1,OTC
4726,13-02-2021 10:00,24 hrs.,wallstreetbets,LKNCY,223,8,215,-207,2,9,197,2,OTC
4726,13-02-2021 10:00,24 hrs.,wallstreetbets,MMEDF,3210,0,3210,-3210,4,1336,522,3,OTC
4726,13-02-2021 10:00,24 hrs.,wallstreetbets,MOTNF,7,0,7,-7,1,1,1,1,OTC
4726,13-02-2021 10:00,24 hrs.,wallstreetbets,NONOF,7,7,0,7,1,1,1,1,OTC
4726,13-02-2021 10:00,24 hrs.,wallstreetbets,NTDOY,15,0,15,-15,2,2,3,2,OTC
4726,13-02-2021 10:00,24 hrs.,wallstreetbets,NXGWF,13,0,13,-13,2,2,1,1,OTC
4726,13-02-2021 10:00,24 hrs.,wallstreetbets,NXTTF,14,0,14,-14,2,2,2,1,OTC
4726,13-02-2021 10:00,24 hrs.,wallstreetbets,PCLOF,13,6,7,-1,2,2,1,2,OTC
4726,13-02-2021 10:00,24 hrs.,wallstreetbets,PDYPF,7,0,7,-7,1,1,1,1,OTC
4726,13-02-2021 10:00,24 hrs.,wallstreetbets,PMNXF,6,0,6,-6,1,1,0,1,OTC
4726,13-02-2021 10:00,24 hrs.,wallstreetbets,RAZFF,7,0,7,-7,1,1,1,1,OTC
4726,13-02-2021 10:00,24 hrs.,wallstreetbets,RLLCF,72,0,72,-72,10,10,12,10,OTC
4726,13-02-2021 10:00,24 hrs.,wallstreetbets,RYCEY,78,14,64,-50,11,11,12,10,OTC
4726,13-02-2021 10:00,24 hrs.,wallstreetbets,SBSAA,7,7,0,7,1,1,1,1,OTC
4726,13-02-2021 10:00,24 hrs.,wallstreetbets,SHRMF,6,6,0,6,1,1,0,1,OTC
4726,13-02-2021 10:00,24 hrs.,wallstreetbets,SPRWF,28,0,28,-28,4,4,4,3,OTC
4726,13-02-2021 10:00,24 hrs.,wallstreetbets,TBUIF,13,13,0,13,2,2,1,1,OTC
4726,13-02-2021 10:00,24 hrs.,wallstreetbets,QOIL,6,0,6,-6,1,1,0,1,OTC
4726,13-02-2021 10:00,24 hrs.,wallstreetbets,RBDC,7,0,7,-7,1,1,1,1,OTC
4726,13-02-2021 10:00,24 hrs.,wallstreetbets,RBNW,6,0,6,-6,1,1,0,1,OTC
4726,13-02-2021 10:00,24 hrs.,wallstreetbets,REFG,7,0,7,-7,1,1,1,1,OTC
4726,13-02-2021 10:00,24 hrs.,wallstreetbets,RELI,6,0,6,-6,1,1,0,1,OTC
4726,13-02-2021 10:00,24 hrs.,wallstreetbets,RSSV,9,0,9,-9,1,2,1,1,OTC
4726,13-02-2021 10:00,24 hrs.,wallstreetbets,RTON,14,6,8,-2,2,2,2,2,OTC
4726,13-02-2021 10:00,24 hrs.,wallstreetbets,SBFM,7,7,0,7,1,1,1,1,OTC
4726,13-02-2021 10:00,24 hrs.,wallstreetbets,SFOR,7,7,0,7,1,1,1,1,OTC
4726,13-02-2021 10:00,24 hrs.,wallstreetbets,SGMD,6,0,6,-6,1,1,0,1,OTC
4726,13-02-2021 10:00,24 hrs.,wallstreetbets,SHMP,14,0,14,-14,2,2,2,2,OTC
4726,13-02-2021 10:00,24 hrs.,wallstreetbets,SHWZ,7,7,0,7,1,1,1,1,OTC
4726,13-02-2021 10:00,24 hrs.,wallstreetbets,SIGN,28,14,14,0,4,4,4,3,OTC
4726,13-02-2021 10:00,24 hrs.,wallstreetbets,SIMP,7,7,0,7,1,1,1,1,OTC
4726,13-02-2021 10:00,24 hrs.,wallstreetbets,SIRR,7,0,7,-7,1,1,1,1,OTC
4726,13-02-2021 10:00,24 hrs.,wallstreetbets,SNDD,7,7,0,7,1,1,1,1,OTC
4726,13-02-2021 10:00,24 hrs.,wallstreetbets,SNRS,7,7,0,7,1,1,1,1,OTC
4726,13-02-2021 10:00,24 hrs.,wallstreetbets,SNYR,14,0,14,-14,2,2,2,1,OTC
4726,13-02-2021 10:00,24 hrs.,wallstreetbets,SRMX,13,0,13,-13,2,2,1,2,OTC
4726,13-02-2021 10:00,24 hrs.,wallstreetbets,SUIC,6,0,6,-6,1,1,0,1,OTC
4726,13-02-2021 10:00,24 hrs.,wallstreetbets,TCHH,12,6,6,0,2,2,0,2,OTC
4726,13-02-2021 10:00,24 hrs.,wallstreetbets,TGLO,7,0,7,-7,1,1,1,1,OTC
4726,13-02-2021 10:00,24 hrs.,wallstreetbets,TRTC,21,0,21,-21,3,3,3,2,OTC
4726,13-02-2021 10:00,24 hrs.,wallstreetbets,TSNP,21,7,14,-7,3,3,3,3,OTC
4726,13-02-2021 10:00,24 hrs.,wallstreetbets,UBQU,7,0,7,-7,1,1,1,1,OTC
4726,13-02-2021 10:00,24 hrs.,wallstreetbets,USDC,21,13,8,5,3,3,3,3,OTC
4726,13-02-2021 10:00,24 hrs.,wallstreetbets,USMJ,13,0,13,-13,2,2,1,2,OTC
4726,13-02-2021 10:00,24 hrs.,wallstreetbets,USPS,6,6,0,6,1,1,0,1,OTC
4726,13-02-2021 10:00,24 hrs.,wallstreetbets,UVSE,7,0,7,-7,1,1,1,1,OTC
4726,13-02-2021 10:00,24 hrs.,wallstreetbets,VTLR,7,0,7,-7,1,1,1,1,OTC
4726,13-02-2021 10:00,24 hrs.,wallstreetbets,VYST,6,0,6,-6,1,1,0,1,OTC
4726,13-02-2021 10:00,24 hrs.,wallstreetbets,WDDD,7,0,7,-7,1,1,1,1,OTC
4726,13-02-2021 10:00,24 hrs.,wallstreetbets,WDLF,7,0,7,-7,1,1,1,1,OTC
4726,13-02-2021 10:00,24 hrs.,wallstreetbets,WHEN,13,7,6,1,2,2,1,2,OTC
4726,13-02-2021 10:00,24 hrs.,wallstreetbets,WSSE,7,0,7,-7,1,1,1,1,OTC
4726,13-02-2021 10:00,24 hrs.,wallstreetbets,XFLS,6,6,0,6,1,1,0,1,OTC
4726,13-02-2021 10:00,24 hrs.,wallstreetbets,YRIV,23,0,23,-23,1,5,9,1,OTC
4726,13-02-2021 10:00,24 hrs.,wallstreetbets,ZMRK,7,0,7,-7,1,1,1,1,OTC
4726,13-02-2021 10:00,24 hrs.,wallstreetbets,ZNOG,7,0,7,-7,1,1,1,1,OTC
4726,13-02-2021 10:00,24 hrs.,wallstreetbets,AGUNF,6,0,6,-6,1,1,0,1,OTC
4726,13-02-2021 10:00,24 hrs.,wallstreetbets,AMYZF,23,0,23,-23,3,3,5,2,OTC
4726,13-02-2021 10:00,24 hrs.,wallstreetbets,ARBKF,6,0,6,-6,1,1,0,1,OTC
4726,13-02-2021 10:00,24 hrs.,wallstreetbets,ATURF,7,0,7,-7,1,1,1,1,OTC
4726,13-02-2021 10:00,24 hrs.,wallstreetbets,AZKLF,18,0,18,-18,3,3,0,1,OTC
4726,13-02-2021 10:00,24 hrs.,wallstreetbets,BBKCF,6,0,6,-6,1,1,0,1,OTC
4726,13-02-2021 10:00,24 hrs.,wallstreetbets,BDRBF,14,0,14,-14,2,2,2,2,OTC
4726,13-02-2021 10:00,24 hrs.,wallstreetbets,CLXPF,7,0,7,-7,1,1,1,1,OTC
4726,13-02-2021 10:00,24 hrs.,wallstreetbets,CNPOF,7,7,0,7,1,1,1,1,OTC
4726,13-02-2021 10:00,24 hrs.,wallstreetbets,CRLBF,18,6,12,-6,3,3,0,3,OTC
4726,13-02-2021 10:00,24 hrs.,wallstreetbets,CTTAY,34,34,0,34,1,10,10,1,OTC
4726,13-02-2021 10:00,24 hrs.,wallstreetbets,CURLF,6,6,0,6,1,1,0,1,OTC
4726,13-02-2021 10:00,24 hrs.,wallstreetbets,DIAAF,7,0,7,-7,1,1,1,1,OTC
4726,13-02-2021 10:00,24 hrs.,wallstreetbets,EPWCF,7,7,0,7,1,1,1,1,OTC
4726,13-02-2021 10:00,24 hrs.,wallstreetbets,FDVRF,6,0,6,-6,1,1,0,1,OTC
4726,13-02-2021 10:00,24 hrs.,wallstreetbets,FUNFF,7,7,0,7,1,1,1,1,OTC
4726,13-02-2021 10:00,24 hrs.,wallstreetbets,GAYMF,6,0,6,-6,1,1,0,1,OTC
4726,13-02-2021 10:00,24 hrs.,wallstreetbets,GGTTF,7,0,7,-7,1,1,1,1,OTC
4726,13-02-2021 10:00,24 hrs.,wallstreetbets,GTBIF,13,6,7,-1,2,2,1,2,OTC
4726,13-02-2021 10:00,24 hrs.,wallstreetbets,HITIF,59,52,7,45,4,13,17,3,OTC
4726,13-02-2021 10:00,24 hrs.,wallstreetbets,HRSTW,11,0,11,-11,2,1,1,1,OTC
4726,13-02-2021 10:00,24 hrs.,wallstreetbets,HTZGQ,7,7,0,7,1,1,1,1,OTC
4726,13-02-2021 10:00,24 hrs.,wallstreetbets,HUTMF,13,0,13,-13,2,2,1,2,OTC
4726,13-02-2021 10:00,24 hrs.,wallstreetbets,HVBTF,22,0,22,-22,3,3,4,3,OTC
4726,13-02-2021 10:00,24 hrs.,wallstreetbets,FTPM,7,0,7,-7,1,1,1,1,OTC
4726,13-02-2021 10:00,24 hrs.,wallstreetbets,GAHC,14,14,0,14,2,2,2,1,OTC
4726,13-02-2021 10:00,24 hrs.,wallstreetbets,GARB,7,0,7,-7,1,1,1,1,OTC
4726,13-02-2021 10:00,24 hrs.,wallstreetbets,GBTC,6009,0,6009,-6009,3,2826,345,2,OTC
4726,13-02-2021 10:00,24 hrs.,wallstreetbets,GMEV,14,0,14,-14,2,2,2,2,OTC
4726,13-02-2021 10:00,24 hrs.,wallstreetbets,GMSC,14,0,14,-14,2,2,2,1,OTC
4726,13-02-2021 10:00,24 hrs.,wallstreetbets,GPFT,27,7,20,-13,4,4,3,4,OTC
4726,13-02-2021 10:00,24 hrs.,wallstreetbets,GRNH,7,7,0,7,1,1,1,1,OTC
4726,13-02-2021 10:00,24 hrs.,wallstreetbets,GTCH,7,0,7,-7,1,1,1,1,OTC
4726,13-02-2021 10:00,24 hrs.,wallstreetbets,GTEH,20,14,6,8,3,3,2,3,OTC
4726,13-02-2021 10:00,24 hrs.,wallstreetbets,GTLL,12,6,6,0,2,2,0,2,OTC
4726,13-02-2021 10:00,24 hrs.,wallstreetbets,GTXO,14,0,14,-14,2,2,2,1,OTC
4726,13-02-2021 10:00,24 hrs.,wallstreetbets,HCMC,292,40,252,-212,43,43,34,39,OTC
4726,13-02-2021 10:00,24 hrs.,wallstreetbets,HEMP,27,6,21,-15,4,4,3,3,OTC
4726,13-02-2021 10:00,24 hrs.,wallstreetbets,HGLC,14,14,0,14,2,2,2,1,OTC
4726,13-02-2021 10:00,24 hrs.,wallstreetbets,HIHI,7,0,7,-7,1,1,1,1,OTC
4726,13-02-2021 10:00,24 hrs.,wallstreetbets,HIPH,7,0,7,-7,1,1,1,1,OTC
4726,13-02-2021 10:00,24 hrs.,wallstreetbets,HMNY,42,0,42,-42,6,6,6,3,OTC
4726,13-02-2021 10:00,24 hrs.,wallstreetbets,HMPQ,7,0,7,-7,1,1,1,1,OTC
4726,13-02-2021 10:00,24 hrs.,wallstreetbets,HQGE,28,0,28,-28,4,4,4,3,OTC
4726,13-02-2021 10:00,24 hrs.,wallstreetbets,HRBR,6,0,6,-6,1,1,0,1,OTC
4726,13-02-2021 10:00,24 hrs.,wallstreetbets,HTRE,7,7,0,7,1,1,1,1,OTC
4726,13-02-2021 10:00,24 hrs.,wallstreetbets,HYSR,20,13,7,6,3,3,2,3,OTC
4726,13-02-2021 10:00,24 hrs.,wallstreetbets,ICBU,7,0,7,-7,1,1,1,1,OTC
4726,13-02-2021 10:00,24 hrs.,wallstreetbets,INCT,21,0,21,-21,3,3,3,2,OTC
4726,13-02-2021 10:00,24 hrs.,wallstreetbets,INKW,7,0,7,-7,1,1,1,1,OTC
4726,13-02-2021 10:00,24 hrs.,wallstreetbets,INND,14,0,14,-14,2,2,2,1,OTC
4726,13-02-2021 10:00,24 hrs.,wallstreetbets,INTV,28,7,21,-14,4,4,4,3,OTC
4726,13-02-2021 10:00,24 hrs.,wallstreetbets,IPIX,12,0,12,-12,1,4,0,1,OTC
4726,13-02-2021 10:00,24 hrs.,wallstreetbets,IQST,13,0,13,-13,2,2,1,1,OTC
4726,13-02-2021 10:00,24 hrs.,wallstreetbets,ITCJ,6,0,6,-6,1,1,0,1,OTC
4726,13-02-2021 10:00,24 hrs.,wallstreetbets,KALY,7,0,7,-7,1,1,1,1,OTC
4726,13-02-2021 10:00,24 hrs.,wallstreetbets,KWBT,7,0,7,-7,1,1,1,1,OTC
4726,13-02-2021 10:00,24 hrs.,wallstreetbets,KYNC,7,0,7,-7,1,1,1,1,OTC
4726,13-02-2021 10:00,24 hrs.,wallstreetbets,LBCC,7,0,7,-7,1,1,1,1,OTC
4726,13-02-2021 10:00,24 hrs.,wallstreetbets,LINK,455,7,448,-441,5,179,77,5,OTC
4726,13-02-2021 10:00,24 hrs.,wallstreetbets,LITH,7,0,7,-7,1,1,1,1,OTC
4726,13-02-2021 10:00,24 hrs.,wallstreetbets,LQMT,7,7,0,7,1,1,1,1,OTC
4726,13-02-2021 10:00,24 hrs.,wallstreetbets,LRDG,14,14,0,14,2,2,2,1,OTC
4726,13-02-2021 10:00,24 hrs.,wallstreetbets,LTNC,14,0,14,-14,2,2,2,2,OTC
4726,13-02-2021 10:00,24 hrs.,wallstreetbets,LTUM,6,0,6,-6,1,1,0,1,OTC
4726,13-02-2021 10:00,24 hrs.,wallstreetbets,MAXD,22,0,22,-22,3,3,4,3,OTC
4726,13-02-2021 10:00,24 hrs.,wallstreetbets,MCOA,20,0,20,-20,3,3,2,3,OTC
4726,13-02-2021 10:00,24 hrs.,wallstreetbets,MEDH,7,0,7,-7,1,1,1,1,OTC
4726,13-02-2021 10:00,24 hrs.,wallstreetbets,MGNT,7,0,7,-7,1,1,1,1,OTC
4726,13-02-2021 10:00,24 hrs.,wallstreetbets,MGTI,7,0,7,-7,1,1,1,1,OTC
4726,13-02-2021 10:00,24 hrs.,wallstreetbets,MINE,48,0,48,-48,7,7,6,4,OTC
4726,13-02-2021 10:00,24 hrs.,wallstreetbets,MJNA,34,7,27,-20,5,5,4,5,OTC
4726,13-02-2021 10:00,24 hrs.,wallstreetbets,MKTY,21,0,21,-21,3,3,3,2,OTC
4726,13-02-2021 10:00,24 hrs.,wallstreetbets,MLFB,7,7,0,7,1,1,1,1,OTC
4726,13-02-2021 10:00,24 hrs.,wallstreetbets,MNGG,6,6,0,6,1,1,0,1,OTC
4726,13-02-2021 10:00,24 hrs.,wallstreetbets,MOJO,13,0,13,-13,2,2,1,1,OTC
4726,13-02-2021 10:00,24 hrs.,wallstreetbets,MOST,49,0,49,-49,4,14,5,4,OTC
4726,13-02-2021 10:00,24 hrs.,wallstreetbets,NBVG,6,0,6,-6,1,1,0,1,OTC
4726,13-02-2021 10:00,24 hrs.,wallstreetbets,NEOM,28,7,21,-14,4,4,4,3,OTC
4726,13-02-2021 10:00,24 hrs.,wallstreetbets,NOVC,34,0,34,-34,5,5,4,3,OTC
4726,13-02-2021 10:00,24 hrs.,wallstreetbets,NPHC,7,0,7,-7,1,1,1,1,OTC
4726,13-02-2021 10:00,24 hrs.,wallstreetbets,NWPN,6,0,6,-6,1,1,0,1,OTC
4726,13-02-2021 10:00,24 hrs.,wallstreetbets,ONPH,6,0,6,-6,1,1,0,1,OTC
4726,13-02-2021 10:00,24 hrs.,wallstreetbets,OTTV,14,0,14,-14,2,2,2,1,OTC
4726,13-02-2021 10:00,24 hrs.,wallstreetbets,OWPC,6,0,6,-6,1,1,0,1,OTC
4726,13-02-2021 10:00,24 hrs.,wallstreetbets,OZSC,14,7,7,0,2,2,2,2,OTC
4726,13-02-2021 10:00,24 hrs.,wallstreetbets,PAOG,7,0,7,-7,1,1,1,1,OTC
4726,13-02-2021 10:00,24 hrs.,wallstreetbets,PHBI,14,0,14,-14,2,2,2,1,OTC
4726,13-02-2021 10:00,24 hrs.,wallstreetbets,BUDZ,6,0,6,-6,1,1,0,1,OTC
4726,13-02-2021 10:00,24 hrs.,wallstreetbets,CBDD,7,0,7,-7,1,1,1,1,OTC
4726,13-02-2021 10:00,24 hrs.,wallstreetbets,CBDL,55,0,55,-55,8,8,7,5,OTC
4726,13-02-2021 10:00,24 hrs.,wallstreetbets,CCTC,7,0,7,-7,1,1,1,1,OTC
4726,13-02-2021 10:00,24 hrs.,wallstreetbets,CGLD,7,0,7,-7,1,1,1,1,OTC
4726,13-02-2021 10:00,24 hrs.,wallstreetbets,CHUC,7,0,7,-7,1,1,1,1,OTC
4726,13-02-2021 10:00,24 hrs.,wallstreetbets,CLIS,14,0,14,-14,2,2,2,1,OTC
4726,13-02-2021 10:00,24 hrs.,wallstreetbets,CLWD,7,0,7,-7,1,1,1,1,OTC
4726,13-02-2021 10:00,24 hrs.,wallstreetbets,COMS,19,0,19,-19,3,3,1,2,OTC
4726,13-02-2021 10:00,24 hrs.,wallstreetbets,CYDY,7,0,7,-7,1,1,1,1,OTC
4726,13-02-2021 10:00,24 hrs.,wallstreetbets,CYLC,7,0,7,-7,1,1,1,1,OTC
4726,13-02-2021 10:00,24 hrs.,wallstreetbets,DGWR,7,0,7,-7,1,1,1,1,OTC
4726,13-02-2021 10:00,24 hrs.,wallstreetbets,DPLS,13,0,13,-13,2,2,1,2,OTC
4726,13-02-2021 10:00,24 hrs.,wallstreetbets,DPWW,7,0,7,-7,1,1,1,1,OTC
4726,13-02-2021 10:00,24 hrs.,wallstreetbets,ELCR,7,0,7,-7,1,1,1,1,OTC
4726,13-02-2021 10:00,24 hrs.,wallstreetbets,ELTP,31,7,24,-17,4,4,7,4,OTC
4726,13-02-2021 10:00,24 hrs.,wallstreetbets,ENZN,7,0,7,-7,1,1,1,1,OTC
4726,13-02-2021 10:00,24 hrs.,wallstreetbets,EPOR,8,8,0,8,1,1,2,1,OTC
4726,13-02-2021 10:00,24 hrs.,wallstreetbets,ETFM,17,0,17,-17,2,2,5,1,OTC
4726,13-02-2021 10:00,24 hrs.,wallstreetbets,EWKS,6,0,6,-6,1,1,0,1,OTC
4726,13-02-2021 10:00,24 hrs.,wallstreetbets,FNMA,7,7,0,7,1,1,1,1,OTC
4726,13-02-2021 10:00,24 hrs.,wallstreetbets,FTEG,14,7,7,0,2,2,2,2,OTC
4726,13-02-2021 10:00,24 hrs.,pennystocks,SNGX,2083,89,1994,-1905,17,811,393,9,NASDAQ
4726,13-02-2021 10:00,24 hrs.,pennystocks,SOLO,19,0,19,-19,1,7,1,1,NASDAQ
4726,13-02-2021 10:00,24 hrs.,pennystocks,SRGA,6,0,6,-6,1,1,0,1,NASDAQ
4726,13-02-2021 10:00,24 hrs.,pennystocks,STCN,6,0,6,-6,1,1,0,1,NASDAQ
4726,13-02-2021 10:00,24 hrs.,pennystocks,TBLT,192,186,6,180,2,69,46,2,NASDAQ
4726,13-02-2021 10:00,24 hrs.,pennystocks,TLRY,7,0,7,-7,1,1,1,1,NASDAQ
4726,13-02-2021 10:00,24 hrs.,pennystocks,TNXP,231,146,85,61,9,72,51,5,NASDAQ
4726,13-02-2021 10:00,24 hrs.,pennystocks,TRCH,247,240,7,233,5,80,67,5,NASDAQ
4726,13-02-2021 10:00,24 hrs.,pennystocks,TRVG,19,0,19,-19,3,3,1,2,NASDAQ
4726,13-02-2021 10:00,24 hrs.,pennystocks,TSLA,6,0,6,-6,1,1,0,1,NASDAQ
4726,13-02-2021 10:00,24 hrs.,pennystocks,TXMD,13,6,7,-1,2,2,1,2,NASDAQ
4726,13-02-2021 10:00,24 hrs.,pennystocks,TYME,20,0,20,-20,1,6,4,1,NASDAQ
4726,13-02-2021 10:00,24 hrs.,pennystocks,VEON,7,0,7,-7,1,1,1,1,NASDAQ
4726,13-02-2021 10:00,24 hrs.,pennystocks,VETS,1718,0,1718,-1718,1,729,256,1,NASDAQ
4726,13-02-2021 10:00,24 hrs.,pennystocks,VTGN,7,7,0,7,1,1,1,1,NASDAQ
4726,13-02-2021 10:00,24 hrs.,pennystocks,VUZI,6,6,0,6,1,0,2,1,NASDAQ
4726,13-02-2021 10:00,24 hrs.,pennystocks,XELA,202,0,202,-202,1,90,18,1,NASDAQ
4726,13-02-2021 10:00,24 hrs.,pennystocks,XSPA,34,0,34,-34,1,13,4,1,NASDAQ
4726,13-02-2021 10:00,24 hrs.,pennystocks,ZSAN,92,0,92,-92,2,28,28,2,NASDAQ
4726,13-02-2021 10:00,24 hrs.,wallstreetbets,ABML,14,0,14,-14,2,2,2,2,OTC
4726,13-02-2021 10:00,24 hrs.,wallstreetbets,ACRL,6,0,6,-6,1,1,0,1,OTC
4726,13-02-2021 10:00,24 hrs.,wallstreetbets,ACTX,8,0,8,-8,1,1,2,1,OTC
4726,13-02-2021 10:00,24 hrs.,wallstreetbets,AITX,23,23,0,23,2,1,13,2,OTC
4726,13-02-2021 10:00,24 hrs.,wallstreetbets,ALPP,14,0,14,-14,2,2,2,2,OTC
4726,13-02-2021 10:00,24 hrs.,wallstreetbets,ALYI,7,0,7,-7,1,1,1,1,OTC
4726,13-02-2021 10:00,24 hrs.,wallstreetbets,AMNE,13,0,13,-13,2,2,1,1,OTC
4726,13-02-2021 10:00,24 hrs.,wallstreetbets,APCX,7,0,7,-7,1,1,1,1,OTC
4726,13-02-2021 10:00,24 hrs.,wallstreetbets,ASTI,7,7,0,7,1,1,1,1,OTC
4726,13-02-2021 10:00,24 hrs.,wallstreetbets,BANT,13,7,6,1,2,2,1,2,OTC
4726,13-02-2021 10:00,24 hrs.,wallstreetbets,BBRW,20,20,0,20,3,3,2,1,OTC
4726,13-02-2021 10:00,24 hrs.,wallstreetbets,BIEL,12,0,12,-12,2,2,0,2,OTC
4726,13-02-2021 10:00,24 hrs.,wallstreetbets,BLSP,28,7,21,-14,4,4,4,2,OTC
4726,13-02-2021 10:00,24 hrs.,wallstreetbets,BMIX,11,0,11,-11,1,1,5,1,OTC
4726,13-02-2021 10:00,24 hrs.,wallstreetbets,BOTH,7,0,7,-7,1,1,1,1,OTC
4726,13-02-2021 10:00,24 hrs.,wallstreetbets,BOTY,12,6,6,0,2,2,0,2,OTC
4726,13-02-2021 10:00,24 hrs.,wallstreetbets,BRLL,7,0,7,-7,1,1,1,1,OTC
4726,13-02-2021 10:00,24 hrs.,wallstreetbets,BTCS,21,0,21,-21,3,3,3,1,OTC
4726,13-02-2021 10:00,24 hrs.,wallstreetbets,BTSC,7,0,7,-7,1,1,1,1,OTC
4726,13-02-2021 10:00,24 hrs.,wallstreetbets,BTZI,13,0,13,-13,2,2,1,2,OTC
4726,13-02-2021 10:00,24 hrs.,pennystocks,GLBS,27,0,27,-27,1,0,23,1,NASDAQ
4726,13-02-2021 10:00,24 hrs.,pennystocks,GNPX,6,6,0,6,1,0,2,1,NASDAQ
4726,13-02-2021 10:00,24 hrs.,pennystocks,GNUS,6,6,0,6,1,1,0,1,NASDAQ
4726,13-02-2021 10:00,24 hrs.,pennystocks,GOEV,93,0,93,-93,2,28,29,2,NASDAQ
4726,13-02-2021 10:00,24 hrs.,pennystocks,GOOG,7,7,0,7,1,0,3,1,NASDAQ
4726,13-02-2021 10:00,24 hrs.,pennystocks,HRTX,15,0,15,-15,1,2,7,1,NASDAQ
4726,13-02-2021 10:00,24 hrs.,pennystocks,HSTO,6,0,6,-6,1,1,0,1,NASDAQ
4726,13-02-2021 10:00,24 hrs.,pennystocks,IBKR,7,7,0,7,1,1,1,1,NASDAQ
4726,13-02-2021 10:00,24 hrs.,pennystocks,IDEX,6,6,0,6,1,0,2,1,NASDAQ
4726,13-02-2021 10:00,24 hrs.,pennystocks,INFI,12,0,12,-12,1,1,6,1,NASDAQ
4726,13-02-2021 10:00,24 hrs.,pennystocks,INOD,69,0,69,-69,1,11,43,1,NASDAQ
4726,13-02-2021 10:00,24 hrs.,pennystocks,INPX,6,6,0,6,1,1,0,1,NASDAQ
4726,13-02-2021 10:00,24 hrs.,pennystocks,IRDM,19,0,19,-19,1,7,1,1,NASDAQ
4726,13-02-2021 10:00,24 hrs.,pennystocks,IZEA,6,0,6,-6,1,1,0,1,NASDAQ
4726,13-02-2021 10:00,24 hrs.,pennystocks,KTRA,51,0,51,-51,3,8,23,3,NASDAQ
4726,13-02-2021 10:00,24 hrs.,pennystocks,KXIN,19,0,19,-19,1,7,1,1,NASDAQ
4726,13-02-2021 10:00,24 hrs.,pennystocks,LIFE,6,6,0,6,1,1,0,1,NASDAQ
4726,13-02-2021 10:00,24 hrs.,pennystocks,LLIT,7,7,0,7,1,1,1,1,NASDAQ
4726,13-02-2021 10:00,24 hrs.,pennystocks,LPTH,70,0,70,-70,1,27,12,1,NASDAQ
4726,13-02-2021 10:00,24 hrs.,pennystocks,LPTX,43,43,0,43,1,11,17,1,NASDAQ
4726,13-02-2021 10:00,24 hrs.,pennystocks,MARK,6,6,0,6,1,1,0,1,NASDAQ
4726,13-02-2021 10:00,24 hrs.,pennystocks,MOGO,26,26,0,26,1,8,6,1,NASDAQ
4726,13-02-2021 10:00,24 hrs.,pennystocks,MVIS,14,14,0,14,1,0,10,1,NASDAQ
4726,13-02-2021 10:00,24 hrs.,pennystocks,NAKD,1191,1151,40,1111,3,513,153,3,NASDAQ
4726,13-02-2021 10:00,24 hrs.,pennystocks,NAOV,6,0,6,-6,1,1,0,1,NASDAQ
4726,13-02-2021 10:00,24 hrs.,pennystocks,NCMI,17,0,17,-17,1,5,3,1,NASDAQ
4726,13-02-2021 10:00,24 hrs.,pennystocks,NDAQ,19,0,19,-19,1,7,1,1,NASDAQ
4726,13-02-2021 10:00,24 hrs.,pennystocks,NMTR,6,6,0,6,1,1,0,1,NASDAQ
4726,13-02-2021 10:00,24 hrs.,pennystocks,NOVN,6,0,6,-6,1,1,0,1,NASDAQ
4726,13-02-2021 10:00,24 hrs.,pennystocks,NVCN,55,12,43,-31,3,15,13,2,NASDAQ
4726,13-02-2021 10:00,24 hrs.,pennystocks,OCGN,66,6,60,-54,4,16,18,4,NASDAQ
4726,13-02-2021 10:00,24 hrs.,pennystocks,ONTX,6,0,6,-6,1,1,0,1,NASDAQ
4726,13-02-2021 10:00,24 hrs.,pennystocks,OPTT,24,0,24,-24,1,8,4,1,NASDAQ
4726,13-02-2021 10:00,24 hrs.,pennystocks,OTIC,10,0,10,-10,1,1,4,1,NASDAQ
4726,13-02-2021 10:00,24 hrs.,pennystocks,PLAY,6,0,6,-6,1,1,0,1,NASDAQ
4726,13-02-2021 10:00,24 hrs.,pennystocks,PLUG,19,0,19,-19,1,7,1,1,NASDAQ
4726,13-02-2021 10:00,24 hrs.,pennystocks,PSTV,6,0,6,-6,1,1,0,1,NASDAQ
4726,13-02-2021 10:00,24 hrs.,pennystocks,PTON,33,33,0,33,1,12,5,1,NASDAQ
4726,13-02-2021 10:00,24 hrs.,pennystocks,PULM,188,0,188,-188,4,35,102,4,NASDAQ
4726,13-02-2021 10:00,24 hrs.,pennystocks,RIBT,13,6,7,-1,2,2,1,2,NASDAQ
4726,13-02-2021 10:00,24 hrs.,pennystocks,RIDE,6,0,6,-6,1,1,0,1,NASDAQ
4726,13-02-2021 10:00,24 hrs.,pennystocks,SEAC,17,5,12,-7,2,2,5,2,NASDAQ
4726,13-02-2021 10:00,24 hrs.,pennystocks,SELB,20,0,20,-20,1,6,4,1,NASDAQ
4726,13-02-2021 10:00,24 hrs.,pennystocks,SESN,69,69,0,69,1,30,5,1,NASDAQ
4726,13-02-2021 10:00,24 hrs.,pennystocks,SFET,31,0,31,-31,2,5,13,2,NASDAQ
4726,13-02-2021 10:00,24 hrs.,pennystocks,SHIP,20,0,20,-20,3,3,2,2,NASDAQ
4726,13-02-2021 10:00,24 hrs.,pennystocks,SNDL,112,6,106,-100,18,18,4,15,NASDAQ
4726,13-02-2021 10:00,24 hrs.,pennystocks,EBON,6,0,6,-6,1,1,0,1,NASDAQ
4726,13-02-2021 10:00,24 hrs.,pennystocks,EDIT,202,0,202,-202,1,90,18,1,NASDAQ
4726,13-02-2021 10:00,24 hrs.,pennystocks,ENTX,26,0,26,-26,1,9,4,1,NASDAQ
4726,13-02-2021 10:00,24 hrs.,pennystocks,ENVB,6,0,6,-6,1,1,0,1,NASDAQ
4726,13-02-2021 10:00,24 hrs.,pennystocks,EPSN,12,0,12,-12,2,2,0,2,NASDAQ
4726,13-02-2021 10:00,24 hrs.,pennystocks,FAMI,13,0,13,-13,2,2,1,2,NASDAQ
4726,13-02-2021 10:00,24 hrs.,pennystocks,FAST,6,0,6,-6,1,1,0,1,NASDAQ
4726,13-02-2021 10:00,24 hrs.,pennystocks,FATE,19,0,19,-19,1,7,1,1,NASDAQ
4726,13-02-2021 10:00,24 hrs.,pennystocks,GAIN,7,0,7,-7,1,1,1,1,NASDAQ
4726,13-02-2021 10:00,24 hrs.,pennystocks,GALT,7,0,7,-7,1,1,1,1,NASDAQ
4726,13-02-2021 10:00,24 hrs.,pennystocks,GEVO,6,0,6,-6,1,1,0,1,NASDAQ
4726,13-02-2021 10:00,24 hrs.,pennystocks,GHSI,103,0,103,-103,1,48,3,1,NASDAQ
4726,13-02-2021 10:00,24 hrs.,pennystocks,MIN,6,6,0,6,1,1,0,1,NYSE
4726,13-02-2021 10:00,24 hrs.,pennystocks,NAT,7,0,7,-7,1,1,1,1,NYSE
4726,13-02-2021 10:00,24 hrs.,pennystocks,NOK,6,0,6,-6,1,1,0,1,NYSE
4726,13-02-2021 10:00,24 hrs.,pennystocks,NPV,26,0,26,-26,1,8,6,1,NYSE
4726,13-02-2021 10:00,24 hrs.,pennystocks,RKT,86,0,86,-86,1,27,28,1,NYSE
4726,13-02-2021 10:00,24 hrs.,pennystocks,RSI,283,0,283,-283,1,123,33,1,NYSE
4726,13-02-2021 10:00,24 hrs.,pennystocks,SOS,51,6,45,-39,4,8,19,4,NYSE
4726,13-02-2021 10:00,24 hrs.,pennystocks,SUM,283,0,283,-283,1,123,33,1,NYSE
4726,13-02-2021 10:00,24 hrs.,pennystocks,TSM,43,0,43,-43,1,12,15,1,NYSE
4726,13-02-2021 10:00,24 hrs.,pennystocks,VET,7,7,0,7,1,1,1,1,NYSE
4726,13-02-2021 10:00,24 hrs.,pennystocks,WEI,19,0,19,-19,1,7,1,1,NYSE
4726,13-02-2021 10:00,24 hrs.,pennystocks,WLL,6,0,6,-6,1,1,0,1,NYSE
4726,13-02-2021 10:00,24 hrs.,pennystocks,ARGO,44,0,44,-44,1,7,26,1,NYSE
4726,13-02-2021 10:00,24 hrs.,pennystocks,CCIV,7,0,7,-7,1,1,1,1,NYSE
4726,13-02-2021 10:00,24 hrs.,pennystocks,DASH,24,24,0,24,1,7,6,1,NYSE
4726,13-02-2021 10:00,24 hrs.,pennystocks,FINV,16,0,16,-16,1,4,4,1,NYSE
4726,13-02-2021 10:00,24 hrs.,pennystocks,HEXO,23,0,23,-23,1,2,15,1,NYSE
4726,13-02-2021 10:00,24 hrs.,pennystocks,PUMP,13,0,13,-13,2,2,1,1,NYSE
4726,13-02-2021 10:00,24 hrs.,pennystocks,SHOP,12,12,0,12,2,2,0,1,NYSE
4726,13-02-2021 10:00,24 hrs.,pennystocks,SPCE,33,33,0,33,1,12,5,1,NYSE
4726,13-02-2021 10:00,24 hrs.,pennystocks,VIST,12,0,12,-12,1,2,4,1,NYSE
4726,13-02-2021 10:00,24 hrs.,pennystocks,WELL,1718,0,1718,-1718,1,729,256,1,NYSE
4726,13-02-2021 10:00,24 hrs.,pennystocks,FWP,10,0,10,-10,1,0,6,1,NASDAQ
4726,13-02-2021 10:00,24 hrs.,pennystocks,GBT,6,0,6,-6,1,1,0,1,NASDAQ
4726,13-02-2021 10:00,24 hrs.,pennystocks,KOD,6,0,6,-6,1,1,0,1,NASDAQ
4726,13-02-2021 10:00,24 hrs.,pennystocks,MKD,23,0,23,-23,1,6,7,1,NASDAQ
4726,13-02-2021 10:00,24 hrs.,pennystocks,MYT,11,0,11,-11,1,1,5,1,NASDAQ
4726,13-02-2021 10:00,24 hrs.,pennystocks,OGI,19,19,0,19,1,6,3,1,NASDAQ
4726,13-02-2021 10:00,24 hrs.,pennystocks,SND,43,43,0,43,1,11,17,1,NASDAQ
4726,13-02-2021 10:00,24 hrs.,pennystocks,SPI,13,13,0,13,1,3,3,1,NASDAQ
4726,13-02-2021 10:00,24 hrs.,pennystocks,ABEO,7,0,7,-7,1,1,1,1,NASDAQ
4726,13-02-2021 10:00,24 hrs.,pennystocks,ACST,6,0,6,-6,1,1,0,1,NASDAQ
4726,13-02-2021 10:00,24 hrs.,pennystocks,AGEN,10,0,10,-10,1,3,0,1,NASDAQ
4726,13-02-2021 10:00,24 hrs.,pennystocks,AGTC,14,0,14,-14,2,2,2,2,NASDAQ
4726,13-02-2021 10:00,24 hrs.,pennystocks,AIKI,6,6,0,6,1,1,0,1,NASDAQ
4726,13-02-2021 10:00,24 hrs.,pennystocks,AMTX,73,0,73,-73,1,25,19,1,NASDAQ
4726,13-02-2021 10:00,24 hrs.,pennystocks,APHA,80,0,80,-80,3,26,16,3,NASDAQ
4726,13-02-2021 10:00,24 hrs.,pennystocks,APRE,6,6,0,6,1,1,0,1,NASDAQ
4726,13-02-2021 10:00,24 hrs.,pennystocks,ARTL,55,0,55,-55,5,14,7,3,NASDAQ
4726,13-02-2021 10:00,24 hrs.,pennystocks,ASRT,479,0,479,-479,6,168,119,6,NASDAQ
4726,13-02-2021 10:00,24 hrs.,pennystocks,ATOS,130,0,130,-130,3,45,28,3,NASDAQ
4726,13-02-2021 10:00,24 hrs.,pennystocks,BCLI,6,6,0,6,1,0,2,1,NASDAQ
4726,13-02-2021 10:00,24 hrs.,pennystocks,BIOL,49,43,6,37,2,12,17,2,NASDAQ
4726,13-02-2021 10:00,24 hrs.,pennystocks,BLUE,15,15,0,15,1,3,5,1,NASDAQ
4726,13-02-2021 10:00,24 hrs.,pennystocks,BNGO,70,33,37,-4,4,23,8,4,NASDAQ
4726,13-02-2021 10:00,24 hrs.,pennystocks,BWEN,12,12,0,12,2,2,0,2,NASDAQ
4726,13-02-2021 10:00,24 hrs.,pennystocks,CFMS,12,0,12,-12,2,2,0,2,NASDAQ
4726,13-02-2021 10:00,24 hrs.,pennystocks,CIDM,126,0,126,-126,2,29,60,2,NASDAQ
4726,13-02-2021 10:00,24 hrs.,pennystocks,CKPT,27,0,27,-27,3,4,7,3,NASDAQ
4726,13-02-2021 10:00,24 hrs.,pennystocks,CLBS,258,71,187,-116,5,89,60,5,NASDAQ
4726,13-02-2021 10:00,24 hrs.,pennystocks,CLEU,7,0,7,-7,1,1,1,1,NASDAQ
4726,13-02-2021 10:00,24 hrs.,pennystocks,CMPS,7,7,0,7,1,1,1,1,NASDAQ
4726,13-02-2021 10:00,24 hrs.,pennystocks,COCP,41,0,41,-41,2,15,3,2,NASDAQ
4726,13-02-2021 10:00,24 hrs.,pennystocks,CPLP,18,0,18,-18,2,0,10,1,NASDAQ
4726,13-02-2021 10:00,24 hrs.,pennystocks,CRBP,75,0,75,-75,1,32,7,1,NASDAQ
4726,13-02-2021 10:00,24 hrs.,pennystocks,CRWS,6,0,6,-6,1,1,0,1,NASDAQ
4726,13-02-2021 10:00,24 hrs.,pennystocks,CSCW,7,0,7,-7,1,1,1,1,NASDAQ
4726,13-02-2021 10:00,24 hrs.,pennystocks,CSTR,6,0,6,-6,1,1,0,1,NASDAQ
4726,13-02-2021 10:00,24 hrs.,pennystocks,CTHR,20,0,20,-20,1,6,4,1,NASDAQ
4726,13-02-2021 10:00,24 hrs.,pennystocks,CTMX,14,0,14,-14,1,2,6,1,NASDAQ
4726,13-02-2021 10:00,24 hrs.,pennystocks,CTRM,77,22,55,-33,7,18,13,7,NASDAQ
4726,13-02-2021 10:00,24 hrs.,pennystocks,CTXR,20,0,20,-20,1,6,4,1,NASDAQ
4726,13-02-2021 10:00,24 hrs.,pennystocks,CYTH,8,0,8,-8,1,1,2,1,NASDAQ
4726,13-02-2021 10:00,24 hrs.,pennystocks,DFFN,292,91,201,-110,7,112,40,7,NASDAQ
4726,13-02-2021 10:00,24 hrs.,pennystocks,CLI,62,0,62,-62,1,21,16,1,NYSE
4726,13-02-2021 10:00,24 hrs.,pennystocks,CMD,62,0,62,-62,1,21,16,1,NYSE
4726,13-02-2021 10:00,24 hrs.,pennystocks,CVE,18,0,18,-18,3,3,0,1,NYSE
4726,13-02-2021 10:00,24 hrs.,pennystocks,CVX,31,0,31,-31,1,10,7,1,NYSE
4726,13-02-2021 10:00,24 hrs.,pennystocks,ETH,6,0,6,-6,1,1,0,1,NYSE
4726,13-02-2021 10:00,24 hrs.,pennystocks,FLT,42,0,42,-42,1,15,8,1,NYSE
4726,13-02-2021 10:00,24 hrs.,pennystocks,GME,24,12,12,0,4,4,0,3,NYSE
4726,13-02-2021 10:00,24 hrs.,pennystocks,IRR,26,0,26,-26,1,8,6,1,NYSE
4726,13-02-2021 10:00,24 hrs.,pennystocks,KOS,7,7,0,7,1,1,1,1,NYSE
4726,13-02-2021 10:00,24 hrs.,pennystocks,LOW,6,6,0,6,1,1,0,1,NYSE
4726,13-02-2021 10:00,24 hrs.,pennystocks,MDC,19,0,19,-19,1,6,3,1,NYSE
4726,13-02-2021 10:00,24 hrs.,pennystocks,MED,6,6,0,6,1,1,0,1,NYSE
4726,13-02-2021 10:00,24 hrs.,RobinHoodPennyStocks,GLBS,6,0,6,-6,1,1,0,1,NASDAQ
4726,13-02-2021 10:00,24 hrs.,RobinHoodPennyStocks,IDEX,13,0,13,-13,1,2,5,1,NASDAQ
4726,13-02-2021 10:00,24 hrs.,RobinHoodPennyStocks,IMMR,17,17,0,17,1,5,3,1,NASDAQ
4726,13-02-2021 10:00,24 hrs.,RobinHoodPennyStocks,INPX,12,12,0,12,2,2,0,1,NASDAQ
4726,13-02-2021 10:00,24 hrs.,RobinHoodPennyStocks,ITRM,6,0,6,-6,1,1,0,1,NASDAQ
4726,13-02-2021 10:00,24 hrs.,RobinHoodPennyStocks,KTRA,19,19,0,19,1,5,5,1,NASDAQ
4726,13-02-2021 10:00,24 hrs.,RobinHoodPennyStocks,LKCO,103,0,103,-103,8,28,15,8,NASDAQ
4726,13-02-2021 10:00,24 hrs.,RobinHoodPennyStocks,MMLP,6,0,6,-6,1,1,0,1,NASDAQ
4726,13-02-2021 10:00,24 hrs.,RobinHoodPennyStocks,NAKD,112,100,12,88,3,41,18,3,NASDAQ
4726,13-02-2021 10:00,24 hrs.,RobinHoodPennyStocks,NMTR,156,0,156,-156,1,52,48,1,NASDAQ
4726,13-02-2021 10:00,24 hrs.,RobinHoodPennyStocks,NOVN,47,0,47,-47,1,16,11,1,NASDAQ
4726,13-02-2021 10:00,24 hrs.,RobinHoodPennyStocks,NVCN,62,0,62,-62,2,15,24,2,NASDAQ
4726,13-02-2021 10:00,24 hrs.,RobinHoodPennyStocks,OCGN,42,0,42,-42,1,12,14,1,NASDAQ
4726,13-02-2021 10:00,24 hrs.,RobinHoodPennyStocks,OPGN,30,0,30,-30,5,5,0,1,NASDAQ
4726,13-02-2021 10:00,24 hrs.,RobinHoodPennyStocks,OPTT,6,0,6,-6,1,1,0,1,NASDAQ
4726,13-02-2021 10:00,24 hrs.,RobinHoodPennyStocks,OVID,6,0,6,-6,1,1,0,1,NASDAQ
4726,13-02-2021 10:00,24 hrs.,RobinHoodPennyStocks,PHUN,6,6,0,6,1,1,0,1,NASDAQ
4726,13-02-2021 10:00,24 hrs.,RobinHoodPennyStocks,PSEC,51,0,51,-51,3,11,17,2,NASDAQ
4726,13-02-2021 10:00,24 hrs.,RobinHoodPennyStocks,PSTV,155,0,155,-155,1,63,25,1,NASDAQ
4726,13-02-2021 10:00,24 hrs.,RobinHoodPennyStocks,RIOT,9,0,9,-9,1,1,3,1,NASDAQ
4726,13-02-2021 10:00,24 hrs.,RobinHoodPennyStocks,SHIP,54,6,48,-42,9,9,0,6,NASDAQ
4726,13-02-2021 10:00,24 hrs.,RobinHoodPennyStocks,SNDL,1474,12,1462,-1450,24,536,306,22,NASDAQ
4726,13-02-2021 10:00,24 hrs.,RobinHoodPennyStocks,SNGX,195,9,186,-177,3,81,21,2,NASDAQ
4726,13-02-2021 10:00,24 hrs.,RobinHoodPennyStocks,SRAX,6,0,6,-6,1,1,0,1,NASDAQ
4726,13-02-2021 10:00,24 hrs.,RobinHoodPennyStocks,SRGA,6,0,6,-6,1,1,0,1,NASDAQ
4726,13-02-2021 10:00,24 hrs.,RobinHoodPennyStocks,TBLT,87,0,87,-87,1,28,27,1,NASDAQ
4726,13-02-2021 10:00,24 hrs.,RobinHoodPennyStocks,TNXP,56,0,56,-56,2,15,18,2,NASDAQ
4726,13-02-2021 10:00,24 hrs.,RobinHoodPennyStocks,TRCH,93,6,87,-81,3,23,35,3,NASDAQ
4726,13-02-2021 10:00,24 hrs.,RobinHoodPennyStocks,TTOO,34,0,34,-34,1,12,6,1,NASDAQ
4726,13-02-2021 10:00,24 hrs.,RobinHoodPennyStocks,TXMD,36,18,18,0,6,6,0,6,NASDAQ
4726,13-02-2021 10:00,24 hrs.,RobinHoodPennyStocks,TYME,6,6,0,6,1,1,0,1,NASDAQ
4726,13-02-2021 10:00,24 hrs.,RobinHoodPennyStocks,XSPA,23,0,23,-23,1,9,1,1,NASDAQ
4726,13-02-2021 10:00,24 hrs.,RobinHoodPennyStocks,ZSAN,696,0,696,-696,3,296,92,3,NASDAQ
4726,13-02-2021 10:00,24 hrs.,RobinHoodPennyStocks,CTRM,502,89,413,-324,11,126,206,11,NASDAQ
4726,13-02-2021 10:00,24 hrs.,RobinHoodPennyStocks,DFFN,894,155,739,-584,9,346,166,8,NASDAQ
4726,13-02-2021 10:00,24 hrs.,RobinHoodPennyStocks,ENTX,58,0,58,-58,1,22,10,1,NASDAQ
4726,13-02-2021 10:00,24 hrs.,RobinHoodPennyStocks,FCEL,51,0,51,-51,1,9,29,1,NASDAQ
4726,13-02-2021 10:00,24 hrs.,RobinHoodPennyStocks,GAIN,6,6,0,6,1,1,0,1,NASDAQ
4714,13-02-2021 08:00,24 hrs.,wallstreetbets,HPK,6,0,6,-6,1,1,0,1,NASDAQ
4714,13-02-2021 08:00,24 hrs.,wallstreetbets,IEA,7,0,7,-7,1,1,1,1,NASDAQ
4714,13-02-2021 08:00,24 hrs.,wallstreetbets,IIN,6,6,0,6,1,1,0,1,NASDAQ
4714,13-02-2021 08:00,24 hrs.,wallstreetbets,INO,132,58,74,-16,14,18,40,14,NASDAQ
4714,13-02-2021 08:00,24 hrs.,wallstreetbets,JFU,6,6,0,6,1,1,0,1,NASDAQ
4714,13-02-2021 08:00,24 hrs.,wallstreetbets,KHC,14,14,0,14,2,2,2,2,NASDAQ
4714,13-02-2021 08:00,24 hrs.,wallstreetbets,KOD,6,0,6,-6,1,1,0,1,NASDAQ
4714,13-02-2021 08:00,24 hrs.,wallstreetbets,MGI,9,0,9,-9,1,1,3,1,NASDAQ
4714,13-02-2021 08:00,24 hrs.,wallstreetbets,MKD,13,13,0,13,2,2,1,2,NASDAQ
4714,13-02-2021 08:00,24 hrs.,wallstreetbets,MYT,7,7,0,7,1,1,1,1,NASDAQ
4714,13-02-2021 08:00,24 hrs.,wallstreetbets,NPA,6,0,6,-6,1,1,0,1,NASDAQ
4714,13-02-2021 08:00,24 hrs.,wallstreetbets,NWL,437,0,437,-437,1,179,75,1,NASDAQ
4714,13-02-2021 08:00,24 hrs.,wallstreetbets,OGI,80,41,39,2,12,12,8,12,NASDAQ
4714,13-02-2021 08:00,24 hrs.,wallstreetbets,OPK,7,0,7,-7,1,1,1,1,NASDAQ
4714,13-02-2021 08:00,24 hrs.,wallstreetbets,PDD,7,7,0,7,1,1,1,1,NASDAQ
4714,13-02-2021 08:00,24 hrs.,wallstreetbets,RUN,237,237,0,237,3,71,83,3,NASDAQ
4714,13-02-2021 08:00,24 hrs.,wallstreetbets,RXT,7,7,0,7,1,1,1,1,NASDAQ
4714,13-02-2021 08:00,24 hrs.,wallstreetbets,SDC,7,7,0,7,1,1,1,1,NASDAQ
4714,13-02-2021 08:00,24 hrs.,wallstreetbets,SFT,7,0,7,-7,1,1,1,1,NASDAQ
4714,13-02-2021 08:00,24 hrs.,wallstreetbets,SLM,8,8,0,8,1,1,2,1,NASDAQ
4714,13-02-2021 08:00,24 hrs.,wallstreetbets,SLP,7,7,0,7,1,1,1,1,NASDAQ
4714,13-02-2021 08:00,24 hrs.,wallstreetbets,SMH,7,0,7,-7,1,1,1,1,NASDAQ
4714,13-02-2021 08:00,24 hrs.,wallstreetbets,SND,34,7,27,-20,5,5,4,5,NASDAQ
4714,13-02-2021 08:00,24 hrs.,wallstreetbets,SPI,7,0,7,-7,1,1,1,1,NASDAQ
4714,13-02-2021 08:00,24 hrs.,wallstreetbets,SPT,7,7,0,7,1,1,1,1,NASDAQ
4714,13-02-2021 08:00,24 hrs.,wallstreetbets,VFF,24,10,14,-4,3,3,6,3,NASDAQ
4714,13-02-2021 08:00,24 hrs.,wallstreetbets,WBA,7,7,0,7,1,1,1,1,NASDAQ
4714,13-02-2021 08:00,24 hrs.,wallstreetbets,WNW,60,45,15,30,8,8,12,7,NASDAQ
4714,13-02-2021 08:00,24 hrs.,wallstreetbets,WWR,6,6,0,6,1,1,0,1,NASDAQ
4714,13-02-2021 08:00,24 hrs.,wallstreetbets,AACG,7,0,7,-7,1,1,1,1,NASDAQ
4714,13-02-2021 08:00,24 hrs.,SPACs,ZGYH,333,0,333,-333,1,95,139,1,NASDAQ
4714,13-02-2021 08:00,24 hrs.,SPACs,CMLFW,239,239,0,239,1,20,195,1,NASDAQ
4714,13-02-2021 08:00,24 hrs.,SPACs,DSACW,239,239,0,239,1,20,195,1,NASDAQ
4714,13-02-2021 08:00,24 hrs.,SPACs,EXPCW,239,239,0,239,1,20,195,1,NASDAQ
4714,13-02-2021 08:00,24 hrs.,SPACs,FCACW,239,239,0,239,1,20,195,1,NASDAQ
4714,13-02-2021 08:00,24 hrs.,SPACs,NBACR,5,5,0,5,1,0,1,1,NASDAQ
4714,13-02-2021 08:00,24 hrs.,SPACs,NBACW,5,5,0,5,1,0,1,1,NASDAQ
4714,13-02-2021 08:00,24 hrs.,SPACs,SAIIW,239,239,0,239,1,20,195,1,NASDAQ
4714,13-02-2021 08:00,24 hrs.,SPACs,TWCTW,239,239,0,239,1,20,195,1,NASDAQ
4714,13-02-2021 08:00,24 hrs.,stocks,ABML,6,0,6,-6,1,1,0,1,OTC
4714,13-02-2021 08:00,24 hrs.,wallstreetbets,AAPL,32,19,13,6,5,5,2,5,NASDAQ
4714,13-02-2021 08:00,24 hrs.,wallstreetbets,AAWW,6,0,6,-6,1,1,0,1,NASDAQ
4714,13-02-2021 08:00,24 hrs.,wallstreetbets,ABCL,7,7,0,7,1,1,1,1,NASDAQ
4714,13-02-2021 08:00,24 hrs.,wallstreetbets,ABEO,7,0,7,-7,1,1,1,1,NASDAQ
4714,13-02-2021 08:00,24 hrs.,wallstreetbets,ABNB,21,6,15,-9,3,3,3,2,NASDAQ
4714,13-02-2021 08:00,24 hrs.,wallstreetbets,ABUS,7,0,7,-7,1,1,1,1,NASDAQ
4714,13-02-2021 08:00,24 hrs.,wallstreetbets,ACEV,6,0,6,-6,1,1,0,1,NASDAQ
4714,13-02-2021 08:00,24 hrs.,wallstreetbets,ACIU,7,0,7,-7,1,1,1,1,NASDAQ
4714,13-02-2021 08:00,24 hrs.,wallstreetbets,ACOR,7,7,0,7,1,1,1,1,NASDAQ
4714,13-02-2021 08:00,24 hrs.,wallstreetbets,ACST,20,0,20,-20,3,3,2,3,NASDAQ
4714,13-02-2021 08:00,24 hrs.,wallstreetbets,ADMA,7,7,0,7,1,1,1,1,NASDAQ
4714,13-02-2021 08:00,24 hrs.,wallstreetbets,ADMP,7,0,7,-7,1,1,1,1,NASDAQ
4714,13-02-2021 08:00,24 hrs.,wallstreetbets,ADXS,6,0,6,-6,1,1,0,1,NASDAQ
4714,13-02-2021 08:00,24 hrs.,wallstreetbets,AEZS,14,0,14,-14,2,2,2,1,NASDAQ
4714,13-02-2021 08:00,24 hrs.,wallstreetbets,AGEN,7,0,7,-7,1,1,1,1,NASDAQ
4714,13-02-2021 08:00,24 hrs.,wallstreetbets,AGTC,36,0,36,-36,5,5,6,3,NASDAQ
4714,13-02-2021 08:00,24 hrs.,wallstreetbets,AIKI,7,0,7,-7,1,1,1,1,NASDAQ
4714,13-02-2021 08:00,24 hrs.,wallstreetbets,AKBA,7,7,0,7,1,1,1,1,NASDAQ
4714,13-02-2021 08:00,24 hrs.,wallstreetbets,ALRN,7,7,0,7,1,1,1,1,NASDAQ
4714,13-02-2021 08:00,24 hrs.,wallstreetbets,AMAT,13,0,13,-13,2,2,1,2,NASDAQ
4714,13-02-2021 08:00,24 hrs.,wallstreetbets,AMBC,8,0,8,-8,1,1,2,1,NASDAQ
4714,13-02-2021 08:00,24 hrs.,wallstreetbets,AMKR,21,0,21,-21,3,3,3,3,NASDAQ
4714,13-02-2021 08:00,24 hrs.,wallstreetbets,AMZN,116,21,95,-74,5,4,88,5,NASDAQ
4714,13-02-2021 08:00,24 hrs.,wallstreetbets,ANCN,7,0,7,-7,1,1,1,1,NASDAQ
4714,13-02-2021 08:00,24 hrs.,wallstreetbets,APEN,7,7,0,7,1,1,1,1,NASDAQ
4714,13-02-2021 08:00,24 hrs.,wallstreetbets,APHA,627,346,281,65,45,149,149,32,NASDAQ
4714,13-02-2021 08:00,24 hrs.,wallstreetbets,APPS,7,7,0,7,1,1,1,1,NASDAQ
4714,13-02-2021 08:00,24 hrs.,wallstreetbets,APRE,7,0,7,-7,1,1,1,1,NASDAQ
4714,13-02-2021 08:00,24 hrs.,wallstreetbets,AQST,13,0,13,-13,2,2,1,2,NASDAQ
4714,13-02-2021 08:00,24 hrs.,wallstreetbets,ARTL,89,0,89,-89,13,13,11,11,NASDAQ
4714,13-02-2021 08:00,24 hrs.,wallstreetbets,ASRT,48,20,28,-8,7,7,6,7,NASDAQ
4714,13-02-2021 08:00,24 hrs.,wallstreetbets,ASYS,6,0,6,-6,1,1,0,1,NASDAQ
4714,13-02-2021 08:00,24 hrs.,wallstreetbets,ATHA,7,0,7,-7,1,1,1,1,NASDAQ
4714,13-02-2021 08:00,24 hrs.,wallstreetbets,ATHE,12,0,12,-12,2,2,0,1,NASDAQ
4714,13-02-2021 08:00,24 hrs.,wallstreetbets,ATOS,41,20,21,-1,6,6,5,5,NASDAQ
4714,13-02-2021 08:00,24 hrs.,wallstreetbets,ATVI,7,7,0,7,1,1,1,1,NASDAQ
4714,13-02-2021 08:00,24 hrs.,wallstreetbets,AUPH,6,0,6,-6,1,1,0,1,NASDAQ
4714,13-02-2021 08:00,24 hrs.,wallstreetbets,AVXL,7,0,7,-7,1,1,1,1,NASDAQ
4714,13-02-2021 08:00,24 hrs.,wallstreetbets,AWRE,7,0,7,-7,1,1,1,1,NASDAQ
4714,13-02-2021 08:00,24 hrs.,wallstreetbets,AYRO,7,0,7,-7,1,1,1,1,NASDAQ
4714,13-02-2021 08:00,24 hrs.,wallstreetbets,BBBY,7,7,0,7,1,1,1,1,NASDAQ
4714,13-02-2021 08:00,24 hrs.,wallstreetbets,BEAT,8,0,8,-8,1,2,0,1,NASDAQ
4714,13-02-2021 08:00,24 hrs.,wallstreetbets,BIOC,7,0,7,-7,1,1,1,1,NASDAQ
4714,13-02-2021 08:00,24 hrs.,wallstreetbets,BIVI,6,6,0,6,1,1,0,1,NASDAQ
4714,13-02-2021 08:00,24 hrs.,wallstreetbets,BLCM,6,6,0,6,1,1,0,1,NASDAQ
4714,13-02-2021 08:00,24 hrs.,wallstreetbets,BLNK,7,0,7,-7,1,1,1,1,NASDAQ
4714,13-02-2021 08:00,24 hrs.,wallstreetbets,BNGO,350,271,79,192,21,100,66,12,NASDAQ
4714,13-02-2021 08:00,24 hrs.,wallstreetbets,BNTX,13,0,13,-13,2,2,1,1,NASDAQ
4714,13-02-2021 08:00,24 hrs.,wallstreetbets,BOXL,7,0,7,-7,1,1,1,1,NASDAQ
4714,13-02-2021 08:00,24 hrs.,wallstreetbets,BPTH,7,0,7,-7,1,1,1,1,NASDAQ
4714,13-02-2021 08:00,24 hrs.,wallstreetbets,BRQS,6,0,6,-6,1,1,0,1,NASDAQ
4714,13-02-2021 08:00,24 hrs.,wallstreetbets,BTWN,7,0,7,-7,1,1,1,1,NASDAQ
4714,13-02-2021 08:00,24 hrs.,wallstreetbets,GSM,19,13,6,7,3,3,1,3,NASDAQ
4714,13-02-2021 08:00,24 hrs.,wallstreetbets,HAS,6,6,0,6,1,1,0,1,NASDAQ
4714,13-02-2021 08:00,24 hrs.,stocks,SSET,7,7,0,7,1,1,1,1,OTC
4714,13-02-2021 08:00,24 hrs.,stocks,TMRC,6,0,6,-6,1,1,0,1,OTC
4714,13-02-2021 08:00,24 hrs.,stocks,ACRDF,6,0,6,-6,1,1,0,1,OTC
4714,13-02-2021 08:00,24 hrs.,stocks,ACRHF,6,0,6,-6,1,1,0,1,OTC
4714,13-02-2021 08:00,24 hrs.,stocks,BDRBF,6,0,6,-6,1,1,0,1,OTC
4714,13-02-2021 08:00,24 hrs.,stocks,DGTHF,6,0,6,-6,1,1,0,1,OTC
4714,13-02-2021 08:00,24 hrs.,stocks,EMHTF,6,0,6,-6,1,1,0,1,OTC
4714,13-02-2021 08:00,24 hrs.,stocks,HRSTW,6,6,0,6,1,1,0,1,OTC
4714,13-02-2021 08:00,24 hrs.,stocks,ILIKF,6,6,0,6,1,1,0,1,OTC
4714,13-02-2021 08:00,24 hrs.,stocks,MMEDF,12,6,6,0,2,2,0,2,OTC
4714,13-02-2021 08:00,24 hrs.,stocks,NXTTF,6,0,6,-6,1,1,0,1,OTC
4714,13-02-2021 08:00,24 hrs.,stocks,OILFF,6,0,6,-6,1,1,0,1,OTC
4714,13-02-2021 08:00,24 hrs.,stocks,RHDGF,6,0,6,-6,1,1,0,1,OTC
4714,13-02-2021 08:00,24 hrs.,stocks,RHHBY,32,0,32,-32,1,10,8,1,OTC
4714,13-02-2021 08:00,24 hrs.,stocks,RLLCF,6,0,6,-6,1,1,0,1,OTC
4714,13-02-2021 08:00,24 hrs.,stocks,RVVTF,13,13,0,13,2,2,1,2,OTC
4714,13-02-2021 08:00,24 hrs.,stocks,TBUIF,6,6,0,6,1,1,0,1,OTC
4714,13-02-2021 08:00,24 hrs.,stocks,DNN,29,29,0,29,1,6,13,1,AMEX
4714,13-02-2021 08:00,24 hrs.,stocks,DSS,6,0,6,-6,1,1,0,1,AMEX
4714,13-02-2021 08:00,24 hrs.,stocks,GDP,33,0,33,-33,1,5,19,1,AMEX
4714,13-02-2021 08:00,24 hrs.,stocks,GTE,13,13,0,13,2,2,1,2,AMEX
4714,13-02-2021 08:00,24 hrs.,stocks,IGC,6,0,6,-6,1,1,0,1,AMEX
4714,13-02-2021 08:00,24 hrs.,stocks,MXC,6,0,6,-6,1,1,0,1,AMEX
4714,13-02-2021 08:00,24 hrs.,stocks,PLX,13,0,13,-13,1,2,5,1,AMEX
4714,13-02-2021 08:00,24 hrs.,stocks,ZOM,18,6,12,-6,3,3,0,3,AMEX
4714,13-02-2021 08:00,24 hrs.,stocks,GSAT,24,18,6,12,4,4,0,2,AMEX
4714,13-02-2021 08:00,24 hrs.,stocks,SENS,6,6,0,6,1,1,0,1,AMEX
4714,13-02-2021 08:00,24 hrs.,stocks,TMBR,6,0,6,-6,1,1,0,1,AMEX
4714,13-02-2021 08:00,24 hrs.,stocks,ADT,6,0,6,-6,1,1,0,1,NYSE
4714,13-02-2021 08:00,24 hrs.,stocks,AMC,117,79,38,41,5,23,51,5,NYSE
4714,13-02-2021 08:00,24 hrs.,stocks,ASX,13,6,7,-1,2,2,1,2,NYSE
4714,13-02-2021 08:00,24 hrs.,stocks,ATH,33,0,33,-33,1,5,19,1,NYSE
4714,13-02-2021 08:00,24 hrs.,stocks,BEP,217,0,217,-217,5,52,93,5,NYSE
4714,13-02-2021 08:00,24 hrs.,stocks,BHC,12,0,12,-12,1,3,2,1,NYSE
4714,13-02-2021 08:00,24 hrs.,stocks,BTT,6,0,6,-6,1,1,0,1,NYSE
4714,13-02-2021 08:00,24 hrs.,stocks,CBD,6,0,6,-6,1,1,0,1,NYSE
4714,13-02-2021 08:00,24 hrs.,stocks,CRM,6,0,6,-6,1,1,0,1,NYSE
4714,13-02-2021 08:00,24 hrs.,stocks,CVE,6,0,6,-6,1,1,0,1,NYSE
4714,13-02-2021 08:00,24 hrs.,stocks,CVS,38,27,11,16,3,8,10,3,NYSE
4714,13-02-2021 08:00,24 hrs.,stocks,DIS,12,0,12,-12,1,3,2,1,NYSE
4714,13-02-2021 08:00,24 hrs.,wallstreetbets,BWEN,7,7,0,7,1,1,1,1,NASDAQ
4714,13-02-2021 08:00,24 hrs.,wallstreetbets,CARE,49,0,49,-49,7,7,7,2,NASDAQ
4714,13-02-2021 08:00,24 hrs.,SPACs,PRCH,36,0,36,-36,1,13,6,1,NASDAQ
4714,13-02-2021 08:00,24 hrs.,SPACs,PYPL,94,94,0,94,1,34,22,1,NASDAQ
4714,13-02-2021 08:00,24 hrs.,SPACs,QELL,527,0,527,-527,2,221,77,2,NASDAQ
4714,13-02-2021 08:00,24 hrs.,SPACs,RCHG,333,0,333,-333,1,95,139,1,NASDAQ
4714,13-02-2021 08:00,24 hrs.,SPACs,RIDE,24,18,6,12,2,5,6,2,NASDAQ
4714,13-02-2021 08:00,24 hrs.,SPACs,ROCH,18,18,0,18,1,4,6,1,NASDAQ
4714,13-02-2021 08:00,24 hrs.,SPACs,SGAM,333,0,333,-333,1,95,139,1,NASDAQ
4714,13-02-2021 08:00,24 hrs.,SPACs,SRAC,130,8,122,-114,2,44,34,2,NASDAQ
4714,13-02-2021 08:00,24 hrs.,SPACs,SSPK,18,18,0,18,1,4,6,1,NASDAQ
4714,13-02-2021 08:00,24 hrs.,SPACs,STWO,333,0,333,-333,1,95,139,1,NASDAQ
4714,13-02-2021 08:00,24 hrs.,SPACs,SVAC,333,0,333,-333,1,95,139,1,NASDAQ
4714,13-02-2021 08:00,24 hrs.,SPACs,TEKK,333,0,333,-333,1,95,139,1,NASDAQ
4714,13-02-2021 08:00,24 hrs.,SPACs,THBR,273,239,34,205,2,25,215,2,NASDAQ
4714,13-02-2021 08:00,24 hrs.,SPACs,THCA,333,0,333,-333,1,95,139,1,NASDAQ
4714,13-02-2021 08:00,24 hrs.,SPACs,THCB,263,257,6,251,3,25,201,3,NASDAQ
4714,13-02-2021 08:00,24 hrs.,SPACs,TMPM,333,0,333,-333,1,95,139,1,NASDAQ
4714,13-02-2021 08:00,24 hrs.,SPACs,TMTS,333,0,333,-333,1,95,139,1,NASDAQ
4714,13-02-2021 08:00,24 hrs.,SPACs,TWCT,333,0,333,-333,1,95,139,1,NASDAQ
4714,13-02-2021 08:00,24 hrs.,SPACs,VACQ,333,0,333,-333,1,95,139,1,NASDAQ
4714,13-02-2021 08:00,24 hrs.,SPACs,VMAC,340,0,340,-340,2,96,140,2,NASDAQ
4714,13-02-2021 08:00,24 hrs.,SPACs,VTIQ,36,18,18,0,2,7,14,2,NASDAQ
4714,13-02-2021 08:00,24 hrs.,SPACs,YSAC,333,0,333,-333,1,95,139,1,NASDAQ
4714,13-02-2021 08:00,24 hrs.,wallstreetbets,CTMX,7,7,0,7,1,1,1,1,NASDAQ
4714,13-02-2021 08:00,24 hrs.,wallstreetbets,CTRM,253,35,218,-183,37,37,31,30,NASDAQ
4714,13-02-2021 08:00,24 hrs.,wallstreetbets,CVAC,60,60,0,60,1,20,16,1,NASDAQ
4714,13-02-2021 08:00,24 hrs.,wallstreetbets,DDOG,437,0,437,-437,1,179,75,1,NASDAQ
4714,13-02-2021 08:00,24 hrs.,wallstreetbets,DFFN,14,0,14,-14,2,2,2,1,NASDAQ
4714,13-02-2021 08:00,24 hrs.,wallstreetbets,DKNG,21,7,14,-7,3,3,3,3,NASDAQ
4714,13-02-2021 08:00,24 hrs.,wallstreetbets,DOYU,7,0,7,-7,1,1,1,1,NASDAQ
4714,13-02-2021 08:00,24 hrs.,wallstreetbets,DRIV,6,6,0,6,1,1,0,1,NASDAQ
4714,13-02-2021 08:00,24 hrs.,wallstreetbets,DRRX,7,0,7,-7,1,1,1,1,NASDAQ
4714,13-02-2021 08:00,24 hrs.,wallstreetbets,DSKE,7,0,7,-7,1,1,1,1,NASDAQ
4714,13-02-2021 08:00,24 hrs.,wallstreetbets,DXYN,7,7,0,7,1,1,1,1,NASDAQ
4714,13-02-2021 08:00,24 hrs.,wallstreetbets,EBON,56,49,7,42,8,8,8,4,NASDAQ
4714,13-02-2021 08:00,24 hrs.,wallstreetbets,EDIT,8187,98,8089,-7991,2,3810,559,2,NASDAQ
4714,13-02-2021 08:00,24 hrs.,wallstreetbets,EDSA,6,0,6,-6,1,1,0,1,NASDAQ
4714,13-02-2021 08:00,24 hrs.,wallstreetbets,EHTH,7,0,7,-7,1,1,1,1,NASDAQ
4714,13-02-2021 08:00,24 hrs.,wallstreetbets,ELSE,7,0,7,-7,1,1,1,1,NASDAQ
4714,13-02-2021 08:00,24 hrs.,wallstreetbets,ENLV,7,7,0,7,1,1,1,1,NASDAQ
4714,13-02-2021 08:00,24 hrs.,wallstreetbets,ENVB,26,0,26,-26,4,4,2,3,NASDAQ
4714,13-02-2021 08:00,24 hrs.,wallstreetbets,ESPR,7,0,7,-7,1,1,1,1,NASDAQ
4714,13-02-2021 08:00,24 hrs.,wallstreetbets,EVER,28,7,21,-14,4,4,4,4,NASDAQ
4714,13-02-2021 08:00,24 hrs.,wallstreetbets,EXPC,7,0,7,-7,1,1,1,1,NASDAQ
4714,13-02-2021 08:00,24 hrs.,wallstreetbets,EXPE,437,0,437,-437,1,179,75,1,NASDAQ
4714,13-02-2021 08:00,24 hrs.,wallstreetbets,EXPI,6,6,0,6,1,1,0,1,NASDAQ
4714,13-02-2021 08:00,24 hrs.,wallstreetbets,FAMI,6,0,6,-6,1,1,0,1,NASDAQ
4714,13-02-2021 08:00,24 hrs.,wallstreetbets,FARM,7,0,7,-7,1,1,1,1,NASDAQ
4714,13-02-2021 08:00,24 hrs.,wallstreetbets,FAST,7,7,0,7,1,1,1,1,NASDAQ
4714,13-02-2021 08:00,24 hrs.,wallstreetbets,FCAC,8,0,8,-8,1,1,2,1,NASDAQ
4714,13-02-2021 08:00,24 hrs.,wallstreetbets,FCEL,6,0,6,-6,1,1,0,1,NASDAQ
4714,13-02-2021 08:00,24 hrs.,wallstreetbets,FLDM,7,0,7,-7,1,1,1,1,NASDAQ
4714,13-02-2021 08:00,24 hrs.,wallstreetbets,FLGT,13,0,13,-13,2,2,1,2,NASDAQ
4714,13-02-2021 08:00,24 hrs.,wallstreetbets,FLWR,7,7,0,7,1,1,1,1,NASDAQ
4714,13-02-2021 08:00,24 hrs.,wallstreetbets,FLWS,15,8,7,1,2,2,3,2,NASDAQ
4714,13-02-2021 08:00,24 hrs.,wallstreetbets,FOLD,48,14,34,-20,7,7,6,6,NASDAQ
4714,13-02-2021 08:00,24 hrs.,wallstreetbets,FORD,7,0,7,-7,1,1,1,1,NASDAQ
4714,13-02-2021 08:00,24 hrs.,wallstreetbets,FORM,168,168,0,168,1,67,30,1,NASDAQ
4714,13-02-2021 08:00,24 hrs.,wallstreetbets,FTFT,14,7,7,0,2,2,2,2,NASDAQ
4714,13-02-2021 08:00,24 hrs.,wallstreetbets,FUTU,1029,0,1029,-1029,1,407,211,1,NASDAQ
4714,13-02-2021 08:00,24 hrs.,wallstreetbets,GAIN,13,6,7,-1,2,2,1,2,NASDAQ
4714,13-02-2021 08:00,24 hrs.,wallstreetbets,GERN,6,6,0,6,1,1,0,1,NASDAQ
4714,13-02-2021 08:00,24 hrs.,wallstreetbets,GEVO,201,7,194,-187,9,54,57,7,NASDAQ
4714,13-02-2021 08:00,24 hrs.,wallstreetbets,GILT,14,0,14,-14,2,2,2,2,NASDAQ
4714,13-02-2021 08:00,24 hrs.,wallstreetbets,GLBS,21,21,0,21,3,3,3,2,NASDAQ
4714,13-02-2021 08:00,24 hrs.,stocks,APTY,6,0,6,-6,1,1,0,1,OTC
4714,13-02-2021 08:00,24 hrs.,stocks,BLSP,6,6,0,6,1,1,0,1,OTC
4714,13-02-2021 08:00,24 hrs.,stocks,BONZ,6,6,0,6,1,1,0,1,OTC
4714,13-02-2021 08:00,24 hrs.,stocks,CANN,6,0,6,-6,1,1,0,1,OTC
4714,13-02-2021 08:00,24 hrs.,stocks,CAPC,6,0,6,-6,1,1,0,1,OTC
4714,13-02-2021 08:00,24 hrs.,stocks,ETCG,6,6,0,6,1,1,0,1,OTC
4714,13-02-2021 08:00,24 hrs.,stocks,FRCH,14,14,0,14,1,5,0,1,OTC
4714,13-02-2021 08:00,24 hrs.,stocks,GRYN,6,0,6,-6,1,1,0,1,OTC
4714,13-02-2021 08:00,24 hrs.,stocks,GTEH,6,0,6,-6,1,1,0,1,OTC
4714,13-02-2021 08:00,24 hrs.,stocks,HCMC,22,16,6,10,2,2,10,2,OTC
4714,13-02-2021 08:00,24 hrs.,stocks,HEMP,38,38,0,38,1,9,16,1,OTC
4714,13-02-2021 08:00,24 hrs.,stocks,IGEN,6,6,0,6,1,1,0,1,OTC
4714,13-02-2021 08:00,24 hrs.,stocks,IJJP,6,6,0,6,1,1,0,1,OTC
4714,13-02-2021 08:00,24 hrs.,stocks,LINK,12,0,12,-12,1,3,2,1,OTC
4714,13-02-2021 08:00,24 hrs.,stocks,MCAP,6,0,6,-6,1,1,0,1,OTC
4714,13-02-2021 08:00,24 hrs.,stocks,MINE,6,6,0,6,1,1,0,1,OTC
4714,13-02-2021 08:00,24 hrs.,stocks,MJNA,6,0,6,-6,1,1,0,1,OTC
4714,13-02-2021 08:00,24 hrs.,stocks,MOJO,6,0,6,-6,1,1,0,1,OTC
4714,13-02-2021 08:00,24 hrs.,stocks,NTRR,6,0,6,-6,1,1,0,1,OTC
4714,13-02-2021 08:00,24 hrs.,stocks,OZSC,6,0,6,-6,1,1,0,1,OTC
4714,13-02-2021 08:00,24 hrs.,stocks,RSSV,17,0,17,-17,1,5,3,1,OTC
4714,13-02-2021 08:00,24 hrs.,stocks,SNYR,6,0,6,-6,1,1,0,1,OTC
4714,13-02-2021 08:00,24 hrs.,stocks,TWTR,6,6,0,6,1,1,0,1,NYSE
4714,13-02-2021 08:00,24 hrs.,stocks,VGAC,6,0,6,-6,1,1,0,1,NYSE
4714,13-02-2021 08:00,24 hrs.,stocks,XPEV,86,80,6,74,5,13,40,3,NYSE
4714,13-02-2021 08:00,24 hrs.,stocks,YETI,58,0,58,-58,1,13,28,1,NYSE
4714,13-02-2021 08:00,24 hrs.,stocks,AMD,59,6,53,-47,2,11,29,2,NASDAQ
4714,13-02-2021 08:00,24 hrs.,stocks,AZN,12,0,12,-12,1,3,2,1,NASDAQ
4714,13-02-2021 08:00,24 hrs.,stocks,CDC,12,0,12,-12,1,3,2,1,NASDAQ
4714,13-02-2021 08:00,24 hrs.,stocks,FTC,29,0,29,-29,1,8,9,1,NASDAQ
4714,13-02-2021 08:00,24 hrs.,stocks,GAN,7,7,0,7,1,1,1,1,NASDAQ
4714,13-02-2021 08:00,24 hrs.,stocks,GSM,71,71,0,71,2,22,19,1,NASDAQ
4714,13-02-2021 08:00,24 hrs.,stocks,IEA,18,0,18,-18,1,4,6,1,NASDAQ
4714,13-02-2021 08:00,24 hrs.,stocks,INO,6,6,0,6,1,1,0,1,NASDAQ
4714,13-02-2021 08:00,24 hrs.,stocks,NWL,12,0,12,-12,1,3,2,1,NASDAQ
4714,13-02-2021 08:00,24 hrs.,stocks,OGI,12,0,12,-12,2,2,0,2,NASDAQ
4714,13-02-2021 08:00,24 hrs.,stocks,PEP,30,30,0,30,1,6,14,1,NASDAQ
4714,13-02-2021 08:00,24 hrs.,stocks,SMH,31,31,0,31,1,4,19,1,NASDAQ
4714,13-02-2021 08:00,24 hrs.,stocks,SPI,6,6,0,6,1,1,0,1,NASDAQ
4714,13-02-2021 08:00,24 hrs.,stocks,WBA,21,21,0,21,1,6,5,1,NASDAQ
4714,13-02-2021 08:00,24 hrs.,stocks,ABUS,6,0,6,-6,1,1,0,1,NASDAQ
4714,13-02-2021 08:00,24 hrs.,stocks,DPG,11,11,0,11,1,3,1,1,NYSE
4714,13-02-2021 08:00,24 hrs.,stocks,ETH,6,0,6,-6,1,1,0,1,NYSE
4714,13-02-2021 08:00,24 hrs.,stocks,FCF,33,0,33,-33,1,5,19,1,NYSE
4714,13-02-2021 08:00,24 hrs.,stocks,FSR,6,0,6,-6,1,1,0,1,NYSE
4714,13-02-2021 08:00,24 hrs.,stocks,GME,1211,1092,119,973,13,481,197,12,NYSE
4714,13-02-2021 08:00,24 hrs.,stocks,IBM,356,0,356,-356,1,156,40,1,NYSE
4714,13-02-2021 08:00,24 hrs.,wallstreetbets,GLMD,21,0,21,-21,3,3,3,1,NASDAQ
4714,13-02-2021 08:00,24 hrs.,wallstreetbets,GLPG,7,0,7,-7,1,1,1,1,NASDAQ
4714,13-02-2021 08:00,24 hrs.,wallstreetbets,GLUU,30,0,30,-30,2,1,20,1,NASDAQ
4714,13-02-2021 08:00,24 hrs.,wallstreetbets,GMBL,7,0,7,-7,1,1,1,1,NASDAQ
4714,13-02-2021 08:00,24 hrs.,wallstreetbets,GNRS,14,0,14,-14,2,2,2,1,NASDAQ
4714,13-02-2021 08:00,24 hrs.,wallstreetbets,GNUS,27,21,6,15,4,4,3,4,NASDAQ
4714,13-02-2021 08:00,24 hrs.,wallstreetbets,GOEV,7,7,0,7,1,1,1,1,NASDAQ
4714,13-02-2021 08:00,24 hrs.,wallstreetbets,GOGO,49,36,13,23,8,8,1,5,NASDAQ
4714,13-02-2021 08:00,24 hrs.,wallstreetbets,GOLD,13,0,13,-13,2,2,1,2,NASDAQ
4714,13-02-2021 08:00,24 hrs.,wallstreetbets,GRIL,7,7,0,7,1,1,1,1,NASDAQ
4714,13-02-2021 08:00,24 hrs.,wallstreetbets,GRTS,6,0,6,-6,1,1,0,1,NASDAQ
4714,13-02-2021 08:00,24 hrs.,wallstreetbets,GTEC,8,8,0,8,1,1,2,1,NASDAQ
4714,13-02-2021 08:00,24 hrs.,wallstreetbets,GTHX,50,25,25,0,8,8,2,5,NASDAQ
4714,13-02-2021 08:00,24 hrs.,wallstreetbets,GWPH,13,0,13,-13,1,0,9,1,NASDAQ
4714,13-02-2021 08:00,24 hrs.,wallstreetbets,HALO,14,0,14,-14,2,2,2,2,NASDAQ
4714,13-02-2021 08:00,24 hrs.,wallstreetbets,HDSN,7,0,7,-7,1,1,1,1,NASDAQ
4714,13-02-2021 08:00,24 hrs.,wallstreetbets,HEAR,6,6,0,6,1,1,0,1,NASDAQ
4714,13-02-2021 08:00,24 hrs.,wallstreetbets,CARV,7,0,7,-7,1,1,1,1,NASDAQ
4714,13-02-2021 08:00,24 hrs.,wallstreetbets,CASH,14,0,14,-14,2,2,2,1,NASDAQ
4714,13-02-2021 08:00,24 hrs.,wallstreetbets,CATM,7,0,7,-7,1,1,1,1,NASDAQ
4714,13-02-2021 08:00,24 hrs.,wallstreetbets,CBAT,7,0,7,-7,1,1,1,1,NASDAQ
4714,13-02-2021 08:00,24 hrs.,wallstreetbets,CCRC,12,0,12,-12,2,2,0,1,NASDAQ
4714,13-02-2021 08:00,24 hrs.,wallstreetbets,CIDM,21,7,14,-7,3,3,3,3,NASDAQ
4714,13-02-2021 08:00,24 hrs.,wallstreetbets,CKPT,14,0,14,-14,2,2,2,2,NASDAQ
4714,13-02-2021 08:00,24 hrs.,wallstreetbets,CLBS,14,0,14,-14,2,2,2,1,NASDAQ
4714,13-02-2021 08:00,24 hrs.,wallstreetbets,CLEU,7,0,7,-7,1,1,1,1,NASDAQ
4714,13-02-2021 08:00,24 hrs.,wallstreetbets,CLGN,7,0,7,-7,1,1,1,1,NASDAQ
4714,13-02-2021 08:00,24 hrs.,wallstreetbets,CLSN,7,0,7,-7,1,1,1,1,NASDAQ
4714,13-02-2021 08:00,24 hrs.,wallstreetbets,CMPS,3190,14,3176,-3162,6,1326,514,6,NASDAQ
4714,13-02-2021 08:00,24 hrs.,wallstreetbets,CNDT,6,0,6,-6,1,1,0,1,NASDAQ
4714,13-02-2021 08:00,24 hrs.,wallstreetbets,COCP,7,7,0,7,1,1,1,1,NASDAQ
4714,13-02-2021 08:00,24 hrs.,wallstreetbets,CODX,7,0,7,-7,1,1,1,1,NASDAQ
4714,13-02-2021 08:00,24 hrs.,wallstreetbets,COHR,437,0,437,-437,1,179,75,1,NASDAQ
4714,13-02-2021 08:00,24 hrs.,wallstreetbets,CRBP,28,14,14,0,4,4,4,4,NASDAQ
4714,13-02-2021 08:00,24 hrs.,wallstreetbets,CRNT,13,0,13,-13,2,2,1,2,NASDAQ
4714,13-02-2021 08:00,24 hrs.,wallstreetbets,CRON,20,14,6,8,3,3,2,3,NASDAQ
4714,13-02-2021 08:00,24 hrs.,wallstreetbets,CRSP,68,68,0,68,4,6,40,2,NASDAQ
4714,13-02-2021 08:00,24 hrs.,wallstreetbets,CRSR,593,552,41,511,15,205,123,11,NASDAQ
4714,13-02-2021 08:00,24 hrs.,wallstreetbets,CTHR,7,0,7,-7,1,1,1,1,NASDAQ
4714,13-02-2021 08:00,24 hrs.,wallstreetbets,KOSS,170,7,163,-156,3,48,62,3,NASDAQ
4714,13-02-2021 08:00,24 hrs.,wallstreetbets,LAZR,8,8,0,8,1,1,2,1,NASDAQ
4714,13-02-2021 08:00,24 hrs.,wallstreetbets,LEGN,7,0,7,-7,1,1,1,1,NASDAQ
4714,13-02-2021 08:00,24 hrs.,wallstreetbets,LGND,13,0,13,-13,2,2,1,2,NASDAQ
4714,13-02-2021 08:00,24 hrs.,wallstreetbets,LIFE,20,6,14,-8,3,3,2,3,NASDAQ
4714,13-02-2021 08:00,24 hrs.,wallstreetbets,LITE,437,0,437,-437,1,179,75,1,NASDAQ
4714,13-02-2021 08:00,24 hrs.,wallstreetbets,LIVE,444,0,444,-444,2,180,76,2,NASDAQ
4714,13-02-2021 08:00,24 hrs.,wallstreetbets,LKCO,42,0,42,-42,6,6,6,5,NASDAQ
4714,13-02-2021 08:00,24 hrs.,wallstreetbets,LLIT,7,0,7,-7,1,1,1,1,NASDAQ
4714,13-02-2021 08:00,24 hrs.,wallstreetbets,LLNW,27,0,27,-27,4,4,3,4,NASDAQ
4714,13-02-2021 08:00,24 hrs.,wallstreetbets,LOAN,14,7,7,0,2,2,2,2,NASDAQ
4714,13-02-2021 08:00,24 hrs.,wallstreetbets,LPCN,7,0,7,-7,1,1,1,1,NASDAQ
4714,13-02-2021 08:00,24 hrs.,wallstreetbets,LRCX,510,0,510,-510,1,134,238,1,NASDAQ
4714,13-02-2021 08:00,24 hrs.,wallstreetbets,LXRX,7,7,0,7,1,1,1,1,NASDAQ
4714,13-02-2021 08:00,24 hrs.,wallstreetbets,MARA,28,14,14,0,4,4,4,4,NASDAQ
4714,13-02-2021 08:00,24 hrs.,wallstreetbets,MARK,14,0,14,-14,2,2,2,2,NASDAQ
4714,13-02-2021 08:00,24 hrs.,wallstreetbets,MBIO,6,6,0,6,1,1,0,1,NASDAQ
4714,13-02-2021 08:00,24 hrs.,wallstreetbets,MBRX,26,7,19,-12,4,4,2,4,NASDAQ
4714,13-02-2021 08:00,24 hrs.,wallstreetbets,MESO,7,7,0,7,1,1,1,1,NASDAQ
4714,13-02-2021 08:00,24 hrs.,stocks,ICE,33,0,33,-33,1,5,19,1,NYSE
4714,13-02-2021 08:00,24 hrs.,stocks,IRS,78,13,65,-52,2,26,18,2,NYSE
4714,13-02-2021 08:00,24 hrs.,stocks,JNJ,6,6,0,6,1,1,0,1,NYSE
4714,13-02-2021 08:00,24 hrs.,stocks,LOW,13,13,0,13,1,1,7,1,NYSE
4714,13-02-2021 08:00,24 hrs.,stocks,LUV,58,0,58,-58,1,13,28,1,NYSE
4714,13-02-2021 08:00,24 hrs.,stocks,MCO,12,0,12,-12,1,3,2,1,NYSE
4714,13-02-2021 08:00,24 hrs.,stocks,MFA,8,0,8,-8,1,1,2,1,NYSE
4714,13-02-2021 08:00,24 hrs.,stocks,MGM,10,0,10,-10,1,1,4,1,NYSE
4714,13-02-2021 08:00,24 hrs.,stocks,MRO,12,0,12,-12,1,3,2,1,NYSE
4714,13-02-2021 08:00,24 hrs.,stocks,NET,24,13,11,2,2,2,12,2,NYSE
4714,13-02-2021 08:00,24 hrs.,stocks,NGL,6,0,6,-6,1,1,0,1,NYSE
4714,13-02-2021 08:00,24 hrs.,stocks,NIO,863,118,745,-627,9,264,299,7,NYSE
4714,13-02-2021 08:00,24 hrs.,stocks,NOK,141,0,141,-141,3,23,83,3,NYSE
4714,13-02-2021 08:00,24 hrs.,stocks,NOM,79,0,79,-79,1,29,17,1,NYSE
4714,13-02-2021 08:00,24 hrs.,stocks,OSK,16,16,0,16,2,1,6,1,NYSE
4714,13-02-2021 08:00,24 hrs.,stocks,PEG,556,0,556,-556,1,40,472,1,NYSE
4714,13-02-2021 08:00,24 hrs.,stocks,PFE,7,0,7,-7,1,1,1,1,NYSE
4714,13-02-2021 08:00,24 hrs.,stocks,RAD,21,21,0,21,1,6,5,1,NYSE
4714,13-02-2021 08:00,24 hrs.,stocks,RDY,6,6,0,6,1,1,0,1,NYSE
4714,13-02-2021 08:00,24 hrs.,stocks,RTX,42,42,0,42,1,12,14,1,NYSE
4714,13-02-2021 08:00,24 hrs.,stocks,SOS,12,0,12,-12,2,2,0,2,NYSE
4714,13-02-2021 08:00,24 hrs.,stocks,SQZ,7,7,0,7,1,1,1,1,NYSE
4714,13-02-2021 08:00,24 hrs.,stocks,SUP,6,0,6,-6,1,1,0,1,NYSE
4714,13-02-2021 08:00,24 hrs.,stocks,TSM,53,0,53,-53,1,10,29,1,NYSE
4714,13-02-2021 08:00,24 hrs.,stocks,UBS,30679,0,30679,-30679,1,14993,689,1,NYSE
4714,13-02-2021 08:00,24 hrs.,stocks,WLL,6,0,6,-6,1,1,0,1,NYSE
4714,13-02-2021 08:00,24 hrs.,stocks,WMT,145,0,145,-145,1,46,49,1,NYSE
4714,13-02-2021 08:00,24 hrs.,stocks,AJRD,145,0,145,-145,1,46,49,1,NYSE
4714,13-02-2021 08:00,24 hrs.,stocks,APTV,145,0,145,-145,1,46,49,1,NYSE
4714,13-02-2021 08:00,24 hrs.,stocks,BABA,6,6,0,6,1,1,0,1,NYSE
4714,13-02-2021 08:00,24 hrs.,stocks,BEPC,36,0,36,-36,2,4,20,2,NYSE
4714,13-02-2021 08:00,24 hrs.,stocks,BORR,48,0,48,-48,3,11,14,3,NYSE
4714,13-02-2021 08:00,24 hrs.,stocks,CCIV,12,12,0,12,2,2,0,2,NYSE
4714,13-02-2021 08:00,24 hrs.,stocks,CHWY,25,25,0,25,1,6,9,1,NYSE
4714,13-02-2021 08:00,24 hrs.,stocks,COTY,6,0,6,-6,1,1,0,1,NYSE
4714,13-02-2021 08:00,24 hrs.,stocks,DASH,6,6,0,6,1,1,0,1,NYSE
4714,13-02-2021 08:00,24 hrs.,stocks,FUSE,6,0,6,-6,1,1,0,1,NYSE
4714,13-02-2021 08:00,24 hrs.,stocks,HEXO,6,0,6,-6,1,1,0,1,NYSE
4714,13-02-2021 08:00,24 hrs.,stocks,HOME,25,25,0,25,1,6,9,1,NYSE
4714,13-02-2021 08:00,24 hrs.,stocks,HUYA,97,6,91,-85,2,33,23,2,NYSE
4714,13-02-2021 08:00,24 hrs.,stocks,JMIA,6,0,6,-6,1,1,0,1,NYSE
4714,13-02-2021 08:00,24 hrs.,stocks,PLTR,564,122,442,-320,3,194,164,3,NYSE
4714,13-02-2021 08:00,24 hrs.,stocks,SHOP,72,72,0,72,1,17,34,1,NYSE
4714,13-02-2021 08:00,24 hrs.,stocks,SPCE,174,29,145,-116,2,53,60,2,NYSE
4714,13-02-2021 08:00,24 hrs.,stocks,TWLO,16,16,0,16,2,1,6,1,NYSE
4714,13-02-2021 08:00,24 hrs.,wallstreetbets,NVIV,7,7,0,7,1,1,1,1,NASDAQ
4714,13-02-2021 08:00,24 hrs.,wallstreetbets,OCGN,45,7,38,-31,7,7,3,6,NASDAQ
4714,13-02-2021 08:00,24 hrs.,wallstreetbets,ONTX,14,14,0,14,2,2,2,2,NASDAQ
4714,13-02-2021 08:00,24 hrs.,wallstreetbets,ONVO,7,0,7,-7,1,1,1,1,NASDAQ
4714,13-02-2021 08:00,24 hrs.,wallstreetbets,OPGN,14,0,14,-14,2,2,2,1,NASDAQ
4714,13-02-2021 08:00,24 hrs.,wallstreetbets,OPTT,6,0,6,-6,1,1,0,1,NASDAQ
4714,13-02-2021 08:00,24 hrs.,wallstreetbets,PENN,5959,0,5959,-5959,6,2794,347,2,NASDAQ
4714,13-02-2021 08:00,24 hrs.,wallstreetbets,PGNY,7,7,0,7,1,1,1,1,NASDAQ
4714,13-02-2021 08:00,24 hrs.,wallstreetbets,PHUN,7,0,7,-7,1,1,1,1,NASDAQ
4714,13-02-2021 08:00,24 hrs.,wallstreetbets,PLAY,7,0,7,-7,1,1,1,1,NASDAQ
4714,13-02-2021 08:00,24 hrs.,wallstreetbets,PLUG,7,0,7,-7,1,1,1,1,NASDAQ
4714,13-02-2021 08:00,24 hrs.,wallstreetbets,PLYA,20,13,7,6,3,3,2,2,NASDAQ
4714,13-02-2021 08:00,24 hrs.,wallstreetbets,POTX,7,0,7,-7,1,1,1,1,NASDAQ
4714,13-02-2021 08:00,24 hrs.,wallstreetbets,POWW,27,7,20,-13,4,4,3,4,NASDAQ
4714,13-02-2021 08:00,24 hrs.,wallstreetbets,PRCH,76,63,13,50,3,16,32,2,NASDAQ
4714,13-02-2021 08:00,24 hrs.,wallstreetbets,PRPL,1029,0,1029,-1029,1,407,211,1,NASDAQ
4714,13-02-2021 08:00,24 hrs.,wallstreetbets,PRTS,15,0,15,-15,2,2,3,1,NASDAQ
4714,13-02-2021 08:00,24 hrs.,wallstreetbets,PSAC,7,0,7,-7,1,1,1,1,NASDAQ
4714,13-02-2021 08:00,24 hrs.,wallstreetbets,PSEC,6,6,0,6,1,0,2,1,NASDAQ
4714,13-02-2021 08:00,24 hrs.,stocks,AESE,6,6,0,6,1,1,0,1,NASDAQ
4714,13-02-2021 08:00,24 hrs.,stocks,AEZS,199,0,199,-199,1,88,19,1,NASDAQ
4714,13-02-2021 08:00,24 hrs.,stocks,AGEN,10,0,10,-10,1,3,0,1,NASDAQ
4714,13-02-2021 08:00,24 hrs.,stocks,AGTC,12,0,12,-12,2,2,0,1,NASDAQ
4714,13-02-2021 08:00,24 hrs.,stocks,AMAT,7,7,0,7,1,1,1,1,NASDAQ
4714,13-02-2021 08:00,24 hrs.,stocks,AMZN,161,16,145,-129,2,48,57,2,NASDAQ
4714,13-02-2021 08:00,24 hrs.,stocks,APHA,891,0,891,-891,4,231,413,4,NASDAQ
4714,13-02-2021 08:00,24 hrs.,stocks,ARTL,18,0,18,-18,3,3,0,2,NASDAQ
4714,13-02-2021 08:00,24 hrs.,stocks,ASYS,6,0,6,-6,1,1,0,1,NASDAQ
4714,13-02-2021 08:00,24 hrs.,stocks,ATOS,199,0,199,-199,1,88,19,1,NASDAQ
4714,13-02-2021 08:00,24 hrs.,stocks,AVGO,6,0,6,-6,1,1,0,1,NASDAQ
4714,13-02-2021 08:00,24 hrs.,stocks,BNGO,6,0,6,-6,1,1,0,1,NASDAQ
4714,13-02-2021 08:00,24 hrs.,stocks,BYND,6,0,6,-6,1,1,0,1,NASDAQ
4714,13-02-2021 08:00,24 hrs.,stocks,CLVR,17,17,0,17,1,3,7,1,NASDAQ
4714,13-02-2021 08:00,24 hrs.,stocks,CMPS,18,6,12,-6,3,3,0,2,NASDAQ
4714,13-02-2021 08:00,24 hrs.,stocks,COHR,12,0,12,-12,1,3,2,1,NASDAQ
4714,13-02-2021 08:00,24 hrs.,stocks,CPST,6,0,6,-6,1,1,0,1,NASDAQ
4714,13-02-2021 08:00,24 hrs.,stocks,CRBP,7,7,0,7,1,1,1,1,NASDAQ
4714,13-02-2021 08:00,24 hrs.,stocks,CREG,6,6,0,6,1,1,0,1,NASDAQ
4714,13-02-2021 08:00,24 hrs.,stocks,CRNC,23,23,0,23,1,5,9,1,NASDAQ
4714,13-02-2021 08:00,24 hrs.,stocks,CRON,74,74,0,74,1,21,28,1,NASDAQ
4714,13-02-2021 08:00,24 hrs.,stocks,CRSP,145,0,145,-145,1,46,49,1,NASDAQ
4714,13-02-2021 08:00,24 hrs.,stocks,CRWD,145,0,145,-145,1,46,49,1,NASDAQ
4714,13-02-2021 08:00,24 hrs.,stocks,CTRM,13,0,13,-13,2,2,1,2,NASDAQ
4714,13-02-2021 08:00,24 hrs.,wallstreetbets,HJLI,14,0,14,-14,2,2,2,1,NASDAQ
4714,13-02-2021 08:00,24 hrs.,wallstreetbets,HSTO,26,0,26,-26,4,4,2,3,NASDAQ
4714,13-02-2021 08:00,24 hrs.,wallstreetbets,HTBX,8,0,8,-8,1,1,2,1,NASDAQ
4714,13-02-2021 08:00,24 hrs.,wallstreetbets,HZNP,7,7,0,7,1,1,1,1,NASDAQ
4714,13-02-2021 08:00,24 hrs.,wallstreetbets,ICLN,6,0,6,-6,1,1,0,1,NASDAQ
4714,13-02-2021 08:00,24 hrs.,wallstreetbets,ICON,7,0,7,-7,1,1,1,1,NASDAQ
4714,13-02-2021 08:00,24 hrs.,wallstreetbets,ICPT,7,0,7,-7,1,1,1,1,NASDAQ
4714,13-02-2021 08:00,24 hrs.,wallstreetbets,IDEX,158,0,158,-158,3,41,64,3,NASDAQ
4714,13-02-2021 08:00,24 hrs.,wallstreetbets,IFMK,7,7,0,7,1,1,1,1,NASDAQ
4714,13-02-2021 08:00,24 hrs.,wallstreetbets,IIVI,437,0,437,-437,1,179,75,1,NASDAQ
4714,13-02-2021 08:00,24 hrs.,wallstreetbets,ILMN,7,0,7,-7,1,1,1,1,NASDAQ
4714,13-02-2021 08:00,24 hrs.,wallstreetbets,IMGN,21,0,21,-21,3,3,3,3,NASDAQ
4714,13-02-2021 08:00,24 hrs.,wallstreetbets,INFI,21,0,21,-21,3,3,3,1,NASDAQ
4714,13-02-2021 08:00,24 hrs.,wallstreetbets,INPX,33,14,19,-5,5,5,3,4,NASDAQ
4714,13-02-2021 08:00,24 hrs.,wallstreetbets,INSG,6,6,0,6,1,1,0,1,NASDAQ
4714,13-02-2021 08:00,24 hrs.,wallstreetbets,INTC,150,13,137,-124,4,3,128,4,NASDAQ
4714,13-02-2021 08:00,24 hrs.,wallstreetbets,IPWR,6,0,6,-6,1,1,0,1,NASDAQ
4714,13-02-2021 08:00,24 hrs.,wallstreetbets,ITRM,42,7,35,-28,6,6,6,4,NASDAQ
4714,13-02-2021 08:00,24 hrs.,wallstreetbets,JAGX,45,45,0,45,7,7,3,3,NASDAQ
4714,13-02-2021 08:00,24 hrs.,wallstreetbets,JNCE,12,6,6,0,2,2,0,2,NASDAQ
4714,13-02-2021 08:00,24 hrs.,wallstreetbets,KOPN,15,15,0,15,2,2,3,2,NASDAQ
4714,13-02-2021 08:00,24 hrs.,stocks,EDIT,568,45,523,-478,5,186,176,5,NASDAQ
4714,13-02-2021 08:00,24 hrs.,stocks,ENPH,145,0,145,-145,1,46,49,1,NASDAQ
4714,13-02-2021 08:00,24 hrs.,stocks,ENTX,7,0,7,-7,1,1,1,1,NASDAQ
4714,13-02-2021 08:00,24 hrs.,stocks,EXPE,12,0,12,-12,1,3,2,1,NASDAQ
4714,13-02-2021 08:00,24 hrs.,stocks,EXPI,12,6,6,0,2,2,0,2,NASDAQ
4714,13-02-2021 08:00,24 hrs.,stocks,FNKO,26,26,0,26,1,10,2,1,NASDAQ
4714,13-02-2021 08:00,24 hrs.,stocks,GILT,6,0,6,-6,1,1,0,1,NASDAQ
4714,13-02-2021 08:00,24 hrs.,stocks,GLUU,7,0,7,-7,1,1,1,1,NASDAQ
4714,13-02-2021 08:00,24 hrs.,stocks,GOEV,128,0,128,-128,1,21,82,1,NASDAQ
4714,13-02-2021 08:00,24 hrs.,stocks,ICLN,98,0,98,-98,1,27,40,1,NASDAQ
4714,13-02-2021 08:00,24 hrs.,stocks,IIVI,12,0,12,-12,1,3,2,1,NASDAQ
4714,13-02-2021 08:00,24 hrs.,stocks,ILMN,24,0,24,-24,1,9,2,1,NASDAQ
4714,13-02-2021 08:00,24 hrs.,stocks,INPX,18,0,18,-18,3,3,0,1,NASDAQ
4714,13-02-2021 08:00,24 hrs.,stocks,INTC,108,0,108,-108,1,35,34,1,NASDAQ
4714,13-02-2021 08:00,24 hrs.,stocks,INVE,7,0,7,-7,1,1,1,1,NASDAQ
4714,13-02-2021 08:00,24 hrs.,stocks,ITRM,15,6,9,-3,2,3,1,2,NASDAQ
4714,13-02-2021 08:00,24 hrs.,stocks,LITE,12,0,12,-12,1,3,2,1,NASDAQ
4714,13-02-2021 08:00,24 hrs.,stocks,LIVE,12,0,12,-12,1,3,2,1,NASDAQ
4714,13-02-2021 08:00,24 hrs.,stocks,LKCO,12,0,12,-12,2,2,0,1,NASDAQ
4714,13-02-2021 08:00,24 hrs.,stocks,LLNW,26,0,26,-26,1,6,10,1,NASDAQ
4714,13-02-2021 08:00,24 hrs.,stocks,LMPX,26,26,0,26,1,10,2,1,NASDAQ
4714,13-02-2021 08:00,24 hrs.,stocks,LRCX,53,0,53,-53,1,10,29,1,NASDAQ
4714,13-02-2021 08:00,24 hrs.,stocks,MITK,6,6,0,6,1,1,0,1,NASDAQ
4714,13-02-2021 08:00,24 hrs.,stocks,MKSI,12,0,12,-12,1,3,2,1,NASDAQ
4714,13-02-2021 08:00,24 hrs.,stocks,MOGO,18,18,0,18,3,3,0,2,NASDAQ
4714,13-02-2021 08:00,24 hrs.,stocks,MRNA,6,6,0,6,1,1,0,1,NASDAQ
4714,13-02-2021 08:00,24 hrs.,stocks,MSFT,356,0,356,-356,1,156,40,1,NASDAQ
4714,13-02-2021 08:00,24 hrs.,stocks,NAKD,6,0,6,-6,1,1,0,1,NASDAQ
4714,13-02-2021 08:00,24 hrs.,stocks,NBAC,6,6,0,6,1,1,0,1,NASDAQ
4714,13-02-2021 08:00,24 hrs.,stocks,NCMI,64,0,64,-64,2,24,8,1,NASDAQ
4714,13-02-2021 08:00,24 hrs.,stocks,NKLA,6,6,0,6,1,1,0,1,NASDAQ
4714,13-02-2021 08:00,24 hrs.,stocks,NMTR,9,0,9,-9,1,1,3,1,NASDAQ
4714,13-02-2021 08:00,24 hrs.,stocks,NVDA,100,6,94,-88,3,23,42,3,NASDAQ
4714,13-02-2021 08:00,24 hrs.,stocks,NXTD,12,0,12,-12,2,2,0,1,NASDAQ
4714,13-02-2021 08:00,24 hrs.,stocks,NYMT,8,0,8,-8,1,1,2,1,NASDAQ
4714,13-02-2021 08:00,24 hrs.,stocks,OCGN,6,6,0,6,1,1,0,1,NASDAQ
4714,13-02-2021 08:00,24 hrs.,stocks,OCSL,12,12,0,12,2,2,0,1,NASDAQ
4714,13-02-2021 08:00,24 hrs.,stocks,OLED,113,0,113,-113,1,49,11,1,NASDAQ
4714,13-02-2021 08:00,24 hrs.,stocks,ONCR,7,7,0,7,1,1,1,1,NASDAQ
4714,13-02-2021 08:00,24 hrs.,stocks,ONTX,6,0,6,-6,1,1,0,1,NASDAQ
4714,13-02-2021 08:00,24 hrs.,stocks,ONVO,6,0,6,-6,1,1,0,1,NASDAQ
4714,13-02-2021 08:00,24 hrs.,wallstreetbets,MGNI,14,0,14,-14,2,2,2,2,NASDAQ
4714,13-02-2021 08:00,24 hrs.,wallstreetbets,MKSI,437,0,437,-437,1,179,75,1,NASDAQ
4714,13-02-2021 08:00,24 hrs.,wallstreetbets,MOGO,7,7,0,7,1,1,1,1,NASDAQ
4714,13-02-2021 08:00,24 hrs.,wallstreetbets,MRKR,6,6,0,6,1,1,0,1,NASDAQ
4714,13-02-2021 08:00,24 hrs.,wallstreetbets,MRNA,6,0,6,-6,1,1,0,1,NASDAQ
4714,13-02-2021 08:00,24 hrs.,wallstreetbets,MRVL,7,0,7,-7,1,1,1,1,NASDAQ
4714,13-02-2021 08:00,24 hrs.,wallstreetbets,MSFT,8089,0,8089,-8089,1,3781,523,1,NASDAQ
4714,13-02-2021 08:00,24 hrs.,wallstreetbets,MSTR,34,7,27,-20,5,5,4,3,NASDAQ
4714,13-02-2021 08:00,24 hrs.,wallstreetbets,MTCH,7,0,7,-7,1,1,1,1,NASDAQ
4714,13-02-2021 08:00,24 hrs.,wallstreetbets,MVIS,499,67,432,-365,7,167,137,6,NASDAQ
4714,13-02-2021 08:00,24 hrs.,wallstreetbets,NAKD,147,50,97,-47,21,21,21,14,NASDAQ
4714,13-02-2021 08:00,24 hrs.,wallstreetbets,NBAC,14,14,0,14,2,2,2,1,NASDAQ
4714,13-02-2021 08:00,24 hrs.,wallstreetbets,NCLH,28,21,7,14,4,4,4,3,NASDAQ
4714,13-02-2021 08:00,24 hrs.,wallstreetbets,NEOS,7,0,7,-7,1,1,1,1,NASDAQ
4714,13-02-2021 08:00,24 hrs.,wallstreetbets,NFLX,7,0,7,-7,1,1,1,1,NASDAQ
4714,13-02-2021 08:00,24 hrs.,wallstreetbets,NKLA,7,7,0,7,1,1,1,1,NASDAQ
4714,13-02-2021 08:00,24 hrs.,wallstreetbets,NLOK,7,0,7,-7,1,1,1,1,NASDAQ
4714,13-02-2021 08:00,24 hrs.,wallstreetbets,NMRK,6,0,6,-6,1,1,0,1,NASDAQ
4714,13-02-2021 08:00,24 hrs.,wallstreetbets,NNDM,21,0,21,-21,3,3,3,1,NASDAQ
4714,13-02-2021 08:00,24 hrs.,wallstreetbets,NOVN,29,29,0,29,4,4,5,3,NASDAQ
4714,13-02-2021 08:00,24 hrs.,wallstreetbets,NUAN,681,0,681,-681,1,294,89,1,NASDAQ
4714,13-02-2021 08:00,24 hrs.,wallstreetbets,NVAX,6,6,0,6,1,1,0,1,NASDAQ
4714,13-02-2021 08:00,24 hrs.,wallstreetbets,NVDA,647,0,647,-647,3,135,365,3,NASDAQ
4714,13-02-2021 08:00,24 hrs.,stocks,QCLN,98,0,98,-98,1,27,40,1,NASDAQ
4714,13-02-2021 08:00,24 hrs.,stocks,QDEL,6,6,0,6,1,1,0,1,NASDAQ
4714,13-02-2021 08:00,24 hrs.,stocks,QFIN,6,6,0,6,1,1,0,1,NASDAQ
4714,13-02-2021 08:00,24 hrs.,stocks,QQQJ,31,31,0,31,1,4,19,1,NASDAQ
4714,13-02-2021 08:00,24 hrs.,stocks,QQQM,31,31,0,31,1,4,19,1,NASDAQ
4714,13-02-2021 08:00,24 hrs.,stocks,REGN,6,6,0,6,1,1,0,1,NASDAQ
4714,13-02-2021 08:00,24 hrs.,stocks,RRGB,23,23,0,23,1,5,9,1,NASDAQ
4714,13-02-2021 08:00,24 hrs.,stocks,SABR,58,0,58,-58,1,13,28,1,NASDAQ
4714,13-02-2021 08:00,24 hrs.,stocks,SEDG,145,0,145,-145,1,46,49,1,NASDAQ
4714,13-02-2021 08:00,24 hrs.,stocks,SEEL,12,0,12,-12,2,2,0,1,NASDAQ
4714,13-02-2021 08:00,24 hrs.,stocks,SESN,7,0,7,-7,1,1,1,1,NASDAQ
4714,13-02-2021 08:00,24 hrs.,stocks,SHIP,11,0,11,-11,1,2,3,1,NASDAQ
4714,13-02-2021 08:00,24 hrs.,stocks,SNDL,37,0,37,-37,6,6,1,5,NASDAQ
4714,13-02-2021 08:00,24 hrs.,stocks,SNGX,37,13,24,-11,5,7,3,5,NASDAQ
4714,13-02-2021 08:00,24 hrs.,stocks,SRAC,6,0,6,-6,1,1,0,1,NASDAQ
4714,13-02-2021 08:00,24 hrs.,stocks,SRNE,145,0,145,-145,1,46,49,1,NASDAQ
4714,13-02-2021 08:00,24 hrs.,stocks,SVMK,12,0,12,-12,1,3,2,1,NASDAQ
4714,13-02-2021 08:00,24 hrs.,stocks,SWKS,53,0,53,-53,1,10,29,1,NASDAQ
4714,13-02-2021 08:00,24 hrs.,stocks,TIGR,6,6,0,6,1,1,0,1,NASDAQ
4714,13-02-2021 08:00,24 hrs.,stocks,TLRY,805,0,805,-805,1,221,359,1,NASDAQ
4714,13-02-2021 08:00,24 hrs.,stocks,TRCH,13,13,0,13,2,2,1,2,NASDAQ
4714,13-02-2021 08:00,24 hrs.,stocks,TRVG,12,6,6,0,2,2,0,2,NASDAQ
4714,13-02-2021 08:00,24 hrs.,stocks,TSLA,1004,775,229,546,10,350,264,8,NASDAQ
4714,13-02-2021 08:00,24 hrs.,stocks,TTGT,6,6,0,6,1,1,0,1,NASDAQ
4714,13-02-2021 08:00,24 hrs.,stocks,VRNT,14,0,14,-14,1,3,4,1,NASDAQ
4714,13-02-2021 08:00,24 hrs.,stocks,VRSN,12,0,12,-12,1,3,2,1,NASDAQ
4714,13-02-2021 08:00,24 hrs.,stocks,VUZI,6,6,0,6,1,1,0,1,NASDAQ
4714,13-02-2021 08:00,24 hrs.,stocks,VXRT,6,6,0,6,1,1,0,1,NASDAQ
4714,13-02-2021 08:00,24 hrs.,stocks,VXUS,33,33,0,33,2,9,7,2,NASDAQ
4714,13-02-2021 08:00,24 hrs.,stocks,WDAY,14,14,0,14,1,3,4,1,NASDAQ
4714,13-02-2021 08:00,24 hrs.,stocks,WISH,6,0,6,-6,1,1,0,1,NASDAQ
4714,13-02-2021 08:00,24 hrs.,stocks,XERS,6,0,6,-6,1,1,0,1,NASDAQ
4714,13-02-2021 08:00,24 hrs.,stocks,XONE,9,9,0,9,1,2,1,1,NASDAQ
4714,13-02-2021 08:00,24 hrs.,stocks,ZGNX,6,0,6,-6,1,1,0,1,NASDAQ
4714,13-02-2021 08:00,24 hrs.,stocks,DISCA,12,0,12,-12,2,2,0,2,NASDAQ
4714,13-02-2021 08:00,24 hrs.,stocks,LILAK,12,12,0,12,2,2,0,1,NASDAQ
4714,13-02-2021 08:00,24 hrs.,stocks,SRACU,6,0,6,-6,1,1,0,1,NASDAQ
4714,13-02-2021 08:00,24 hrs.,stocks,SRACW,6,0,6,-6,1,1,0,1,NASDAQ
4714,13-02-2021 08:00,24 hrs.,Daytrading,SGMD,17,17,0,17,1,3,7,1,OTC
4714,13-02-2021 08:00,24 hrs.,Daytrading,HVBTF,6,6,0,6,1,1,0,1,OTC
4714,13-02-2021 08:00,24 hrs.,Daytrading,DNN,508,0,508,-508,2,211,78,2,AMEX
4714,13-02-2021 08:00,24 hrs.,Daytrading,DSS,502,0,502,-502,1,210,78,1,AMEX
4714,13-02-2021 08:00,24 hrs.,Daytrading,GTE,7,7,0,7,1,1,1,1,AMEX
4714,13-02-2021 08:00,24 hrs.,wallstreetbets,PTCT,7,0,7,-7,1,1,1,1,NASDAQ
4714,13-02-2021 08:00,24 hrs.,wallstreetbets,PTON,5952,0,5952,-5952,5,2793,346,1,NASDAQ
4714,13-02-2021 08:00,24 hrs.,wallstreetbets,QCOM,7,0,7,-7,1,1,1,1,NASDAQ
4714,13-02-2021 08:00,24 hrs.,wallstreetbets,QFIN,7,7,0,7,1,1,1,1,NASDAQ
4714,13-02-2021 08:00,24 hrs.,wallstreetbets,QQQJ,20,0,20,-20,1,5,6,1,NASDAQ
4714,13-02-2021 08:00,24 hrs.,wallstreetbets,QUIK,13,0,13,-13,2,2,1,2,NASDAQ
4714,13-02-2021 08:00,24 hrs.,wallstreetbets,RAVE,14,14,0,14,2,2,2,2,NASDAQ
4714,13-02-2021 08:00,24 hrs.,wallstreetbets,RDHL,13,0,13,-13,2,2,1,2,NASDAQ
4714,13-02-2021 08:00,24 hrs.,wallstreetbets,REAL,205,205,0,205,4,36,117,4,NASDAQ
4714,13-02-2021 08:00,24 hrs.,wallstreetbets,REGI,7,7,0,7,1,1,1,1,NASDAQ
4714,13-02-2021 08:00,24 hrs.,wallstreetbets,REGN,35,14,21,-7,5,5,5,3,NASDAQ
4714,13-02-2021 08:00,24 hrs.,wallstreetbets,RIDE,89,19,70,-51,13,13,11,11,NASDAQ
4714,13-02-2021 08:00,24 hrs.,wallstreetbets,RIOT,6037,6,6031,-6025,17,2805,359,12,NASDAQ
4714,13-02-2021 08:00,24 hrs.,wallstreetbets,RKDA,7,0,7,-7,1,1,1,1,NASDAQ
4714,13-02-2021 08:00,24 hrs.,wallstreetbets,ROKU,13,7,6,1,2,2,1,2,NASDAQ
4714,13-02-2021 08:00,24 hrs.,wallstreetbets,ROOT,14,0,14,-14,2,2,2,1,NASDAQ
4714,13-02-2021 08:00,24 hrs.,wallstreetbets,RWLK,21,0,21,-21,3,3,3,3,NASDAQ
4714,13-02-2021 08:00,24 hrs.,stocks,CVLB,6,0,6,-6,1,1,0,1,NASDAQ
4714,13-02-2021 08:00,24 hrs.,stocks,DDOG,12,0,12,-12,1,3,2,1,NASDAQ
4714,13-02-2021 08:00,24 hrs.,stocks,DFFN,15,0,15,-15,2,3,1,2,NASDAQ
4714,13-02-2021 08:00,24 hrs.,stocks,DOCU,6,0,6,-6,1,1,0,1,NASDAQ
4714,13-02-2021 08:00,24 hrs.,wallstreetbets,SEEL,7,0,7,-7,1,1,1,1,NASDAQ
4714,13-02-2021 08:00,24 hrs.,wallstreetbets,SHIP,151,27,124,-97,22,22,19,17,NASDAQ
4714,13-02-2021 08:00,24 hrs.,wallstreetbets,SIRI,7,0,7,-7,1,1,1,1,NASDAQ
4714,13-02-2021 08:00,24 hrs.,wallstreetbets,SLRX,7,0,7,-7,1,1,1,1,NASDAQ
4714,13-02-2021 08:00,24 hrs.,wallstreetbets,SNCA,6,0,6,-6,1,1,0,1,NASDAQ
4714,13-02-2021 08:00,24 hrs.,wallstreetbets,SNDL,2514,465,2049,-1584,213,540,582,175,NASDAQ
4714,13-02-2021 08:00,24 hrs.,wallstreetbets,SNGX,34,26,8,18,5,5,4,4,NASDAQ
4714,13-02-2021 08:00,24 hrs.,wallstreetbets,SQQQ,7,0,7,-7,1,1,1,1,NASDAQ
4714,13-02-2021 08:00,24 hrs.,wallstreetbets,SRAC,13,7,6,1,2,2,1,2,NASDAQ
4714,13-02-2021 08:00,24 hrs.,wallstreetbets,SRGA,7,0,7,-7,1,1,1,1,NASDAQ
4714,13-02-2021 08:00,24 hrs.,wallstreetbets,SRNE,14,7,7,0,2,2,2,2,NASDAQ
4714,13-02-2021 08:00,24 hrs.,wallstreetbets,SSRM,6,6,0,6,1,1,0,1,NASDAQ
4714,13-02-2021 08:00,24 hrs.,wallstreetbets,STAF,20,13,7,6,3,3,2,3,NASDAQ
4714,13-02-2021 08:00,24 hrs.,wallstreetbets,STAY,12,6,6,0,2,2,0,2,NASDAQ
4714,13-02-2021 08:00,24 hrs.,wallstreetbets,STEP,16,0,16,-16,1,0,12,1,NASDAQ
4714,13-02-2021 08:00,24 hrs.,wallstreetbets,STLD,7,0,7,-7,1,1,1,1,NASDAQ
4714,13-02-2021 08:00,24 hrs.,wallstreetbets,SVMK,437,0,437,-437,1,179,75,1,NASDAQ
4714,13-02-2021 08:00,24 hrs.,wallstreetbets,SWBI,28,21,7,14,4,4,4,3,NASDAQ
4714,13-02-2021 08:00,24 hrs.,wallstreetbets,SWKS,510,0,510,-510,1,134,238,1,NASDAQ
4714,13-02-2021 08:00,24 hrs.,wallstreetbets,TECH,7,7,0,7,1,1,1,1,NASDAQ
4714,13-02-2021 08:00,24 hrs.,wallstreetbets,TELL,13,0,13,-13,2,2,1,2,NASDAQ
4714,13-02-2021 08:00,24 hrs.,wallstreetbets,THCB,6,6,0,6,1,1,0,1,NASDAQ
4714,13-02-2021 08:00,24 hrs.,wallstreetbets,THMO,13,0,13,-13,2,2,1,1,NASDAQ
4714,13-02-2021 08:00,24 hrs.,wallstreetbets,TLGT,7,7,0,7,1,1,1,1,NASDAQ
4714,13-02-2021 08:00,24 hrs.,wallstreetbets,TLRY,1124,774,350,424,60,291,302,49,NASDAQ
4714,13-02-2021 08:00,24 hrs.,wallstreetbets,TLSA,7,7,0,7,1,1,1,1,NASDAQ
4714,13-02-2021 08:00,24 hrs.,wallstreetbets,TNXP,63,7,56,-49,9,9,9,4,NASDAQ
4714,13-02-2021 08:00,24 hrs.,wallstreetbets,TOPS,100,20,80,-60,14,15,14,11,NASDAQ
4714,13-02-2021 08:00,24 hrs.,wallstreetbets,TOWN,167,0,167,-167,1,53,57,1,NASDAQ
4714,13-02-2021 08:00,24 hrs.,wallstreetbets,TQQQ,35,35,0,35,5,5,5,1,NASDAQ
4714,13-02-2021 08:00,24 hrs.,wallstreetbets,TRCH,14,0,14,-14,2,2,2,2,NASDAQ
4714,13-02-2021 08:00,24 hrs.,wallstreetbets,TRIT,52,13,39,-26,8,8,4,6,NASDAQ
4714,13-02-2021 08:00,24 hrs.,wallstreetbets,TRVG,2834,28,2806,-2778,30,1030,654,21,NASDAQ
4714,13-02-2021 08:00,24 hrs.,wallstreetbets,TSLA,8904,258,8646,-8388,30,3911,962,20,NASDAQ
4714,13-02-2021 08:00,24 hrs.,wallstreetbets,TTCF,7,0,7,-7,1,1,1,1,NASDAQ
4714,13-02-2021 08:00,24 hrs.,wallstreetbets,TTOO,7,7,0,7,1,1,1,1,NASDAQ
4714,13-02-2021 08:00,24 hrs.,wallstreetbets,TXMD,43,0,43,-43,6,6,7,5,NASDAQ
4714,13-02-2021 08:00,24 hrs.,wallstreetbets,UNFI,363,0,363,-363,1,166,27,1,NASDAQ
4714,13-02-2021 08:00,24 hrs.,wallstreetbets,VEON,6,0,6,-6,1,1,0,1,NASDAQ
4714,13-02-2021 08:00,24 hrs.,wallstreetbets,VERU,7,0,7,-7,1,1,1,1,NASDAQ
4714,13-02-2021 08:00,24 hrs.,wallstreetbets,VISL,7,0,7,-7,1,1,1,1,NASDAQ
4714,13-02-2021 08:00,24 hrs.,wallstreetbets,VIVO,7,7,0,7,1,1,1,1,NASDAQ
4714,13-02-2021 08:00,24 hrs.,wallstreetbets,VKTX,7,7,0,7,1,1,1,1,NASDAQ
4714,13-02-2021 08:00,24 hrs.,wallstreetbets,VLDR,7,0,7,-7,1,1,1,1,NASDAQ
4714,13-02-2021 08:00,24 hrs.,wallstreetbets,VOXX,6,6,0,6,1,1,0,1,NASDAQ
4714,13-02-2021 08:00,24 hrs.,wallstreetbets,VRSN,437,0,437,-437,1,179,75,1,NASDAQ
4714,13-02-2021 08:00,24 hrs.,wallstreetbets,VSAT,14,0,14,-14,2,2,2,1,NASDAQ
4714,13-02-2021 08:00,24 hrs.,wallstreetbets,VTGN,7,7,0,7,1,1,1,1,NASDAQ
4714,13-02-2021 08:00,24 hrs.,wallstreetbets,VUZI,21,21,0,21,3,3,3,1,NASDAQ
4714,13-02-2021 08:00,24 hrs.,wallstreetbets,VXRT,21,14,7,7,3,3,3,3,NASDAQ
4714,13-02-2021 08:00,24 hrs.,wallstreetbets,WATT,7,7,0,7,1,1,1,1,NASDAQ
4714,13-02-2021 08:00,24 hrs.,wallstreetbets,WKHS,7792,20,7772,-7752,5,3557,658,4,NASDAQ
4714,13-02-2021 08:00,24 hrs.,wallstreetbets,WRAP,7,0,7,-7,1,1,1,1,NASDAQ
4714,13-02-2021 08:00,24 hrs.,wallstreetbets,XENE,14,0,14,-14,2,2,2,1,NASDAQ
4714,13-02-2021 08:00,24 hrs.,wallstreetbets,XERS,15,0,15,-15,2,2,3,2,NASDAQ
4714,13-02-2021 08:00,24 hrs.,wallstreetbets,XNET,14,0,14,-14,2,2,2,1,NASDAQ
4714,13-02-2021 08:00,24 hrs.,wallstreetbets,XSPA,58,24,34,-10,9,9,4,8,NASDAQ
4714,13-02-2021 08:00,24 hrs.,wallstreetbets,ZNGA,15,15,0,15,2,2,3,2,NASDAQ
4714,13-02-2021 08:00,24 hrs.,wallstreetbets,ZYNE,7,0,7,-7,1,1,1,1,NASDAQ
4714,13-02-2021 08:00,24 hrs.,wallstreetbets,CMCSA,7,0,7,-7,1,1,1,1,NASDAQ
4714,13-02-2021 08:00,24 hrs.,stocks,PAAS,6,0,6,-6,1,1,0,1,NASDAQ
4714,13-02-2021 08:00,24 hrs.,stocks,PHUN,6,0,6,-6,1,1,0,1,NASDAQ
4714,13-02-2021 08:00,24 hrs.,stocks,PLUG,134,0,134,-134,2,22,82,2,NASDAQ
4714,13-02-2021 08:00,24 hrs.,stocks,PSTV,6,0,6,-6,1,1,0,1,NASDAQ
4714,13-02-2021 08:00,24 hrs.,trakstocks,DNN,85,0,85,-85,1,33,15,1,AMEX
4714,13-02-2021 08:00,24 hrs.,trakstocks,DPW,12,12,0,12,2,2,0,2,AMEX
4714,13-02-2021 08:00,24 hrs.,trakstocks,TRXC,157,0,157,-157,1,54,45,1,AMEX
4714,13-02-2021 08:00,24 hrs.,trakstocks,AMC,25,0,25,-25,1,2,17,1,NYSE
4714,13-02-2021 08:00,24 hrs.,trakstocks,BFT,6,6,0,6,1,1,0,1,NYSE
4714,13-02-2021 08:00,24 hrs.,trakstocks,GME,25,0,25,-25,1,2,17,1,NYSE
4714,13-02-2021 08:00,24 hrs.,trakstocks,SOL,8,0,8,-8,1,2,0,1,NYSE
4714,13-02-2021 08:00,24 hrs.,trakstocks,SOS,23,0,23,-23,1,9,1,1,NYSE
4714,13-02-2021 08:00,24 hrs.,trakstocks,SWN,9,9,0,9,1,2,1,1,NYSE
4714,13-02-2021 08:00,24 hrs.,trakstocks,ARGO,6,0,6,-6,1,1,0,1,NYSE
4714,13-02-2021 08:00,24 hrs.,trakstocks,PLTR,6,6,0,6,1,1,0,1,NYSE
4714,13-02-2021 08:00,24 hrs.,trakstocks,STPK,59,59,0,59,4,16,11,3,NYSE
4714,13-02-2021 08:00,24 hrs.,trakstocks,AQB,14,14,0,14,1,4,2,1,NASDAQ
4714,13-02-2021 08:00,24 hrs.,trakstocks,OEG,29,0,29,-29,1,10,5,1,NASDAQ
4714,13-02-2021 08:00,24 hrs.,trakstocks,ABEO,8,0,8,-8,1,2,0,1,NASDAQ
4714,13-02-2021 08:00,24 hrs.,trakstocks,APPS,6,0,6,-6,1,1,0,1,NASDAQ
4714,13-02-2021 08:00,24 hrs.,trakstocks,AYRO,131,61,70,-9,2,45,33,2,NASDAQ
4714,13-02-2021 08:00,24 hrs.,trakstocks,BHTG,412,0,412,-412,1,156,96,1,NASDAQ
4714,13-02-2021 08:00,24 hrs.,trakstocks,CFII,89,0,89,-89,1,31,23,1,NASDAQ
4714,13-02-2021 08:00,24 hrs.,trakstocks,CLVS,11,11,0,11,1,2,3,1,NASDAQ
4714,13-02-2021 08:00,24 hrs.,trakstocks,CPSH,44,0,44,-44,2,12,12,2,NASDAQ
4714,13-02-2021 08:00,24 hrs.,trakstocks,EXPC,16,16,0,16,1,5,2,1,NASDAQ
4714,13-02-2021 08:00,24 hrs.,trakstocks,GTHX,6,0,6,-6,1,1,0,1,NASDAQ
4714,13-02-2021 08:00,24 hrs.,trakstocks,IMMR,44,44,0,44,1,16,8,1,NASDAQ
4714,13-02-2021 08:00,24 hrs.,trakstocks,LIFE,14,14,0,14,1,1,8,1,NASDAQ
4714,13-02-2021 08:00,24 hrs.,trakstocks,MARA,31,31,0,31,1,11,5,1,NASDAQ
4714,13-02-2021 08:00,24 hrs.,trakstocks,OPRX,12,0,12,-12,1,3,2,1,NASDAQ
4714,13-02-2021 08:00,24 hrs.,trakstocks,RIOT,41,41,0,41,2,12,9,2,NASDAQ
4714,13-02-2021 08:00,24 hrs.,trakstocks,SNDL,6,6,0,6,1,1,0,1,NASDAQ
4714,13-02-2021 08:00,24 hrs.,trakstocks,TLRY,6,6,0,6,1,1,0,1,NASDAQ
4714,13-02-2021 08:00,24 hrs.,trakstocks,TRIT,23,23,0,23,1,7,5,1,NASDAQ
4714,13-02-2021 08:00,24 hrs.,trakstocks,TTCF,24,24,0,24,2,3,10,2,NASDAQ
4714,13-02-2021 08:00,24 hrs.,StockMarket,ABML,6,0,6,-6,1,1,0,1,OTC
4714,13-02-2021 08:00,24 hrs.,StockMarket,BOTY,10,0,10,-10,1,3,0,1,OTC
4714,13-02-2021 08:00,24 hrs.,StockMarket,GTEH,6,6,0,6,1,1,0,1,OTC
4714,13-02-2021 08:00,24 hrs.,Daytrading,MXC,6,0,6,-6,1,1,0,1,AMEX
4714,13-02-2021 08:00,24 hrs.,Daytrading,ACB,508,0,508,-508,2,211,78,2,NYSE
4714,13-02-2021 08:00,24 hrs.,Daytrading,ADX,9,0,9,-9,1,2,1,1,NYSE
4714,13-02-2021 08:00,24 hrs.,Daytrading,AMC,6,6,0,6,1,1,0,1,NYSE
4714,13-02-2021 08:00,24 hrs.,Daytrading,BDX,7,0,7,-7,1,1,1,1,NYSE
4714,13-02-2021 08:00,24 hrs.,Daytrading,FSR,502,0,502,-502,1,210,78,1,NYSE
4714,13-02-2021 08:00,24 hrs.,Daytrading,GME,221,221,0,221,2,84,45,2,NYSE
4714,13-02-2021 08:00,24 hrs.,Daytrading,PDT,31,9,22,-13,2,5,13,2,NYSE
4714,13-02-2021 08:00,24 hrs.,Daytrading,RTP,502,0,502,-502,1,210,78,1,NYSE
4714,13-02-2021 08:00,24 hrs.,Daytrading,WLL,6,0,6,-6,1,1,0,1,NYSE
4714,13-02-2021 08:00,24 hrs.,Daytrading,CCIV,502,0,502,-502,1,210,78,1,NYSE
4714,13-02-2021 08:00,24 hrs.,Daytrading,CHWY,6,0,6,-6,1,1,0,1,NYSE
4714,13-02-2021 08:00,24 hrs.,Daytrading,SPCE,502,0,502,-502,1,210,78,1,NYSE
4714,13-02-2021 08:00,24 hrs.,Daytrading,API,306,0,306,-306,1,131,40,1,NASDAQ
4714,13-02-2021 08:00,24 hrs.,Daytrading,INO,502,0,502,-502,1,210,78,1,NASDAQ
4714,13-02-2021 08:00,24 hrs.,Daytrading,ACST,6,0,6,-6,1,1,0,1,NASDAQ
4714,13-02-2021 08:00,24 hrs.,Daytrading,APDN,502,0,502,-502,1,210,78,1,NASDAQ
4714,13-02-2021 08:00,24 hrs.,Daytrading,APHA,502,0,502,-502,1,210,78,1,NASDAQ
4714,13-02-2021 08:00,24 hrs.,Daytrading,ARTL,619,6,613,-607,7,248,95,7,NASDAQ
4714,13-02-2021 08:00,24 hrs.,Daytrading,BNGO,112,0,112,-112,1,44,20,1,NASDAQ
4714,13-02-2021 08:00,24 hrs.,Daytrading,CLEU,565,0,565,-565,2,235,87,2,NASDAQ
4714,13-02-2021 08:00,24 hrs.,Daytrading,CLGN,502,0,502,-502,1,210,78,1,NASDAQ
4714,13-02-2021 08:00,24 hrs.,Daytrading,CLSN,502,0,502,-502,1,210,78,1,NASDAQ
4714,13-02-2021 08:00,24 hrs.,Daytrading,CMLF,502,0,502,-502,1,210,78,1,NASDAQ
4714,13-02-2021 08:00,24 hrs.,wallstreetbets,GOOGL,6,0,6,-6,1,1,0,1,NASDAQ
4714,13-02-2021 08:00,24 hrs.,wallstreetbets,SAVA,7,0,7,-7,1,1,1,1,NASDAQ
4714,13-02-2021 08:00,24 hrs.,wallstreetbets,SAVE,7,0,7,-7,1,1,1,1,NASDAQ
4714,13-02-2021 08:00,24 hrs.,wallstreetbets,SBUX,7,0,7,-7,1,1,1,1,NASDAQ
4714,13-02-2021 08:00,24 hrs.,wallstreetbets,SEAC,7,0,7,-7,1,1,1,1,NASDAQ
4714,13-02-2021 08:00,24 hrs.,RobinHoodPennyStocks,NAK,87,0,87,-87,6,16,31,6,AMEX
4714,13-02-2021 08:00,24 hrs.,RobinHoodPennyStocks,REI,22,22,0,22,2,5,4,2,AMEX
4714,13-02-2021 08:00,24 hrs.,RobinHoodPennyStocks,SYN,6,0,6,-6,1,1,0,1,AMEX
4714,13-02-2021 08:00,24 hrs.,RobinHoodPennyStocks,TRX,38,0,38,-38,1,9,16,1,AMEX
4714,13-02-2021 08:00,24 hrs.,RobinHoodPennyStocks,XPL,6,6,0,6,1,1,0,1,AMEX
4714,13-02-2021 08:00,24 hrs.,RobinHoodPennyStocks,ZOM,1290,79,1211,-1132,11,481,284,10,AMEX
4714,13-02-2021 08:00,24 hrs.,RobinHoodPennyStocks,IBIO,37,0,37,-37,1,14,5,1,AMEX
4714,13-02-2021 08:00,24 hrs.,RobinHoodPennyStocks,NSPR,30,0,30,-30,1,8,10,1,AMEX
4714,13-02-2021 08:00,24 hrs.,RobinHoodPennyStocks,OGEN,18,0,18,-18,3,3,0,3,AMEX
4714,13-02-2021 08:00,24 hrs.,RobinHoodPennyStocks,SENS,61,0,61,-61,3,22,5,3,AMEX
4714,13-02-2021 08:00,24 hrs.,RobinHoodPennyStocks,TRXC,6,0,6,-6,1,1,0,1,AMEX
4714,13-02-2021 08:00,24 hrs.,RobinHoodPennyStocks,AIV,6,0,6,-6,1,1,0,1,NYSE
4714,13-02-2021 08:00,24 hrs.,RobinHoodPennyStocks,DNK,6,6,0,6,1,1,0,1,NYSE
4714,13-02-2021 08:00,24 hrs.,RobinHoodPennyStocks,ETN,6,6,0,6,1,1,0,1,NYSE
4714,13-02-2021 08:00,24 hrs.,RobinHoodPennyStocks,FSR,6,0,6,-6,1,1,0,1,NYSE
4714,13-02-2021 08:00,24 hrs.,RobinHoodPennyStocks,GME,55,11,44,-33,2,12,23,2,NYSE
4714,13-02-2021 08:00,24 hrs.,RobinHoodPennyStocks,IRS,321,0,321,-321,1,145,27,1,NYSE
4714,13-02-2021 08:00,24 hrs.,RobinHoodPennyStocks,MRO,6,6,0,6,1,1,0,1,NYSE
4714,13-02-2021 08:00,24 hrs.,RobinHoodPennyStocks,MTL,19,6,13,-7,2,2,7,2,NYSE
4714,13-02-2021 08:00,24 hrs.,RobinHoodPennyStocks,NAT,6,0,6,-6,1,1,0,1,NYSE
4714,13-02-2021 08:00,24 hrs.,RobinHoodPennyStocks,NBB,6,6,0,6,1,1,0,1,NYSE
4714,13-02-2021 08:00,24 hrs.,RobinHoodPennyStocks,PHI,6,0,6,-6,1,1,0,1,NYSE
4714,13-02-2021 08:00,24 hrs.,RobinHoodPennyStocks,SOS,96,43,53,-10,3,20,44,3,NYSE
4714,13-02-2021 08:00,24 hrs.,RobinHoodPennyStocks,CCIV,40,0,40,-40,1,11,14,1,NYSE
4714,13-02-2021 08:00,24 hrs.,RobinHoodPennyStocks,PLTR,6,6,0,6,1,1,0,1,NYSE
4714,13-02-2021 08:00,24 hrs.,RobinHoodPennyStocks,BBI,6,0,6,-6,1,1,0,1,NASDAQ
4714,13-02-2021 08:00,24 hrs.,RobinHoodPennyStocks,JFU,6,6,0,6,1,1,0,1,NASDAQ
4714,13-02-2021 08:00,24 hrs.,RobinHoodPennyStocks,OGI,6,0,6,-6,1,1,0,1,NASDAQ
4714,13-02-2021 08:00,24 hrs.,RobinHoodPennyStocks,SND,34,16,18,-2,4,7,4,2,NASDAQ
4714,13-02-2021 08:00,24 hrs.,RobinHoodPennyStocks,ABEO,192,0,192,-192,3,64,52,3,NASDAQ
4714,13-02-2021 08:00,24 hrs.,RobinHoodPennyStocks,ACRX,22,0,22,-22,1,7,4,1,NASDAQ
4714,13-02-2021 08:00,24 hrs.,RobinHoodPennyStocks,ACST,6,0,6,-6,1,1,0,1,NASDAQ
4714,13-02-2021 08:00,24 hrs.,RobinHoodPennyStocks,ADXS,18,0,18,-18,3,3,0,2,NASDAQ
4714,13-02-2021 08:00,24 hrs.,RobinHoodPennyStocks,AEZS,126,126,0,126,1,50,22,1,NASDAQ
4714,13-02-2021 08:00,24 hrs.,RobinHoodPennyStocks,AGTC,1371,131,1240,-1109,18,490,319,16,NASDAQ
4714,13-02-2021 08:00,24 hrs.,Daytrading,CRSR,502,0,502,-502,1,210,78,1,NASDAQ
4714,13-02-2021 08:00,24 hrs.,Daytrading,EBON,6,0,6,-6,1,1,0,1,NASDAQ
4714,13-02-2021 08:00,24 hrs.,Daytrading,FOLD,508,0,508,-508,2,211,78,2,NASDAQ
4714,13-02-2021 08:00,24 hrs.,Daytrading,FTFT,502,0,502,-502,1,210,78,1,NASDAQ
4714,13-02-2021 08:00,24 hrs.,Daytrading,LIVE,126,0,126,-126,2,49,20,1,NASDAQ
4714,13-02-2021 08:00,24 hrs.,Daytrading,MARA,502,0,502,-502,1,210,78,1,NASDAQ
4714,13-02-2021 08:00,24 hrs.,Daytrading,NOVN,502,0,502,-502,1,210,78,1,NASDAQ
4714,13-02-2021 08:00,24 hrs.,Daytrading,OCGN,28,0,28,-28,1,4,16,1,NASDAQ
4714,13-02-2021 08:00,24 hrs.,Daytrading,PYPL,502,0,502,-502,1,210,78,1,NASDAQ
4714,13-02-2021 08:00,24 hrs.,Daytrading,RIDE,502,0,502,-502,1,210,78,1,NASDAQ
4714,13-02-2021 08:00,24 hrs.,Daytrading,RIOT,508,6,502,-496,2,211,78,2,NASDAQ
4714,13-02-2021 08:00,24 hrs.,Daytrading,STAY,39,0,39,-39,1,17,1,1,NASDAQ
4714,13-02-2021 08:00,24 hrs.,Daytrading,TLRY,509,7,502,-495,2,211,79,2,NASDAQ
4714,13-02-2021 08:00,24 hrs.,Daytrading,TSLA,9,9,0,9,1,1,3,1,NASDAQ
4714,13-02-2021 08:00,24 hrs.,Daytrading,WAFU,63,0,63,-63,1,25,9,1,NASDAQ
4714,13-02-2021 08:00,24 hrs.,Daytrading,XERS,502,0,502,-502,1,210,78,1,NASDAQ
4714,13-02-2021 08:00,24 hrs.,trakstocks,ALPP,6,0,6,-6,1,1,0,1,OTC
4714,13-02-2021 08:00,24 hrs.,trakstocks,BRTX,9,0,9,-9,1,2,1,1,OTC
4714,13-02-2021 08:00,24 hrs.,trakstocks,HCMC,6,6,0,6,1,0,2,1,OTC
4714,13-02-2021 08:00,24 hrs.,trakstocks,INND,6,6,0,6,1,0,2,1,OTC
4714,13-02-2021 08:00,24 hrs.,trakstocks,MMEX,20,0,20,-20,2,3,6,2,OTC
4714,13-02-2021 08:00,24 hrs.,trakstocks,MOST,6,0,6,-6,1,1,0,1,OTC
4714,13-02-2021 08:00,24 hrs.,trakstocks,ARBKF,6,0,6,-6,1,1,0,1,OTC
4714,13-02-2021 08:00,24 hrs.,trakstocks,BBXIA,6,0,6,-6,1,1,0,1,OTC
4714,13-02-2021 08:00,24 hrs.,trakstocks,MGROF,11,11,0,11,1,3,1,1,OTC
4714,13-02-2021 08:00,24 hrs.,trakstocks,NMGRF,48,0,48,-48,1,18,8,1,OTC
4714,13-02-2021 08:00,24 hrs.,trakstocks,NXTTF,16,0,16,-16,1,6,0,1,OTC
4714,13-02-2021 08:00,24 hrs.,trakstocks,PYRNF,16,10,6,4,2,3,2,2,OTC
4714,13-02-2021 08:00,24 hrs.,trakstocks,VRYYF,7,7,0,7,1,1,1,1,OTC
4714,13-02-2021 08:00,24 hrs.,StockMarket,PLTR,46,46,0,46,1,20,2,1,NYSE
4714,13-02-2021 08:00,24 hrs.,StockMarket,UBER,46,46,0,46,1,20,2,1,NYSE
4714,13-02-2021 08:00,24 hrs.,StockMarket,VGAC,8,0,8,-8,1,0,4,1,NYSE
4714,13-02-2021 08:00,24 hrs.,StockMarket,YETI,4,0,4,-4,1,0,0,1,NYSE
4714,13-02-2021 08:00,24 hrs.,StockMarket,AMD,6,0,6,-6,1,1,0,1,NASDAQ
4714,13-02-2021 08:00,24 hrs.,StockMarket,AQB,8,8,0,8,1,2,0,1,NASDAQ
4714,13-02-2021 08:00,24 hrs.,StockMarket,AZN,13,0,13,-13,1,3,3,1,NASDAQ
4714,13-02-2021 08:00,24 hrs.,StockMarket,GTVH,6,0,6,-6,1,1,0,1,OTC
4714,13-02-2021 08:00,24 hrs.,StockMarket,HCMC,57,0,57,-57,2,20,9,2,OTC
4714,13-02-2021 08:00,24 hrs.,StockMarket,HEMP,6,0,6,-6,1,1,0,1,OTC
4714,13-02-2021 08:00,24 hrs.,StockMarket,KGET,6,6,0,6,1,1,0,1,OTC
4714,13-02-2021 08:00,24 hrs.,StockMarket,KWBT,6,0,6,-6,1,1,0,1,OTC
4714,13-02-2021 08:00,24 hrs.,StockMarket,LINK,13,0,13,-13,1,3,3,1,OTC
4714,13-02-2021 08:00,24 hrs.,StockMarket,MAXD,46,12,34,-22,3,12,10,3,OTC
4714,13-02-2021 08:00,24 hrs.,StockMarket,MOST,13,0,13,-13,1,3,3,1,OTC
4714,13-02-2021 08:00,24 hrs.,StockMarket,PCTL,6,0,6,-6,1,1,0,1,OTC
4714,13-02-2021 08:00,24 hrs.,StockMarket,PHIL,8,0,8,-8,1,2,0,1,OTC
4714,13-02-2021 08:00,24 hrs.,StockMarket,RSSV,24,0,24,-24,1,9,2,1,OTC
4714,13-02-2021 08:00,24 hrs.,StockMarket,SGMD,158,0,158,-158,6,38,58,2,OTC
4714,13-02-2021 08:00,24 hrs.,StockMarket,AYRWF,20,20,0,20,1,6,4,1,OTC
4714,13-02-2021 08:00,24 hrs.,RobinHoodPennyStocks,APHA,12,0,12,-12,2,2,0,1,NASDAQ
4714,13-02-2021 08:00,24 hrs.,RobinHoodPennyStocks,ARPO,6,0,6,-6,1,1,0,1,NASDAQ
4714,13-02-2021 08:00,24 hrs.,RobinHoodPennyStocks,ARTL,18,0,18,-18,3,3,0,3,NASDAQ
4714,13-02-2021 08:00,24 hrs.,RobinHoodPennyStocks,ASRT,86,74,12,62,4,32,6,3,NASDAQ
4714,13-02-2021 08:00,24 hrs.,RobinHoodPennyStocks,ATOS,518,0,518,-518,12,189,92,12,NASDAQ
4714,13-02-2021 08:00,24 hrs.,RobinHoodPennyStocks,BHTG,63,0,63,-63,2,19,17,2,NASDAQ
4714,13-02-2021 08:00,24 hrs.,RobinHoodPennyStocks,BIOL,6,0,6,-6,1,1,0,1,NASDAQ
4714,13-02-2021 08:00,24 hrs.,RobinHoodPennyStocks,BNGO,42,0,42,-42,3,11,8,3,NASDAQ
4714,13-02-2021 08:00,24 hrs.,RobinHoodPennyStocks,BRQS,31,0,31,-31,2,5,13,2,NASDAQ
4714,13-02-2021 08:00,24 hrs.,RobinHoodPennyStocks,CDTX,6,6,0,6,1,1,0,1,NASDAQ
4714,13-02-2021 08:00,24 hrs.,RobinHoodPennyStocks,CIDM,97,97,0,97,2,20,49,2,NASDAQ
4714,13-02-2021 08:00,24 hrs.,RobinHoodPennyStocks,CKPT,63,29,34,-5,2,20,15,2,NASDAQ
4714,13-02-2021 08:00,24 hrs.,RobinHoodPennyStocks,CLBS,24,18,6,12,2,7,2,2,NASDAQ
4714,13-02-2021 08:00,24 hrs.,RobinHoodPennyStocks,CRBP,23,23,0,23,1,7,5,1,NASDAQ
4714,13-02-2021 08:00,24 hrs.,RobinHoodPennyStocks,CTRM,501,84,417,-333,11,128,201,11,NASDAQ
4714,13-02-2021 08:00,24 hrs.,wallstreetbets,SRACU,6,0,6,-6,1,1,0,1,NASDAQ
4714,13-02-2021 08:00,24 hrs.,wallstreetbets,SRACW,6,0,6,-6,1,1,0,1,NASDAQ
4714,13-02-2021 08:00,24 hrs.,RobinHoodPennyStocks,BGMD,4,4,0,4,1,0,0,1,OTC
4714,13-02-2021 08:00,24 hrs.,RobinHoodPennyStocks,BLXX,6,0,6,-6,1,1,0,1,OTC
4714,13-02-2021 08:00,24 hrs.,RobinHoodPennyStocks,CBDD,6,0,6,-6,1,1,0,1,OTC
4714,13-02-2021 08:00,24 hrs.,RobinHoodPennyStocks,CRWG,6,6,0,6,1,1,0,1,OTC
4714,13-02-2021 08:00,24 hrs.,RobinHoodPennyStocks,GLEC,6,0,6,-6,1,1,0,1,OTC
4714,13-02-2021 08:00,24 hrs.,RobinHoodPennyStocks,GPFT,34,6,28,-22,5,5,4,3,OTC
4714,13-02-2021 08:00,24 hrs.,RobinHoodPennyStocks,GSPH,6,0,6,-6,1,1,0,1,OTC
4714,13-02-2021 08:00,24 hrs.,RobinHoodPennyStocks,GTLL,6,6,0,6,1,1,0,1,OTC
4714,13-02-2021 08:00,24 hrs.,RobinHoodPennyStocks,HCMC,12,6,6,0,2,2,0,2,OTC
4714,13-02-2021 08:00,24 hrs.,RobinHoodPennyStocks,INKW,6,0,6,-6,1,1,0,1,OTC
4714,13-02-2021 08:00,24 hrs.,RobinHoodPennyStocks,LTUM,6,0,6,-6,1,1,0,1,OTC
4714,13-02-2021 08:00,24 hrs.,RobinHoodPennyStocks,MJNA,6,0,6,-6,1,1,0,1,OTC
4714,13-02-2021 08:00,24 hrs.,RobinHoodPennyStocks,NUUU,6,6,0,6,1,1,0,1,OTC
4714,13-02-2021 08:00,24 hrs.,RobinHoodPennyStocks,PHIL,6,0,6,-6,1,1,0,1,OTC
4714,13-02-2021 08:00,24 hrs.,RobinHoodPennyStocks,ALLIF,6,6,0,6,1,1,0,1,OTC
4714,13-02-2021 08:00,24 hrs.,RobinHoodPennyStocks,BDRBF,12,0,12,-12,2,2,0,2,OTC
4714,13-02-2021 08:00,24 hrs.,RobinHoodPennyStocks,MMEDF,17,17,0,17,1,4,5,1,OTC
4714,13-02-2021 08:00,24 hrs.,RobinHoodPennyStocks,NXTTF,6,0,6,-6,1,1,0,1,OTC
4714,13-02-2021 08:00,24 hrs.,RobinHoodPennyStocks,PMEDF,6,0,6,-6,1,1,0,1,OTC
4714,13-02-2021 08:00,24 hrs.,RobinHoodPennyStocks,RYCEY,18,0,18,-18,3,3,0,3,OTC
4714,13-02-2021 08:00,24 hrs.,RobinHoodPennyStocks,SHCAY,17,0,17,-17,1,6,1,1,OTC
4714,13-02-2021 08:00,24 hrs.,RobinHoodPennyStocks,ZBISF,6,6,0,6,1,1,0,1,OTC
4714,13-02-2021 08:00,24 hrs.,RobinHoodPennyStocks,DNN,122,110,12,98,4,43,20,4,AMEX
4714,13-02-2021 08:00,24 hrs.,RobinHoodPennyStocks,DPW,19,19,0,19,1,3,9,1,AMEX
4714,13-02-2021 08:00,24 hrs.,RobinHoodPennyStocks,GSV,12,6,6,0,2,2,0,2,AMEX
4714,13-02-2021 08:00,24 hrs.,RobinHoodPennyStocks,GTE,642,56,586,-530,15,178,226,15,AMEX
4714,13-02-2021 08:00,24 hrs.,RobinHoodPennyStocks,ITP,6,0,6,-6,1,1,0,1,AMEX
4714,13-02-2021 08:00,24 hrs.,RobinHoodPennyStocks,TNXP,56,0,56,-56,2,15,18,2,NASDAQ
4714,13-02-2021 08:00,24 hrs.,RobinHoodPennyStocks,TRCH,93,6,87,-81,3,23,35,3,NASDAQ
4714,13-02-2021 08:00,24 hrs.,RobinHoodPennyStocks,TTOO,34,0,34,-34,1,12,6,1,NASDAQ
4714,13-02-2021 08:00,24 hrs.,RobinHoodPennyStocks,TXMD,36,18,18,0,6,6,0,6,NASDAQ
4714,13-02-2021 08:00,24 hrs.,RobinHoodPennyStocks,TYME,6,6,0,6,1,1,0,1,NASDAQ
4714,13-02-2021 08:00,24 hrs.,RobinHoodPennyStocks,XSPA,23,0,23,-23,1,9,1,1,NASDAQ
4714,13-02-2021 08:00,24 hrs.,RobinHoodPennyStocks,ZSAN,686,0,686,-686,3,292,90,3,NASDAQ
4714,13-02-2021 08:00,24 hrs.,StockMarket,BMWLF,20,20,0,20,1,6,4,1,OTC
4714,13-02-2021 08:00,24 hrs.,StockMarket,CRLBF,20,20,0,20,1,6,4,1,OTC
4714,13-02-2021 08:00,24 hrs.,StockMarket,CURLF,20,20,0,20,1,6,4,1,OTC
4714,13-02-2021 08:00,24 hrs.,StockMarket,DIGAF,6,0,6,-6,1,1,0,1,OTC
4714,13-02-2021 08:00,24 hrs.,StockMarket,GTBIF,20,20,0,20,1,6,4,1,OTC
4714,13-02-2021 08:00,24 hrs.,StockMarket,HTZGQ,6,0,6,-6,1,1,0,1,OTC
4714,13-02-2021 08:00,24 hrs.,StockMarket,LHSIF,20,20,0,20,1,6,4,1,OTC
4714,13-02-2021 08:00,24 hrs.,StockMarket,NMGRF,6,0,6,-6,1,1,0,1,OTC
4714,13-02-2021 08:00,24 hrs.,StockMarket,RAZFF,6,0,6,-6,1,1,0,1,OTC
4714,13-02-2021 08:00,24 hrs.,StockMarket,RHDGF,18,0,18,-18,2,3,4,1,OTC
4714,13-02-2021 08:00,24 hrs.,StockMarket,RWBYF,20,20,0,20,1,6,4,1,OTC
4714,13-02-2021 08:00,24 hrs.,StockMarket,RYCEY,12,6,6,0,2,2,0,2,OTC
4714,13-02-2021 08:00,24 hrs.,StockMarket,TCNNF,20,20,0,20,1,6,4,1,OTC
4714,13-02-2021 08:00,24 hrs.,StockMarket,TFECY,18,0,18,-18,3,3,0,1,OTC
4714,13-02-2021 08:00,24 hrs.,StockMarket,ZBISF,32,32,0,32,1,10,8,1,OTC
4714,13-02-2021 08:00,24 hrs.,StockMarket,DNN,20,14,6,8,2,5,2,2,AMEX
4714,13-02-2021 08:00,24 hrs.,StockMarket,DSS,6,6,0,6,1,1,0,1,AMEX
4714,13-02-2021 08:00,24 hrs.,StockMarket,TRX,6,6,0,6,1,1,0,1,AMEX
4714,13-02-2021 08:00,24 hrs.,StockMarket,GSAT,102,24,78,-54,5,24,34,2,AMEX
4714,13-02-2021 08:00,24 hrs.,StockMarket,LODE,6,0,6,-6,1,1,0,1,AMEX
4714,13-02-2021 08:00,24 hrs.,StockMarket,NSPR,6,0,6,-6,1,1,0,1,AMEX
4714,13-02-2021 08:00,24 hrs.,StockMarket,UAVS,10,10,0,10,1,1,4,1,AMEX
4714,13-02-2021 08:00,24 hrs.,StockMarket,ACB,46,46,0,46,1,20,2,1,NYSE
4714,13-02-2021 08:00,24 hrs.,StockMarket,AFC,6,0,6,-6,1,1,0,1,NYSE
4714,13-02-2021 08:00,24 hrs.,StockMarket,AGX,6,0,6,-6,1,1,0,1,NYSE
4714,13-02-2021 08:00,24 hrs.,StockMarket,AMC,36,22,14,8,3,1,22,3,NYSE
4714,13-02-2021 08:00,24 hrs.,StockMarket,BHC,13,0,13,-13,1,3,3,1,NYSE
4714,13-02-2021 08:00,24 hrs.,StockMarket,DIS,59,46,13,33,2,23,5,2,NYSE
4714,13-02-2021 08:00,24 hrs.,StockMarket,FSR,13,0,13,-13,1,3,3,1,NYSE
4714,13-02-2021 08:00,24 hrs.,StockMarket,GME,81,61,20,41,6,10,37,6,NYSE
4714,13-02-2021 08:00,24 hrs.,StockMarket,IBM,46,46,0,46,1,20,2,1,NYSE
4714,13-02-2021 08:00,24 hrs.,StockMarket,JNJ,6,6,0,6,1,1,0,1,NYSE
4714,13-02-2021 08:00,24 hrs.,StockMarket,JPM,18,18,0,18,1,3,8,1,NYSE
4714,13-02-2021 08:00,24 hrs.,StockMarket,LAC,4,0,4,-4,1,0,0,1,NYSE
4714,13-02-2021 08:00,24 hrs.,StockMarket,LLY,46,46,0,46,1,20,2,1,NYSE
4714,13-02-2021 08:00,24 hrs.,StockMarket,MCO,13,0,13,-13,1,3,3,1,NYSE
4714,13-02-2021 08:00,24 hrs.,StockMarket,MRO,13,0,13,-13,1,3,3,1,NYSE
4714,13-02-2021 08:00,24 hrs.,StockMarket,NIO,216,210,6,204,3,75,54,3,NYSE
4714,13-02-2021 08:00,24 hrs.,StockMarket,PHI,8,0,8,-8,1,2,0,1,NYSE
4714,13-02-2021 08:00,24 hrs.,StockMarket,PSA,6,6,0,6,1,1,0,1,NYSE
4714,13-02-2021 08:00,24 hrs.,StockMarket,SBE,6,0,6,-6,1,1,0,1,NYSE
4714,13-02-2021 08:00,24 hrs.,StockMarket,SMG,20,20,0,20,1,6,4,1,NYSE
4714,13-02-2021 08:00,24 hrs.,StockMarket,SOS,31,6,25,-19,4,6,3,4,NYSE
4714,13-02-2021 08:00,24 hrs.,StockMarket,TDA,13,0,13,-13,1,1,7,1,NYSE
4714,13-02-2021 08:00,24 hrs.,StockMarket,VRT,12,12,0,12,1,3,2,1,NYSE
4714,13-02-2021 08:00,24 hrs.,StockMarket,XPO,46,46,0,46,1,20,2,1,NYSE
4714,13-02-2021 08:00,24 hrs.,StockMarket,CCIV,33,21,12,9,2,9,7,2,NYSE
4714,13-02-2021 08:00,24 hrs.,StockMarket,CHWY,6,6,0,6,1,1,0,1,NYSE
4714,13-02-2021 08:00,24 hrs.,StockMarket,COTY,16,5,11,-6,2,2,4,2,NYSE
4714,13-02-2021 08:00,24 hrs.,StockMarket,DSSI,6,6,0,6,1,1,0,1,NYSE
4714,13-02-2021 08:00,24 hrs.,StockMarket,FUSE,12,0,12,-12,2,2,0,2,NYSE
4714,13-02-2021 08:00,24 hrs.,StockMarket,GDDY,46,46,0,46,1,20,2,1,NYSE
4714,13-02-2021 08:00,24 hrs.,StockMarket,GNRC,46,46,0,46,1,20,2,1,NYSE
4714,13-02-2021 08:00,24 hrs.,StockMarket,HEXO,13,13,0,13,1,4,1,1,NYSE
4714,13-02-2021 08:00,24 hrs.,StockMarket,HYLN,13,0,13,-13,1,3,3,1,NYSE
4714,13-02-2021 08:00,24 hrs.,StockMarket,LAIX,14,0,14,-14,1,0,10,1,NYSE
4714,13-02-2021 08:00,24 hrs.,StockMarket,PINS,27,27,0,27,1,5,13,1,NYSE
4714,13-02-2021 08:00,24 hrs.,StockMarket,RCMT,4,0,4,-4,1,0,0,1,NASDAQ
4714,13-02-2021 08:00,24 hrs.,StockMarket,REAL,34,0,34,-34,1,0,30,1,NASDAQ
4714,13-02-2021 08:00,24 hrs.,StockMarket,RIDE,19,0,19,-19,2,4,3,2,NASDAQ
4714,13-02-2021 08:00,24 hrs.,StockMarket,SBUX,27,27,0,27,1,5,13,1,NASDAQ
4714,13-02-2021 08:00,24 hrs.,StockMarket,SESN,36,36,0,36,2,12,4,1,NASDAQ
4714,13-02-2021 08:00,24 hrs.,StockMarket,SNDL,132,110,22,88,6,24,60,6,NASDAQ
4714,13-02-2021 08:00,24 hrs.,StockMarket,SPSC,46,46,0,46,1,20,2,1,NASDAQ
4714,13-02-2021 08:00,24 hrs.,StockMarket,SRAC,8,0,8,-8,1,0,4,1,NASDAQ
4714,13-02-2021 08:00,24 hrs.,StockMarket,SVMK,13,0,13,-13,1,3,3,1,NASDAQ
4714,13-02-2021 08:00,24 hrs.,StockMarket,TLRY,60,12,48,-36,6,12,12,6,NASDAQ
4714,13-02-2021 08:00,24 hrs.,StockMarket,TLSA,4,0,4,-4,1,0,0,1,NASDAQ
4714,13-02-2021 08:00,24 hrs.,StockMarket,TNXP,6,0,6,-6,1,1,0,1,NASDAQ
4714,13-02-2021 08:00,24 hrs.,StockMarket,TRVG,6,6,0,6,1,1,0,1,NASDAQ
4714,13-02-2021 08:00,24 hrs.,StockMarket,TSLA,1036,1030,6,1024,2,493,42,2,NASDAQ
4714,13-02-2021 08:00,24 hrs.,StockMarket,VITL,51,45,6,39,2,20,3,2,NASDAQ
4714,13-02-2021 08:00,24 hrs.,StockMarket,VRSN,13,0,13,-13,1,3,3,1,NASDAQ
4714,13-02-2021 08:00,24 hrs.,StockMarket,VUZI,6,6,0,6,1,1,0,1,NASDAQ
4714,13-02-2021 08:00,24 hrs.,StockMarket,VXRT,6,6,0,6,1,1,0,1,NASDAQ
4714,13-02-2021 08:00,24 hrs.,StockMarket,WAFU,83,0,83,-83,1,20,39,1,NASDAQ
4714,13-02-2021 08:00,24 hrs.,StockMarket,ZIOP,6,6,0,6,1,1,0,1,NASDAQ
4714,13-02-2021 08:00,24 hrs.,StockMarket,SRACU,8,0,8,-8,1,0,4,1,NASDAQ
4714,13-02-2021 08:00,24 hrs.,StockMarket,SRACW,8,0,8,-8,1,0,4,1,NASDAQ
4714,13-02-2021 08:00,24 hrs.,StockMarket,CDC,13,0,13,-13,1,3,3,1,NASDAQ
4714,13-02-2021 08:00,24 hrs.,StockMarket,INO,13,0,13,-13,1,3,3,1,NASDAQ
4714,13-02-2021 08:00,24 hrs.,StockMarket,JFU,78,0,78,-78,1,21,32,1,NASDAQ
4714,13-02-2021 08:00,24 hrs.,StockMarket,MGI,9,0,9,-9,1,2,1,1,NASDAQ
4714,13-02-2021 08:00,24 hrs.,StockMarket,NWL,13,0,13,-13,1,3,3,1,NASDAQ
4714,13-02-2021 08:00,24 hrs.,StockMarket,OGI,10,0,10,-10,2,1,0,2,NASDAQ
4714,13-02-2021 08:00,24 hrs.,StockMarket,OPK,6,0,6,-6,1,1,0,1,NASDAQ
4714,13-02-2021 08:00,24 hrs.,StockMarket,QQQ,73,73,0,73,2,25,15,2,NASDAQ
4714,13-02-2021 08:00,24 hrs.,StockMarket,SFT,6,0,6,-6,1,1,0,1,NASDAQ
4714,13-02-2021 08:00,24 hrs.,StockMarket,VFF,20,20,0,20,1,6,4,1,NASDAQ
4714,13-02-2021 08:00,24 hrs.,StockMarket,AAPL,27,27,0,27,1,5,13,1,NASDAQ
4714,13-02-2021 08:00,24 hrs.,StockMarket,AEZS,6,0,6,-6,1,1,0,1,NASDAQ
4714,13-02-2021 08:00,24 hrs.,RobinHoodPennyStocks,DFFN,876,155,721,-566,9,337,166,8,NASDAQ
4714,13-02-2021 08:00,24 hrs.,RobinHoodPennyStocks,ENTX,62,0,62,-62,1,24,10,1,NASDAQ
4714,13-02-2021 08:00,24 hrs.,RobinHoodPennyStocks,FCEL,51,0,51,-51,1,9,29,1,NASDAQ
4714,13-02-2021 08:00,24 hrs.,RobinHoodPennyStocks,GAIN,6,6,0,6,1,1,0,1,NASDAQ
4714,13-02-2021 08:00,24 hrs.,RobinHoodPennyStocks,GLBS,6,0,6,-6,1,1,0,1,NASDAQ
4714,13-02-2021 08:00,24 hrs.,RobinHoodPennyStocks,IDEX,13,0,13,-13,1,2,5,1,NASDAQ
4714,13-02-2021 08:00,24 hrs.,RobinHoodPennyStocks,IMMR,17,17,0,17,1,5,3,1,NASDAQ
4714,13-02-2021 08:00,24 hrs.,RobinHoodPennyStocks,INPX,12,12,0,12,2,2,0,1,NASDAQ
4714,13-02-2021 08:00,24 hrs.,RobinHoodPennyStocks,ITRM,6,6,0,6,1,1,0,1,NASDAQ
4714,13-02-2021 08:00,24 hrs.,RobinHoodPennyStocks,KTRA,18,18,0,18,1,5,4,1,NASDAQ
4714,13-02-2021 08:00,24 hrs.,RobinHoodPennyStocks,LKCO,103,0,103,-103,8,28,15,8,NASDAQ
4714,13-02-2021 08:00,24 hrs.,RobinHoodPennyStocks,MMLP,6,0,6,-6,1,1,0,1,NASDAQ
4714,13-02-2021 08:00,24 hrs.,RobinHoodPennyStocks,NAKD,99,87,12,75,3,36,15,3,NASDAQ
4714,13-02-2021 08:00,24 hrs.,RobinHoodPennyStocks,NMTR,152,152,0,152,1,50,48,1,NASDAQ
4714,13-02-2021 08:00,24 hrs.,RobinHoodPennyStocks,NOVN,45,0,45,-45,1,15,11,1,NASDAQ
4714,13-02-2021 08:00,24 hrs.,RobinHoodPennyStocks,NVCN,62,4,58,-54,2,15,24,2,NASDAQ
4714,13-02-2021 08:00,24 hrs.,RobinHoodPennyStocks,OCGN,40,0,40,-40,1,11,14,1,NASDAQ
4714,13-02-2021 08:00,24 hrs.,RobinHoodPennyStocks,OPGN,30,6,24,-18,5,5,0,2,NASDAQ
4714,13-02-2021 08:00,24 hrs.,RobinHoodPennyStocks,OPTT,6,0,6,-6,1,1,0,1,NASDAQ
4714,13-02-2021 08:00,24 hrs.,RobinHoodPennyStocks,OVID,6,0,6,-6,1,1,0,1,NASDAQ
4714,13-02-2021 08:00,24 hrs.,RobinHoodPennyStocks,PHUN,6,6,0,6,1,1,0,1,NASDAQ
4714,13-02-2021 08:00,24 hrs.,RobinHoodPennyStocks,PSEC,49,0,49,-49,3,10,17,2,NASDAQ
4714,13-02-2021 08:00,24 hrs.,RobinHoodPennyStocks,PSTV,159,0,159,-159,1,65,25,1,NASDAQ
4714,13-02-2021 08:00,24 hrs.,RobinHoodPennyStocks,RIOT,11,0,11,-11,1,2,3,1,NASDAQ
4714,13-02-2021 08:00,24 hrs.,RobinHoodPennyStocks,SHIP,54,18,36,-18,9,9,0,6,NASDAQ
4714,13-02-2021 08:00,24 hrs.,RobinHoodPennyStocks,SNDL,1452,6,1446,-1440,23,528,304,21,NASDAQ
4714,13-02-2021 08:00,24 hrs.,RobinHoodPennyStocks,SNGX,251,11,240,-229,4,96,43,3,NASDAQ
4714,13-02-2021 08:00,24 hrs.,RobinHoodPennyStocks,SRAX,6,6,0,6,1,1,0,1,NASDAQ
4714,13-02-2021 08:00,24 hrs.,RobinHoodPennyStocks,SRGA,6,0,6,-6,1,1,0,1,NASDAQ
4714,13-02-2021 08:00,24 hrs.,RobinHoodPennyStocks,TBLT,85,0,85,-85,1,27,27,1,NASDAQ
4714,13-02-2021 08:00,24 hrs.,pennystocks,ADTM,13,0,13,-13,2,2,1,1,OTC
4714,13-02-2021 08:00,24 hrs.,pennystocks,AFPW,6,0,6,-6,1,1,0,1,OTC
4714,13-02-2021 08:00,24 hrs.,pennystocks,AITX,332,0,332,-332,3,120,80,3,OTC
4714,13-02-2021 08:00,24 hrs.,pennystocks,ALKM,7,0,7,-7,1,1,1,1,OTC
4714,13-02-2021 08:00,24 hrs.,pennystocks,ALPP,386,0,386,-386,6,130,102,5,OTC
4714,13-02-2021 08:00,24 hrs.,pennystocks,ALST,24,0,24,-24,2,2,12,1,OTC
4714,13-02-2021 08:00,24 hrs.,pennystocks,ALYI,42,0,42,-42,3,11,8,3,OTC
4714,13-02-2021 08:00,24 hrs.,pennystocks,ANDI,7,0,7,-7,1,1,1,1,OTC
4714,13-02-2021 08:00,24 hrs.,pennystocks,APPZ,7,0,7,-7,1,1,1,1,OTC
4714,13-02-2021 08:00,24 hrs.,pennystocks,ASCK,6,6,0,6,1,1,0,1,OTC
4714,13-02-2021 08:00,24 hrs.,pennystocks,ASTI,18,0,18,-18,3,3,0,3,OTC
4714,13-02-2021 08:00,24 hrs.,pennystocks,ATDS,6,0,6,-6,1,1,0,1,OTC
4714,13-02-2021 08:00,24 hrs.,pennystocks,ATNP,29,29,0,29,1,4,17,1,OTC
4714,13-02-2021 08:00,24 hrs.,pennystocks,AXXA,26,0,26,-26,1,9,4,1,OTC
4714,13-02-2021 08:00,24 hrs.,pennystocks,AZFL,40,0,40,-40,1,6,24,1,OTC
4714,13-02-2021 08:00,24 hrs.,pennystocks,BANT,6,0,6,-6,1,1,0,1,OTC
4714,13-02-2021 08:00,24 hrs.,pennystocks,BBRW,166,0,166,-166,4,36,78,4,OTC
4714,13-02-2021 08:00,24 hrs.,pennystocks,BDGR,6,0,6,-6,1,1,0,1,OTC
4714,13-02-2021 08:00,24 hrs.,pennystocks,BFRE,16,0,16,-16,1,0,12,1,OTC
4714,13-02-2021 08:00,24 hrs.,pennystocks,BGMD,6,0,6,-6,1,1,0,1,OTC
4714,13-02-2021 08:00,24 hrs.,pennystocks,BIEL,111,0,111,-111,4,27,41,3,OTC
4714,13-02-2021 08:00,24 hrs.,pennystocks,BLDV,72,72,0,72,1,24,20,1,OTC
4714,13-02-2021 08:00,24 hrs.,StockMarket,AMAT,46,46,0,46,1,20,2,1,NASDAQ
4714,13-02-2021 08:00,24 hrs.,StockMarket,AMZN,46,46,0,46,1,20,2,1,NASDAQ
4714,13-02-2021 08:00,24 hrs.,StockMarket,APHA,6,0,6,-6,1,1,0,1,NASDAQ
4714,13-02-2021 08:00,24 hrs.,StockMarket,ARTL,83,0,83,-83,1,20,39,1,NASDAQ
4714,13-02-2021 08:00,24 hrs.,StockMarket,ATHX,6,6,0,6,1,1,0,1,NASDAQ
4714,13-02-2021 08:00,24 hrs.,StockMarket,ATOS,21,0,21,-21,2,6,1,2,NASDAQ
4714,13-02-2021 08:00,24 hrs.,StockMarket,AVGO,7,0,7,-7,1,1,1,1,NASDAQ
4714,13-02-2021 08:00,24 hrs.,StockMarket,BBBY,6,6,0,6,1,1,0,1,NASDAQ
4714,13-02-2021 08:00,24 hrs.,StockMarket,BPTH,6,0,6,-6,1,1,0,1,NASDAQ
4714,13-02-2021 08:00,24 hrs.,StockMarket,BSQR,9,9,0,9,1,1,3,1,NASDAQ
4714,13-02-2021 08:00,24 hrs.,StockMarket,BYND,6,0,6,-6,1,1,0,1,NASDAQ
4714,13-02-2021 08:00,24 hrs.,StockMarket,CLEU,97,0,97,-97,2,20,49,2,NASDAQ
4714,13-02-2021 08:00,24 hrs.,StockMarket,COHR,13,0,13,-13,1,3,3,1,NASDAQ
4714,13-02-2021 08:00,24 hrs.,StockMarket,CPLP,20,6,14,-8,3,4,0,3,NASDAQ
4714,13-02-2021 08:00,24 hrs.,StockMarket,CRSP,4,0,4,-4,1,0,0,1,NASDAQ
4714,13-02-2021 08:00,24 hrs.,StockMarket,CRSR,27,27,0,27,1,5,13,1,NASDAQ
4714,13-02-2021 08:00,24 hrs.,StockMarket,CTRM,6,6,0,6,1,1,0,1,NASDAQ
4714,13-02-2021 08:00,24 hrs.,StockMarket,CWCO,12,12,0,12,2,2,0,1,NASDAQ
4714,13-02-2021 08:00,24 hrs.,StockMarket,DDOG,59,46,13,33,2,23,5,2,NASDAQ
4714,13-02-2021 08:00,24 hrs.,StockMarket,ENTX,8,0,8,-8,1,2,0,1,NASDAQ
4714,13-02-2021 08:00,24 hrs.,StockMarket,EXPE,13,0,13,-13,1,3,3,1,NASDAQ
4714,13-02-2021 08:00,24 hrs.,StockMarket,FROG,46,46,0,46,1,20,2,1,NASDAQ
4714,13-02-2021 08:00,24 hrs.,StockMarket,GBIO,7,0,7,-7,1,1,1,1,NASDAQ
4714,13-02-2021 08:00,24 hrs.,StockMarket,GTHX,56,56,0,56,1,14,24,1,NASDAQ
4714,13-02-2021 08:00,24 hrs.,StockMarket,HTBX,84,0,84,-84,2,22,32,2,NASDAQ
4714,13-02-2021 08:00,24 hrs.,StockMarket,IDEX,6,6,0,6,1,1,0,1,NASDAQ
4714,13-02-2021 08:00,24 hrs.,StockMarket,IIVI,13,0,13,-13,1,3,3,1,NASDAQ
4714,13-02-2021 08:00,24 hrs.,StockMarket,INPX,6,6,0,6,1,1,0,1,NASDAQ
4714,13-02-2021 08:00,24 hrs.,StockMarket,INTZ,4,0,4,-4,1,0,0,1,NASDAQ
4714,13-02-2021 08:00,24 hrs.,StockMarket,LITE,13,0,13,-13,1,3,3,1,NASDAQ
4714,13-02-2021 08:00,24 hrs.,StockMarket,LIVE,13,0,13,-13,1,3,3,1,NASDAQ
4714,13-02-2021 08:00,24 hrs.,StockMarket,LLNW,25,0,25,-25,4,4,1,1,NASDAQ
4714,13-02-2021 08:00,24 hrs.,StockMarket,MKSI,13,0,13,-13,1,3,3,1,NASDAQ
4714,13-02-2021 08:00,24 hrs.,StockMarket,MSFT,27,27,0,27,1,5,13,1,NASDAQ
4714,13-02-2021 08:00,24 hrs.,StockMarket,MSTR,12,0,12,-12,2,2,0,1,NASDAQ
4714,13-02-2021 08:00,24 hrs.,StockMarket,MTCH,7,0,7,-7,1,0,3,1,NASDAQ
4714,13-02-2021 08:00,24 hrs.,StockMarket,OCGN,26,6,20,-14,3,2,10,3,NASDAQ
4714,13-02-2021 08:00,24 hrs.,StockMarket,PACB,4,0,4,-4,1,0,0,1,NASDAQ
4714,13-02-2021 08:00,24 hrs.,StockMarket,PTON,27,27,0,27,1,5,13,1,NASDAQ
4714,13-02-2021 08:00,24 hrs.,StockMarket,PYPL,19,0,19,-19,1,5,5,1,NASDAQ
4714,13-02-2021 08:00,24 hrs.,StockMarket,RARE,46,46,0,46,1,20,2,1,NASDAQ
4714,13-02-2021 08:00,24 hrs.,StockMarket,RBBN,6,0,6,-6,1,1,0,1,NASDAQ
4714,13-02-2021 08:00,24 hrs.,pennystocks,ICLD,6,0,6,-6,1,1,0,1,OTC
4714,13-02-2021 08:00,24 hrs.,pennystocks,ICNM,15,0,15,-15,1,3,5,1,OTC
4714,13-02-2021 08:00,24 hrs.,pennystocks,IMJX,92,0,92,-92,1,24,40,1,OTC
4714,13-02-2021 08:00,24 hrs.,pennystocks,IMTL,6,0,6,-6,1,1,0,1,OTC
4714,13-02-2021 08:00,24 hrs.,pennystocks,INKW,56,6,50,-44,9,9,2,7,OTC
4714,13-02-2021 08:00,24 hrs.,pennystocks,INND,206,106,100,6,7,44,90,7,OTC
4714,13-02-2021 08:00,24 hrs.,pennystocks,INTV,19,7,12,-5,3,3,1,3,OTC
4714,13-02-2021 08:00,24 hrs.,pennystocks,IPIX,6,0,6,-6,1,1,0,1,OTC
4714,13-02-2021 08:00,24 hrs.,pennystocks,IPSI,16,0,16,-16,1,4,4,1,OTC
4714,13-02-2021 08:00,24 hrs.,pennystocks,IQST,18,0,18,-18,3,3,0,2,OTC
4714,13-02-2021 08:00,24 hrs.,pennystocks,ISBL,7,7,0,7,1,1,1,1,OTC
4714,13-02-2021 08:00,24 hrs.,pennystocks,ITCJ,7,0,7,-7,1,1,1,1,OTC
4714,13-02-2021 08:00,24 hrs.,pennystocks,JSDA,6,0,6,-6,1,1,0,1,OTC
4714,13-02-2021 08:00,24 hrs.,pennystocks,KWBT,13,6,7,-1,2,2,1,2,OTC
4714,13-02-2021 08:00,24 hrs.,pennystocks,KYNC,6,0,6,-6,1,1,0,1,OTC
4714,13-02-2021 08:00,24 hrs.,pennystocks,LBTI,6,6,0,6,1,1,0,1,OTC
4714,13-02-2021 08:00,24 hrs.,pennystocks,BLSP,6,0,6,-6,1,1,0,1,OTC
4714,13-02-2021 08:00,24 hrs.,pennystocks,BMCS,10,0,10,-10,1,2,2,1,OTC
4714,13-02-2021 08:00,24 hrs.,pennystocks,BMIX,6,0,6,-6,1,1,0,1,OTC
4714,13-02-2021 08:00,24 hrs.,pennystocks,BMMJ,6,6,0,6,1,1,0,1,OTC
4714,13-02-2021 08:00,24 hrs.,pennystocks,BONZ,6,0,6,-6,1,0,2,1,OTC
4714,13-02-2021 08:00,24 hrs.,pennystocks,BRLL,46,0,46,-46,2,3,32,2,OTC
4714,13-02-2021 08:00,24 hrs.,pennystocks,BRTX,12,6,6,0,2,2,0,2,OTC
4714,13-02-2021 08:00,24 hrs.,pennystocks,BRZL,6,6,0,6,1,1,0,1,OTC
4714,13-02-2021 08:00,24 hrs.,pennystocks,BTZI,6,6,0,6,1,1,0,1,OTC
4714,13-02-2021 08:00,24 hrs.,pennystocks,BUDZ,24,0,24,-24,3,4,4,3,OTC
4714,13-02-2021 08:00,24 hrs.,pennystocks,BWMG,57,0,57,-57,2,14,21,2,OTC
4714,13-02-2021 08:00,24 hrs.,pennystocks,BZWR,15,0,15,-15,1,0,11,1,OTC
4714,13-02-2021 08:00,24 hrs.,pennystocks,CAFS,7,7,0,7,1,1,1,1,OTC
4714,13-02-2021 08:00,24 hrs.,pennystocks,CANN,6,0,6,-6,1,1,0,1,OTC
4714,13-02-2021 08:00,24 hrs.,pennystocks,CAPC,7,0,7,-7,1,1,1,1,OTC
4714,13-02-2021 08:00,24 hrs.,pennystocks,CATV,131,131,0,131,1,56,15,1,OTC
4714,13-02-2021 08:00,24 hrs.,pennystocks,CAVR,6,0,6,-6,1,1,0,1,OTC
4714,13-02-2021 08:00,24 hrs.,pennystocks,CBBT,392,0,392,-392,3,156,68,3,OTC
4714,13-02-2021 08:00,24 hrs.,pennystocks,CBDD,5,0,5,-5,1,0,1,1,OTC
4714,13-02-2021 08:00,24 hrs.,pennystocks,CBDL,283,0,283,-283,4,87,93,4,OTC
4714,13-02-2021 08:00,24 hrs.,pennystocks,CCTL,21,0,21,-21,1,7,3,1,OTC
4714,13-02-2021 08:00,24 hrs.,pennystocks,CELZ,13,6,7,-1,2,2,1,2,OTC
4714,13-02-2021 08:00,24 hrs.,pennystocks,CHNC,24,0,24,-24,1,6,8,1,OTC
4714,13-02-2021 08:00,24 hrs.,pennystocks,CLWD,6,0,6,-6,1,1,0,1,OTC
4714,13-02-2021 08:00,24 hrs.,pennystocks,CNNA,76,76,0,76,1,8,56,1,OTC
4714,13-02-2021 08:00,24 hrs.,pennystocks,COMS,13,13,0,13,2,2,1,1,OTC
4714,13-02-2021 08:00,24 hrs.,pennystocks,CORG,41,0,41,-41,3,5,19,3,OTC
4714,13-02-2021 08:00,24 hrs.,pennystocks,CRTG,33,0,33,-33,1,10,9,1,OTC
4714,13-02-2021 08:00,24 hrs.,pennystocks,CRWG,6,0,6,-6,1,1,0,1,OTC
4714,13-02-2021 08:00,24 hrs.,pennystocks,CSLI,44,44,0,44,1,12,16,1,OTC
4714,13-02-2021 08:00,24 hrs.,pennystocks,CTLE,18,12,6,6,3,3,0,3,OTC
4714,13-02-2021 08:00,24 hrs.,pennystocks,CYDY,7,0,7,-7,1,1,1,1,OTC
4714,13-02-2021 08:00,24 hrs.,pennystocks,DMAN,17,0,17,-17,1,4,5,1,OTC
4714,13-02-2021 08:00,24 hrs.,pennystocks,DPLS,163,47,116,-69,7,52,31,5,OTC
4714,13-02-2021 08:00,24 hrs.,pennystocks,DSGT,6,6,0,6,1,1,0,1,OTC
4714,13-02-2021 08:00,24 hrs.,pennystocks,EAWD,6,6,0,6,1,1,0,1,OTC
4714,13-02-2021 08:00,24 hrs.,pennystocks,ECEZ,7,7,0,7,1,1,1,1,OTC
4714,13-02-2021 08:00,24 hrs.,pennystocks,EHOS,40,40,0,40,1,9,18,1,OTC
4714,13-02-2021 08:00,24 hrs.,pennystocks,ELTP,16,0,16,-16,1,4,4,1,OTC
4714,13-02-2021 08:00,24 hrs.,pennystocks,ENRT,6,0,6,-6,1,1,0,1,OTC
4714,13-02-2021 08:00,24 hrs.,pennystocks,ENZC,12,0,12,-12,2,2,0,2,OTC
4714,13-02-2021 08:00,24 hrs.,pennystocks,ERBB,26,14,12,2,2,1,16,2,OTC
4714,13-02-2021 08:00,24 hrs.,pennystocks,ETFM,201,201,0,201,4,67,51,3,OTC
4714,13-02-2021 08:00,24 hrs.,pennystocks,ETHE,40,0,40,-40,1,5,26,1,OTC
4714,13-02-2021 08:00,24 hrs.,pennystocks,EWKS,7,0,7,-7,1,1,1,1,OTC
4714,13-02-2021 08:00,24 hrs.,pennystocks,FBEC,6,0,6,-6,1,1,0,1,OTC
4714,13-02-2021 08:00,24 hrs.,pennystocks,FDBH,7,0,7,-7,1,1,1,1,OTC
4714,13-02-2021 08:00,24 hrs.,pennystocks,ABML,152,66,86,-20,3,47,46,3,OTC
4714,13-02-2021 08:00,24 hrs.,pennystocks,VPLM,6,0,6,-6,1,1,0,1,OTC
4714,13-02-2021 08:00,24 hrs.,pennystocks,VSPC,6,6,0,6,1,1,0,1,OTC
4714,13-02-2021 08:00,24 hrs.,pennystocks,VTLR,6,0,6,-6,1,1,0,1,OTC
4714,13-02-2021 08:00,24 hrs.,pennystocks,WCVC,92,0,92,-92,1,24,40,1,OTC
4714,13-02-2021 08:00,24 hrs.,pennystocks,WIZD,16,0,16,-16,1,4,4,1,OTC
4714,13-02-2021 08:00,24 hrs.,pennystocks,WTII,37,0,37,-37,1,11,11,1,OTC
4714,13-02-2021 08:00,24 hrs.,pennystocks,XLPI,183,183,0,183,1,82,15,1,OTC
4714,13-02-2021 08:00,24 hrs.,pennystocks,XMET,6,6,0,6,1,1,0,1,OTC
4714,13-02-2021 08:00,24 hrs.,pennystocks,ZHUD,8,8,0,8,1,1,2,1,OTC
4714,13-02-2021 08:00,24 hrs.,pennystocks,AGGHF,19,0,19,-19,1,4,7,1,OTC
4714,13-02-2021 08:00,24 hrs.,pennystocks,ALLIF,124,0,124,-124,1,36,48,1,OTC
4714,13-02-2021 08:00,24 hrs.,pennystocks,ARBKF,70,24,46,-22,3,12,34,3,OTC
4714,13-02-2021 08:00,24 hrs.,pennystocks,BDRBF,6,0,6,-6,1,1,0,1,OTC
4714,13-02-2021 08:00,24 hrs.,pennystocks,BFARF,9,9,0,9,1,0,5,1,OTC
4714,13-02-2021 08:00,24 hrs.,pennystocks,LITH,6,0,6,-6,1,1,0,1,OTC
4714,13-02-2021 08:00,24 hrs.,pennystocks,LQMT,6,0,6,-6,1,1,0,1,OTC
4714,13-02-2021 08:00,24 hrs.,pennystocks,LUVU,14,0,14,-14,2,3,0,2,OTC
4714,13-02-2021 08:00,24 hrs.,pennystocks,LVVV,39,39,0,39,1,8,19,1,OTC
4714,13-02-2021 08:00,24 hrs.,pennystocks,MAXD,59,6,53,-47,6,15,5,6,OTC
4714,13-02-2021 08:00,24 hrs.,pennystocks,MCOA,7,0,7,-7,1,1,1,1,OTC
4714,13-02-2021 08:00,24 hrs.,pennystocks,MDCN,13,0,13,-13,2,2,1,2,OTC
4714,13-02-2021 08:00,24 hrs.,pennystocks,MEDH,81,0,81,-81,1,19,39,1,OTC
4714,13-02-2021 08:00,24 hrs.,pennystocks,MGTI,24,24,0,24,1,8,4,1,OTC
4714,13-02-2021 08:00,24 hrs.,pennystocks,MIHI,6,0,6,-6,1,1,0,1,OTC
4714,13-02-2021 08:00,24 hrs.,pennystocks,MINE,71,6,65,-59,6,11,25,6,OTC
4714,13-02-2021 08:00,24 hrs.,pennystocks,MJNA,25,0,25,-25,4,4,1,4,OTC
4714,13-02-2021 08:00,24 hrs.,pennystocks,MJTV,7,0,7,-7,1,1,1,1,OTC
4714,13-02-2021 08:00,24 hrs.,pennystocks,MKTY,7,0,7,-7,1,1,1,1,OTC
4714,13-02-2021 08:00,24 hrs.,pennystocks,MLFB,155,0,155,-155,3,47,49,3,OTC
4714,13-02-2021 08:00,24 hrs.,pennystocks,MMEX,139,0,139,-139,3,25,77,2,OTC
4714,13-02-2021 08:00,24 hrs.,pennystocks,MOJO,12,6,6,0,2,2,0,2,OTC
4714,13-02-2021 08:00,24 hrs.,pennystocks,MRMD,5,5,0,5,1,0,1,1,OTC
4714,13-02-2021 08:00,24 hrs.,pennystocks,MTVX,6,0,6,-6,1,1,0,1,OTC
4714,13-02-2021 08:00,24 hrs.,pennystocks,NBVG,7,0,7,-7,1,1,1,1,OTC
4714,13-02-2021 08:00,24 hrs.,pennystocks,NOVC,56,0,56,-56,2,17,14,2,OTC
4714,13-02-2021 08:00,24 hrs.,pennystocks,NSAV,13,0,13,-13,2,2,1,2,OTC
4714,13-02-2021 08:00,24 hrs.,pennystocks,NSPT,6,0,6,-6,1,1,0,1,OTC
4714,13-02-2021 08:00,24 hrs.,pennystocks,NUGS,7,7,0,7,1,1,1,1,OTC
4714,13-02-2021 08:00,24 hrs.,pennystocks,FLXT,6,0,6,-6,1,1,0,1,OTC
4714,13-02-2021 08:00,24 hrs.,pennystocks,FTEG,6,6,0,6,1,1,0,1,OTC
4714,13-02-2021 08:00,24 hrs.,pennystocks,FUST,7,0,7,-7,1,1,1,1,OTC
4714,13-02-2021 08:00,24 hrs.,pennystocks,GAXY,72,72,0,72,1,25,18,1,OTC
4714,13-02-2021 08:00,24 hrs.,pennystocks,GBTC,40,0,40,-40,1,5,26,1,OTC
4714,13-02-2021 08:00,24 hrs.,pennystocks,GHMP,46,0,46,-46,3,8,18,2,OTC
4714,13-02-2021 08:00,24 hrs.,pennystocks,GLCO,6,0,6,-6,1,1,0,1,OTC
4714,13-02-2021 08:00,24 hrs.,pennystocks,GLEC,6,0,6,-6,1,1,0,1,OTC
4714,13-02-2021 08:00,24 hrs.,pennystocks,GPFT,12,12,0,12,1,3,2,1,OTC
4714,13-02-2021 08:00,24 hrs.,pennystocks,GRCU,11,0,11,-11,1,1,5,1,OTC
4714,13-02-2021 08:00,24 hrs.,pennystocks,GRCV,7,7,0,7,1,1,1,1,OTC
4714,13-02-2021 08:00,24 hrs.,pennystocks,GRST,109,103,6,97,2,34,33,2,OTC
4714,13-02-2021 08:00,24 hrs.,pennystocks,GTBP,19,19,0,19,1,2,11,1,OTC
4714,13-02-2021 08:00,24 hrs.,pennystocks,GTCH,20,0,20,-20,1,0,16,1,OTC
4714,13-02-2021 08:00,24 hrs.,pennystocks,GTEH,43,43,0,43,1,9,21,1,OTC
4714,13-02-2021 08:00,24 hrs.,pennystocks,GTLL,81,27,54,-27,4,27,11,4,OTC
4714,13-02-2021 08:00,24 hrs.,pennystocks,HALB,33,0,33,-33,2,9,7,1,OTC
4714,13-02-2021 08:00,24 hrs.,pennystocks,HCMC,121,50,71,-21,19,19,7,17,OTC
4714,13-02-2021 08:00,24 hrs.,pennystocks,HEMP,7,0,7,-7,1,1,1,1,OTC
4714,13-02-2021 08:00,24 hrs.,pennystocks,HENC,13,13,0,13,1,2,5,1,OTC
4714,13-02-2021 08:00,24 hrs.,pennystocks,HIPH,18,6,12,-6,3,2,2,2,OTC
4714,13-02-2021 08:00,24 hrs.,pennystocks,HMMR,7,0,7,-7,1,1,1,1,OTC
4714,13-02-2021 08:00,24 hrs.,pennystocks,HMNY,6,0,6,-6,1,1,0,1,OTC
4714,13-02-2021 08:00,24 hrs.,pennystocks,HPTY,46,0,46,-46,1,14,14,1,OTC
4714,13-02-2021 08:00,24 hrs.,pennystocks,HYSR,6,0,6,-6,1,1,0,1,OTC
4714,13-02-2021 08:00,24 hrs.,pennystocks,ICBU,6,0,6,-6,1,1,0,1,OTC
4714,13-02-2021 08:00,24 hrs.,pennystocks,RLFTF,6,0,6,-6,1,1,0,1,OTC
4714,13-02-2021 08:00,24 hrs.,pennystocks,RLLCF,69,0,69,-69,8,12,13,7,OTC
4714,13-02-2021 08:00,24 hrs.,pennystocks,RVVTF,7,0,7,-7,1,1,1,1,OTC
4714,13-02-2021 08:00,24 hrs.,pennystocks,SNNAF,12,0,12,-12,1,3,2,1,OTC
4714,13-02-2021 08:00,24 hrs.,pennystocks,SPFYF,9,0,9,-9,1,1,3,1,OTC
4714,13-02-2021 08:00,24 hrs.,pennystocks,SPMTF,20,0,20,-20,1,2,12,1,OTC
4714,13-02-2021 08:00,24 hrs.,pennystocks,SPRWF,166,0,166,-166,5,58,30,5,OTC
4714,13-02-2021 08:00,24 hrs.,pennystocks,TAKOF,42,42,0,42,1,15,8,1,OTC
4714,13-02-2021 08:00,24 hrs.,pennystocks,TOBAF,29,29,0,29,1,6,13,1,OTC
4714,13-02-2021 08:00,24 hrs.,pennystocks,TSCRF,80,0,80,-80,3,22,24,3,OTC
4714,13-02-2021 08:00,24 hrs.,pennystocks,VRNDF,18,0,18,-18,1,5,4,1,OTC
4714,13-02-2021 08:00,24 hrs.,pennystocks,XELAW,200,0,200,-200,1,89,18,1,OTC
4714,13-02-2021 08:00,24 hrs.,pennystocks,ZBISF,57,0,57,-57,1,21,11,1,OTC
4714,13-02-2021 08:00,24 hrs.,pennystocks,BKLLF,86,0,86,-86,1,27,28,1,OTC
4714,13-02-2021 08:00,24 hrs.,pennystocks,OZSC,101,101,0,101,3,23,43,3,OTC
4714,13-02-2021 08:00,24 hrs.,pennystocks,PAOG,7,0,7,-7,1,1,1,1,OTC
4714,13-02-2021 08:00,24 hrs.,pennystocks,PDXP,7,0,7,-7,1,1,1,1,OTC
4714,13-02-2021 08:00,24 hrs.,pennystocks,PHIL,6,0,6,-6,1,1,0,1,OTC
4714,13-02-2021 08:00,24 hrs.,pennystocks,PMCB,6,0,6,-6,1,1,0,1,OTC
4714,13-02-2021 08:00,24 hrs.,pennystocks,PPJE,6,0,6,-6,1,1,0,1,OTC
4714,13-02-2021 08:00,24 hrs.,pennystocks,PUGE,45,6,39,-33,2,14,9,2,OTC
4714,13-02-2021 08:00,24 hrs.,pennystocks,PURA,54,41,13,28,3,8,26,3,OTC
4714,13-02-2021 08:00,24 hrs.,pennystocks,PVDG,25,0,25,-25,1,2,17,1,OTC
4714,13-02-2021 08:00,24 hrs.,pennystocks,QOIL,7,0,7,-7,1,1,1,1,OTC
4714,13-02-2021 08:00,24 hrs.,pennystocks,RDGL,6,0,6,-6,1,1,0,1,OTC
4714,13-02-2021 08:00,24 hrs.,pennystocks,RELI,16,0,16,-16,1,0,12,1,OTC
4714,13-02-2021 08:00,24 hrs.,pennystocks,RGBP,21,0,21,-21,2,5,3,1,OTC
4714,13-02-2021 08:00,24 hrs.,pennystocks,RLBD,18,0,18,-18,1,5,4,1,OTC
4714,13-02-2021 08:00,24 hrs.,pennystocks,RMTD,6,0,6,-6,1,1,0,1,OTC
4714,13-02-2021 08:00,24 hrs.,pennystocks,RNVA,6,6,0,6,1,1,0,1,OTC
4714,13-02-2021 08:00,24 hrs.,pennystocks,RSHN,19,0,19,-19,1,2,11,1,OTC
4714,13-02-2021 08:00,24 hrs.,pennystocks,RSSV,302,0,302,-302,2,109,76,2,OTC
4714,13-02-2021 08:00,24 hrs.,pennystocks,RTON,13,0,13,-13,2,2,1,2,OTC
4714,13-02-2021 08:00,24 hrs.,pennystocks,SCIE,6,0,6,-6,1,1,0,1,OTC
4714,13-02-2021 08:00,24 hrs.,pennystocks,SCNA,6,6,0,6,1,1,0,1,OTC
4714,13-02-2021 08:00,24 hrs.,pennystocks,SFOR,15,0,15,-15,1,0,11,1,OTC
4714,13-02-2021 08:00,24 hrs.,pennystocks,SGMD,361,67,294,-227,10,113,95,10,OTC
4714,13-02-2021 08:00,24 hrs.,pennystocks,SGSI,6,0,6,-6,1,1,0,1,OTC
4714,13-02-2021 08:00,24 hrs.,pennystocks,SHMP,6,0,6,-6,1,1,0,1,OTC
4714,13-02-2021 08:00,24 hrs.,pennystocks,SHWZ,7,0,7,-7,1,1,1,1,OTC
4714,13-02-2021 08:00,24 hrs.,pennystocks,SIML,98,0,98,-98,2,25,40,2,OTC
4714,13-02-2021 08:00,24 hrs.,pennystocks,SING,34,0,34,-34,2,5,16,2,OTC
4714,13-02-2021 08:00,24 hrs.,pennystocks,SNPW,75,42,33,9,4,23,13,4,OTC
4714,13-02-2021 08:00,24 hrs.,pennystocks,SNRS,14,0,14,-14,2,2,2,2,OTC
4714,13-02-2021 08:00,24 hrs.,pennystocks,SNWV,12,0,12,-12,2,2,0,1,OTC
4714,13-02-2021 08:00,24 hrs.,pennystocks,SNYR,6,0,6,-6,1,1,0,1,OTC
4714,13-02-2021 08:00,24 hrs.,pennystocks,SRMX,71,6,65,-59,6,19,9,6,OTC
4714,13-02-2021 08:00,24 hrs.,pennystocks,SRNA,6,0,6,-6,1,1,0,1,OTC
4714,13-02-2021 08:00,24 hrs.,pennystocks,SSFT,15,0,15,-15,1,0,11,1,OTC
4714,13-02-2021 08:00,24 hrs.,pennystocks,SSOK,15,0,15,-15,1,0,11,1,OTC
4714,13-02-2021 08:00,24 hrs.,pennystocks,STEV,12,0,12,-12,1,3,2,1,OTC
4714,13-02-2021 08:00,24 hrs.,pennystocks,STWC,23,23,0,23,1,7,5,1,OTC
4714,13-02-2021 08:00,24 hrs.,pennystocks,TAUG,6,6,0,6,1,1,0,1,OTC
4714,13-02-2021 08:00,24 hrs.,pennystocks,TCHH,7,0,7,-7,1,1,1,1,OTC
4714,13-02-2021 08:00,24 hrs.,pennystocks,TGHI,11,0,11,-11,1,2,3,1,OTC
4714,13-02-2021 08:00,24 hrs.,pennystocks,TLGN,71,0,71,-71,3,18,23,2,OTC
4714,13-02-2021 08:00,24 hrs.,pennystocks,TLSS,92,0,92,-92,2,28,28,2,OTC
4714,13-02-2021 08:00,24 hrs.,pennystocks,TPAC,5223,0,5223,-5223,1,2354,511,1,OTC
4714,13-02-2021 08:00,24 hrs.,pennystocks,TSNP,69,63,6,57,4,21,11,3,OTC
4714,13-02-2021 08:00,24 hrs.,pennystocks,TXTM,7,7,0,7,1,1,1,1,OTC
4714,13-02-2021 08:00,24 hrs.,pennystocks,USMJ,40,0,40,-40,2,8,16,2,OTC
4714,13-02-2021 08:00,24 hrs.,pennystocks,USRM,6,0,6,-6,1,1,0,1,OTC
4714,13-02-2021 08:00,24 hrs.,pennystocks,VFRM,6,0,6,-6,1,1,0,1,OTC
4714,13-02-2021 08:00,24 hrs.,pennystocks,VPER,59,59,0,59,1,9,37,1,OTC
4714,13-02-2021 08:00,24 hrs.,pennystocks,PTN,28,0,28,-28,1,9,6,1,AMEX
4714,13-02-2021 08:00,24 hrs.,pennystocks,TGB,37,6,31,-25,2,11,7,2,AMEX
4714,13-02-2021 08:00,24 hrs.,pennystocks,TRX,8,0,8,-8,1,1,2,1,AMEX
4714,13-02-2021 08:00,24 hrs.,pennystocks,ZOM,89,76,13,63,3,10,57,3,AMEX
4714,13-02-2021 08:00,24 hrs.,pennystocks,GSAT,70,70,0,70,1,17,32,1,AMEX
4714,13-02-2021 08:00,24 hrs.,pennystocks,IBIO,21,21,0,21,1,7,3,1,AMEX
4714,13-02-2021 08:00,24 hrs.,pennystocks,INUV,65,0,65,-65,1,23,15,1,AMEX
4714,13-02-2021 08:00,24 hrs.,pennystocks,NSPR,20,0,20,-20,1,6,4,1,AMEX
4714,13-02-2021 08:00,24 hrs.,pennystocks,OGEN,6,6,0,6,1,1,0,1,AMEX
4714,13-02-2021 08:00,24 hrs.,pennystocks,SDPI,6,0,6,-6,1,1,0,1,AMEX
4714,13-02-2021 08:00,24 hrs.,pennystocks,SENS,34,0,34,-34,3,5,12,3,AMEX
4714,13-02-2021 08:00,24 hrs.,pennystocks,TRXC,17,5,12,-7,3,2,1,3,AMEX
4714,13-02-2021 08:00,24 hrs.,pennystocks,UAVS,108,0,108,-108,1,35,34,1,AMEX
4714,13-02-2021 08:00,24 hrs.,pennystocks,XXII,6,0,6,-6,1,0,2,1,AMEX
4714,13-02-2021 08:00,24 hrs.,pennystocks,ACB,19,19,0,19,1,1,13,1,NYSE
4714,13-02-2021 08:00,24 hrs.,pennystocks,AHT,6,0,6,-6,1,1,0,1,NYSE
4714,13-02-2021 08:00,24 hrs.,pennystocks,AMC,84,0,84,-84,5,15,34,5,NYSE
4714,13-02-2021 08:00,24 hrs.,pennystocks,ASX,24,0,24,-24,4,4,0,2,NYSE
4714,13-02-2021 08:00,24 hrs.,pennystocks,ATH,12,0,12,-12,1,3,2,1,NYSE
4714,13-02-2021 08:00,24 hrs.,pennystocks,AXL,5,5,0,5,1,0,1,1,NYSE
4714,13-02-2021 08:00,24 hrs.,pennystocks,BTU,6,0,6,-6,1,1,0,1,NYSE
4714,13-02-2021 08:00,24 hrs.,pennystocks,BNCHF,6,0,6,-6,1,1,0,1,OTC
4714,13-02-2021 08:00,24 hrs.,pennystocks,BRPHF,40,0,40,-40,1,5,26,1,OTC
4714,13-02-2021 08:00,24 hrs.,pennystocks,BVNNF,7,0,7,-7,1,1,1,1,OTC
4714,13-02-2021 08:00,24 hrs.,pennystocks,CANSF,5,0,5,-5,1,0,1,1,OTC
4714,13-02-2021 08:00,24 hrs.,pennystocks,CBULF,6,0,6,-6,1,1,0,1,OTC
4714,13-02-2021 08:00,24 hrs.,pennystocks,CBWTF,13,0,13,-13,2,2,1,2,OTC
4714,13-02-2021 08:00,24 hrs.,pennystocks,CIOXY,7,0,7,-7,1,1,1,1,OTC
4714,13-02-2021 08:00,24 hrs.,pennystocks,CLUBQ,23,23,0,23,2,5,5,1,OTC
4714,13-02-2021 08:00,24 hrs.,pennystocks,CPHRF,6,6,0,6,1,1,0,1,OTC
4714,13-02-2021 08:00,24 hrs.,pennystocks,CRLBF,97,76,21,55,2,9,71,2,OTC
4714,13-02-2021 08:00,24 hrs.,pennystocks,CWGYF,6,6,0,6,1,1,0,1,OTC
4714,13-02-2021 08:00,24 hrs.,pennystocks,CWSFF,6,6,0,6,1,1,0,1,OTC
4714,13-02-2021 08:00,24 hrs.,pennystocks,DFODQ,22,0,22,-22,1,4,10,1,OTC
4714,13-02-2021 08:00,24 hrs.,pennystocks,DIGAF,7,7,0,7,1,1,1,1,OTC
4714,13-02-2021 08:00,24 hrs.,pennystocks,DMGGF,40,0,40,-40,1,5,26,1,OTC
4714,13-02-2021 08:00,24 hrs.,pennystocks,EHVVF,15,0,15,-15,1,0,11,1,OTC
4714,13-02-2021 08:00,24 hrs.,pennystocks,ELRRF,12,0,12,-12,2,2,0,2,OTC
4714,13-02-2021 08:00,24 hrs.,pennystocks,EMHTF,6,0,6,-6,1,1,0,1,OTC
4714,13-02-2021 08:00,24 hrs.,pennystocks,EPWCF,14,14,0,14,1,0,10,1,OTC
4714,13-02-2021 08:00,24 hrs.,pennystocks,ERPNF,25,25,0,25,1,9,3,1,OTC
4714,13-02-2021 08:00,24 hrs.,pennystocks,EVKIF,33,0,33,-33,1,10,9,1,OTC
4714,13-02-2021 08:00,24 hrs.,pennystocks,FLWPF,26,0,26,-26,1,6,10,1,OTC
4714,13-02-2021 08:00,24 hrs.,pennystocks,FUNFF,12,0,12,-12,1,3,2,1,OTC
4714,13-02-2021 08:00,24 hrs.,pennystocks,GLDFF,6,0,6,-6,1,1,0,1,OTC
4714,13-02-2021 08:00,24 hrs.,pennystocks,HITIF,2718,1304,1414,-110,12,998,674,11,OTC
4714,13-02-2021 08:00,24 hrs.,pennystocks,HRVSF,6,0,6,-6,1,1,0,1,OTC
4714,13-02-2021 08:00,24 hrs.,pennystocks,IDXAF,6,0,6,-6,1,1,0,1,OTC
4714,13-02-2021 08:00,24 hrs.,pennystocks,INTEQ,6,0,6,-6,1,1,0,1,OTC
4714,13-02-2021 08:00,24 hrs.,pennystocks,KCCFF,26,26,0,26,1,8,6,1,OTC
4714,13-02-2021 08:00,24 hrs.,pennystocks,LLKKF,24,0,24,-24,4,4,0,1,OTC
4714,13-02-2021 08:00,24 hrs.,pennystocks,LXXGF,98,0,98,-98,1,21,52,1,OTC
4714,13-02-2021 08:00,24 hrs.,pennystocks,MEDIF,6,0,6,-6,1,1,0,1,OTC
4714,13-02-2021 08:00,24 hrs.,pennystocks,MMEDF,31,0,31,-31,1,13,1,1,OTC
4714,13-02-2021 08:00,24 hrs.,pennystocks,MNXXF,57,0,57,-57,3,11,23,2,OTC
4714,13-02-2021 08:00,24 hrs.,pennystocks,NMGRF,12,6,6,0,2,2,0,2,OTC
4714,13-02-2021 08:00,24 hrs.,pennystocks,NOSUF,45,45,0,45,2,11,15,2,OTC
4714,13-02-2021 08:00,24 hrs.,pennystocks,NXTTF,71,53,18,35,4,16,23,4,OTC
4714,13-02-2021 08:00,24 hrs.,pennystocks,OILFF,6,0,6,-6,1,1,0,1,OTC
4714,13-02-2021 08:00,24 hrs.,pennystocks,PFWIQ,92,0,92,-92,1,24,40,1,OTC
4714,13-02-2021 08:00,24 hrs.,pennystocks,PMNXF,6,0,6,-6,1,1,0,1,OTC
4714,13-02-2021 08:00,24 hrs.,pennystocks,QYOUF,6,0,6,-6,1,1,0,1,OTC
4714,13-02-2021 08:00,24 hrs.,pennystocks,RAZFF,7,7,0,7,1,1,1,1,OTC
4714,13-02-2021 08:00,24 hrs.,pennystocks,RHDGF,9,0,9,-9,1,1,3,1,OTC
4714,13-02-2021 08:00,24 hrs.,pennystocks,ATOS,122,0,122,-122,3,41,28,3,NASDAQ
4714,13-02-2021 08:00,24 hrs.,pennystocks,BCLI,5,5,0,5,1,0,1,1,NASDAQ
4714,13-02-2021 08:00,24 hrs.,pennystocks,BIOL,42,36,6,30,2,10,14,2,NASDAQ
4714,13-02-2021 08:00,24 hrs.,pennystocks,BNGO,62,25,37,-12,4,20,6,4,NASDAQ
4714,13-02-2021 08:00,24 hrs.,pennystocks,BWEN,12,12,0,12,2,2,0,2,NASDAQ
4714,13-02-2021 08:00,24 hrs.,pennystocks,CFMS,12,0,12,-12,2,2,0,2,NASDAQ
4714,13-02-2021 08:00,24 hrs.,pennystocks,CIDM,130,32,98,-66,2,31,60,2,NASDAQ
4714,13-02-2021 08:00,24 hrs.,pennystocks,CKPT,27,21,6,15,3,4,7,3,NASDAQ
4714,13-02-2021 08:00,24 hrs.,pennystocks,CLBS,242,133,109,24,5,81,60,5,NASDAQ
4714,13-02-2021 08:00,24 hrs.,pennystocks,CLEU,7,0,7,-7,1,1,1,1,NASDAQ
4714,13-02-2021 08:00,24 hrs.,pennystocks,COCP,39,0,39,-39,2,14,3,2,NASDAQ
4714,13-02-2021 08:00,24 hrs.,pennystocks,CPLP,20,0,20,-20,2,1,10,1,NASDAQ
4714,13-02-2021 08:00,24 hrs.,pennystocks,CRBP,75,75,0,75,1,32,7,1,NASDAQ
4714,13-02-2021 08:00,24 hrs.,pennystocks,CRWS,6,0,6,-6,1,1,0,1,NASDAQ
4714,13-02-2021 08:00,24 hrs.,pennystocks,CSCW,7,0,7,-7,1,1,1,1,NASDAQ
4714,13-02-2021 08:00,24 hrs.,pennystocks,CSTR,6,0,6,-6,1,1,0,1,NASDAQ
4714,13-02-2021 08:00,24 hrs.,pennystocks,CTHR,16,0,16,-16,1,4,4,1,NASDAQ
4714,13-02-2021 08:00,24 hrs.,pennystocks,CTMX,14,14,0,14,1,2,6,1,NASDAQ
4714,13-02-2021 08:00,24 hrs.,pennystocks,CTRM,66,13,53,-40,6,15,12,6,NASDAQ
4714,13-02-2021 08:00,24 hrs.,pennystocks,CTXR,20,0,20,-20,1,6,4,1,NASDAQ
4714,13-02-2021 08:00,24 hrs.,pennystocks,CYTH,8,0,8,-8,1,1,2,1,NASDAQ
4714,13-02-2021 08:00,24 hrs.,pennystocks,DFFN,288,91,197,-106,7,110,40,7,NASDAQ
4714,13-02-2021 08:00,24 hrs.,pennystocks,EBON,6,0,6,-6,1,1,0,1,NASDAQ
4714,13-02-2021 08:00,24 hrs.,pennystocks,EDIT,200,0,200,-200,1,89,18,1,NASDAQ
4714,13-02-2021 08:00,24 hrs.,pennystocks,ENTX,28,0,28,-28,1,10,4,1,NASDAQ
4714,13-02-2021 08:00,24 hrs.,pennystocks,ENVB,6,0,6,-6,1,1,0,1,NASDAQ
4714,13-02-2021 08:00,24 hrs.,pennystocks,EPSN,12,0,12,-12,2,2,0,2,NASDAQ
4714,13-02-2021 08:00,24 hrs.,pennystocks,FAMI,13,0,13,-13,2,2,1,2,NASDAQ
4714,13-02-2021 08:00,24 hrs.,pennystocks,FAST,6,6,0,6,1,1,0,1,NASDAQ
4714,13-02-2021 08:00,24 hrs.,pennystocks,FATE,19,0,19,-19,1,7,1,1,NASDAQ
4714,13-02-2021 08:00,24 hrs.,pennystocks,GAIN,7,0,7,-7,1,1,1,1,NASDAQ
4714,13-02-2021 08:00,24 hrs.,pennystocks,CBD,42,24,18,6,4,9,8,4,NYSE
4714,13-02-2021 08:00,24 hrs.,pennystocks,CHS,33,0,33,-33,1,10,9,1,NYSE
4714,13-02-2021 08:00,24 hrs.,pennystocks,CLI,64,64,0,64,1,22,16,1,NYSE
4714,13-02-2021 08:00,24 hrs.,pennystocks,CMD,64,64,0,64,1,22,16,1,NYSE
4714,13-02-2021 08:00,24 hrs.,pennystocks,CVE,18,0,18,-18,3,3,0,1,NYSE
4714,13-02-2021 08:00,24 hrs.,pennystocks,CVX,33,0,33,-33,1,11,7,1,NYSE
4714,13-02-2021 08:00,24 hrs.,pennystocks,ETH,6,0,6,-6,1,1,0,1,NYSE
4714,13-02-2021 08:00,24 hrs.,pennystocks,FLT,42,42,0,42,1,15,8,1,NYSE
4714,13-02-2021 08:00,24 hrs.,pennystocks,GME,24,18,6,12,4,4,0,3,NYSE
4714,13-02-2021 08:00,24 hrs.,pennystocks,IRR,26,26,0,26,1,8,6,1,NYSE
4714,13-02-2021 08:00,24 hrs.,pennystocks,KOS,7,7,0,7,1,1,1,1,NYSE
4714,13-02-2021 08:00,24 hrs.,pennystocks,LOW,6,6,0,6,1,1,0,1,NYSE
4714,13-02-2021 08:00,24 hrs.,pennystocks,MDC,15,0,15,-15,1,4,3,1,NYSE
4714,13-02-2021 08:00,24 hrs.,pennystocks,MED,6,6,0,6,1,1,0,1,NYSE
4714,13-02-2021 08:00,24 hrs.,pennystocks,MIN,6,6,0,6,1,1,0,1,NYSE
4714,13-02-2021 08:00,24 hrs.,pennystocks,NAT,7,0,7,-7,1,1,1,1,NYSE
4714,13-02-2021 08:00,24 hrs.,pennystocks,NOK,6,0,6,-6,1,1,0,1,NYSE
4714,13-02-2021 08:00,24 hrs.,pennystocks,NPV,26,26,0,26,1,8,6,1,NYSE
4714,13-02-2021 08:00,24 hrs.,pennystocks,RKT,86,0,86,-86,1,27,28,1,NYSE
4714,13-02-2021 08:00,24 hrs.,pennystocks,RSI,278,0,278,-278,1,122,30,1,NYSE
4714,13-02-2021 08:00,24 hrs.,pennystocks,SOS,57,12,45,-33,5,9,19,5,NYSE
4714,13-02-2021 08:00,24 hrs.,pennystocks,AIM,8,0,8,-8,1,1,2,1,AMEX
4714,13-02-2021 08:00,24 hrs.,pennystocks,CTO,20,0,20,-20,1,0,16,1,AMEX
4714,13-02-2021 08:00,24 hrs.,pennystocks,DNN,56,19,37,-18,9,9,2,8,AMEX
4714,13-02-2021 08:00,24 hrs.,pennystocks,DPW,6,6,0,6,1,1,0,1,AMEX
4714,13-02-2021 08:00,24 hrs.,pennystocks,DSS,32,0,32,-32,1,10,8,1,AMEX
4714,13-02-2021 08:00,24 hrs.,pennystocks,GSV,7,7,0,7,1,1,1,1,AMEX
4714,13-02-2021 08:00,24 hrs.,pennystocks,GTE,18,12,6,6,3,3,0,3,AMEX
4714,13-02-2021 08:00,24 hrs.,pennystocks,ITP,12,0,12,-12,1,0,8,1,AMEX
4714,13-02-2021 08:00,24 hrs.,pennystocks,MCF,6,0,6,-6,1,1,0,1,AMEX
4714,13-02-2021 08:00,24 hrs.,pennystocks,MXC,7,0,7,-7,1,1,1,1,AMEX
4714,13-02-2021 08:00,24 hrs.,pennystocks,NAK,33,0,33,-33,1,7,15,1,AMEX
4714,13-02-2021 08:00,24 hrs.,pennystocks,NBY,45,45,0,45,1,13,15,1,AMEX
4714,13-02-2021 08:00,24 hrs.,pennystocks,NOVN,6,0,6,-6,1,1,0,1,NASDAQ
4714,13-02-2021 08:00,24 hrs.,pennystocks,NVCN,61,12,49,-37,3,18,13,2,NASDAQ
4714,13-02-2021 08:00,24 hrs.,pennystocks,OCGN,68,6,62,-56,4,17,18,4,NASDAQ
4714,13-02-2021 08:00,24 hrs.,pennystocks,ONTX,6,0,6,-6,1,1,0,1,NASDAQ
4714,13-02-2021 08:00,24 hrs.,pennystocks,OPTT,26,0,26,-26,1,9,4,1,NASDAQ
4714,13-02-2021 08:00,24 hrs.,pennystocks,OTIC,10,0,10,-10,1,1,4,1,NASDAQ
4714,13-02-2021 08:00,24 hrs.,pennystocks,PLAY,6,6,0,6,1,1,0,1,NASDAQ
4714,13-02-2021 08:00,24 hrs.,pennystocks,PLUG,19,0,19,-19,1,7,1,1,NASDAQ
4714,13-02-2021 08:00,24 hrs.,pennystocks,PSTV,6,0,6,-6,1,1,0,1,NASDAQ
4714,13-02-2021 08:00,24 hrs.,pennystocks,PTON,25,25,0,25,1,9,3,1,NASDAQ
4714,13-02-2021 08:00,24 hrs.,pennystocks,PULM,194,51,143,-92,4,38,102,4,NASDAQ
4714,13-02-2021 08:00,24 hrs.,pennystocks,RIBT,13,13,0,13,2,2,1,1,NASDAQ
4714,13-02-2021 08:00,24 hrs.,pennystocks,RIDE,6,6,0,6,1,1,0,1,NASDAQ
4714,13-02-2021 08:00,24 hrs.,pennystocks,SEAC,12,0,12,-12,1,2,4,1,NASDAQ
4714,13-02-2021 08:00,24 hrs.,pennystocks,SELB,20,0,20,-20,1,6,4,1,NASDAQ
4714,13-02-2021 08:00,24 hrs.,pennystocks,SESN,71,71,0,71,1,31,5,1,NASDAQ
4714,13-02-2021 08:00,24 hrs.,pennystocks,SFET,33,27,6,21,2,6,13,2,NASDAQ
4714,13-02-2021 08:00,24 hrs.,pennystocks,SHIP,20,0,20,-20,3,3,2,2,NASDAQ
4714,13-02-2021 08:00,24 hrs.,pennystocks,SNDL,118,32,86,-54,19,19,4,15,NASDAQ
4714,13-02-2021 08:00,24 hrs.,pennystocks,SNGX,2028,89,1939,-1850,17,790,380,9,NASDAQ
4714,13-02-2021 08:00,24 hrs.,pennystocks,SOLO,19,0,19,-19,1,7,1,1,NASDAQ
4714,13-02-2021 08:00,24 hrs.,pennystocks,SRGA,6,0,6,-6,1,1,0,1,NASDAQ
4714,13-02-2021 08:00,24 hrs.,pennystocks,STCN,6,0,6,-6,1,1,0,1,NASDAQ
4714,13-02-2021 08:00,24 hrs.,pennystocks,TBLT,200,194,6,188,2,73,46,2,NASDAQ
4714,13-02-2021 08:00,24 hrs.,pennystocks,TLRY,7,0,7,-7,1,1,1,1,NASDAQ
4714,13-02-2021 08:00,24 hrs.,pennystocks,TNXP,209,124,85,39,9,61,51,5,NASDAQ
4714,13-02-2021 08:00,24 hrs.,pennystocks,TRCH,257,257,0,257,5,85,67,5,NASDAQ
4714,13-02-2021 08:00,24 hrs.,pennystocks,TRVG,19,0,19,-19,3,3,1,2,NASDAQ
4714,13-02-2021 08:00,24 hrs.,pennystocks,TSLA,6,0,6,-6,1,1,0,1,NASDAQ
4714,13-02-2021 08:00,24 hrs.,pennystocks,GALT,7,0,7,-7,1,1,1,1,NASDAQ
4714,13-02-2021 08:00,24 hrs.,pennystocks,GEVO,6,6,0,6,1,1,0,1,NASDAQ
4714,13-02-2021 08:00,24 hrs.,pennystocks,SUM,278,0,278,-278,1,122,30,1,NYSE
4714,13-02-2021 08:00,24 hrs.,pennystocks,TSM,39,0,39,-39,1,10,15,1,NYSE
4714,13-02-2021 08:00,24 hrs.,pennystocks,VET,7,7,0,7,1,1,1,1,NYSE
4714,13-02-2021 08:00,24 hrs.,pennystocks,WEI,19,0,19,-19,1,7,1,1,NYSE
4714,13-02-2021 08:00,24 hrs.,pennystocks,WLL,6,0,6,-6,1,1,0,1,NYSE
4714,13-02-2021 08:00,24 hrs.,pennystocks,ARGO,40,0,40,-40,1,5,26,1,NYSE
4714,13-02-2021 08:00,24 hrs.,pennystocks,CCIV,7,7,0,7,1,1,1,1,NYSE
4714,13-02-2021 08:00,24 hrs.,pennystocks,DASH,20,20,0,20,1,5,6,1,NYSE
4714,13-02-2021 08:00,24 hrs.,pennystocks,FINV,14,0,14,-14,1,3,4,1,NYSE
4714,13-02-2021 08:00,24 hrs.,pennystocks,HEXO,21,0,21,-21,1,1,15,1,NYSE
4714,13-02-2021 08:00,24 hrs.,pennystocks,PUMP,13,13,0,13,2,2,1,1,NYSE
4714,13-02-2021 08:00,24 hrs.,pennystocks,SHOP,12,12,0,12,2,2,0,1,NYSE
4714,13-02-2021 08:00,24 hrs.,pennystocks,SPCE,25,25,0,25,1,9,3,1,NYSE
4714,13-02-2021 08:00,24 hrs.,pennystocks,VIST,12,0,12,-12,1,2,4,1,NYSE
4714,13-02-2021 08:00,24 hrs.,pennystocks,WELL,1677,0,1677,-1677,1,710,253,1,NYSE
4714,13-02-2021 08:00,24 hrs.,pennystocks,FWP,10,0,10,-10,1,0,6,1,NASDAQ
4714,13-02-2021 08:00,24 hrs.,pennystocks,GBT,6,6,0,6,1,1,0,1,NASDAQ
4714,13-02-2021 08:00,24 hrs.,pennystocks,KOD,6,0,6,-6,1,1,0,1,NASDAQ
4714,13-02-2021 08:00,24 hrs.,pennystocks,MKD,29,0,29,-29,1,9,7,1,NASDAQ
4714,13-02-2021 08:00,24 hrs.,pennystocks,MYT,11,0,11,-11,1,1,5,1,NASDAQ
4714,13-02-2021 08:00,24 hrs.,pennystocks,OGI,21,21,0,21,1,7,3,1,NASDAQ
4714,13-02-2021 08:00,24 hrs.,pennystocks,SND,36,36,0,36,1,9,14,1,NASDAQ
4714,13-02-2021 08:00,24 hrs.,pennystocks,SPI,13,13,0,13,1,3,3,1,NASDAQ
4714,13-02-2021 08:00,24 hrs.,pennystocks,ABEO,7,0,7,-7,1,1,1,1,NASDAQ
4714,13-02-2021 08:00,24 hrs.,pennystocks,ACST,6,0,6,-6,1,1,0,1,NASDAQ
4714,13-02-2021 08:00,24 hrs.,pennystocks,AGEN,10,0,10,-10,1,3,0,1,NASDAQ
4714,13-02-2021 08:00,24 hrs.,pennystocks,AGTC,14,0,14,-14,2,2,2,2,NASDAQ
4714,13-02-2021 08:00,24 hrs.,pennystocks,AIKI,6,6,0,6,1,1,0,1,NASDAQ
4714,13-02-2021 08:00,24 hrs.,pennystocks,AMTX,79,0,79,-79,1,28,19,1,NASDAQ
4714,13-02-2021 08:00,24 hrs.,pennystocks,APHA,74,0,74,-74,3,24,14,3,NASDAQ
4714,13-02-2021 08:00,24 hrs.,pennystocks,APRE,6,6,0,6,1,1,0,1,NASDAQ
4714,13-02-2021 08:00,24 hrs.,pennystocks,ARTL,53,0,53,-53,5,13,7,3,NASDAQ
4714,13-02-2021 08:00,24 hrs.,pennystocks,ASRT,1945,0,1945,-1945,14,760,369,8,NASDAQ
4714,13-02-2021 08:00,24 hrs.,wallstreetbets,FTEG,14,7,7,0,2,2,2,2,OTC
4714,13-02-2021 08:00,24 hrs.,wallstreetbets,FTPM,7,0,7,-7,1,1,1,1,OTC
4714,13-02-2021 08:00,24 hrs.,wallstreetbets,GAHC,14,14,0,14,2,2,2,1,OTC
4714,13-02-2021 08:00,24 hrs.,wallstreetbets,GARB,7,0,7,-7,1,1,1,1,OTC
4714,13-02-2021 08:00,24 hrs.,wallstreetbets,GBTC,5938,0,5938,-5938,3,2791,344,2,OTC
4714,13-02-2021 08:00,24 hrs.,wallstreetbets,GMEV,14,0,14,-14,2,2,2,2,OTC
4714,13-02-2021 08:00,24 hrs.,wallstreetbets,GMSC,14,0,14,-14,2,2,2,1,OTC
4714,13-02-2021 08:00,24 hrs.,pennystocks,TXMD,13,6,7,-1,2,2,1,2,NASDAQ
4714,13-02-2021 08:00,24 hrs.,pennystocks,TYME,20,0,20,-20,1,6,4,1,NASDAQ
4714,13-02-2021 08:00,24 hrs.,pennystocks,VEON,7,0,7,-7,1,1,1,1,NASDAQ
4714,13-02-2021 08:00,24 hrs.,pennystocks,VETS,1677,0,1677,-1677,1,710,253,1,NASDAQ
4714,13-02-2021 08:00,24 hrs.,pennystocks,VTGN,7,7,0,7,1,1,1,1,NASDAQ
4714,13-02-2021 08:00,24 hrs.,pennystocks,VUZI,5,5,0,5,1,0,1,1,NASDAQ
4714,13-02-2021 08:00,24 hrs.,pennystocks,XELA,200,0,200,-200,1,89,18,1,NASDAQ
4714,13-02-2021 08:00,24 hrs.,pennystocks,XSPA,32,0,32,-32,1,12,4,1,NASDAQ
4714,13-02-2021 08:00,24 hrs.,pennystocks,ZSAN,92,0,92,-92,2,28,28,2,NASDAQ
4714,13-02-2021 08:00,24 hrs.,wallstreetbets,ABML,20,0,20,-20,3,3,2,3,OTC
4714,13-02-2021 08:00,24 hrs.,wallstreetbets,ABQQ,7,0,7,-7,1,1,1,1,OTC
4714,13-02-2021 08:00,24 hrs.,wallstreetbets,ACRL,6,0,6,-6,1,1,0,1,OTC
4714,13-02-2021 08:00,24 hrs.,wallstreetbets,ACTX,8,8,0,8,1,1,2,1,OTC
4714,13-02-2021 08:00,24 hrs.,wallstreetbets,AITX,23,23,0,23,2,1,13,2,OTC
4714,13-02-2021 08:00,24 hrs.,wallstreetbets,ALPP,14,0,14,-14,2,2,2,2,OTC
4714,13-02-2021 08:00,24 hrs.,wallstreetbets,ALYI,7,0,7,-7,1,1,1,1,OTC
4714,13-02-2021 08:00,24 hrs.,wallstreetbets,AMNE,13,0,13,-13,2,2,1,1,OTC
4714,13-02-2021 08:00,24 hrs.,wallstreetbets,APCX,7,0,7,-7,1,1,1,1,OTC
4714,13-02-2021 08:00,24 hrs.,wallstreetbets,ASTI,7,7,0,7,1,1,1,1,OTC
4714,13-02-2021 08:00,24 hrs.,wallstreetbets,BANT,13,7,6,1,2,2,1,2,OTC
4714,13-02-2021 08:00,24 hrs.,wallstreetbets,BBRW,14,14,0,14,2,2,2,1,OTC
4714,13-02-2021 08:00,24 hrs.,wallstreetbets,BIEL,12,0,12,-12,2,2,0,2,OTC
4714,13-02-2021 08:00,24 hrs.,wallstreetbets,BLSP,28,7,21,-14,4,4,4,2,OTC
4714,13-02-2021 08:00,24 hrs.,wallstreetbets,BMIX,11,0,11,-11,1,1,5,1,OTC
4714,13-02-2021 08:00,24 hrs.,wallstreetbets,BOTH,7,0,7,-7,1,1,1,1,OTC
4714,13-02-2021 08:00,24 hrs.,wallstreetbets,BOTY,6,0,6,-6,1,1,0,1,OTC
4714,13-02-2021 08:00,24 hrs.,wallstreetbets,BRLL,7,0,7,-7,1,1,1,1,OTC
4714,13-02-2021 08:00,24 hrs.,pennystocks,GHSI,91,0,91,-91,1,42,3,1,NASDAQ
4714,13-02-2021 08:00,24 hrs.,pennystocks,GLBS,27,27,0,27,1,0,23,1,NASDAQ
4714,13-02-2021 08:00,24 hrs.,pennystocks,GNPX,5,5,0,5,1,0,1,1,NASDAQ
4714,13-02-2021 08:00,24 hrs.,pennystocks,GNUS,6,6,0,6,1,1,0,1,NASDAQ
4714,13-02-2021 08:00,24 hrs.,pennystocks,GOEV,93,0,93,-93,2,28,29,2,NASDAQ
4714,13-02-2021 08:00,24 hrs.,pennystocks,GOOG,7,7,0,7,1,0,3,1,NASDAQ
4714,13-02-2021 08:00,24 hrs.,pennystocks,HRTX,15,0,15,-15,1,2,7,1,NASDAQ
4714,13-02-2021 08:00,24 hrs.,pennystocks,HSTO,12,0,12,-12,2,2,0,2,NASDAQ
4714,13-02-2021 08:00,24 hrs.,pennystocks,IBKR,7,7,0,7,1,1,1,1,NASDAQ
4714,13-02-2021 08:00,24 hrs.,pennystocks,IDEX,5,5,0,5,1,0,1,1,NASDAQ
4714,13-02-2021 08:00,24 hrs.,pennystocks,INFI,12,0,12,-12,1,1,6,1,NASDAQ
4714,13-02-2021 08:00,24 hrs.,pennystocks,INOD,71,0,71,-71,1,12,43,1,NASDAQ
4714,13-02-2021 08:00,24 hrs.,pennystocks,INPX,6,6,0,6,1,1,0,1,NASDAQ
4714,13-02-2021 08:00,24 hrs.,pennystocks,IRDM,19,0,19,-19,1,7,1,1,NASDAQ
4714,13-02-2021 08:00,24 hrs.,pennystocks,IZEA,6,0,6,-6,1,1,0,1,NASDAQ
4714,13-02-2021 08:00,24 hrs.,pennystocks,KTRA,117,0,117,-117,4,29,43,4,NASDAQ
4714,13-02-2021 08:00,24 hrs.,pennystocks,KXIN,19,0,19,-19,1,7,1,1,NASDAQ
4714,13-02-2021 08:00,24 hrs.,pennystocks,LIFE,6,6,0,6,1,1,0,1,NASDAQ
4714,13-02-2021 08:00,24 hrs.,pennystocks,LKCO,9,0,9,-9,1,2,1,1,NASDAQ
4714,13-02-2021 08:00,24 hrs.,pennystocks,LLIT,7,7,0,7,1,1,1,1,NASDAQ
4714,13-02-2021 08:00,24 hrs.,pennystocks,LPTH,72,0,72,-72,1,28,12,1,NASDAQ
4714,13-02-2021 08:00,24 hrs.,pennystocks,LPTX,36,36,0,36,1,9,14,1,NASDAQ
4714,13-02-2021 08:00,24 hrs.,pennystocks,MARK,6,6,0,6,1,1,0,1,NASDAQ
4714,13-02-2021 08:00,24 hrs.,pennystocks,MOGO,28,28,0,28,1,9,6,1,NASDAQ
4714,13-02-2021 08:00,24 hrs.,pennystocks,MVIS,14,14,0,14,1,0,10,1,NASDAQ
4714,13-02-2021 08:00,24 hrs.,pennystocks,NAKD,1083,1043,40,1003,3,462,147,3,NASDAQ
4714,13-02-2021 08:00,24 hrs.,pennystocks,NAOV,6,0,6,-6,1,1,0,1,NASDAQ
4714,13-02-2021 08:00,24 hrs.,pennystocks,NCMI,17,0,17,-17,1,5,3,1,NASDAQ
4714,13-02-2021 08:00,24 hrs.,pennystocks,NDAQ,19,0,19,-19,1,7,1,1,NASDAQ
4714,13-02-2021 08:00,24 hrs.,pennystocks,NMTR,6,6,0,6,1,1,0,1,NASDAQ
4714,13-02-2021 08:00,24 hrs.,wallstreetbets,HTRE,7,7,0,7,1,1,1,1,OTC
4714,13-02-2021 08:00,24 hrs.,wallstreetbets,HYSR,20,13,7,6,3,3,2,3,OTC
4714,13-02-2021 08:00,24 hrs.,wallstreetbets,ICBU,7,0,7,-7,1,1,1,1,OTC
4714,13-02-2021 08:00,24 hrs.,wallstreetbets,INCT,21,0,21,-21,3,3,3,2,OTC
4714,13-02-2021 08:00,24 hrs.,wallstreetbets,INKW,7,0,7,-7,1,1,1,1,OTC
4714,13-02-2021 08:00,24 hrs.,wallstreetbets,INND,14,0,14,-14,2,2,2,1,OTC
4714,13-02-2021 08:00,24 hrs.,wallstreetbets,INTV,28,7,21,-14,4,4,4,3,OTC
4714,13-02-2021 08:00,24 hrs.,wallstreetbets,IPIX,10,0,10,-10,1,3,0,1,OTC
4714,13-02-2021 08:00,24 hrs.,wallstreetbets,IQST,13,0,13,-13,2,2,1,1,OTC
4714,13-02-2021 08:00,24 hrs.,wallstreetbets,ITCJ,6,0,6,-6,1,1,0,1,OTC
4714,13-02-2021 08:00,24 hrs.,wallstreetbets,KALY,7,0,7,-7,1,1,1,1,OTC
4714,13-02-2021 08:00,24 hrs.,wallstreetbets,KWBT,7,0,7,-7,1,1,1,1,OTC
4714,13-02-2021 08:00,24 hrs.,wallstreetbets,KYNC,7,0,7,-7,1,1,1,1,OTC
4714,13-02-2021 08:00,24 hrs.,wallstreetbets,LBCC,7,0,7,-7,1,1,1,1,OTC
4714,13-02-2021 08:00,24 hrs.,wallstreetbets,LINK,463,7,456,-449,5,183,77,5,OTC
4714,13-02-2021 08:00,24 hrs.,wallstreetbets,LITH,7,0,7,-7,1,1,1,1,OTC
4714,13-02-2021 08:00,24 hrs.,wallstreetbets,LQMT,7,7,0,7,1,1,1,1,OTC
4714,13-02-2021 08:00,24 hrs.,wallstreetbets,LRDG,14,14,0,14,2,2,2,1,OTC
4714,13-02-2021 08:00,24 hrs.,wallstreetbets,LTNC,14,0,14,-14,2,2,2,2,OTC
4714,13-02-2021 08:00,24 hrs.,wallstreetbets,LTUM,6,0,6,-6,1,1,0,1,OTC
4714,13-02-2021 08:00,24 hrs.,wallstreetbets,MAXD,22,7,15,-8,3,3,4,3,OTC
4714,13-02-2021 08:00,24 hrs.,wallstreetbets,MCOA,20,0,20,-20,3,3,2,3,OTC
4714,13-02-2021 08:00,24 hrs.,wallstreetbets,MEDH,7,0,7,-7,1,1,1,1,OTC
4714,13-02-2021 08:00,24 hrs.,wallstreetbets,MGNT,7,0,7,-7,1,1,1,1,OTC
4714,13-02-2021 08:00,24 hrs.,wallstreetbets,MGTI,7,0,7,-7,1,1,1,1,OTC
4714,13-02-2021 08:00,24 hrs.,wallstreetbets,MINE,48,13,35,-22,7,7,6,4,OTC
4714,13-02-2021 08:00,24 hrs.,wallstreetbets,MJNA,34,7,27,-20,5,5,4,5,OTC
4714,13-02-2021 08:00,24 hrs.,wallstreetbets,MKTY,21,7,14,-7,3,3,3,2,OTC
4714,13-02-2021 08:00,24 hrs.,wallstreetbets,MNGG,6,6,0,6,1,1,0,1,OTC
4714,13-02-2021 08:00,24 hrs.,wallstreetbets,MOJO,13,6,7,-1,2,2,1,2,OTC
4714,13-02-2021 08:00,24 hrs.,wallstreetbets,MOST,49,6,43,-37,4,14,5,4,OTC
4714,13-02-2021 08:00,24 hrs.,wallstreetbets,NBVG,6,0,6,-6,1,1,0,1,OTC
4714,13-02-2021 08:00,24 hrs.,wallstreetbets,NEOM,28,14,14,0,4,4,4,2,OTC
4714,13-02-2021 08:00,24 hrs.,wallstreetbets,NOVC,34,0,34,-34,5,5,4,3,OTC
4714,13-02-2021 08:00,24 hrs.,wallstreetbets,NPHC,7,0,7,-7,1,1,1,1,OTC
4714,13-02-2021 08:00,24 hrs.,wallstreetbets,NWPN,6,0,6,-6,1,1,0,1,OTC
4714,13-02-2021 08:00,24 hrs.,wallstreetbets,ONPH,6,0,6,-6,1,1,0,1,OTC
4714,13-02-2021 08:00,24 hrs.,wallstreetbets,OTTV,14,0,14,-14,2,2,2,1,OTC
4714,13-02-2021 08:00,24 hrs.,wallstreetbets,OWPC,6,0,6,-6,1,1,0,1,OTC
4714,13-02-2021 08:00,24 hrs.,wallstreetbets,OZSC,14,7,7,0,2,2,2,2,OTC
4714,13-02-2021 08:00,24 hrs.,wallstreetbets,BTCS,21,0,21,-21,3,3,3,1,OTC
4714,13-02-2021 08:00,24 hrs.,wallstreetbets,BTSC,7,0,7,-7,1,1,1,1,OTC
4714,13-02-2021 08:00,24 hrs.,wallstreetbets,BTZI,13,0,13,-13,2,2,1,2,OTC
4714,13-02-2021 08:00,24 hrs.,wallstreetbets,BUDZ,6,0,6,-6,1,1,0,1,OTC
4714,13-02-2021 08:00,24 hrs.,wallstreetbets,CBDD,7,0,7,-7,1,1,1,1,OTC
4714,13-02-2021 08:00,24 hrs.,wallstreetbets,CBDL,55,14,41,-27,8,8,7,5,OTC
4714,13-02-2021 08:00,24 hrs.,wallstreetbets,CCTC,7,0,7,-7,1,1,1,1,OTC
4714,13-02-2021 08:00,24 hrs.,wallstreetbets,CGLD,7,0,7,-7,1,1,1,1,OTC
4714,13-02-2021 08:00,24 hrs.,wallstreetbets,CHUC,7,0,7,-7,1,1,1,1,OTC
4714,13-02-2021 08:00,24 hrs.,wallstreetbets,CLIS,14,14,0,14,2,2,2,1,OTC
4714,13-02-2021 08:00,24 hrs.,wallstreetbets,CLWD,7,0,7,-7,1,1,1,1,OTC
4714,13-02-2021 08:00,24 hrs.,wallstreetbets,COMS,19,13,6,7,3,3,1,3,OTC
4714,13-02-2021 08:00,24 hrs.,wallstreetbets,CYDY,7,0,7,-7,1,1,1,1,OTC
4714,13-02-2021 08:00,24 hrs.,wallstreetbets,CYLC,7,0,7,-7,1,1,1,1,OTC
4714,13-02-2021 08:00,24 hrs.,wallstreetbets,DGWR,7,0,7,-7,1,1,1,1,OTC
4714,13-02-2021 08:00,24 hrs.,wallstreetbets,DPLS,13,0,13,-13,2,2,1,2,OTC
4714,13-02-2021 08:00,24 hrs.,wallstreetbets,DPWW,7,0,7,-7,1,1,1,1,OTC
4714,13-02-2021 08:00,24 hrs.,wallstreetbets,ELCR,28,0,28,-28,4,4,4,2,OTC
4714,13-02-2021 08:00,24 hrs.,wallstreetbets,ELTP,31,7,24,-17,4,4,7,4,OTC
4714,13-02-2021 08:00,24 hrs.,wallstreetbets,ENZN,7,0,7,-7,1,1,1,1,OTC
4714,13-02-2021 08:00,24 hrs.,wallstreetbets,EPOR,8,8,0,8,1,1,2,1,OTC
4714,13-02-2021 08:00,24 hrs.,wallstreetbets,ETFM,17,17,0,17,2,2,5,1,OTC
4714,13-02-2021 08:00,24 hrs.,wallstreetbets,EWKS,6,0,6,-6,1,1,0,1,OTC
4714,13-02-2021 08:00,24 hrs.,wallstreetbets,FNMA,7,7,0,7,1,1,1,1,OTC
4714,13-02-2021 08:00,24 hrs.,wallstreetbets,USDC,21,13,8,5,3,3,3,3,OTC
4714,13-02-2021 08:00,24 hrs.,wallstreetbets,USMJ,13,0,13,-13,2,2,1,2,OTC
4714,13-02-2021 08:00,24 hrs.,wallstreetbets,USPS,6,6,0,6,1,1,0,1,OTC
4714,13-02-2021 08:00,24 hrs.,wallstreetbets,UVSE,7,0,7,-7,1,1,1,1,OTC
4714,13-02-2021 08:00,24 hrs.,wallstreetbets,VTLR,7,0,7,-7,1,1,1,1,OTC
4714,13-02-2021 08:00,24 hrs.,wallstreetbets,VYST,6,6,0,6,1,1,0,1,OTC
4714,13-02-2021 08:00,24 hrs.,wallstreetbets,WDDD,7,0,7,-7,1,1,1,1,OTC
4714,13-02-2021 08:00,24 hrs.,wallstreetbets,WDLF,7,0,7,-7,1,1,1,1,OTC
4714,13-02-2021 08:00,24 hrs.,wallstreetbets,WHEN,26,7,19,-12,4,4,2,4,OTC
4714,13-02-2021 08:00,24 hrs.,wallstreetbets,WSSE,7,0,7,-7,1,1,1,1,OTC
4714,13-02-2021 08:00,24 hrs.,wallstreetbets,YRIV,19,0,19,-19,1,3,9,1,OTC
4714,13-02-2021 08:00,24 hrs.,wallstreetbets,ZMRK,7,0,7,-7,1,1,1,1,OTC
4714,13-02-2021 08:00,24 hrs.,wallstreetbets,ZNOG,7,0,7,-7,1,1,1,1,OTC
4714,13-02-2021 08:00,24 hrs.,wallstreetbets,AGUNF,6,6,0,6,1,1,0,1,OTC
4714,13-02-2021 08:00,24 hrs.,wallstreetbets,AMYZF,23,0,23,-23,3,3,5,2,OTC
4714,13-02-2021 08:00,24 hrs.,wallstreetbets,ARBKF,6,0,6,-6,1,1,0,1,OTC
4714,13-02-2021 08:00,24 hrs.,wallstreetbets,ATURF,7,0,7,-7,1,1,1,1,OTC
4714,13-02-2021 08:00,24 hrs.,wallstreetbets,AZKLF,18,0,18,-18,3,3,0,1,OTC
4714,13-02-2021 08:00,24 hrs.,wallstreetbets,BBKCF,6,6,0,6,1,1,0,1,OTC
4714,13-02-2021 08:00,24 hrs.,wallstreetbets,BDRBF,14,0,14,-14,2,2,2,2,OTC
4714,13-02-2021 08:00,24 hrs.,wallstreetbets,CLXPF,7,0,7,-7,1,1,1,1,OTC
4714,13-02-2021 08:00,24 hrs.,wallstreetbets,CNPOF,7,7,0,7,1,1,1,1,OTC
4714,13-02-2021 08:00,24 hrs.,wallstreetbets,CRLBF,18,6,12,-6,3,3,0,3,OTC
4714,13-02-2021 08:00,24 hrs.,wallstreetbets,CTTAY,29,29,0,29,1,8,9,1,OTC
4714,13-02-2021 08:00,24 hrs.,wallstreetbets,CURLF,6,6,0,6,1,1,0,1,OTC
4714,13-02-2021 08:00,24 hrs.,wallstreetbets,DIAAF,7,0,7,-7,1,1,1,1,OTC
4714,13-02-2021 08:00,24 hrs.,wallstreetbets,EPWCF,7,7,0,7,1,1,1,1,OTC
4714,13-02-2021 08:00,24 hrs.,wallstreetbets,FDVRF,6,0,6,-6,1,1,0,1,OTC
4714,13-02-2021 08:00,24 hrs.,wallstreetbets,FUNFF,7,7,0,7,1,1,1,1,OTC
4714,13-02-2021 08:00,24 hrs.,wallstreetbets,GAYMF,6,0,6,-6,1,1,0,1,OTC
4714,13-02-2021 08:00,24 hrs.,wallstreetbets,GGTTF,7,0,7,-7,1,1,1,1,OTC
4714,13-02-2021 08:00,24 hrs.,wallstreetbets,GTBIF,13,13,0,13,2,2,1,2,OTC
4714,13-02-2021 08:00,24 hrs.,wallstreetbets,HITIF,55,48,7,41,4,11,17,3,OTC
4714,13-02-2021 08:00,24 hrs.,wallstreetbets,HRSTW,11,0,11,-11,2,1,1,1,OTC
4714,13-02-2021 08:00,24 hrs.,wallstreetbets,HTZGQ,7,7,0,7,1,1,1,1,OTC
4714,13-02-2021 08:00,24 hrs.,wallstreetbets,HUTMF,13,0,13,-13,2,2,1,2,OTC
4714,13-02-2021 08:00,24 hrs.,wallstreetbets,HVBTF,22,0,22,-22,3,3,4,3,OTC
4714,13-02-2021 08:00,24 hrs.,wallstreetbets,IGCIW,49,0,49,-49,7,7,7,2,OTC
4714,13-02-2021 08:00,24 hrs.,wallstreetbets,ISCNF,14,0,14,-14,2,2,2,2,OTC
4714,13-02-2021 08:00,24 hrs.,wallstreetbets,ITHUF,7,0,7,-7,1,1,1,1,OTC
4714,13-02-2021 08:00,24 hrs.,wallstreetbets,KBEVF,7,0,7,-7,1,1,1,1,OTC
4714,13-02-2021 08:00,24 hrs.,wallstreetbets,LHSIF,7,0,7,-7,1,1,1,1,OTC
4714,13-02-2021 08:00,24 hrs.,wallstreetbets,LKNCY,231,225,6,219,3,11,197,3,OTC
4714,13-02-2021 08:00,24 hrs.,wallstreetbets,PAOG,7,0,7,-7,1,1,1,1,OTC
4714,13-02-2021 08:00,24 hrs.,wallstreetbets,PHBI,14,0,14,-14,2,2,2,1,OTC
4714,13-02-2021 08:00,24 hrs.,wallstreetbets,QOIL,6,0,6,-6,1,1,0,1,OTC
4714,13-02-2021 08:00,24 hrs.,wallstreetbets,RBDC,7,0,7,-7,1,1,1,1,OTC
4714,13-02-2021 08:00,24 hrs.,wallstreetbets,RBNW,6,0,6,-6,1,1,0,1,OTC
4714,13-02-2021 08:00,24 hrs.,wallstreetbets,REFG,7,0,7,-7,1,1,1,1,OTC
4714,13-02-2021 08:00,24 hrs.,wallstreetbets,GPFT,27,7,20,-13,4,4,3,4,OTC
4714,13-02-2021 08:00,24 hrs.,wallstreetbets,GRNH,7,7,0,7,1,1,1,1,OTC
4714,13-02-2021 08:00,24 hrs.,wallstreetbets,GTCH,7,7,0,7,1,1,1,1,OTC
4714,13-02-2021 08:00,24 hrs.,wallstreetbets,GTEH,20,20,0,20,3,3,2,2,OTC
4714,13-02-2021 08:00,24 hrs.,wallstreetbets,GTLL,12,6,6,0,2,2,0,2,OTC
4714,13-02-2021 08:00,24 hrs.,wallstreetbets,GTXO,14,0,14,-14,2,2,2,1,OTC
4714,13-02-2021 08:00,24 hrs.,wallstreetbets,HCMC,313,96,217,-121,46,46,37,41,OTC
4714,13-02-2021 08:00,24 hrs.,wallstreetbets,HEMP,27,13,14,-1,4,4,3,3,OTC
4714,13-02-2021 08:00,24 hrs.,wallstreetbets,HGLC,14,14,0,14,2,2,2,1,OTC
4714,13-02-2021 08:00,24 hrs.,wallstreetbets,HIHI,7,0,7,-7,1,1,1,1,OTC
4714,13-02-2021 08:00,24 hrs.,wallstreetbets,HIPH,7,0,7,-7,1,1,1,1,OTC
4714,13-02-2021 08:00,24 hrs.,wallstreetbets,HMNY,42,14,28,-14,6,6,6,3,OTC
4714,13-02-2021 08:00,24 hrs.,wallstreetbets,HMPQ,7,0,7,-7,1,1,1,1,OTC
4714,13-02-2021 08:00,24 hrs.,wallstreetbets,HQGE,35,7,28,-21,5,5,5,3,OTC
4714,13-02-2021 08:00,24 hrs.,wallstreetbets,HRBR,6,0,6,-6,1,1,0,1,OTC
4714,13-02-2021 08:00,24 hrs.,wallstreetbets,PTN,7,0,7,-7,1,1,1,1,AMEX
4714,13-02-2021 08:00,24 hrs.,wallstreetbets,REI,7,0,7,-7,1,1,1,1,AMEX
4714,13-02-2021 08:00,24 hrs.,wallstreetbets,SYN,14,0,14,-14,2,2,2,1,AMEX
4714,13-02-2021 08:00,24 hrs.,wallstreetbets,TGB,6,0,6,-6,1,1,0,1,AMEX
4714,13-02-2021 08:00,24 hrs.,wallstreetbets,TRX,69,14,55,-41,10,10,9,6,AMEX
4714,13-02-2021 08:00,24 hrs.,wallstreetbets,UUU,6,0,6,-6,1,1,0,1,AMEX
4714,13-02-2021 08:00,24 hrs.,wallstreetbets,ZOM,243,149,94,55,18,62,47,17,AMEX
4714,13-02-2021 08:00,24 hrs.,wallstreetbets,AMPE,41,14,27,-13,6,6,5,4,AMEX
4714,13-02-2021 08:00,24 hrs.,wallstreetbets,CRMD,7,0,7,-7,1,1,1,1,AMEX
4714,13-02-2021 08:00,24 hrs.,wallstreetbets,EMAN,7,0,7,-7,1,1,1,1,AMEX
4714,13-02-2021 08:00,24 hrs.,wallstreetbets,GOED,13,13,0,13,2,2,1,2,AMEX
4714,13-02-2021 08:00,24 hrs.,wallstreetbets,GSAT,40,26,14,12,6,6,4,5,AMEX
4714,13-02-2021 08:00,24 hrs.,wallstreetbets,HUSA,7,0,7,-7,1,1,1,1,AMEX
4714,13-02-2021 08:00,24 hrs.,wallstreetbets,LODE,13,0,13,-13,2,2,1,2,AMEX
4714,13-02-2021 08:00,24 hrs.,wallstreetbets,OGEN,20,6,14,-8,3,3,2,3,AMEX
4714,13-02-2021 08:00,24 hrs.,wallstreetbets,SENS,474,251,223,28,18,124,154,14,AMEX
4714,13-02-2021 08:00,24 hrs.,wallstreetbets,TMBR,48,34,14,20,7,7,6,3,AMEX
4714,13-02-2021 08:00,24 hrs.,wallstreetbets,TRXC,19,0,19,-19,3,3,1,3,AMEX
4714,13-02-2021 08:00,24 hrs.,wallstreetbets,UAVS,21,0,21,-21,3,3,3,2,AMEX
4714,13-02-2021 08:00,24 hrs.,wallstreetbets,UUUU,21,14,7,7,3,3,3,2,AMEX
4714,13-02-2021 08:00,24 hrs.,wallstreetbets,XXII,7,7,0,7,1,1,1,1,AMEX
4714,13-02-2021 08:00,24 hrs.,wallstreetbets,YCBD,14,7,7,0,2,2,2,2,AMEX
4714,13-02-2021 08:00,24 hrs.,wallstreetbets,ABT,13,0,13,-13,2,2,1,2,NYSE
4714,13-02-2021 08:00,24 hrs.,wallstreetbets,ACB,173,70,103,-33,25,25,23,21,NYSE
4714,13-02-2021 08:00,24 hrs.,wallstreetbets,ACI,7,0,7,-7,1,1,1,1,NYSE
4714,13-02-2021 08:00,24 hrs.,wallstreetbets,AEM,8,0,8,-8,1,1,2,1,NYSE
4714,13-02-2021 08:00,24 hrs.,wallstreetbets,AFC,7,7,0,7,1,1,1,1,NYSE
4714,13-02-2021 08:00,24 hrs.,wallstreetbets,MMEDF,3219,0,3219,-3219,5,1339,521,4,OTC
4714,13-02-2021 08:00,24 hrs.,wallstreetbets,MOTNF,7,7,0,7,1,1,1,1,OTC
4714,13-02-2021 08:00,24 hrs.,wallstreetbets,NONOF,7,7,0,7,1,1,1,1,OTC
4714,13-02-2021 08:00,24 hrs.,wallstreetbets,NTDOY,15,0,15,-15,2,2,3,2,OTC
4714,13-02-2021 08:00,24 hrs.,wallstreetbets,NXGWF,13,0,13,-13,2,2,1,1,OTC
4714,13-02-2021 08:00,24 hrs.,wallstreetbets,NXTTF,14,0,14,-14,2,2,2,1,OTC
4714,13-02-2021 08:00,24 hrs.,wallstreetbets,PCLOF,13,13,0,13,2,2,1,1,OTC
4714,13-02-2021 08:00,24 hrs.,wallstreetbets,PDYPF,7,0,7,-7,1,1,1,1,OTC
4714,13-02-2021 08:00,24 hrs.,wallstreetbets,PMNXF,6,0,6,-6,1,1,0,1,OTC
4714,13-02-2021 08:00,24 hrs.,wallstreetbets,RAZFF,7,0,7,-7,1,1,1,1,OTC
4714,13-02-2021 08:00,24 hrs.,wallstreetbets,RLLCF,72,15,57,-42,10,10,12,10,OTC
4714,13-02-2021 08:00,24 hrs.,wallstreetbets,RYCEY,490,23,467,-444,15,128,174,12,OTC
4714,13-02-2021 08:00,24 hrs.,wallstreetbets,SBSAA,7,7,0,7,1,1,1,1,OTC
4714,13-02-2021 08:00,24 hrs.,wallstreetbets,SHRMF,6,6,0,6,1,1,0,1,OTC
4714,13-02-2021 08:00,24 hrs.,wallstreetbets,SPRWF,28,0,28,-28,4,4,4,3,OTC
4714,13-02-2021 08:00,24 hrs.,wallstreetbets,TBUIF,13,13,0,13,2,2,1,1,OTC
4714,13-02-2021 08:00,24 hrs.,wallstreetbets,RELI,6,0,6,-6,1,1,0,1,OTC
4714,13-02-2021 08:00,24 hrs.,wallstreetbets,RSSV,9,0,9,-9,1,2,1,1,OTC
4714,13-02-2021 08:00,24 hrs.,wallstreetbets,RTON,14,6,8,-2,2,2,2,2,OTC
4714,13-02-2021 08:00,24 hrs.,wallstreetbets,SBFM,7,7,0,7,1,1,1,1,OTC
4714,13-02-2021 08:00,24 hrs.,wallstreetbets,SFOR,7,7,0,7,1,1,1,1,OTC
4714,13-02-2021 08:00,24 hrs.,wallstreetbets,SGMD,6,0,6,-6,1,1,0,1,OTC
4714,13-02-2021 08:00,24 hrs.,wallstreetbets,SHMP,14,0,14,-14,2,2,2,2,OTC
4714,13-02-2021 08:00,24 hrs.,wallstreetbets,SHWZ,7,7,0,7,1,1,1,1,OTC
4714,13-02-2021 08:00,24 hrs.,wallstreetbets,SIGN,28,14,14,0,4,4,4,3,OTC
4714,13-02-2021 08:00,24 hrs.,wallstreetbets,SIMP,7,7,0,7,1,1,1,1,OTC
4714,13-02-2021 08:00,24 hrs.,wallstreetbets,SIRR,7,0,7,-7,1,1,1,1,OTC
4714,13-02-2021 08:00,24 hrs.,wallstreetbets,SNDD,7,7,0,7,1,1,1,1,OTC
4714,13-02-2021 08:00,24 hrs.,wallstreetbets,SNRS,7,7,0,7,1,1,1,1,OTC
4714,13-02-2021 08:00,24 hrs.,wallstreetbets,SNYR,14,14,0,14,2,2,2,1,OTC
4714,13-02-2021 08:00,24 hrs.,wallstreetbets,SRMX,13,0,13,-13,2,2,1,2,OTC
4714,13-02-2021 08:00,24 hrs.,wallstreetbets,SUIC,6,0,6,-6,1,1,0,1,OTC
4714,13-02-2021 08:00,24 hrs.,wallstreetbets,TCHH,12,6,6,0,2,2,0,2,OTC
4714,13-02-2021 08:00,24 hrs.,wallstreetbets,TGLO,7,0,7,-7,1,1,1,1,OTC
4714,13-02-2021 08:00,24 hrs.,wallstreetbets,TRTC,21,7,14,-7,3,3,3,2,OTC
4714,13-02-2021 08:00,24 hrs.,wallstreetbets,TSNP,21,7,14,-7,3,3,3,3,OTC
4714,13-02-2021 08:00,24 hrs.,wallstreetbets,UBQU,7,0,7,-7,1,1,1,1,OTC
4714,13-02-2021 08:00,24 hrs.,SPACs,HPX,333,0,333,-333,1,95,139,1,NYSE
4714,13-02-2021 08:00,24 hrs.,SPACs,ICE,46,0,46,-46,1,16,10,1,NYSE
4714,13-02-2021 08:00,24 hrs.,SPACs,IRR,79,0,79,-79,1,24,27,1,NYSE
4714,13-02-2021 08:00,24 hrs.,SPACs,JWS,281,281,0,281,7,26,201,3,NYSE
4714,13-02-2021 08:00,24 hrs.,SPACs,NAV,263,14,249,-235,5,65,113,4,NYSE
4714,13-02-2021 08:00,24 hrs.,SPACs,NGA,110,18,92,-74,5,26,38,4,NYSE
4714,13-02-2021 08:00,24 hrs.,wallstreetbets,AIR,6,0,6,-6,1,1,0,1,NYSE
4714,13-02-2021 08:00,24 hrs.,wallstreetbets,AIV,6,0,6,-6,1,1,0,1,NYSE
4714,13-02-2021 08:00,24 hrs.,wallstreetbets,AMC,6856,1828,5028,-3200,196,2552,968,162,NYSE
4714,13-02-2021 08:00,24 hrs.,wallstreetbets,AMP,29,8,21,-13,4,4,5,4,NYSE
4714,13-02-2021 08:00,24 hrs.,wallstreetbets,ASX,7,0,7,-7,1,1,1,1,NYSE
4714,13-02-2021 08:00,24 hrs.,wallstreetbets,ATH,41,20,21,-1,5,8,5,5,NYSE
4714,13-02-2021 08:00,24 hrs.,wallstreetbets,AUY,127,7,120,-113,9,23,45,5,NYSE
4714,13-02-2021 08:00,24 hrs.,wallstreetbets,AXP,5931,0,5931,-5931,2,2790,343,1,NYSE
4714,13-02-2021 08:00,24 hrs.,wallstreetbets,BBW,6,0,6,-6,1,1,0,1,NYSE
4714,13-02-2021 08:00,24 hrs.,wallstreetbets,BCH,11,4,7,-3,2,1,1,2,NYSE
4714,13-02-2021 08:00,24 hrs.,wallstreetbets,BGS,8,0,8,-8,1,1,2,1,NYSE
4714,13-02-2021 08:00,24 hrs.,wallstreetbets,BHC,444,0,444,-444,2,180,76,2,NYSE
4714,13-02-2021 08:00,24 hrs.,wallstreetbets,BTT,40,28,12,16,6,6,4,6,NYSE
4714,13-02-2021 08:00,24 hrs.,wallstreetbets,BTU,14,0,14,-14,2,2,2,1,NYSE
4714,13-02-2021 08:00,24 hrs.,wallstreetbets,CAT,14,7,7,0,2,2,2,2,NYSE
4714,13-02-2021 08:00,24 hrs.,wallstreetbets,CBD,7,0,7,-7,1,1,1,1,NYSE
4714,13-02-2021 08:00,24 hrs.,wallstreetbets,CCL,20,20,0,20,3,3,2,2,NYSE
4714,13-02-2021 08:00,24 hrs.,wallstreetbets,CMA,6,6,0,6,1,1,0,1,NYSE
4714,13-02-2021 08:00,24 hrs.,wallstreetbets,CMC,15,15,0,15,1,1,9,1,NYSE
4714,13-02-2021 08:00,24 hrs.,wallstreetbets,CPE,7,7,0,7,1,1,1,1,NYSE
4714,13-02-2021 08:00,24 hrs.,wallstreetbets,CPG,7,0,7,-7,1,1,1,1,NYSE
4714,13-02-2021 08:00,24 hrs.,wallstreetbets,CPS,6,6,0,6,1,1,0,1,NYSE
4714,13-02-2021 08:00,24 hrs.,wallstreetbets,CSV,223,223,0,223,1,57,105,1,NYSE
4714,13-02-2021 08:00,24 hrs.,wallstreetbets,CVS,14,14,0,14,2,2,2,2,NYSE
4714,13-02-2021 08:00,24 hrs.,wallstreetbets,DAC,20,0,20,-20,3,3,2,2,NYSE
4714,13-02-2021 08:00,24 hrs.,wallstreetbets,DAL,13,0,13,-13,2,2,1,2,NYSE
4714,13-02-2021 08:00,24 hrs.,wallstreetbets,DAO,12,0,12,-12,2,2,0,1,NYSE
4714,13-02-2021 08:00,24 hrs.,wallstreetbets,DHT,7,0,7,-7,1,1,1,1,NYSE
4714,13-02-2021 08:00,24 hrs.,wallstreetbets,DIS,464,0,464,-464,5,183,78,5,NYSE
4714,13-02-2021 08:00,24 hrs.,wallstreetbets,DTE,167,0,167,-167,1,53,57,1,NYSE
4714,13-02-2021 08:00,24 hrs.,wallstreetbets,DVN,7,0,7,-7,1,1,1,1,NYSE
4714,13-02-2021 08:00,24 hrs.,wallstreetbets,EAT,14,0,14,-14,2,2,2,2,NYSE
4714,13-02-2021 08:00,24 hrs.,wallstreetbets,EPD,47,0,47,-47,2,12,15,1,NYSE
4714,13-02-2021 08:00,24 hrs.,wallstreetbets,ETN,21,14,7,7,3,3,3,3,NYSE
4714,13-02-2021 08:00,24 hrs.,wallstreetbets,EXP,13,7,6,1,2,2,1,2,NYSE
4714,13-02-2021 08:00,24 hrs.,wallstreetbets,TCNNF,5952,0,5952,-5952,5,2793,346,1,OTC
4714,13-02-2021 08:00,24 hrs.,wallstreetbets,TGODF,7,0,7,-7,1,1,1,1,OTC
4714,13-02-2021 08:00,24 hrs.,wallstreetbets,TPPRF,14,0,14,-14,2,2,2,1,OTC
4714,13-02-2021 08:00,24 hrs.,wallstreetbets,TSCRF,54,0,54,-54,3,4,34,2,OTC
4714,13-02-2021 08:00,24 hrs.,wallstreetbets,TXLZF,7,0,7,-7,1,1,1,1,OTC
4714,13-02-2021 08:00,24 hrs.,wallstreetbets,VALPQ,9,9,0,9,1,2,1,1,OTC
4714,13-02-2021 08:00,24 hrs.,wallstreetbets,VVCIF,6,6,0,6,1,1,0,1,OTC
4714,13-02-2021 08:00,24 hrs.,wallstreetbets,VYGVF,6,6,0,6,1,1,0,1,OTC
4714,13-02-2021 08:00,24 hrs.,wallstreetbets,WDDMF,7,0,7,-7,1,1,1,1,OTC
4714,13-02-2021 08:00,24 hrs.,wallstreetbets,ZBISF,7,7,0,7,1,1,1,1,OTC
4714,13-02-2021 08:00,24 hrs.,wallstreetbets,AAU,14,0,14,-14,2,2,2,2,AMEX
4714,13-02-2021 08:00,24 hrs.,wallstreetbets,BTN,15,0,15,-15,2,2,3,1,AMEX
4714,13-02-2021 08:00,24 hrs.,wallstreetbets,DIT,6,0,6,-6,1,1,0,1,AMEX
4714,13-02-2021 08:00,24 hrs.,wallstreetbets,DNN,185,68,117,-49,27,27,23,21,AMEX
4714,13-02-2021 08:00,24 hrs.,wallstreetbets,DPW,14,0,14,-14,2,2,2,2,AMEX
4714,13-02-2021 08:00,24 hrs.,wallstreetbets,GDP,183,0,183,-183,2,53,69,2,AMEX
4714,13-02-2021 08:00,24 hrs.,wallstreetbets,GLU,7,0,7,-7,1,1,1,1,AMEX
4714,13-02-2021 08:00,24 hrs.,wallstreetbets,GTE,73,53,20,33,11,11,7,7,AMEX
4714,13-02-2021 08:00,24 hrs.,wallstreetbets,ITP,7,0,7,-7,1,1,1,1,AMEX
4714,13-02-2021 08:00,24 hrs.,wallstreetbets,MSN,7,0,7,-7,1,1,1,1,AMEX
4714,13-02-2021 08:00,24 hrs.,wallstreetbets,MXC,14,0,14,-14,2,2,2,2,AMEX
4714,13-02-2021 08:00,24 hrs.,wallstreetbets,MYO,7,0,7,-7,1,1,1,1,AMEX
4714,13-02-2021 08:00,24 hrs.,wallstreetbets,NAK,57,13,44,-31,9,9,3,8,AMEX
4714,13-02-2021 08:00,24 hrs.,SPACs,ASPL,333,0,333,-333,1,95,139,1,NYSE
4714,13-02-2021 08:00,24 hrs.,SPACs,ATAC,333,0,333,-333,1,95,139,1,NYSE
4714,13-02-2021 08:00,24 hrs.,SPACs,AVAN,333,0,333,-333,1,95,139,1,NYSE
4714,13-02-2021 08:00,24 hrs.,SPACs,BOAC,428,0,428,-428,2,127,166,2,NYSE
4714,13-02-2021 08:00,24 hrs.,SPACs,CCIV,1494,379,1115,-736,11,419,612,11,NYSE
4714,13-02-2021 08:00,24 hrs.,SPACs,CPSR,333,0,333,-333,1,95,139,1,NYSE
4714,13-02-2021 08:00,24 hrs.,SPACs,CTAC,333,0,333,-333,1,95,139,1,NYSE
4714,13-02-2021 08:00,24 hrs.,SPACs,DFNS,384,0,384,-384,2,115,146,2,NYSE
4714,13-02-2021 08:00,24 hrs.,SPACs,DGNR,385,0,385,-385,1,169,43,1,NYSE
4714,13-02-2021 08:00,24 hrs.,SPACs,DMYD,504,0,504,-504,2,188,120,2,NYSE
4714,13-02-2021 08:00,24 hrs.,SPACs,DNMR,7,7,0,7,1,1,1,1,NYSE
4714,13-02-2021 08:00,24 hrs.,SPACs,EMPW,572,239,333,-94,2,115,334,2,NYSE
4714,13-02-2021 08:00,24 hrs.,SPACs,ENPC,239,239,0,239,1,20,195,1,NYSE
4714,13-02-2021 08:00,24 hrs.,SPACs,FGNA,812,812,0,812,2,280,244,1,NYSE
4714,13-02-2021 08:00,24 hrs.,SPACs,FUSE,2898,952,1946,-994,18,940,946,15,NYSE
4714,13-02-2021 08:00,24 hrs.,SPACs,GLEO,333,0,333,-333,1,95,139,1,NYSE
4714,13-02-2021 08:00,24 hrs.,SPACs,GOAC,333,0,333,-333,1,95,139,1,NYSE
4714,13-02-2021 08:00,24 hrs.,SPACs,GSAH,1187,683,504,179,3,422,331,3,NYSE
4714,13-02-2021 08:00,24 hrs.,SPACs,HIGA,333,0,333,-333,1,95,139,1,NYSE
4714,13-02-2021 08:00,24 hrs.,SPACs,HYLN,18,18,0,18,1,4,6,1,NYSE
4714,13-02-2021 08:00,24 hrs.,SPACs,HZAC,333,0,333,-333,1,95,139,1,NYSE
4714,13-02-2021 08:00,24 hrs.,SPACs,HZON,333,0,333,-333,1,95,139,1,NYSE
4714,13-02-2021 08:00,24 hrs.,SPACs,IMPX,333,0,333,-333,1,95,139,1,NYSE
4714,13-02-2021 08:00,24 hrs.,SPACs,IPOE,683,683,0,683,1,234,211,1,NYSE
4714,13-02-2021 08:00,24 hrs.,SPACs,IPOF,5,5,0,5,1,0,1,1,NYSE
4714,13-02-2021 08:00,24 hrs.,wallstreetbets,FDX,7,0,7,-7,1,1,1,1,NYSE
4714,13-02-2021 08:00,24 hrs.,wallstreetbets,FLT,7,0,7,-7,1,1,1,1,NYSE
4714,13-02-2021 08:00,24 hrs.,wallstreetbets,FMC,13,0,13,-13,2,2,1,1,NYSE
4714,13-02-2021 08:00,24 hrs.,wallstreetbets,FRO,19,13,6,7,3,3,1,2,NYSE
4714,13-02-2021 08:00,24 hrs.,wallstreetbets,FSD,14,0,14,-14,2,2,2,2,NYSE
4714,13-02-2021 08:00,24 hrs.,wallstreetbets,FSR,248,34,214,-180,35,41,26,16,NYSE
4714,13-02-2021 08:00,24 hrs.,wallstreetbets,FTI,20,0,20,-20,3,3,2,1,NYSE
4714,13-02-2021 08:00,24 hrs.,wallstreetbets,GAM,7,0,7,-7,1,1,1,1,NYSE
4714,13-02-2021 08:00,24 hrs.,wallstreetbets,GEO,28,0,28,-28,4,4,4,1,NYSE
4714,13-02-2021 08:00,24 hrs.,wallstreetbets,GLW,7,0,7,-7,1,1,1,1,NYSE
4714,13-02-2021 08:00,24 hrs.,wallstreetbets,GME,159173,30864,128309,-97445,460,72350,12633,341,NYSE
4714,13-02-2021 08:00,24 hrs.,wallstreetbets,GNT,14,14,0,14,2,2,2,1,NYSE
4714,13-02-2021 08:00,24 hrs.,wallstreetbets,HMC,29,29,0,29,1,8,9,1,NYSE
4714,13-02-2021 08:00,24 hrs.,wallstreetbets,HMI,7,0,7,-7,1,1,1,1,NYSE
4714,13-02-2021 08:00,24 hrs.,wallstreetbets,HSY,8,8,0,8,1,1,2,1,NYSE
4714,13-02-2021 08:00,24 hrs.,wallstreetbets,IAG,14,0,14,-14,2,2,2,2,NYSE
4714,13-02-2021 08:00,24 hrs.,wallstreetbets,IBM,8803,12,8791,-8779,7,4080,615,7,NYSE
4714,13-02-2021 08:00,24 hrs.,wallstreetbets,ICE,162,162,0,162,1,48,62,1,NYSE
4714,13-02-2021 08:00,24 hrs.,wallstreetbets,IGT,7,7,0,7,1,1,1,1,NYSE
4714,13-02-2021 08:00,24 hrs.,wallstreetbets,IRS,12,12,0,12,2,2,0,2,NYSE
4714,13-02-2021 08:00,24 hrs.,wallstreetbets,IVR,49,0,49,-49,7,6,9,5,NYSE
4714,13-02-2021 08:00,24 hrs.,SPACs,APEX,33,0,33,-33,1,5,19,1,OTC
4714,13-02-2021 08:00,24 hrs.,SPACs,BRRN,11,11,0,11,1,2,3,1,OTC
4714,13-02-2021 08:00,24 hrs.,SPACs,CIK,68,0,68,-68,1,21,22,1,AMEX
4714,13-02-2021 08:00,24 hrs.,SPACs,NBA,333,0,333,-333,1,95,139,1,AMEX
4714,13-02-2021 08:00,24 hrs.,SPACs,PTK,361,28,333,-305,2,102,149,2,AMEX
4714,13-02-2021 08:00,24 hrs.,SPACs,CHAQ,361,28,333,-305,2,102,149,2,AMEX
4714,13-02-2021 08:00,24 hrs.,SPACs,AIR,142,0,142,-142,1,52,34,1,NYSE
4714,13-02-2021 08:00,24 hrs.,SPACs,BFT,246,246,0,246,2,21,196,2,NYSE
4714,13-02-2021 08:00,24 hrs.,SPACs,BSN,333,0,333,-333,1,95,139,1,NYSE
4714,13-02-2021 08:00,24 hrs.,SPACs,CCX,333,0,333,-333,1,95,139,1,NYSE
4714,13-02-2021 08:00,24 hrs.,SPACs,COO,41,0,41,-41,1,5,27,1,NYSE
4714,13-02-2021 08:00,24 hrs.,SPACs,DEH,333,0,333,-333,1,95,139,1,NYSE
4714,13-02-2021 08:00,24 hrs.,SPACs,DFS,142,0,142,-142,1,52,34,1,NYSE
4714,13-02-2021 08:00,24 hrs.,SPACs,ELY,18,18,0,18,1,6,2,1,NYSE
4714,13-02-2021 08:00,24 hrs.,SPACs,EQD,572,239,333,-94,2,115,334,2,NYSE
4714,13-02-2021 08:00,24 hrs.,SPACs,FSR,24,18,6,12,2,5,6,2,NYSE
4714,13-02-2021 08:00,24 hrs.,SPACs,GIK,30,0,30,-30,4,2,10,2,NYSE
4714,13-02-2021 08:00,24 hrs.,SPACs,GIX,333,0,333,-333,1,95,139,1,NYSE
4714,13-02-2021 08:00,24 hrs.,wallstreetbets,NLY,7,0,7,-7,1,1,1,1,NYSE
4714,13-02-2021 08:00,24 hrs.,wallstreetbets,NMR,7,7,0,7,1,1,1,1,NYSE
4714,13-02-2021 08:00,24 hrs.,wallstreetbets,NOK,3156,204,2952,-2748,24,1280,500,23,NYSE
4714,13-02-2021 08:00,24 hrs.,wallstreetbets,NOV,6,6,0,6,1,1,0,1,NYSE
4714,13-02-2021 08:00,24 hrs.,wallstreetbets,NRG,35,0,35,-35,5,5,5,1,NYSE
4714,13-02-2021 08:00,24 hrs.,wallstreetbets,NUS,7,0,7,-7,1,1,1,1,NYSE
4714,13-02-2021 08:00,24 hrs.,wallstreetbets,NVO,77,77,0,77,2,18,33,2,NYSE
4714,13-02-2021 08:00,24 hrs.,wallstreetbets,NYC,14,7,7,0,2,2,2,2,NYSE
4714,13-02-2021 08:00,24 hrs.,wallstreetbets,OGE,7,0,7,-7,1,1,1,1,NYSE
4714,13-02-2021 08:00,24 hrs.,wallstreetbets,OSK,149,0,149,-149,1,42,61,1,NYSE
4714,13-02-2021 08:00,24 hrs.,wallstreetbets,OVV,5,0,5,-5,1,0,1,1,NYSE
4714,13-02-2021 08:00,24 hrs.,wallstreetbets,PCG,317,172,145,27,2,97,115,2,NYSE
4714,13-02-2021 08:00,24 hrs.,wallstreetbets,PFE,13,0,13,-13,2,2,1,2,NYSE
4714,13-02-2021 08:00,24 hrs.,wallstreetbets,PHT,7,7,0,7,1,1,1,1,NYSE
4714,13-02-2021 08:00,24 hrs.,wallstreetbets,PMO,7,0,7,-7,1,1,1,1,NYSE
4714,13-02-2021 08:00,24 hrs.,wallstreetbets,PSA,2642,2579,63,2516,10,1045,512,8,NYSE
4714,13-02-2021 08:00,24 hrs.,wallstreetbets,PSN,7,7,0,7,1,1,1,1,NYSE
4714,13-02-2021 08:00,24 hrs.,wallstreetbets,PVL,13,0,13,-13,2,2,1,1,NYSE
4714,13-02-2021 08:00,24 hrs.,wallstreetbets,PWR,6,6,0,6,1,1,0,1,NYSE
4714,13-02-2021 08:00,24 hrs.,wallstreetbets,RAD,7,7,0,7,1,1,1,1,NYSE
4714,13-02-2021 08:00,24 hrs.,wallstreetbets,RDY,13,7,6,1,2,2,1,2,NYSE
4714,13-02-2021 08:00,24 hrs.,wallstreetbets,RKT,7296,465,6831,-6366,14,3376,488,13,NYSE
4714,13-02-2021 08:00,24 hrs.,wallstreetbets,RMO,69,0,69,-69,10,10,9,6,NYSE
4714,13-02-2021 08:00,24 hrs.,wallstreetbets,RPT,7,0,7,-7,1,1,1,1,NYSE
4714,13-02-2021 08:00,24 hrs.,wallstreetbets,RSI,6,0,6,-6,1,1,0,1,NYSE
4714,13-02-2021 08:00,24 hrs.,wallstreetbets,RTP,6,6,0,6,1,1,0,1,NYSE
4714,13-02-2021 08:00,24 hrs.,wallstreetbets,SBE,6,0,6,-6,1,1,0,1,NYSE
4714,13-02-2021 08:00,24 hrs.,wallstreetbets,SJM,98,98,0,98,2,30,30,2,NYSE
4714,13-02-2021 08:00,24 hrs.,wallstreetbets,SKM,30,0,30,-30,1,0,26,1,NYSE
4714,13-02-2021 08:00,24 hrs.,wallstreetbets,SKY,6,6,0,6,1,1,0,1,NYSE
4714,13-02-2021 08:00,24 hrs.,wallstreetbets,SNE,14,0,14,-14,2,2,2,1,NYSE
4714,13-02-2021 08:00,24 hrs.,wallstreetbets,SNX,6,6,0,6,1,1,0,1,NYSE
4714,13-02-2021 08:00,24 hrs.,wallstreetbets,SOS,184,78,106,-28,26,25,30,24,NYSE
4714,13-02-2021 08:00,24 hrs.,wallstreetbets,STM,7,0,7,-7,1,1,1,1,NYSE
4714,13-02-2021 08:00,24 hrs.,wallstreetbets,SUN,6,0,6,-6,1,1,0,1,NYSE
4714,13-02-2021 08:00,24 hrs.,wallstreetbets,SUP,7,0,7,-7,1,1,1,1,NYSE
4714,13-02-2021 08:00,24 hrs.,wallstreetbets,TAK,14,0,14,-14,2,2,2,2,NYSE
4714,13-02-2021 08:00,24 hrs.,wallstreetbets,TAP,13,6,7,-1,2,2,1,2,NYSE
4714,13-02-2021 08:00,24 hrs.,wallstreetbets,TBC,7,7,0,7,1,1,1,1,NYSE
4714,13-02-2021 08:00,24 hrs.,wallstreetbets,TDC,32,26,6,20,2,4,16,2,NYSE
4714,13-02-2021 08:00,24 hrs.,wallstreetbets,TFC,7,0,7,-7,1,1,1,1,NYSE
4714,13-02-2021 08:00,24 hrs.,wallstreetbets,THC,7,7,0,7,1,1,1,1,NYSE
4714,13-02-2021 08:00,24 hrs.,wallstreetbets,TRQ,6,0,6,-6,1,1,0,1,NYSE
4714,13-02-2021 08:00,24 hrs.,wallstreetbets,TRU,7,0,7,-7,1,1,1,1,NYSE
4714,13-02-2021 08:00,24 hrs.,wallstreetbets,TSM,516,0,516,-516,2,135,238,2,NYSE
4714,13-02-2021 08:00,24 hrs.,wallstreetbets,TSN,5931,0,5931,-5931,2,2790,343,1,NYSE
4714,13-02-2021 08:00,24 hrs.,SPACs,NSH,333,0,333,-333,1,95,139,1,NYSE
4714,13-02-2021 08:00,24 hrs.,SPACs,RBC,7,7,0,7,1,1,1,1,NYSE
4714,13-02-2021 08:00,24 hrs.,SPACs,RMO,6,6,0,6,1,1,0,1,NYSE
4714,13-02-2021 08:00,24 hrs.,SPACs,RSI,9,0,9,-9,1,0,5,1,NYSE
4714,13-02-2021 08:00,24 hrs.,SPACs,RTP,645,239,406,-167,4,190,249,3,NYSE
4714,13-02-2021 08:00,24 hrs.,SPACs,SBE,277,271,6,265,4,94,73,3,NYSE
4714,13-02-2021 08:00,24 hrs.,SPACs,SBG,333,0,333,-333,1,95,139,1,NYSE
4714,13-02-2021 08:00,24 hrs.,SPACs,SOS,7,7,0,7,1,1,1,1,NYSE
4714,13-02-2021 08:00,24 hrs.,SPACs,TDA,7,0,7,-7,1,1,1,1,NYSE
4714,13-02-2021 08:00,24 hrs.,SPACs,WPF,333,0,333,-333,1,95,139,1,NYSE
4714,13-02-2021 08:00,24 hrs.,SPACs,YAC,333,0,333,-333,1,95,139,1,NYSE
4714,13-02-2021 08:00,24 hrs.,SPACs,YUM,55,0,55,-55,1,17,17,1,NYSE
4714,13-02-2021 08:00,24 hrs.,SPACs,ACIC,239,239,0,239,1,20,195,1,NYSE
4714,13-02-2021 08:00,24 hrs.,SPACs,ACND,333,0,333,-333,1,95,139,1,NYSE
4714,13-02-2021 08:00,24 hrs.,SPACs,ALUS,52,0,52,-52,1,10,28,1,NYSE
4714,13-02-2021 08:00,24 hrs.,SPACs,AONE,333,0,333,-333,1,95,139,1,NYSE
4714,13-02-2021 08:00,24 hrs.,SPACs,APSG,333,0,333,-333,1,95,139,1,NYSE
4714,13-02-2021 08:00,24 hrs.,SPACs,ASAQ,333,0,333,-333,1,95,139,1,NYSE
4714,13-02-2021 08:00,24 hrs.,SPACs,DFHT,239,239,0,239,1,20,195,1,NASDAQ
4714,13-02-2021 08:00,24 hrs.,SPACs,DFPH,333,0,333,-333,1,95,139,1,NASDAQ
4714,13-02-2021 08:00,24 hrs.,SPACs,DGNS,504,0,504,-504,2,188,120,2,NASDAQ
4714,13-02-2021 08:00,24 hrs.,SPACs,DSAC,333,0,333,-333,1,95,139,1,NASDAQ
4714,13-02-2021 08:00,24 hrs.,SPACs,ERES,333,0,333,-333,1,95,139,1,NASDAQ
4714,13-02-2021 08:00,24 hrs.,SPACs,ESSC,333,0,333,-333,1,95,139,1,NASDAQ
4714,13-02-2021 08:00,24 hrs.,SPACs,ETAC,333,0,333,-333,1,95,139,1,NASDAQ
4714,13-02-2021 08:00,24 hrs.,SPACs,EUCR,333,0,333,-333,1,95,139,1,NASDAQ
4714,13-02-2021 08:00,24 hrs.,SPACs,FCAC,704,251,453,-202,5,216,252,4,NASDAQ
4714,13-02-2021 08:00,24 hrs.,SPACs,FTOC,327,306,21,285,6,109,85,5,NASDAQ
4714,13-02-2021 08:00,24 hrs.,SPACs,FVAM,333,0,333,-333,1,95,139,1,NASDAQ
4714,13-02-2021 08:00,24 hrs.,SPACs,GHIV,51,51,0,51,1,21,5,1,NASDAQ
4714,13-02-2021 08:00,24 hrs.,SPACs,GNRS,333,0,333,-333,1,95,139,1,NASDAQ
4714,13-02-2021 08:00,24 hrs.,SPACs,GRCY,361,28,333,-305,2,102,149,2,NASDAQ
4714,13-02-2021 08:00,24 hrs.,SPACs,GRNV,333,0,333,-333,1,95,139,1,NASDAQ
4714,13-02-2021 08:00,24 hrs.,SPACs,GRSV,424,91,333,-242,4,118,172,4,NASDAQ
4714,13-02-2021 08:00,24 hrs.,SPACs,GWAC,333,0,333,-333,1,95,139,1,NASDAQ
4714,13-02-2021 08:00,24 hrs.,SPACs,GXGX,333,0,333,-333,1,95,139,1,NASDAQ
4714,13-02-2021 08:00,24 hrs.,SPACs,IGAC,333,0,333,-333,1,95,139,1,NASDAQ
4714,13-02-2021 08:00,24 hrs.,SPACs,ITAC,333,0,333,-333,1,95,139,1,NASDAQ
4714,13-02-2021 08:00,24 hrs.,SPACs,JYAC,333,0,333,-333,1,95,139,1,NASDAQ
4714,13-02-2021 08:00,24 hrs.,SPACs,KERN,41,0,41,-41,1,5,27,1,NASDAQ
4714,13-02-2021 08:00,24 hrs.,SPACs,KSMT,333,0,333,-333,1,95,139,1,NASDAQ
4714,13-02-2021 08:00,24 hrs.,SPACs,LATN,333,0,333,-333,1,95,139,1,NASDAQ
4714,13-02-2021 08:00,24 hrs.,SPACs,LCAP,333,0,333,-333,1,95,139,1,NASDAQ
4714,13-02-2021 08:00,24 hrs.,SPACs,LFTR,333,0,333,-333,1,95,139,1,NASDAQ
4714,13-02-2021 08:00,24 hrs.,SPACs,LIVK,333,0,333,-333,1,95,139,1,NASDAQ
4714,13-02-2021 08:00,24 hrs.,SPACs,MAAC,333,0,333,-333,1,95,139,1,NASDAQ
4714,13-02-2021 08:00,24 hrs.,SPACs,MACU,361,28,333,-305,2,102,149,2,NASDAQ
4714,13-02-2021 08:00,24 hrs.,SPACs,LGVW,403,18,385,-367,2,173,49,2,NYSE
4714,13-02-2021 08:00,24 hrs.,SPACs,OACB,333,0,333,-333,1,95,139,1,NYSE
4714,13-02-2021 08:00,24 hrs.,SPACs,PANA,333,0,333,-333,1,95,139,1,NYSE
4714,13-02-2021 08:00,24 hrs.,SPACs,PCPL,333,0,333,-333,1,95,139,1,NYSE
4714,13-02-2021 08:00,24 hrs.,SPACs,PDAC,7,7,0,7,1,1,1,1,NYSE
4714,13-02-2021 08:00,24 hrs.,SPACs,PIAI,333,0,333,-333,1,95,139,1,NYSE
4714,13-02-2021 08:00,24 hrs.,SPACs,PRPB,333,0,333,-333,1,95,139,1,NYSE
4714,13-02-2021 08:00,24 hrs.,SPACs,PSTH,722,722,0,722,4,218,270,4,NYSE
4714,13-02-2021 08:00,24 hrs.,SPACs,RBAC,333,0,333,-333,1,95,139,1,NYSE
4714,13-02-2021 08:00,24 hrs.,SPACs,RPLA,333,0,333,-333,1,95,139,1,NYSE
4714,13-02-2021 08:00,24 hrs.,SPACs,SCPE,333,0,333,-333,1,95,139,1,NYSE
4714,13-02-2021 08:00,24 hrs.,SPACs,SCVX,333,0,333,-333,1,95,139,1,NYSE
4714,13-02-2021 08:00,24 hrs.,SPACs,SEAH,333,0,333,-333,1,95,139,1,NYSE
4714,13-02-2021 08:00,24 hrs.,SPACs,SFTW,333,0,333,-333,1,95,139,1,NYSE
4714,13-02-2021 08:00,24 hrs.,SPACs,SNPR,306,266,40,226,8,97,80,7,NYSE
4714,13-02-2021 08:00,24 hrs.,SPACs,STPK,31,31,0,31,3,6,7,3,NYSE
4714,13-02-2021 08:00,24 hrs.,SPACs,TPGY,18,18,0,18,1,4,6,1,NYSE
4714,13-02-2021 08:00,24 hrs.,wallstreetbets,JNJ,13,6,7,-1,2,2,1,2,NYSE
4714,13-02-2021 08:00,24 hrs.,wallstreetbets,JWS,12,12,0,12,2,2,0,1,NYSE
4714,13-02-2021 08:00,24 hrs.,wallstreetbets,KMI,47,0,47,-47,2,12,15,1,NYSE
4714,13-02-2021 08:00,24 hrs.,wallstreetbets,KOS,12,0,12,-12,2,2,0,1,NYSE
4714,13-02-2021 08:00,24 hrs.,wallstreetbets,LEE,6,6,0,6,1,1,0,1,NYSE
4714,13-02-2021 08:00,24 hrs.,wallstreetbets,LOW,22,0,22,-22,3,3,4,2,NYSE
4714,13-02-2021 08:00,24 hrs.,wallstreetbets,LTC,7,7,0,7,1,1,1,1,NYSE
4714,13-02-2021 08:00,24 hrs.,wallstreetbets,MAC,9,0,9,-9,1,1,3,1,NYSE
4714,13-02-2021 08:00,24 hrs.,wallstreetbets,MBI,14,0,14,-14,2,2,2,2,NYSE
4714,13-02-2021 08:00,24 hrs.,wallstreetbets,MCO,437,0,437,-437,1,179,75,1,NYSE
4714,13-02-2021 08:00,24 hrs.,wallstreetbets,MFA,7,0,7,-7,1,1,1,1,NYSE
4714,13-02-2021 08:00,24 hrs.,wallstreetbets,MIN,7,7,0,7,1,1,1,1,NYSE
4714,13-02-2021 08:00,24 hrs.,wallstreetbets,MRO,443,0,443,-443,2,180,75,2,NYSE
4714,13-02-2021 08:00,24 hrs.,wallstreetbets,MSM,7,0,7,-7,1,1,1,1,NYSE
4714,13-02-2021 08:00,24 hrs.,wallstreetbets,NAT,20,6,14,-8,3,2,4,3,NYSE
4714,13-02-2021 08:00,24 hrs.,wallstreetbets,NET,170,163,7,156,2,55,52,2,NYSE
4714,13-02-2021 08:00,24 hrs.,wallstreetbets,NGA,6,0,6,-6,1,1,0,1,NYSE
4714,13-02-2021 08:00,24 hrs.,wallstreetbets,NIO,747,19,728,-709,11,304,95,10,NYSE
4714,13-02-2021 08:00,24 hrs.,wallstreetbets,CLII,7,0,7,-7,1,1,1,1,NYSE
4714,13-02-2021 08:00,24 hrs.,wallstreetbets,DASH,13,13,0,13,2,2,1,2,NYSE
4714,13-02-2021 08:00,24 hrs.,wallstreetbets,EXPR,15,8,7,1,2,2,3,2,NYSE
4714,13-02-2021 08:00,24 hrs.,wallstreetbets,FEDU,7,0,7,-7,1,1,1,1,NYSE
4714,13-02-2021 08:00,24 hrs.,wallstreetbets,FLOW,7,0,7,-7,1,1,1,1,NYSE
4714,13-02-2021 08:00,24 hrs.,wallstreetbets,FSLY,14,0,14,-14,2,2,2,2,NYSE
4714,13-02-2021 08:00,24 hrs.,wallstreetbets,FUBO,1050,14,1036,-1022,4,410,214,4,NYSE
4714,13-02-2021 08:00,24 hrs.,wallstreetbets,FUSE,30,0,30,-30,4,4,6,2,NYSE
4714,13-02-2021 08:00,24 hrs.,wallstreetbets,FVRR,7,0,7,-7,1,1,1,1,NYSE
4714,13-02-2021 08:00,24 hrs.,wallstreetbets,GNRC,6,6,0,6,1,1,0,1,NYSE
4714,13-02-2021 08:00,24 hrs.,wallstreetbets,GPRK,7,0,7,-7,1,1,1,1,NYSE
4714,13-02-2021 08:00,24 hrs.,wallstreetbets,HEXO,27,27,0,27,4,4,3,3,NYSE
4714,13-02-2021 08:00,24 hrs.,wallstreetbets,HUBS,13,0,13,-13,2,2,1,2,NYSE
4714,13-02-2021 08:00,24 hrs.,wallstreetbets,HUYA,35,14,21,-7,5,5,5,4,NYSE
4714,13-02-2021 08:00,24 hrs.,wallstreetbets,HYLN,544,98,446,-348,12,152,192,10,NYSE
4714,13-02-2021 08:00,24 hrs.,wallstreetbets,IIPR,20,0,20,-20,3,3,2,2,NYSE
4714,13-02-2021 08:00,24 hrs.,wallstreetbets,IPOE,7,0,7,-7,1,1,1,1,NYSE
4714,13-02-2021 08:00,24 hrs.,wallstreetbets,JMIA,5973,7,5966,-5959,8,2796,349,3,NYSE
4714,13-02-2021 08:00,24 hrs.,wallstreetbets,JNPR,6,0,6,-6,1,1,0,1,NYSE
4714,13-02-2021 08:00,24 hrs.,wallstreetbets,KODK,13,0,13,-13,2,2,1,1,NYSE
4714,13-02-2021 08:00,24 hrs.,wallstreetbets,LGVW,7,0,7,-7,1,1,1,1,NYSE
4714,13-02-2021 08:00,24 hrs.,wallstreetbets,LSPD,6,0,6,-6,1,1,0,1,NYSE
4714,13-02-2021 08:00,24 hrs.,wallstreetbets,MAIN,6,6,0,6,1,1,0,1,NYSE
4714,13-02-2021 08:00,24 hrs.,wallstreetbets,MANU,12,0,12,-12,2,2,0,2,NYSE
4714,13-02-2021 08:00,24 hrs.,wallstreetbets,PACK,15,0,15,-15,2,2,3,1,NYSE
4714,13-02-2021 08:00,24 hrs.,wallstreetbets,PLTR,12730,2870,9860,-6990,39,5641,1292,31,NYSE
4714,13-02-2021 08:00,24 hrs.,wallstreetbets,PRTY,14,0,14,-14,2,2,2,2,NYSE
4714,13-02-2021 08:00,24 hrs.,wallstreetbets,PSTH,227,227,0,227,3,75,65,2,NYSE
4714,13-02-2021 08:00,24 hrs.,wallstreetbets,PUMP,49,0,49,-49,7,7,7,2,NYSE
4714,13-02-2021 08:00,24 hrs.,SPACs,TWND,36,0,36,-36,1,6,20,1,NYSE
4714,13-02-2021 08:00,24 hrs.,SPACs,VTOL,142,0,142,-142,1,52,34,1,NYSE
4714,13-02-2021 08:00,24 hrs.,SPACs,VYGG,38,32,6,26,2,7,16,2,NYSE
4714,13-02-2021 08:00,24 hrs.,SPACs,ADV,572,239,333,-94,2,115,334,2,NASDAQ
4714,13-02-2021 08:00,24 hrs.,SPACs,CFO,197,0,197,-197,2,69,51,2,NASDAQ
4714,13-02-2021 08:00,24 hrs.,SPACs,ESG,148,18,130,-112,2,46,48,2,NASDAQ
4714,13-02-2021 08:00,24 hrs.,SPACs,III,180,180,0,180,2,67,38,2,NASDAQ
4714,13-02-2021 08:00,24 hrs.,SPACs,LCY,333,0,333,-333,1,95,139,1,NASDAQ
4714,13-02-2021 08:00,24 hrs.,SPACs,NPA,122,0,122,-122,1,43,32,1,NASDAQ
4714,13-02-2021 08:00,24 hrs.,SPACs,VIH,46,0,46,-46,1,16,10,1,NASDAQ
4714,13-02-2021 08:00,24 hrs.,SPACs,AACQ,2017,2017,0,2017,10,652,673,8,NASDAQ
4714,13-02-2021 08:00,24 hrs.,SPACs,ACEV,41,0,41,-41,1,2,33,1,NASDAQ
4714,13-02-2021 08:00,24 hrs.,SPACs,ACTC,18,18,0,18,1,4,6,1,NASDAQ
4714,13-02-2021 08:00,24 hrs.,SPACs,ADOC,361,28,333,-305,2,102,149,2,NASDAQ
4714,13-02-2021 08:00,24 hrs.,SPACs,AGBA,333,0,333,-333,1,95,139,1,NASDAQ
4714,13-02-2021 08:00,24 hrs.,SPACs,AHAC,333,0,333,-333,1,95,139,1,NASDAQ
4714,13-02-2021 08:00,24 hrs.,SPACs,AMHC,333,0,333,-333,1,95,139,1,NASDAQ
4714,13-02-2021 08:00,24 hrs.,SPACs,BHSE,361,28,333,-305,2,102,149,2,NASDAQ
4714,13-02-2021 08:00,24 hrs.,SPACs,BLNK,41,0,41,-41,1,5,27,1,NASDAQ
4714,13-02-2021 08:00,24 hrs.,SPACs,BOWX,333,0,333,-333,1,95,139,1,NASDAQ
4714,13-02-2021 08:00,24 hrs.,SPACs,BREZ,333,0,333,-333,1,95,139,1,NASDAQ
4714,13-02-2021 08:00,24 hrs.,SPACs,BRLI,333,0,333,-333,1,95,139,1,NASDAQ
4714,13-02-2021 08:00,24 hrs.,SPACs,BRPA,257,257,0,257,2,24,201,2,NASDAQ
4714,13-02-2021 08:00,24 hrs.,SPACs,BTAQ,862,0,862,-862,3,314,222,3,NASDAQ
4714,13-02-2021 08:00,24 hrs.,SPACs,BTWN,11,0,11,-11,1,2,3,1,NASDAQ
4714,13-02-2021 08:00,24 hrs.,SPACs,BWAC,333,0,333,-333,1,95,139,1,NASDAQ
4714,13-02-2021 08:00,24 hrs.,SPACs,CAPA,333,0,333,-333,1,95,139,1,NASDAQ
4714,13-02-2021 08:00,24 hrs.,SPACs,CFII,333,0,333,-333,1,95,139,1,NASDAQ
4714,13-02-2021 08:00,24 hrs.,SPACs,CHPM,333,0,333,-333,1,95,139,1,NASDAQ
4714,13-02-2021 08:00,24 hrs.,SPACs,CIIC,60,44,16,28,3,17,14,2,NASDAQ
4714,13-02-2021 08:00,24 hrs.,SPACs,CMLF,257,257,0,257,2,24,201,2,NASDAQ
4714,13-02-2021 08:00,24 hrs.,SPACs,CONX,333,0,333,-333,1,95,139,1,NASDAQ
4714,13-02-2021 08:00,24 hrs.,SPACs,CRSA,333,0,333,-333,1,95,139,1,NASDAQ
4714,13-02-2021 08:00,24 hrs.,SPACs,DBDR,333,0,333,-333,1,95,139,1,NASDAQ
4714,13-02-2021 08:00,24 hrs.,SPACs,DCRB,16,0,16,-16,1,4,4,1,NASDAQ
4714,13-02-2021 08:00,24 hrs.,wallstreetbets,SAFE,135,9,126,-117,2,36,55,2,NYSE
4714,13-02-2021 08:00,24 hrs.,wallstreetbets,SPCE,247,34,213,-179,22,53,53,13,NYSE
4714,13-02-2021 08:00,24 hrs.,wallstreetbets,STIC,7,7,0,7,1,1,1,1,NYSE
4714,13-02-2021 08:00,24 hrs.,wallstreetbets,STPK,6,6,0,6,1,1,0,1,NYSE
4714,13-02-2021 08:00,24 hrs.,wallstreetbets,STWD,145,0,145,-145,1,39,63,1,NYSE
4714,13-02-2021 08:00,24 hrs.,wallstreetbets,TWTR,7,0,7,-7,1,1,1,1,NYSE
4714,13-02-2021 08:00,24 hrs.,wallstreetbets,UBER,7,0,7,-7,1,1,1,1,NYSE
4714,13-02-2021 08:00,24 hrs.,wallstreetbets,VALE,7,7,0,7,1,1,1,1,NYSE
4714,13-02-2021 08:00,24 hrs.,wallstreetbets,VGAC,19,0,19,-19,3,3,1,3,NYSE
4714,13-02-2021 08:00,24 hrs.,wallstreetbets,VSTO,7,7,0,7,1,1,1,1,NYSE
4714,13-02-2021 08:00,24 hrs.,wallstreetbets,WORK,3170,7,3163,-3156,3,1323,512,3,NYSE
4714,13-02-2021 08:00,24 hrs.,wallstreetbets,XPEV,7,0,7,-7,1,1,1,1,NYSE
4714,13-02-2021 08:00,24 hrs.,wallstreetbets,YELP,7,7,0,7,1,1,1,1,NYSE
4714,13-02-2021 08:00,24 hrs.,wallstreetbets,AAL,19,0,19,-19,3,3,1,3,NASDAQ
4714,13-02-2021 08:00,24 hrs.,wallstreetbets,AMD,2427,20,2407,-2387,21,833,677,17,NASDAQ
4714,13-02-2021 08:00,24 hrs.,wallstreetbets,AQB,7,7,0,7,1,1,1,1,NASDAQ
4714,13-02-2021 08:00,24 hrs.,wallstreetbets,ASO,6,0,6,-6,1,1,0,1,NASDAQ
4714,13-02-2021 08:00,24 hrs.,wallstreetbets,AZN,451,7,444,-437,3,181,77,3,NASDAQ
4714,13-02-2021 08:00,24 hrs.,wallstreetbets,BFI,14,0,14,-14,2,2,2,1,NASDAQ
4714,13-02-2021 08:00,24 hrs.,wallstreetbets,BLU,14,0,14,-14,2,2,2,1,NASDAQ
4714,13-02-2021 08:00,24 hrs.,wallstreetbets,BUG,12,0,12,-12,2,2,0,1,NASDAQ
4714,13-02-2021 08:00,24 hrs.,wallstreetbets,CDC,437,0,437,-437,1,179,75,1,NASDAQ
4714,13-02-2021 08:00,24 hrs.,wallstreetbets,CGC,96,7,89,-82,5,22,32,5,NASDAQ
4714,13-02-2021 08:00,24 hrs.,wallstreetbets,CTG,7,0,7,-7,1,1,1,1,NASDAQ
4714,13-02-2021 08:00,24 hrs.,wallstreetbets,DBX,7,0,7,-7,1,1,1,1,NASDAQ
4714,13-02-2021 08:00,24 hrs.,wallstreetbets,FAT,174,7,167,-160,2,54,58,2,NASDAQ
4714,13-02-2021 08:00,24 hrs.,wallstreetbets,FUV,7,0,7,-7,1,1,1,1,NASDAQ
4714,13-02-2021 08:00,24 hrs.,wallstreetbets,FWP,14,0,14,-14,2,2,2,1,NASDAQ
4714,13-02-2021 08:00,24 hrs.,wallstreetbets,GBT,7,7,0,7,1,1,1,1,NASDAQ
4714,13-02-2021 08:00,24 hrs.,SPACs,MCMJ,333,0,333,-333,1,95,139,1,NASDAQ
4714,13-02-2021 08:00,24 hrs.,SPACs,MLAC,333,0,333,-333,1,95,139,1,NASDAQ
4714,13-02-2021 08:00,24 hrs.,SPACs,MOTN,333,0,333,-333,1,95,139,1,NASDAQ
4714,13-02-2021 08:00,24 hrs.,SPACs,NBAC,30,30,0,30,2,8,6,2,NASDAQ
4714,13-02-2021 08:00,24 hrs.,SPACs,NKLA,18,18,0,18,1,4,6,1,NASDAQ
4714,13-02-2021 08:00,24 hrs.,SPACs,OKTA,52,52,0,52,1,17,14,1,NASDAQ
4714,13-02-2021 08:00,24 hrs.,SPACs,OTRA,333,0,333,-333,1,95,139,1,NASDAQ
4714,13-02-2021 08:00,24 hrs.,SPACs,PAIC,333,0,333,-333,1,95,139,1,NASDAQ
4714,13-02-2021 08:00,24 hrs.,SPACs,PLUG,6,0,6,-6,1,1,0,1,NASDAQ
4714,13-02-2021 08:00,24 hrs.,wallstreetbets,TTM,6,0,6,-6,1,1,0,1,NYSE
4714,13-02-2021 08:00,24 hrs.,wallstreetbets,TWO,7,0,7,-7,1,1,1,1,NYSE
4714,13-02-2021 08:00,24 hrs.,wallstreetbets,UBS,14,7,7,0,2,2,2,2,NYSE
4714,13-02-2021 08:00,24 hrs.,wallstreetbets,UNP,7,0,7,-7,1,1,1,1,NYSE
4714,13-02-2021 08:00,24 hrs.,wallstreetbets,UTZ,1029,0,1029,-1029,1,407,211,1,NYSE
4714,13-02-2021 08:00,24 hrs.,wallstreetbets,VGR,7,0,7,-7,1,1,1,1,NYSE
4714,13-02-2021 08:00,24 hrs.,wallstreetbets,VHC,7,7,0,7,1,1,1,1,NYSE
4714,13-02-2021 08:00,24 hrs.,wallstreetbets,VRT,152,152,0,152,2,54,36,1,NYSE
4714,13-02-2021 08:00,24 hrs.,wallstreetbets,VST,35,0,35,-35,5,5,5,1,NYSE
4714,13-02-2021 08:00,24 hrs.,wallstreetbets,WFC,7,0,7,-7,1,1,1,1,NYSE
4714,13-02-2021 08:00,24 hrs.,wallstreetbets,WLL,6,0,6,-6,1,1,0,1,NYSE
4714,13-02-2021 08:00,24 hrs.,wallstreetbets,WMC,8,0,8,-8,1,1,2,1,NYSE
4714,13-02-2021 08:00,24 hrs.,wallstreetbets,WMT,13,0,13,-13,2,2,1,2,NYSE
4714,13-02-2021 08:00,24 hrs.,wallstreetbets,ABBV,7,7,0,7,1,1,1,1,NYSE
4714,13-02-2021 08:00,24 hrs.,wallstreetbets,ABEV,7,0,7,-7,1,1,1,1,NYSE
4714,13-02-2021 08:00,24 hrs.,wallstreetbets,ACIC,27,7,20,-13,4,4,3,4,NYSE
4714,13-02-2021 08:00,24 hrs.,wallstreetbets,ALLY,7,7,0,7,1,1,1,1,NYSE
4714,13-02-2021 08:00,24 hrs.,wallstreetbets,APRN,6,0,6,-6,1,1,0,1,NYSE
4714,13-02-2021 08:00,24 hrs.,wallstreetbets,ARGO,6,0,6,-6,1,1,0,1,NYSE
4714,13-02-2021 08:00,24 hrs.,wallstreetbets,ATUS,14,0,14,-14,2,2,2,1,NYSE
4714,13-02-2021 08:00,24 hrs.,wallstreetbets,BABA,181,0,181,-181,3,55,59,3,NYSE
4714,13-02-2021 08:00,24 hrs.,wallstreetbets,BNED,6,0,6,-6,1,1,0,1,NYSE
4714,13-02-2021 08:00,24 hrs.,wallstreetbets,CARS,6,0,6,-6,1,1,0,1,NYSE
4714,13-02-2021 08:00,24 hrs.,wallstreetbets,CCIV,232,110,122,-12,34,34,28,29,NYSE
4714,13-02-2021 08:00,24 hrs.,wallstreetbets,CHWY,7,0,7,-7,1,1,1,1,NYSE
4714,13-02-2021 08:00,24 hrs.,wallstreetbets,CLDR,6,6,0,6,1,1,0,1,NYSE
4701,13-02-2021 06:00,24 hrs.,pennystocks,ICNM,15,0,15,-15,1,3,5,1,OTC
4701,13-02-2021 06:00,24 hrs.,pennystocks,IMJX,96,0,96,-96,1,26,40,1,OTC
4701,13-02-2021 06:00,24 hrs.,pennystocks,IMTL,6,0,6,-6,1,1,0,1,OTC
4701,13-02-2021 06:00,24 hrs.,pennystocks,INKW,56,6,50,-44,9,9,2,7,OTC
4701,13-02-2021 06:00,24 hrs.,pennystocks,INND,176,68,108,-40,7,28,92,7,OTC
4701,13-02-2021 06:00,24 hrs.,pennystocks,INTV,19,13,6,7,3,3,1,3,OTC
4701,13-02-2021 06:00,24 hrs.,pennystocks,IPIX,6,0,6,-6,1,1,0,1,OTC
4701,13-02-2021 06:00,24 hrs.,pennystocks,IPSI,14,14,0,14,1,3,4,1,OTC
4701,13-02-2021 06:00,24 hrs.,pennystocks,IQST,18,0,18,-18,3,3,0,2,OTC
4701,13-02-2021 06:00,24 hrs.,pennystocks,ISBL,7,7,0,7,1,1,1,1,OTC
4701,13-02-2021 06:00,24 hrs.,pennystocks,ITCJ,7,0,7,-7,1,1,1,1,OTC
4701,13-02-2021 06:00,24 hrs.,pennystocks,BMIX,6,0,6,-6,1,1,0,1,OTC
4701,13-02-2021 06:00,24 hrs.,pennystocks,BMMJ,6,6,0,6,1,1,0,1,OTC
4701,13-02-2021 06:00,24 hrs.,pennystocks,BONZ,6,0,6,-6,1,0,2,1,OTC
4701,13-02-2021 06:00,24 hrs.,pennystocks,BRLL,46,0,46,-46,2,3,32,2,OTC
4701,13-02-2021 06:00,24 hrs.,pennystocks,BRTX,12,6,6,0,2,2,0,2,OTC
4701,13-02-2021 06:00,24 hrs.,pennystocks,BRZL,6,6,0,6,1,1,0,1,OTC
4701,13-02-2021 06:00,24 hrs.,pennystocks,BTZI,6,6,0,6,1,1,0,1,OTC
4701,13-02-2021 06:00,24 hrs.,pennystocks,BUDZ,24,0,24,-24,3,4,4,3,OTC
4701,13-02-2021 06:00,24 hrs.,pennystocks,BWMG,55,0,55,-55,2,13,21,2,OTC
4701,13-02-2021 06:00,24 hrs.,pennystocks,BZWR,15,15,0,15,1,0,11,1,OTC
4701,13-02-2021 06:00,24 hrs.,pennystocks,CANN,6,0,6,-6,1,1,0,1,OTC
4701,13-02-2021 06:00,24 hrs.,pennystocks,CAPC,7,0,7,-7,1,1,1,1,OTC
4701,13-02-2021 06:00,24 hrs.,pennystocks,CATV,138,138,0,138,1,60,14,1,OTC
4701,13-02-2021 06:00,24 hrs.,pennystocks,CAVR,6,6,0,6,1,1,0,1,OTC
4701,13-02-2021 06:00,24 hrs.,pennystocks,CBBT,496,0,496,-496,6,193,86,5,OTC
4701,13-02-2021 06:00,24 hrs.,pennystocks,CBDD,5,0,5,-5,1,0,1,1,OTC
4701,13-02-2021 06:00,24 hrs.,pennystocks,CBDL,283,50,233,-183,4,87,93,4,OTC
4701,13-02-2021 06:00,24 hrs.,pennystocks,CCTL,17,17,0,17,1,5,3,1,OTC
4701,13-02-2021 06:00,24 hrs.,pennystocks,ABML,154,70,84,-14,3,48,46,3,OTC
4701,13-02-2021 06:00,24 hrs.,pennystocks,ADTM,13,13,0,13,2,2,1,1,OTC
4701,13-02-2021 06:00,24 hrs.,pennystocks,AEPT,6,0,6,-6,1,1,0,1,OTC
4701,13-02-2021 06:00,24 hrs.,pennystocks,AFPW,6,0,6,-6,1,1,0,1,OTC
4701,13-02-2021 06:00,24 hrs.,pennystocks,AITX,330,0,330,-330,3,119,80,3,OTC
4701,13-02-2021 06:00,24 hrs.,pennystocks,ALKM,7,0,7,-7,1,1,1,1,OTC
4701,13-02-2021 06:00,24 hrs.,pennystocks,ALPP,374,115,259,-144,6,124,102,5,OTC
4701,13-02-2021 06:00,24 hrs.,pennystocks,ALST,26,26,0,26,2,3,12,1,OTC
4701,13-02-2021 06:00,24 hrs.,pennystocks,ALYI,42,0,42,-42,3,11,8,3,OTC
4701,13-02-2021 06:00,24 hrs.,pennystocks,ANDI,7,0,7,-7,1,1,1,1,OTC
4701,13-02-2021 06:00,24 hrs.,pennystocks,APPZ,7,0,7,-7,1,1,1,1,OTC
4701,13-02-2021 06:00,24 hrs.,pennystocks,ASCK,6,6,0,6,1,1,0,1,OTC
4701,13-02-2021 06:00,24 hrs.,pennystocks,ASTI,18,0,18,-18,3,3,0,3,OTC
4701,13-02-2021 06:00,24 hrs.,pennystocks,ATDS,6,0,6,-6,1,1,0,1,OTC
4701,13-02-2021 06:00,24 hrs.,pennystocks,ATNP,29,29,0,29,1,4,17,1,OTC
4701,13-02-2021 06:00,24 hrs.,pennystocks,AXXA,26,26,0,26,1,9,4,1,OTC
4701,13-02-2021 06:00,24 hrs.,pennystocks,AZFL,42,0,42,-42,1,7,24,1,OTC
4701,13-02-2021 06:00,24 hrs.,pennystocks,BANT,6,0,6,-6,1,1,0,1,OTC
4701,13-02-2021 06:00,24 hrs.,pennystocks,BBRW,168,53,115,-62,4,37,78,4,OTC
4701,13-02-2021 06:00,24 hrs.,pennystocks,BDGR,6,0,6,-6,1,1,0,1,OTC
4701,13-02-2021 06:00,24 hrs.,pennystocks,BFRE,16,16,0,16,1,0,12,1,OTC
4701,13-02-2021 06:00,24 hrs.,pennystocks,BGMD,6,6,0,6,1,1,0,1,OTC
4701,13-02-2021 06:00,24 hrs.,pennystocks,BIEL,115,0,115,-115,4,29,41,3,OTC
4701,13-02-2021 06:00,24 hrs.,pennystocks,BLDV,71,71,0,71,1,24,19,1,OTC
4701,13-02-2021 06:00,24 hrs.,pennystocks,BLSP,13,0,13,-13,2,2,1,2,OTC
4701,13-02-2021 06:00,24 hrs.,pennystocks,BMCS,10,0,10,-10,1,2,2,1,OTC
4701,13-02-2021 06:00,24 hrs.,pennystocks,SHMP,6,0,6,-6,1,1,0,1,OTC
4701,13-02-2021 06:00,24 hrs.,pennystocks,SHWZ,7,0,7,-7,1,1,1,1,OTC
4701,13-02-2021 06:00,24 hrs.,pennystocks,SIML,102,6,96,-90,2,27,40,2,OTC
4701,13-02-2021 06:00,24 hrs.,pennystocks,JSDA,6,0,6,-6,1,1,0,1,OTC
4701,13-02-2021 06:00,24 hrs.,pennystocks,KWBT,13,6,7,-1,2,2,1,2,OTC
4701,13-02-2021 06:00,24 hrs.,pennystocks,KYNC,6,6,0,6,1,1,0,1,OTC
4701,13-02-2021 06:00,24 hrs.,pennystocks,LBTI,6,6,0,6,1,1,0,1,OTC
4701,13-02-2021 06:00,24 hrs.,pennystocks,LITH,6,6,0,6,1,1,0,1,OTC
4701,13-02-2021 06:00,24 hrs.,pennystocks,LQMT,6,0,6,-6,1,1,0,1,OTC
4701,13-02-2021 06:00,24 hrs.,pennystocks,LUVU,14,0,14,-14,2,3,0,2,OTC
4701,13-02-2021 06:00,24 hrs.,pennystocks,LVVV,37,37,0,37,1,7,19,1,OTC
4701,13-02-2021 06:00,24 hrs.,pennystocks,CELZ,7,0,7,-7,1,1,1,1,OTC
4701,13-02-2021 06:00,24 hrs.,pennystocks,CHNC,20,20,0,20,1,4,8,1,OTC
4701,13-02-2021 06:00,24 hrs.,pennystocks,CLWD,6,0,6,-6,1,1,0,1,OTC
4701,13-02-2021 06:00,24 hrs.,pennystocks,CNNA,78,78,0,78,1,9,56,1,OTC
4701,13-02-2021 06:00,24 hrs.,pennystocks,COMS,13,13,0,13,2,2,1,1,OTC
4701,13-02-2021 06:00,24 hrs.,pennystocks,CORG,39,0,39,-39,3,4,19,3,OTC
4701,13-02-2021 06:00,24 hrs.,pennystocks,CRTG,37,0,37,-37,1,12,9,1,OTC
4701,13-02-2021 06:00,24 hrs.,pennystocks,CRWG,6,0,6,-6,1,1,0,1,OTC
4701,13-02-2021 06:00,24 hrs.,pennystocks,CSLI,48,48,0,48,1,14,16,1,OTC
4701,13-02-2021 06:00,24 hrs.,pennystocks,CTLE,24,12,12,0,4,4,0,3,OTC
4701,13-02-2021 06:00,24 hrs.,pennystocks,CYDY,7,0,7,-7,1,1,1,1,OTC
4701,13-02-2021 06:00,24 hrs.,pennystocks,DIGI,13,0,13,-13,2,2,1,1,OTC
4701,13-02-2021 06:00,24 hrs.,pennystocks,DMAN,17,0,17,-17,1,4,5,1,OTC
4701,13-02-2021 06:00,24 hrs.,pennystocks,DPLS,141,31,110,-79,7,42,29,5,OTC
4701,13-02-2021 06:00,24 hrs.,pennystocks,DSGT,6,6,0,6,1,1,0,1,OTC
4701,13-02-2021 06:00,24 hrs.,pennystocks,EAWD,6,6,0,6,1,1,0,1,OTC
4701,13-02-2021 06:00,24 hrs.,pennystocks,ECEZ,7,7,0,7,1,1,1,1,OTC
4701,13-02-2021 06:00,24 hrs.,pennystocks,EHOS,42,42,0,42,1,11,16,1,OTC
4701,13-02-2021 06:00,24 hrs.,pennystocks,ELTP,18,0,18,-18,1,5,4,1,OTC
4701,13-02-2021 06:00,24 hrs.,pennystocks,ENRT,6,0,6,-6,1,1,0,1,OTC
4701,13-02-2021 06:00,24 hrs.,pennystocks,ENZC,12,0,12,-12,2,2,0,2,OTC
4701,13-02-2021 06:00,24 hrs.,pennystocks,ERBB,28,14,14,0,2,2,16,2,OTC
4701,13-02-2021 06:00,24 hrs.,pennystocks,ETFM,204,204,0,204,4,69,50,3,OTC
4701,13-02-2021 06:00,24 hrs.,pennystocks,ETHE,40,0,40,-40,1,5,26,1,OTC
4701,13-02-2021 06:00,24 hrs.,pennystocks,EWKS,7,0,7,-7,1,1,1,1,OTC
4701,13-02-2021 06:00,24 hrs.,pennystocks,FBEC,6,0,6,-6,1,1,0,1,OTC
4701,13-02-2021 06:00,24 hrs.,pennystocks,FDBH,7,0,7,-7,1,1,1,1,OTC
4701,13-02-2021 06:00,24 hrs.,pennystocks,FLXT,6,6,0,6,1,1,0,1,OTC
4701,13-02-2021 06:00,24 hrs.,pennystocks,FTEG,6,6,0,6,1,1,0,1,OTC
4701,13-02-2021 06:00,24 hrs.,pennystocks,FUST,7,0,7,-7,1,1,1,1,OTC
4701,13-02-2021 06:00,24 hrs.,pennystocks,GAXY,63,63,0,63,1,22,15,1,OTC
4701,13-02-2021 06:00,24 hrs.,pennystocks,GBTC,40,0,40,-40,1,5,26,1,OTC
4701,13-02-2021 06:00,24 hrs.,pennystocks,GHMP,46,0,46,-46,3,8,18,2,OTC
4701,13-02-2021 06:00,24 hrs.,pennystocks,GLCO,6,6,0,6,1,1,0,1,OTC
4701,13-02-2021 06:00,24 hrs.,pennystocks,GLEC,6,0,6,-6,1,1,0,1,OTC
4701,13-02-2021 06:00,24 hrs.,pennystocks,GPFT,49,10,39,-29,2,10,21,2,OTC
4701,13-02-2021 06:00,24 hrs.,pennystocks,GRCU,9,0,9,-9,1,0,5,1,OTC
4701,13-02-2021 06:00,24 hrs.,pennystocks,GRST,106,106,0,106,2,33,32,1,OTC
4701,13-02-2021 06:00,24 hrs.,pennystocks,GTBP,19,19,0,19,1,2,11,1,OTC
4701,13-02-2021 06:00,24 hrs.,pennystocks,GTCH,22,0,22,-22,1,1,16,1,OTC
4701,13-02-2021 06:00,24 hrs.,pennystocks,GTEH,43,43,0,43,1,9,21,1,OTC
4701,13-02-2021 06:00,24 hrs.,pennystocks,GTLL,77,25,52,-27,4,25,11,4,OTC
4701,13-02-2021 06:00,24 hrs.,pennystocks,HALB,29,18,11,7,2,7,7,2,OTC
4701,13-02-2021 06:00,24 hrs.,pennystocks,HCMC,120,43,77,-34,19,19,6,17,OTC
4701,13-02-2021 06:00,24 hrs.,pennystocks,HEMP,7,7,0,7,1,1,1,1,OTC
4701,13-02-2021 06:00,24 hrs.,pennystocks,HENC,15,15,0,15,1,3,5,1,OTC
4701,13-02-2021 06:00,24 hrs.,pennystocks,HIPH,18,6,12,-6,3,2,2,2,OTC
4701,13-02-2021 06:00,24 hrs.,pennystocks,HMMR,7,7,0,7,1,1,1,1,OTC
4701,13-02-2021 06:00,24 hrs.,pennystocks,HMNY,6,6,0,6,1,1,0,1,OTC
4701,13-02-2021 06:00,24 hrs.,pennystocks,HPTY,52,0,52,-52,1,17,14,1,OTC
4701,13-02-2021 06:00,24 hrs.,pennystocks,HYSR,6,0,6,-6,1,1,0,1,OTC
4701,13-02-2021 06:00,24 hrs.,pennystocks,ICBU,6,0,6,-6,1,1,0,1,OTC
4701,13-02-2021 06:00,24 hrs.,pennystocks,ICLD,6,6,0,6,1,1,0,1,OTC
4701,13-02-2021 06:00,24 hrs.,pennystocks,VSPC,6,6,0,6,1,1,0,1,OTC
4701,13-02-2021 06:00,24 hrs.,pennystocks,VTLR,6,0,6,-6,1,1,0,1,OTC
4701,13-02-2021 06:00,24 hrs.,pennystocks,WCVC,96,0,96,-96,1,26,40,1,OTC
4701,13-02-2021 06:00,24 hrs.,pennystocks,WIZD,18,0,18,-18,1,5,4,1,OTC
4701,13-02-2021 06:00,24 hrs.,pennystocks,WTII,35,0,35,-35,1,10,11,1,OTC
4701,13-02-2021 06:00,24 hrs.,pennystocks,XLPI,193,193,0,193,1,90,9,1,OTC
4701,13-02-2021 06:00,24 hrs.,pennystocks,XMET,6,6,0,6,1,1,0,1,OTC
4701,13-02-2021 06:00,24 hrs.,pennystocks,ZHUD,8,8,0,8,1,1,2,1,OTC
4701,13-02-2021 06:00,24 hrs.,pennystocks,ZPAS,6,0,6,-6,1,1,0,1,OTC
4701,13-02-2021 06:00,24 hrs.,pennystocks,AGGHF,19,0,19,-19,1,4,7,1,OTC
4701,13-02-2021 06:00,24 hrs.,pennystocks,ALLIF,128,0,128,-128,1,38,48,1,OTC
4701,13-02-2021 06:00,24 hrs.,pennystocks,ARBKF,72,26,46,-20,3,13,34,3,OTC
4701,13-02-2021 06:00,24 hrs.,pennystocks,BDRBF,6,6,0,6,1,1,0,1,OTC
4701,13-02-2021 06:00,24 hrs.,pennystocks,BFARF,11,11,0,11,1,1,5,1,OTC
4701,13-02-2021 06:00,24 hrs.,pennystocks,BKLLF,84,0,84,-84,1,26,28,1,OTC
4701,13-02-2021 06:00,24 hrs.,pennystocks,BNCHF,6,6,0,6,1,1,0,1,OTC
4701,13-02-2021 06:00,24 hrs.,pennystocks,BRPHF,40,0,40,-40,1,5,26,1,OTC
4701,13-02-2021 06:00,24 hrs.,pennystocks,BVNNF,7,0,7,-7,1,1,1,1,OTC
4701,13-02-2021 06:00,24 hrs.,pennystocks,CANSF,5,0,5,-5,1,0,1,1,OTC
4701,13-02-2021 06:00,24 hrs.,pennystocks,CBULF,6,0,6,-6,1,1,0,1,OTC
4701,13-02-2021 06:00,24 hrs.,pennystocks,MAXD,59,43,16,27,6,15,5,6,OTC
4701,13-02-2021 06:00,24 hrs.,pennystocks,MCOA,7,0,7,-7,1,1,1,1,OTC
4701,13-02-2021 06:00,24 hrs.,pennystocks,MDCN,13,0,13,-13,2,2,1,2,OTC
4701,13-02-2021 06:00,24 hrs.,pennystocks,MEDH,75,0,75,-75,1,16,39,1,OTC
4701,13-02-2021 06:00,24 hrs.,pennystocks,MGTI,22,22,0,22,1,7,4,1,OTC
4701,13-02-2021 06:00,24 hrs.,pennystocks,MIHI,6,6,0,6,1,1,0,1,OTC
4701,13-02-2021 06:00,24 hrs.,pennystocks,MINE,73,31,42,-11,6,12,25,5,OTC
4701,13-02-2021 06:00,24 hrs.,pennystocks,MJNA,25,0,25,-25,4,4,1,4,OTC
4701,13-02-2021 06:00,24 hrs.,pennystocks,MJTV,7,0,7,-7,1,1,1,1,OTC
4701,13-02-2021 06:00,24 hrs.,pennystocks,MKTY,7,0,7,-7,1,1,1,1,OTC
4701,13-02-2021 06:00,24 hrs.,pennystocks,MLFB,157,43,114,-71,3,48,49,3,OTC
4701,13-02-2021 06:00,24 hrs.,pennystocks,MMEX,139,72,67,5,3,25,77,2,OTC
4701,13-02-2021 06:00,24 hrs.,pennystocks,MOJO,12,6,6,0,2,2,0,2,OTC
4701,13-02-2021 06:00,24 hrs.,pennystocks,MRMD,5,5,0,5,1,0,1,1,OTC
4701,13-02-2021 06:00,24 hrs.,pennystocks,MTVX,6,0,6,-6,1,1,0,1,OTC
4701,13-02-2021 06:00,24 hrs.,pennystocks,NBVG,7,0,7,-7,1,1,1,1,OTC
4701,13-02-2021 06:00,24 hrs.,pennystocks,NOVC,52,0,52,-52,2,15,14,2,OTC
4701,13-02-2021 06:00,24 hrs.,pennystocks,NSAV,13,7,6,1,2,2,1,2,OTC
4701,13-02-2021 06:00,24 hrs.,pennystocks,NSPT,6,0,6,-6,1,1,0,1,OTC
4701,13-02-2021 06:00,24 hrs.,pennystocks,NUGS,7,7,0,7,1,1,1,1,OTC
4701,13-02-2021 06:00,24 hrs.,pennystocks,OZSC,62,62,0,62,2,9,36,2,OTC
4701,13-02-2021 06:00,24 hrs.,pennystocks,PAOG,7,0,7,-7,1,1,1,1,OTC
4701,13-02-2021 06:00,24 hrs.,pennystocks,PDXP,7,0,7,-7,1,1,1,1,OTC
4701,13-02-2021 06:00,24 hrs.,pennystocks,PHIL,6,0,6,-6,1,1,0,1,OTC
4701,13-02-2021 06:00,24 hrs.,pennystocks,PMCB,6,0,6,-6,1,1,0,1,OTC
4701,13-02-2021 06:00,24 hrs.,pennystocks,PPJE,6,6,0,6,1,1,0,1,OTC
4701,13-02-2021 06:00,24 hrs.,pennystocks,PUGE,47,6,41,-35,2,15,9,2,OTC
4701,13-02-2021 06:00,24 hrs.,pennystocks,PURA,52,45,7,38,3,7,26,3,OTC
4701,13-02-2021 06:00,24 hrs.,pennystocks,PVDG,25,0,25,-25,1,2,17,1,OTC
4701,13-02-2021 06:00,24 hrs.,pennystocks,QOIL,7,0,7,-7,1,1,1,1,OTC
4701,13-02-2021 06:00,24 hrs.,pennystocks,RDGL,6,6,0,6,1,1,0,1,OTC
4701,13-02-2021 06:00,24 hrs.,pennystocks,RELI,16,0,16,-16,1,0,12,1,OTC
4701,13-02-2021 06:00,24 hrs.,pennystocks,RGBP,21,21,0,21,2,5,3,1,OTC
4701,13-02-2021 06:00,24 hrs.,pennystocks,RLBD,16,0,16,-16,1,4,4,1,OTC
4701,13-02-2021 06:00,24 hrs.,pennystocks,RMTD,6,0,6,-6,1,1,0,1,OTC
4701,13-02-2021 06:00,24 hrs.,pennystocks,RNVA,6,6,0,6,1,1,0,1,OTC
4701,13-02-2021 06:00,24 hrs.,pennystocks,RSHN,17,0,17,-17,1,1,11,1,OTC
4701,13-02-2021 06:00,24 hrs.,pennystocks,RSSV,304,7,297,-290,2,112,72,2,OTC
4701,13-02-2021 06:00,24 hrs.,pennystocks,RTON,13,7,6,1,2,2,1,2,OTC
4701,13-02-2021 06:00,24 hrs.,pennystocks,SCIE,6,0,6,-6,1,1,0,1,OTC
4701,13-02-2021 06:00,24 hrs.,pennystocks,SCNA,6,6,0,6,1,1,0,1,OTC
4701,13-02-2021 06:00,24 hrs.,pennystocks,SFOR,15,15,0,15,1,0,11,1,OTC
4701,13-02-2021 06:00,24 hrs.,pennystocks,SGMD,355,67,288,-221,9,112,95,9,OTC
4701,13-02-2021 06:00,24 hrs.,pennystocks,SGSI,6,0,6,-6,1,1,0,1,OTC
4701,13-02-2021 06:00,24 hrs.,pennystocks,NBY,45,45,0,45,1,13,15,1,AMEX
4701,13-02-2021 06:00,24 hrs.,pennystocks,PTN,28,0,28,-28,1,9,6,1,AMEX
4701,13-02-2021 06:00,24 hrs.,pennystocks,TGB,41,6,35,-29,2,13,7,2,AMEX
4701,13-02-2021 06:00,24 hrs.,pennystocks,TRX,15,0,15,-15,2,2,3,2,AMEX
4701,13-02-2021 06:00,24 hrs.,pennystocks,ZOM,91,78,13,65,3,11,57,3,AMEX
4701,13-02-2021 06:00,24 hrs.,pennystocks,GSAT,66,66,0,66,1,15,32,1,AMEX
4701,13-02-2021 06:00,24 hrs.,pennystocks,IBIO,25,25,0,25,1,9,3,1,AMEX
4701,13-02-2021 06:00,24 hrs.,pennystocks,INUV,65,0,65,-65,1,23,15,1,AMEX
4701,13-02-2021 06:00,24 hrs.,pennystocks,NSPR,20,20,0,20,1,6,4,1,AMEX
4701,13-02-2021 06:00,24 hrs.,pennystocks,OGEN,6,6,0,6,1,1,0,1,AMEX
4701,13-02-2021 06:00,24 hrs.,pennystocks,SDPI,6,0,6,-6,1,1,0,1,AMEX
4701,13-02-2021 06:00,24 hrs.,pennystocks,SENS,30,11,19,-8,3,3,12,3,AMEX
4701,13-02-2021 06:00,24 hrs.,pennystocks,TRXC,17,5,12,-7,3,2,1,3,AMEX
4701,13-02-2021 06:00,24 hrs.,pennystocks,UAVS,114,0,114,-114,1,38,34,1,AMEX
4701,13-02-2021 06:00,24 hrs.,pennystocks,XXII,6,0,6,-6,1,0,2,1,AMEX
4701,13-02-2021 06:00,24 hrs.,pennystocks,ACB,19,19,0,19,1,1,13,1,NYSE
4701,13-02-2021 06:00,24 hrs.,pennystocks,AHT,6,0,6,-6,1,1,0,1,NYSE
4701,13-02-2021 06:00,24 hrs.,pennystocks,AMC,82,0,82,-82,5,14,34,5,NYSE
4701,13-02-2021 06:00,24 hrs.,pennystocks,ASX,24,0,24,-24,4,4,0,2,NYSE
4701,13-02-2021 06:00,24 hrs.,pennystocks,ATH,12,0,12,-12,1,3,2,1,NYSE
4701,13-02-2021 06:00,24 hrs.,pennystocks,AXL,5,5,0,5,1,0,1,1,NYSE
4701,13-02-2021 06:00,24 hrs.,pennystocks,CBWTF,13,7,6,1,2,2,1,2,OTC
4701,13-02-2021 06:00,24 hrs.,pennystocks,CIOXY,7,7,0,7,1,1,1,1,OTC
4701,13-02-2021 06:00,24 hrs.,pennystocks,CLUBQ,23,23,0,23,2,5,5,1,OTC
4701,13-02-2021 06:00,24 hrs.,pennystocks,CPHRF,6,6,0,6,1,1,0,1,OTC
4701,13-02-2021 06:00,24 hrs.,pennystocks,CRLBF,103,78,25,53,2,12,71,2,OTC
4701,13-02-2021 06:00,24 hrs.,pennystocks,CWGYF,6,6,0,6,1,1,0,1,OTC
4701,13-02-2021 06:00,24 hrs.,pennystocks,CWSFF,6,6,0,6,1,1,0,1,OTC
4701,13-02-2021 06:00,24 hrs.,pennystocks,DFODQ,22,0,22,-22,1,4,10,1,OTC
4701,13-02-2021 06:00,24 hrs.,pennystocks,DIGAF,7,7,0,7,1,1,1,1,OTC
4701,13-02-2021 06:00,24 hrs.,pennystocks,DMGGF,40,0,40,-40,1,5,26,1,OTC
4701,13-02-2021 06:00,24 hrs.,pennystocks,EHVVF,15,15,0,15,1,0,11,1,OTC
4701,13-02-2021 06:00,24 hrs.,pennystocks,ELRRF,12,6,6,0,2,2,0,2,OTC
4701,13-02-2021 06:00,24 hrs.,pennystocks,EMHTF,6,0,6,-6,1,1,0,1,OTC
4701,13-02-2021 06:00,24 hrs.,pennystocks,EPWCF,14,14,0,14,1,0,10,1,OTC
4701,13-02-2021 06:00,24 hrs.,pennystocks,ERPNF,25,25,0,25,1,9,3,1,OTC
4701,13-02-2021 06:00,24 hrs.,pennystocks,EVKIF,37,0,37,-37,1,12,9,1,OTC
4701,13-02-2021 06:00,24 hrs.,pennystocks,FLWPF,22,0,22,-22,1,4,10,1,OTC
4701,13-02-2021 06:00,24 hrs.,pennystocks,FUNFF,12,0,12,-12,1,3,2,1,OTC
4701,13-02-2021 06:00,24 hrs.,pennystocks,GLDFF,6,0,6,-6,1,1,0,1,OTC
4701,13-02-2021 06:00,24 hrs.,pennystocks,HITIF,2636,1248,1388,-140,12,965,658,11,OTC
4701,13-02-2021 06:00,24 hrs.,pennystocks,SING,32,0,32,-32,2,4,16,2,OTC
4701,13-02-2021 06:00,24 hrs.,pennystocks,SNPW,39,6,33,-27,3,10,7,3,OTC
4701,13-02-2021 06:00,24 hrs.,pennystocks,SNRS,14,0,14,-14,2,2,2,2,OTC
4701,13-02-2021 06:00,24 hrs.,pennystocks,SNWV,12,0,12,-12,2,2,0,1,OTC
4701,13-02-2021 06:00,24 hrs.,pennystocks,SNYR,6,6,0,6,1,1,0,1,OTC
4701,13-02-2021 06:00,24 hrs.,pennystocks,SRMX,216,6,210,-204,8,49,86,7,OTC
4701,13-02-2021 06:00,24 hrs.,pennystocks,SRNA,6,0,6,-6,1,1,0,1,OTC
4701,13-02-2021 06:00,24 hrs.,pennystocks,SSFT,15,15,0,15,1,0,11,1,OTC
4701,13-02-2021 06:00,24 hrs.,pennystocks,SSOK,15,15,0,15,1,0,11,1,OTC
4701,13-02-2021 06:00,24 hrs.,pennystocks,STEV,12,0,12,-12,1,3,2,1,OTC
4701,13-02-2021 06:00,24 hrs.,pennystocks,STWC,9,9,0,9,1,1,3,1,OTC
4701,13-02-2021 06:00,24 hrs.,pennystocks,TCHH,7,0,7,-7,1,1,1,1,OTC
4701,13-02-2021 06:00,24 hrs.,pennystocks,TGHI,11,0,11,-11,1,2,3,1,OTC
4701,13-02-2021 06:00,24 hrs.,pennystocks,TLGN,64,64,0,64,3,15,22,2,OTC
4701,13-02-2021 06:00,24 hrs.,pennystocks,TLSS,90,0,90,-90,2,27,28,2,OTC
4701,13-02-2021 06:00,24 hrs.,pennystocks,TPAC,5099,5099,0,5099,1,2300,495,1,OTC
4701,13-02-2021 06:00,24 hrs.,pennystocks,TSNP,33,27,6,21,3,8,5,3,OTC
4701,13-02-2021 06:00,24 hrs.,pennystocks,TXTM,7,7,0,7,1,1,1,1,OTC
4701,13-02-2021 06:00,24 hrs.,pennystocks,USMJ,42,0,42,-42,2,9,16,2,OTC
4701,13-02-2021 06:00,24 hrs.,pennystocks,USRM,6,0,6,-6,1,1,0,1,OTC
4701,13-02-2021 06:00,24 hrs.,pennystocks,VFRM,6,6,0,6,1,1,0,1,OTC
4701,13-02-2021 06:00,24 hrs.,pennystocks,VPER,56,56,0,56,1,8,36,1,OTC
4701,13-02-2021 06:00,24 hrs.,pennystocks,VPLM,6,0,6,-6,1,1,0,1,OTC
4701,13-02-2021 06:00,24 hrs.,pennystocks,UFO,6,0,6,-6,1,1,0,1,NASDAQ
4701,13-02-2021 06:00,24 hrs.,pennystocks,ABEO,7,0,7,-7,1,1,1,1,NASDAQ
4701,13-02-2021 06:00,24 hrs.,pennystocks,ACST,6,0,6,-6,1,1,0,1,NASDAQ
4701,13-02-2021 06:00,24 hrs.,pennystocks,AGEN,10,10,0,10,1,3,0,1,NASDAQ
4701,13-02-2021 06:00,24 hrs.,pennystocks,AGTC,14,0,14,-14,2,2,2,2,NASDAQ
4701,13-02-2021 06:00,24 hrs.,pennystocks,AIKI,6,6,0,6,1,1,0,1,NASDAQ
4701,13-02-2021 06:00,24 hrs.,pennystocks,AMTX,83,83,0,83,1,30,19,1,NASDAQ
4701,13-02-2021 06:00,24 hrs.,pennystocks,APHA,70,55,15,40,3,22,14,3,NASDAQ
4701,13-02-2021 06:00,24 hrs.,pennystocks,APRE,6,6,0,6,1,1,0,1,NASDAQ
4701,13-02-2021 06:00,24 hrs.,pennystocks,ARTL,51,0,51,-51,5,12,7,3,NASDAQ
4701,13-02-2021 06:00,24 hrs.,pennystocks,ASRT,1953,7,1946,-1939,14,764,369,8,NASDAQ
4701,13-02-2021 06:00,24 hrs.,pennystocks,ATOS,128,6,122,-116,3,44,28,3,NASDAQ
4701,13-02-2021 06:00,24 hrs.,pennystocks,BCLI,5,5,0,5,1,0,1,1,NASDAQ
4701,13-02-2021 06:00,24 hrs.,pennystocks,BIOL,32,32,0,32,2,6,12,2,NASDAQ
4701,13-02-2021 06:00,24 hrs.,pennystocks,BNGO,64,25,39,-14,4,21,6,4,NASDAQ
4701,13-02-2021 06:00,24 hrs.,pennystocks,BWEN,12,12,0,12,2,2,0,2,NASDAQ
4701,13-02-2021 06:00,24 hrs.,pennystocks,BTU,6,0,6,-6,1,1,0,1,NYSE
4701,13-02-2021 06:00,24 hrs.,pennystocks,CBD,30,14,16,-2,4,3,8,4,NYSE
4701,13-02-2021 06:00,24 hrs.,pennystocks,CHS,37,0,37,-37,1,12,9,1,NYSE
4701,13-02-2021 06:00,24 hrs.,pennystocks,CLI,60,60,0,60,1,20,16,1,NYSE
4701,13-02-2021 06:00,24 hrs.,pennystocks,CMD,60,60,0,60,1,20,16,1,NYSE
4701,13-02-2021 06:00,24 hrs.,pennystocks,HRVSF,6,6,0,6,1,1,0,1,OTC
4701,13-02-2021 06:00,24 hrs.,pennystocks,IDXAF,6,0,6,-6,1,1,0,1,OTC
4701,13-02-2021 06:00,24 hrs.,pennystocks,INTEQ,6,6,0,6,1,1,0,1,OTC
4701,13-02-2021 06:00,24 hrs.,pennystocks,KCCFF,27,27,0,27,1,9,5,1,OTC
4701,13-02-2021 06:00,24 hrs.,pennystocks,LLKKF,24,24,0,24,4,4,0,1,OTC
4701,13-02-2021 06:00,24 hrs.,pennystocks,LXXGF,95,0,95,-95,1,20,51,1,OTC
4701,13-02-2021 06:00,24 hrs.,pennystocks,MEDIF,6,0,6,-6,1,1,0,1,OTC
4701,13-02-2021 06:00,24 hrs.,pennystocks,MMEDF,27,27,0,27,1,11,1,1,OTC
4701,13-02-2021 06:00,24 hrs.,pennystocks,MNXXF,58,0,58,-58,3,12,22,2,OTC
4701,13-02-2021 06:00,24 hrs.,pennystocks,NMGRF,12,6,6,0,2,2,0,2,OTC
4701,13-02-2021 06:00,24 hrs.,pennystocks,NOSUF,45,45,0,45,2,11,15,2,OTC
4701,13-02-2021 06:00,24 hrs.,pennystocks,NXTTF,61,49,12,37,4,12,21,4,OTC
4701,13-02-2021 06:00,24 hrs.,pennystocks,OILFF,6,0,6,-6,1,1,0,1,OTC
4701,13-02-2021 06:00,24 hrs.,pennystocks,PFWIQ,96,0,96,-96,1,26,40,1,OTC
4701,13-02-2021 06:00,24 hrs.,pennystocks,PMNXF,6,6,0,6,1,1,0,1,OTC
4701,13-02-2021 06:00,24 hrs.,pennystocks,PYRNF,6,0,6,-6,1,1,0,1,OTC
4701,13-02-2021 06:00,24 hrs.,pennystocks,QYOUF,6,0,6,-6,1,1,0,1,OTC
4701,13-02-2021 06:00,24 hrs.,pennystocks,RAZFF,7,7,0,7,1,1,1,1,OTC
4701,13-02-2021 06:00,24 hrs.,pennystocks,RHDGF,9,0,9,-9,1,1,3,1,OTC
4701,13-02-2021 06:00,24 hrs.,pennystocks,RLFTF,6,0,6,-6,1,1,0,1,OTC
4701,13-02-2021 06:00,24 hrs.,pennystocks,RLLCF,69,0,69,-69,8,12,13,7,OTC
4701,13-02-2021 06:00,24 hrs.,pennystocks,RVVTF,7,0,7,-7,1,1,1,1,OTC
4701,13-02-2021 06:00,24 hrs.,pennystocks,SNNAF,12,0,12,-12,1,3,2,1,OTC
4701,13-02-2021 06:00,24 hrs.,pennystocks,SPFYF,9,0,9,-9,1,1,3,1,OTC
4701,13-02-2021 06:00,24 hrs.,pennystocks,SPMTF,20,0,20,-20,1,2,12,1,OTC
4701,13-02-2021 06:00,24 hrs.,pennystocks,SPRWF,186,6,180,-174,7,64,30,7,OTC
4701,13-02-2021 06:00,24 hrs.,pennystocks,TAKOF,42,42,0,42,1,15,8,1,OTC
4701,13-02-2021 06:00,24 hrs.,pennystocks,TOBAF,25,25,0,25,1,4,13,1,OTC
4701,13-02-2021 06:00,24 hrs.,pennystocks,TSCRF,76,7,69,-62,3,20,24,3,OTC
4701,13-02-2021 06:00,24 hrs.,pennystocks,VRNDF,14,0,14,-14,1,3,4,1,OTC
4701,13-02-2021 06:00,24 hrs.,pennystocks,XELAW,200,0,200,-200,1,89,18,1,OTC
4701,13-02-2021 06:00,24 hrs.,pennystocks,ZBISF,54,0,54,-54,1,20,10,1,OTC
4701,13-02-2021 06:00,24 hrs.,pennystocks,AIM,8,0,8,-8,1,1,2,1,AMEX
4701,13-02-2021 06:00,24 hrs.,pennystocks,CTO,22,0,22,-22,1,1,16,1,AMEX
4701,13-02-2021 06:00,24 hrs.,pennystocks,DNN,56,31,25,6,9,9,2,8,AMEX
4701,13-02-2021 06:00,24 hrs.,pennystocks,DPW,6,6,0,6,1,1,0,1,AMEX
4701,13-02-2021 06:00,24 hrs.,pennystocks,DSS,28,28,0,28,1,8,8,1,AMEX
4701,13-02-2021 06:00,24 hrs.,pennystocks,GSV,7,7,0,7,1,1,1,1,AMEX
4701,13-02-2021 06:00,24 hrs.,pennystocks,GTE,12,12,0,12,2,2,0,2,AMEX
4701,13-02-2021 06:00,24 hrs.,pennystocks,ITP,12,0,12,-12,1,0,8,1,AMEX
4701,13-02-2021 06:00,24 hrs.,pennystocks,MCF,6,6,0,6,1,1,0,1,AMEX
4701,13-02-2021 06:00,24 hrs.,pennystocks,MXC,7,0,7,-7,1,1,1,1,AMEX
4701,13-02-2021 06:00,24 hrs.,pennystocks,NAK,37,0,37,-37,1,9,15,1,AMEX
4701,13-02-2021 06:00,24 hrs.,pennystocks,CRWS,6,0,6,-6,1,1,0,1,NASDAQ
4701,13-02-2021 06:00,24 hrs.,pennystocks,CSCW,7,7,0,7,1,1,1,1,NASDAQ
4701,13-02-2021 06:00,24 hrs.,pennystocks,CSTR,6,0,6,-6,1,1,0,1,NASDAQ
4701,13-02-2021 06:00,24 hrs.,pennystocks,CTHR,18,0,18,-18,1,5,4,1,NASDAQ
4701,13-02-2021 06:00,24 hrs.,pennystocks,CTMX,14,14,0,14,1,2,6,1,NASDAQ
4701,13-02-2021 06:00,24 hrs.,pennystocks,CTRM,60,7,53,-46,5,14,12,5,NASDAQ
4701,13-02-2021 06:00,24 hrs.,pennystocks,CTXR,20,20,0,20,1,6,4,1,NASDAQ
4701,13-02-2021 06:00,24 hrs.,pennystocks,CYTH,8,8,0,8,1,1,2,1,NASDAQ
4701,13-02-2021 06:00,24 hrs.,pennystocks,DFFN,300,183,117,66,7,116,40,6,NASDAQ
4701,13-02-2021 06:00,24 hrs.,pennystocks,EBON,6,0,6,-6,1,1,0,1,NASDAQ
4701,13-02-2021 06:00,24 hrs.,pennystocks,EDIT,200,0,200,-200,1,89,18,1,NASDAQ
4701,13-02-2021 06:00,24 hrs.,pennystocks,ENTX,24,0,24,-24,1,8,4,1,NASDAQ
4701,13-02-2021 06:00,24 hrs.,pennystocks,ENVB,6,0,6,-6,1,1,0,1,NASDAQ
4701,13-02-2021 06:00,24 hrs.,pennystocks,EPSN,12,12,0,12,2,2,0,2,NASDAQ
4701,13-02-2021 06:00,24 hrs.,pennystocks,FAMI,13,0,13,-13,2,2,1,2,NASDAQ
4701,13-02-2021 06:00,24 hrs.,pennystocks,FAST,6,6,0,6,1,1,0,1,NASDAQ
4701,13-02-2021 06:00,24 hrs.,pennystocks,FATE,21,0,21,-21,1,8,1,1,NASDAQ
4701,13-02-2021 06:00,24 hrs.,pennystocks,GAIN,7,0,7,-7,1,1,1,1,NASDAQ
4701,13-02-2021 06:00,24 hrs.,pennystocks,GALT,7,0,7,-7,1,1,1,1,NASDAQ
4701,13-02-2021 06:00,24 hrs.,pennystocks,GEVO,6,6,0,6,1,1,0,1,NASDAQ
4701,13-02-2021 06:00,24 hrs.,pennystocks,GHSI,101,0,101,-101,1,47,3,1,NASDAQ
4701,13-02-2021 06:00,24 hrs.,pennystocks,GLBS,27,27,0,27,1,0,23,1,NASDAQ
4701,13-02-2021 06:00,24 hrs.,pennystocks,GNPX,5,5,0,5,1,0,1,1,NASDAQ
4701,13-02-2021 06:00,24 hrs.,pennystocks,GNUS,6,6,0,6,1,1,0,1,NASDAQ
4701,13-02-2021 06:00,24 hrs.,pennystocks,GOEV,91,0,91,-91,2,27,29,2,NASDAQ
4701,13-02-2021 06:00,24 hrs.,pennystocks,CVE,18,0,18,-18,3,3,0,1,NYSE
4701,13-02-2021 06:00,24 hrs.,pennystocks,CVX,35,0,35,-35,1,12,7,1,NYSE
4701,13-02-2021 06:00,24 hrs.,pennystocks,ETH,6,0,6,-6,1,1,0,1,NYSE
4701,13-02-2021 06:00,24 hrs.,pennystocks,FLT,42,42,0,42,1,15,8,1,NYSE
4701,13-02-2021 06:00,24 hrs.,pennystocks,GME,24,18,6,12,4,4,0,3,NYSE
4701,13-02-2021 06:00,24 hrs.,pennystocks,IRR,27,27,0,27,1,9,5,1,NYSE
4701,13-02-2021 06:00,24 hrs.,pennystocks,KOS,7,7,0,7,1,1,1,1,NYSE
4701,13-02-2021 06:00,24 hrs.,pennystocks,LOW,6,6,0,6,1,1,0,1,NYSE
4701,13-02-2021 06:00,24 hrs.,pennystocks,MDC,17,0,17,-17,1,5,3,1,NYSE
4701,13-02-2021 06:00,24 hrs.,pennystocks,MED,6,6,0,6,1,1,0,1,NYSE
4701,13-02-2021 06:00,24 hrs.,pennystocks,MIN,6,6,0,6,1,1,0,1,NYSE
4701,13-02-2021 06:00,24 hrs.,pennystocks,NAT,7,0,7,-7,1,1,1,1,NYSE
4701,13-02-2021 06:00,24 hrs.,pennystocks,NOK,6,6,0,6,1,1,0,1,NYSE
4701,13-02-2021 06:00,24 hrs.,pennystocks,NPV,27,27,0,27,1,9,5,1,NYSE
4701,13-02-2021 06:00,24 hrs.,pennystocks,RKT,84,0,84,-84,1,26,28,1,NYSE
4701,13-02-2021 06:00,24 hrs.,pennystocks,RSI,271,271,0,271,1,119,29,1,NYSE
4701,13-02-2021 06:00,24 hrs.,pennystocks,SOS,57,51,6,45,5,9,19,5,NYSE
4701,13-02-2021 06:00,24 hrs.,pennystocks,SUM,271,271,0,271,1,119,29,1,NYSE
4701,13-02-2021 06:00,24 hrs.,pennystocks,TSM,43,43,0,43,1,12,15,1,NYSE
4701,13-02-2021 06:00,24 hrs.,pennystocks,VET,7,7,0,7,1,1,1,1,NYSE
4701,13-02-2021 06:00,24 hrs.,pennystocks,WEI,21,0,21,-21,1,8,1,1,NYSE
4701,13-02-2021 06:00,24 hrs.,pennystocks,WLL,6,0,6,-6,1,1,0,1,NYSE
4701,13-02-2021 06:00,24 hrs.,pennystocks,ARGO,40,0,40,-40,1,5,26,1,NYSE
4701,13-02-2021 06:00,24 hrs.,pennystocks,CCIV,7,7,0,7,1,1,1,1,NYSE
4701,13-02-2021 06:00,24 hrs.,pennystocks,FINV,16,16,0,16,1,4,4,1,NYSE
4701,13-02-2021 06:00,24 hrs.,pennystocks,HEXO,25,0,25,-25,1,3,15,1,NYSE
4701,13-02-2021 06:00,24 hrs.,pennystocks,PUMP,13,13,0,13,2,2,1,1,NYSE
4701,13-02-2021 06:00,24 hrs.,pennystocks,SHOP,12,12,0,12,2,2,0,1,NYSE
4701,13-02-2021 06:00,24 hrs.,pennystocks,SPCE,25,25,0,25,1,9,3,1,NYSE
4701,13-02-2021 06:00,24 hrs.,pennystocks,VIST,12,0,12,-12,1,2,4,1,NYSE
4701,13-02-2021 06:00,24 hrs.,pennystocks,WELL,1632,1632,0,1632,1,688,252,1,NYSE
4701,13-02-2021 06:00,24 hrs.,pennystocks,FWP,10,0,10,-10,1,0,6,1,NASDAQ
4701,13-02-2021 06:00,24 hrs.,pennystocks,GBT,6,6,0,6,1,1,0,1,NASDAQ
4701,13-02-2021 06:00,24 hrs.,pennystocks,KOD,6,0,6,-6,1,1,0,1,NASDAQ
4701,13-02-2021 06:00,24 hrs.,pennystocks,MKD,25,0,25,-25,1,7,7,1,NASDAQ
4701,13-02-2021 06:00,24 hrs.,pennystocks,MYT,11,0,11,-11,1,1,5,1,NASDAQ
4701,13-02-2021 06:00,24 hrs.,pennystocks,OGI,28,21,7,14,2,8,4,2,NASDAQ
4701,13-02-2021 06:00,24 hrs.,pennystocks,SND,26,26,0,26,1,5,12,1,NASDAQ
4701,13-02-2021 06:00,24 hrs.,pennystocks,SPI,13,13,0,13,1,3,3,1,NASDAQ
4701,13-02-2021 06:00,24 hrs.,pennystocks,TSLA,6,0,6,-6,1,1,0,1,NASDAQ
4701,13-02-2021 06:00,24 hrs.,pennystocks,TXMD,13,6,7,-1,2,2,1,2,NASDAQ
4701,13-02-2021 06:00,24 hrs.,pennystocks,TYME,20,20,0,20,1,6,4,1,NASDAQ
4701,13-02-2021 06:00,24 hrs.,pennystocks,VEON,7,0,7,-7,1,1,1,1,NASDAQ
4701,13-02-2021 06:00,24 hrs.,pennystocks,VETS,1632,1632,0,1632,1,688,252,1,NASDAQ
4701,13-02-2021 06:00,24 hrs.,pennystocks,VTGN,7,7,0,7,1,1,1,1,NASDAQ
4701,13-02-2021 06:00,24 hrs.,pennystocks,VUZI,5,5,0,5,1,0,1,1,NASDAQ
4701,13-02-2021 06:00,24 hrs.,pennystocks,XELA,200,0,200,-200,1,89,18,1,NASDAQ
4701,13-02-2021 06:00,24 hrs.,pennystocks,XSPA,40,0,40,-40,1,16,4,1,NASDAQ
4701,13-02-2021 06:00,24 hrs.,pennystocks,ZSAN,90,0,90,-90,2,27,28,2,NASDAQ
4701,13-02-2021 06:00,24 hrs.,RobinHoodPennyStocks,BGMD,4,4,0,4,1,0,0,1,OTC
4701,13-02-2021 06:00,24 hrs.,RobinHoodPennyStocks,BLXX,6,0,6,-6,1,1,0,1,OTC
4701,13-02-2021 06:00,24 hrs.,RobinHoodPennyStocks,CAPS,6,0,6,-6,1,1,0,1,OTC
4701,13-02-2021 06:00,24 hrs.,RobinHoodPennyStocks,CBDD,6,0,6,-6,1,1,0,1,OTC
4701,13-02-2021 06:00,24 hrs.,RobinHoodPennyStocks,CRWG,6,6,0,6,1,1,0,1,OTC
4701,13-02-2021 06:00,24 hrs.,RobinHoodPennyStocks,DIGI,6,0,6,-6,1,1,0,1,OTC
4701,13-02-2021 06:00,24 hrs.,RobinHoodPennyStocks,GLEC,6,0,6,-6,1,1,0,1,OTC
4701,13-02-2021 06:00,24 hrs.,RobinHoodPennyStocks,GPFT,34,6,28,-22,5,5,4,3,OTC
4701,13-02-2021 06:00,24 hrs.,RobinHoodPennyStocks,GSPH,6,6,0,6,1,1,0,1,OTC
4701,13-02-2021 06:00,24 hrs.,RobinHoodPennyStocks,GTLL,6,6,0,6,1,1,0,1,OTC
4701,13-02-2021 06:00,24 hrs.,RobinHoodPennyStocks,HCMC,12,6,6,0,2,2,0,2,OTC
4701,13-02-2021 06:00,24 hrs.,RobinHoodPennyStocks,INKW,6,6,0,6,1,1,0,1,OTC
4701,13-02-2021 06:00,24 hrs.,RobinHoodPennyStocks,LTUM,6,0,6,-6,1,1,0,1,OTC
4701,13-02-2021 06:00,24 hrs.,RobinHoodPennyStocks,MJNA,6,0,6,-6,1,1,0,1,OTC
4701,13-02-2021 06:00,24 hrs.,RobinHoodPennyStocks,NUUU,6,6,0,6,1,1,0,1,OTC
4701,13-02-2021 06:00,24 hrs.,RobinHoodPennyStocks,PHIL,6,6,0,6,1,1,0,1,OTC
4701,13-02-2021 06:00,24 hrs.,RobinHoodPennyStocks,ALLIF,6,6,0,6,1,1,0,1,OTC
4701,13-02-2021 06:00,24 hrs.,RobinHoodPennyStocks,BDRBF,12,0,12,-12,2,2,0,2,OTC
4701,13-02-2021 06:00,24 hrs.,RobinHoodPennyStocks,MMEDF,17,17,0,17,1,4,5,1,OTC
4701,13-02-2021 06:00,24 hrs.,pennystocks,GOOG,7,7,0,7,1,0,3,1,NASDAQ
4701,13-02-2021 06:00,24 hrs.,pennystocks,HRTX,15,0,15,-15,1,2,7,1,NASDAQ
4701,13-02-2021 06:00,24 hrs.,pennystocks,HSTO,12,0,12,-12,2,2,0,2,NASDAQ
4701,13-02-2021 06:00,24 hrs.,pennystocks,IBKR,7,7,0,7,1,1,1,1,NASDAQ
4701,13-02-2021 06:00,24 hrs.,pennystocks,IDEX,5,5,0,5,1,0,1,1,NASDAQ
4701,13-02-2021 06:00,24 hrs.,pennystocks,INFI,13,0,13,-13,1,1,7,1,NASDAQ
4701,13-02-2021 06:00,24 hrs.,pennystocks,INOD,67,67,0,67,1,10,43,1,NASDAQ
4701,13-02-2021 06:00,24 hrs.,pennystocks,INPX,6,6,0,6,1,1,0,1,NASDAQ
4701,13-02-2021 06:00,24 hrs.,pennystocks,IRDM,21,0,21,-21,1,8,1,1,NASDAQ
4701,13-02-2021 06:00,24 hrs.,pennystocks,IZEA,6,6,0,6,1,1,0,1,NASDAQ
4701,13-02-2021 06:00,24 hrs.,pennystocks,KTRA,166,45,121,-76,5,47,52,5,NASDAQ
4701,13-02-2021 06:00,24 hrs.,pennystocks,KXIN,21,0,21,-21,1,8,1,1,NASDAQ
4701,13-02-2021 06:00,24 hrs.,pennystocks,LIFE,6,6,0,6,1,1,0,1,NASDAQ
4701,13-02-2021 06:00,24 hrs.,pennystocks,LKCO,9,0,9,-9,1,2,1,1,NASDAQ
4701,13-02-2021 06:00,24 hrs.,pennystocks,LLIT,7,7,0,7,1,1,1,1,NASDAQ
4701,13-02-2021 06:00,24 hrs.,pennystocks,LPCN,56,0,56,-56,1,20,12,1,NASDAQ
4701,13-02-2021 06:00,24 hrs.,pennystocks,LPTH,72,0,72,-72,1,28,12,1,NASDAQ
4701,13-02-2021 06:00,24 hrs.,pennystocks,LPTX,26,26,0,26,1,5,12,1,NASDAQ
4701,13-02-2021 06:00,24 hrs.,pennystocks,MARK,6,6,0,6,1,1,0,1,NASDAQ
4701,13-02-2021 06:00,24 hrs.,pennystocks,MDGS,6,0,6,-6,1,1,0,1,NASDAQ
4701,13-02-2021 06:00,24 hrs.,pennystocks,MOGO,24,24,0,24,1,7,6,1,NASDAQ
4701,13-02-2021 06:00,24 hrs.,pennystocks,MVIS,14,14,0,14,1,0,10,1,NASDAQ
4701,13-02-2021 06:00,24 hrs.,pennystocks,NAKD,857,813,44,769,3,359,127,3,NASDAQ
4701,13-02-2021 06:00,24 hrs.,pennystocks,NAOV,6,0,6,-6,1,1,0,1,NASDAQ
4701,13-02-2021 06:00,24 hrs.,pennystocks,NCMI,13,0,13,-13,1,3,3,1,NASDAQ
4701,13-02-2021 06:00,24 hrs.,pennystocks,NDAQ,21,0,21,-21,1,8,1,1,NASDAQ
4701,13-02-2021 06:00,24 hrs.,pennystocks,NMTR,6,6,0,6,1,1,0,1,NASDAQ
4701,13-02-2021 06:00,24 hrs.,pennystocks,CFMS,12,6,6,0,2,2,0,2,NASDAQ
4701,13-02-2021 06:00,24 hrs.,pennystocks,CIDM,125,30,95,-65,2,29,59,2,NASDAQ
4701,13-02-2021 06:00,24 hrs.,pennystocks,CKPT,27,21,6,15,3,4,7,3,NASDAQ
4701,13-02-2021 06:00,24 hrs.,pennystocks,CLBS,240,121,119,2,5,80,60,5,NASDAQ
4701,13-02-2021 06:00,24 hrs.,pennystocks,CLEU,7,0,7,-7,1,1,1,1,NASDAQ
4701,13-02-2021 06:00,24 hrs.,pennystocks,COCP,37,7,30,-23,2,13,3,2,NASDAQ
4701,13-02-2021 06:00,24 hrs.,pennystocks,CPLP,20,0,20,-20,2,1,10,1,NASDAQ
4701,13-02-2021 06:00,24 hrs.,pennystocks,CRBP,77,77,0,77,1,33,7,1,NASDAQ
4701,13-02-2021 06:00,24 hrs.,RobinHoodPennyStocks,MRO,6,6,0,6,1,1,0,1,NYSE
4701,13-02-2021 06:00,24 hrs.,RobinHoodPennyStocks,MTL,19,19,0,19,2,2,7,2,NYSE
4701,13-02-2021 06:00,24 hrs.,RobinHoodPennyStocks,NAT,6,6,0,6,1,1,0,1,NYSE
4701,13-02-2021 06:00,24 hrs.,RobinHoodPennyStocks,NBB,6,6,0,6,1,1,0,1,NYSE
4701,13-02-2021 06:00,24 hrs.,RobinHoodPennyStocks,PHI,6,6,0,6,1,1,0,1,NYSE
4701,13-02-2021 06:00,24 hrs.,RobinHoodPennyStocks,SOS,94,41,53,-12,3,19,44,3,NYSE
4701,13-02-2021 06:00,24 hrs.,RobinHoodPennyStocks,CCIV,38,0,38,-38,1,10,14,1,NYSE
4701,13-02-2021 06:00,24 hrs.,RobinHoodPennyStocks,PLTR,6,6,0,6,1,1,0,1,NYSE
4701,13-02-2021 06:00,24 hrs.,RobinHoodPennyStocks,BBI,6,0,6,-6,1,1,0,1,NASDAQ
4701,13-02-2021 06:00,24 hrs.,RobinHoodPennyStocks,JFU,6,6,0,6,1,1,0,1,NASDAQ
4701,13-02-2021 06:00,24 hrs.,RobinHoodPennyStocks,OGI,6,0,6,-6,1,1,0,1,NASDAQ
4701,13-02-2021 06:00,24 hrs.,RobinHoodPennyStocks,SND,38,26,12,14,4,9,4,3,NASDAQ
4701,13-02-2021 06:00,24 hrs.,RobinHoodPennyStocks,ABEO,190,119,71,48,3,63,52,3,NASDAQ
4701,13-02-2021 06:00,24 hrs.,RobinHoodPennyStocks,ACRX,20,0,20,-20,1,6,4,1,NASDAQ
4701,13-02-2021 06:00,24 hrs.,RobinHoodPennyStocks,ACST,6,0,6,-6,1,1,0,1,NASDAQ
4701,13-02-2021 06:00,24 hrs.,RobinHoodPennyStocks,ADXS,18,0,18,-18,3,3,0,2,NASDAQ
4701,13-02-2021 06:00,24 hrs.,RobinHoodPennyStocks,AEZS,134,134,0,134,1,54,22,1,NASDAQ
4701,13-02-2021 06:00,24 hrs.,RobinHoodPennyStocks,AGTC,1327,200,1127,-927,18,471,313,16,NASDAQ
4701,13-02-2021 06:00,24 hrs.,RobinHoodPennyStocks,APHA,12,0,12,-12,2,2,0,1,NASDAQ
4701,13-02-2021 06:00,24 hrs.,RobinHoodPennyStocks,ARPO,6,0,6,-6,1,1,0,1,NASDAQ
4701,13-02-2021 06:00,24 hrs.,RobinHoodPennyStocks,ARTL,18,6,12,-6,3,3,0,3,NASDAQ
4701,13-02-2021 06:00,24 hrs.,RobinHoodPennyStocks,ASRT,83,71,12,59,4,31,5,3,NASDAQ
4701,13-02-2021 06:00,24 hrs.,RobinHoodPennyStocks,ATOS,530,7,523,-516,14,191,92,14,NASDAQ
4701,13-02-2021 06:00,24 hrs.,RobinHoodPennyStocks,BHTG,66,66,0,66,2,21,16,2,NASDAQ
4701,13-02-2021 06:00,24 hrs.,RobinHoodPennyStocks,BIOL,6,6,0,6,1,1,0,1,NASDAQ
4701,13-02-2021 06:00,24 hrs.,RobinHoodPennyStocks,BNGO,38,32,6,26,3,9,8,3,NASDAQ
4701,13-02-2021 06:00,24 hrs.,RobinHoodPennyStocks,BRQS,31,0,31,-31,2,5,13,2,NASDAQ
4701,13-02-2021 06:00,24 hrs.,RobinHoodPennyStocks,CDTX,6,6,0,6,1,1,0,1,NASDAQ
4701,13-02-2021 06:00,24 hrs.,RobinHoodPennyStocks,CIDM,79,79,0,79,2,13,45,2,NASDAQ
4701,13-02-2021 06:00,24 hrs.,RobinHoodPennyStocks,CKPT,63,29,34,-5,2,20,15,2,NASDAQ
4701,13-02-2021 06:00,24 hrs.,RobinHoodPennyStocks,CLBS,22,22,0,22,2,6,2,2,NASDAQ
4701,13-02-2021 06:00,24 hrs.,RobinHoodPennyStocks,CRBP,22,22,0,22,1,7,4,1,NASDAQ
4701,13-02-2021 06:00,24 hrs.,RobinHoodPennyStocks,CTRM,460,144,316,-172,10,120,180,10,NASDAQ
4701,13-02-2021 06:00,24 hrs.,RobinHoodPennyStocks,DFFN,839,262,577,-315,9,320,163,8,NASDAQ
4701,13-02-2021 06:00,24 hrs.,RobinHoodPennyStocks,ENTX,62,0,62,-62,1,24,10,1,NASDAQ
4701,13-02-2021 06:00,24 hrs.,pennystocks,NOVN,6,0,6,-6,1,1,0,1,NASDAQ
4701,13-02-2021 06:00,24 hrs.,pennystocks,NVCN,61,12,49,-37,3,18,13,2,NASDAQ
4701,13-02-2021 06:00,24 hrs.,pennystocks,OCGN,64,26,38,-12,4,15,18,4,NASDAQ
4701,13-02-2021 06:00,24 hrs.,pennystocks,ONTX,6,0,6,-6,1,1,0,1,NASDAQ
4701,13-02-2021 06:00,24 hrs.,pennystocks,OPTT,22,0,22,-22,1,7,4,1,NASDAQ
4701,13-02-2021 06:00,24 hrs.,pennystocks,OTIC,10,10,0,10,1,1,4,1,NASDAQ
4701,13-02-2021 06:00,24 hrs.,pennystocks,PLAY,6,6,0,6,1,1,0,1,NASDAQ
4701,13-02-2021 06:00,24 hrs.,pennystocks,PLUG,21,0,21,-21,1,8,1,1,NASDAQ
4701,13-02-2021 06:00,24 hrs.,pennystocks,PSTV,6,0,6,-6,1,1,0,1,NASDAQ
4701,13-02-2021 06:00,24 hrs.,pennystocks,PTON,25,25,0,25,1,9,3,1,NASDAQ
4701,13-02-2021 06:00,24 hrs.,pennystocks,PULM,191,90,101,-11,4,37,101,4,NASDAQ
4701,13-02-2021 06:00,24 hrs.,pennystocks,RIBT,13,13,0,13,2,2,1,1,NASDAQ
4701,13-02-2021 06:00,24 hrs.,pennystocks,RIDE,6,6,0,6,1,1,0,1,NASDAQ
4701,13-02-2021 06:00,24 hrs.,pennystocks,SEAC,12,0,12,-12,1,2,4,1,NASDAQ
4701,13-02-2021 06:00,24 hrs.,pennystocks,SELB,20,20,0,20,1,6,4,1,NASDAQ
4701,13-02-2021 06:00,24 hrs.,pennystocks,SESN,67,67,0,67,1,29,5,1,NASDAQ
4701,13-02-2021 06:00,24 hrs.,pennystocks,SFET,31,25,6,19,2,5,13,2,NASDAQ
4701,13-02-2021 06:00,24 hrs.,pennystocks,SHIP,20,0,20,-20,3,3,2,2,NASDAQ
4701,13-02-2021 06:00,24 hrs.,pennystocks,SNDL,131,38,93,-55,21,21,5,17,NASDAQ
4701,13-02-2021 06:00,24 hrs.,pennystocks,SNGX,2017,97,1920,-1823,17,786,377,9,NASDAQ
4701,13-02-2021 06:00,24 hrs.,pennystocks,SOLO,21,0,21,-21,1,8,1,1,NASDAQ
4701,13-02-2021 06:00,24 hrs.,pennystocks,SRGA,6,0,6,-6,1,1,0,1,NASDAQ
4701,13-02-2021 06:00,24 hrs.,pennystocks,STCN,6,6,0,6,1,1,0,1,NASDAQ
4701,13-02-2021 06:00,24 hrs.,pennystocks,TBLT,173,167,6,161,2,61,43,2,NASDAQ
4701,13-02-2021 06:00,24 hrs.,pennystocks,TLRY,14,0,14,-14,2,2,2,2,NASDAQ
4701,13-02-2021 06:00,24 hrs.,pennystocks,TMDI,6,0,6,-6,1,1,0,1,NASDAQ
4701,13-02-2021 06:00,24 hrs.,pennystocks,TNXP,203,163,40,123,9,59,49,5,NASDAQ
4701,13-02-2021 06:00,24 hrs.,pennystocks,TRCH,231,231,0,231,5,74,63,5,NASDAQ
4701,13-02-2021 06:00,24 hrs.,pennystocks,TRVG,19,7,12,-5,3,3,1,2,NASDAQ
4701,13-02-2021 06:00,24 hrs.,RobinHoodPennyStocks,OCGN,38,0,38,-38,1,10,14,1,NASDAQ
4701,13-02-2021 06:00,24 hrs.,RobinHoodPennyStocks,OPGN,30,6,24,-18,5,5,0,2,NASDAQ
4701,13-02-2021 06:00,24 hrs.,RobinHoodPennyStocks,OPTT,6,0,6,-6,1,1,0,1,NASDAQ
4701,13-02-2021 06:00,24 hrs.,RobinHoodPennyStocks,OVID,6,0,6,-6,1,1,0,1,NASDAQ
4701,13-02-2021 06:00,24 hrs.,RobinHoodPennyStocks,PHUN,6,6,0,6,1,1,0,1,NASDAQ
4701,13-02-2021 06:00,24 hrs.,RobinHoodPennyStocks,PSEC,51,0,51,-51,3,11,17,2,NASDAQ
4701,13-02-2021 06:00,24 hrs.,RobinHoodPennyStocks,PSTV,155,0,155,-155,1,63,25,1,NASDAQ
4701,13-02-2021 06:00,24 hrs.,RobinHoodPennyStocks,RIOT,9,0,9,-9,1,1,3,1,NASDAQ
4701,13-02-2021 06:00,24 hrs.,RobinHoodPennyStocks,SHIP,54,24,30,-6,9,9,0,6,NASDAQ
4701,13-02-2021 06:00,24 hrs.,RobinHoodPennyStocks,SNDL,1426,24,1402,-1378,23,518,298,21,NASDAQ
4701,13-02-2021 06:00,24 hrs.,RobinHoodPennyStocks,SNGX,245,11,234,-223,4,93,43,3,NASDAQ
4701,13-02-2021 06:00,24 hrs.,RobinHoodPennyStocks,SRAX,6,6,0,6,1,1,0,1,NASDAQ
4701,13-02-2021 06:00,24 hrs.,RobinHoodPennyStocks,SRGA,6,0,6,-6,1,1,0,1,NASDAQ
4701,13-02-2021 06:00,24 hrs.,RobinHoodPennyStocks,TBLT,87,0,87,-87,1,28,27,1,NASDAQ
4701,13-02-2021 06:00,24 hrs.,RobinHoodPennyStocks,TNXP,56,0,56,-56,2,15,18,2,NASDAQ
4701,13-02-2021 06:00,24 hrs.,RobinHoodPennyStocks,TRCH,91,51,40,11,3,22,35,2,NASDAQ
4701,13-02-2021 06:00,24 hrs.,RobinHoodPennyStocks,TTOO,36,0,36,-36,1,13,6,1,NASDAQ
4701,13-02-2021 06:00,24 hrs.,RobinHoodPennyStocks,TXMD,36,18,18,0,6,6,0,6,NASDAQ
4701,13-02-2021 06:00,24 hrs.,RobinHoodPennyStocks,TYME,6,6,0,6,1,1,0,1,NASDAQ
4701,13-02-2021 06:00,24 hrs.,RobinHoodPennyStocks,XSPA,25,0,25,-25,1,10,1,1,NASDAQ
4701,13-02-2021 06:00,24 hrs.,RobinHoodPennyStocks,ZSAN,675,0,675,-675,3,287,89,3,NASDAQ
4701,13-02-2021 06:00,24 hrs.,RobinHoodPennyStocks,FCEL,51,0,51,-51,1,9,29,1,NASDAQ
4701,13-02-2021 06:00,24 hrs.,RobinHoodPennyStocks,GAIN,6,6,0,6,1,1,0,1,NASDAQ
4701,13-02-2021 06:00,24 hrs.,RobinHoodPennyStocks,GLBS,6,0,6,-6,1,1,0,1,NASDAQ
4701,13-02-2021 06:00,24 hrs.,RobinHoodPennyStocks,IDEX,13,0,13,-13,1,2,5,1,NASDAQ
4701,13-02-2021 06:00,24 hrs.,RobinHoodPennyStocks,IMMR,17,17,0,17,1,5,3,1,NASDAQ
4701,13-02-2021 06:00,24 hrs.,RobinHoodPennyStocks,INPX,12,12,0,12,2,2,0,1,NASDAQ
4701,13-02-2021 06:00,24 hrs.,RobinHoodPennyStocks,ITRM,6,6,0,6,1,1,0,1,NASDAQ
4701,13-02-2021 06:00,24 hrs.,RobinHoodPennyStocks,KTRA,67,18,49,-31,2,24,11,2,NASDAQ
4701,13-02-2021 06:00,24 hrs.,RobinHoodPennyStocks,LKCO,101,24,77,-53,8,27,15,8,NASDAQ
4701,13-02-2021 06:00,24 hrs.,RobinHoodPennyStocks,MMLP,6,0,6,-6,1,1,0,1,NASDAQ
4701,13-02-2021 06:00,24 hrs.,RobinHoodPennyStocks,NAKD,73,55,18,37,4,22,13,4,NASDAQ
4701,13-02-2021 06:00,24 hrs.,RobinHoodPennyStocks,NMTR,153,153,0,153,1,51,47,1,NASDAQ
4701,13-02-2021 06:00,24 hrs.,RobinHoodPennyStocks,NOVN,45,0,45,-45,1,15,11,1,NASDAQ
4701,13-02-2021 06:00,24 hrs.,RobinHoodPennyStocks,NVCN,64,64,0,64,2,16,24,2,NASDAQ
4701,13-02-2021 06:00,24 hrs.,RobinHoodPennyStocks,NXTTF,6,6,0,6,1,1,0,1,OTC
4701,13-02-2021 06:00,24 hrs.,RobinHoodPennyStocks,PMEDF,6,0,6,-6,1,1,0,1,OTC
4701,13-02-2021 06:00,24 hrs.,RobinHoodPennyStocks,RYCEY,18,6,12,-6,3,3,0,3,OTC
4701,13-02-2021 06:00,24 hrs.,RobinHoodPennyStocks,SHCAY,21,0,21,-21,1,8,1,1,OTC
4701,13-02-2021 06:00,24 hrs.,RobinHoodPennyStocks,ZBISF,6,6,0,6,1,1,0,1,OTC
4701,13-02-2021 06:00,24 hrs.,RobinHoodPennyStocks,DNN,114,108,6,102,4,39,20,4,AMEX
4701,13-02-2021 06:00,24 hrs.,RobinHoodPennyStocks,DPW,19,19,0,19,1,3,9,1,AMEX
4701,13-02-2021 06:00,24 hrs.,RobinHoodPennyStocks,GSV,12,6,6,0,2,2,0,2,AMEX
4701,13-02-2021 06:00,24 hrs.,RobinHoodPennyStocks,GTE,614,155,459,-304,15,168,218,15,AMEX
4701,13-02-2021 06:00,24 hrs.,RobinHoodPennyStocks,ITP,6,0,6,-6,1,1,0,1,AMEX
4701,13-02-2021 06:00,24 hrs.,RobinHoodPennyStocks,NAK,87,63,24,39,6,16,31,6,AMEX
4701,13-02-2021 06:00,24 hrs.,RobinHoodPennyStocks,REI,26,26,0,26,2,7,4,2,AMEX
4701,13-02-2021 06:00,24 hrs.,RobinHoodPennyStocks,SYN,6,6,0,6,1,1,0,1,AMEX
4701,13-02-2021 06:00,24 hrs.,RobinHoodPennyStocks,TGB,6,0,6,-6,1,1,0,1,AMEX
4701,13-02-2021 06:00,24 hrs.,RobinHoodPennyStocks,TRX,38,0,38,-38,1,9,16,1,AMEX
4701,13-02-2021 06:00,24 hrs.,RobinHoodPennyStocks,XPL,6,6,0,6,1,1,0,1,AMEX
4701,13-02-2021 06:00,24 hrs.,RobinHoodPennyStocks,ZOM,1228,125,1103,-978,10,460,268,10,AMEX
4701,13-02-2021 06:00,24 hrs.,RobinHoodPennyStocks,IBIO,37,37,0,37,1,14,5,1,AMEX
4701,13-02-2021 06:00,24 hrs.,RobinHoodPennyStocks,NSPR,30,0,30,-30,1,8,10,1,AMEX
4701,13-02-2021 06:00,24 hrs.,RobinHoodPennyStocks,OGEN,18,0,18,-18,3,3,0,3,AMEX
4701,13-02-2021 06:00,24 hrs.,RobinHoodPennyStocks,SENS,59,6,53,-47,3,21,5,3,AMEX
4701,13-02-2021 06:00,24 hrs.,RobinHoodPennyStocks,TRXC,12,0,12,-12,2,2,0,2,AMEX
4701,13-02-2021 06:00,24 hrs.,RobinHoodPennyStocks,AIV,6,0,6,-6,1,1,0,1,NYSE
4701,13-02-2021 06:00,24 hrs.,RobinHoodPennyStocks,DNK,6,6,0,6,1,1,0,1,NYSE
4701,13-02-2021 06:00,24 hrs.,RobinHoodPennyStocks,ETN,6,6,0,6,1,1,0,1,NYSE
4701,13-02-2021 06:00,24 hrs.,RobinHoodPennyStocks,FSR,6,0,6,-6,1,1,0,1,NYSE
4701,13-02-2021 06:00,24 hrs.,RobinHoodPennyStocks,GME,57,57,0,57,2,13,23,2,NYSE
4701,13-02-2021 06:00,24 hrs.,RobinHoodPennyStocks,IRS,309,0,309,-309,1,140,25,1,NYSE
4701,13-02-2021 06:00,24 hrs.,RobinHoodPennyStocks,LOW,6,0,6,-6,1,1,0,1,NYSE
4678,13-02-2021 02:00,24 hrs.,stocks,KYNC,18,0,18,-18,3,3,0,1,OTC
4678,13-02-2021 02:00,24 hrs.,stocks,LINK,8,0,8,-8,1,1,2,1,OTC
4678,13-02-2021 02:00,24 hrs.,stocks,MCAP,6,6,0,6,1,1,0,1,OTC
4678,13-02-2021 02:00,24 hrs.,stocks,MINE,6,6,0,6,1,1,0,1,OTC
4678,13-02-2021 02:00,24 hrs.,stocks,MJNA,6,6,0,6,1,1,0,1,OTC
4678,13-02-2021 02:00,24 hrs.,stocks,MOJO,6,0,6,-6,1,1,0,1,OTC
4678,13-02-2021 02:00,24 hrs.,stocks,NTRR,6,6,0,6,1,1,0,1,OTC
4678,13-02-2021 02:00,24 hrs.,stocks,OZSC,6,6,0,6,1,1,0,1,OTC
4678,13-02-2021 02:00,24 hrs.,stocks,PZOO,6,0,6,-6,1,1,0,1,OTC
4678,13-02-2021 02:00,24 hrs.,stocks,RSSV,17,17,0,17,1,5,3,1,OTC
4678,13-02-2021 02:00,24 hrs.,stocks,SNYR,6,6,0,6,1,1,0,1,OTC
4678,13-02-2021 02:00,24 hrs.,stocks,SSET,7,7,0,7,1,1,1,1,OTC
4678,13-02-2021 02:00,24 hrs.,stocks,SUIC,6,0,6,-6,1,1,0,1,OTC
4678,13-02-2021 02:00,24 hrs.,stocks,TMRC,6,6,0,6,1,1,0,1,OTC
4678,13-02-2021 02:00,24 hrs.,stocks,ACRDF,6,0,6,-6,1,1,0,1,OTC
4678,13-02-2021 02:00,24 hrs.,stocks,ACRHF,6,0,6,-6,1,1,0,1,OTC
4678,13-02-2021 02:00,24 hrs.,stocks,BDRBF,6,6,0,6,1,1,0,1,OTC
4678,13-02-2021 02:00,24 hrs.,stocks,DGTHF,6,6,0,6,1,1,0,1,OTC
4678,13-02-2021 02:00,24 hrs.,stocks,EMHTF,6,6,0,6,1,1,0,1,OTC
4678,13-02-2021 02:00,24 hrs.,stocks,HRSTW,6,6,0,6,1,1,0,1,OTC
4678,13-02-2021 02:00,24 hrs.,stocks,ILIKF,6,6,0,6,1,1,0,1,OTC
4678,13-02-2021 02:00,24 hrs.,stocks,MMEDF,12,12,0,12,2,2,0,1,OTC
4678,13-02-2021 02:00,24 hrs.,stocks,NXTTF,6,6,0,6,1,1,0,1,OTC
4678,13-02-2021 02:00,24 hrs.,stocks,OILFF,6,6,0,6,1,1,0,1,OTC
4678,13-02-2021 02:00,24 hrs.,stocks,RHDGF,6,6,0,6,1,1,0,1,OTC
4678,13-02-2021 02:00,24 hrs.,stocks,RHHBY,25,25,0,25,1,8,5,1,OTC
4678,13-02-2021 02:00,24 hrs.,stocks,RLLCF,12,6,6,0,2,2,0,2,OTC
4678,13-02-2021 02:00,24 hrs.,stocks,RVVTF,13,13,0,13,2,2,1,2,OTC
4678,13-02-2021 02:00,24 hrs.,stocks,TBUIF,6,6,0,6,1,1,0,1,OTC
4678,13-02-2021 02:00,24 hrs.,stocks,DNN,31,31,0,31,1,7,13,1,AMEX
4678,13-02-2021 02:00,24 hrs.,stocks,DSS,6,6,0,6,1,1,0,1,AMEX
4678,13-02-2021 02:00,24 hrs.,stocks,GDP,33,0,33,-33,1,5,19,1,AMEX
4678,13-02-2021 02:00,24 hrs.,stocks,GTE,13,13,0,13,2,2,1,2,AMEX
4678,13-02-2021 02:00,24 hrs.,stocks,IGC,6,6,0,6,1,1,0,1,AMEX
4678,13-02-2021 02:00,24 hrs.,stocks,MXC,6,0,6,-6,1,1,0,1,AMEX
4678,13-02-2021 02:00,24 hrs.,stocks,PLX,12,12,0,12,1,2,4,1,AMEX
4678,13-02-2021 02:00,24 hrs.,stocks,ZOM,24,6,18,-12,4,4,0,4,AMEX
4678,13-02-2021 02:00,24 hrs.,stocks,GSAT,24,24,0,24,4,4,0,2,AMEX
4678,13-02-2021 02:00,24 hrs.,stocks,TMBR,6,0,6,-6,1,1,0,1,AMEX
4678,13-02-2021 02:00,24 hrs.,stocks,ACB,6,0,6,-6,1,1,0,1,NYSE
4678,13-02-2021 02:00,24 hrs.,stocks,ADT,6,6,0,6,1,1,0,1,NYSE
4678,13-02-2021 02:00,24 hrs.,stocks,AMC,206,100,106,-6,9,45,80,9,NYSE
4678,13-02-2021 02:00,24 hrs.,stocks,ASX,7,7,0,7,1,1,1,1,NYSE
4678,13-02-2021 02:00,24 hrs.,stocks,ATH,33,0,33,-33,1,5,19,1,NYSE
4678,13-02-2021 02:00,24 hrs.,stocks,BEP,171,171,0,171,5,36,79,5,NYSE
4678,13-02-2021 02:00,24 hrs.,stocks,BHC,8,0,8,-8,1,1,2,1,NYSE
4678,13-02-2021 02:00,24 hrs.,stocks,BTT,6,0,6,-6,1,1,0,1,NYSE
4678,13-02-2021 02:00,24 hrs.,stocks,CBD,6,6,0,6,1,1,0,1,NYSE
4678,13-02-2021 02:00,24 hrs.,stocks,CRM,6,0,6,-6,1,1,0,1,NYSE
4678,13-02-2021 02:00,24 hrs.,stocks,CVE,6,0,6,-6,1,1,0,1,NYSE
4678,13-02-2021 02:00,24 hrs.,stocks,CVS,32,32,0,32,3,5,10,3,NYSE
4678,13-02-2021 02:00,24 hrs.,stocks,DIS,8,0,8,-8,1,1,2,1,NYSE
4678,13-02-2021 02:00,24 hrs.,stocks,DPG,7,7,0,7,1,1,1,1,NYSE
4678,13-02-2021 02:00,24 hrs.,stocks,ETH,6,0,6,-6,1,1,0,1,NYSE
4678,13-02-2021 02:00,24 hrs.,stocks,FCF,33,0,33,-33,1,5,19,1,NYSE
4678,13-02-2021 02:00,24 hrs.,stocks,FCX,6,0,6,-6,1,1,0,1,NYSE
4678,13-02-2021 02:00,24 hrs.,stocks,FSR,32,6,26,-20,2,12,0,2,NYSE
4678,13-02-2021 02:00,24 hrs.,stocks,GME,1008,672,336,336,19,313,306,18,NYSE
4678,13-02-2021 02:00,24 hrs.,stocks,LUV,58,0,58,-58,1,13,28,1,NYSE
4678,13-02-2021 02:00,24 hrs.,stocks,MCO,8,0,8,-8,1,1,2,1,NYSE
4678,13-02-2021 02:00,24 hrs.,stocks,MFA,8,0,8,-8,1,1,2,1,NYSE
4678,13-02-2021 02:00,24 hrs.,stocks,MGM,9,9,0,9,1,1,3,1,NYSE
4678,13-02-2021 02:00,24 hrs.,stocks,MRO,8,0,8,-8,1,1,2,1,NYSE
4678,13-02-2021 02:00,24 hrs.,stocks,NET,11,11,0,11,1,1,5,1,NYSE
4678,13-02-2021 02:00,24 hrs.,stocks,NGL,6,0,6,-6,1,1,0,1,NYSE
4678,13-02-2021 02:00,24 hrs.,stocks,NIO,771,771,0,771,9,237,261,6,NYSE
4678,13-02-2021 02:00,24 hrs.,stocks,NOK,134,134,0,134,3,21,80,3,NYSE
4678,13-02-2021 02:00,24 hrs.,stocks,NOM,76,0,76,-76,1,28,16,1,NYSE
4678,13-02-2021 02:00,24 hrs.,stocks,OSK,16,16,0,16,2,1,6,1,NYSE
4678,13-02-2021 02:00,24 hrs.,stocks,PDT,6,0,6,-6,1,1,0,1,NYSE
4678,13-02-2021 02:00,24 hrs.,stocks,PEG,434,434,0,434,1,29,372,1,NYSE
4678,13-02-2021 02:00,24 hrs.,stocks,PFE,7,7,0,7,1,1,1,1,NYSE
4678,13-02-2021 02:00,24 hrs.,stocks,RAD,15,15,0,15,1,3,5,1,NYSE
4678,13-02-2021 02:00,24 hrs.,stocks,RDY,6,6,0,6,1,1,0,1,NYSE
4678,13-02-2021 02:00,24 hrs.,stocks,RKT,108,0,108,-108,1,43,18,1,NYSE
4678,13-02-2021 02:00,24 hrs.,stocks,RTX,34,34,0,34,1,9,12,1,NYSE
4678,13-02-2021 02:00,24 hrs.,stocks,SBE,6,0,6,-6,1,1,0,1,NYSE
4678,13-02-2021 02:00,24 hrs.,stocks,SOI,6,0,6,-6,1,1,0,1,NYSE
4678,13-02-2021 02:00,24 hrs.,stocks,SOS,24,6,18,-12,4,4,0,4,NYSE
4678,13-02-2021 02:00,24 hrs.,stocks,SUP,6,6,0,6,1,1,0,1,NYSE
4678,13-02-2021 02:00,24 hrs.,stocks,TSM,54,54,0,54,1,11,28,1,NYSE
4678,13-02-2021 02:00,24 hrs.,stocks,UBS,20635,20635,0,20635,1,10071,489,1,NYSE
4678,13-02-2021 02:00,24 hrs.,stocks,WLL,6,0,6,-6,1,1,0,1,NYSE
4678,13-02-2021 02:00,24 hrs.,stocks,WMT,104,104,0,104,1,32,36,1,NYSE
4678,13-02-2021 02:00,24 hrs.,stocks,AJRD,104,104,0,104,1,32,36,1,NYSE
4678,13-02-2021 02:00,24 hrs.,stocks,APTV,104,104,0,104,1,32,36,1,NYSE
4678,13-02-2021 02:00,24 hrs.,stocks,BEPC,33,33,0,33,2,3,19,2,NYSE
4678,13-02-2021 02:00,24 hrs.,stocks,BORR,53,47,6,41,3,14,13,3,NYSE
4678,13-02-2021 02:00,24 hrs.,stocks,CCIV,6,6,0,6,1,1,0,1,NYSE
4678,13-02-2021 02:00,24 hrs.,stocks,CHWY,17,17,0,17,1,4,5,1,NYSE
4678,13-02-2021 02:00,24 hrs.,stocks,COTY,6,6,0,6,1,1,0,1,NYSE
4678,13-02-2021 02:00,24 hrs.,stocks,DASH,6,6,0,6,1,1,0,1,NYSE
4678,13-02-2021 02:00,24 hrs.,stocks,FTCH,29,0,29,-29,1,6,13,1,NYSE
4678,13-02-2021 02:00,24 hrs.,stocks,FUSE,6,6,0,6,1,1,0,1,NYSE
4678,13-02-2021 02:00,24 hrs.,stocks,FVRR,29,0,29,-29,1,6,13,1,NYSE
4678,13-02-2021 02:00,24 hrs.,stocks,HEXO,6,6,0,6,1,1,0,1,NYSE
4678,13-02-2021 02:00,24 hrs.,stocks,HOME,17,17,0,17,1,4,5,1,NYSE
4678,13-02-2021 02:00,24 hrs.,stocks,HUYA,89,6,83,-77,2,29,23,2,NYSE
4678,13-02-2021 02:00,24 hrs.,stocks,JMIA,6,6,0,6,1,1,0,1,NYSE
4678,13-02-2021 02:00,24 hrs.,stocks,PLTR,433,427,6,421,4,136,145,4,NYSE
4678,13-02-2021 02:00,24 hrs.,stocks,SHOP,43,43,0,43,1,11,17,1,NYSE
4678,13-02-2021 02:00,24 hrs.,stocks,SPCE,130,123,7,116,3,37,44,3,NYSE
4678,13-02-2021 02:00,24 hrs.,stocks,TWLO,16,16,0,16,2,1,6,1,NYSE
4678,13-02-2021 02:00,24 hrs.,stocks,TWTR,6,6,0,6,1,1,0,1,NYSE
4678,13-02-2021 02:00,24 hrs.,stocks,VGAC,6,6,0,6,1,1,0,1,NYSE
4678,13-02-2021 02:00,24 hrs.,stocks,XPEV,77,77,0,77,5,11,35,2,NYSE
4678,13-02-2021 02:00,24 hrs.,stocks,YETI,58,0,58,-58,1,13,28,1,NYSE
4678,13-02-2021 02:00,24 hrs.,stocks,AAL,23,0,23,-23,1,3,13,1,NASDAQ
4678,13-02-2021 02:00,24 hrs.,stocks,AMD,60,60,0,60,2,12,28,2,NASDAQ
4678,13-02-2021 02:00,24 hrs.,stocks,AZN,8,0,8,-8,1,1,2,1,NASDAQ
4678,13-02-2021 02:00,24 hrs.,stocks,CDC,8,0,8,-8,1,1,2,1,NASDAQ
4678,13-02-2021 02:00,24 hrs.,stocks,FTC,33,33,0,33,1,10,9,1,NASDAQ
4678,13-02-2021 02:00,24 hrs.,stocks,GAN,7,7,0,7,1,1,1,1,NASDAQ
4678,13-02-2021 02:00,24 hrs.,stocks,GSM,58,58,0,58,2,19,12,1,NASDAQ
4678,13-02-2021 02:00,24 hrs.,stocks,IEA,14,14,0,14,1,2,6,1,NASDAQ
4678,13-02-2021 02:00,24 hrs.,stocks,INO,6,6,0,6,1,1,0,1,NASDAQ
4678,13-02-2021 02:00,24 hrs.,stocks,FRCH,6,6,0,6,1,1,0,1,OTC
4678,13-02-2021 02:00,24 hrs.,stocks,GRYN,6,6,0,6,1,1,0,1,OTC
4678,13-02-2021 02:00,24 hrs.,stocks,GTEH,6,6,0,6,1,1,0,1,OTC
4678,13-02-2021 02:00,24 hrs.,stocks,HCMC,28,22,6,16,3,3,10,3,OTC
4678,13-02-2021 02:00,24 hrs.,stocks,HEMP,6,0,6,-6,1,1,0,1,OTC
4678,13-02-2021 02:00,24 hrs.,stocks,IGEN,6,6,0,6,1,1,0,1,OTC
4678,13-02-2021 02:00,24 hrs.,stocks,SPI,6,6,0,6,1,1,0,1,NASDAQ
4678,13-02-2021 02:00,24 hrs.,stocks,WBA,15,15,0,15,1,3,5,1,NASDAQ
4678,13-02-2021 02:00,24 hrs.,stocks,ABIO,6,0,6,-6,1,1,0,1,NASDAQ
4678,13-02-2021 02:00,24 hrs.,stocks,ABUS,6,0,6,-6,1,1,0,1,NASDAQ
4678,13-02-2021 02:00,24 hrs.,stocks,AEZS,173,173,0,173,1,77,15,1,NASDAQ
4678,13-02-2021 02:00,24 hrs.,stocks,AGEN,10,10,0,10,1,3,0,1,NASDAQ
4678,13-02-2021 02:00,24 hrs.,stocks,AGTC,18,12,6,6,3,3,0,2,NASDAQ
4678,13-02-2021 02:00,24 hrs.,stocks,AMZN,117,117,0,117,2,33,43,2,NASDAQ
4678,13-02-2021 02:00,24 hrs.,stocks,APHA,842,82,760,-678,7,218,378,7,NASDAQ
4678,13-02-2021 02:00,24 hrs.,stocks,APXT,6,0,6,-6,1,1,0,1,NASDAQ
4678,13-02-2021 02:00,24 hrs.,stocks,ARTL,18,0,18,-18,3,3,0,2,NASDAQ
4678,13-02-2021 02:00,24 hrs.,stocks,ASYS,6,0,6,-6,1,1,0,1,NASDAQ
4678,13-02-2021 02:00,24 hrs.,stocks,ATOS,173,173,0,173,1,77,15,1,NASDAQ
4678,13-02-2021 02:00,24 hrs.,stocks,AVGO,6,6,0,6,1,1,0,1,NASDAQ
4678,13-02-2021 02:00,24 hrs.,stocks,BNGO,6,6,0,6,1,1,0,1,NASDAQ
4678,13-02-2021 02:00,24 hrs.,stocks,BYND,6,6,0,6,1,1,0,1,NASDAQ
4678,13-02-2021 02:00,24 hrs.,stocks,CLEU,7,0,7,-7,1,1,1,1,NASDAQ
4678,13-02-2021 02:00,24 hrs.,stocks,CLSK,7,0,7,-7,1,1,1,1,NASDAQ
4678,13-02-2021 02:00,24 hrs.,stocks,CLVR,17,17,0,17,1,3,7,1,NASDAQ
4678,13-02-2021 02:00,24 hrs.,stocks,CMPS,12,0,12,-12,2,2,0,1,NASDAQ
4678,13-02-2021 02:00,24 hrs.,stocks,CNDT,15,0,15,-15,1,3,5,1,NASDAQ
4678,13-02-2021 02:00,24 hrs.,stocks,COHR,8,0,8,-8,1,1,2,1,NASDAQ
4678,13-02-2021 02:00,24 hrs.,stocks,CPST,6,6,0,6,1,1,0,1,NASDAQ
4678,13-02-2021 02:00,24 hrs.,stocks,CRBP,7,7,0,7,1,1,1,1,NASDAQ
4678,13-02-2021 02:00,24 hrs.,stocks,CRON,56,56,0,56,1,13,26,1,NASDAQ
4678,13-02-2021 02:00,24 hrs.,stocks,CRSP,104,104,0,104,1,32,36,1,NASDAQ
4678,13-02-2021 02:00,24 hrs.,stocks,CRWD,104,104,0,104,1,32,36,1,NASDAQ
4678,13-02-2021 02:00,24 hrs.,stocks,CTRM,25,13,12,1,4,4,1,4,NASDAQ
4678,13-02-2021 02:00,24 hrs.,stocks,CVLB,6,0,6,-6,1,1,0,1,NASDAQ
4678,13-02-2021 02:00,24 hrs.,stocks,DDOG,8,0,8,-8,1,1,2,1,NASDAQ
4678,13-02-2021 02:00,24 hrs.,stocks,DFFN,15,6,9,-3,2,3,1,2,NASDAQ
4678,13-02-2021 02:00,24 hrs.,stocks,DOCU,6,0,6,-6,1,1,0,1,NASDAQ
4678,13-02-2021 02:00,24 hrs.,stocks,EDIT,433,433,0,433,3,145,131,3,NASDAQ
4678,13-02-2021 02:00,24 hrs.,stocks,ENPH,104,104,0,104,1,32,36,1,NASDAQ
4678,13-02-2021 02:00,24 hrs.,stocks,ENTX,7,0,7,-7,1,1,1,1,NASDAQ
4678,13-02-2021 02:00,24 hrs.,stocks,ETSY,29,0,29,-29,1,6,13,1,NASDAQ
4678,13-02-2021 02:00,24 hrs.,stocks,EXPE,8,0,8,-8,1,1,2,1,NASDAQ
4678,13-02-2021 02:00,24 hrs.,stocks,EXPI,6,6,0,6,1,1,0,1,NASDAQ
4678,13-02-2021 02:00,24 hrs.,stocks,FNKO,18,18,0,18,1,6,2,1,NASDAQ
4678,13-02-2021 02:00,24 hrs.,stocks,GILT,6,6,0,6,1,1,0,1,NASDAQ
4678,13-02-2021 02:00,24 hrs.,stocks,GLUU,7,7,0,7,1,1,1,1,NASDAQ
4678,13-02-2021 02:00,24 hrs.,stocks,GNUS,6,0,6,-6,1,1,0,1,NASDAQ
4678,13-02-2021 02:00,24 hrs.,stocks,GOEV,121,121,0,121,1,19,79,1,NASDAQ
4678,13-02-2021 02:00,24 hrs.,stocks,HTBX,6,0,6,-6,1,1,0,1,NASDAQ
4678,13-02-2021 02:00,24 hrs.,stocks,ICLN,97,97,0,97,1,31,31,1,NASDAQ
4678,13-02-2021 02:00,24 hrs.,stocks,IIVI,8,0,8,-8,1,1,2,1,NASDAQ
4678,13-02-2021 02:00,24 hrs.,stocks,ILMN,14,14,0,14,1,4,2,1,NASDAQ
4678,13-02-2021 02:00,24 hrs.,stocks,INPX,18,0,18,-18,3,3,0,1,NASDAQ
4678,13-02-2021 02:00,24 hrs.,stocks,INTC,103,103,0,103,1,34,31,1,NASDAQ
4678,13-02-2021 02:00,24 hrs.,stocks,INVE,7,7,0,7,1,1,1,1,NASDAQ
4678,13-02-2021 02:00,24 hrs.,stocks,ITRM,9,9,0,9,1,2,1,1,NASDAQ
4678,13-02-2021 02:00,24 hrs.,stocks,LITE,8,0,8,-8,1,1,2,1,NASDAQ
4678,13-02-2021 02:00,24 hrs.,stocks,LIVE,8,0,8,-8,1,1,2,1,NASDAQ
4678,13-02-2021 02:00,24 hrs.,stocks,LKCO,12,12,0,12,2,2,0,1,NASDAQ
4678,13-02-2021 02:00,24 hrs.,stocks,LLNW,25,25,0,25,1,6,9,1,NASDAQ
4678,13-02-2021 02:00,24 hrs.,stocks,LMPX,18,18,0,18,1,6,2,1,NASDAQ
4678,13-02-2021 02:00,24 hrs.,stocks,LRCX,54,54,0,54,1,11,28,1,NASDAQ
4678,13-02-2021 02:00,24 hrs.,stocks,MITK,6,6,0,6,1,1,0,1,NASDAQ
4678,13-02-2021 02:00,24 hrs.,stocks,IBM,235,235,0,235,1,97,37,1,NYSE
4678,13-02-2021 02:00,24 hrs.,stocks,ICE,33,0,33,-33,1,5,19,1,NYSE
4678,13-02-2021 02:00,24 hrs.,stocks,IRS,65,0,65,-65,1,25,11,1,NYSE
4678,13-02-2021 02:00,24 hrs.,stocks,KEY,100,0,100,-100,1,40,16,1,NYSE
4678,13-02-2021 02:00,24 hrs.,stocks,LEN,6,0,6,-6,1,1,0,1,NYSE
4678,13-02-2021 02:00,24 hrs.,stocks,LMT,6,0,6,-6,1,1,0,1,NYSE
4678,13-02-2021 02:00,24 hrs.,stocks,NCMI,64,64,0,64,2,24,8,1,NASDAQ
4678,13-02-2021 02:00,24 hrs.,stocks,NKLA,6,6,0,6,1,1,0,1,NASDAQ
4678,13-02-2021 02:00,24 hrs.,stocks,NMTR,9,9,0,9,1,1,3,1,NASDAQ
4678,13-02-2021 02:00,24 hrs.,stocks,NVDA,125,96,29,67,4,28,53,4,NASDAQ
4678,13-02-2021 02:00,24 hrs.,stocks,NXTD,12,0,12,-12,2,2,0,1,NASDAQ
4678,13-02-2021 02:00,24 hrs.,stocks,NYMT,8,0,8,-8,1,1,2,1,NASDAQ
4678,13-02-2021 02:00,24 hrs.,stocks,OCSL,12,12,0,12,2,2,0,1,NASDAQ
4678,13-02-2021 02:00,24 hrs.,stocks,OLED,112,0,112,-112,1,49,10,1,NASDAQ
4678,13-02-2021 02:00,24 hrs.,stocks,ONTX,6,6,0,6,1,1,0,1,NASDAQ
4678,13-02-2021 02:00,24 hrs.,stocks,ONVO,6,6,0,6,1,1,0,1,NASDAQ
4678,13-02-2021 02:00,24 hrs.,stocks,PAAS,6,6,0,6,1,1,0,1,NASDAQ
4678,13-02-2021 02:00,24 hrs.,stocks,PHUN,6,6,0,6,1,1,0,1,NASDAQ
4678,13-02-2021 02:00,24 hrs.,stocks,PLUG,127,127,0,127,2,20,79,2,NASDAQ
4678,13-02-2021 02:00,24 hrs.,stocks,PSTV,6,0,6,-6,1,1,0,1,NASDAQ
4678,13-02-2021 02:00,24 hrs.,stocks,QCLN,97,97,0,97,1,31,31,1,NASDAQ
4678,13-02-2021 02:00,24 hrs.,stocks,QDEL,6,6,0,6,1,1,0,1,NASDAQ
4678,13-02-2021 02:00,24 hrs.,stocks,QFIN,6,6,0,6,1,1,0,1,NASDAQ
4678,13-02-2021 02:00,24 hrs.,stocks,QQQJ,21,21,0,21,1,1,15,1,NASDAQ
4678,13-02-2021 02:00,24 hrs.,stocks,QQQM,50,21,29,-8,2,6,30,2,NASDAQ
4678,13-02-2021 02:00,24 hrs.,stocks,SABR,58,0,58,-58,1,13,28,1,NASDAQ
4678,13-02-2021 02:00,24 hrs.,stocks,SEDG,104,104,0,104,1,32,36,1,NASDAQ
4678,13-02-2021 02:00,24 hrs.,stocks,SEEL,12,0,12,-12,2,2,0,1,NASDAQ
4678,13-02-2021 02:00,24 hrs.,stocks,SESN,7,7,0,7,1,1,1,1,NASDAQ
4678,13-02-2021 02:00,24 hrs.,stocks,SHIP,11,11,0,11,1,2,3,1,NASDAQ
4678,13-02-2021 02:00,24 hrs.,stocks,SNDL,49,24,25,-1,8,8,1,7,NASDAQ
4678,13-02-2021 02:00,24 hrs.,stocks,SNGX,36,25,11,14,5,7,2,5,NASDAQ
4678,13-02-2021 02:00,24 hrs.,stocks,SRAC,14,6,8,-2,2,3,0,2,NASDAQ
4678,13-02-2021 02:00,24 hrs.,stocks,SRNE,104,104,0,104,1,32,36,1,NASDAQ
4678,13-02-2021 02:00,24 hrs.,stocks,SVMK,8,0,8,-8,1,1,2,1,NASDAQ
4678,13-02-2021 02:00,24 hrs.,stocks,SWKS,54,54,0,54,1,11,28,1,NASDAQ
4678,13-02-2021 02:00,24 hrs.,stocks,TIGR,6,6,0,6,1,1,0,1,NASDAQ
4678,13-02-2021 02:00,24 hrs.,stocks,TLRY,759,0,759,-759,4,210,323,4,NASDAQ
4678,13-02-2021 02:00,24 hrs.,stocks,TRCH,7,7,0,7,1,1,1,1,NASDAQ
4678,13-02-2021 02:00,24 hrs.,stocks,TRVG,12,12,0,12,2,2,0,2,NASDAQ
4678,13-02-2021 02:00,24 hrs.,stocks,TSLA,567,455,112,343,10,154,219,9,NASDAQ
4678,13-02-2021 02:00,24 hrs.,stocks,TTGT,6,6,0,6,1,1,0,1,NASDAQ
4678,13-02-2021 02:00,24 hrs.,stocks,VRNT,14,14,0,14,1,3,4,1,NASDAQ
4678,13-02-2021 02:00,24 hrs.,stocks,VRSN,8,0,8,-8,1,1,2,1,NASDAQ
4678,13-02-2021 02:00,24 hrs.,stocks,VUZI,6,6,0,6,1,1,0,1,NASDAQ
4678,13-02-2021 02:00,24 hrs.,stocks,VXRT,6,6,0,6,1,1,0,1,NASDAQ
4678,13-02-2021 02:00,24 hrs.,stocks,VXUS,20,20,0,20,2,4,4,2,NASDAQ
4678,13-02-2021 02:00,24 hrs.,stocks,WDAY,12,12,0,12,1,2,4,1,NASDAQ
4678,13-02-2021 02:00,24 hrs.,stocks,WISH,6,6,0,6,1,1,0,1,NASDAQ
4678,13-02-2021 02:00,24 hrs.,stocks,XCUR,6,0,6,-6,1,1,0,1,NASDAQ
4678,13-02-2021 02:00,24 hrs.,stocks,XERS,6,0,6,-6,1,1,0,1,NASDAQ
4678,13-02-2021 02:00,24 hrs.,stocks,ZGNX,6,6,0,6,1,1,0,1,NASDAQ
4678,13-02-2021 02:00,24 hrs.,stocks,DISCA,12,12,0,12,2,2,0,2,NASDAQ
4678,13-02-2021 02:00,24 hrs.,stocks,SRACU,6,6,0,6,1,1,0,1,NASDAQ
4678,13-02-2021 02:00,24 hrs.,stocks,SRACW,6,6,0,6,1,1,0,1,NASDAQ
4678,13-02-2021 02:00,24 hrs.,Daytrading,AABB,27,0,27,-27,1,8,7,1,OTC
4678,13-02-2021 02:00,24 hrs.,Daytrading,HCMC,27,0,27,-27,1,8,7,1,OTC
4678,13-02-2021 02:00,24 hrs.,Daytrading,IDEA,6,0,6,-6,1,1,0,1,OTC
4678,13-02-2021 02:00,24 hrs.,Daytrading,INKW,8,0,8,-8,1,2,0,1,OTC
4678,13-02-2021 02:00,24 hrs.,Daytrading,LVVV,27,0,27,-27,1,8,7,1,OTC
4678,13-02-2021 02:00,24 hrs.,Daytrading,RLTR,6,0,6,-6,1,1,0,1,OTC
4678,13-02-2021 02:00,24 hrs.,Daytrading,SGMD,12,12,0,12,1,1,6,1,OTC
4678,13-02-2021 02:00,24 hrs.,Daytrading,TSTS,27,0,27,-27,1,8,7,1,OTC
4678,13-02-2021 02:00,24 hrs.,Daytrading,DNN,479,473,6,467,2,198,75,2,AMEX
4678,13-02-2021 02:00,24 hrs.,stocks,MIK,6,0,6,-6,1,1,0,1,NASDAQ
4678,13-02-2021 02:00,24 hrs.,stocks,NWL,8,0,8,-8,1,1,2,1,NASDAQ
4678,13-02-2021 02:00,24 hrs.,stocks,OGI,24,12,12,0,4,4,0,4,NASDAQ
4678,13-02-2021 02:00,24 hrs.,stocks,OLB,6,0,6,-6,1,1,0,1,NASDAQ
4678,13-02-2021 02:00,24 hrs.,stocks,PEP,22,22,0,22,1,3,12,1,NASDAQ
4678,13-02-2021 02:00,24 hrs.,stocks,SMH,21,21,0,21,1,1,15,1,NASDAQ
4678,13-02-2021 02:00,24 hrs.,Daytrading,BDX,7,0,7,-7,1,1,1,1,NYSE
4678,13-02-2021 02:00,24 hrs.,Daytrading,FSR,473,473,0,473,1,197,75,1,NYSE
4678,13-02-2021 02:00,24 hrs.,Daytrading,GME,64,58,6,52,3,21,10,3,NYSE
4678,13-02-2021 02:00,24 hrs.,Daytrading,NOK,18,0,18,-18,1,0,14,1,NYSE
4678,13-02-2021 02:00,24 hrs.,Daytrading,PDT,22,22,0,22,1,4,10,1,NYSE
4678,13-02-2021 02:00,24 hrs.,Daytrading,RTP,473,473,0,473,1,197,75,1,NYSE
4678,13-02-2021 02:00,24 hrs.,Daytrading,SCI,6,0,6,-6,1,1,0,1,NYSE
4678,13-02-2021 02:00,24 hrs.,Daytrading,WLL,6,0,6,-6,1,1,0,1,NYSE
4678,13-02-2021 02:00,24 hrs.,Daytrading,CCIV,473,473,0,473,1,197,75,1,NYSE
4678,13-02-2021 02:00,24 hrs.,Daytrading,CHWY,6,6,0,6,1,1,0,1,NYSE
4678,13-02-2021 02:00,24 hrs.,Daytrading,SPCE,480,473,7,466,2,198,76,2,NYSE
4678,13-02-2021 02:00,24 hrs.,Daytrading,AMD,10,0,10,-10,1,0,6,1,NASDAQ
4678,13-02-2021 02:00,24 hrs.,Daytrading,API,221,221,0,221,1,93,31,1,NASDAQ
4678,13-02-2021 02:00,24 hrs.,Daytrading,INO,473,473,0,473,1,197,75,1,NASDAQ
4678,13-02-2021 02:00,24 hrs.,Daytrading,OGI,13,0,13,-13,1,1,7,1,NASDAQ
4678,13-02-2021 02:00,24 hrs.,Daytrading,ACST,6,6,0,6,1,1,0,1,NASDAQ
4678,13-02-2021 02:00,24 hrs.,Daytrading,APDN,473,473,0,473,1,197,75,1,NASDAQ
4678,13-02-2021 02:00,24 hrs.,Daytrading,APHA,473,473,0,473,1,197,75,1,NASDAQ
4678,13-02-2021 02:00,24 hrs.,Daytrading,ARTL,571,571,0,571,6,228,91,6,NASDAQ
4678,13-02-2021 02:00,24 hrs.,Daytrading,BNGO,74,74,0,74,1,29,12,1,NASDAQ
4678,13-02-2021 02:00,24 hrs.,Daytrading,BYND,6,0,6,-6,1,1,0,1,NASDAQ
4678,13-02-2021 02:00,24 hrs.,Daytrading,CLEU,528,528,0,528,2,218,84,2,NASDAQ
4678,13-02-2021 02:00,24 hrs.,Daytrading,CLGN,473,473,0,473,1,197,75,1,NASDAQ
4678,13-02-2021 02:00,24 hrs.,Daytrading,CLSN,473,473,0,473,1,197,75,1,NASDAQ
4678,13-02-2021 02:00,24 hrs.,Daytrading,CMLF,473,473,0,473,1,197,75,1,NASDAQ
4678,13-02-2021 02:00,24 hrs.,Daytrading,CRSR,473,473,0,473,1,197,75,1,NASDAQ
4678,13-02-2021 02:00,24 hrs.,Daytrading,EBON,6,6,0,6,1,1,0,1,NASDAQ
4678,13-02-2021 02:00,24 hrs.,Daytrading,EXPE,4,0,4,-4,1,0,0,1,NASDAQ
4678,13-02-2021 02:00,24 hrs.,Daytrading,FOLD,479,479,0,479,2,198,75,2,NASDAQ
4678,13-02-2021 02:00,24 hrs.,Daytrading,FTFT,473,473,0,473,1,197,75,1,NASDAQ
4678,13-02-2021 02:00,24 hrs.,Daytrading,IBKR,19,0,19,-19,1,4,7,1,NASDAQ
4678,13-02-2021 02:00,24 hrs.,Daytrading,LIVE,106,106,0,106,2,40,18,1,NASDAQ
4678,13-02-2021 02:00,24 hrs.,Daytrading,MARA,473,473,0,473,1,197,75,1,NASDAQ
4678,13-02-2021 02:00,24 hrs.,Daytrading,NOVN,473,473,0,473,1,197,75,1,NASDAQ
4678,13-02-2021 02:00,24 hrs.,Daytrading,OCGN,23,23,0,23,1,3,13,1,NASDAQ
4678,13-02-2021 02:00,24 hrs.,Daytrading,PLAY,10,0,10,-10,1,0,6,1,NASDAQ
4678,13-02-2021 02:00,24 hrs.,Daytrading,PYPL,473,473,0,473,1,197,75,1,NASDAQ
4678,13-02-2021 02:00,24 hrs.,Daytrading,RIDE,473,473,0,473,1,197,75,1,NASDAQ
4678,13-02-2021 02:00,24 hrs.,Daytrading,RIOT,473,473,0,473,1,197,75,1,NASDAQ
4678,13-02-2021 02:00,24 hrs.,Daytrading,SNDL,13,0,13,-13,1,1,7,1,NASDAQ
4678,13-02-2021 02:00,24 hrs.,Daytrading,STAY,37,0,37,-37,1,16,1,1,NASDAQ
4678,13-02-2021 02:00,24 hrs.,Daytrading,TLRY,486,473,13,460,2,198,82,2,NASDAQ
4678,13-02-2021 02:00,24 hrs.,Daytrading,WAFU,55,55,0,55,1,21,9,1,NASDAQ
4678,13-02-2021 02:00,24 hrs.,Daytrading,XERS,473,473,0,473,1,197,75,1,NASDAQ
4678,13-02-2021 02:00,24 hrs.,trakstocks,ALPP,6,6,0,6,1,1,0,1,OTC
4678,13-02-2021 02:00,24 hrs.,trakstocks,BRTX,6,6,0,6,1,1,0,1,OTC
4678,13-02-2021 02:00,24 hrs.,trakstocks,MMEX,20,20,0,20,2,3,6,2,OTC
4678,13-02-2021 02:00,24 hrs.,trakstocks,MOST,6,6,0,6,1,1,0,1,OTC
4678,13-02-2021 02:00,24 hrs.,trakstocks,SUIC,6,0,6,-6,1,1,0,1,OTC
4678,13-02-2021 02:00,24 hrs.,trakstocks,ARBKF,6,6,0,6,1,1,0,1,OTC
4678,13-02-2021 02:00,24 hrs.,trakstocks,BBXIA,6,6,0,6,1,1,0,1,OTC
4678,13-02-2021 02:00,24 hrs.,trakstocks,MGROF,6,6,0,6,1,1,0,1,OTC
4678,13-02-2021 02:00,24 hrs.,trakstocks,NMGRF,44,44,0,44,1,16,8,1,OTC
4678,13-02-2021 02:00,24 hrs.,trakstocks,NXTTF,10,10,0,10,1,3,0,1,OTC
4678,13-02-2021 02:00,24 hrs.,trakstocks,PYRNF,12,12,0,12,2,2,0,2,OTC
4678,13-02-2021 02:00,24 hrs.,trakstocks,DNN,65,65,0,65,1,24,13,1,AMEX
4678,13-02-2021 02:00,24 hrs.,trakstocks,DPW,12,12,0,12,2,2,0,2,AMEX
4678,13-02-2021 02:00,24 hrs.,trakstocks,TRXC,113,113,0,113,1,34,41,1,AMEX
4678,13-02-2021 02:00,24 hrs.,stocks,MKSI,8,0,8,-8,1,1,2,1,NASDAQ
4678,13-02-2021 02:00,24 hrs.,stocks,MNPR,6,0,6,-6,1,1,0,1,NASDAQ
4678,13-02-2021 02:00,24 hrs.,stocks,MRNA,6,6,0,6,1,1,0,1,NASDAQ
4678,13-02-2021 02:00,24 hrs.,stocks,MSFT,264,235,29,206,2,103,50,2,NASDAQ
4678,13-02-2021 02:00,24 hrs.,stocks,NAKD,6,0,6,-6,1,1,0,1,NASDAQ
4678,13-02-2021 02:00,24 hrs.,stocks,NBAC,6,6,0,6,1,1,0,1,NASDAQ
4678,13-02-2021 02:00,24 hrs.,trakstocks,SOS,18,18,0,18,1,7,0,1,NYSE
4678,13-02-2021 02:00,24 hrs.,trakstocks,ARGO,6,6,0,6,1,1,0,1,NYSE
4678,13-02-2021 02:00,24 hrs.,trakstocks,CCIV,22,0,22,-22,2,5,4,2,NYSE
4678,13-02-2021 02:00,24 hrs.,trakstocks,SKLZ,6,0,6,-6,1,1,0,1,NYSE
4678,13-02-2021 02:00,24 hrs.,trakstocks,STIC,29,0,29,-29,1,9,7,1,NYSE
4678,13-02-2021 02:00,24 hrs.,trakstocks,STPK,38,38,0,38,3,9,8,2,NYSE
4678,13-02-2021 02:00,24 hrs.,trakstocks,AQB,8,8,0,8,1,2,0,1,NASDAQ
4678,13-02-2021 02:00,24 hrs.,trakstocks,OEG,22,22,0,22,1,7,4,1,NASDAQ
4678,13-02-2021 02:00,24 hrs.,trakstocks,ABEO,10,0,10,-10,1,3,0,1,NASDAQ
4678,13-02-2021 02:00,24 hrs.,trakstocks,APPS,6,6,0,6,1,1,0,1,NASDAQ
4678,13-02-2021 02:00,24 hrs.,trakstocks,AYRO,97,97,0,97,2,32,25,2,NASDAQ
4678,13-02-2021 02:00,24 hrs.,trakstocks,BHTG,344,344,0,344,1,126,88,1,NASDAQ
4678,13-02-2021 02:00,24 hrs.,trakstocks,CFII,69,69,0,69,1,24,17,1,NASDAQ
4678,13-02-2021 02:00,24 hrs.,trakstocks,CPSH,131,37,94,-57,3,51,17,3,NASDAQ
4678,13-02-2021 02:00,24 hrs.,trakstocks,EXPC,8,8,0,8,1,2,0,1,NASDAQ
4678,13-02-2021 02:00,24 hrs.,trakstocks,GTHX,6,6,0,6,1,1,0,1,NASDAQ
4678,13-02-2021 02:00,24 hrs.,trakstocks,IMMR,22,22,0,22,1,6,6,1,NASDAQ
4678,13-02-2021 02:00,24 hrs.,trakstocks,LIFE,8,8,0,8,1,1,2,1,NASDAQ
4678,13-02-2021 02:00,24 hrs.,trakstocks,MARA,17,17,0,17,1,5,3,1,NASDAQ
4678,13-02-2021 02:00,24 hrs.,trakstocks,OPRX,12,12,0,12,1,3,2,1,NASDAQ
4678,13-02-2021 02:00,24 hrs.,trakstocks,RIOT,25,25,0,25,2,6,5,2,NASDAQ
4678,13-02-2021 02:00,24 hrs.,trakstocks,TTCF,8,8,0,8,1,1,2,1,NASDAQ
4678,13-02-2021 02:00,24 hrs.,trakstocks,VNDA,10,0,10,-10,1,3,0,1,NASDAQ
4678,13-02-2021 02:00,24 hrs.,trakstocks,XSPA,25,0,25,-25,1,8,5,1,NASDAQ
4678,13-02-2021 02:00,24 hrs.,StockMarket,ABML,6,6,0,6,1,1,0,1,OTC
4678,13-02-2021 02:00,24 hrs.,StockMarket,BOTY,12,12,0,12,1,4,0,1,OTC
4678,13-02-2021 02:00,24 hrs.,StockMarket,DIGI,6,0,6,-6,1,1,0,1,OTC
4678,13-02-2021 02:00,24 hrs.,StockMarket,GTEH,6,6,0,6,1,1,0,1,OTC
4678,13-02-2021 02:00,24 hrs.,StockMarket,GTVH,6,0,6,-6,1,1,0,1,OTC
4678,13-02-2021 02:00,24 hrs.,StockMarket,HCMC,61,0,61,-61,2,22,9,2,OTC
4678,13-02-2021 02:00,24 hrs.,StockMarket,HEMP,6,6,0,6,1,1,0,1,OTC
4678,13-02-2021 02:00,24 hrs.,StockMarket,KGET,6,6,0,6,1,1,0,1,OTC
4678,13-02-2021 02:00,24 hrs.,StockMarket,KWBT,6,6,0,6,1,1,0,1,OTC
4678,13-02-2021 02:00,24 hrs.,StockMarket,LINK,13,0,13,-13,1,3,3,1,OTC
4678,13-02-2021 02:00,24 hrs.,StockMarket,MAXD,57,57,0,57,4,17,7,3,OTC
4678,13-02-2021 02:00,24 hrs.,StockMarket,MOST,13,0,13,-13,1,3,3,1,OTC
4678,13-02-2021 02:00,24 hrs.,StockMarket,PCTL,6,6,0,6,1,1,0,1,OTC
4678,13-02-2021 02:00,24 hrs.,StockMarket,PHIL,8,8,0,8,1,2,0,1,OTC
4678,13-02-2021 02:00,24 hrs.,StockMarket,RLTR,6,0,6,-6,1,1,0,1,OTC
4678,13-02-2021 02:00,24 hrs.,StockMarket,RSSV,22,22,0,22,1,8,2,1,OTC
4678,13-02-2021 02:00,24 hrs.,StockMarket,SGMD,137,137,0,137,6,31,51,2,OTC
4678,13-02-2021 02:00,24 hrs.,StockMarket,SUIC,6,0,6,-6,1,1,0,1,OTC
4678,13-02-2021 02:00,24 hrs.,StockMarket,AYRWF,20,20,0,20,1,7,2,1,OTC
4678,13-02-2021 02:00,24 hrs.,pennystocks,ITCJ,7,7,0,7,1,1,1,1,OTC
4678,13-02-2021 02:00,24 hrs.,pennystocks,JSDA,6,6,0,6,1,1,0,1,OTC
4678,13-02-2021 02:00,24 hrs.,pennystocks,KGKG,25,0,25,-25,4,4,1,2,OTC
4678,13-02-2021 02:00,24 hrs.,pennystocks,KWBT,13,6,7,-1,2,2,1,2,OTC
4678,13-02-2021 02:00,24 hrs.,pennystocks,KYNC,37,6,31,-25,6,6,1,2,OTC
4678,13-02-2021 02:00,24 hrs.,pennystocks,LITH,6,6,0,6,1,1,0,1,OTC
4678,13-02-2021 02:00,24 hrs.,pennystocks,LQMT,6,0,6,-6,1,1,0,1,OTC
4678,13-02-2021 02:00,24 hrs.,pennystocks,LUVU,14,6,8,-2,2,3,0,2,OTC
4678,13-02-2021 02:00,24 hrs.,pennystocks,LVVV,51,27,24,3,5,10,11,3,OTC
4678,13-02-2021 02:00,24 hrs.,pennystocks,MAXD,60,60,0,60,6,15,6,6,OTC
4678,13-02-2021 02:00,24 hrs.,pennystocks,MCOA,7,7,0,7,1,1,1,1,OTC
4678,13-02-2021 02:00,24 hrs.,pennystocks,MDCN,13,13,0,13,2,2,1,2,OTC
4678,13-02-2021 02:00,24 hrs.,pennystocks,MEDH,80,80,0,80,1,19,38,1,OTC
4678,13-02-2021 02:00,24 hrs.,pennystocks,MGLG,6,0,6,-6,1,1,0,1,OTC
4678,13-02-2021 02:00,24 hrs.,pennystocks,MGTI,17,17,0,17,1,5,3,1,OTC
4678,13-02-2021 02:00,24 hrs.,Daytrading,DSS,473,473,0,473,1,197,75,1,AMEX
4678,13-02-2021 02:00,24 hrs.,Daytrading,MXC,6,0,6,-6,1,1,0,1,AMEX
4678,13-02-2021 02:00,24 hrs.,Daytrading,TRX,6,0,6,-6,1,1,0,1,AMEX
4678,13-02-2021 02:00,24 hrs.,Daytrading,ACB,479,479,0,479,2,198,75,2,NYSE
4678,13-02-2021 02:00,24 hrs.,Daytrading,ADX,9,9,0,9,1,2,1,1,NYSE
4678,13-02-2021 02:00,24 hrs.,Daytrading,AMC,6,6,0,6,1,1,0,1,NYSE
4678,13-02-2021 02:00,24 hrs.,pennystocks,MLFB,149,65,84,-19,3,44,49,3,OTC
4678,13-02-2021 02:00,24 hrs.,pennystocks,MMEX,130,130,0,130,3,21,76,2,OTC
4678,13-02-2021 02:00,24 hrs.,pennystocks,MODC,6,0,6,-6,1,1,0,1,OTC
4678,13-02-2021 02:00,24 hrs.,pennystocks,MOJO,12,12,0,12,2,2,0,1,OTC
4678,13-02-2021 02:00,24 hrs.,pennystocks,MRMD,50,5,45,-40,2,18,6,2,OTC
4678,13-02-2021 02:00,24 hrs.,pennystocks,MRNJ,13,0,13,-13,2,2,1,1,OTC
4678,13-02-2021 02:00,24 hrs.,pennystocks,MTVX,6,6,0,6,1,1,0,1,OTC
4678,13-02-2021 02:00,24 hrs.,pennystocks,NBVG,7,7,0,7,1,1,1,1,OTC
4678,13-02-2021 02:00,24 hrs.,pennystocks,NOVC,54,54,0,54,2,16,14,2,OTC
4678,13-02-2021 02:00,24 hrs.,pennystocks,NSAV,13,13,0,13,2,2,1,2,OTC
4678,13-02-2021 02:00,24 hrs.,pennystocks,NSEO,6,0,6,-6,1,1,0,1,OTC
4678,13-02-2021 02:00,24 hrs.,pennystocks,NSPT,6,6,0,6,1,1,0,1,OTC
4678,13-02-2021 02:00,24 hrs.,pennystocks,OZSC,57,23,34,-11,4,13,15,4,OTC
4678,13-02-2021 02:00,24 hrs.,pennystocks,PAOG,7,7,0,7,1,1,1,1,OTC
4678,13-02-2021 02:00,24 hrs.,pennystocks,PDXP,7,7,0,7,1,1,1,1,OTC
4678,13-02-2021 02:00,24 hrs.,pennystocks,PHIL,6,6,0,6,1,1,0,1,OTC
4678,13-02-2021 02:00,24 hrs.,pennystocks,PLSB,6,0,6,-6,1,1,0,1,OTC
4678,13-02-2021 02:00,24 hrs.,pennystocks,PMCB,6,0,6,-6,1,1,0,1,OTC
4678,13-02-2021 02:00,24 hrs.,pennystocks,PPJE,6,6,0,6,1,1,0,1,OTC
4678,13-02-2021 02:00,24 hrs.,pennystocks,PUGE,43,43,0,43,2,13,9,1,OTC
4678,13-02-2021 02:00,24 hrs.,pennystocks,PURA,13,13,0,13,2,2,1,2,OTC
4678,13-02-2021 02:00,24 hrs.,pennystocks,PVDG,25,25,0,25,1,2,17,1,OTC
4678,13-02-2021 02:00,24 hrs.,pennystocks,PZOO,7,0,7,-7,1,1,1,1,OTC
4678,13-02-2021 02:00,24 hrs.,pennystocks,QOIL,7,7,0,7,1,1,1,1,OTC
4678,13-02-2021 02:00,24 hrs.,pennystocks,RDGL,6,6,0,6,1,1,0,1,OTC
4678,13-02-2021 02:00,24 hrs.,pennystocks,RELI,15,15,0,15,1,0,11,1,OTC
4678,13-02-2021 02:00,24 hrs.,pennystocks,RGBP,21,21,0,21,2,5,3,1,OTC
4678,13-02-2021 02:00,24 hrs.,pennystocks,RITE,39,0,39,-39,1,7,21,1,OTC
4678,13-02-2021 02:00,24 hrs.,pennystocks,RLBD,18,0,18,-18,1,5,4,1,OTC
4678,13-02-2021 02:00,24 hrs.,pennystocks,RMTD,6,0,6,-6,1,1,0,1,OTC
4678,13-02-2021 02:00,24 hrs.,pennystocks,RNVA,6,6,0,6,1,1,0,1,OTC
4678,13-02-2021 02:00,24 hrs.,pennystocks,RSHN,17,17,0,17,1,1,11,1,OTC
4678,13-02-2021 02:00,24 hrs.,pennystocks,RSSV,299,299,0,299,2,110,71,2,OTC
4678,13-02-2021 02:00,24 hrs.,pennystocks,RTON,13,13,0,13,2,2,1,2,OTC
4678,13-02-2021 02:00,24 hrs.,pennystocks,SCIE,6,0,6,-6,1,1,0,1,OTC
4678,13-02-2021 02:00,24 hrs.,pennystocks,SCNA,6,6,0,6,1,1,0,1,OTC
4678,13-02-2021 02:00,24 hrs.,pennystocks,SFOR,15,15,0,15,1,0,11,1,OTC
4678,13-02-2021 02:00,24 hrs.,pennystocks,SGMD,348,348,0,348,9,109,94,9,OTC
4678,13-02-2021 02:00,24 hrs.,pennystocks,SGSI,6,0,6,-6,1,1,0,1,OTC
4678,13-02-2021 02:00,24 hrs.,pennystocks,SHMP,6,0,6,-6,1,1,0,1,OTC
4678,13-02-2021 02:00,24 hrs.,pennystocks,SHWZ,7,7,0,7,1,1,1,1,OTC
4678,13-02-2021 02:00,24 hrs.,pennystocks,SIML,99,99,0,99,2,27,37,2,OTC
4678,13-02-2021 02:00,24 hrs.,pennystocks,SING,67,67,0,67,3,5,45,3,OTC
4678,13-02-2021 02:00,24 hrs.,pennystocks,SNPW,178,33,145,-112,3,59,48,3,OTC
4678,13-02-2021 02:00,24 hrs.,pennystocks,SNRS,14,14,0,14,2,2,2,2,OTC
4678,13-02-2021 02:00,24 hrs.,pennystocks,SNWV,12,12,0,12,2,2,0,1,OTC
4678,13-02-2021 02:00,24 hrs.,pennystocks,SNYR,6,6,0,6,1,1,0,1,OTC
4678,13-02-2021 02:00,24 hrs.,pennystocks,SRMX,210,68,142,-74,8,46,86,7,OTC
4678,13-02-2021 02:00,24 hrs.,pennystocks,SRNA,6,6,0,6,1,1,0,1,OTC
4678,13-02-2021 02:00,24 hrs.,pennystocks,SSFT,15,15,0,15,1,0,11,1,OTC
4678,13-02-2021 02:00,24 hrs.,pennystocks,SSOK,15,15,0,15,1,0,11,1,OTC
4678,13-02-2021 02:00,24 hrs.,pennystocks,STEV,12,12,0,12,1,3,2,1,OTC
4678,13-02-2021 02:00,24 hrs.,pennystocks,TCHH,7,7,0,7,1,1,1,1,OTC
4678,13-02-2021 02:00,24 hrs.,pennystocks,TFZI,6,0,6,-6,1,1,0,1,OTC
4678,13-02-2021 02:00,24 hrs.,pennystocks,TGHI,11,11,0,11,1,2,3,1,OTC
4678,13-02-2021 02:00,24 hrs.,pennystocks,TLGN,60,60,0,60,3,13,22,2,OTC
4678,13-02-2021 02:00,24 hrs.,pennystocks,TLSS,85,85,0,85,2,25,27,2,OTC
4678,13-02-2021 02:00,24 hrs.,pennystocks,TPAC,3221,3215,6,3209,2,1440,333,2,OTC
4678,13-02-2021 02:00,24 hrs.,trakstocks,AMC,25,25,0,25,1,2,17,1,NYSE
4678,13-02-2021 02:00,24 hrs.,trakstocks,BFT,6,6,0,6,1,1,0,1,NYSE
4678,13-02-2021 02:00,24 hrs.,trakstocks,CPS,94,0,94,-94,1,41,8,1,NYSE
4678,13-02-2021 02:00,24 hrs.,trakstocks,GME,25,25,0,25,1,2,17,1,NYSE
4678,13-02-2021 02:00,24 hrs.,trakstocks,LEN,11,0,11,-11,1,3,1,1,NYSE
4678,13-02-2021 02:00,24 hrs.,trakstocks,SOL,8,8,0,8,1,2,0,1,NYSE
4678,13-02-2021 02:00,24 hrs.,pennystocks,VPLM,6,0,6,-6,1,1,0,1,OTC
4678,13-02-2021 02:00,24 hrs.,pennystocks,VTLR,6,0,6,-6,1,1,0,1,OTC
4678,13-02-2021 02:00,24 hrs.,pennystocks,WCVC,93,93,0,93,1,26,37,1,OTC
4678,13-02-2021 02:00,24 hrs.,pennystocks,WHEN,7,0,7,-7,1,1,1,1,OTC
4678,13-02-2021 02:00,24 hrs.,pennystocks,WIZD,20,20,0,20,1,6,4,1,OTC
4678,13-02-2021 02:00,24 hrs.,pennystocks,GSAT,50,50,0,50,1,11,24,1,AMEX
4678,13-02-2021 02:00,24 hrs.,pennystocks,IBIO,21,21,0,21,1,7,3,1,AMEX
4678,13-02-2021 02:00,24 hrs.,pennystocks,INUV,65,0,65,-65,1,23,15,1,AMEX
4678,13-02-2021 02:00,24 hrs.,pennystocks,NSPR,20,20,0,20,1,6,4,1,AMEX
4678,13-02-2021 02:00,24 hrs.,pennystocks,OGEN,6,6,0,6,1,1,0,1,AMEX
4678,13-02-2021 02:00,24 hrs.,pennystocks,SDPI,6,6,0,6,1,1,0,1,AMEX
4678,13-02-2021 02:00,24 hrs.,pennystocks,SENS,75,34,41,-7,4,22,15,4,AMEX
4678,13-02-2021 02:00,24 hrs.,pennystocks,TRXC,17,11,6,5,3,2,1,3,AMEX
4678,13-02-2021 02:00,24 hrs.,pennystocks,UAVS,112,112,0,112,1,37,34,1,AMEX
4678,13-02-2021 02:00,24 hrs.,pennystocks,XXII,6,6,0,6,1,0,2,1,AMEX
4678,13-02-2021 02:00,24 hrs.,pennystocks,ACB,21,21,0,21,1,2,13,1,NYSE
4678,13-02-2021 02:00,24 hrs.,pennystocks,AHT,6,6,0,6,1,1,0,1,NYSE
4678,13-02-2021 02:00,24 hrs.,pennystocks,AMC,80,80,0,80,5,13,34,5,NYSE
4678,13-02-2021 02:00,24 hrs.,pennystocks,ASX,24,24,0,24,4,4,0,2,NYSE
4678,13-02-2021 02:00,24 hrs.,pennystocks,ATH,12,12,0,12,1,3,2,1,NYSE
4678,13-02-2021 02:00,24 hrs.,pennystocks,AXL,5,5,0,5,1,0,1,1,NYSE
4678,13-02-2021 02:00,24 hrs.,pennystocks,BIO,316,0,316,-316,1,131,50,1,NYSE
4678,13-02-2021 02:00,24 hrs.,pennystocks,BTU,6,6,0,6,1,1,0,1,NYSE
4678,13-02-2021 02:00,24 hrs.,pennystocks,CBD,22,15,7,8,2,4,6,2,NYSE
4678,13-02-2021 02:00,24 hrs.,pennystocks,CHS,35,35,0,35,1,11,9,1,NYSE
4678,13-02-2021 02:00,24 hrs.,pennystocks,CLI,57,57,0,57,1,19,15,1,NYSE
4678,13-02-2021 02:00,24 hrs.,pennystocks,CMD,57,57,0,57,1,19,15,1,NYSE
4678,13-02-2021 02:00,24 hrs.,pennystocks,CVE,18,0,18,-18,3,3,0,1,NYSE
4678,13-02-2021 02:00,24 hrs.,pennystocks,CVX,35,35,0,35,1,12,7,1,NYSE
4678,13-02-2021 02:00,24 hrs.,pennystocks,ETH,6,6,0,6,1,1,0,1,NYSE
4678,13-02-2021 02:00,24 hrs.,pennystocks,FLT,33,33,0,33,1,11,7,1,NYSE
4678,13-02-2021 02:00,24 hrs.,pennystocks,GME,30,24,6,18,5,5,0,4,NYSE
4678,13-02-2021 02:00,24 hrs.,pennystocks,IRR,27,27,0,27,1,9,5,1,NYSE
4678,13-02-2021 02:00,24 hrs.,pennystocks,KOS,7,7,0,7,1,1,1,1,NYSE
4678,13-02-2021 02:00,24 hrs.,pennystocks,MDC,17,17,0,17,1,5,3,1,NYSE
4678,13-02-2021 02:00,24 hrs.,pennystocks,NAT,7,7,0,7,1,1,1,1,NYSE
4678,13-02-2021 02:00,24 hrs.,pennystocks,NOK,6,6,0,6,1,1,0,1,NYSE
4678,13-02-2021 02:00,24 hrs.,pennystocks,NPV,27,27,0,27,1,9,5,1,NYSE
4678,13-02-2021 02:00,24 hrs.,pennystocks,RKT,79,79,0,79,1,24,27,1,NYSE
4678,13-02-2021 02:00,24 hrs.,pennystocks,RSI,203,203,0,203,1,87,25,1,NYSE
4678,13-02-2021 02:00,24 hrs.,pennystocks,SOS,57,51,6,45,5,9,19,5,NYSE
4678,13-02-2021 02:00,24 hrs.,pennystocks,SUM,203,203,0,203,1,87,25,1,NYSE
4678,13-02-2021 02:00,24 hrs.,pennystocks,TSM,33,33,0,33,1,9,11,1,NYSE
4678,13-02-2021 02:00,24 hrs.,pennystocks,VET,7,7,0,7,1,1,1,1,NYSE
4678,13-02-2021 02:00,24 hrs.,pennystocks,WEI,19,0,19,-19,1,7,1,1,NYSE
4678,13-02-2021 02:00,24 hrs.,pennystocks,WLL,6,0,6,-6,1,1,0,1,NYSE
4678,13-02-2021 02:00,24 hrs.,pennystocks,WWE,7,0,7,-7,1,1,1,1,NYSE
4678,13-02-2021 02:00,24 hrs.,pennystocks,ARGO,37,0,37,-37,1,4,25,1,NYSE
4678,13-02-2021 02:00,24 hrs.,pennystocks,CCIV,7,7,0,7,1,1,1,1,NYSE
4678,13-02-2021 02:00,24 hrs.,pennystocks,FINV,14,14,0,14,1,3,4,1,NYSE
4678,13-02-2021 02:00,24 hrs.,pennystocks,HEXO,23,23,0,23,1,2,15,1,NYSE
4678,13-02-2021 02:00,24 hrs.,pennystocks,PUMP,13,13,0,13,2,2,1,1,NYSE
4678,13-02-2021 02:00,24 hrs.,pennystocks,SHOP,12,12,0,12,2,2,0,1,NYSE
4678,13-02-2021 02:00,24 hrs.,pennystocks,VIST,12,0,12,-12,1,2,4,1,NYSE
4678,13-02-2021 02:00,24 hrs.,pennystocks,WELL,1290,1290,0,1290,1,538,210,1,NYSE
4678,13-02-2021 02:00,24 hrs.,pennystocks,BBI,53,0,53,-53,1,20,9,1,NASDAQ
4678,13-02-2021 02:00,24 hrs.,pennystocks,FWP,10,10,0,10,1,0,6,1,NASDAQ
4678,13-02-2021 02:00,24 hrs.,pennystocks,GBT,6,6,0,6,1,1,0,1,NASDAQ
4678,13-02-2021 02:00,24 hrs.,pennystocks,MIHI,6,6,0,6,1,1,0,1,OTC
4678,13-02-2021 02:00,24 hrs.,pennystocks,MIKP,6,0,6,-6,1,1,0,1,OTC
4678,13-02-2021 02:00,24 hrs.,pennystocks,MINE,124,31,93,-62,7,27,42,6,OTC
4678,13-02-2021 02:00,24 hrs.,pennystocks,MJNA,25,25,0,25,4,4,1,4,OTC
4678,13-02-2021 02:00,24 hrs.,pennystocks,MJTV,7,7,0,7,1,1,1,1,OTC
4678,13-02-2021 02:00,24 hrs.,pennystocks,MKTY,7,7,0,7,1,1,1,1,OTC
4678,13-02-2021 02:00,24 hrs.,pennystocks,ABEO,7,7,0,7,1,1,1,1,NASDAQ
4678,13-02-2021 02:00,24 hrs.,pennystocks,ABIO,26,0,26,-26,1,9,4,1,NASDAQ
4678,13-02-2021 02:00,24 hrs.,pennystocks,ACST,13,6,7,-1,2,2,1,2,NASDAQ
4678,13-02-2021 02:00,24 hrs.,pennystocks,AGEN,10,10,0,10,1,3,0,1,NASDAQ
4678,13-02-2021 02:00,24 hrs.,pennystocks,AGTC,31,14,17,-3,3,5,9,3,NASDAQ
4678,13-02-2021 02:00,24 hrs.,pennystocks,AMTX,72,72,0,72,1,25,18,1,NASDAQ
4678,13-02-2021 02:00,24 hrs.,pennystocks,APHA,74,74,0,74,3,24,14,3,NASDAQ
4678,13-02-2021 02:00,24 hrs.,pennystocks,ARTL,57,39,18,21,5,15,7,3,NASDAQ
4678,13-02-2021 02:00,24 hrs.,pennystocks,ASRT,1900,166,1734,-1568,15,743,354,9,NASDAQ
4678,13-02-2021 02:00,24 hrs.,pennystocks,ATOS,118,118,0,118,3,39,28,3,NASDAQ
4678,13-02-2021 02:00,24 hrs.,pennystocks,BBIG,6,0,6,-6,1,1,0,1,NASDAQ
4678,13-02-2021 02:00,24 hrs.,pennystocks,BCLI,5,5,0,5,1,0,1,1,NASDAQ
4678,13-02-2021 02:00,24 hrs.,pennystocks,BIOL,6,6,0,6,1,1,0,1,NASDAQ
4678,13-02-2021 02:00,24 hrs.,pennystocks,BKEP,18,0,18,-18,1,5,4,1,NASDAQ
4678,13-02-2021 02:00,24 hrs.,pennystocks,BNGO,37,18,19,-1,3,11,3,3,NASDAQ
4678,13-02-2021 02:00,24 hrs.,pennystocks,BWEN,12,12,0,12,2,2,0,2,NASDAQ
4678,13-02-2021 02:00,24 hrs.,pennystocks,CFMS,12,12,0,12,2,2,0,2,NASDAQ
4678,13-02-2021 02:00,24 hrs.,pennystocks,CIDM,121,121,0,121,2,29,55,2,NASDAQ
4678,13-02-2021 02:00,24 hrs.,pennystocks,CKPT,27,27,0,27,3,4,7,3,NASDAQ
4678,13-02-2021 02:00,24 hrs.,pennystocks,CLBS,213,213,0,213,5,70,53,5,NASDAQ
4678,13-02-2021 02:00,24 hrs.,pennystocks,CLEU,7,7,0,7,1,1,1,1,NASDAQ
4678,13-02-2021 02:00,24 hrs.,pennystocks,COCP,33,33,0,33,2,11,3,2,NASDAQ
4678,13-02-2021 02:00,24 hrs.,pennystocks,CPLP,22,22,0,22,2,2,10,1,NASDAQ
4678,13-02-2021 02:00,24 hrs.,pennystocks,CRBP,70,70,0,70,1,30,6,1,NASDAQ
4678,13-02-2021 02:00,24 hrs.,pennystocks,CRWS,6,6,0,6,1,1,0,1,NASDAQ
4678,13-02-2021 02:00,24 hrs.,pennystocks,CSCW,7,7,0,7,1,1,1,1,NASDAQ
4678,13-02-2021 02:00,24 hrs.,pennystocks,CSTR,6,6,0,6,1,1,0,1,NASDAQ
4678,13-02-2021 02:00,24 hrs.,pennystocks,CTHR,18,18,0,18,1,5,4,1,NASDAQ
4678,13-02-2021 02:00,24 hrs.,pennystocks,CTMX,14,14,0,14,1,2,6,1,NASDAQ
4678,13-02-2021 02:00,24 hrs.,StockMarket,ARTL,81,81,0,81,1,19,39,1,NASDAQ
4678,13-02-2021 02:00,24 hrs.,StockMarket,ATHX,6,6,0,6,1,1,0,1,NASDAQ
4678,13-02-2021 02:00,24 hrs.,StockMarket,ATOS,21,14,7,7,2,6,1,2,NASDAQ
4678,13-02-2021 02:00,24 hrs.,StockMarket,AVGO,7,7,0,7,1,1,1,1,NASDAQ
4678,13-02-2021 02:00,24 hrs.,StockMarket,BBBY,6,6,0,6,1,1,0,1,NASDAQ
4678,13-02-2021 02:00,24 hrs.,StockMarket,BPTH,6,6,0,6,1,1,0,1,NASDAQ
4678,13-02-2021 02:00,24 hrs.,StockMarket,BSQR,11,11,0,11,1,2,3,1,NASDAQ
4678,13-02-2021 02:00,24 hrs.,StockMarket,BYND,6,6,0,6,1,1,0,1,NASDAQ
4678,13-02-2021 02:00,24 hrs.,StockMarket,CECE,16,0,16,-16,1,6,0,1,NASDAQ
4678,13-02-2021 02:00,24 hrs.,StockMarket,CLEU,94,94,0,94,2,19,48,2,NASDAQ
4678,13-02-2021 02:00,24 hrs.,StockMarket,CLSK,8,0,8,-8,1,1,2,1,NASDAQ
4678,13-02-2021 02:00,24 hrs.,StockMarket,COHR,13,0,13,-13,1,3,3,1,NASDAQ
4678,13-02-2021 02:00,24 hrs.,StockMarket,CPLP,20,20,0,20,3,4,0,2,NASDAQ
4678,13-02-2021 02:00,24 hrs.,StockMarket,CRSP,4,0,4,-4,1,0,0,1,NASDAQ
4678,13-02-2021 02:00,24 hrs.,StockMarket,CRSR,17,17,0,17,1,3,7,1,NASDAQ
4678,13-02-2021 02:00,24 hrs.,StockMarket,CTRM,6,6,0,6,1,1,0,1,NASDAQ
4678,13-02-2021 02:00,24 hrs.,StockMarket,CWCO,12,12,0,12,2,2,0,1,NASDAQ
4678,13-02-2021 02:00,24 hrs.,StockMarket,DDOG,29,16,13,3,2,9,3,2,NASDAQ
4678,13-02-2021 02:00,24 hrs.,StockMarket,ENTX,8,0,8,-8,1,2,0,1,NASDAQ
4678,13-02-2021 02:00,24 hrs.,StockMarket,EXPE,13,0,13,-13,1,3,3,1,NASDAQ
4678,13-02-2021 02:00,24 hrs.,StockMarket,FROG,16,16,0,16,1,6,0,1,NASDAQ
4678,13-02-2021 02:00,24 hrs.,StockMarket,GBIO,7,7,0,7,1,1,1,1,NASDAQ
4678,13-02-2021 02:00,24 hrs.,StockMarket,GTHX,33,33,0,33,1,5,19,1,NASDAQ
4678,13-02-2021 02:00,24 hrs.,StockMarket,HTBX,76,70,6,64,3,19,26,3,NASDAQ
4678,13-02-2021 02:00,24 hrs.,StockMarket,IDEX,6,6,0,6,1,1,0,1,NASDAQ
4678,13-02-2021 02:00,24 hrs.,StockMarket,IIVI,13,0,13,-13,1,3,3,1,NASDAQ
4678,13-02-2021 02:00,24 hrs.,StockMarket,INPX,6,6,0,6,1,1,0,1,NASDAQ
4678,13-02-2021 02:00,24 hrs.,StockMarket,INTZ,4,0,4,-4,1,0,0,1,NASDAQ
4678,13-02-2021 02:00,24 hrs.,StockMarket,INVE,24,0,24,-24,2,6,4,1,NASDAQ
4678,13-02-2021 02:00,24 hrs.,pennystocks,TSNP,65,59,6,53,5,6,33,5,OTC
4678,13-02-2021 02:00,24 hrs.,pennystocks,TSTS,12,0,12,-12,2,2,0,1,OTC
4678,13-02-2021 02:00,24 hrs.,pennystocks,USMJ,43,43,0,43,2,10,15,2,OTC
4678,13-02-2021 02:00,24 hrs.,pennystocks,USRM,6,0,6,-6,1,1,0,1,OTC
4678,13-02-2021 02:00,24 hrs.,pennystocks,VFRM,6,6,0,6,1,1,0,1,OTC
4678,13-02-2021 02:00,24 hrs.,pennystocks,VPER,17,17,0,17,1,2,9,1,OTC
4678,13-02-2021 02:00,24 hrs.,StockMarket,MKSI,13,0,13,-13,1,3,3,1,NASDAQ
4678,13-02-2021 02:00,24 hrs.,StockMarket,MSFT,17,17,0,17,1,3,7,1,NASDAQ
4678,13-02-2021 02:00,24 hrs.,StockMarket,MSTR,12,0,12,-12,2,2,0,1,NASDAQ
4678,13-02-2021 02:00,24 hrs.,StockMarket,MTCH,7,7,0,7,1,0,3,1,NASDAQ
4678,13-02-2021 02:00,24 hrs.,StockMarket,OCGN,25,25,0,25,3,2,9,3,NASDAQ
4678,13-02-2021 02:00,24 hrs.,StockMarket,PACB,4,0,4,-4,1,0,0,1,NASDAQ
4678,13-02-2021 02:00,24 hrs.,StockMarket,PTON,17,17,0,17,1,3,7,1,NASDAQ
4678,13-02-2021 02:00,24 hrs.,StockMarket,PYPL,20,0,20,-20,1,6,4,1,NASDAQ
4678,13-02-2021 02:00,24 hrs.,StockMarket,RARE,16,16,0,16,1,6,0,1,NASDAQ
4678,13-02-2021 02:00,24 hrs.,StockMarket,RBBN,6,6,0,6,1,1,0,1,NASDAQ
4678,13-02-2021 02:00,24 hrs.,StockMarket,RCMT,4,0,4,-4,1,0,0,1,NASDAQ
4678,13-02-2021 02:00,24 hrs.,StockMarket,REAL,34,34,0,34,1,0,30,1,NASDAQ
4678,13-02-2021 02:00,24 hrs.,StockMarket,RIDE,19,6,13,-7,2,4,3,2,NASDAQ
4678,13-02-2021 02:00,24 hrs.,StockMarket,SBUX,17,17,0,17,1,3,7,1,NASDAQ
4678,13-02-2021 02:00,24 hrs.,StockMarket,SESN,24,24,0,24,2,6,4,1,NASDAQ
4678,13-02-2021 02:00,24 hrs.,StockMarket,SNDL,406,6,400,-394,7,118,142,7,NASDAQ
4678,13-02-2021 02:00,24 hrs.,StockMarket,SPSC,16,16,0,16,1,6,0,1,NASDAQ
4678,13-02-2021 02:00,24 hrs.,StockMarket,SRAC,8,8,0,8,1,0,4,1,NASDAQ
4678,13-02-2021 02:00,24 hrs.,StockMarket,SVMK,13,0,13,-13,1,3,3,1,NASDAQ
4678,13-02-2021 02:00,24 hrs.,StockMarket,TLRY,93,47,46,1,7,23,19,7,NASDAQ
4678,13-02-2021 02:00,24 hrs.,StockMarket,TLSA,4,0,4,-4,1,0,0,1,NASDAQ
4678,13-02-2021 02:00,24 hrs.,StockMarket,TNXP,6,0,6,-6,1,1,0,1,NASDAQ
4678,13-02-2021 02:00,24 hrs.,StockMarket,TRVG,6,6,0,6,1,1,0,1,NASDAQ
4678,13-02-2021 02:00,24 hrs.,StockMarket,TSLA,6,6,0,6,1,1,0,1,NASDAQ
4678,13-02-2021 02:00,24 hrs.,StockMarket,VITL,6,6,0,6,1,1,0,1,NASDAQ
4678,13-02-2021 02:00,24 hrs.,StockMarket,VRSN,13,0,13,-13,1,3,3,1,NASDAQ
4678,13-02-2021 02:00,24 hrs.,StockMarket,VUZI,6,6,0,6,1,1,0,1,NASDAQ
4678,13-02-2021 02:00,24 hrs.,StockMarket,WAFU,81,81,0,81,1,19,39,1,NASDAQ
4678,13-02-2021 02:00,24 hrs.,StockMarket,ZIOP,6,6,0,6,1,1,0,1,NASDAQ
4678,13-02-2021 02:00,24 hrs.,StockMarket,SRACU,8,8,0,8,1,0,4,1,NASDAQ
4678,13-02-2021 02:00,24 hrs.,StockMarket,SRACW,8,8,0,8,1,0,4,1,NASDAQ
4678,13-02-2021 02:00,24 hrs.,pennystocks,AABB,12,0,12,-12,2,2,0,1,OTC
4678,13-02-2021 02:00,24 hrs.,pennystocks,ABML,115,115,0,115,2,34,39,2,OTC
4678,13-02-2021 02:00,24 hrs.,pennystocks,ADTM,13,13,0,13,2,2,1,1,OTC
4678,13-02-2021 02:00,24 hrs.,pennystocks,AEPT,6,0,6,-6,1,1,0,1,OTC
4678,13-02-2021 02:00,24 hrs.,pennystocks,AFPW,6,6,0,6,1,1,0,1,OTC
4678,13-02-2021 02:00,24 hrs.,pennystocks,AITX,358,352,6,346,5,115,108,5,OTC
4678,13-02-2021 02:00,24 hrs.,pennystocks,ALKM,26,7,19,-12,4,4,2,2,OTC
4678,13-02-2021 02:00,24 hrs.,pennystocks,ALPP,384,384,0,384,6,130,100,5,OTC
4678,13-02-2021 02:00,24 hrs.,pennystocks,ALST,26,26,0,26,2,3,12,1,OTC
4678,13-02-2021 02:00,24 hrs.,pennystocks,ALYI,189,44,145,-101,4,62,49,4,OTC
4678,13-02-2021 02:00,24 hrs.,pennystocks,ANDI,7,0,7,-7,1,1,1,1,OTC
4678,13-02-2021 02:00,24 hrs.,pennystocks,APPZ,7,0,7,-7,1,1,1,1,OTC
4678,13-02-2021 02:00,24 hrs.,pennystocks,ASCK,6,6,0,6,1,1,0,1,OTC
4678,13-02-2021 02:00,24 hrs.,pennystocks,ASTI,18,18,0,18,3,3,0,3,OTC
4678,13-02-2021 02:00,24 hrs.,pennystocks,ATDS,6,6,0,6,1,1,0,1,OTC
4678,13-02-2021 02:00,24 hrs.,pennystocks,ATNP,29,29,0,29,1,5,15,1,OTC
4678,13-02-2021 02:00,24 hrs.,pennystocks,AXXA,22,22,0,22,1,7,4,1,OTC
4678,13-02-2021 02:00,24 hrs.,pennystocks,AZFL,95,0,95,-95,4,9,61,3,OTC
4678,13-02-2021 02:00,24 hrs.,pennystocks,BANT,25,6,19,-13,2,4,9,2,OTC
4678,13-02-2021 02:00,24 hrs.,pennystocks,BBRW,164,164,0,164,4,35,78,4,OTC
4678,13-02-2021 02:00,24 hrs.,pennystocks,BDGR,6,6,0,6,1,1,0,1,OTC
4678,13-02-2021 02:00,24 hrs.,pennystocks,CTRM,129,52,77,-25,7,34,33,7,NASDAQ
4678,13-02-2021 02:00,24 hrs.,pennystocks,CTXR,20,20,0,20,1,6,4,1,NASDAQ
4678,13-02-2021 02:00,24 hrs.,pennystocks,CYTH,8,8,0,8,1,1,2,1,NASDAQ
4678,13-02-2021 02:00,24 hrs.,pennystocks,DFFN,288,265,23,242,8,107,42,7,NASDAQ
4678,13-02-2021 02:00,24 hrs.,pennystocks,EBON,6,6,0,6,1,1,0,1,NASDAQ
4678,13-02-2021 02:00,24 hrs.,pennystocks,EDIT,199,0,199,-199,1,89,17,1,NASDAQ
4678,13-02-2021 02:00,24 hrs.,pennystocks,KOD,6,0,6,-6,1,1,0,1,NASDAQ
4678,13-02-2021 02:00,24 hrs.,pennystocks,MKD,21,0,21,-21,1,5,7,1,NASDAQ
4678,13-02-2021 02:00,24 hrs.,pennystocks,MYT,11,0,11,-11,1,1,5,1,NASDAQ
4678,13-02-2021 02:00,24 hrs.,pennystocks,OGI,26,19,7,12,2,7,4,2,NASDAQ
4678,13-02-2021 02:00,24 hrs.,pennystocks,SPI,12,12,0,12,1,3,2,1,NASDAQ
4678,13-02-2021 02:00,24 hrs.,pennystocks,UFO,6,0,6,-6,1,1,0,1,NASDAQ
4678,13-02-2021 02:00,24 hrs.,pennystocks,FATE,19,0,19,-19,1,7,1,1,NASDAQ
4678,13-02-2021 02:00,24 hrs.,pennystocks,FCEL,100,0,100,-100,1,20,56,1,NASDAQ
4678,13-02-2021 02:00,24 hrs.,pennystocks,GAIN,7,7,0,7,1,1,1,1,NASDAQ
4678,13-02-2021 02:00,24 hrs.,pennystocks,GALT,7,7,0,7,1,1,1,1,NASDAQ
4678,13-02-2021 02:00,24 hrs.,pennystocks,GEVO,6,6,0,6,1,1,0,1,NASDAQ
4678,13-02-2021 02:00,24 hrs.,pennystocks,GHSI,85,79,6,73,2,37,3,2,NASDAQ
4678,13-02-2021 02:00,24 hrs.,pennystocks,GLBS,27,27,0,27,1,0,23,1,NASDAQ
4678,13-02-2021 02:00,24 hrs.,pennystocks,GNPX,5,5,0,5,1,0,1,1,NASDAQ
4678,13-02-2021 02:00,24 hrs.,pennystocks,GNUS,6,6,0,6,1,1,0,1,NASDAQ
4678,13-02-2021 02:00,24 hrs.,pennystocks,GOEV,86,86,0,86,2,25,28,2,NASDAQ
4678,13-02-2021 02:00,24 hrs.,pennystocks,GRIL,45,0,45,-45,1,15,11,1,NASDAQ
4678,13-02-2021 02:00,24 hrs.,pennystocks,HRTX,15,15,0,15,1,2,7,1,NASDAQ
4678,13-02-2021 02:00,24 hrs.,pennystocks,HSTO,12,6,6,0,2,2,0,2,NASDAQ
4678,13-02-2021 02:00,24 hrs.,pennystocks,IBKR,7,7,0,7,1,1,1,1,NASDAQ
4678,13-02-2021 02:00,24 hrs.,pennystocks,IDEX,5,5,0,5,1,0,1,1,NASDAQ
4678,13-02-2021 02:00,24 hrs.,pennystocks,IFMK,45,0,45,-45,1,15,11,1,NASDAQ
4678,13-02-2021 02:00,24 hrs.,pennystocks,INFI,13,13,0,13,1,1,7,1,NASDAQ
4678,13-02-2021 02:00,24 hrs.,pennystocks,INOD,73,73,0,73,1,13,43,1,NASDAQ
4678,13-02-2021 02:00,24 hrs.,pennystocks,INPX,6,0,6,-6,1,1,0,1,NASDAQ
4678,13-02-2021 02:00,24 hrs.,pennystocks,IRDM,19,0,19,-19,1,7,1,1,NASDAQ
4678,13-02-2021 02:00,24 hrs.,pennystocks,IZEA,6,6,0,6,1,1,0,1,NASDAQ
4678,13-02-2021 02:00,24 hrs.,pennystocks,KTRA,168,51,117,-66,5,48,52,5,NASDAQ
4678,13-02-2021 02:00,24 hrs.,pennystocks,KXIN,19,0,19,-19,1,7,1,1,NASDAQ
4678,13-02-2021 02:00,24 hrs.,pennystocks,LKCO,9,0,9,-9,1,2,1,1,NASDAQ
4678,13-02-2021 02:00,24 hrs.,pennystocks,LLIT,7,7,0,7,1,1,1,1,NASDAQ
4678,13-02-2021 02:00,24 hrs.,pennystocks,LPCN,52,0,52,-52,1,18,12,1,NASDAQ
4678,13-02-2021 02:00,24 hrs.,pennystocks,LPTH,63,63,0,63,1,24,11,1,NASDAQ
4678,13-02-2021 02:00,24 hrs.,pennystocks,MARK,106,6,100,-94,2,21,56,2,NASDAQ
4678,13-02-2021 02:00,24 hrs.,pennystocks,MDGS,6,0,6,-6,1,1,0,1,NASDAQ
4678,13-02-2021 02:00,24 hrs.,pennystocks,MVIS,16,10,6,4,2,1,6,2,NASDAQ
4678,13-02-2021 02:00,24 hrs.,pennystocks,NAKD,40,33,7,26,2,8,16,2,NASDAQ
4678,13-02-2021 02:00,24 hrs.,pennystocks,NAOV,6,6,0,6,1,1,0,1,NASDAQ
4678,13-02-2021 02:00,24 hrs.,pennystocks,NCMI,17,17,0,17,1,5,3,1,NASDAQ
4678,13-02-2021 02:00,24 hrs.,pennystocks,NDAQ,19,0,19,-19,1,7,1,1,NASDAQ
4678,13-02-2021 02:00,24 hrs.,pennystocks,NOVN,6,0,6,-6,1,1,0,1,NASDAQ
4678,13-02-2021 02:00,24 hrs.,pennystocks,NVCN,59,59,0,59,3,17,13,2,NASDAQ
4678,13-02-2021 02:00,24 hrs.,pennystocks,OCGN,62,62,0,62,3,16,18,3,NASDAQ
4678,13-02-2021 02:00,24 hrs.,pennystocks,ONTX,6,0,6,-6,1,1,0,1,NASDAQ
4678,13-02-2021 02:00,24 hrs.,pennystocks,OPTT,22,22,0,22,1,7,4,1,NASDAQ
4678,13-02-2021 02:00,24 hrs.,pennystocks,OTIC,10,10,0,10,1,1,4,1,NASDAQ
4678,13-02-2021 02:00,24 hrs.,pennystocks,PLAY,6,6,0,6,1,1,0,1,NASDAQ
4678,13-02-2021 02:00,24 hrs.,pennystocks,PLUG,119,0,119,-119,2,27,57,2,NASDAQ
4678,13-02-2021 02:00,24 hrs.,pennystocks,PSTV,75,0,75,-75,2,28,11,2,NASDAQ
4678,13-02-2021 02:00,24 hrs.,pennystocks,PULM,188,188,0,188,4,37,98,4,NASDAQ
4678,13-02-2021 02:00,24 hrs.,pennystocks,RAVE,45,0,45,-45,1,15,11,1,NASDAQ
4678,13-02-2021 02:00,24 hrs.,pennystocks,REAL,56,0,56,-56,1,9,34,1,NASDAQ
4678,13-02-2021 02:00,24 hrs.,pennystocks,RIBT,13,13,0,13,2,2,1,1,NASDAQ
4678,13-02-2021 02:00,24 hrs.,pennystocks,RIDE,6,6,0,6,1,1,0,1,NASDAQ
4678,13-02-2021 02:00,24 hrs.,pennystocks,RIGL,12,0,12,-12,2,2,0,2,NASDAQ
4678,13-02-2021 02:00,24 hrs.,pennystocks,RMTI,6,0,6,-6,1,1,0,1,NASDAQ
4678,13-02-2021 02:00,24 hrs.,pennystocks,SEAC,12,0,12,-12,1,2,4,1,NASDAQ
4678,13-02-2021 02:00,24 hrs.,pennystocks,SELB,20,20,0,20,1,6,4,1,NASDAQ
4678,13-02-2021 02:00,24 hrs.,pennystocks,SESN,38,38,0,38,1,15,4,1,NASDAQ
4678,13-02-2021 02:00,24 hrs.,pennystocks,SFET,34,34,0,34,2,7,12,2,NASDAQ
4678,13-02-2021 02:00,24 hrs.,pennystocks,SHIP,20,14,6,8,3,3,2,2,NASDAQ
4678,13-02-2021 02:00,24 hrs.,pennystocks,SNDL,144,57,87,-30,23,23,6,19,NASDAQ
4678,13-02-2021 02:00,24 hrs.,pennystocks,SNGX,1869,573,1296,-723,15,728,353,6,NASDAQ
4678,13-02-2021 02:00,24 hrs.,pennystocks,SOLO,19,0,19,-19,1,7,1,1,NASDAQ
4678,13-02-2021 02:00,24 hrs.,StockMarket,LAZR,6,0,6,-6,1,1,0,1,NASDAQ
4678,13-02-2021 02:00,24 hrs.,StockMarket,LGND,6,0,6,-6,1,1,0,1,NASDAQ
4678,13-02-2021 02:00,24 hrs.,StockMarket,LIFE,3971,0,3971,-3971,1,1940,87,1,NASDAQ
4678,13-02-2021 02:00,24 hrs.,StockMarket,LITE,13,0,13,-13,1,3,3,1,NASDAQ
4678,13-02-2021 02:00,24 hrs.,StockMarket,LIVE,13,0,13,-13,1,3,3,1,NASDAQ
4678,13-02-2021 02:00,24 hrs.,StockMarket,LLNW,25,0,25,-25,4,4,1,1,NASDAQ
4678,13-02-2021 02:00,24 hrs.,pennystocks,TRCH,56,56,0,56,3,12,20,3,NASDAQ
4678,13-02-2021 02:00,24 hrs.,pennystocks,TRVG,19,19,0,19,3,3,1,2,NASDAQ
4678,13-02-2021 02:00,24 hrs.,pennystocks,TSLA,6,0,6,-6,1,1,0,1,NASDAQ
4678,13-02-2021 02:00,24 hrs.,pennystocks,TXMD,7,7,0,7,1,1,1,1,NASDAQ
4678,13-02-2021 02:00,24 hrs.,pennystocks,TYME,20,20,0,20,1,6,4,1,NASDAQ
4678,13-02-2021 02:00,24 hrs.,pennystocks,USWS,6,0,6,-6,1,1,0,1,NASDAQ
4678,13-02-2021 02:00,24 hrs.,pennystocks,VEON,7,7,0,7,1,1,1,1,NASDAQ
4678,13-02-2021 02:00,24 hrs.,pennystocks,VETS,1290,1290,0,1290,1,538,210,1,NASDAQ
4678,13-02-2021 02:00,24 hrs.,pennystocks,VTGN,7,7,0,7,1,1,1,1,NASDAQ
4678,13-02-2021 02:00,24 hrs.,pennystocks,VUZI,5,5,0,5,1,0,1,1,NASDAQ
4678,13-02-2021 02:00,24 hrs.,pennystocks,WTRH,45,0,45,-45,1,15,11,1,NASDAQ
4678,13-02-2021 02:00,24 hrs.,pennystocks,XELA,199,0,199,-199,1,89,17,1,NASDAQ
4678,13-02-2021 02:00,24 hrs.,pennystocks,XSPA,38,38,0,38,1,15,4,1,NASDAQ
4678,13-02-2021 02:00,24 hrs.,pennystocks,ZSAN,91,85,6,79,3,26,27,3,NASDAQ
4678,13-02-2021 02:00,24 hrs.,wallstreetbets,ABML,20,7,13,-6,3,3,2,3,OTC
4678,13-02-2021 02:00,24 hrs.,wallstreetbets,ABQQ,7,0,7,-7,1,1,1,1,OTC
4678,13-02-2021 02:00,24 hrs.,wallstreetbets,ACRL,6,6,0,6,1,1,0,1,OTC
4678,13-02-2021 02:00,24 hrs.,wallstreetbets,ACTX,8,8,0,8,1,1,2,1,OTC
4678,13-02-2021 02:00,24 hrs.,wallstreetbets,AITX,14,0,14,-14,2,2,2,2,OTC
4678,13-02-2021 02:00,24 hrs.,wallstreetbets,ALPP,14,7,7,0,2,2,2,2,OTC
4678,13-02-2021 02:00,24 hrs.,wallstreetbets,ALYI,14,7,7,0,2,2,2,2,OTC
4678,13-02-2021 02:00,24 hrs.,wallstreetbets,AMNE,13,13,0,13,2,2,1,1,OTC
4678,13-02-2021 02:00,24 hrs.,wallstreetbets,APCX,7,7,0,7,1,1,1,1,OTC
4678,13-02-2021 02:00,24 hrs.,wallstreetbets,BANT,13,13,0,13,2,2,1,2,OTC
4678,13-02-2021 02:00,24 hrs.,wallstreetbets,BBRW,20,14,6,8,3,3,2,2,OTC
4678,13-02-2021 02:00,24 hrs.,wallstreetbets,BIEL,19,0,19,-19,3,3,1,3,OTC
4678,13-02-2021 02:00,24 hrs.,wallstreetbets,BLSP,21,21,0,21,3,3,3,1,OTC
4678,13-02-2021 02:00,24 hrs.,wallstreetbets,BMIX,11,0,11,-11,1,1,5,1,OTC
4678,13-02-2021 02:00,24 hrs.,wallstreetbets,BOTH,7,7,0,7,1,1,1,1,OTC
4678,13-02-2021 02:00,24 hrs.,wallstreetbets,BOTY,6,6,0,6,1,1,0,1,OTC
4678,13-02-2021 02:00,24 hrs.,wallstreetbets,BRLL,7,7,0,7,1,1,1,1,OTC
4678,13-02-2021 02:00,24 hrs.,wallstreetbets,BTCS,21,21,0,21,3,3,3,1,OTC
4678,13-02-2021 02:00,24 hrs.,wallstreetbets,BTSC,7,7,0,7,1,1,1,1,OTC
4678,13-02-2021 02:00,24 hrs.,wallstreetbets,BTZI,13,13,0,13,2,2,1,2,OTC
4678,13-02-2021 02:00,24 hrs.,wallstreetbets,BUDZ,6,6,0,6,1,1,0,1,OTC
4678,13-02-2021 02:00,24 hrs.,wallstreetbets,CBDD,7,7,0,7,1,1,1,1,OTC
4678,13-02-2021 02:00,24 hrs.,wallstreetbets,CBDL,55,55,0,55,8,8,7,5,OTC
4678,13-02-2021 02:00,24 hrs.,wallstreetbets,CCTC,7,7,0,7,1,1,1,1,OTC
4678,13-02-2021 02:00,24 hrs.,wallstreetbets,CCTL,6,0,6,-6,1,1,0,1,OTC
4678,13-02-2021 02:00,24 hrs.,wallstreetbets,CGEI,7,0,7,-7,1,1,1,1,OTC
4678,13-02-2021 02:00,24 hrs.,wallstreetbets,CGLD,7,7,0,7,1,1,1,1,OTC
4678,13-02-2021 02:00,24 hrs.,wallstreetbets,CHUC,7,0,7,-7,1,1,1,1,OTC
4678,13-02-2021 02:00,24 hrs.,wallstreetbets,CLIS,14,14,0,14,2,2,2,1,OTC
4678,13-02-2021 02:00,24 hrs.,wallstreetbets,CLWD,7,7,0,7,1,1,1,1,OTC
4678,13-02-2021 02:00,24 hrs.,wallstreetbets,COMS,19,19,0,19,3,3,1,2,OTC
4678,13-02-2021 02:00,24 hrs.,wallstreetbets,CYDY,7,7,0,7,1,1,1,1,OTC
4678,13-02-2021 02:00,24 hrs.,wallstreetbets,CYLC,7,7,0,7,1,1,1,1,OTC
4678,13-02-2021 02:00,24 hrs.,wallstreetbets,DGWR,7,7,0,7,1,1,1,1,OTC
4678,13-02-2021 02:00,24 hrs.,wallstreetbets,DIGI,14,0,14,-14,2,2,2,1,OTC
4678,13-02-2021 02:00,24 hrs.,wallstreetbets,DPLS,13,13,0,13,2,2,1,2,OTC
4678,13-02-2021 02:00,24 hrs.,wallstreetbets,DPWW,7,7,0,7,1,1,1,1,OTC
4678,13-02-2021 02:00,24 hrs.,wallstreetbets,ELCR,28,7,21,-14,4,4,4,2,OTC
4678,13-02-2021 02:00,24 hrs.,wallstreetbets,ELTP,31,31,0,31,4,4,7,4,OTC
4678,13-02-2021 02:00,24 hrs.,wallstreetbets,ENZN,7,0,7,-7,1,1,1,1,OTC
4678,13-02-2021 02:00,24 hrs.,wallstreetbets,EPOR,8,8,0,8,1,1,2,1,OTC
4678,13-02-2021 02:00,24 hrs.,wallstreetbets,ETFM,23,17,6,11,3,3,5,2,OTC
4678,13-02-2021 02:00,24 hrs.,wallstreetbets,EWKS,6,6,0,6,1,1,0,1,OTC
4678,13-02-2021 02:00,24 hrs.,wallstreetbets,FTEG,14,14,0,14,2,2,2,1,OTC
4678,13-02-2021 02:00,24 hrs.,pennystocks,ENPH,100,0,100,-100,1,20,56,1,NASDAQ
4678,13-02-2021 02:00,24 hrs.,pennystocks,ENTX,24,24,0,24,1,8,4,1,NASDAQ
4678,13-02-2021 02:00,24 hrs.,pennystocks,ENVB,6,0,6,-6,1,1,0,1,NASDAQ
4678,13-02-2021 02:00,24 hrs.,pennystocks,EPSN,12,12,0,12,2,2,0,2,NASDAQ
4678,13-02-2021 02:00,24 hrs.,pennystocks,FAMI,13,13,0,13,2,2,1,2,NASDAQ
4678,13-02-2021 02:00,24 hrs.,pennystocks,FAST,6,6,0,6,1,1,0,1,NASDAQ
4678,13-02-2021 02:00,24 hrs.,wallstreetbets,GPFT,34,27,7,20,5,5,4,5,OTC
4678,13-02-2021 02:00,24 hrs.,wallstreetbets,GRNH,6,0,6,-6,1,1,0,1,OTC
4678,13-02-2021 02:00,24 hrs.,wallstreetbets,GTCH,7,7,0,7,1,1,1,1,OTC
4678,13-02-2021 02:00,24 hrs.,wallstreetbets,GTEH,20,20,0,20,3,3,2,2,OTC
4678,13-02-2021 02:00,24 hrs.,wallstreetbets,GTII,1289,0,1289,-1289,1,460,365,1,OTC
4678,13-02-2021 02:00,24 hrs.,wallstreetbets,GTLL,13,0,13,-13,2,2,1,2,OTC
4678,13-02-2021 02:00,24 hrs.,wallstreetbets,GTXO,14,14,0,14,2,2,2,1,OTC
4678,13-02-2021 02:00,24 hrs.,wallstreetbets,HCMC,360,231,129,102,53,53,42,50,OTC
4678,13-02-2021 02:00,24 hrs.,wallstreetbets,HEMP,21,21,0,21,3,3,3,2,OTC
4678,13-02-2021 02:00,24 hrs.,wallstreetbets,HGLC,14,14,0,14,2,2,2,1,OTC
4678,13-02-2021 02:00,24 hrs.,wallstreetbets,HIHI,7,0,7,-7,1,1,1,1,OTC
4678,13-02-2021 02:00,24 hrs.,wallstreetbets,HIPH,14,0,14,-14,2,2,2,2,OTC
4678,13-02-2021 02:00,24 hrs.,wallstreetbets,HMNY,62,42,20,22,9,9,8,5,OTC
4678,13-02-2021 02:00,24 hrs.,wallstreetbets,HMPQ,7,7,0,7,1,1,1,1,OTC
4678,13-02-2021 02:00,24 hrs.,wallstreetbets,HQGE,35,35,0,35,5,5,5,3,OTC
4678,13-02-2021 02:00,24 hrs.,wallstreetbets,HRBR,6,6,0,6,1,1,0,1,OTC
4678,13-02-2021 02:00,24 hrs.,wallstreetbets,HTRE,7,7,0,7,1,1,1,1,OTC
4678,13-02-2021 02:00,24 hrs.,wallstreetbets,HYSR,13,13,0,13,2,2,1,2,OTC
4678,13-02-2021 02:00,24 hrs.,wallstreetbets,ICBU,7,7,0,7,1,1,1,1,OTC
4678,13-02-2021 02:00,24 hrs.,wallstreetbets,INCT,21,21,0,21,3,3,3,2,OTC
4678,13-02-2021 02:00,24 hrs.,wallstreetbets,INKW,7,7,0,7,1,1,1,1,OTC
4678,13-02-2021 02:00,24 hrs.,wallstreetbets,INND,20,14,6,8,3,3,2,2,OTC
4678,13-02-2021 02:00,24 hrs.,wallstreetbets,INTV,21,21,0,21,3,3,3,2,OTC
4678,13-02-2021 02:00,24 hrs.,wallstreetbets,IPIX,10,10,0,10,1,3,0,1,OTC
4678,13-02-2021 02:00,24 hrs.,wallstreetbets,IQST,13,13,0,13,2,2,1,1,OTC
4678,13-02-2021 02:00,24 hrs.,wallstreetbets,ITCJ,6,6,0,6,1,1,0,1,OTC
4678,13-02-2021 02:00,24 hrs.,wallstreetbets,KALY,7,7,0,7,1,1,1,1,OTC
4678,13-02-2021 02:00,24 hrs.,wallstreetbets,KGKG,7,0,7,-7,1,1,1,1,OTC
4678,13-02-2021 02:00,24 hrs.,wallstreetbets,KRFG,7,0,7,-7,1,1,1,1,OTC
4678,13-02-2021 02:00,24 hrs.,wallstreetbets,KWBT,7,0,7,-7,1,1,1,1,OTC
4678,13-02-2021 02:00,24 hrs.,wallstreetbets,KYNC,14,0,14,-14,2,2,2,2,OTC
4678,13-02-2021 02:00,24 hrs.,wallstreetbets,LBCC,7,7,0,7,1,1,1,1,OTC
4678,13-02-2021 02:00,24 hrs.,wallstreetbets,LINK,445,26,419,-393,5,175,75,5,OTC
4678,13-02-2021 02:00,24 hrs.,pennystocks,BFRE,16,16,0,16,1,0,12,1,OTC
4678,13-02-2021 02:00,24 hrs.,pennystocks,BGMD,6,6,0,6,1,1,0,1,OTC
4678,13-02-2021 02:00,24 hrs.,pennystocks,BIEL,112,106,6,100,4,29,38,4,OTC
4678,13-02-2021 02:00,24 hrs.,pennystocks,BKMP,6,0,6,-6,1,1,0,1,OTC
4678,13-02-2021 02:00,24 hrs.,pennystocks,BLDV,60,60,0,60,1,19,18,1,OTC
4678,13-02-2021 02:00,24 hrs.,pennystocks,BLSP,13,6,7,-1,2,2,1,2,OTC
4678,13-02-2021 02:00,24 hrs.,pennystocks,BMCS,10,10,0,10,1,2,2,1,OTC
4678,13-02-2021 02:00,24 hrs.,pennystocks,BMIX,45,0,45,-45,2,8,21,2,OTC
4678,13-02-2021 02:00,24 hrs.,pennystocks,BMMJ,6,6,0,6,1,1,0,1,OTC
4678,13-02-2021 02:00,24 hrs.,pennystocks,BONZ,6,6,0,6,1,0,2,1,OTC
4678,13-02-2021 02:00,24 hrs.,pennystocks,BOTY,14,0,14,-14,2,2,2,1,OTC
4678,13-02-2021 02:00,24 hrs.,pennystocks,BRGO,19,0,19,-19,1,6,3,1,OTC
4678,13-02-2021 02:00,24 hrs.,pennystocks,BRLL,45,45,0,45,2,3,31,2,OTC
4678,13-02-2021 02:00,24 hrs.,pennystocks,BRTX,12,12,0,12,2,2,0,2,OTC
4678,13-02-2021 02:00,24 hrs.,pennystocks,BRZL,6,6,0,6,1,1,0,1,OTC
4678,13-02-2021 02:00,24 hrs.,pennystocks,BTZI,6,6,0,6,1,1,0,1,OTC
4678,13-02-2021 02:00,24 hrs.,pennystocks,BUDZ,24,13,11,2,3,4,4,3,OTC
4678,13-02-2021 02:00,24 hrs.,pennystocks,BWMG,61,28,33,-5,2,16,21,2,OTC
4678,13-02-2021 02:00,24 hrs.,pennystocks,BZWR,15,15,0,15,1,0,11,1,OTC
4678,13-02-2021 02:00,24 hrs.,pennystocks,CANN,6,6,0,6,1,1,0,1,OTC
4678,13-02-2021 02:00,24 hrs.,pennystocks,CAPC,7,7,0,7,1,1,1,1,OTC
4678,13-02-2021 02:00,24 hrs.,pennystocks,CATV,119,119,0,119,1,51,13,1,OTC
4678,13-02-2021 02:00,24 hrs.,pennystocks,CAVR,6,6,0,6,1,1,0,1,OTC
4678,13-02-2021 02:00,24 hrs.,pennystocks,CBBT,500,371,129,242,7,193,86,6,OTC
4678,13-02-2021 02:00,24 hrs.,pennystocks,CBDD,5,0,5,-5,1,0,1,1,OTC
4678,13-02-2021 02:00,24 hrs.,pennystocks,SRGA,6,6,0,6,1,1,0,1,NASDAQ
4678,13-02-2021 02:00,24 hrs.,pennystocks,STCN,6,6,0,6,1,1,0,1,NASDAQ
4678,13-02-2021 02:00,24 hrs.,pennystocks,TBLT,6,6,0,6,1,1,0,1,NASDAQ
4678,13-02-2021 02:00,24 hrs.,pennystocks,TLRY,14,7,7,0,2,2,2,2,NASDAQ
4678,13-02-2021 02:00,24 hrs.,pennystocks,TMDI,6,0,6,-6,1,1,0,1,NASDAQ
4678,13-02-2021 02:00,24 hrs.,pennystocks,TNXP,476,153,323,-170,11,170,92,7,NASDAQ
4678,13-02-2021 02:00,24 hrs.,pennystocks,CORG,37,7,30,-23,3,4,17,3,OTC
4678,13-02-2021 02:00,24 hrs.,pennystocks,CRTG,35,35,0,35,1,11,9,1,OTC
4678,13-02-2021 02:00,24 hrs.,pennystocks,CRWG,6,0,6,-6,1,1,0,1,OTC
4678,13-02-2021 02:00,24 hrs.,pennystocks,CSLI,41,41,0,41,1,11,15,1,OTC
4678,13-02-2021 02:00,24 hrs.,pennystocks,CTLE,12,6,6,0,2,2,0,2,OTC
4678,13-02-2021 02:00,24 hrs.,pennystocks,CYDY,7,7,0,7,1,1,1,1,OTC
4678,13-02-2021 02:00,24 hrs.,pennystocks,CYPW,6,0,6,-6,1,1,0,1,OTC
4678,13-02-2021 02:00,24 hrs.,pennystocks,DGMA,6,0,6,-6,1,1,0,1,OTC
4678,13-02-2021 02:00,24 hrs.,pennystocks,DIGI,13,0,13,-13,2,2,1,1,OTC
4678,13-02-2021 02:00,24 hrs.,pennystocks,DMAN,17,17,0,17,1,4,5,1,OTC
4678,13-02-2021 02:00,24 hrs.,pennystocks,DPLS,208,109,99,10,8,69,38,7,OTC
4678,13-02-2021 02:00,24 hrs.,pennystocks,ECCI,6,0,6,-6,1,1,0,1,OTC
4678,13-02-2021 02:00,24 hrs.,pennystocks,EHOS,27,27,0,27,1,5,13,1,OTC
4678,13-02-2021 02:00,24 hrs.,pennystocks,ELTP,16,16,0,16,1,4,4,1,OTC
4678,13-02-2021 02:00,24 hrs.,pennystocks,ENCS,6,0,6,-6,1,1,0,1,OTC
4678,13-02-2021 02:00,24 hrs.,pennystocks,ENDV,6,0,6,-6,1,1,0,1,OTC
4678,13-02-2021 02:00,24 hrs.,pennystocks,ENRT,6,6,0,6,1,1,0,1,OTC
4678,13-02-2021 02:00,24 hrs.,pennystocks,ENZC,12,12,0,12,2,2,0,2,OTC
4678,13-02-2021 02:00,24 hrs.,pennystocks,ERBB,26,12,14,-2,2,2,14,2,OTC
4678,13-02-2021 02:00,24 hrs.,pennystocks,ETFM,170,164,6,158,4,55,44,3,OTC
4678,13-02-2021 02:00,24 hrs.,pennystocks,ETHE,37,0,37,-37,1,4,25,1,OTC
4678,13-02-2021 02:00,24 hrs.,pennystocks,EWKS,7,7,0,7,1,1,1,1,OTC
4678,13-02-2021 02:00,24 hrs.,pennystocks,FBEC,6,0,6,-6,1,1,0,1,OTC
4678,13-02-2021 02:00,24 hrs.,pennystocks,FDBH,7,0,7,-7,1,1,1,1,OTC
4678,13-02-2021 02:00,24 hrs.,pennystocks,FLXT,6,6,0,6,1,1,0,1,OTC
4678,13-02-2021 02:00,24 hrs.,pennystocks,FTEG,6,6,0,6,1,1,0,1,OTC
4678,13-02-2021 02:00,24 hrs.,pennystocks,FUST,7,7,0,7,1,1,1,1,OTC
4678,13-02-2021 02:00,24 hrs.,pennystocks,GBTC,37,0,37,-37,1,4,25,1,OTC
4678,13-02-2021 02:00,24 hrs.,pennystocks,GHMP,46,46,0,46,3,8,18,2,OTC
4678,13-02-2021 02:00,24 hrs.,pennystocks,GLCO,6,6,0,6,1,1,0,1,OTC
4678,13-02-2021 02:00,24 hrs.,pennystocks,GLEC,6,6,0,6,1,1,0,1,OTC
4678,13-02-2021 02:00,24 hrs.,pennystocks,GPFT,53,10,43,-33,2,12,21,2,OTC
4678,13-02-2021 02:00,24 hrs.,pennystocks,GRCU,15,15,0,15,1,3,5,1,OTC
4678,13-02-2021 02:00,24 hrs.,pennystocks,GRST,92,92,0,92,2,27,30,1,OTC
4678,13-02-2021 02:00,24 hrs.,pennystocks,GTBP,21,21,0,21,1,3,11,1,OTC
4678,13-02-2021 02:00,24 hrs.,pennystocks,GTCH,22,0,22,-22,1,1,16,1,OTC
4678,13-02-2021 02:00,24 hrs.,pennystocks,GTEH,25,25,0,25,1,6,9,1,OTC
4678,13-02-2021 02:00,24 hrs.,pennystocks,GTLL,143,25,118,-93,4,37,53,4,OTC
4678,13-02-2021 02:00,24 hrs.,pennystocks,HALB,33,22,11,11,2,9,7,2,OTC
4678,13-02-2021 02:00,24 hrs.,pennystocks,HCMC,115,77,38,39,18,18,7,15,OTC
4678,13-02-2021 02:00,24 hrs.,pennystocks,HEMP,14,7,7,0,2,2,2,2,OTC
4678,13-02-2021 02:00,24 hrs.,pennystocks,HENC,9,9,0,9,1,2,1,1,OTC
4678,13-02-2021 02:00,24 hrs.,pennystocks,HIPH,21,15,6,9,3,4,1,3,OTC
4678,13-02-2021 02:00,24 hrs.,pennystocks,HMMR,7,7,0,7,1,1,1,1,OTC
4678,13-02-2021 02:00,24 hrs.,pennystocks,HMNY,6,6,0,6,1,1,0,1,OTC
4678,13-02-2021 02:00,24 hrs.,pennystocks,HPTY,44,44,0,44,1,13,14,1,OTC
4678,13-02-2021 02:00,24 hrs.,pennystocks,HYII,7,0,7,-7,1,1,1,1,OTC
4678,13-02-2021 02:00,24 hrs.,pennystocks,HYSR,151,6,145,-139,2,51,41,2,OTC
4678,13-02-2021 02:00,24 hrs.,pennystocks,ICBU,6,6,0,6,1,1,0,1,OTC
4678,13-02-2021 02:00,24 hrs.,pennystocks,ICLD,6,6,0,6,1,1,0,1,OTC
4678,13-02-2021 02:00,24 hrs.,pennystocks,ICNM,15,15,0,15,1,3,5,1,OTC
4678,13-02-2021 02:00,24 hrs.,pennystocks,IMJX,99,93,6,87,2,27,37,2,OTC
4678,13-02-2021 02:00,24 hrs.,pennystocks,IMTL,6,6,0,6,1,1,0,1,OTC
4678,13-02-2021 02:00,24 hrs.,pennystocks,INKW,56,44,12,32,9,9,2,7,OTC
4678,13-02-2021 02:00,24 hrs.,pennystocks,INND,162,138,24,114,7,25,84,7,OTC
4678,13-02-2021 02:00,24 hrs.,pennystocks,INTV,12,12,0,12,2,2,0,2,OTC
4678,13-02-2021 02:00,24 hrs.,pennystocks,IPIX,6,0,6,-6,1,1,0,1,OTC
4678,13-02-2021 02:00,24 hrs.,pennystocks,IPSI,15,15,0,15,1,4,3,1,OTC
4678,13-02-2021 02:00,24 hrs.,wallstreetbets,FTPM,7,7,0,7,1,1,1,1,OTC
4678,13-02-2021 02:00,24 hrs.,wallstreetbets,GAHC,14,14,0,14,2,2,2,1,OTC
4678,13-02-2021 02:00,24 hrs.,wallstreetbets,GARB,7,7,0,7,1,1,1,1,OTC
4678,13-02-2021 02:00,24 hrs.,wallstreetbets,GBTC,5191,5183,8,5175,3,2428,323,3,OTC
4678,13-02-2021 02:00,24 hrs.,wallstreetbets,GMEV,14,14,0,14,2,2,2,2,OTC
4678,13-02-2021 02:00,24 hrs.,wallstreetbets,GMSC,14,0,14,-14,2,2,2,1,OTC
4678,13-02-2021 02:00,24 hrs.,pennystocks,AGGHF,17,17,0,17,1,3,7,1,OTC
4678,13-02-2021 02:00,24 hrs.,pennystocks,ALLIF,130,0,130,-130,1,39,48,1,OTC
4678,13-02-2021 02:00,24 hrs.,pennystocks,ARBKF,195,21,174,-153,4,43,93,4,OTC
4678,13-02-2021 02:00,24 hrs.,pennystocks,BDRBF,6,6,0,6,1,1,0,1,OTC
4678,13-02-2021 02:00,24 hrs.,pennystocks,BFARF,13,13,0,13,1,2,5,1,OTC
4678,13-02-2021 02:00,24 hrs.,pennystocks,BKLLF,79,79,0,79,1,24,27,1,OTC
4678,13-02-2021 02:00,24 hrs.,pennystocks,BNCHF,6,6,0,6,1,1,0,1,OTC
4678,13-02-2021 02:00,24 hrs.,pennystocks,BRPHF,37,0,37,-37,1,4,25,1,OTC
4678,13-02-2021 02:00,24 hrs.,pennystocks,BVNNF,7,7,0,7,1,1,1,1,OTC
4678,13-02-2021 02:00,24 hrs.,pennystocks,CANSF,5,5,0,5,1,0,1,1,OTC
4678,13-02-2021 02:00,24 hrs.,pennystocks,CBULF,6,6,0,6,1,1,0,1,OTC
4678,13-02-2021 02:00,24 hrs.,pennystocks,CBWTF,13,13,0,13,2,2,1,2,OTC
4678,13-02-2021 02:00,24 hrs.,pennystocks,CIOXY,7,7,0,7,1,1,1,1,OTC
4678,13-02-2021 02:00,24 hrs.,pennystocks,CLUBQ,20,20,0,20,2,4,4,1,OTC
4678,13-02-2021 02:00,24 hrs.,pennystocks,COCSF,6,0,6,-6,1,1,0,1,OTC
4678,13-02-2021 02:00,24 hrs.,pennystocks,CPHRF,6,6,0,6,1,1,0,1,OTC
4678,13-02-2021 02:00,24 hrs.,pennystocks,CRLBF,62,62,0,62,2,6,42,2,OTC
4678,13-02-2021 02:00,24 hrs.,pennystocks,CWGYF,6,6,0,6,1,1,0,1,OTC
4678,13-02-2021 02:00,24 hrs.,pennystocks,CWSFF,6,6,0,6,1,1,0,1,OTC
4678,13-02-2021 02:00,24 hrs.,pennystocks,DFODQ,21,0,21,-21,1,4,9,1,OTC
4678,13-02-2021 02:00,24 hrs.,pennystocks,DMGGF,37,0,37,-37,1,4,25,1,OTC
4678,13-02-2021 02:00,24 hrs.,pennystocks,EHVVF,15,15,0,15,1,0,11,1,OTC
4678,13-02-2021 02:00,24 hrs.,pennystocks,ELRRF,12,12,0,12,2,2,0,2,OTC
4678,13-02-2021 02:00,24 hrs.,pennystocks,EMHTF,6,6,0,6,1,1,0,1,OTC
4678,13-02-2021 02:00,24 hrs.,pennystocks,EPWCF,10,10,0,10,1,0,6,1,OTC
4678,13-02-2021 02:00,24 hrs.,pennystocks,EVKIF,35,35,0,35,1,11,9,1,OTC
4678,13-02-2021 02:00,24 hrs.,pennystocks,FIORF,8,0,8,-8,1,1,2,1,OTC
4678,13-02-2021 02:00,24 hrs.,pennystocks,FLWPF,20,20,0,20,1,3,10,1,OTC
4678,13-02-2021 02:00,24 hrs.,pennystocks,FUNFF,12,12,0,12,1,3,2,1,OTC
4678,13-02-2021 02:00,24 hrs.,pennystocks,GLDFF,6,6,0,6,1,1,0,1,OTC
4678,13-02-2021 02:00,24 hrs.,pennystocks,GUESF,7,0,7,-7,1,1,1,1,OTC
4678,13-02-2021 02:00,24 hrs.,pennystocks,HITIF,2137,1085,1052,33,12,761,567,11,OTC
4678,13-02-2021 02:00,24 hrs.,pennystocks,HRVSF,6,6,0,6,1,1,0,1,OTC
4678,13-02-2021 02:00,24 hrs.,pennystocks,IDXAF,6,0,6,-6,1,1,0,1,OTC
4678,13-02-2021 02:00,24 hrs.,pennystocks,INTEQ,6,6,0,6,1,1,0,1,OTC
4678,13-02-2021 02:00,24 hrs.,pennystocks,KCCFF,27,27,0,27,1,9,5,1,OTC
4678,13-02-2021 02:00,24 hrs.,pennystocks,LLKKF,30,24,6,18,5,5,0,2,OTC
4678,13-02-2021 02:00,24 hrs.,pennystocks,LXXGF,91,91,0,91,1,19,49,1,OTC
4678,13-02-2021 02:00,24 hrs.,pennystocks,MEDIF,6,0,6,-6,1,1,0,1,OTC
4678,13-02-2021 02:00,24 hrs.,pennystocks,MMEDF,17,17,0,17,1,6,1,1,OTC
4678,13-02-2021 02:00,24 hrs.,pennystocks,MNXXF,54,0,54,-54,3,10,22,2,OTC
4678,13-02-2021 02:00,24 hrs.,pennystocks,NMGRF,12,12,0,12,2,2,0,2,OTC
4678,13-02-2021 02:00,24 hrs.,pennystocks,NOSUF,43,43,0,43,2,10,15,2,OTC
4678,13-02-2021 02:00,24 hrs.,pennystocks,NRGOF,7,0,7,-7,1,1,1,1,OTC
4678,13-02-2021 02:00,24 hrs.,pennystocks,NTSFF,6,0,6,-6,1,1,0,1,OTC
4678,13-02-2021 02:00,24 hrs.,pennystocks,NXTTF,18,12,6,6,3,3,0,3,OTC
4678,13-02-2021 02:00,24 hrs.,pennystocks,OILFF,6,6,0,6,1,1,0,1,OTC
4678,13-02-2021 02:00,24 hrs.,pennystocks,PFWIQ,93,93,0,93,1,26,37,1,OTC
4678,13-02-2021 02:00,24 hrs.,pennystocks,PMNXF,6,6,0,6,1,1,0,1,OTC
4678,13-02-2021 02:00,24 hrs.,pennystocks,PYRNF,6,0,6,-6,1,1,0,1,OTC
4678,13-02-2021 02:00,24 hrs.,pennystocks,QYOUF,6,0,6,-6,1,1,0,1,OTC
4678,13-02-2021 02:00,24 hrs.,pennystocks,RAZFF,7,7,0,7,1,1,1,1,OTC
4678,13-02-2021 02:00,24 hrs.,pennystocks,RHDGF,9,9,0,9,1,1,3,1,OTC
4678,13-02-2021 02:00,24 hrs.,pennystocks,RLFTF,6,0,6,-6,1,1,0,1,OTC
4678,13-02-2021 02:00,24 hrs.,pennystocks,RLLCF,66,60,6,54,8,11,12,7,OTC
4678,13-02-2021 02:00,24 hrs.,pennystocks,RVVTF,7,7,0,7,1,1,1,1,OTC
4678,13-02-2021 02:00,24 hrs.,pennystocks,SNNAF,14,0,14,-14,1,4,2,1,OTC
4678,13-02-2021 02:00,24 hrs.,pennystocks,SPFYF,9,0,9,-9,1,1,3,1,OTC
4678,13-02-2021 02:00,24 hrs.,pennystocks,CBDL,263,257,6,251,4,79,89,4,OTC
4678,13-02-2021 02:00,24 hrs.,pennystocks,CCTL,16,16,0,16,1,5,2,1,OTC
4678,13-02-2021 02:00,24 hrs.,pennystocks,CELZ,7,7,0,7,1,1,1,1,OTC
4678,13-02-2021 02:00,24 hrs.,pennystocks,CHNC,25,25,0,25,1,7,7,1,OTC
4678,13-02-2021 02:00,24 hrs.,pennystocks,CLWD,6,6,0,6,1,1,0,1,OTC
4678,13-02-2021 02:00,24 hrs.,pennystocks,CNNA,68,39,29,10,3,9,38,3,OTC
4678,13-02-2021 02:00,24 hrs.,pennystocks,TSKFF,46,0,46,-46,1,16,10,1,OTC
4678,13-02-2021 02:00,24 hrs.,pennystocks,VRNDF,20,20,0,20,1,6,4,1,OTC
4678,13-02-2021 02:00,24 hrs.,pennystocks,XELAW,199,0,199,-199,1,89,17,1,OTC
4678,13-02-2021 02:00,24 hrs.,pennystocks,ZBISF,54,54,0,54,1,20,10,1,OTC
4678,13-02-2021 02:00,24 hrs.,pennystocks,AIM,8,0,8,-8,1,1,2,1,AMEX
4678,13-02-2021 02:00,24 hrs.,pennystocks,CTO,22,0,22,-22,1,1,16,1,AMEX
4678,13-02-2021 02:00,24 hrs.,pennystocks,DNN,150,43,107,-64,9,28,58,8,AMEX
4678,13-02-2021 02:00,24 hrs.,pennystocks,DPW,6,6,0,6,1,1,0,1,AMEX
4678,13-02-2021 02:00,24 hrs.,pennystocks,DSS,30,30,0,30,1,9,8,1,AMEX
4678,13-02-2021 02:00,24 hrs.,pennystocks,GPL,35,0,35,-35,1,13,5,1,AMEX
4678,13-02-2021 02:00,24 hrs.,pennystocks,GTE,19,12,7,5,3,3,1,3,AMEX
4678,13-02-2021 02:00,24 hrs.,pennystocks,ITP,33,0,33,-33,2,4,17,2,AMEX
4678,13-02-2021 02:00,24 hrs.,pennystocks,MCF,6,6,0,6,1,1,0,1,AMEX
4678,13-02-2021 02:00,24 hrs.,pennystocks,MXC,7,0,7,-7,1,1,1,1,AMEX
4678,13-02-2021 02:00,24 hrs.,pennystocks,NAK,39,33,6,27,2,8,15,2,AMEX
4678,13-02-2021 02:00,24 hrs.,pennystocks,NBY,49,49,0,49,1,16,13,1,AMEX
4678,13-02-2021 02:00,24 hrs.,pennystocks,PTN,24,0,24,-24,1,7,6,1,AMEX
4678,13-02-2021 02:00,24 hrs.,pennystocks,TGB,30,30,0,30,1,10,6,1,AMEX
4678,13-02-2021 02:00,24 hrs.,pennystocks,TRX,15,0,15,-15,2,2,3,2,AMEX
4678,13-02-2021 02:00,24 hrs.,pennystocks,ZOM,183,46,137,-91,4,60,47,4,AMEX
4678,13-02-2021 02:00,24 hrs.,StockMarket,BMWLF,20,20,0,20,1,7,2,1,OTC
4678,13-02-2021 02:00,24 hrs.,StockMarket,CRLBF,20,20,0,20,1,7,2,1,OTC
4678,13-02-2021 02:00,24 hrs.,StockMarket,CURLF,20,20,0,20,1,7,2,1,OTC
4678,13-02-2021 02:00,24 hrs.,StockMarket,DIGAF,6,6,0,6,1,1,0,1,OTC
4678,13-02-2021 02:00,24 hrs.,StockMarket,GTBIF,20,20,0,20,1,7,2,1,OTC
4678,13-02-2021 02:00,24 hrs.,StockMarket,HTZGQ,6,6,0,6,1,1,0,1,OTC
4678,13-02-2021 02:00,24 hrs.,StockMarket,LHSIF,20,20,0,20,1,7,2,1,OTC
4678,13-02-2021 02:00,24 hrs.,StockMarket,NMGRF,6,6,0,6,1,1,0,1,OTC
4678,13-02-2021 02:00,24 hrs.,StockMarket,NXGWF,17,0,17,-17,1,6,1,1,OTC
4678,13-02-2021 02:00,24 hrs.,StockMarket,RAZFF,6,6,0,6,1,1,0,1,OTC
4678,13-02-2021 02:00,24 hrs.,StockMarket,RHDGF,18,18,0,18,2,3,4,1,OTC
4678,13-02-2021 02:00,24 hrs.,StockMarket,RWBYF,20,20,0,20,1,7,2,1,OTC
4678,13-02-2021 02:00,24 hrs.,StockMarket,RYCEY,12,12,0,12,2,2,0,2,OTC
4678,13-02-2021 02:00,24 hrs.,StockMarket,TCNNF,20,20,0,20,1,7,2,1,OTC
4678,13-02-2021 02:00,24 hrs.,StockMarket,TFECY,18,18,0,18,3,3,0,1,OTC
4678,13-02-2021 02:00,24 hrs.,StockMarket,ZBISF,29,29,0,29,1,9,7,1,OTC
4678,13-02-2021 02:00,24 hrs.,StockMarket,DNN,39,14,25,-11,3,8,11,3,AMEX
4678,13-02-2021 02:00,24 hrs.,StockMarket,DSS,6,6,0,6,1,1,0,1,AMEX
4678,13-02-2021 02:00,24 hrs.,StockMarket,TRX,6,6,0,6,1,1,0,1,AMEX
4678,13-02-2021 02:00,24 hrs.,StockMarket,URG,25,0,25,-25,1,6,9,1,AMEX
4678,13-02-2021 02:00,24 hrs.,StockMarket,GSAT,88,88,0,88,5,20,28,2,AMEX
4678,13-02-2021 02:00,24 hrs.,StockMarket,LODE,6,6,0,6,1,1,0,1,AMEX
4678,13-02-2021 02:00,24 hrs.,StockMarket,NSPR,6,6,0,6,1,1,0,1,AMEX
4678,13-02-2021 02:00,24 hrs.,StockMarket,RLGT,6,0,6,-6,1,1,0,1,AMEX
4678,13-02-2021 02:00,24 hrs.,StockMarket,UAVS,9,9,0,9,1,1,3,1,AMEX
4678,13-02-2021 02:00,24 hrs.,StockMarket,UUUU,25,0,25,-25,1,6,9,1,AMEX
4678,13-02-2021 02:00,24 hrs.,StockMarket,ACB,16,16,0,16,1,6,0,1,NYSE
4678,13-02-2021 02:00,24 hrs.,StockMarket,AFC,6,6,0,6,1,1,0,1,NYSE
4678,13-02-2021 02:00,24 hrs.,StockMarket,AGX,6,6,0,6,1,1,0,1,NYSE
4678,13-02-2021 02:00,24 hrs.,StockMarket,ALV,20,0,20,-20,1,3,10,1,NYSE
4678,13-02-2021 02:00,24 hrs.,StockMarket,AMC,566,35,531,-496,4,236,78,4,NYSE
4678,13-02-2021 02:00,24 hrs.,StockMarket,BHC,13,0,13,-13,1,3,3,1,NYSE
4678,13-02-2021 02:00,24 hrs.,StockMarket,DIS,29,16,13,3,2,9,3,2,NYSE
4678,13-02-2021 02:00,24 hrs.,StockMarket,FSR,13,0,13,-13,1,3,3,1,NYSE
4678,13-02-2021 02:00,24 hrs.,StockMarket,GME,600,43,557,-514,8,241,86,8,NYSE
4678,13-02-2021 02:00,24 hrs.,StockMarket,IBM,16,16,0,16,1,6,0,1,NYSE
4678,13-02-2021 02:00,24 hrs.,StockMarket,JNJ,6,6,0,6,1,1,0,1,NYSE
4678,13-02-2021 02:00,24 hrs.,StockMarket,LAC,4,0,4,-4,1,0,0,1,NYSE
4678,13-02-2021 02:00,24 hrs.,pennystocks,IQST,51,51,0,51,4,3,29,3,OTC
4678,13-02-2021 02:00,24 hrs.,pennystocks,WTII,37,0,37,-37,1,11,11,1,OTC
4678,13-02-2021 02:00,24 hrs.,pennystocks,XMET,14,6,8,-2,2,1,4,2,OTC
4678,13-02-2021 02:00,24 hrs.,pennystocks,XTRM,6,0,6,-6,1,1,0,1,OTC
4678,13-02-2021 02:00,24 hrs.,pennystocks,ZHUD,8,8,0,8,1,1,2,1,OTC
4678,13-02-2021 02:00,24 hrs.,pennystocks,ZPAS,6,0,6,-6,1,1,0,1,OTC
4678,13-02-2021 02:00,24 hrs.,StockMarket,PDT,10,0,10,-10,1,2,2,1,NYSE
4678,13-02-2021 02:00,24 hrs.,StockMarket,PHI,8,8,0,8,1,2,0,1,NYSE
4678,13-02-2021 02:00,24 hrs.,StockMarket,PSA,6,6,0,6,1,1,0,1,NYSE
4678,13-02-2021 02:00,24 hrs.,StockMarket,RSI,6,0,6,-6,1,1,0,1,NYSE
4678,13-02-2021 02:00,24 hrs.,StockMarket,SBE,6,6,0,6,1,1,0,1,NYSE
4678,13-02-2021 02:00,24 hrs.,StockMarket,SMG,20,20,0,20,1,7,2,1,NYSE
4678,13-02-2021 02:00,24 hrs.,StockMarket,SOS,31,6,25,-19,4,6,3,4,NYSE
4678,13-02-2021 02:00,24 hrs.,StockMarket,TDA,12,12,0,12,1,1,6,1,NYSE
4678,13-02-2021 02:00,24 hrs.,StockMarket,TSE,31,0,31,-31,1,9,9,1,NYSE
4678,13-02-2021 02:00,24 hrs.,StockMarket,TTM,19,0,19,-19,1,3,9,1,NYSE
4678,13-02-2021 02:00,24 hrs.,StockMarket,XPO,16,16,0,16,1,6,0,1,NYSE
4678,13-02-2021 02:00,24 hrs.,StockMarket,CCIV,31,31,0,31,2,9,5,1,NYSE
4678,13-02-2021 02:00,24 hrs.,StockMarket,CHWY,6,6,0,6,1,1,0,1,NYSE
4678,13-02-2021 02:00,24 hrs.,StockMarket,COTY,12,12,0,12,2,2,0,1,NYSE
4678,13-02-2021 02:00,24 hrs.,StockMarket,DSSI,6,6,0,6,1,1,0,1,NYSE
4678,13-02-2021 02:00,24 hrs.,StockMarket,FUSE,12,6,6,0,2,2,0,2,NYSE
4678,13-02-2021 02:00,24 hrs.,StockMarket,GDDY,16,16,0,16,1,6,0,1,NYSE
4678,13-02-2021 02:00,24 hrs.,StockMarket,GNRC,16,16,0,16,1,6,0,1,NYSE
4678,13-02-2021 02:00,24 hrs.,StockMarket,HEXO,9,9,0,9,1,2,1,1,NYSE
4678,13-02-2021 02:00,24 hrs.,StockMarket,HYLN,13,0,13,-13,1,3,3,1,NYSE
4678,13-02-2021 02:00,24 hrs.,StockMarket,LAIX,13,13,0,13,1,0,9,1,NYSE
4678,13-02-2021 02:00,24 hrs.,StockMarket,PINS,17,17,0,17,1,3,7,1,NYSE
4678,13-02-2021 02:00,24 hrs.,StockMarket,PLTR,16,16,0,16,1,6,0,1,NYSE
4678,13-02-2021 02:00,24 hrs.,StockMarket,UBER,16,16,0,16,1,6,0,1,NYSE
4678,13-02-2021 02:00,24 hrs.,StockMarket,VGAC,8,8,0,8,1,0,4,1,NYSE
4678,13-02-2021 02:00,24 hrs.,StockMarket,YETI,4,0,4,-4,1,0,0,1,NYSE
4678,13-02-2021 02:00,24 hrs.,StockMarket,AMD,18,6,12,-6,2,1,8,2,NASDAQ
4678,13-02-2021 02:00,24 hrs.,StockMarket,AZN,13,0,13,-13,1,3,3,1,NASDAQ
4678,13-02-2021 02:00,24 hrs.,StockMarket,CDC,13,0,13,-13,1,3,3,1,NASDAQ
4678,13-02-2021 02:00,24 hrs.,StockMarket,HAS,6,0,6,-6,1,1,0,1,NASDAQ
4678,13-02-2021 02:00,24 hrs.,StockMarket,INO,13,0,13,-13,1,3,3,1,NASDAQ
4678,13-02-2021 02:00,24 hrs.,StockMarket,JFU,64,64,0,64,1,17,26,1,NASDAQ
4678,13-02-2021 02:00,24 hrs.,StockMarket,MGI,5,0,5,-5,1,0,1,1,NASDAQ
4678,13-02-2021 02:00,24 hrs.,StockMarket,NWL,13,0,13,-13,1,3,3,1,NASDAQ
4678,13-02-2021 02:00,24 hrs.,StockMarket,OGI,43,10,33,-23,3,12,7,3,NASDAQ
4678,13-02-2021 02:00,24 hrs.,StockMarket,OPK,6,6,0,6,1,1,0,1,NASDAQ
4678,13-02-2021 02:00,24 hrs.,StockMarket,QQQ,33,33,0,33,2,9,7,2,NASDAQ
4678,13-02-2021 02:00,24 hrs.,StockMarket,RCM,6,0,6,-6,1,1,0,1,NASDAQ
4678,13-02-2021 02:00,24 hrs.,StockMarket,SFT,6,6,0,6,1,1,0,1,NASDAQ
4678,13-02-2021 02:00,24 hrs.,StockMarket,VFF,20,20,0,20,1,7,2,1,NASDAQ
4678,13-02-2021 02:00,24 hrs.,StockMarket,AAPL,17,17,0,17,1,3,7,1,NASDAQ
4678,13-02-2021 02:00,24 hrs.,StockMarket,AEZS,6,0,6,-6,1,1,0,1,NASDAQ
4678,13-02-2021 02:00,24 hrs.,StockMarket,AMAT,16,16,0,16,1,6,0,1,NASDAQ
4678,13-02-2021 02:00,24 hrs.,StockMarket,AMZN,16,16,0,16,1,6,0,1,NASDAQ
4678,13-02-2021 02:00,24 hrs.,StockMarket,APHA,6,6,0,6,1,1,0,1,NASDAQ
4678,13-02-2021 02:00,24 hrs.,SPACs,APEX,31,31,0,31,1,4,19,1,OTC
4678,13-02-2021 02:00,24 hrs.,SPACs,BRRN,11,11,0,11,1,2,3,1,OTC
4678,13-02-2021 02:00,24 hrs.,SPACs,CAGR,114,0,114,-114,1,22,66,1,OTC
4678,13-02-2021 02:00,24 hrs.,SPACs,CIK,56,56,0,56,1,16,20,1,AMEX
4678,13-02-2021 02:00,24 hrs.,SPACs,NBA,312,0,312,-312,1,89,130,1,AMEX
4678,13-02-2021 02:00,24 hrs.,SPACs,PTK,312,0,312,-312,1,89,130,1,AMEX
4678,13-02-2021 02:00,24 hrs.,SPACs,CHAQ,312,0,312,-312,1,89,130,1,AMEX
4678,13-02-2021 02:00,24 hrs.,SPACs,AIR,132,132,0,132,1,49,30,1,NYSE
4678,13-02-2021 02:00,24 hrs.,SPACs,BFT,2666,7,2659,-2652,2,62,2534,2,NYSE
4678,13-02-2021 02:00,24 hrs.,SPACs,BSN,312,0,312,-312,1,89,130,1,NYSE
4678,13-02-2021 02:00,24 hrs.,SPACs,CCX,312,0,312,-312,1,89,130,1,NYSE
4678,13-02-2021 02:00,24 hrs.,SPACs,COO,44,44,0,44,1,7,26,1,NYSE
4678,13-02-2021 02:00,24 hrs.,SPACs,DEH,312,0,312,-312,1,89,130,1,NYSE
4678,13-02-2021 02:00,24 hrs.,pennystocks,SPMTF,18,18,0,18,1,2,10,1,OTC
4678,13-02-2021 02:00,24 hrs.,pennystocks,SPRWF,356,58,298,-240,9,136,48,8,OTC
4678,13-02-2021 02:00,24 hrs.,pennystocks,TAKOF,33,33,0,33,1,11,7,1,OTC
4678,13-02-2021 02:00,24 hrs.,pennystocks,TLOFF,12,0,12,-12,2,2,0,1,OTC
4678,13-02-2021 02:00,24 hrs.,pennystocks,TOBAF,19,19,0,19,1,2,11,1,OTC
4678,13-02-2021 02:00,24 hrs.,pennystocks,TSCRF,109,78,31,47,4,31,31,4,OTC
4678,13-02-2021 02:00,24 hrs.,SPACs,ICE,35,0,35,-35,1,11,9,1,NYSE
4678,13-02-2021 02:00,24 hrs.,SPACs,IRR,76,76,0,76,1,23,26,1,NYSE
4678,13-02-2021 02:00,24 hrs.,SPACs,JWS,2695,36,2659,-2623,6,66,2539,2,NYSE
4678,13-02-2021 02:00,24 hrs.,SPACs,NAV,262,90,172,-82,7,61,112,5,NYSE
4678,13-02-2021 02:00,24 hrs.,SPACs,NGA,80,56,24,32,4,17,30,3,NYSE
4678,13-02-2021 02:00,24 hrs.,SPACs,NSH,312,0,312,-312,1,89,130,1,NYSE
4678,13-02-2021 02:00,24 hrs.,SPACs,RMO,6,6,0,6,1,1,0,1,NYSE
4678,13-02-2021 02:00,24 hrs.,SPACs,RSI,141,8,133,-125,2,39,55,2,NYSE
4678,13-02-2021 02:00,24 hrs.,SPACs,RTP,3050,21,3029,-3008,4,223,2588,3,NYSE
4678,13-02-2021 02:00,24 hrs.,SPACs,SBE,160,154,6,148,3,55,38,2,NYSE
4678,13-02-2021 02:00,24 hrs.,SPACs,SBG,312,0,312,-312,1,89,130,1,NYSE
4678,13-02-2021 02:00,24 hrs.,SPACs,TDA,7,7,0,7,1,1,1,1,NYSE
4678,13-02-2021 02:00,24 hrs.,SPACs,WPF,312,0,312,-312,1,89,130,1,NYSE
4678,13-02-2021 02:00,24 hrs.,SPACs,YAC,312,0,312,-312,1,89,130,1,NYSE
4678,13-02-2021 02:00,24 hrs.,SPACs,YUM,34,34,0,34,1,9,12,1,NYSE
4678,13-02-2021 02:00,24 hrs.,SPACs,ACIC,2659,0,2659,-2659,1,61,2533,1,NYSE
4678,13-02-2021 02:00,24 hrs.,SPACs,ACND,312,0,312,-312,1,89,130,1,NYSE
4678,13-02-2021 02:00,24 hrs.,SPACs,ALUS,47,0,47,-47,1,9,25,1,NYSE
4678,13-02-2021 02:00,24 hrs.,SPACs,AONE,312,0,312,-312,1,89,130,1,NYSE
4678,13-02-2021 02:00,24 hrs.,SPACs,APSG,312,0,312,-312,1,89,130,1,NYSE
4678,13-02-2021 02:00,24 hrs.,SPACs,ASAQ,312,0,312,-312,1,89,130,1,NYSE
4678,13-02-2021 02:00,24 hrs.,SPACs,ASPL,318,0,318,-318,2,90,130,2,NYSE
4678,13-02-2021 02:00,24 hrs.,SPACs,ATAC,312,0,312,-312,1,89,130,1,NYSE
4678,13-02-2021 02:00,24 hrs.,SPACs,AVAN,312,0,312,-312,1,89,130,1,NYSE
4678,13-02-2021 02:00,24 hrs.,SPACs,BOAC,395,83,312,-229,2,115,157,2,NYSE
4678,13-02-2021 02:00,24 hrs.,SPACs,CCIV,3813,396,3417,-3021,10,438,2897,9,NYSE
4678,13-02-2021 02:00,24 hrs.,SPACs,CLII,8,0,8,-8,1,1,2,1,NYSE
4678,13-02-2021 02:00,24 hrs.,SPACs,CPSR,312,0,312,-312,1,89,130,1,NYSE
4678,13-02-2021 02:00,24 hrs.,SPACs,CTAC,312,0,312,-312,1,89,130,1,NYSE
4678,13-02-2021 02:00,24 hrs.,SPACs,DFNS,356,0,356,-356,2,106,136,2,NYSE
4678,13-02-2021 02:00,24 hrs.,SPACs,DGNR,370,0,370,-370,1,161,44,1,NYSE
4678,13-02-2021 02:00,24 hrs.,SPACs,DMYD,484,0,484,-484,2,178,120,2,NYSE
4678,13-02-2021 02:00,24 hrs.,SPACs,DNMR,7,7,0,7,1,1,1,1,NYSE
4678,13-02-2021 02:00,24 hrs.,SPACs,EMPW,2971,0,2971,-2971,2,150,2663,1,NYSE
4678,13-02-2021 02:00,24 hrs.,SPACs,ENPC,2659,0,2659,-2659,1,61,2533,1,NYSE
4678,13-02-2021 02:00,24 hrs.,SPACs,FGNA,260,260,0,260,2,90,72,1,NYSE
4678,13-02-2021 02:00,24 hrs.,SPACs,FUSE,4720,304,4416,-4112,17,778,3096,15,NYSE
4678,13-02-2021 02:00,24 hrs.,SPACs,GLEO,312,0,312,-312,1,89,130,1,NYSE
4678,13-02-2021 02:00,24 hrs.,SPACs,GOAC,312,0,312,-312,1,89,130,1,NYSE
4678,13-02-2021 02:00,24 hrs.,SPACs,GSAH,656,172,484,-312,3,237,170,3,NYSE
4678,13-02-2021 02:00,24 hrs.,SPACs,HIGA,312,0,312,-312,1,89,130,1,NYSE
4678,13-02-2021 02:00,24 hrs.,SPACs,HZAC,312,0,312,-312,1,89,130,1,NYSE
4678,13-02-2021 02:00,24 hrs.,SPACs,HZON,312,0,312,-312,1,89,130,1,NYSE
4678,13-02-2021 02:00,24 hrs.,SPACs,IMPX,312,0,312,-312,1,89,130,1,NYSE
4678,13-02-2021 02:00,24 hrs.,SPACs,IPOE,178,172,6,166,2,60,50,2,NYSE
4678,13-02-2021 02:00,24 hrs.,SPACs,LGVW,457,0,457,-457,4,183,75,3,NYSE
4678,13-02-2021 02:00,24 hrs.,SPACs,OACB,312,0,312,-312,1,89,130,1,NYSE
4678,13-02-2021 02:00,24 hrs.,SPACs,PANA,312,0,312,-312,1,89,130,1,NYSE
4678,13-02-2021 02:00,24 hrs.,SPACs,PCPL,312,0,312,-312,1,89,130,1,NYSE
4678,13-02-2021 02:00,24 hrs.,SPACs,PDAC,7,7,0,7,1,1,1,1,NYSE
4678,13-02-2021 02:00,24 hrs.,SPACs,PIAI,312,0,312,-312,1,89,130,1,NYSE
4678,13-02-2021 02:00,24 hrs.,SPACs,PRPB,312,0,312,-312,1,89,130,1,NYSE
4678,13-02-2021 02:00,24 hrs.,SPACs,PSTH,323,323,0,323,2,98,119,2,NYSE
4678,13-02-2021 02:00,24 hrs.,SPACs,RBAC,312,0,312,-312,1,89,130,1,NYSE
4678,13-02-2021 02:00,24 hrs.,SPACs,RPLA,312,0,312,-312,1,89,130,1,NYSE
4678,13-02-2021 02:00,24 hrs.,SPACs,SCPE,312,0,312,-312,1,89,130,1,NYSE
4678,13-02-2021 02:00,24 hrs.,SPACs,SCVX,312,0,312,-312,1,89,130,1,NYSE
4678,13-02-2021 02:00,24 hrs.,SPACs,SEAH,312,0,312,-312,1,89,130,1,NYSE
4678,13-02-2021 02:00,24 hrs.,StockMarket,LLY,16,16,0,16,1,6,0,1,NYSE
4678,13-02-2021 02:00,24 hrs.,StockMarket,LMT,22,0,22,-22,1,3,12,1,NYSE
4678,13-02-2021 02:00,24 hrs.,StockMarket,MAX,11,11,0,11,1,3,1,1,NYSE
4678,13-02-2021 02:00,24 hrs.,StockMarket,MCO,13,0,13,-13,1,3,3,1,NYSE
4678,13-02-2021 02:00,24 hrs.,StockMarket,MRO,13,0,13,-13,1,3,3,1,NYSE
4678,13-02-2021 02:00,24 hrs.,StockMarket,NIO,59,59,0,59,3,14,19,3,NYSE
4678,13-02-2021 02:00,24 hrs.,SPACs,VTOL,132,132,0,132,1,49,30,1,NYSE
4678,13-02-2021 02:00,24 hrs.,SPACs,VYGG,34,34,0,34,2,5,16,2,NYSE
4678,13-02-2021 02:00,24 hrs.,SPACs,ADV,2971,0,2971,-2971,2,150,2663,1,NASDAQ
4678,13-02-2021 02:00,24 hrs.,SPACs,CFO,166,166,0,166,2,58,42,2,NASDAQ
4678,13-02-2021 02:00,24 hrs.,SPACs,ESG,123,0,123,-123,1,37,45,1,NASDAQ
4678,13-02-2021 02:00,24 hrs.,SPACs,HOL,2666,0,2666,-2666,2,62,2534,2,NASDAQ
4678,13-02-2021 02:00,24 hrs.,SPACs,III,88,88,0,88,1,31,22,1,NASDAQ
4678,13-02-2021 02:00,24 hrs.,SPACs,LCY,312,0,312,-312,1,89,130,1,NASDAQ
4678,13-02-2021 02:00,24 hrs.,SPACs,NPA,106,106,0,106,1,36,30,1,NASDAQ
4678,13-02-2021 02:00,24 hrs.,SPACs,VIH,35,0,35,-35,1,11,9,1,NASDAQ
4678,13-02-2021 02:00,24 hrs.,SPACs,AACQ,1033,1033,0,1033,7,339,327,6,NASDAQ
4678,13-02-2021 02:00,24 hrs.,SPACs,ACAC,133,0,133,-133,1,39,51,1,NASDAQ
4678,13-02-2021 02:00,24 hrs.,SPACs,ACEV,41,0,41,-41,1,2,33,1,NASDAQ
4678,13-02-2021 02:00,24 hrs.,SPACs,ADOC,312,0,312,-312,1,89,130,1,NASDAQ
4678,13-02-2021 02:00,24 hrs.,SPACs,AGBA,312,0,312,-312,1,89,130,1,NASDAQ
4678,13-02-2021 02:00,24 hrs.,SPACs,AHAC,312,0,312,-312,1,89,130,1,NASDAQ
4678,13-02-2021 02:00,24 hrs.,SPACs,AMHC,312,0,312,-312,1,89,130,1,NASDAQ
4678,13-02-2021 02:00,24 hrs.,SPACs,ANDA,114,0,114,-114,1,22,66,1,NASDAQ
4678,13-02-2021 02:00,24 hrs.,SPACs,BHSE,312,0,312,-312,1,89,130,1,NASDAQ
4678,13-02-2021 02:00,24 hrs.,SPACs,BLNK,44,44,0,44,1,7,26,1,NASDAQ
4678,13-02-2021 02:00,24 hrs.,SPACs,BOWX,312,0,312,-312,1,89,130,1,NASDAQ
4678,13-02-2021 02:00,24 hrs.,SPACs,BREZ,312,0,312,-312,1,89,130,1,NASDAQ
4678,13-02-2021 02:00,24 hrs.,SPACs,BRLI,312,0,312,-312,1,89,130,1,NASDAQ
4678,13-02-2021 02:00,24 hrs.,SPACs,BRPA,2659,0,2659,-2659,1,61,2533,1,NASDAQ
4678,13-02-2021 02:00,24 hrs.,SPACs,BTAQ,747,429,318,111,3,270,195,3,NASDAQ
4678,13-02-2021 02:00,24 hrs.,SPACs,BTWN,78,9,69,-60,3,14,38,3,NASDAQ
4678,13-02-2021 02:00,24 hrs.,SPACs,BWAC,312,0,312,-312,1,89,130,1,NASDAQ
4678,13-02-2021 02:00,24 hrs.,SPACs,CAPA,312,0,312,-312,1,89,130,1,NASDAQ
4678,13-02-2021 02:00,24 hrs.,SPACs,CELH,114,0,114,-114,1,22,66,1,NASDAQ
4678,13-02-2021 02:00,24 hrs.,SPACs,CFII,312,0,312,-312,1,89,130,1,NASDAQ
4678,13-02-2021 02:00,24 hrs.,SPACs,CHPM,312,0,312,-312,1,89,130,1,NASDAQ
4678,13-02-2021 02:00,24 hrs.,SPACs,CIIC,18,0,18,-18,1,5,4,1,NASDAQ
4678,13-02-2021 02:00,24 hrs.,SPACs,CMLF,2659,0,2659,-2659,1,61,2533,1,NASDAQ
4678,13-02-2021 02:00,24 hrs.,SPACs,CONX,312,0,312,-312,1,89,130,1,NASDAQ
4678,13-02-2021 02:00,24 hrs.,SPACs,CRSA,312,0,312,-312,1,89,130,1,NASDAQ
4678,13-02-2021 02:00,24 hrs.,SPACs,DBDR,312,0,312,-312,1,89,130,1,NASDAQ
4678,13-02-2021 02:00,24 hrs.,SPACs,DCRB,18,0,18,-18,1,5,4,1,NASDAQ
4678,13-02-2021 02:00,24 hrs.,SPACs,DFHT,2659,0,2659,-2659,1,61,2533,1,NASDAQ
4678,13-02-2021 02:00,24 hrs.,SPACs,DFPH,312,0,312,-312,1,89,130,1,NASDAQ
4678,13-02-2021 02:00,24 hrs.,SPACs,DGNS,484,0,484,-484,2,178,120,2,NASDAQ
4678,13-02-2021 02:00,24 hrs.,SPACs,DSAC,312,0,312,-312,1,89,130,1,NASDAQ
4678,13-02-2021 02:00,24 hrs.,SPACs,ERES,312,0,312,-312,1,89,130,1,NASDAQ
4678,13-02-2021 02:00,24 hrs.,SPACs,ESSC,312,0,312,-312,1,89,130,1,NASDAQ
4678,13-02-2021 02:00,24 hrs.,SPACs,ETAC,312,0,312,-312,1,89,130,1,NASDAQ
4678,13-02-2021 02:00,24 hrs.,SPACs,EUCR,312,0,312,-312,1,89,130,1,NASDAQ
4678,13-02-2021 02:00,24 hrs.,SPACs,FCAC,3105,12,3093,-3081,5,247,2591,4,NASDAQ
4678,13-02-2021 02:00,24 hrs.,SPACs,FTOC,113,113,0,113,4,30,37,3,NASDAQ
4678,13-02-2021 02:00,24 hrs.,SPACs,FVAM,312,0,312,-312,1,89,130,1,NASDAQ
4678,13-02-2021 02:00,24 hrs.,SPACs,GNRS,312,0,312,-312,1,89,130,1,NASDAQ
4678,13-02-2021 02:00,24 hrs.,SPACs,GRCY,312,0,312,-312,1,89,130,1,NASDAQ
4678,13-02-2021 02:00,24 hrs.,SPACs,GRNV,312,0,312,-312,1,89,130,1,NASDAQ
4678,13-02-2021 02:00,24 hrs.,SPACs,GRSV,393,81,312,-231,4,109,159,4,NASDAQ
4678,13-02-2021 02:00,24 hrs.,SPACs,GWAC,312,0,312,-312,1,89,130,1,NASDAQ
4678,13-02-2021 02:00,24 hrs.,SPACs,GXGX,312,0,312,-312,1,89,130,1,NASDAQ
4678,13-02-2021 02:00,24 hrs.,SPACs,IGAC,312,0,312,-312,1,89,130,1,NASDAQ
4678,13-02-2021 02:00,24 hrs.,SPACs,ITAC,312,0,312,-312,1,89,130,1,NASDAQ
4678,13-02-2021 02:00,24 hrs.,SPACs,JYAC,312,0,312,-312,1,89,130,1,NASDAQ
4678,13-02-2021 02:00,24 hrs.,SPACs,KERN,44,44,0,44,1,7,26,1,NASDAQ
4678,13-02-2021 02:00,24 hrs.,SPACs,DFS,132,132,0,132,1,49,30,1,NYSE
4678,13-02-2021 02:00,24 hrs.,SPACs,EQD,2971,0,2971,-2971,2,150,2663,1,NYSE
4678,13-02-2021 02:00,24 hrs.,SPACs,FSR,6,6,0,6,1,1,0,1,NYSE
4678,13-02-2021 02:00,24 hrs.,SPACs,GIK,30,0,30,-30,4,2,10,2,NYSE
4678,13-02-2021 02:00,24 hrs.,SPACs,GIX,312,0,312,-312,1,89,130,1,NYSE
4678,13-02-2021 02:00,24 hrs.,SPACs,HPX,312,0,312,-312,1,89,130,1,NYSE
4678,13-02-2021 02:00,24 hrs.,wallstreetbets,IIN,6,6,0,6,1,1,0,1,NASDAQ
4678,13-02-2021 02:00,24 hrs.,wallstreetbets,INO,744,55,689,-634,14,262,164,14,NASDAQ
4678,13-02-2021 02:00,24 hrs.,wallstreetbets,KHC,14,14,0,14,2,2,2,2,NASDAQ
4678,13-02-2021 02:00,24 hrs.,SPACs,KSMT,312,0,312,-312,1,89,130,1,NASDAQ
4678,13-02-2021 02:00,24 hrs.,SPACs,LATN,312,0,312,-312,1,89,130,1,NASDAQ
4678,13-02-2021 02:00,24 hrs.,SPACs,LCAP,312,0,312,-312,1,89,130,1,NASDAQ
4678,13-02-2021 02:00,24 hrs.,SPACs,LFTR,312,0,312,-312,1,89,130,1,NASDAQ
4678,13-02-2021 02:00,24 hrs.,SPACs,LIVK,312,0,312,-312,1,89,130,1,NASDAQ
4678,13-02-2021 02:00,24 hrs.,SPACs,MAAC,312,0,312,-312,1,89,130,1,NASDAQ
4678,13-02-2021 02:00,24 hrs.,SPACs,MACU,312,0,312,-312,1,89,130,1,NASDAQ
4678,13-02-2021 02:00,24 hrs.,SPACs,MCMJ,312,0,312,-312,1,89,130,1,NASDAQ
4678,13-02-2021 02:00,24 hrs.,SPACs,MLAC,312,0,312,-312,1,89,130,1,NASDAQ
4678,13-02-2021 02:00,24 hrs.,SPACs,MOTN,312,0,312,-312,1,89,130,1,NASDAQ
4678,13-02-2021 02:00,24 hrs.,SPACs,NBAC,28,28,0,28,2,7,6,2,NASDAQ
4678,13-02-2021 02:00,24 hrs.,SPACs,OKTA,27,27,0,27,1,7,9,1,NASDAQ
4678,13-02-2021 02:00,24 hrs.,SPACs,OTRA,312,0,312,-312,1,89,130,1,NASDAQ
4678,13-02-2021 02:00,24 hrs.,SPACs,PAIC,312,0,312,-312,1,89,130,1,NASDAQ
4678,13-02-2021 02:00,24 hrs.,SPACs,PLUG,6,0,6,-6,1,1,0,1,NASDAQ
4678,13-02-2021 02:00,24 hrs.,SPACs,PRCH,32,32,0,32,1,11,6,1,NASDAQ
4678,13-02-2021 02:00,24 hrs.,SPACs,PYPL,72,72,0,72,1,27,14,1,NASDAQ
4678,13-02-2021 02:00,24 hrs.,SPACs,QELL,657,132,525,-393,4,229,183,4,NASDAQ
4678,13-02-2021 02:00,24 hrs.,SPACs,RCHG,312,0,312,-312,1,89,130,1,NASDAQ
4678,13-02-2021 02:00,24 hrs.,SPACs,RIDE,6,0,6,-6,1,1,0,1,NASDAQ
4678,13-02-2021 02:00,24 hrs.,SPACs,SGAM,312,0,312,-312,1,89,130,1,NASDAQ
4678,13-02-2021 02:00,24 hrs.,SPACs,SRAC,114,114,0,114,2,37,32,2,NASDAQ
4678,13-02-2021 02:00,24 hrs.,SPACs,STWO,312,0,312,-312,1,89,130,1,NASDAQ
4678,13-02-2021 02:00,24 hrs.,SPACs,SVAC,312,0,312,-312,1,89,130,1,NASDAQ
4678,13-02-2021 02:00,24 hrs.,SPACs,TEKK,312,0,312,-312,1,89,130,1,NASDAQ
4678,13-02-2021 02:00,24 hrs.,SPACs,THBR,2690,0,2690,-2690,2,65,2552,2,NASDAQ
4678,13-02-2021 02:00,24 hrs.,SPACs,THCA,312,0,312,-312,1,89,130,1,NASDAQ
4678,13-02-2021 02:00,24 hrs.,SPACs,THCB,6,6,0,6,1,1,0,1,NASDAQ
4678,13-02-2021 02:00,24 hrs.,SPACs,TMPM,312,0,312,-312,1,89,130,1,NASDAQ
4678,13-02-2021 02:00,24 hrs.,SPACs,TMTS,312,0,312,-312,1,89,130,1,NASDAQ
4678,13-02-2021 02:00,24 hrs.,SPACs,TTCF,114,0,114,-114,1,22,66,1,NASDAQ
4678,13-02-2021 02:00,24 hrs.,SPACs,TWCT,312,0,312,-312,1,89,130,1,NASDAQ
4678,13-02-2021 02:00,24 hrs.,SPACs,VACQ,312,0,312,-312,1,89,130,1,NASDAQ
4678,13-02-2021 02:00,24 hrs.,SPACs,VMAC,319,0,319,-319,2,90,131,2,NASDAQ
4678,13-02-2021 02:00,24 hrs.,SPACs,VSPR,48,0,48,-48,1,13,18,1,NASDAQ
4678,13-02-2021 02:00,24 hrs.,SPACs,VTIQ,16,0,16,-16,1,2,8,1,NASDAQ
4678,13-02-2021 02:00,24 hrs.,SPACs,YSAC,312,0,312,-312,1,89,130,1,NASDAQ
4678,13-02-2021 02:00,24 hrs.,SPACs,ZGYH,312,0,312,-312,1,89,130,1,NASDAQ
4678,13-02-2021 02:00,24 hrs.,SPACs,CMLFW,2659,0,2659,-2659,1,61,2533,1,NASDAQ
4678,13-02-2021 02:00,24 hrs.,SPACs,DSACW,2659,0,2659,-2659,1,61,2533,1,NASDAQ
4678,13-02-2021 02:00,24 hrs.,SPACs,EXPCW,2659,0,2659,-2659,1,61,2533,1,NASDAQ
4678,13-02-2021 02:00,24 hrs.,SPACs,FCACW,2659,0,2659,-2659,1,61,2533,1,NASDAQ
4678,13-02-2021 02:00,24 hrs.,SPACs,NBACR,5,5,0,5,1,0,1,1,NASDAQ
4678,13-02-2021 02:00,24 hrs.,SPACs,NBACW,5,5,0,5,1,0,1,1,NASDAQ
4678,13-02-2021 02:00,24 hrs.,SPACs,SAIIW,2659,0,2659,-2659,1,61,2533,1,NASDAQ
4678,13-02-2021 02:00,24 hrs.,SPACs,TWCTW,2659,0,2659,-2659,1,61,2533,1,NASDAQ
4678,13-02-2021 02:00,24 hrs.,stocks,ABML,6,6,0,6,1,1,0,1,OTC
4678,13-02-2021 02:00,24 hrs.,stocks,APTY,6,0,6,-6,1,1,0,1,OTC
4678,13-02-2021 02:00,24 hrs.,stocks,BLSP,6,6,0,6,1,1,0,1,OTC
4678,13-02-2021 02:00,24 hrs.,stocks,BONZ,6,6,0,6,1,1,0,1,OTC
4678,13-02-2021 02:00,24 hrs.,stocks,CANN,6,6,0,6,1,1,0,1,OTC
4678,13-02-2021 02:00,24 hrs.,stocks,CAPC,6,6,0,6,1,1,0,1,OTC
4678,13-02-2021 02:00,24 hrs.,stocks,DIGI,6,0,6,-6,1,1,0,1,OTC
4678,13-02-2021 02:00,24 hrs.,stocks,ETCG,6,6,0,6,1,1,0,1,OTC
4678,13-02-2021 02:00,24 hrs.,stocks,FNMA,6,0,6,-6,1,1,0,1,OTC
4678,13-02-2021 02:00,24 hrs.,SPACs,SFTW,312,0,312,-312,1,89,130,1,NYSE
4678,13-02-2021 02:00,24 hrs.,SPACs,SKLZ,133,0,133,-133,1,39,51,1,NYSE
4678,13-02-2021 02:00,24 hrs.,SPACs,SNPR,2864,183,2681,-2498,9,122,2584,7,NYSE
4678,13-02-2021 02:00,24 hrs.,SPACs,SPCE,7,0,7,-7,1,1,1,1,NYSE
4678,13-02-2021 02:00,24 hrs.,SPACs,STPK,13,13,0,13,2,2,1,2,NYSE
4678,13-02-2021 02:00,24 hrs.,SPACs,TWND,34,34,0,34,1,5,20,1,NYSE
4678,13-02-2021 02:00,24 hrs.,wallstreetbets,UFO,6,0,6,-6,1,1,0,1,NASDAQ
4678,13-02-2021 02:00,24 hrs.,wallstreetbets,VFF,24,17,7,10,3,3,6,2,NASDAQ
4678,13-02-2021 02:00,24 hrs.,wallstreetbets,VRM,123,0,123,-123,1,38,43,1,NASDAQ
4678,13-02-2021 02:00,24 hrs.,wallstreetbets,WBA,7,7,0,7,1,1,1,1,NASDAQ
4678,13-02-2021 02:00,24 hrs.,wallstreetbets,WNW,43,43,0,43,6,6,7,5,NASDAQ
4678,13-02-2021 02:00,24 hrs.,wallstreetbets,WWR,6,6,0,6,1,1,0,1,NASDAQ
4678,13-02-2021 02:00,24 hrs.,wallstreetbets,AACG,7,7,0,7,1,1,1,1,NASDAQ
4678,13-02-2021 02:00,24 hrs.,wallstreetbets,AAPL,33,26,7,19,5,5,3,5,NASDAQ
4678,13-02-2021 02:00,24 hrs.,wallstreetbets,AAWW,6,6,0,6,1,1,0,1,NASDAQ
4678,13-02-2021 02:00,24 hrs.,wallstreetbets,ABEO,7,7,0,7,1,1,1,1,NASDAQ
4678,13-02-2021 02:00,24 hrs.,wallstreetbets,ABIO,7,0,7,-7,1,1,1,1,NASDAQ
4678,13-02-2021 02:00,24 hrs.,wallstreetbets,ABNB,29,8,21,-13,4,4,5,4,NASDAQ
4678,13-02-2021 02:00,24 hrs.,wallstreetbets,ABUS,7,7,0,7,1,1,1,1,NASDAQ
4678,13-02-2021 02:00,24 hrs.,wallstreetbets,ACEV,6,6,0,6,1,1,0,1,NASDAQ
4678,13-02-2021 02:00,24 hrs.,wallstreetbets,ACIU,7,7,0,7,1,1,1,1,NASDAQ
4678,13-02-2021 02:00,24 hrs.,wallstreetbets,JMIA,5226,5197,29,5168,8,2433,328,4,NYSE
4678,13-02-2021 02:00,24 hrs.,wallstreetbets,JNPR,6,6,0,6,1,1,0,1,NYSE
4678,13-02-2021 02:00,24 hrs.,wallstreetbets,KODK,13,0,13,-13,2,2,1,1,NYSE
4678,13-02-2021 02:00,24 hrs.,wallstreetbets,LGVW,14,7,7,0,2,2,2,2,NYSE
4678,13-02-2021 02:00,24 hrs.,wallstreetbets,LSPD,6,6,0,6,1,1,0,1,NYSE
4678,13-02-2021 02:00,24 hrs.,wallstreetbets,MAIN,7,0,7,-7,1,1,1,1,NYSE
4678,13-02-2021 02:00,24 hrs.,wallstreetbets,MANU,12,12,0,12,2,2,0,2,NYSE
4678,13-02-2021 02:00,24 hrs.,wallstreetbets,PACK,15,15,0,15,2,2,3,1,NYSE
4678,13-02-2021 02:00,24 hrs.,wallstreetbets,PINS,7,0,7,-7,1,1,1,1,NYSE
4678,13-02-2021 02:00,24 hrs.,wallstreetbets,PLTR,2862,2781,81,2700,43,1075,540,32,NYSE
4678,13-02-2021 02:00,24 hrs.,wallstreetbets,PRTY,14,14,0,14,2,2,2,2,NYSE
4678,13-02-2021 02:00,24 hrs.,wallstreetbets,PSTH,126,126,0,126,3,35,44,2,NYSE
4678,13-02-2021 02:00,24 hrs.,wallstreetbets,PUMP,49,49,0,49,7,7,7,2,NYSE
4678,13-02-2021 02:00,24 hrs.,wallstreetbets,QUAD,8,0,8,-8,1,1,2,1,NYSE
4678,13-02-2021 02:00,24 hrs.,wallstreetbets,SAFE,112,112,0,112,1,28,52,1,NYSE
4678,13-02-2021 02:00,24 hrs.,wallstreetbets,SCVX,6,0,6,-6,1,1,0,1,NYSE
4678,13-02-2021 02:00,24 hrs.,wallstreetbets,SPCE,903,168,735,-567,24,307,193,15,NYSE
4678,13-02-2021 02:00,24 hrs.,wallstreetbets,STIC,7,7,0,7,1,1,1,1,NYSE
4678,13-02-2021 02:00,24 hrs.,wallstreetbets,STPK,6,6,0,6,1,1,0,1,NYSE
4678,13-02-2021 02:00,24 hrs.,wallstreetbets,STWD,152,0,152,-152,1,43,62,1,NYSE
4678,13-02-2021 02:00,24 hrs.,wallstreetbets,TDOC,6,0,6,-6,1,1,0,1,NYSE
4678,13-02-2021 02:00,24 hrs.,wallstreetbets,TWTR,7,7,0,7,1,1,1,1,NYSE
4678,13-02-2021 02:00,24 hrs.,wallstreetbets,UBER,33,7,26,-19,5,5,3,2,NYSE
4678,13-02-2021 02:00,24 hrs.,wallstreetbets,VALE,7,7,0,7,1,1,1,1,NYSE
4678,13-02-2021 02:00,24 hrs.,wallstreetbets,VGAC,19,12,7,5,3,3,1,3,NYSE
4678,13-02-2021 02:00,24 hrs.,wallstreetbets,WORK,3009,14,2995,-2981,4,1254,485,4,NYSE
4678,13-02-2021 02:00,24 hrs.,wallstreetbets,XPEV,14,7,7,0,2,2,2,2,NYSE
4678,13-02-2021 02:00,24 hrs.,wallstreetbets,YELP,7,7,0,7,1,1,1,1,NYSE
4678,13-02-2021 02:00,24 hrs.,wallstreetbets,AAL,19,7,12,-5,3,3,1,3,NASDAQ
4678,13-02-2021 02:00,24 hrs.,wallstreetbets,AMD,2289,1087,1202,-115,25,771,647,22,NASDAQ
4678,13-02-2021 02:00,24 hrs.,wallstreetbets,ASO,6,6,0,6,1,1,0,1,NASDAQ
4678,13-02-2021 02:00,24 hrs.,wallstreetbets,AZN,433,14,419,-405,3,173,75,3,NASDAQ
4678,13-02-2021 02:00,24 hrs.,wallstreetbets,BFI,21,0,21,-21,3,3,3,2,NASDAQ
4678,13-02-2021 02:00,24 hrs.,wallstreetbets,BLU,14,14,0,14,2,2,2,1,NASDAQ
4678,13-02-2021 02:00,24 hrs.,wallstreetbets,BUG,12,12,0,12,2,2,0,1,NASDAQ
4678,13-02-2021 02:00,24 hrs.,wallstreetbets,CDC,419,0,419,-419,1,171,73,1,NASDAQ
4678,13-02-2021 02:00,24 hrs.,wallstreetbets,CGC,1399,14,1385,-1371,8,484,399,8,NASDAQ
4678,13-02-2021 02:00,24 hrs.,wallstreetbets,CTG,7,7,0,7,1,1,1,1,NASDAQ
4678,13-02-2021 02:00,24 hrs.,wallstreetbets,DBX,7,7,0,7,1,1,1,1,NASDAQ
4678,13-02-2021 02:00,24 hrs.,wallstreetbets,ESG,8,0,8,-8,1,1,2,1,NASDAQ
4678,13-02-2021 02:00,24 hrs.,wallstreetbets,FAT,157,157,0,157,2,46,57,2,NASDAQ
4678,13-02-2021 02:00,24 hrs.,wallstreetbets,FUV,7,7,0,7,1,1,1,1,NASDAQ
4678,13-02-2021 02:00,24 hrs.,wallstreetbets,FWP,14,14,0,14,2,2,2,1,NASDAQ
4678,13-02-2021 02:00,24 hrs.,wallstreetbets,GBT,7,7,0,7,1,1,1,1,NASDAQ
4678,13-02-2021 02:00,24 hrs.,wallstreetbets,GSM,19,13,6,7,3,3,1,3,NASDAQ
4678,13-02-2021 02:00,24 hrs.,wallstreetbets,HAS,20,0,20,-20,3,3,2,3,NASDAQ
4678,13-02-2021 02:00,24 hrs.,wallstreetbets,HPK,6,0,6,-6,1,1,0,1,NASDAQ
4678,13-02-2021 02:00,24 hrs.,wallstreetbets,IEA,7,7,0,7,1,1,1,1,NASDAQ
4678,13-02-2021 02:00,24 hrs.,wallstreetbets,III,129,0,129,-129,2,39,43,2,NASDAQ
4678,13-02-2021 02:00,24 hrs.,wallstreetbets,CMPS,3031,28,3003,-2975,7,1257,489,6,NASDAQ
4678,13-02-2021 02:00,24 hrs.,wallstreetbets,CNDT,6,0,6,-6,1,1,0,1,NASDAQ
4678,13-02-2021 02:00,24 hrs.,wallstreetbets,CNSP,7,0,7,-7,1,1,1,1,NASDAQ
4678,13-02-2021 02:00,24 hrs.,wallstreetbets,COCP,7,7,0,7,1,1,1,1,NASDAQ
4678,13-02-2021 02:00,24 hrs.,wallstreetbets,CODX,7,0,7,-7,1,1,1,1,NASDAQ
4678,13-02-2021 02:00,24 hrs.,wallstreetbets,COHR,419,0,419,-419,1,171,73,1,NASDAQ
4678,13-02-2021 02:00,24 hrs.,wallstreetbets,CRBP,28,21,7,14,4,4,4,4,NASDAQ
4678,13-02-2021 02:00,24 hrs.,wallstreetbets,CRNT,13,7,6,1,2,2,1,2,NASDAQ
4678,13-02-2021 02:00,24 hrs.,wallstreetbets,CRON,20,20,0,20,3,3,2,3,NASDAQ
4678,13-02-2021 02:00,24 hrs.,wallstreetbets,CRSR,297,283,14,269,12,90,69,7,NASDAQ
4678,13-02-2021 02:00,24 hrs.,wallstreetbets,CTHR,7,7,0,7,1,1,1,1,NASDAQ
4678,13-02-2021 02:00,24 hrs.,wallstreetbets,CTMX,7,7,0,7,1,1,1,1,NASDAQ
4678,13-02-2021 02:00,24 hrs.,wallstreetbets,CTRM,300,172,128,44,44,44,36,37,NASDAQ
4678,13-02-2021 02:00,24 hrs.,wallstreetbets,CVAC,33,33,0,33,1,8,13,1,NASDAQ
4678,13-02-2021 02:00,24 hrs.,wallstreetbets,DBVT,8,0,8,-8,1,1,2,1,NASDAQ
4678,13-02-2021 02:00,24 hrs.,wallstreetbets,DDOG,419,0,419,-419,1,171,73,1,NASDAQ
4678,13-02-2021 02:00,24 hrs.,wallstreetbets,DFFN,14,14,0,14,2,2,2,1,NASDAQ
4678,13-02-2021 02:00,24 hrs.,wallstreetbets,DKNG,20,14,6,8,3,3,2,3,NASDAQ
4678,13-02-2021 02:00,24 hrs.,wallstreetbets,DOYU,7,7,0,7,1,1,1,1,NASDAQ
4678,13-02-2021 02:00,24 hrs.,wallstreetbets,DRIV,6,6,0,6,1,1,0,1,NASDAQ
4678,13-02-2021 02:00,24 hrs.,wallstreetbets,DRRX,7,7,0,7,1,1,1,1,NASDAQ
4678,13-02-2021 02:00,24 hrs.,wallstreetbets,DSKE,7,7,0,7,1,1,1,1,NASDAQ
4678,13-02-2021 02:00,24 hrs.,wallstreetbets,ACOR,7,7,0,7,1,1,1,1,NASDAQ
4678,13-02-2021 02:00,24 hrs.,wallstreetbets,ACST,20,20,0,20,3,3,2,3,NASDAQ
4678,13-02-2021 02:00,24 hrs.,wallstreetbets,ADMA,7,7,0,7,1,1,1,1,NASDAQ
4678,13-02-2021 02:00,24 hrs.,wallstreetbets,ADMP,7,7,0,7,1,1,1,1,NASDAQ
4678,13-02-2021 02:00,24 hrs.,wallstreetbets,ADXS,6,6,0,6,1,1,0,1,NASDAQ
4678,13-02-2021 02:00,24 hrs.,wallstreetbets,AEZS,14,14,0,14,2,2,2,1,NASDAQ
4678,13-02-2021 02:00,24 hrs.,wallstreetbets,AGEN,7,7,0,7,1,1,1,1,NASDAQ
4678,13-02-2021 02:00,24 hrs.,wallstreetbets,AGTC,36,36,0,36,5,5,6,3,NASDAQ
4678,13-02-2021 02:00,24 hrs.,wallstreetbets,AIKI,7,7,0,7,1,1,1,1,NASDAQ
4678,13-02-2021 02:00,24 hrs.,wallstreetbets,AKBA,7,7,0,7,1,1,1,1,NASDAQ
4678,13-02-2021 02:00,24 hrs.,wallstreetbets,ALRN,7,7,0,7,1,1,1,1,NASDAQ
4678,13-02-2021 02:00,24 hrs.,wallstreetbets,AMAT,32,13,19,-6,5,5,2,4,NASDAQ
4678,13-02-2021 02:00,24 hrs.,wallstreetbets,AMBC,8,0,8,-8,1,1,2,1,NASDAQ
4678,13-02-2021 02:00,24 hrs.,wallstreetbets,AMKR,21,21,0,21,3,3,3,3,NASDAQ
4678,13-02-2021 02:00,24 hrs.,wallstreetbets,AMZN,960,116,844,-728,6,394,148,5,NASDAQ
4678,13-02-2021 02:00,24 hrs.,wallstreetbets,ANCN,7,0,7,-7,1,1,1,1,NASDAQ
4678,13-02-2021 02:00,24 hrs.,wallstreetbets,APEN,7,7,0,7,1,1,1,1,NASDAQ
4678,13-02-2021 02:00,24 hrs.,wallstreetbets,APHA,80415,228,80187,-79959,57,37707,4773,45,NASDAQ
4678,13-02-2021 02:00,24 hrs.,wallstreetbets,APRE,7,7,0,7,1,1,1,1,NASDAQ
4678,13-02-2021 02:00,24 hrs.,wallstreetbets,APXT,22,0,22,-22,3,3,4,2,NASDAQ
4678,13-02-2021 02:00,24 hrs.,wallstreetbets,AQST,13,7,6,1,2,2,1,2,NASDAQ
4678,13-02-2021 02:00,24 hrs.,wallstreetbets,ARTL,89,68,21,47,13,13,11,11,NASDAQ
4678,13-02-2021 02:00,24 hrs.,wallstreetbets,ASML,12,0,12,-12,2,2,0,1,NASDAQ
4678,13-02-2021 02:00,24 hrs.,wallstreetbets,ASRT,48,41,7,34,7,7,6,7,NASDAQ
4678,13-02-2021 02:00,24 hrs.,wallstreetbets,ASYS,6,0,6,-6,1,1,0,1,NASDAQ
4678,13-02-2021 02:00,24 hrs.,wallstreetbets,KOD,6,0,6,-6,1,1,0,1,NASDAQ
4678,13-02-2021 02:00,24 hrs.,wallstreetbets,MGI,9,0,9,-9,1,1,3,1,NASDAQ
4678,13-02-2021 02:00,24 hrs.,wallstreetbets,MYT,7,7,0,7,1,1,1,1,NASDAQ
4678,13-02-2021 02:00,24 hrs.,wallstreetbets,NPA,6,0,6,-6,1,1,0,1,NASDAQ
4678,13-02-2021 02:00,24 hrs.,wallstreetbets,NWL,419,0,419,-419,1,171,73,1,NASDAQ
4678,13-02-2021 02:00,24 hrs.,wallstreetbets,OGI,94,73,21,52,14,14,10,14,NASDAQ
4678,13-02-2021 02:00,24 hrs.,wallstreetbets,OPK,7,7,0,7,1,1,1,1,NASDAQ
4678,13-02-2021 02:00,24 hrs.,wallstreetbets,PTE,35,0,35,-35,5,5,5,1,NASDAQ
4678,13-02-2021 02:00,24 hrs.,wallstreetbets,RUN,188,181,7,174,4,53,66,4,NASDAQ
4678,13-02-2021 02:00,24 hrs.,wallstreetbets,RXT,7,7,0,7,1,1,1,1,NASDAQ
4678,13-02-2021 02:00,24 hrs.,wallstreetbets,SDC,7,7,0,7,1,1,1,1,NASDAQ
4678,13-02-2021 02:00,24 hrs.,wallstreetbets,SFT,7,7,0,7,1,1,1,1,NASDAQ
4678,13-02-2021 02:00,24 hrs.,wallstreetbets,SLM,8,8,0,8,1,1,2,1,NASDAQ
4678,13-02-2021 02:00,24 hrs.,wallstreetbets,SMH,7,7,0,7,1,1,1,1,NASDAQ
4678,13-02-2021 02:00,24 hrs.,wallstreetbets,SND,34,20,14,6,5,5,4,5,NASDAQ
4678,13-02-2021 02:00,24 hrs.,wallstreetbets,SPI,7,7,0,7,1,1,1,1,NASDAQ
4678,13-02-2021 02:00,24 hrs.,wallstreetbets,SPT,7,7,0,7,1,1,1,1,NASDAQ
4678,13-02-2021 02:00,24 hrs.,wallstreetbets,GLMD,21,0,21,-21,3,3,3,1,NASDAQ
4678,13-02-2021 02:00,24 hrs.,wallstreetbets,GLPG,7,0,7,-7,1,1,1,1,NASDAQ
4678,13-02-2021 02:00,24 hrs.,wallstreetbets,GLUU,25,0,25,-25,1,0,21,1,NASDAQ
4678,13-02-2021 02:00,24 hrs.,wallstreetbets,GMBL,7,7,0,7,1,1,1,1,NASDAQ
4678,13-02-2021 02:00,24 hrs.,wallstreetbets,GNOG,7,0,7,-7,1,1,1,1,NASDAQ
4678,13-02-2021 02:00,24 hrs.,wallstreetbets,GNRS,14,0,14,-14,2,2,2,1,NASDAQ
4678,13-02-2021 02:00,24 hrs.,wallstreetbets,GNUS,20,20,0,20,3,3,2,3,NASDAQ
4678,13-02-2021 02:00,24 hrs.,wallstreetbets,GOEV,7,7,0,7,1,1,1,1,NASDAQ
4678,13-02-2021 02:00,24 hrs.,wallstreetbets,GOGO,43,43,0,43,7,7,1,2,NASDAQ
4678,13-02-2021 02:00,24 hrs.,wallstreetbets,GOLD,29,13,16,-3,4,4,5,4,NASDAQ
4678,13-02-2021 02:00,24 hrs.,wallstreetbets,GRIL,7,7,0,7,1,1,1,1,NASDAQ
4678,13-02-2021 02:00,24 hrs.,wallstreetbets,GRTS,6,6,0,6,1,1,0,1,NASDAQ
4678,13-02-2021 02:00,24 hrs.,wallstreetbets,GTEC,8,8,0,8,1,1,2,1,NASDAQ
4678,13-02-2021 02:00,24 hrs.,wallstreetbets,GTHX,44,44,0,44,7,7,2,5,NASDAQ
4678,13-02-2021 02:00,24 hrs.,wallstreetbets,GWPH,13,0,13,-13,1,0,9,1,NASDAQ
4678,13-02-2021 02:00,24 hrs.,wallstreetbets,HALO,14,14,0,14,2,2,2,2,NASDAQ
4678,13-02-2021 02:00,24 hrs.,wallstreetbets,HDSN,7,7,0,7,1,1,1,1,NASDAQ
4678,13-02-2021 02:00,24 hrs.,wallstreetbets,HEAR,6,6,0,6,1,1,0,1,NASDAQ
4678,13-02-2021 02:00,24 hrs.,wallstreetbets,HJLI,14,0,14,-14,2,2,2,1,NASDAQ
4678,13-02-2021 02:00,24 hrs.,wallstreetbets,HSTO,26,19,7,12,4,4,2,3,NASDAQ
4678,13-02-2021 02:00,24 hrs.,wallstreetbets,HTBX,14,8,6,2,2,2,2,2,NASDAQ
4678,13-02-2021 02:00,24 hrs.,wallstreetbets,ICLN,6,6,0,6,1,1,0,1,NASDAQ
4678,13-02-2021 02:00,24 hrs.,wallstreetbets,ICON,7,7,0,7,1,1,1,1,NASDAQ
4678,13-02-2021 02:00,24 hrs.,wallstreetbets,ICPT,7,0,7,-7,1,1,1,1,NASDAQ
4678,13-02-2021 02:00,24 hrs.,wallstreetbets,IDEX,186,13,173,-160,6,48,66,4,NASDAQ
4678,13-02-2021 02:00,24 hrs.,wallstreetbets,IIVI,419,0,419,-419,1,171,73,1,NASDAQ
4678,13-02-2021 02:00,24 hrs.,wallstreetbets,ILMN,7,7,0,7,1,1,1,1,NASDAQ
4678,13-02-2021 02:00,24 hrs.,wallstreetbets,IMGN,21,21,0,21,3,3,3,3,NASDAQ
4678,13-02-2021 02:00,24 hrs.,wallstreetbets,ATHA,7,7,0,7,1,1,1,1,NASDAQ
4678,13-02-2021 02:00,24 hrs.,wallstreetbets,ATHE,12,12,0,12,2,2,0,1,NASDAQ
4678,13-02-2021 02:00,24 hrs.,wallstreetbets,ATOS,48,41,7,34,7,7,6,6,NASDAQ
4678,13-02-2021 02:00,24 hrs.,wallstreetbets,ATVI,7,7,0,7,1,1,1,1,NASDAQ
4678,13-02-2021 02:00,24 hrs.,wallstreetbets,AUPH,6,6,0,6,1,1,0,1,NASDAQ
4678,13-02-2021 02:00,24 hrs.,wallstreetbets,AUTL,14,0,14,-14,2,2,2,1,NASDAQ
4678,13-02-2021 02:00,24 hrs.,wallstreetbets,AVXL,7,7,0,7,1,1,1,1,NASDAQ
4678,13-02-2021 02:00,24 hrs.,wallstreetbets,AWRE,7,7,0,7,1,1,1,1,NASDAQ
4678,13-02-2021 02:00,24 hrs.,wallstreetbets,AXDX,21,0,21,-21,3,3,3,1,NASDAQ
4678,13-02-2021 02:00,24 hrs.,wallstreetbets,AYRO,7,0,7,-7,1,1,1,1,NASDAQ
4678,13-02-2021 02:00,24 hrs.,wallstreetbets,BBBY,7,7,0,7,1,1,1,1,NASDAQ
4678,13-02-2021 02:00,24 hrs.,wallstreetbets,BEAT,8,8,0,8,1,2,0,1,NASDAQ
4678,13-02-2021 02:00,24 hrs.,wallstreetbets,BIOC,7,0,7,-7,1,1,1,1,NASDAQ
4678,13-02-2021 02:00,24 hrs.,wallstreetbets,BIVI,6,6,0,6,1,1,0,1,NASDAQ
4678,13-02-2021 02:00,24 hrs.,wallstreetbets,BLCM,6,6,0,6,1,1,0,1,NASDAQ
4678,13-02-2021 02:00,24 hrs.,wallstreetbets,BLNK,7,7,0,7,1,1,1,1,NASDAQ
4678,13-02-2021 02:00,24 hrs.,wallstreetbets,BNGO,148,141,7,134,21,22,20,12,NASDAQ
4678,13-02-2021 02:00,24 hrs.,wallstreetbets,BNTX,13,0,13,-13,2,2,1,1,NASDAQ
4678,13-02-2021 02:00,24 hrs.,wallstreetbets,BOXL,7,7,0,7,1,1,1,1,NASDAQ
4678,13-02-2021 02:00,24 hrs.,wallstreetbets,BPTH,7,0,7,-7,1,1,1,1,NASDAQ
4678,13-02-2021 02:00,24 hrs.,wallstreetbets,BRQS,6,6,0,6,1,1,0,1,NASDAQ
4678,13-02-2021 02:00,24 hrs.,wallstreetbets,BTWN,7,7,0,7,1,1,1,1,NASDAQ
4678,13-02-2021 02:00,24 hrs.,wallstreetbets,BWEN,7,7,0,7,1,1,1,1,NASDAQ
4678,13-02-2021 02:00,24 hrs.,wallstreetbets,CARE,49,49,0,49,7,7,7,2,NASDAQ
4678,13-02-2021 02:00,24 hrs.,wallstreetbets,CARV,14,7,7,0,2,2,2,2,NASDAQ
4678,13-02-2021 02:00,24 hrs.,wallstreetbets,CASH,14,14,0,14,2,2,2,1,NASDAQ
4678,13-02-2021 02:00,24 hrs.,wallstreetbets,CATM,7,7,0,7,1,1,1,1,NASDAQ
4678,13-02-2021 02:00,24 hrs.,wallstreetbets,CBAT,7,7,0,7,1,1,1,1,NASDAQ
4678,13-02-2021 02:00,24 hrs.,wallstreetbets,CCRC,12,12,0,12,2,2,0,1,NASDAQ
4678,13-02-2021 02:00,24 hrs.,wallstreetbets,CIDM,21,14,7,7,3,3,3,3,NASDAQ
4678,13-02-2021 02:00,24 hrs.,wallstreetbets,CKPT,14,7,7,0,2,2,2,2,NASDAQ
4678,13-02-2021 02:00,24 hrs.,wallstreetbets,CLBS,14,14,0,14,2,2,2,1,NASDAQ
4678,13-02-2021 02:00,24 hrs.,wallstreetbets,CLEU,7,0,7,-7,1,1,1,1,NASDAQ
4678,13-02-2021 02:00,24 hrs.,wallstreetbets,CLGN,7,7,0,7,1,1,1,1,NASDAQ
4678,13-02-2021 02:00,24 hrs.,wallstreetbets,CLSN,7,7,0,7,1,1,1,1,NASDAQ
4678,13-02-2021 02:00,24 hrs.,wallstreetbets,CMLF,7,0,7,-7,1,1,1,1,NASDAQ
4678,13-02-2021 02:00,24 hrs.,wallstreetbets,NVIV,7,7,0,7,1,1,1,1,NASDAQ
4678,13-02-2021 02:00,24 hrs.,wallstreetbets,OCGN,45,45,0,45,7,7,3,6,NASDAQ
4678,13-02-2021 02:00,24 hrs.,wallstreetbets,ONTX,7,7,0,7,1,1,1,1,NASDAQ
4678,13-02-2021 02:00,24 hrs.,wallstreetbets,ONVO,7,0,7,-7,1,1,1,1,NASDAQ
4678,13-02-2021 02:00,24 hrs.,wallstreetbets,OPGN,14,7,7,0,2,2,2,2,NASDAQ
4678,13-02-2021 02:00,24 hrs.,wallstreetbets,OPTT,6,6,0,6,1,1,0,1,NASDAQ
4678,13-02-2021 02:00,24 hrs.,wallstreetbets,PENN,5212,5183,29,5154,6,2431,326,3,NASDAQ
4678,13-02-2021 02:00,24 hrs.,wallstreetbets,PGNY,7,7,0,7,1,1,1,1,NASDAQ
4678,13-02-2021 02:00,24 hrs.,wallstreetbets,PHUN,7,7,0,7,1,1,1,1,NASDAQ
4678,13-02-2021 02:00,24 hrs.,wallstreetbets,INFI,21,0,21,-21,3,3,3,1,NASDAQ
4678,13-02-2021 02:00,24 hrs.,wallstreetbets,INFO,8,0,8,-8,1,1,2,1,NASDAQ
4678,13-02-2021 02:00,24 hrs.,wallstreetbets,INPX,26,7,19,-12,4,4,2,3,NASDAQ
4678,13-02-2021 02:00,24 hrs.,wallstreetbets,INTC,135,128,7,121,3,2,119,3,NASDAQ
4678,13-02-2021 02:00,24 hrs.,wallstreetbets,IPWR,6,6,0,6,1,1,0,1,NASDAQ
4678,13-02-2021 02:00,24 hrs.,wallstreetbets,ITRM,35,21,14,7,5,5,5,3,NASDAQ
4678,13-02-2021 02:00,24 hrs.,wallstreetbets,JAGX,32,32,0,32,5,5,2,2,NASDAQ
4678,13-02-2021 02:00,24 hrs.,wallstreetbets,JBLU,12,0,12,-12,2,2,0,2,NASDAQ
4678,13-02-2021 02:00,24 hrs.,wallstreetbets,JNCE,12,6,6,0,2,2,0,2,NASDAQ
4678,13-02-2021 02:00,24 hrs.,wallstreetbets,KOPN,15,15,0,15,2,2,3,2,NASDAQ
4678,13-02-2021 02:00,24 hrs.,wallstreetbets,KOSS,159,159,0,159,3,44,59,2,NASDAQ
4678,13-02-2021 02:00,24 hrs.,wallstreetbets,LAZR,15,8,7,1,2,2,3,2,NASDAQ
4678,13-02-2021 02:00,24 hrs.,wallstreetbets,LEGN,7,7,0,7,1,1,1,1,NASDAQ
4678,13-02-2021 02:00,24 hrs.,wallstreetbets,LGND,13,7,6,1,2,2,1,2,NASDAQ
4678,13-02-2021 02:00,24 hrs.,wallstreetbets,LIFE,20,7,13,-6,3,3,2,3,NASDAQ
4678,13-02-2021 02:00,24 hrs.,wallstreetbets,LITE,419,0,419,-419,1,171,73,1,NASDAQ
4678,13-02-2021 02:00,24 hrs.,wallstreetbets,LIVE,426,0,426,-426,2,172,74,2,NASDAQ
4678,13-02-2021 02:00,24 hrs.,wallstreetbets,LIVX,15,0,15,-15,2,2,3,1,NASDAQ
4678,13-02-2021 02:00,24 hrs.,wallstreetbets,LKCO,48,42,6,36,7,7,6,6,NASDAQ
4678,13-02-2021 02:00,24 hrs.,wallstreetbets,DXYN,7,7,0,7,1,1,1,1,NASDAQ
4678,13-02-2021 02:00,24 hrs.,wallstreetbets,EBAY,123,0,123,-123,1,38,43,1,NASDAQ
4678,13-02-2021 02:00,24 hrs.,wallstreetbets,EBON,56,56,0,56,8,8,8,4,NASDAQ
4678,13-02-2021 02:00,24 hrs.,wallstreetbets,EDIT,6442,5153,1289,3864,3,2848,734,3,NASDAQ
4678,13-02-2021 02:00,24 hrs.,wallstreetbets,EDSA,6,0,6,-6,1,1,0,1,NASDAQ
4678,13-02-2021 02:00,24 hrs.,wallstreetbets,EHTH,7,0,7,-7,1,1,1,1,NASDAQ
4678,13-02-2021 02:00,24 hrs.,wallstreetbets,ELSE,7,7,0,7,1,1,1,1,NASDAQ
4678,13-02-2021 02:00,24 hrs.,wallstreetbets,ENLV,6,6,0,6,1,1,0,1,NASDAQ
4678,13-02-2021 02:00,24 hrs.,wallstreetbets,ENVB,33,26,7,19,5,5,3,4,NASDAQ
4678,13-02-2021 02:00,24 hrs.,wallstreetbets,ERIC,7,0,7,-7,1,1,1,1,NASDAQ
4678,13-02-2021 02:00,24 hrs.,wallstreetbets,ESPR,7,0,7,-7,1,1,1,1,NASDAQ
4678,13-02-2021 02:00,24 hrs.,wallstreetbets,ETSY,129,0,129,-129,2,39,43,2,NASDAQ
4678,13-02-2021 02:00,24 hrs.,wallstreetbets,EVER,34,28,6,22,5,5,4,5,NASDAQ
4678,13-02-2021 02:00,24 hrs.,wallstreetbets,EXPC,7,7,0,7,1,1,1,1,NASDAQ
4678,13-02-2021 02:00,24 hrs.,wallstreetbets,EXPE,419,0,419,-419,1,171,73,1,NASDAQ
4678,13-02-2021 02:00,24 hrs.,wallstreetbets,EYES,26,0,26,-26,4,4,2,1,NASDAQ
4678,13-02-2021 02:00,24 hrs.,wallstreetbets,FAMI,6,6,0,6,1,1,0,1,NASDAQ
4678,13-02-2021 02:00,24 hrs.,wallstreetbets,FANG,7,0,7,-7,1,1,1,1,NASDAQ
4678,13-02-2021 02:00,24 hrs.,wallstreetbets,FARM,7,7,0,7,1,1,1,1,NASDAQ
4678,13-02-2021 02:00,24 hrs.,wallstreetbets,FAST,7,7,0,7,1,1,1,1,NASDAQ
4678,13-02-2021 02:00,24 hrs.,wallstreetbets,FCAC,8,8,0,8,1,1,2,1,NASDAQ
4678,13-02-2021 02:00,24 hrs.,wallstreetbets,FCEL,6,6,0,6,1,1,0,1,NASDAQ
4678,13-02-2021 02:00,24 hrs.,wallstreetbets,FLDM,7,0,7,-7,1,1,1,1,NASDAQ
4678,13-02-2021 02:00,24 hrs.,wallstreetbets,FLGT,13,13,0,13,2,2,1,2,NASDAQ
4678,13-02-2021 02:00,24 hrs.,wallstreetbets,FLWR,7,7,0,7,1,1,1,1,NASDAQ
4678,13-02-2021 02:00,24 hrs.,wallstreetbets,FLWS,15,15,0,15,2,2,3,2,NASDAQ
4678,13-02-2021 02:00,24 hrs.,wallstreetbets,FOLD,48,48,0,48,7,7,6,6,NASDAQ
4678,13-02-2021 02:00,24 hrs.,wallstreetbets,FORD,7,7,0,7,1,1,1,1,NASDAQ
4678,13-02-2021 02:00,24 hrs.,wallstreetbets,FORM,131,131,0,131,1,51,25,1,NASDAQ
4678,13-02-2021 02:00,24 hrs.,wallstreetbets,FTFT,14,14,0,14,2,2,2,2,NASDAQ
4678,13-02-2021 02:00,24 hrs.,wallstreetbets,FUTU,928,928,0,928,1,361,202,1,NASDAQ
4678,13-02-2021 02:00,24 hrs.,wallstreetbets,GAIN,28,13,15,-2,4,4,4,4,NASDAQ
4678,13-02-2021 02:00,24 hrs.,wallstreetbets,GERN,13,6,7,-1,2,2,1,2,NASDAQ
4678,13-02-2021 02:00,24 hrs.,wallstreetbets,GEVO,204,197,7,190,10,56,52,8,NASDAQ
4678,13-02-2021 02:00,24 hrs.,wallstreetbets,GILT,14,14,0,14,2,2,2,2,NASDAQ
4678,13-02-2021 02:00,24 hrs.,wallstreetbets,GLBS,21,21,0,21,3,3,3,2,NASDAQ
4678,13-02-2021 02:00,24 hrs.,wallstreetbets,PSEC,6,6,0,6,1,0,2,1,NASDAQ
4678,13-02-2021 02:00,24 hrs.,wallstreetbets,PSTV,7,0,7,-7,1,1,1,1,NASDAQ
4678,13-02-2021 02:00,24 hrs.,wallstreetbets,PTCT,7,7,0,7,1,1,1,1,NASDAQ
4678,13-02-2021 02:00,24 hrs.,wallstreetbets,PTON,5205,5176,29,5147,5,2430,325,2,NASDAQ
4678,13-02-2021 02:00,24 hrs.,wallstreetbets,QCOM,7,7,0,7,1,1,1,1,NASDAQ
4678,13-02-2021 02:00,24 hrs.,wallstreetbets,QFIN,7,7,0,7,1,1,1,1,NASDAQ
4678,13-02-2021 02:00,24 hrs.,wallstreetbets,QQQJ,24,24,0,24,1,7,6,1,NASDAQ
4678,13-02-2021 02:00,24 hrs.,wallstreetbets,QUIK,13,7,6,1,2,2,1,2,NASDAQ
4678,13-02-2021 02:00,24 hrs.,wallstreetbets,RAVE,14,14,0,14,2,2,2,2,NASDAQ
4678,13-02-2021 02:00,24 hrs.,wallstreetbets,RDHL,13,13,0,13,2,2,1,2,NASDAQ
4678,13-02-2021 02:00,24 hrs.,wallstreetbets,REAL,127,98,29,69,6,12,79,6,NASDAQ
4678,13-02-2021 02:00,24 hrs.,wallstreetbets,REGI,6,0,6,-6,1,1,0,1,NASDAQ
4678,13-02-2021 02:00,24 hrs.,wallstreetbets,REGN,21,14,7,7,3,3,3,2,NASDAQ
4678,13-02-2021 02:00,24 hrs.,wallstreetbets,RIDE,95,89,6,83,14,14,11,11,NASDAQ
4678,13-02-2021 02:00,24 hrs.,wallstreetbets,RIOT,5289,5253,36,5217,17,2442,337,13,NASDAQ
4678,13-02-2021 02:00,24 hrs.,wallstreetbets,RKDA,7,7,0,7,1,1,1,1,NASDAQ
4678,13-02-2021 02:00,24 hrs.,wallstreetbets,RMTI,20,0,20,-20,3,3,2,2,NASDAQ
4678,13-02-2021 02:00,24 hrs.,wallstreetbets,ROKU,6,6,0,6,1,1,0,1,NASDAQ
4678,13-02-2021 02:00,24 hrs.,wallstreetbets,ROOT,14,0,14,-14,2,2,2,1,NASDAQ
4678,13-02-2021 02:00,24 hrs.,wallstreetbets,RWLK,21,21,0,21,3,3,3,3,NASDAQ
4678,13-02-2021 02:00,24 hrs.,wallstreetbets,SABR,7,0,7,-7,1,1,1,1,NASDAQ
4678,13-02-2021 02:00,24 hrs.,wallstreetbets,SAVA,13,7,6,1,2,2,1,2,NASDAQ
4678,13-02-2021 02:00,24 hrs.,wallstreetbets,SAVE,7,7,0,7,1,1,1,1,NASDAQ
4678,13-02-2021 02:00,24 hrs.,wallstreetbets,SBUX,7,0,7,-7,1,1,1,1,NASDAQ
4678,13-02-2021 02:00,24 hrs.,wallstreetbets,SEAC,7,7,0,7,1,1,1,1,NASDAQ
4678,13-02-2021 02:00,24 hrs.,wallstreetbets,SEEL,7,7,0,7,1,1,1,1,NASDAQ
4678,13-02-2021 02:00,24 hrs.,wallstreetbets,SHIP,144,117,27,90,21,21,18,17,NASDAQ
4678,13-02-2021 02:00,24 hrs.,wallstreetbets,SIRI,7,7,0,7,1,1,1,1,NASDAQ
4678,13-02-2021 02:00,24 hrs.,wallstreetbets,SLRX,7,7,0,7,1,1,1,1,NASDAQ
4678,13-02-2021 02:00,24 hrs.,wallstreetbets,SNCA,6,6,0,6,1,1,0,1,NASDAQ
4678,13-02-2021 02:00,24 hrs.,wallstreetbets,SNDL,7869,1895,5974,-4079,262,2697,1427,196,NASDAQ
4678,13-02-2021 02:00,24 hrs.,wallstreetbets,LLIT,7,7,0,7,1,1,1,1,NASDAQ
4678,13-02-2021 02:00,24 hrs.,wallstreetbets,LLNW,34,13,21,-8,5,5,4,4,NASDAQ
4678,13-02-2021 02:00,24 hrs.,wallstreetbets,LOAN,14,14,0,14,2,2,2,2,NASDAQ
4678,13-02-2021 02:00,24 hrs.,wallstreetbets,LPCN,7,7,0,7,1,1,1,1,NASDAQ
4678,13-02-2021 02:00,24 hrs.,wallstreetbets,LRCX,482,482,0,482,1,123,232,1,NASDAQ
4678,13-02-2021 02:00,24 hrs.,wallstreetbets,MARA,27,14,13,1,4,4,3,4,NASDAQ
4678,13-02-2021 02:00,24 hrs.,wallstreetbets,MARK,14,7,7,0,2,2,2,2,NASDAQ
4678,13-02-2021 02:00,24 hrs.,wallstreetbets,MBIO,6,6,0,6,1,1,0,1,NASDAQ
4678,13-02-2021 02:00,24 hrs.,wallstreetbets,MBRX,39,26,13,13,6,6,3,5,NASDAQ
4678,13-02-2021 02:00,24 hrs.,wallstreetbets,MGNI,14,14,0,14,2,2,2,2,NASDAQ
4678,13-02-2021 02:00,24 hrs.,wallstreetbets,MKSI,419,0,419,-419,1,171,73,1,NASDAQ
4678,13-02-2021 02:00,24 hrs.,wallstreetbets,MNPR,6,0,6,-6,1,1,0,1,NASDAQ
4678,13-02-2021 02:00,24 hrs.,wallstreetbets,MOGO,7,0,7,-7,1,1,1,1,NASDAQ
4678,13-02-2021 02:00,24 hrs.,wallstreetbets,MRNA,6,6,0,6,1,1,0,1,NASDAQ
4678,13-02-2021 02:00,24 hrs.,wallstreetbets,MRVL,7,7,0,7,1,1,1,1,NASDAQ
4678,13-02-2021 02:00,24 hrs.,wallstreetbets,MSFT,5090,5083,7,5076,2,2368,346,2,NASDAQ
4678,13-02-2021 02:00,24 hrs.,wallstreetbets,MSTR,40,13,27,-14,6,6,4,4,NASDAQ
4678,13-02-2021 02:00,24 hrs.,wallstreetbets,MTCH,7,7,0,7,1,1,1,1,NASDAQ
4678,13-02-2021 02:00,24 hrs.,wallstreetbets,MVIS,465,457,8,449,8,151,131,7,NASDAQ
4678,13-02-2021 02:00,24 hrs.,wallstreetbets,NAKD,139,83,56,27,20,20,19,14,NASDAQ
4678,13-02-2021 02:00,24 hrs.,wallstreetbets,NBAC,14,14,0,14,2,2,2,1,NASDAQ
4678,13-02-2021 02:00,24 hrs.,wallstreetbets,NCLH,28,28,0,28,4,4,4,3,NASDAQ
4678,13-02-2021 02:00,24 hrs.,wallstreetbets,NEOS,7,0,7,-7,1,1,1,1,NASDAQ
4678,13-02-2021 02:00,24 hrs.,wallstreetbets,NFLX,7,7,0,7,1,1,1,1,NASDAQ
4678,13-02-2021 02:00,24 hrs.,wallstreetbets,NKLA,7,7,0,7,1,1,1,1,NASDAQ
4678,13-02-2021 02:00,24 hrs.,wallstreetbets,NLOK,7,7,0,7,1,1,1,1,NASDAQ
4678,13-02-2021 02:00,24 hrs.,wallstreetbets,NMRK,6,6,0,6,1,1,0,1,NASDAQ
4678,13-02-2021 02:00,24 hrs.,wallstreetbets,NNDM,28,21,7,14,4,4,4,2,NASDAQ
4678,13-02-2021 02:00,24 hrs.,wallstreetbets,NOVN,21,21,0,21,3,3,3,2,NASDAQ
4678,13-02-2021 02:00,24 hrs.,wallstreetbets,NUAN,598,598,0,598,1,256,82,1,NASDAQ
4678,13-02-2021 02:00,24 hrs.,wallstreetbets,NVAX,12,6,6,0,2,2,0,2,NASDAQ
4678,13-02-2021 02:00,24 hrs.,wallstreetbets,NVCN,6,0,6,-6,1,1,0,1,NASDAQ
4678,13-02-2021 02:00,24 hrs.,wallstreetbets,NVDA,610,610,0,610,3,124,350,3,NASDAQ
4678,13-02-2021 02:00,24 hrs.,RobinHoodPennyStocks,AZFL,6,0,6,-6,1,0,2,1,OTC
4678,13-02-2021 02:00,24 hrs.,RobinHoodPennyStocks,BGMD,4,4,0,4,1,0,0,1,OTC
4678,13-02-2021 02:00,24 hrs.,RobinHoodPennyStocks,BLXX,6,6,0,6,1,1,0,1,OTC
4678,13-02-2021 02:00,24 hrs.,RobinHoodPennyStocks,CAPS,6,0,6,-6,1,1,0,1,OTC
4678,13-02-2021 02:00,24 hrs.,RobinHoodPennyStocks,CBDD,6,6,0,6,1,1,0,1,OTC
4678,13-02-2021 02:00,24 hrs.,RobinHoodPennyStocks,DIGI,6,0,6,-6,1,1,0,1,OTC
4678,13-02-2021 02:00,24 hrs.,RobinHoodPennyStocks,GLEC,6,6,0,6,1,1,0,1,OTC
4678,13-02-2021 02:00,24 hrs.,RobinHoodPennyStocks,GPFT,34,18,16,2,5,5,4,3,OTC
4678,13-02-2021 02:00,24 hrs.,RobinHoodPennyStocks,GSPH,6,6,0,6,1,1,0,1,OTC
4678,13-02-2021 02:00,24 hrs.,RobinHoodPennyStocks,HCMC,12,6,6,0,2,2,0,2,OTC
4678,13-02-2021 02:00,24 hrs.,RobinHoodPennyStocks,INKW,6,6,0,6,1,1,0,1,OTC
4678,13-02-2021 02:00,24 hrs.,RobinHoodPennyStocks,LTUM,6,0,6,-6,1,1,0,1,OTC
4678,13-02-2021 02:00,24 hrs.,RobinHoodPennyStocks,MJNA,6,0,6,-6,1,1,0,1,OTC
4678,13-02-2021 02:00,24 hrs.,RobinHoodPennyStocks,NUUU,6,6,0,6,1,1,0,1,OTC
4678,13-02-2021 02:00,24 hrs.,RobinHoodPennyStocks,OPTI,6,0,6,-6,1,1,0,1,OTC
4678,13-02-2021 02:00,24 hrs.,RobinHoodPennyStocks,PHIL,6,6,0,6,1,1,0,1,OTC
4678,13-02-2021 02:00,24 hrs.,RobinHoodPennyStocks,BDRBF,18,6,12,-6,3,3,0,3,OTC
4678,13-02-2021 02:00,24 hrs.,RobinHoodPennyStocks,NXTTF,6,6,0,6,1,1,0,1,OTC
4678,13-02-2021 02:00,24 hrs.,RobinHoodPennyStocks,PMEDF,6,6,0,6,1,1,0,1,OTC
4678,13-02-2021 02:00,24 hrs.,RobinHoodPennyStocks,RYCEY,18,18,0,18,3,3,0,3,OTC
4678,13-02-2021 02:00,24 hrs.,RobinHoodPennyStocks,SHCAY,19,19,0,19,1,7,1,1,OTC
4678,13-02-2021 02:00,24 hrs.,RobinHoodPennyStocks,ZBISF,6,6,0,6,1,1,0,1,OTC
4678,13-02-2021 02:00,24 hrs.,RobinHoodPennyStocks,AAU,109,0,109,-109,1,39,27,1,AMEX
4678,13-02-2021 02:00,24 hrs.,RobinHoodPennyStocks,DNN,444,61,383,-322,7,159,98,6,AMEX
4678,13-02-2021 02:00,24 hrs.,RobinHoodPennyStocks,DPW,120,11,109,-98,2,40,32,2,AMEX
4678,13-02-2021 02:00,24 hrs.,wallstreetbets,SNGX,34,27,7,20,5,5,4,4,NASDAQ
4678,13-02-2021 02:00,24 hrs.,wallstreetbets,SQQQ,14,7,7,0,2,2,2,2,NASDAQ
4678,13-02-2021 02:00,24 hrs.,wallstreetbets,SRAC,6,6,0,6,1,1,0,1,NASDAQ
4678,13-02-2021 02:00,24 hrs.,wallstreetbets,SRGA,7,7,0,7,1,1,1,1,NASDAQ
4678,13-02-2021 02:00,24 hrs.,wallstreetbets,SRNE,36,14,22,-8,4,7,6,4,NASDAQ
4678,13-02-2021 02:00,24 hrs.,wallstreetbets,STAF,14,14,0,14,2,2,2,2,NASDAQ
4678,13-02-2021 02:00,24 hrs.,wallstreetbets,STAY,12,6,6,0,2,2,0,2,NASDAQ
4678,13-02-2021 02:00,24 hrs.,wallstreetbets,STEP,16,16,0,16,1,0,12,1,NASDAQ
4678,13-02-2021 02:00,24 hrs.,wallstreetbets,STLD,7,7,0,7,1,1,1,1,NASDAQ
4678,13-02-2021 02:00,24 hrs.,wallstreetbets,SVMK,419,0,419,-419,1,171,73,1,NASDAQ
4678,13-02-2021 02:00,24 hrs.,wallstreetbets,SWBI,28,28,0,28,4,4,4,3,NASDAQ
4678,13-02-2021 02:00,24 hrs.,wallstreetbets,SWKS,482,482,0,482,1,123,232,1,NASDAQ
4678,13-02-2021 02:00,24 hrs.,wallstreetbets,TELL,35768,7,35761,-35754,3,17088,1580,3,NASDAQ
4678,13-02-2021 02:00,24 hrs.,wallstreetbets,THBR,7,0,7,-7,1,1,1,1,NASDAQ
4678,13-02-2021 02:00,24 hrs.,wallstreetbets,THCB,6,6,0,6,1,1,0,1,NASDAQ
4678,13-02-2021 02:00,24 hrs.,wallstreetbets,THMO,13,13,0,13,2,2,1,1,NASDAQ
4678,13-02-2021 02:00,24 hrs.,wallstreetbets,TLGT,7,7,0,7,1,1,1,1,NASDAQ
4678,13-02-2021 02:00,24 hrs.,wallstreetbets,TLRY,79507,477,79030,-78553,80,37340,4507,68,NASDAQ
4678,13-02-2021 02:00,24 hrs.,wallstreetbets,TLSA,7,7,0,7,1,1,1,1,NASDAQ
4678,13-02-2021 02:00,24 hrs.,wallstreetbets,TNXP,83,63,20,43,12,12,11,7,NASDAQ
4678,13-02-2021 02:00,24 hrs.,wallstreetbets,TOPS,93,86,7,79,13,14,13,10,NASDAQ
4678,13-02-2021 02:00,24 hrs.,wallstreetbets,TOWN,150,150,0,150,1,45,56,1,NASDAQ
4678,13-02-2021 02:00,24 hrs.,wallstreetbets,TQQQ,14,14,0,14,2,2,2,1,NASDAQ
4678,13-02-2021 02:00,24 hrs.,wallstreetbets,TRCH,21,14,7,7,3,3,3,3,NASDAQ
4678,13-02-2021 02:00,24 hrs.,wallstreetbets,TRIT,46,39,7,32,7,7,4,6,NASDAQ
4678,13-02-2021 02:00,24 hrs.,wallstreetbets,TRVG,2588,2588,0,2588,30,930,608,20,NASDAQ
4678,13-02-2021 02:00,24 hrs.,wallstreetbets,TSLA,7606,7336,270,7066,35,3321,824,28,NASDAQ
4678,13-02-2021 02:00,24 hrs.,wallstreetbets,TTCF,14,7,7,0,2,2,2,2,NASDAQ
4678,13-02-2021 02:00,24 hrs.,wallstreetbets,TTOO,7,7,0,7,1,1,1,1,NASDAQ
4678,13-02-2021 02:00,24 hrs.,wallstreetbets,TXMD,43,14,29,-15,6,6,7,5,NASDAQ
4678,13-02-2021 02:00,24 hrs.,wallstreetbets,PLAY,13,7,6,1,2,2,1,2,NASDAQ
4678,13-02-2021 02:00,24 hrs.,wallstreetbets,PLUG,7,7,0,7,1,1,1,1,NASDAQ
4678,13-02-2021 02:00,24 hrs.,wallstreetbets,PLYA,20,20,0,20,3,3,2,2,NASDAQ
4678,13-02-2021 02:00,24 hrs.,wallstreetbets,POTX,7,7,0,7,1,1,1,1,NASDAQ
4678,13-02-2021 02:00,24 hrs.,wallstreetbets,POWW,48,27,21,6,7,7,6,7,NASDAQ
4678,13-02-2021 02:00,24 hrs.,wallstreetbets,PRCH,72,72,0,72,3,14,32,1,NASDAQ
4678,13-02-2021 02:00,24 hrs.,wallstreetbets,PRPL,928,928,0,928,1,361,202,1,NASDAQ
4678,13-02-2021 02:00,24 hrs.,wallstreetbets,PRTS,15,0,15,-15,2,2,3,1,NASDAQ
4678,13-02-2021 02:00,24 hrs.,wallstreetbets,PSAC,7,7,0,7,1,1,1,1,NASDAQ
4678,13-02-2021 02:00,24 hrs.,RobinHoodPennyStocks,RLGY,109,0,109,-109,1,39,27,1,NYSE
4678,13-02-2021 02:00,24 hrs.,RobinHoodPennyStocks,XPEV,109,0,109,-109,1,39,27,1,NYSE
4678,13-02-2021 02:00,24 hrs.,RobinHoodPennyStocks,AIH,109,0,109,-109,1,39,27,1,NASDAQ
4678,13-02-2021 02:00,24 hrs.,RobinHoodPennyStocks,BBI,6,6,0,6,1,1,0,1,NASDAQ
4678,13-02-2021 02:00,24 hrs.,RobinHoodPennyStocks,ENG,109,0,109,-109,1,39,27,1,NASDAQ
4678,13-02-2021 02:00,24 hrs.,RobinHoodPennyStocks,EVK,109,0,109,-109,1,39,27,1,NASDAQ
4678,13-02-2021 02:00,24 hrs.,RobinHoodPennyStocks,MGI,109,0,109,-109,1,39,27,1,NASDAQ
4678,13-02-2021 02:00,24 hrs.,RobinHoodPennyStocks,OCG,109,0,109,-109,1,39,27,1,NASDAQ
4678,13-02-2021 02:00,24 hrs.,RobinHoodPennyStocks,OEG,109,0,109,-109,1,39,27,1,NASDAQ
4678,13-02-2021 02:00,24 hrs.,RobinHoodPennyStocks,OGI,6,0,6,-6,1,1,0,1,NASDAQ
4678,13-02-2021 02:00,24 hrs.,RobinHoodPennyStocks,PTE,6,0,6,-6,1,1,0,1,NASDAQ
4678,13-02-2021 02:00,24 hrs.,RobinHoodPennyStocks,QTT,109,0,109,-109,1,39,27,1,NASDAQ
4678,13-02-2021 02:00,24 hrs.,RobinHoodPennyStocks,SND,34,34,0,34,4,7,4,2,NASDAQ
4678,13-02-2021 02:00,24 hrs.,RobinHoodPennyStocks,SPI,109,0,109,-109,1,39,27,1,NASDAQ
4678,13-02-2021 02:00,24 hrs.,RobinHoodPennyStocks,WNW,109,0,109,-109,1,39,27,1,NASDAQ
4678,13-02-2021 02:00,24 hrs.,RobinHoodPennyStocks,WWR,109,0,109,-109,1,39,27,1,NASDAQ
4678,13-02-2021 02:00,24 hrs.,RobinHoodPennyStocks,AAOI,109,0,109,-109,1,39,27,1,NASDAQ
4678,13-02-2021 02:00,24 hrs.,RobinHoodPennyStocks,ABEO,173,173,0,173,3,56,49,3,NASDAQ
4678,13-02-2021 02:00,24 hrs.,RobinHoodPennyStocks,ABIO,30,0,30,-30,1,5,16,1,NASDAQ
4678,13-02-2021 02:00,24 hrs.,RobinHoodPennyStocks,ACOR,109,0,109,-109,1,39,27,1,NASDAQ
4678,13-02-2021 02:00,24 hrs.,RobinHoodPennyStocks,ACRX,22,22,0,22,1,7,4,1,NASDAQ
4678,13-02-2021 02:00,24 hrs.,RobinHoodPennyStocks,ACST,6,0,6,-6,1,1,0,1,NASDAQ
4678,13-02-2021 02:00,24 hrs.,RobinHoodPennyStocks,ADXS,18,18,0,18,3,3,0,2,NASDAQ
4678,13-02-2021 02:00,24 hrs.,RobinHoodPennyStocks,AEHR,109,0,109,-109,1,39,27,1,NASDAQ
4678,13-02-2021 02:00,24 hrs.,RobinHoodPennyStocks,AEZS,127,127,0,127,1,51,21,1,NASDAQ
4678,13-02-2021 02:00,24 hrs.,RobinHoodPennyStocks,GSV,121,12,109,-97,3,41,27,3,AMEX
4678,13-02-2021 02:00,24 hrs.,RobinHoodPennyStocks,GTE,846,550,296,254,17,250,278,17,AMEX
4678,13-02-2021 02:00,24 hrs.,RobinHoodPennyStocks,ITP,6,6,0,6,1,1,0,1,AMEX
4678,13-02-2021 02:00,24 hrs.,RobinHoodPennyStocks,NAK,196,81,115,-34,7,55,58,7,AMEX
4678,13-02-2021 02:00,24 hrs.,RobinHoodPennyStocks,REI,22,22,0,22,2,5,4,2,AMEX
4678,13-02-2021 02:00,24 hrs.,RobinHoodPennyStocks,RHE,109,0,109,-109,1,39,27,1,AMEX
4678,13-02-2021 02:00,24 hrs.,RobinHoodPennyStocks,SYN,6,6,0,6,1,1,0,1,AMEX
4678,13-02-2021 02:00,24 hrs.,RobinHoodPennyStocks,TGB,105,0,105,-105,2,39,19,2,AMEX
4678,13-02-2021 02:00,24 hrs.,RobinHoodPennyStocks,TRT,109,0,109,-109,1,39,27,1,AMEX
4678,13-02-2021 02:00,24 hrs.,RobinHoodPennyStocks,TRX,147,0,147,-147,2,48,43,2,AMEX
4678,13-02-2021 02:00,24 hrs.,RobinHoodPennyStocks,XPL,115,6,109,-103,2,40,27,2,AMEX
4678,13-02-2021 02:00,24 hrs.,RobinHoodPennyStocks,ZOM,1177,486,691,-205,12,437,255,12,AMEX
4678,13-02-2021 02:00,24 hrs.,RobinHoodPennyStocks,AMBO,109,0,109,-109,1,39,27,1,AMEX
4678,13-02-2021 02:00,24 hrs.,wallstreetbets,UNFI,317,317,0,317,1,144,25,1,NASDAQ
4678,13-02-2021 02:00,24 hrs.,wallstreetbets,VEON,6,6,0,6,1,1,0,1,NASDAQ
4678,13-02-2021 02:00,24 hrs.,wallstreetbets,VERU,7,7,0,7,1,1,1,1,NASDAQ
4678,13-02-2021 02:00,24 hrs.,wallstreetbets,VISL,7,0,7,-7,1,1,1,1,NASDAQ
4678,13-02-2021 02:00,24 hrs.,wallstreetbets,VKTX,7,7,0,7,1,1,1,1,NASDAQ
4678,13-02-2021 02:00,24 hrs.,wallstreetbets,VLDR,7,7,0,7,1,1,1,1,NASDAQ
4678,13-02-2021 02:00,24 hrs.,wallstreetbets,VOXX,6,6,0,6,1,1,0,1,NASDAQ
4678,13-02-2021 02:00,24 hrs.,wallstreetbets,VRSN,419,0,419,-419,1,171,73,1,NASDAQ
4678,13-02-2021 02:00,24 hrs.,wallstreetbets,VSAT,14,14,0,14,2,2,2,1,NASDAQ
4678,13-02-2021 02:00,24 hrs.,wallstreetbets,VTGN,7,7,0,7,1,1,1,1,NASDAQ
4678,13-02-2021 02:00,24 hrs.,wallstreetbets,VUZI,21,21,0,21,3,3,3,1,NASDAQ
4678,13-02-2021 02:00,24 hrs.,wallstreetbets,VXRT,27,21,6,15,4,4,3,4,NASDAQ
4678,13-02-2021 02:00,24 hrs.,wallstreetbets,WATT,7,7,0,7,1,1,1,1,NASDAQ
4678,13-02-2021 02:00,24 hrs.,wallstreetbets,WKHS,5840,5840,0,5840,2,2651,530,2,NASDAQ
4678,13-02-2021 02:00,24 hrs.,wallstreetbets,WRAP,7,7,0,7,1,1,1,1,NASDAQ
4678,13-02-2021 02:00,24 hrs.,wallstreetbets,XENE,14,14,0,14,2,2,2,1,NASDAQ
4678,13-02-2021 02:00,24 hrs.,wallstreetbets,XERS,15,7,8,-1,2,2,3,2,NASDAQ
4678,13-02-2021 02:00,24 hrs.,wallstreetbets,XNET,14,14,0,14,2,2,2,1,NASDAQ
4678,13-02-2021 02:00,24 hrs.,wallstreetbets,XSPA,71,38,33,5,11,11,5,10,NASDAQ
4678,13-02-2021 02:00,24 hrs.,wallstreetbets,YNDX,503,0,503,-503,1,189,121,1,NASDAQ
4678,13-02-2021 02:00,24 hrs.,wallstreetbets,ZNGA,14,7,7,0,2,2,2,2,NASDAQ
4678,13-02-2021 02:00,24 hrs.,wallstreetbets,ZYNE,7,0,7,-7,1,1,1,1,NASDAQ
4678,13-02-2021 02:00,24 hrs.,wallstreetbets,CMCSA,7,7,0,7,1,1,1,1,NASDAQ
4678,13-02-2021 02:00,24 hrs.,wallstreetbets,GOOGL,6,6,0,6,1,1,0,1,NASDAQ
4678,13-02-2021 02:00,24 hrs.,wallstreetbets,SRACU,6,6,0,6,1,1,0,1,NASDAQ
4678,13-02-2021 02:00,24 hrs.,wallstreetbets,SRACW,6,6,0,6,1,1,0,1,NASDAQ
4678,13-02-2021 02:00,24 hrs.,RobinHoodPennyStocks,CSCW,109,0,109,-109,1,39,27,1,NASDAQ
4678,13-02-2021 02:00,24 hrs.,RobinHoodPennyStocks,CTRM,583,249,334,-85,11,181,177,11,NASDAQ
4678,13-02-2021 02:00,24 hrs.,RobinHoodPennyStocks,DFFN,731,725,6,719,10,269,153,8,NASDAQ
4678,13-02-2021 02:00,24 hrs.,RobinHoodPennyStocks,EAST,54,0,54,-54,1,17,16,1,NASDAQ
4678,13-02-2021 02:00,24 hrs.,RobinHoodPennyStocks,ENTX,62,62,0,62,1,24,10,1,NASDAQ
4678,13-02-2021 02:00,24 hrs.,RobinHoodPennyStocks,EQOS,109,0,109,-109,1,39,27,1,NASDAQ
4678,13-02-2021 02:00,24 hrs.,RobinHoodPennyStocks,FCEL,154,45,109,-64,2,46,54,2,NASDAQ
4678,13-02-2021 02:00,24 hrs.,RobinHoodPennyStocks,GAIN,6,6,0,6,1,1,0,1,NASDAQ
4678,13-02-2021 02:00,24 hrs.,RobinHoodPennyStocks,GLBS,6,6,0,6,1,1,0,1,NASDAQ
4678,13-02-2021 02:00,24 hrs.,RobinHoodPennyStocks,GMDA,6,0,6,-6,1,1,0,1,NASDAQ
4678,13-02-2021 02:00,24 hrs.,RobinHoodPennyStocks,GRIL,109,0,109,-109,1,39,27,1,NASDAQ
4678,13-02-2021 02:00,24 hrs.,RobinHoodPennyStocks,HCDI,109,0,109,-109,1,39,27,1,NASDAQ
4678,13-02-2021 02:00,24 hrs.,RobinHoodPennyStocks,HGSH,109,0,109,-109,1,39,27,1,NASDAQ
4678,13-02-2021 02:00,24 hrs.,RobinHoodPennyStocks,IDEX,122,13,109,-96,2,41,32,2,NASDAQ
4678,13-02-2021 02:00,24 hrs.,RobinHoodPennyStocks,IFMK,109,0,109,-109,1,39,27,1,NASDAQ
4678,13-02-2021 02:00,24 hrs.,RobinHoodPennyStocks,IMMR,10,10,0,10,1,2,2,1,NASDAQ
4678,13-02-2021 02:00,24 hrs.,RobinHoodPennyStocks,IMTE,109,0,109,-109,1,39,27,1,NASDAQ
4678,13-02-2021 02:00,24 hrs.,RobinHoodPennyStocks,ITRM,6,6,0,6,1,1,0,1,NASDAQ
4678,13-02-2021 02:00,24 hrs.,RobinHoodPennyStocks,IZEA,109,0,109,-109,1,39,27,1,NASDAQ
4678,13-02-2021 02:00,24 hrs.,RobinHoodPennyStocks,JFIN,109,0,109,-109,1,39,27,1,NASDAQ
4678,13-02-2021 02:00,24 hrs.,RobinHoodPennyStocks,JRJC,109,0,109,-109,1,39,27,1,NASDAQ
4678,13-02-2021 02:00,24 hrs.,RobinHoodPennyStocks,KNDI,109,0,109,-109,1,39,27,1,NASDAQ
4678,13-02-2021 02:00,24 hrs.,RobinHoodPennyStocks,KTRA,67,20,47,-27,2,24,11,2,NASDAQ
4678,13-02-2021 02:00,24 hrs.,RobinHoodPennyStocks,KXIN,109,0,109,-109,1,39,27,1,NASDAQ
4678,13-02-2021 02:00,24 hrs.,RobinHoodPennyStocks,LEDS,109,0,109,-109,1,39,27,1,NASDAQ
4678,13-02-2021 02:00,24 hrs.,RobinHoodPennyStocks,AUMN,109,0,109,-109,1,39,27,1,AMEX
4678,13-02-2021 02:00,24 hrs.,RobinHoodPennyStocks,IBIO,35,35,0,35,1,13,5,1,AMEX
4678,13-02-2021 02:00,24 hrs.,RobinHoodPennyStocks,NSPR,35,28,7,21,2,8,11,2,AMEX
4678,13-02-2021 02:00,24 hrs.,RobinHoodPennyStocks,OGEN,18,6,12,-6,3,3,0,3,AMEX
4678,13-02-2021 02:00,24 hrs.,RobinHoodPennyStocks,PLAG,109,0,109,-109,1,39,27,1,AMEX
4678,13-02-2021 02:00,24 hrs.,RobinHoodPennyStocks,SENS,61,61,0,61,3,22,5,3,AMEX
4678,13-02-2021 02:00,24 hrs.,RobinHoodPennyStocks,SMTS,6,0,6,-6,1,1,0,1,AMEX
4678,13-02-2021 02:00,24 hrs.,RobinHoodPennyStocks,TKAT,109,0,109,-109,1,39,27,1,AMEX
4678,13-02-2021 02:00,24 hrs.,RobinHoodPennyStocks,TRXC,179,6,173,-167,3,68,31,3,AMEX
4678,13-02-2021 02:00,24 hrs.,RobinHoodPennyStocks,YCBD,6,0,6,-6,1,1,0,1,AMEX
4678,13-02-2021 02:00,24 hrs.,RobinHoodPennyStocks,AIV,6,6,0,6,1,1,0,1,NYSE
4678,13-02-2021 02:00,24 hrs.,RobinHoodPennyStocks,AMC,109,0,109,-109,1,39,27,1,NYSE
4678,13-02-2021 02:00,24 hrs.,RobinHoodPennyStocks,BTU,109,0,109,-109,1,39,27,1,NYSE
4678,13-02-2021 02:00,24 hrs.,RobinHoodPennyStocks,CCM,109,0,109,-109,1,39,27,1,NYSE
4678,13-02-2021 02:00,24 hrs.,RobinHoodPennyStocks,CTK,109,0,109,-109,1,39,27,1,NYSE
4678,13-02-2021 02:00,24 hrs.,RobinHoodPennyStocks,DNK,6,6,0,6,1,1,0,1,NYSE
4678,13-02-2021 02:00,24 hrs.,RobinHoodPennyStocks,FSR,115,6,109,-103,2,40,27,2,NYSE
4678,13-02-2021 02:00,24 hrs.,RobinHoodPennyStocks,GME,48,48,0,48,2,10,20,2,NYSE
4678,13-02-2021 02:00,24 hrs.,RobinHoodPennyStocks,GSX,109,0,109,-109,1,39,27,1,NYSE
4678,13-02-2021 02:00,24 hrs.,RobinHoodPennyStocks,IRS,263,263,0,263,1,119,21,1,NYSE
4678,13-02-2021 02:00,24 hrs.,RobinHoodPennyStocks,LOW,6,0,6,-6,1,1,0,1,NYSE
4678,13-02-2021 02:00,24 hrs.,RobinHoodPennyStocks,MTL,19,19,0,19,2,2,7,2,NYSE
4678,13-02-2021 02:00,24 hrs.,RobinHoodPennyStocks,NAT,6,6,0,6,1,1,0,1,NYSE
4678,13-02-2021 02:00,24 hrs.,RobinHoodPennyStocks,NBB,6,6,0,6,1,1,0,1,NYSE
4678,13-02-2021 02:00,24 hrs.,RobinHoodPennyStocks,NIO,109,0,109,-109,1,39,27,1,NYSE
4678,13-02-2021 02:00,24 hrs.,RobinHoodPennyStocks,PHI,6,6,0,6,1,1,0,1,NYSE
4678,13-02-2021 02:00,24 hrs.,RobinHoodPennyStocks,PSA,18,0,18,-18,1,5,4,1,NYSE
4678,13-02-2021 02:00,24 hrs.,RobinHoodPennyStocks,RFP,109,0,109,-109,1,39,27,1,NYSE
4678,13-02-2021 02:00,24 hrs.,RobinHoodPennyStocks,SOS,196,34,162,-128,4,56,68,4,NYSE
4678,13-02-2021 02:00,24 hrs.,RobinHoodPennyStocks,SUZ,109,0,109,-109,1,39,27,1,NYSE
4678,13-02-2021 02:00,24 hrs.,RobinHoodPennyStocks,TAL,109,0,109,-109,1,39,27,1,NYSE
4678,13-02-2021 02:00,24 hrs.,RobinHoodPennyStocks,WEI,109,0,109,-109,1,39,27,1,NYSE
4678,13-02-2021 02:00,24 hrs.,RobinHoodPennyStocks,BABA,109,0,109,-109,1,39,27,1,NYSE
4678,13-02-2021 02:00,24 hrs.,RobinHoodPennyStocks,CCIV,38,0,38,-38,1,10,14,1,NYSE
4678,13-02-2021 02:00,24 hrs.,RobinHoodPennyStocks,CEIX,109,0,109,-109,1,39,27,1,NYSE
4678,13-02-2021 02:00,24 hrs.,RobinHoodPennyStocks,CMCM,109,0,109,-109,1,39,27,1,NYSE
4678,13-02-2021 02:00,24 hrs.,RobinHoodPennyStocks,FUBO,109,0,109,-109,1,39,27,1,NYSE
4678,13-02-2021 02:00,24 hrs.,RobinHoodPennyStocks,LAIX,109,0,109,-109,1,39,27,1,NYSE
4678,13-02-2021 02:00,24 hrs.,RobinHoodPennyStocks,PLTR,6,6,0,6,1,1,0,1,NYSE
4678,13-02-2021 02:00,24 hrs.,RobinHoodPennyStocks,SNGX,239,9,230,-221,4,91,41,3,NASDAQ
4678,13-02-2021 02:00,24 hrs.,RobinHoodPennyStocks,SRAX,6,6,0,6,1,1,0,1,NASDAQ
4678,13-02-2021 02:00,24 hrs.,RobinHoodPennyStocks,SRGA,6,6,0,6,1,1,0,1,NASDAQ
4678,13-02-2021 02:00,24 hrs.,RobinHoodPennyStocks,SUNW,109,0,109,-109,1,39,27,1,NASDAQ
4678,13-02-2021 02:00,24 hrs.,RobinHoodPennyStocks,SXTC,109,0,109,-109,1,39,27,1,NASDAQ
4678,13-02-2021 02:00,24 hrs.,RobinHoodPennyStocks,SYPR,109,0,109,-109,1,39,27,1,NASDAQ
4678,13-02-2021 02:00,24 hrs.,RobinHoodPennyStocks,TAIT,109,0,109,-109,1,39,27,1,NASDAQ
4678,13-02-2021 02:00,24 hrs.,RobinHoodPennyStocks,TANH,109,0,109,-109,1,39,27,1,NASDAQ
4678,13-02-2021 02:00,24 hrs.,RobinHoodPennyStocks,TAOP,109,0,109,-109,1,39,27,1,NASDAQ
4678,13-02-2021 02:00,24 hrs.,RobinHoodPennyStocks,TBLT,78,78,0,78,1,24,26,1,NASDAQ
4678,13-02-2021 02:00,24 hrs.,RobinHoodPennyStocks,TEDU,109,0,109,-109,1,39,27,1,NASDAQ
4678,13-02-2021 02:00,24 hrs.,RobinHoodPennyStocks,TIGR,109,0,109,-109,1,39,27,1,NASDAQ
4678,13-02-2021 02:00,24 hrs.,RobinHoodPennyStocks,TNXP,83,0,83,-83,3,20,31,3,NASDAQ
4678,13-02-2021 02:00,24 hrs.,RobinHoodPennyStocks,TRCH,192,83,109,-26,4,59,58,3,NASDAQ
4678,13-02-2021 02:00,24 hrs.,RobinHoodPennyStocks,LKCO,102,96,6,90,9,26,14,9,NASDAQ
4678,13-02-2021 02:00,24 hrs.,RobinHoodPennyStocks,LMFA,109,0,109,-109,1,39,27,1,NASDAQ
4678,13-02-2021 02:00,24 hrs.,RobinHoodPennyStocks,LXEH,109,0,109,-109,1,39,27,1,NASDAQ
4678,13-02-2021 02:00,24 hrs.,RobinHoodPennyStocks,MARA,109,0,109,-109,1,39,27,1,NASDAQ
4678,13-02-2021 02:00,24 hrs.,RobinHoodPennyStocks,METX,109,0,109,-109,1,39,27,1,NASDAQ
4678,13-02-2021 02:00,24 hrs.,RobinHoodPennyStocks,MMLP,6,6,0,6,1,1,0,1,NASDAQ
4678,13-02-2021 02:00,24 hrs.,RobinHoodPennyStocks,MOGO,109,0,109,-109,1,39,27,1,NASDAQ
4678,13-02-2021 02:00,24 hrs.,RobinHoodPennyStocks,MOMO,109,0,109,-109,1,39,27,1,NASDAQ
4678,13-02-2021 02:00,24 hrs.,RobinHoodPennyStocks,MOSY,109,0,109,-109,1,39,27,1,NASDAQ
4678,13-02-2021 02:00,24 hrs.,RobinHoodPennyStocks,MOXC,109,0,109,-109,1,39,27,1,NASDAQ
4678,13-02-2021 02:00,24 hrs.,RobinHoodPennyStocks,MVIS,109,0,109,-109,1,39,27,1,NASDAQ
4678,13-02-2021 02:00,24 hrs.,RobinHoodPennyStocks,NAKD,127,6,121,-115,4,42,27,4,NASDAQ
4678,13-02-2021 02:00,24 hrs.,RobinHoodPennyStocks,NCTY,109,0,109,-109,1,39,27,1,NASDAQ
4678,13-02-2021 02:00,24 hrs.,RobinHoodPennyStocks,NMTR,125,125,0,125,1,41,39,1,NASDAQ
4678,13-02-2021 02:00,24 hrs.,RobinHoodPennyStocks,NOVN,162,0,162,-162,3,57,36,3,NASDAQ
4678,13-02-2021 02:00,24 hrs.,RobinHoodPennyStocks,NVCN,66,66,0,66,2,17,24,2,NASDAQ
4678,13-02-2021 02:00,24 hrs.,RobinHoodPennyStocks,NXTD,109,0,109,-109,1,39,27,1,NASDAQ
4678,13-02-2021 02:00,24 hrs.,RobinHoodPennyStocks,AGTC,2124,484,1640,-1156,20,845,354,18,NASDAQ
4678,13-02-2021 02:00,24 hrs.,RobinHoodPennyStocks,AIHS,109,0,109,-109,1,39,27,1,NASDAQ
4678,13-02-2021 02:00,24 hrs.,RobinHoodPennyStocks,ALAC,109,0,109,-109,1,39,27,1,NASDAQ
4678,13-02-2021 02:00,24 hrs.,RobinHoodPennyStocks,AMTX,109,0,109,-109,1,39,27,1,NASDAQ
4678,13-02-2021 02:00,24 hrs.,RobinHoodPennyStocks,APHA,12,6,6,0,2,2,0,2,NASDAQ
4678,13-02-2021 02:00,24 hrs.,RobinHoodPennyStocks,ARPO,6,0,6,-6,1,1,0,1,NASDAQ
4678,13-02-2021 02:00,24 hrs.,RobinHoodPennyStocks,ARTL,18,18,0,18,3,3,0,3,NASDAQ
4678,13-02-2021 02:00,24 hrs.,RobinHoodPennyStocks,ASRT,65,65,0,65,4,22,5,3,NASDAQ
4678,13-02-2021 02:00,24 hrs.,RobinHoodPennyStocks,ASYS,109,0,109,-109,1,39,27,1,NASDAQ
4678,13-02-2021 02:00,24 hrs.,RobinHoodPennyStocks,ATIF,109,0,109,-109,1,39,27,1,NASDAQ
4678,13-02-2021 02:00,24 hrs.,RobinHoodPennyStocks,ATNI,109,0,109,-109,1,39,27,1,NASDAQ
4678,13-02-2021 02:00,24 hrs.,RobinHoodPennyStocks,ATOS,530,500,30,470,14,191,92,14,NASDAQ
4678,13-02-2021 02:00,24 hrs.,RobinHoodPennyStocks,AVCO,109,0,109,-109,1,39,27,1,NASDAQ
4678,13-02-2021 02:00,24 hrs.,RobinHoodPennyStocks,BBIG,6,0,6,-6,1,1,0,1,NASDAQ
4678,13-02-2021 02:00,24 hrs.,RobinHoodPennyStocks,BFRA,109,0,109,-109,1,39,27,1,NASDAQ
4678,13-02-2021 02:00,24 hrs.,RobinHoodPennyStocks,BHAT,109,0,109,-109,1,39,27,1,NASDAQ
4678,13-02-2021 02:00,24 hrs.,RobinHoodPennyStocks,BHTG,65,65,0,65,2,21,15,2,NASDAQ
4678,13-02-2021 02:00,24 hrs.,RobinHoodPennyStocks,BIOL,6,6,0,6,1,1,0,1,NASDAQ
4678,13-02-2021 02:00,24 hrs.,RobinHoodPennyStocks,BNGO,40,40,0,40,3,10,8,3,NASDAQ
4678,13-02-2021 02:00,24 hrs.,RobinHoodPennyStocks,BRQS,140,6,134,-128,3,44,40,3,NASDAQ
4678,13-02-2021 02:00,24 hrs.,RobinHoodPennyStocks,BYFC,109,0,109,-109,1,39,27,1,NASDAQ
4678,13-02-2021 02:00,24 hrs.,RobinHoodPennyStocks,CAAS,109,0,109,-109,1,39,27,1,NASDAQ
4678,13-02-2021 02:00,24 hrs.,RobinHoodPennyStocks,CARV,109,0,109,-109,1,39,27,1,NASDAQ
4678,13-02-2021 02:00,24 hrs.,RobinHoodPennyStocks,CBAT,109,0,109,-109,1,39,27,1,NASDAQ
4678,13-02-2021 02:00,24 hrs.,RobinHoodPennyStocks,CCNC,109,0,109,-109,1,39,27,1,NASDAQ
4678,13-02-2021 02:00,24 hrs.,RobinHoodPennyStocks,CDTX,6,6,0,6,1,1,0,1,NASDAQ
4678,13-02-2021 02:00,24 hrs.,RobinHoodPennyStocks,CHNR,109,0,109,-109,1,39,27,1,NASDAQ
4678,13-02-2021 02:00,24 hrs.,RobinHoodPennyStocks,CIDM,15,15,0,15,1,5,1,1,NASDAQ
4678,13-02-2021 02:00,24 hrs.,RobinHoodPennyStocks,CKPT,61,31,30,1,2,19,15,2,NASDAQ
4678,13-02-2021 02:00,24 hrs.,RobinHoodPennyStocks,CLBS,17,17,0,17,2,4,1,2,NASDAQ
4678,13-02-2021 02:00,24 hrs.,RobinHoodPennyStocks,CLEU,109,0,109,-109,1,39,27,1,NASDAQ
4678,13-02-2021 02:00,24 hrs.,RobinHoodPennyStocks,CLSK,109,0,109,-109,1,39,27,1,NASDAQ
4678,13-02-2021 02:00,24 hrs.,RobinHoodPennyStocks,CMLF,109,0,109,-109,1,39,27,1,NASDAQ
4678,13-02-2021 02:00,24 hrs.,wallstreetbets,OWPC,6,6,0,6,1,1,0,1,OTC
4678,13-02-2021 02:00,24 hrs.,wallstreetbets,OZSC,14,14,0,14,2,2,2,2,OTC
4678,13-02-2021 02:00,24 hrs.,wallstreetbets,PAOG,7,7,0,7,1,1,1,1,OTC
4678,13-02-2021 02:00,24 hrs.,wallstreetbets,PDMI,7,0,7,-7,1,1,1,1,OTC
4678,13-02-2021 02:00,24 hrs.,wallstreetbets,PHBI,14,14,0,14,2,2,2,1,OTC
4678,13-02-2021 02:00,24 hrs.,wallstreetbets,PNPL,13,0,13,-13,2,2,1,1,OTC
4678,13-02-2021 02:00,24 hrs.,wallstreetbets,PRED,7,0,7,-7,1,1,1,1,OTC
4678,13-02-2021 02:00,24 hrs.,wallstreetbets,QOIL,6,6,0,6,1,1,0,1,OTC
4678,13-02-2021 02:00,24 hrs.,wallstreetbets,RBDC,7,0,7,-7,1,1,1,1,OTC
4678,13-02-2021 02:00,24 hrs.,wallstreetbets,RBNW,13,0,13,-13,2,2,1,2,OTC
4678,13-02-2021 02:00,24 hrs.,wallstreetbets,REFG,7,7,0,7,1,1,1,1,OTC
4678,13-02-2021 02:00,24 hrs.,wallstreetbets,RELI,6,6,0,6,1,1,0,1,OTC
4678,13-02-2021 02:00,24 hrs.,wallstreetbets,RSHN,7,0,7,-7,1,1,1,1,OTC
4678,13-02-2021 02:00,24 hrs.,wallstreetbets,RSSV,9,9,0,9,1,2,1,1,OTC
4678,13-02-2021 02:00,24 hrs.,wallstreetbets,RTON,14,14,0,14,2,2,2,2,OTC
4678,13-02-2021 02:00,24 hrs.,wallstreetbets,SFOR,14,0,14,-14,2,2,2,1,OTC
4678,13-02-2021 02:00,24 hrs.,wallstreetbets,SGMD,19,0,19,-19,3,3,1,2,OTC
4678,13-02-2021 02:00,24 hrs.,wallstreetbets,SHMP,21,7,14,-7,3,3,3,3,OTC
4678,13-02-2021 02:00,24 hrs.,wallstreetbets,SHWZ,7,7,0,7,1,1,1,1,OTC
4678,13-02-2021 02:00,24 hrs.,wallstreetbets,SIGN,34,28,6,22,5,5,4,4,OTC
4678,13-02-2021 02:00,24 hrs.,wallstreetbets,SIMP,7,7,0,7,1,1,1,1,OTC
4678,13-02-2021 02:00,24 hrs.,wallstreetbets,SIRR,7,7,0,7,1,1,1,1,OTC
4678,13-02-2021 02:00,24 hrs.,wallstreetbets,SNYR,14,14,0,14,2,2,2,1,OTC
4678,13-02-2021 02:00,24 hrs.,wallstreetbets,SRMX,20,13,7,6,3,3,2,3,OTC
4678,13-02-2021 02:00,24 hrs.,wallstreetbets,SUIC,6,6,0,6,1,1,0,1,OTC
4678,13-02-2021 02:00,24 hrs.,RobinHoodPennyStocks,TTOO,32,0,32,-32,1,11,6,1,NASDAQ
4678,13-02-2021 02:00,24 hrs.,RobinHoodPennyStocks,TXMD,76,30,46,-16,6,18,16,6,NASDAQ
4678,13-02-2021 02:00,24 hrs.,RobinHoodPennyStocks,TYME,28,0,28,-28,1,5,14,1,NASDAQ
4678,13-02-2021 02:00,24 hrs.,RobinHoodPennyStocks,UONE,109,0,109,-109,1,39,27,1,NASDAQ
4678,13-02-2021 02:00,24 hrs.,RobinHoodPennyStocks,USEG,109,0,109,-109,1,39,27,1,NASDAQ
4678,13-02-2021 02:00,24 hrs.,RobinHoodPennyStocks,UXIN,109,0,109,-109,1,39,27,1,NASDAQ
4678,13-02-2021 02:00,24 hrs.,RobinHoodPennyStocks,WATT,109,0,109,-109,1,39,27,1,NASDAQ
4678,13-02-2021 02:00,24 hrs.,RobinHoodPennyStocks,WIMI,109,0,109,-109,1,39,27,1,NASDAQ
4678,13-02-2021 02:00,24 hrs.,RobinHoodPennyStocks,WKEY,109,0,109,-109,1,39,27,1,NASDAQ
4678,13-02-2021 02:00,24 hrs.,RobinHoodPennyStocks,WRAP,109,0,109,-109,1,39,27,1,NASDAQ
4678,13-02-2021 02:00,24 hrs.,RobinHoodPennyStocks,XSPA,25,25,0,25,1,10,1,1,NASDAQ
4678,13-02-2021 02:00,24 hrs.,RobinHoodPennyStocks,YGMZ,109,0,109,-109,1,39,27,1,NASDAQ
4678,13-02-2021 02:00,24 hrs.,RobinHoodPennyStocks,ZSAN,680,6,674,-668,4,286,92,4,NASDAQ
4678,13-02-2021 02:00,24 hrs.,RobinHoodPennyStocks,UONEK,109,0,109,-109,1,39,27,1,NASDAQ
4678,13-02-2021 02:00,24 hrs.,RobinHoodPennyStocks,OCGN,38,0,38,-38,1,10,14,1,NASDAQ
4678,13-02-2021 02:00,24 hrs.,RobinHoodPennyStocks,ONTX,6,0,6,-6,1,1,0,1,NASDAQ
4678,13-02-2021 02:00,24 hrs.,RobinHoodPennyStocks,OPGN,30,24,6,18,5,5,0,2,NASDAQ
4678,13-02-2021 02:00,24 hrs.,RobinHoodPennyStocks,OPTT,115,6,109,-103,2,40,27,2,NASDAQ
4678,13-02-2021 02:00,24 hrs.,RobinHoodPennyStocks,OVID,6,6,0,6,1,1,0,1,NASDAQ
4678,13-02-2021 02:00,24 hrs.,RobinHoodPennyStocks,PECK,109,0,109,-109,1,39,27,1,NASDAQ
4678,13-02-2021 02:00,24 hrs.,RobinHoodPennyStocks,PEIX,109,0,109,-109,1,39,27,1,NASDAQ
4678,13-02-2021 02:00,24 hrs.,RobinHoodPennyStocks,PETZ,109,0,109,-109,1,39,27,1,NASDAQ
4678,13-02-2021 02:00,24 hrs.,RobinHoodPennyStocks,PHUN,115,6,109,-103,2,40,27,2,NASDAQ
4678,13-02-2021 02:00,24 hrs.,RobinHoodPennyStocks,PIXY,109,0,109,-109,1,39,27,1,NASDAQ
4678,13-02-2021 02:00,24 hrs.,RobinHoodPennyStocks,PLIN,109,0,109,-109,1,39,27,1,NASDAQ
4678,13-02-2021 02:00,24 hrs.,RobinHoodPennyStocks,PLUG,109,0,109,-109,1,39,27,1,NASDAQ
4678,13-02-2021 02:00,24 hrs.,RobinHoodPennyStocks,PSEC,53,53,0,53,3,12,17,2,NASDAQ
4678,13-02-2021 02:00,24 hrs.,RobinHoodPennyStocks,PSTV,153,0,153,-153,1,62,25,1,NASDAQ
4678,13-02-2021 02:00,24 hrs.,RobinHoodPennyStocks,QUIK,109,0,109,-109,1,39,27,1,NASDAQ
4678,13-02-2021 02:00,24 hrs.,RobinHoodPennyStocks,RAVE,109,0,109,-109,1,39,27,1,NASDAQ
4678,13-02-2021 02:00,24 hrs.,RobinHoodPennyStocks,RCMT,109,0,109,-109,1,39,27,1,NASDAQ
4678,13-02-2021 02:00,24 hrs.,RobinHoodPennyStocks,REAL,75,0,75,-75,1,25,21,1,NASDAQ
4678,13-02-2021 02:00,24 hrs.,RobinHoodPennyStocks,RIOT,116,7,109,-102,2,39,30,2,NASDAQ
4678,13-02-2021 02:00,24 hrs.,RobinHoodPennyStocks,SALM,109,0,109,-109,1,39,27,1,NASDAQ
4678,13-02-2021 02:00,24 hrs.,RobinHoodPennyStocks,SAVA,109,0,109,-109,1,39,27,1,NASDAQ
4678,13-02-2021 02:00,24 hrs.,RobinHoodPennyStocks,SEED,109,0,109,-109,1,39,27,1,NASDAQ
4678,13-02-2021 02:00,24 hrs.,RobinHoodPennyStocks,SGOC,109,0,109,-109,1,39,27,1,NASDAQ
4678,13-02-2021 02:00,24 hrs.,RobinHoodPennyStocks,SHIP,54,48,6,42,9,9,0,6,NASDAQ
4678,13-02-2021 02:00,24 hrs.,RobinHoodPennyStocks,SNDL,1402,214,1188,-974,27,498,298,25,NASDAQ
4678,13-02-2021 02:00,24 hrs.,wallstreetbets,PDYPF,7,7,0,7,1,1,1,1,OTC
4678,13-02-2021 02:00,24 hrs.,wallstreetbets,PMNXF,6,6,0,6,1,1,0,1,OTC
4678,13-02-2021 02:00,24 hrs.,wallstreetbets,TCHH,6,6,0,6,1,1,0,1,OTC
4678,13-02-2021 02:00,24 hrs.,wallstreetbets,TGLO,7,7,0,7,1,1,1,1,OTC
4678,13-02-2021 02:00,24 hrs.,wallstreetbets,TRNX,7,0,7,-7,1,1,1,1,OTC
4678,13-02-2021 02:00,24 hrs.,wallstreetbets,TRTC,21,21,0,21,3,3,3,2,OTC
4678,13-02-2021 02:00,24 hrs.,wallstreetbets,TSNP,20,14,6,8,3,3,2,3,OTC
4678,13-02-2021 02:00,24 hrs.,wallstreetbets,UBQU,7,7,0,7,1,1,1,1,OTC
4678,13-02-2021 02:00,24 hrs.,wallstreetbets,USDC,8,8,0,8,1,1,2,1,OTC
4678,13-02-2021 02:00,24 hrs.,wallstreetbets,USMJ,13,13,0,13,2,2,1,2,OTC
4678,13-02-2021 02:00,24 hrs.,wallstreetbets,UVSE,7,7,0,7,1,1,1,1,OTC
4678,13-02-2021 02:00,24 hrs.,wallstreetbets,VTLR,7,0,7,-7,1,1,1,1,OTC
4678,13-02-2021 02:00,24 hrs.,wallstreetbets,VYST,6,6,0,6,1,1,0,1,OTC
4678,13-02-2021 02:00,24 hrs.,wallstreetbets,WDDD,7,7,0,7,1,1,1,1,OTC
4678,13-02-2021 02:00,24 hrs.,wallstreetbets,WDLF,7,7,0,7,1,1,1,1,OTC
4678,13-02-2021 02:00,24 hrs.,wallstreetbets,WHEN,19,6,13,-7,3,3,1,3,OTC
4678,13-02-2021 02:00,24 hrs.,wallstreetbets,WSSE,7,7,0,7,1,1,1,1,OTC
4678,13-02-2021 02:00,24 hrs.,wallstreetbets,YRIV,5,5,0,5,1,0,1,1,OTC
4678,13-02-2021 02:00,24 hrs.,wallstreetbets,ZMRK,7,7,0,7,1,1,1,1,OTC
4678,13-02-2021 02:00,24 hrs.,wallstreetbets,ZNOG,7,7,0,7,1,1,1,1,OTC
4678,13-02-2021 02:00,24 hrs.,wallstreetbets,AGUNF,6,6,0,6,1,1,0,1,OTC
4678,13-02-2021 02:00,24 hrs.,wallstreetbets,AMYZF,23,23,0,23,3,3,5,2,OTC
4678,13-02-2021 02:00,24 hrs.,wallstreetbets,ARBKF,6,6,0,6,1,1,0,1,OTC
4678,13-02-2021 02:00,24 hrs.,wallstreetbets,ATURF,7,0,7,-7,1,1,1,1,OTC
4678,13-02-2021 02:00,24 hrs.,wallstreetbets,AZKLF,18,18,0,18,3,3,0,1,OTC
4678,13-02-2021 02:00,24 hrs.,wallstreetbets,BBKCF,6,6,0,6,1,1,0,1,OTC
4678,13-02-2021 02:00,24 hrs.,wallstreetbets,BDRBF,20,14,6,8,3,3,2,3,OTC
4678,13-02-2021 02:00,24 hrs.,wallstreetbets,CBWTF,11,0,11,-11,1,0,7,1,OTC
4678,13-02-2021 02:00,24 hrs.,wallstreetbets,CLXPF,7,7,0,7,1,1,1,1,OTC
4678,13-02-2021 02:00,24 hrs.,wallstreetbets,CRLBF,12,6,6,0,2,2,0,2,OTC
4678,13-02-2021 02:00,24 hrs.,wallstreetbets,CTTAY,32,32,0,32,1,10,8,1,OTC
4678,13-02-2021 02:00,24 hrs.,wallstreetbets,DIAAF,7,7,0,7,1,1,1,1,OTC
4678,13-02-2021 02:00,24 hrs.,wallstreetbets,EPWCF,7,7,0,7,1,1,1,1,OTC
4678,13-02-2021 02:00,24 hrs.,wallstreetbets,FDVRF,6,6,0,6,1,1,0,1,OTC
4678,13-02-2021 02:00,24 hrs.,wallstreetbets,GAYMF,6,6,0,6,1,1,0,1,OTC
4678,13-02-2021 02:00,24 hrs.,wallstreetbets,GGTTF,7,7,0,7,1,1,1,1,OTC
4678,13-02-2021 02:00,24 hrs.,wallstreetbets,GTBIF,7,7,0,7,1,1,1,1,OTC
4678,13-02-2021 02:00,24 hrs.,wallstreetbets,HITIF,7,0,7,-7,1,1,1,1,OTC
4678,13-02-2021 02:00,24 hrs.,wallstreetbets,HRSTW,11,11,0,11,2,1,1,1,OTC
4678,13-02-2021 02:00,24 hrs.,wallstreetbets,LITH,7,7,0,7,1,1,1,1,OTC
4678,13-02-2021 02:00,24 hrs.,wallstreetbets,LOTE,7,0,7,-7,1,1,1,1,OTC
4678,13-02-2021 02:00,24 hrs.,wallstreetbets,LSCG,7,0,7,-7,1,1,1,1,OTC
4678,13-02-2021 02:00,24 hrs.,wallstreetbets,LTNC,14,14,0,14,2,2,2,2,OTC
4678,13-02-2021 02:00,24 hrs.,wallstreetbets,LTUM,12,6,6,0,2,2,0,2,OTC
4678,13-02-2021 02:00,24 hrs.,wallstreetbets,MAXD,22,22,0,22,3,3,4,3,OTC
4678,13-02-2021 02:00,24 hrs.,wallstreetbets,MCOA,20,20,0,20,3,3,2,3,OTC
4678,13-02-2021 02:00,24 hrs.,wallstreetbets,MEDH,7,7,0,7,1,1,1,1,OTC
4678,13-02-2021 02:00,24 hrs.,wallstreetbets,MGNT,7,7,0,7,1,1,1,1,OTC
4678,13-02-2021 02:00,24 hrs.,wallstreetbets,MGTI,7,7,0,7,1,1,1,1,OTC
4678,13-02-2021 02:00,24 hrs.,wallstreetbets,MINE,54,48,6,42,8,8,6,5,OTC
4678,13-02-2021 02:00,24 hrs.,wallstreetbets,MJNA,41,27,14,13,6,6,5,6,OTC
4678,13-02-2021 02:00,24 hrs.,wallstreetbets,MKTY,21,21,0,21,3,3,3,2,OTC
4678,13-02-2021 02:00,24 hrs.,wallstreetbets,MMEX,28,0,28,-28,4,4,4,2,OTC
4678,13-02-2021 02:00,24 hrs.,wallstreetbets,MNGG,6,6,0,6,1,1,0,1,OTC
4678,13-02-2021 02:00,24 hrs.,wallstreetbets,MOJO,13,13,0,13,2,2,1,1,OTC
4678,13-02-2021 02:00,24 hrs.,wallstreetbets,MOST,34,34,0,34,4,7,4,4,OTC
4678,13-02-2021 02:00,24 hrs.,wallstreetbets,MTVX,6,0,6,-6,1,1,0,1,OTC
4678,13-02-2021 02:00,24 hrs.,wallstreetbets,NBVG,6,6,0,6,1,1,0,1,OTC
4678,13-02-2021 02:00,24 hrs.,wallstreetbets,NEOM,28,28,0,28,4,4,4,2,OTC
4678,13-02-2021 02:00,24 hrs.,wallstreetbets,NOVC,34,28,6,22,5,5,4,3,OTC
4678,13-02-2021 02:00,24 hrs.,wallstreetbets,NPHC,7,7,0,7,1,1,1,1,OTC
4678,13-02-2021 02:00,24 hrs.,wallstreetbets,NWPN,6,6,0,6,1,1,0,1,OTC
4678,13-02-2021 02:00,24 hrs.,wallstreetbets,ONPH,6,6,0,6,1,1,0,1,OTC
4678,13-02-2021 02:00,24 hrs.,wallstreetbets,OTTV,14,14,0,14,2,2,2,1,OTC
4678,13-02-2021 02:00,24 hrs.,wallstreetbets,DNN,177,131,46,85,26,26,21,22,AMEX
4678,13-02-2021 02:00,24 hrs.,wallstreetbets,DPW,14,14,0,14,2,2,2,2,AMEX
4678,13-02-2021 02:00,24 hrs.,wallstreetbets,FEN,7,0,7,-7,1,1,1,1,AMEX
4678,13-02-2021 02:00,24 hrs.,wallstreetbets,GDP,166,166,0,166,2,45,68,2,AMEX
4678,13-02-2021 02:00,24 hrs.,wallstreetbets,GLU,7,7,0,7,1,1,1,1,AMEX
4678,13-02-2021 02:00,24 hrs.,wallstreetbets,GSV,14,0,14,-14,2,2,2,2,AMEX
4678,13-02-2021 02:00,24 hrs.,wallstreetbets,GTE,87,67,20,47,13,13,9,10,AMEX
4678,13-02-2021 02:00,24 hrs.,wallstreetbets,IGC,7,0,7,-7,1,1,1,1,AMEX
4678,13-02-2021 02:00,24 hrs.,wallstreetbets,ITP,7,7,0,7,1,1,1,1,AMEX
4678,13-02-2021 02:00,24 hrs.,wallstreetbets,LSF,7,0,7,-7,1,1,1,1,AMEX
4678,13-02-2021 02:00,24 hrs.,wallstreetbets,MSN,7,7,0,7,1,1,1,1,AMEX
4678,13-02-2021 02:00,24 hrs.,wallstreetbets,MXC,14,0,14,-14,2,2,2,2,AMEX
4678,13-02-2021 02:00,24 hrs.,wallstreetbets,MYO,7,7,0,7,1,1,1,1,AMEX
4678,13-02-2021 02:00,24 hrs.,wallstreetbets,NAK,77,51,26,25,12,12,5,10,AMEX
4678,13-02-2021 02:00,24 hrs.,wallstreetbets,PTN,7,7,0,7,1,1,1,1,AMEX
4678,13-02-2021 02:00,24 hrs.,wallstreetbets,REI,7,7,0,7,1,1,1,1,AMEX
4678,13-02-2021 02:00,24 hrs.,wallstreetbets,SYN,14,14,0,14,2,2,2,1,AMEX
4678,13-02-2021 02:00,24 hrs.,wallstreetbets,TGB,6,6,0,6,1,1,0,1,AMEX
4678,13-02-2021 02:00,24 hrs.,wallstreetbets,TMQ,8,0,8,-8,1,1,2,1,AMEX
4678,13-02-2021 02:00,24 hrs.,wallstreetbets,TRX,76,35,41,-6,11,11,10,7,AMEX
4678,13-02-2021 02:00,24 hrs.,wallstreetbets,UUU,6,6,0,6,1,1,0,1,AMEX
4678,13-02-2021 02:00,24 hrs.,wallstreetbets,ZOM,263,174,89,85,27,53,49,26,AMEX
4678,13-02-2021 02:00,24 hrs.,wallstreetbets,AMPE,41,34,7,27,6,6,5,4,AMEX
4678,13-02-2021 02:00,24 hrs.,wallstreetbets,CRMD,7,7,0,7,1,1,1,1,AMEX
4678,13-02-2021 02:00,24 hrs.,wallstreetbets,EMAN,14,7,7,0,2,2,2,2,AMEX
4678,13-02-2021 02:00,24 hrs.,wallstreetbets,GOED,13,13,0,13,2,2,1,2,AMEX
4678,13-02-2021 02:00,24 hrs.,wallstreetbets,GSAT,75,26,49,-23,11,11,9,7,AMEX
4678,13-02-2021 02:00,24 hrs.,wallstreetbets,HUSA,7,0,7,-7,1,1,1,1,AMEX
4678,13-02-2021 02:00,24 hrs.,wallstreetbets,LODE,13,13,0,13,2,2,1,2,AMEX
4678,13-02-2021 02:00,24 hrs.,wallstreetbets,OGEN,27,20,7,13,4,4,3,4,AMEX
4678,13-02-2021 02:00,24 hrs.,wallstreetbets,RLGT,21,0,21,-21,3,3,3,1,AMEX
4678,13-02-2021 02:00,24 hrs.,wallstreetbets,SENS,307,148,159,-11,17,72,95,13,AMEX
4678,13-02-2021 02:00,24 hrs.,wallstreetbets,TMBR,54,34,20,14,8,8,6,4,AMEX
4678,13-02-2021 02:00,24 hrs.,wallstreetbets,TRXC,33,13,20,-7,5,5,3,4,AMEX
4678,13-02-2021 02:00,24 hrs.,wallstreetbets,UAVS,28,21,7,14,4,4,4,3,AMEX
4678,13-02-2021 02:00,24 hrs.,wallstreetbets,UUUU,21,14,7,7,3,3,3,2,AMEX
4678,13-02-2021 02:00,24 hrs.,wallstreetbets,XXII,7,7,0,7,1,1,1,1,AMEX
4678,13-02-2021 02:00,24 hrs.,wallstreetbets,YCBD,21,14,7,7,3,3,3,3,AMEX
4678,13-02-2021 02:00,24 hrs.,wallstreetbets,ABT,13,6,7,-1,2,2,1,2,NYSE
4678,13-02-2021 02:00,24 hrs.,wallstreetbets,ACB,166,132,34,98,24,24,22,20,NYSE
4678,13-02-2021 02:00,24 hrs.,wallstreetbets,ACI,7,7,0,7,1,1,1,1,NYSE
4678,13-02-2021 02:00,24 hrs.,wallstreetbets,AEM,8,8,0,8,1,1,2,1,NYSE
4678,13-02-2021 02:00,24 hrs.,wallstreetbets,AFC,7,7,0,7,1,1,1,1,NYSE
4678,13-02-2021 02:00,24 hrs.,wallstreetbets,AIR,13,6,7,-1,2,2,1,2,NYSE
4678,13-02-2021 02:00,24 hrs.,wallstreetbets,HUTMF,13,6,7,-1,2,2,1,2,OTC
4678,13-02-2021 02:00,24 hrs.,wallstreetbets,HVBTF,22,15,7,8,3,3,4,3,OTC
4678,13-02-2021 02:00,24 hrs.,wallstreetbets,IGCIW,49,49,0,49,7,7,7,2,OTC
4678,13-02-2021 02:00,24 hrs.,wallstreetbets,ISCNF,14,14,0,14,2,2,2,2,OTC
4678,13-02-2021 02:00,24 hrs.,wallstreetbets,ITHUF,7,0,7,-7,1,1,1,1,OTC
4678,13-02-2021 02:00,24 hrs.,wallstreetbets,KBEVF,7,7,0,7,1,1,1,1,OTC
4678,13-02-2021 02:00,24 hrs.,wallstreetbets,LHSIF,7,7,0,7,1,1,1,1,OTC
4678,13-02-2021 02:00,24 hrs.,wallstreetbets,LKNCY,224,218,6,212,3,13,186,3,OTC
4678,13-02-2021 02:00,24 hrs.,wallstreetbets,LLKKF,6,0,6,-6,1,1,0,1,OTC
4678,13-02-2021 02:00,24 hrs.,wallstreetbets,LMLLF,6,0,6,-6,1,1,0,1,OTC
4678,13-02-2021 02:00,24 hrs.,wallstreetbets,LTMCF,6,0,6,-6,1,1,0,1,OTC
4678,13-02-2021 02:00,24 hrs.,wallstreetbets,LXXGF,8,0,8,-8,1,1,2,1,OTC
4678,13-02-2021 02:00,24 hrs.,wallstreetbets,MEDIF,6,0,6,-6,1,1,0,1,OTC
4678,13-02-2021 02:00,24 hrs.,wallstreetbets,MMEDF,3051,63,2988,-2925,5,1269,493,4,OTC
4678,13-02-2021 02:00,24 hrs.,wallstreetbets,MOTNF,7,7,0,7,1,1,1,1,OTC
4678,13-02-2021 02:00,24 hrs.,wallstreetbets,NTDOY,15,15,0,15,2,2,3,2,OTC
4678,13-02-2021 02:00,24 hrs.,wallstreetbets,NTSFF,6,0,6,-6,1,1,0,1,OTC
4678,13-02-2021 02:00,24 hrs.,wallstreetbets,NXGWF,13,13,0,13,2,2,1,1,OTC
4678,13-02-2021 02:00,24 hrs.,wallstreetbets,NXTTF,14,14,0,14,2,2,2,1,OTC
4678,13-02-2021 02:00,24 hrs.,wallstreetbets,PCLOF,13,13,0,13,2,2,1,1,OTC
4678,13-02-2021 02:00,24 hrs.,wallstreetbets,DAO,12,12,0,12,2,2,0,1,NYSE
4678,13-02-2021 02:00,24 hrs.,wallstreetbets,DHT,7,7,0,7,1,1,1,1,NYSE
4678,13-02-2021 02:00,24 hrs.,wallstreetbets,DIS,453,20,433,-413,6,176,77,6,NYSE
4678,13-02-2021 02:00,24 hrs.,wallstreetbets,DOC,7,0,7,-7,1,1,1,1,NYSE
4678,13-02-2021 02:00,24 hrs.,wallstreetbets,DTE,150,150,0,150,1,45,56,1,NYSE
4678,13-02-2021 02:00,24 hrs.,wallstreetbets,DVN,7,7,0,7,1,1,1,1,NYSE
4678,13-02-2021 02:00,24 hrs.,wallstreetbets,EAT,21,14,7,7,3,3,3,3,NYSE
4678,13-02-2021 02:00,24 hrs.,wallstreetbets,EPD,47,47,0,47,2,12,15,1,NYSE
4678,13-02-2021 02:00,24 hrs.,wallstreetbets,ETN,21,21,0,21,3,3,3,3,NYSE
4678,13-02-2021 02:00,24 hrs.,wallstreetbets,EXP,13,13,0,13,2,2,1,2,NYSE
4678,13-02-2021 02:00,24 hrs.,wallstreetbets,FCX,34,0,34,-34,5,5,4,2,NYSE
4678,13-02-2021 02:00,24 hrs.,wallstreetbets,FDX,7,7,0,7,1,1,1,1,NYSE
4678,13-02-2021 02:00,24 hrs.,wallstreetbets,FLT,7,7,0,7,1,1,1,1,NYSE
4678,13-02-2021 02:00,24 hrs.,wallstreetbets,FMC,13,13,0,13,2,2,1,1,NYSE
4678,13-02-2021 02:00,24 hrs.,wallstreetbets,FOF,6,0,6,-6,1,1,0,1,NYSE
4678,13-02-2021 02:00,24 hrs.,wallstreetbets,FRO,19,13,6,7,3,3,1,2,NYSE
4678,13-02-2021 02:00,24 hrs.,wallstreetbets,FSD,14,14,0,14,2,2,2,2,NYSE
4678,13-02-2021 02:00,24 hrs.,wallstreetbets,FSR,261,241,20,221,37,43,27,17,NYSE
4678,13-02-2021 02:00,24 hrs.,wallstreetbets,FTI,20,20,0,20,3,3,2,1,NYSE
4678,13-02-2021 02:00,24 hrs.,wallstreetbets,GAM,7,7,0,7,1,1,1,1,NYSE
4678,13-02-2021 02:00,24 hrs.,wallstreetbets,GEO,42,28,14,14,6,6,6,2,NYSE
4678,13-02-2021 02:00,24 hrs.,wallstreetbets,GLW,14,7,7,0,2,2,2,2,NYSE
4678,13-02-2021 02:00,24 hrs.,wallstreetbets,GME,140778,124172,16606,107566,458,63975,10996,348,NYSE
4678,13-02-2021 02:00,24 hrs.,wallstreetbets,HMC,32,32,0,32,1,10,8,1,NYSE
4678,13-02-2021 02:00,24 hrs.,wallstreetbets,HMI,7,7,0,7,1,1,1,1,NYSE
4678,13-02-2021 02:00,24 hrs.,wallstreetbets,HON,6,0,6,-6,1,1,0,1,NYSE
4678,13-02-2021 02:00,24 hrs.,wallstreetbets,IAG,14,7,7,0,2,2,2,2,NYSE
4678,13-02-2021 02:00,24 hrs.,wallstreetbets,IBM,5702,5702,0,5702,5,2626,430,5,NYSE
4678,13-02-2021 02:00,24 hrs.,wallstreetbets,ICE,78,78,0,78,1,19,36,1,NYSE
4678,13-02-2021 02:00,24 hrs.,wallstreetbets,IGT,7,7,0,7,1,1,1,1,NYSE
4678,13-02-2021 02:00,24 hrs.,wallstreetbets,IRS,6,6,0,6,1,1,0,1,NYSE
4678,13-02-2021 02:00,24 hrs.,wallstreetbets,IVR,55,49,6,43,8,7,9,6,NYSE
4678,13-02-2021 02:00,24 hrs.,wallstreetbets,JNJ,13,7,6,1,2,2,1,2,NYSE
4678,13-02-2021 02:00,24 hrs.,wallstreetbets,JWS,12,12,0,12,2,2,0,1,NYSE
4678,13-02-2021 02:00,24 hrs.,wallstreetbets,KMI,47,47,0,47,2,12,15,1,NYSE
4678,13-02-2021 02:00,24 hrs.,wallstreetbets,KMX,123,0,123,-123,1,38,43,1,NYSE
4678,13-02-2021 02:00,24 hrs.,wallstreetbets,KOS,12,12,0,12,2,2,0,1,NYSE
4678,13-02-2021 02:00,24 hrs.,wallstreetbets,LAC,19,0,19,-19,3,3,1,3,NYSE
4678,13-02-2021 02:00,24 hrs.,wallstreetbets,LEE,6,6,0,6,1,1,0,1,NYSE
4678,13-02-2021 02:00,24 hrs.,wallstreetbets,LEN,6,0,6,-6,1,1,0,1,NYSE
4678,13-02-2021 02:00,24 hrs.,wallstreetbets,LOW,22,22,0,22,3,3,4,2,NYSE
4678,13-02-2021 02:00,24 hrs.,wallstreetbets,AIV,6,6,0,6,1,1,0,1,NYSE
4678,13-02-2021 02:00,24 hrs.,wallstreetbets,AMC,10357,1531,8826,-7295,208,4114,1297,172,NYSE
4678,13-02-2021 02:00,24 hrs.,wallstreetbets,AMP,29,29,0,29,4,4,5,4,NYSE
4678,13-02-2021 02:00,24 hrs.,wallstreetbets,RAZFF,7,7,0,7,1,1,1,1,OTC
4678,13-02-2021 02:00,24 hrs.,wallstreetbets,RLLCF,72,72,0,72,10,10,12,10,OTC
4678,13-02-2021 02:00,24 hrs.,wallstreetbets,RYCEY,488,64,424,-360,16,125,174,14,OTC
4678,13-02-2021 02:00,24 hrs.,wallstreetbets,SBSAA,7,7,0,7,1,1,1,1,OTC
4678,13-02-2021 02:00,24 hrs.,wallstreetbets,SHRMF,6,6,0,6,1,1,0,1,OTC
4678,13-02-2021 02:00,24 hrs.,wallstreetbets,SPRWF,42,28,14,14,6,6,6,5,OTC
4678,13-02-2021 02:00,24 hrs.,wallstreetbets,TBUIF,13,13,0,13,2,2,1,1,OTC
4678,13-02-2021 02:00,24 hrs.,wallstreetbets,TCNNF,5205,5176,29,5147,5,2430,325,2,OTC
4678,13-02-2021 02:00,24 hrs.,wallstreetbets,TGODF,7,7,0,7,1,1,1,1,OTC
4678,13-02-2021 02:00,24 hrs.,wallstreetbets,TPPRF,14,0,14,-14,2,2,2,1,OTC
4678,13-02-2021 02:00,24 hrs.,wallstreetbets,TSCRF,50,50,0,50,3,4,30,2,OTC
4678,13-02-2021 02:00,24 hrs.,wallstreetbets,TXLZF,7,7,0,7,1,1,1,1,OTC
4678,13-02-2021 02:00,24 hrs.,wallstreetbets,VALPQ,8,8,0,8,1,2,0,1,OTC
4678,13-02-2021 02:00,24 hrs.,wallstreetbets,VVCIF,13,6,7,-1,2,2,1,2,OTC
4678,13-02-2021 02:00,24 hrs.,wallstreetbets,WDDMF,7,0,7,-7,1,1,1,1,OTC
4678,13-02-2021 02:00,24 hrs.,wallstreetbets,WPMLF,8,0,8,-8,1,1,2,1,OTC
4678,13-02-2021 02:00,24 hrs.,wallstreetbets,ZBISF,7,7,0,7,1,1,1,1,OTC
4678,13-02-2021 02:00,24 hrs.,wallstreetbets,AAU,14,14,0,14,2,2,2,2,AMEX
4678,13-02-2021 02:00,24 hrs.,wallstreetbets,BTN,15,15,0,15,2,2,3,1,AMEX
4678,13-02-2021 02:00,24 hrs.,wallstreetbets,DIT,6,6,0,6,1,1,0,1,AMEX
4678,13-02-2021 02:00,24 hrs.,wallstreetbets,RTP,6,6,0,6,1,1,0,1,NYSE
4678,13-02-2021 02:00,24 hrs.,wallstreetbets,SBE,12,6,6,0,2,2,0,2,NYSE
4678,13-02-2021 02:00,24 hrs.,wallstreetbets,SKM,30,0,30,-30,1,0,26,1,NYSE
4678,13-02-2021 02:00,24 hrs.,wallstreetbets,SKT,7,0,7,-7,1,1,1,1,NYSE
4678,13-02-2021 02:00,24 hrs.,wallstreetbets,SKY,6,6,0,6,1,1,0,1,NYSE
4678,13-02-2021 02:00,24 hrs.,wallstreetbets,SNE,14,14,0,14,2,2,2,1,NYSE
4678,13-02-2021 02:00,24 hrs.,wallstreetbets,SNX,12,6,6,0,2,2,0,2,NYSE
4678,13-02-2021 02:00,24 hrs.,wallstreetbets,SOL,14,0,14,-14,2,2,2,2,NYSE
4678,13-02-2021 02:00,24 hrs.,wallstreetbets,SOS,225,148,77,71,33,32,29,26,NYSE
4678,13-02-2021 02:00,24 hrs.,wallstreetbets,SPH,13,0,13,-13,2,2,1,2,NYSE
4678,13-02-2021 02:00,24 hrs.,wallstreetbets,STM,7,7,0,7,1,1,1,1,NYSE
4678,13-02-2021 02:00,24 hrs.,wallstreetbets,SUN,6,0,6,-6,1,1,0,1,NYSE
4678,13-02-2021 02:00,24 hrs.,wallstreetbets,SUP,7,7,0,7,1,1,1,1,NYSE
4678,13-02-2021 02:00,24 hrs.,wallstreetbets,TAK,14,7,7,0,2,2,2,2,NYSE
4678,13-02-2021 02:00,24 hrs.,wallstreetbets,TAP,13,13,0,13,2,2,1,2,NYSE
4678,13-02-2021 02:00,24 hrs.,wallstreetbets,TBC,7,7,0,7,1,1,1,1,NYSE
4678,13-02-2021 02:00,24 hrs.,wallstreetbets,TDA,6,0,6,-6,1,1,0,1,NYSE
4678,13-02-2021 02:00,24 hrs.,wallstreetbets,TDC,6,6,0,6,1,1,0,1,NYSE
4678,13-02-2021 02:00,24 hrs.,wallstreetbets,TFC,7,7,0,7,1,1,1,1,NYSE
4678,13-02-2021 02:00,24 hrs.,wallstreetbets,THC,7,7,0,7,1,1,1,1,NYSE
4678,13-02-2021 02:00,24 hrs.,wallstreetbets,TRQ,6,0,6,-6,1,1,0,1,NYSE
4678,13-02-2021 02:00,24 hrs.,wallstreetbets,TRU,7,7,0,7,1,1,1,1,NYSE
4678,13-02-2021 02:00,24 hrs.,wallstreetbets,MAC,9,9,0,9,1,1,3,1,NYSE
4678,13-02-2021 02:00,24 hrs.,wallstreetbets,MBI,14,14,0,14,2,2,2,2,NYSE
4678,13-02-2021 02:00,24 hrs.,wallstreetbets,MCO,419,0,419,-419,1,171,73,1,NYSE
4678,13-02-2021 02:00,24 hrs.,wallstreetbets,MFA,7,7,0,7,1,1,1,1,NYSE
4678,13-02-2021 02:00,24 hrs.,wallstreetbets,MIN,7,7,0,7,1,1,1,1,NYSE
4678,13-02-2021 02:00,24 hrs.,wallstreetbets,MRO,431,6,425,-419,3,173,73,3,NYSE
4678,13-02-2021 02:00,24 hrs.,wallstreetbets,MSM,7,0,7,-7,1,1,1,1,NYSE
4678,13-02-2021 02:00,24 hrs.,wallstreetbets,MTL,6,0,6,-6,1,1,0,1,NYSE
4678,13-02-2021 02:00,24 hrs.,wallstreetbets,NAT,20,20,0,20,3,2,4,3,NYSE
4678,13-02-2021 02:00,24 hrs.,wallstreetbets,NET,119,119,0,119,2,40,31,2,NYSE
4678,13-02-2021 02:00,24 hrs.,wallstreetbets,NGA,12,6,6,0,2,2,0,2,NYSE
4678,13-02-2021 02:00,24 hrs.,wallstreetbets,NIO,1107,664,443,221,17,351,337,15,NYSE
4678,13-02-2021 02:00,24 hrs.,wallstreetbets,NLY,7,7,0,7,1,1,1,1,NYSE
4678,13-02-2021 02:00,24 hrs.,wallstreetbets,NOK,2707,2639,68,2571,29,1089,413,26,NYSE
4678,13-02-2021 02:00,24 hrs.,wallstreetbets,NOV,6,6,0,6,1,1,0,1,NYSE
4678,13-02-2021 02:00,24 hrs.,wallstreetbets,NRG,35,35,0,35,5,5,5,1,NYSE
4678,13-02-2021 02:00,24 hrs.,wallstreetbets,NUS,7,7,0,7,1,1,1,1,NYSE
4678,13-02-2021 02:00,24 hrs.,wallstreetbets,NVO,64,58,6,52,2,16,24,2,NYSE
4678,13-02-2021 02:00,24 hrs.,wallstreetbets,NYC,21,7,14,-7,3,3,3,3,NYSE
4678,13-02-2021 02:00,24 hrs.,wallstreetbets,ASX,7,0,7,-7,1,1,1,1,NYSE
4678,13-02-2021 02:00,24 hrs.,wallstreetbets,ATH,151,28,123,-95,4,44,47,4,NYSE
4678,13-02-2021 02:00,24 hrs.,wallstreetbets,AUY,122,115,7,108,9,21,44,4,NYSE
4678,13-02-2021 02:00,24 hrs.,wallstreetbets,AXP,5184,5176,8,5168,2,2427,322,2,NYSE
4678,13-02-2021 02:00,24 hrs.,wallstreetbets,BBW,6,6,0,6,1,1,0,1,NYSE
4678,13-02-2021 02:00,24 hrs.,wallstreetbets,BBY,14,0,14,-14,2,2,2,1,NYSE
4678,13-02-2021 02:00,24 hrs.,wallstreetbets,BCH,11,11,0,11,2,1,1,2,NYSE
4678,13-02-2021 02:00,24 hrs.,wallstreetbets,BGS,8,8,0,8,1,1,2,1,NYSE
4678,13-02-2021 02:00,24 hrs.,wallstreetbets,BHC,426,0,426,-426,2,172,74,2,NYSE
4678,13-02-2021 02:00,24 hrs.,wallstreetbets,BTT,46,33,13,20,7,7,4,7,NYSE
4678,13-02-2021 02:00,24 hrs.,wallstreetbets,BTU,14,14,0,14,2,2,2,1,NYSE
4678,13-02-2021 02:00,24 hrs.,wallstreetbets,CAT,14,14,0,14,2,2,2,2,NYSE
4678,13-02-2021 02:00,24 hrs.,wallstreetbets,CBD,28,0,28,-28,4,4,4,3,NYSE
4678,13-02-2021 02:00,24 hrs.,wallstreetbets,CCL,14,14,0,14,2,2,2,1,NYSE
4678,13-02-2021 02:00,24 hrs.,wallstreetbets,CHS,8,0,8,-8,1,1,2,1,NYSE
4678,13-02-2021 02:00,24 hrs.,wallstreetbets,CMA,6,6,0,6,1,1,0,1,NYSE
4678,13-02-2021 02:00,24 hrs.,wallstreetbets,CMC,15,15,0,15,1,1,9,1,NYSE
4678,13-02-2021 02:00,24 hrs.,wallstreetbets,CPE,7,7,0,7,1,1,1,1,NYSE
4678,13-02-2021 02:00,24 hrs.,wallstreetbets,CPG,7,7,0,7,1,1,1,1,NYSE
4678,13-02-2021 02:00,24 hrs.,wallstreetbets,CSV,71,71,0,71,1,17,33,1,NYSE
4678,13-02-2021 02:00,24 hrs.,wallstreetbets,CVS,14,14,0,14,2,2,2,2,NYSE
4678,13-02-2021 02:00,24 hrs.,wallstreetbets,DAC,20,20,0,20,3,3,2,2,NYSE
4678,13-02-2021 02:00,24 hrs.,wallstreetbets,DAL,13,13,0,13,2,2,1,2,NYSE
4678,13-02-2021 02:00,24 hrs.,wallstreetbets,TSM,500,488,12,476,4,126,232,3,NYSE
4678,13-02-2021 02:00,24 hrs.,wallstreetbets,TSN,5184,5176,8,5168,2,2427,322,2,NYSE
4678,13-02-2021 02:00,24 hrs.,wallstreetbets,TTM,6,6,0,6,1,1,0,1,NYSE
4678,13-02-2021 02:00,24 hrs.,wallstreetbets,TWO,7,7,0,7,1,1,1,1,NYSE
4678,13-02-2021 02:00,24 hrs.,wallstreetbets,UBS,27,7,20,-13,4,4,3,3,NYSE
4678,13-02-2021 02:00,24 hrs.,wallstreetbets,UNP,7,7,0,7,1,1,1,1,NYSE
4678,13-02-2021 02:00,24 hrs.,wallstreetbets,UTZ,928,928,0,928,1,361,202,1,NYSE
4678,13-02-2021 02:00,24 hrs.,wallstreetbets,VET,7,0,7,-7,1,1,1,1,NYSE
4678,13-02-2021 02:00,24 hrs.,wallstreetbets,VGR,7,7,0,7,1,1,1,1,NYSE
4678,13-02-2021 02:00,24 hrs.,wallstreetbets,VHC,7,7,0,7,1,1,1,1,NYSE
4678,13-02-2021 02:00,24 hrs.,wallstreetbets,VRT,152,152,0,152,2,54,36,1,NYSE
4678,13-02-2021 02:00,24 hrs.,wallstreetbets,VST,35,35,0,35,5,5,5,1,NYSE
4678,13-02-2021 02:00,24 hrs.,wallstreetbets,WFC,7,7,0,7,1,1,1,1,NYSE
4678,13-02-2021 02:00,24 hrs.,wallstreetbets,WLL,6,0,6,-6,1,1,0,1,NYSE
4678,13-02-2021 02:00,24 hrs.,wallstreetbets,WMC,8,8,0,8,1,1,2,1,NYSE
4678,13-02-2021 02:00,24 hrs.,wallstreetbets,WMT,20,13,7,6,3,3,2,3,NYSE
4678,13-02-2021 02:00,24 hrs.,wallstreetbets,WWE,7,0,7,-7,1,1,1,1,NYSE
4678,13-02-2021 02:00,24 hrs.,wallstreetbets,ABEV,7,7,0,7,1,1,1,1,NYSE
4678,13-02-2021 02:00,24 hrs.,wallstreetbets,ACIC,27,13,14,-1,4,4,3,4,NYSE
4678,13-02-2021 02:00,24 hrs.,wallstreetbets,ALLY,7,7,0,7,1,1,1,1,NYSE
4678,13-02-2021 02:00,24 hrs.,wallstreetbets,APRN,6,6,0,6,1,1,0,1,NYSE
4678,13-02-2021 02:00,24 hrs.,wallstreetbets,ARGO,6,6,0,6,1,1,0,1,NYSE
4678,13-02-2021 02:00,24 hrs.,wallstreetbets,ATUS,14,0,14,-14,2,2,2,1,NYSE
4678,13-02-2021 02:00,24 hrs.,wallstreetbets,BABA,170,157,13,144,4,48,58,4,NYSE
4678,13-02-2021 02:00,24 hrs.,wallstreetbets,BNED,6,0,6,-6,1,1,0,1,NYSE
4678,13-02-2021 02:00,24 hrs.,wallstreetbets,CARS,6,6,0,6,1,1,0,1,NYSE
4678,13-02-2021 02:00,24 hrs.,wallstreetbets,CCIV,247,163,84,79,36,36,31,30,NYSE
4678,13-02-2021 02:00,24 hrs.,wallstreetbets,CHWY,130,7,123,-116,2,39,44,2,NYSE
4678,13-02-2021 02:00,24 hrs.,wallstreetbets,CLDR,173,6,167,-161,2,54,57,2,NYSE
4678,13-02-2021 02:00,24 hrs.,wallstreetbets,CLII,7,7,0,7,1,1,1,1,NYSE
4678,13-02-2021 02:00,24 hrs.,wallstreetbets,CVNA,123,0,123,-123,1,38,43,1,NYSE
4678,13-02-2021 02:00,24 hrs.,wallstreetbets,DASH,32,6,26,-20,4,3,10,3,NYSE
4678,13-02-2021 02:00,24 hrs.,wallstreetbets,EXPR,15,15,0,15,2,2,3,2,NYSE
4678,13-02-2021 02:00,24 hrs.,wallstreetbets,FEDU,7,7,0,7,1,1,1,1,NYSE
4678,13-02-2021 02:00,24 hrs.,wallstreetbets,FENG,6,0,6,-6,1,1,0,1,NYSE
4678,13-02-2021 02:00,24 hrs.,wallstreetbets,FLOW,7,7,0,7,1,1,1,1,NYSE
4678,13-02-2021 02:00,24 hrs.,wallstreetbets,FSLY,14,14,0,14,2,2,2,2,NYSE
4678,13-02-2021 02:00,24 hrs.,wallstreetbets,FUBO,949,949,0,949,4,364,205,4,NYSE
4678,13-02-2021 02:00,24 hrs.,wallstreetbets,FUSE,30,0,30,-30,4,4,6,2,NYSE
4678,13-02-2021 02:00,24 hrs.,wallstreetbets,FVRR,7,7,0,7,1,1,1,1,NYSE
4678,13-02-2021 02:00,24 hrs.,wallstreetbets,GPRK,7,0,7,-7,1,1,1,1,NYSE
4678,13-02-2021 02:00,24 hrs.,wallstreetbets,HEXO,13,13,0,13,2,2,1,2,NYSE
4678,13-02-2021 02:00,24 hrs.,wallstreetbets,HUBS,13,13,0,13,2,2,1,2,NYSE
4678,13-02-2021 02:00,24 hrs.,wallstreetbets,HUYA,35,7,28,-21,5,5,5,3,NYSE
4678,13-02-2021 02:00,24 hrs.,wallstreetbets,HYLN,553,498,55,443,19,148,181,16,NYSE
4678,13-02-2021 02:00,24 hrs.,wallstreetbets,IIPR,20,20,0,20,3,3,2,2,NYSE
4678,13-02-2021 02:00,24 hrs.,wallstreetbets,IPOE,13,7,6,1,2,2,1,2,NYSE
4678,13-02-2021 02:00,24 hrs.,wallstreetbets,OGE,7,0,7,-7,1,1,1,1,NYSE
4678,13-02-2021 02:00,24 hrs.,wallstreetbets,OPP,7,0,7,-7,1,1,1,1,NYSE
4678,13-02-2021 02:00,24 hrs.,wallstreetbets,OSK,142,142,0,142,1,40,58,1,NYSE
4678,13-02-2021 02:00,24 hrs.,wallstreetbets,OVV,5,5,0,5,1,0,1,1,NYSE
4678,13-02-2021 02:00,24 hrs.,wallstreetbets,OXY,6,0,6,-6,1,1,0,1,NYSE
4678,13-02-2021 02:00,24 hrs.,wallstreetbets,PCG,152,0,152,-152,1,43,62,1,NYSE
4678,13-02-2021 02:00,24 hrs.,wallstreetbets,PDT,13,0,13,-13,2,2,1,2,NYSE
4678,13-02-2021 02:00,24 hrs.,wallstreetbets,PFE,13,13,0,13,2,2,1,2,NYSE
4678,13-02-2021 02:00,24 hrs.,wallstreetbets,PMO,7,0,7,-7,1,1,1,1,NYSE
4678,13-02-2021 02:00,24 hrs.,wallstreetbets,PSA,916,894,22,872,9,303,274,6,NYSE
4678,13-02-2021 02:00,24 hrs.,wallstreetbets,PSX,7740,0,7740,-7740,1,3343,1050,1,NYSE
4678,13-02-2021 02:00,24 hrs.,wallstreetbets,PVL,13,13,0,13,2,2,1,1,NYSE
4678,13-02-2021 02:00,24 hrs.,wallstreetbets,RDY,13,7,6,1,2,2,1,2,NYSE
4678,13-02-2021 02:00,24 hrs.,wallstreetbets,RKT,4699,4651,48,4603,17,2148,335,13,NYSE
4678,13-02-2021 02:00,24 hrs.,wallstreetbets,RMO,76,27,49,-22,11,11,10,7,NYSE
4678,13-02-2021 02:00,24 hrs.,wallstreetbets,RPT,7,7,0,7,1,1,1,1,NYSE
4678,13-02-2021 02:00,24 hrs.,wallstreetbets,RSI,12,0,12,-12,2,2,0,2,NYSE
4665,13-02-2021 00:00,24 hrs.,pennystocks,EDIT,201,0,201,-201,1,90,17,1,NASDAQ
4665,13-02-2021 00:00,24 hrs.,pennystocks,ENPH,97,0,97,-97,1,19,55,1,NASDAQ
4665,13-02-2021 00:00,24 hrs.,pennystocks,ENTX,22,22,0,22,1,7,4,1,NASDAQ
4665,13-02-2021 00:00,24 hrs.,pennystocks,ENVB,6,6,0,6,1,1,0,1,NASDAQ
4665,13-02-2021 00:00,24 hrs.,pennystocks,EPSN,12,12,0,12,2,2,0,2,NASDAQ
4665,13-02-2021 00:00,24 hrs.,pennystocks,EVFM,6,0,6,-6,1,1,0,1,NASDAQ
4665,13-02-2021 00:00,24 hrs.,pennystocks,FAMI,13,13,0,13,2,2,1,2,NASDAQ
4665,13-02-2021 00:00,24 hrs.,pennystocks,FAST,6,6,0,6,1,1,0,1,NASDAQ
4665,13-02-2021 00:00,24 hrs.,pennystocks,FATE,19,19,0,19,1,7,1,1,NASDAQ
4665,13-02-2021 00:00,24 hrs.,pennystocks,FCEL,97,0,97,-97,1,19,55,1,NASDAQ
4665,13-02-2021 00:00,24 hrs.,pennystocks,GAIN,7,7,0,7,1,1,1,1,NASDAQ
4665,13-02-2021 00:00,24 hrs.,pennystocks,GALT,7,7,0,7,1,1,1,1,NASDAQ
4665,13-02-2021 00:00,24 hrs.,pennystocks,GEVO,69,6,63,-57,4,17,19,3,NASDAQ
4665,13-02-2021 00:00,24 hrs.,pennystocks,GHSI,83,77,6,71,2,36,3,2,NASDAQ
4665,13-02-2021 00:00,24 hrs.,pennystocks,GLBS,27,27,0,27,1,0,23,1,NASDAQ
4665,13-02-2021 00:00,24 hrs.,pennystocks,GOEV,89,89,0,89,2,27,27,2,NASDAQ
4665,13-02-2021 00:00,24 hrs.,pennystocks,GRIL,41,0,41,-41,1,13,11,1,NASDAQ
4665,13-02-2021 00:00,24 hrs.,pennystocks,HALO,6,0,6,-6,1,1,0,1,NASDAQ
4665,13-02-2021 00:00,24 hrs.,pennystocks,HRTX,14,14,0,14,1,2,6,1,NASDAQ
4665,13-02-2021 00:00,24 hrs.,pennystocks,HSTO,12,6,6,0,2,2,0,2,NASDAQ
4665,13-02-2021 00:00,24 hrs.,pennystocks,IBKR,7,7,0,7,1,1,1,1,NASDAQ
4665,13-02-2021 00:00,24 hrs.,pennystocks,IFMK,41,0,41,-41,1,13,11,1,NASDAQ
4665,13-02-2021 00:00,24 hrs.,pennystocks,INFI,13,13,0,13,1,1,7,1,NASDAQ
4665,13-02-2021 00:00,24 hrs.,pennystocks,INOD,71,71,0,71,1,12,43,1,NASDAQ
4665,13-02-2021 00:00,24 hrs.,pennystocks,INPX,13,0,13,-13,2,2,1,2,NASDAQ
4665,13-02-2021 00:00,24 hrs.,pennystocks,IRDM,19,19,0,19,1,7,1,1,NASDAQ
4665,13-02-2021 00:00,24 hrs.,pennystocks,IZEA,6,6,0,6,1,1,0,1,NASDAQ
4665,13-02-2021 00:00,24 hrs.,pennystocks,KTRA,168,53,115,-62,5,48,52,5,NASDAQ
4665,13-02-2021 00:00,24 hrs.,pennystocks,KXIN,19,19,0,19,1,7,1,1,NASDAQ
4665,13-02-2021 00:00,24 hrs.,pennystocks,LKCO,9,0,9,-9,1,2,1,1,NASDAQ
4665,13-02-2021 00:00,24 hrs.,pennystocks,LPCN,54,0,54,-54,1,19,12,1,NASDAQ
4665,13-02-2021 00:00,24 hrs.,pennystocks,LPTH,64,64,0,64,1,25,10,1,NASDAQ
4665,13-02-2021 00:00,24 hrs.,pennystocks,MARK,103,6,97,-91,2,20,55,2,NASDAQ
4665,13-02-2021 00:00,24 hrs.,pennystocks,MDGS,6,0,6,-6,1,1,0,1,NASDAQ
4665,13-02-2021 00:00,24 hrs.,pennystocks,MTRX,15,0,15,-15,1,4,3,1,NASDAQ
4665,13-02-2021 00:00,24 hrs.,pennystocks,MVIS,6,0,6,-6,1,1,0,1,NASDAQ
4665,13-02-2021 00:00,24 hrs.,pennystocks,NAKD,46,40,6,34,3,9,16,3,NASDAQ
4665,13-02-2021 00:00,24 hrs.,pennystocks,NAOV,6,6,0,6,1,1,0,1,NASDAQ
4665,13-02-2021 00:00,24 hrs.,pennystocks,NCMI,15,15,0,15,1,4,3,1,NASDAQ
4665,13-02-2021 00:00,24 hrs.,pennystocks,NDAQ,19,19,0,19,1,7,1,1,NASDAQ
4665,13-02-2021 00:00,24 hrs.,pennystocks,NOVN,6,6,0,6,1,1,0,1,NASDAQ
4665,13-02-2021 00:00,24 hrs.,pennystocks,NVCN,47,47,0,47,2,13,13,2,NASDAQ
4665,13-02-2021 00:00,24 hrs.,pennystocks,OCGN,62,62,0,62,3,16,18,3,NASDAQ
4665,13-02-2021 00:00,24 hrs.,pennystocks,ONTX,12,6,6,0,2,2,0,2,NASDAQ
4665,13-02-2021 00:00,24 hrs.,pennystocks,OPTT,26,26,0,26,1,9,4,1,NASDAQ
4665,13-02-2021 00:00,24 hrs.,pennystocks,OTIC,10,10,0,10,1,1,4,1,NASDAQ
4665,13-02-2021 00:00,24 hrs.,pennystocks,PLAY,6,6,0,6,1,1,0,1,NASDAQ
4665,13-02-2021 00:00,24 hrs.,pennystocks,PLUG,116,19,97,-78,2,26,56,2,NASDAQ
4665,13-02-2021 00:00,24 hrs.,pennystocks,PPBT,10,0,10,-10,1,2,2,1,NASDAQ
4665,13-02-2021 00:00,24 hrs.,pennystocks,PSTV,75,0,75,-75,2,28,11,2,NASDAQ
4665,13-02-2021 00:00,24 hrs.,pennystocks,PULM,190,190,0,190,4,38,98,4,NASDAQ
4665,13-02-2021 00:00,24 hrs.,pennystocks,RAVE,41,0,41,-41,1,13,11,1,NASDAQ
4665,13-02-2021 00:00,24 hrs.,pennystocks,REAL,52,0,52,-52,1,7,34,1,NASDAQ
4665,13-02-2021 00:00,24 hrs.,pennystocks,RIBT,7,7,0,7,1,1,1,1,NASDAQ
4665,13-02-2021 00:00,24 hrs.,pennystocks,RIDE,6,6,0,6,1,1,0,1,NASDAQ
4665,13-02-2021 00:00,24 hrs.,pennystocks,RIGL,12,0,12,-12,2,2,0,2,NASDAQ
4665,13-02-2021 00:00,24 hrs.,pennystocks,RMTI,6,0,6,-6,1,1,0,1,NASDAQ
4665,13-02-2021 00:00,24 hrs.,pennystocks,SEAC,12,0,12,-12,1,2,4,1,NASDAQ
4665,13-02-2021 00:00,24 hrs.,pennystocks,SELB,22,22,0,22,1,7,4,1,NASDAQ
4665,13-02-2021 00:00,24 hrs.,pennystocks,SESN,27,27,0,27,1,10,3,1,NASDAQ
4665,13-02-2021 00:00,24 hrs.,pennystocks,SFET,34,34,0,34,2,7,12,2,NASDAQ
4665,13-02-2021 00:00,24 hrs.,pennystocks,SHIP,20,14,6,8,3,3,2,2,NASDAQ
4665,13-02-2021 00:00,24 hrs.,pennystocks,SNDL,144,106,38,68,23,23,6,20,NASDAQ
4665,13-02-2021 00:00,24 hrs.,pennystocks,SNGX,1741,1692,49,1643,14,683,319,6,NASDAQ
4665,13-02-2021 00:00,24 hrs.,pennystocks,SOLO,19,19,0,19,1,7,1,1,NASDAQ
4665,13-02-2021 00:00,24 hrs.,pennystocks,SRGA,6,6,0,6,1,1,0,1,NASDAQ
4665,13-02-2021 00:00,24 hrs.,pennystocks,STCN,6,6,0,6,1,1,0,1,NASDAQ
4665,13-02-2021 00:00,24 hrs.,pennystocks,TBLT,6,6,0,6,1,1,0,1,NASDAQ
4665,13-02-2021 00:00,24 hrs.,pennystocks,TLRY,14,7,7,0,2,2,2,2,NASDAQ
4665,13-02-2021 00:00,24 hrs.,pennystocks,TMDI,6,0,6,-6,1,1,0,1,NASDAQ
4665,13-02-2021 00:00,24 hrs.,pennystocks,TNXP,414,87,327,-240,10,149,76,6,NASDAQ
4665,13-02-2021 00:00,24 hrs.,pennystocks,TRCH,55,55,0,55,3,12,19,3,NASDAQ
4665,13-02-2021 00:00,24 hrs.,pennystocks,TRVG,19,19,0,19,3,3,1,2,NASDAQ
4665,13-02-2021 00:00,24 hrs.,pennystocks,TSLA,6,0,6,-6,1,1,0,1,NASDAQ
4665,13-02-2021 00:00,24 hrs.,pennystocks,TXMD,7,7,0,7,1,1,1,1,NASDAQ
4665,13-02-2021 00:00,24 hrs.,pennystocks,TYME,22,22,0,22,1,7,4,1,NASDAQ
4665,13-02-2021 00:00,24 hrs.,pennystocks,USWS,6,0,6,-6,1,1,0,1,NASDAQ
4665,13-02-2021 00:00,24 hrs.,pennystocks,VEON,7,7,0,7,1,1,1,1,NASDAQ
4665,13-02-2021 00:00,24 hrs.,pennystocks,VETS,1006,1006,0,1006,1,410,182,1,NASDAQ
4665,13-02-2021 00:00,24 hrs.,pennystocks,VRME,21,0,21,-21,1,6,5,1,NASDAQ
4665,13-02-2021 00:00,24 hrs.,pennystocks,WTRH,41,0,41,-41,1,13,11,1,NASDAQ
4665,13-02-2021 00:00,24 hrs.,pennystocks,XELA,201,0,201,-201,1,90,17,1,NASDAQ
4665,13-02-2021 00:00,24 hrs.,pennystocks,XSPA,32,32,0,32,1,12,4,1,NASDAQ
4665,13-02-2021 00:00,24 hrs.,pennystocks,ZSAN,100,88,12,76,4,29,26,4,NASDAQ
4665,13-02-2021 00:00,24 hrs.,wallstreetbets,ABML,27,7,20,-13,4,4,3,4,OTC
4665,13-02-2021 00:00,24 hrs.,wallstreetbets,ABQQ,7,0,7,-7,1,1,1,1,OTC
4665,13-02-2021 00:00,24 hrs.,wallstreetbets,ACRL,6,6,0,6,1,1,0,1,OTC
4665,13-02-2021 00:00,24 hrs.,wallstreetbets,ACTX,8,8,0,8,1,1,2,1,OTC
4665,13-02-2021 00:00,24 hrs.,wallstreetbets,AITX,14,0,14,-14,2,2,2,2,OTC
4665,13-02-2021 00:00,24 hrs.,wallstreetbets,ALPP,14,14,0,14,2,2,2,2,OTC
4665,13-02-2021 00:00,24 hrs.,wallstreetbets,ALYI,14,7,7,0,2,2,2,2,OTC
4665,13-02-2021 00:00,24 hrs.,wallstreetbets,AMNE,13,13,0,13,2,2,1,1,OTC
4665,13-02-2021 00:00,24 hrs.,wallstreetbets,APCX,7,7,0,7,1,1,1,1,OTC
4665,13-02-2021 00:00,24 hrs.,wallstreetbets,BANT,6,6,0,6,1,1,0,1,OTC
4665,13-02-2021 00:00,24 hrs.,wallstreetbets,BBRW,6,0,6,-6,1,1,0,1,OTC
4665,13-02-2021 00:00,24 hrs.,wallstreetbets,BIEL,19,0,19,-19,3,3,1,3,OTC
4665,13-02-2021 00:00,24 hrs.,wallstreetbets,BIGG,6,0,6,-6,1,1,0,1,OTC
4665,13-02-2021 00:00,24 hrs.,wallstreetbets,BLSP,21,21,0,21,3,3,3,1,OTC
4665,13-02-2021 00:00,24 hrs.,wallstreetbets,BMIX,11,0,11,-11,1,1,5,1,OTC
4665,13-02-2021 00:00,24 hrs.,wallstreetbets,BOTH,42,42,0,42,2,1,32,2,OTC
4665,13-02-2021 00:00,24 hrs.,wallstreetbets,BOTY,12,6,6,0,2,2,0,2,OTC
4665,13-02-2021 00:00,24 hrs.,wallstreetbets,BRLL,7,7,0,7,1,1,1,1,OTC
4665,13-02-2021 00:00,24 hrs.,wallstreetbets,BTCS,21,21,0,21,3,3,3,1,OTC
4665,13-02-2021 00:00,24 hrs.,wallstreetbets,BTSC,7,7,0,7,1,1,1,1,OTC
4665,13-02-2021 00:00,24 hrs.,wallstreetbets,BTZI,13,13,0,13,2,2,1,2,OTC
4665,13-02-2021 00:00,24 hrs.,wallstreetbets,BUDZ,6,6,0,6,1,1,0,1,OTC
4665,13-02-2021 00:00,24 hrs.,wallstreetbets,CBDD,7,7,0,7,1,1,1,1,OTC
4665,13-02-2021 00:00,24 hrs.,wallstreetbets,CBDL,55,55,0,55,8,8,7,5,OTC
4665,13-02-2021 00:00,24 hrs.,wallstreetbets,CCTC,7,7,0,7,1,1,1,1,OTC
4665,13-02-2021 00:00,24 hrs.,wallstreetbets,CCTL,6,0,6,-6,1,1,0,1,OTC
4665,13-02-2021 00:00,24 hrs.,wallstreetbets,CGEI,7,0,7,-7,1,1,1,1,OTC
4665,13-02-2021 00:00,24 hrs.,wallstreetbets,CGLD,7,7,0,7,1,1,1,1,OTC
4665,13-02-2021 00:00,24 hrs.,wallstreetbets,CHUC,7,0,7,-7,1,1,1,1,OTC
4665,13-02-2021 00:00,24 hrs.,wallstreetbets,CLIS,14,14,0,14,2,2,2,1,OTC
4665,13-02-2021 00:00,24 hrs.,wallstreetbets,CLWD,7,7,0,7,1,1,1,1,OTC
4665,13-02-2021 00:00,24 hrs.,wallstreetbets,COMS,19,19,0,19,3,3,1,2,OTC
4665,13-02-2021 00:00,24 hrs.,wallstreetbets,CYDY,7,7,0,7,1,1,1,1,OTC
4665,13-02-2021 00:00,24 hrs.,wallstreetbets,CYLC,7,7,0,7,1,1,1,1,OTC
4665,13-02-2021 00:00,24 hrs.,wallstreetbets,DGWR,7,7,0,7,1,1,1,1,OTC
4665,13-02-2021 00:00,24 hrs.,wallstreetbets,DIGI,14,0,14,-14,2,2,2,1,OTC
4665,13-02-2021 00:00,24 hrs.,wallstreetbets,DPLS,13,13,0,13,2,2,1,2,OTC
4665,13-02-2021 00:00,24 hrs.,wallstreetbets,DPWW,7,7,0,7,1,1,1,1,OTC
4665,13-02-2021 00:00,24 hrs.,wallstreetbets,DWOG,7,0,7,-7,1,1,1,1,OTC
4665,13-02-2021 00:00,24 hrs.,wallstreetbets,ELCR,28,7,21,-14,4,4,4,2,OTC
4665,13-02-2021 00:00,24 hrs.,wallstreetbets,ELTP,24,24,0,24,3,3,6,3,OTC
4665,13-02-2021 00:00,24 hrs.,wallstreetbets,ENZN,7,7,0,7,1,1,1,1,OTC
4665,13-02-2021 00:00,24 hrs.,wallstreetbets,ETFM,23,17,6,11,3,3,5,2,OTC
4665,13-02-2021 00:00,24 hrs.,wallstreetbets,EWKS,6,6,0,6,1,1,0,1,OTC
4665,13-02-2021 00:00,24 hrs.,wallstreetbets,FTEG,14,14,0,14,2,2,2,1,OTC
4665,13-02-2021 00:00,24 hrs.,wallstreetbets,FTPM,7,7,0,7,1,1,1,1,OTC
4665,13-02-2021 00:00,24 hrs.,wallstreetbets,GARB,7,7,0,7,1,1,1,1,OTC
4665,13-02-2021 00:00,24 hrs.,wallstreetbets,GBTC,4629,4629,0,4629,3,2156,305,2,OTC
4665,13-02-2021 00:00,24 hrs.,wallstreetbets,GMEV,14,14,0,14,2,2,2,2,OTC
4665,13-02-2021 00:00,24 hrs.,wallstreetbets,GMSC,14,14,0,14,2,2,2,1,OTC
4665,13-02-2021 00:00,24 hrs.,wallstreetbets,GPFT,34,27,7,20,5,5,4,5,OTC
4665,13-02-2021 00:00,24 hrs.,wallstreetbets,GRNH,6,0,6,-6,1,1,0,1,OTC
4665,13-02-2021 00:00,24 hrs.,wallstreetbets,GTCH,7,7,0,7,1,1,1,1,OTC
4665,13-02-2021 00:00,24 hrs.,wallstreetbets,GTEH,20,20,0,20,3,3,2,2,OTC
4665,13-02-2021 00:00,24 hrs.,wallstreetbets,GTII,1278,0,1278,-1278,1,455,364,1,OTC
4665,13-02-2021 00:00,24 hrs.,wallstreetbets,GTLL,13,6,7,-1,2,2,1,2,OTC
4665,13-02-2021 00:00,24 hrs.,wallstreetbets,GTXO,14,14,0,14,2,2,2,1,OTC
4665,13-02-2021 00:00,24 hrs.,wallstreetbets,HCMC,373,259,114,145,55,55,43,53,OTC
4665,13-02-2021 00:00,24 hrs.,wallstreetbets,HEMP,21,21,0,21,3,3,3,2,OTC
4665,13-02-2021 00:00,24 hrs.,wallstreetbets,HIHI,7,7,0,7,1,1,1,1,OTC
4665,13-02-2021 00:00,24 hrs.,wallstreetbets,HIPH,14,0,14,-14,2,2,2,2,OTC
4665,13-02-2021 00:00,24 hrs.,wallstreetbets,HMNY,62,42,20,22,9,9,8,5,OTC
4665,13-02-2021 00:00,24 hrs.,wallstreetbets,HMPQ,7,7,0,7,1,1,1,1,OTC
4665,13-02-2021 00:00,24 hrs.,wallstreetbets,HQGE,35,35,0,35,5,5,5,3,OTC
4665,13-02-2021 00:00,24 hrs.,wallstreetbets,HRBR,6,6,0,6,1,1,0,1,OTC
4665,13-02-2021 00:00,24 hrs.,wallstreetbets,HYSR,19,13,6,7,3,3,1,3,OTC
4665,13-02-2021 00:00,24 hrs.,wallstreetbets,ICBU,7,7,0,7,1,1,1,1,OTC
4665,13-02-2021 00:00,24 hrs.,wallstreetbets,INCT,21,21,0,21,3,3,3,2,OTC
4665,13-02-2021 00:00,24 hrs.,wallstreetbets,INKW,7,7,0,7,1,1,1,1,OTC
4665,13-02-2021 00:00,24 hrs.,wallstreetbets,INND,20,14,6,8,3,3,2,2,OTC
4665,13-02-2021 00:00,24 hrs.,wallstreetbets,INTV,21,21,0,21,3,3,3,2,OTC
4665,13-02-2021 00:00,24 hrs.,wallstreetbets,IPIX,10,10,0,10,1,3,0,1,OTC
4665,13-02-2021 00:00,24 hrs.,wallstreetbets,IQST,13,13,0,13,2,2,1,1,OTC
4665,13-02-2021 00:00,24 hrs.,wallstreetbets,ITCJ,6,6,0,6,1,1,0,1,OTC
4665,13-02-2021 00:00,24 hrs.,wallstreetbets,KALY,7,7,0,7,1,1,1,1,OTC
4665,13-02-2021 00:00,24 hrs.,wallstreetbets,KGKG,7,0,7,-7,1,1,1,1,OTC
4665,13-02-2021 00:00,24 hrs.,wallstreetbets,KRFG,7,0,7,-7,1,1,1,1,OTC
4665,13-02-2021 00:00,24 hrs.,wallstreetbets,KWBT,7,0,7,-7,1,1,1,1,OTC
4665,13-02-2021 00:00,24 hrs.,wallstreetbets,KYNC,14,7,7,0,2,2,2,2,OTC
4665,13-02-2021 00:00,24 hrs.,wallstreetbets,LBCC,7,7,0,7,1,1,1,1,OTC
4665,13-02-2021 00:00,24 hrs.,wallstreetbets,LINK,443,443,0,443,5,174,75,5,OTC
4665,13-02-2021 00:00,24 hrs.,wallstreetbets,LITH,7,7,0,7,1,1,1,1,OTC
4665,13-02-2021 00:00,24 hrs.,wallstreetbets,LOTE,7,0,7,-7,1,1,1,1,OTC
4665,13-02-2021 00:00,24 hrs.,wallstreetbets,LSCG,7,0,7,-7,1,1,1,1,OTC
4665,13-02-2021 00:00,24 hrs.,wallstreetbets,LTNC,14,14,0,14,2,2,2,2,OTC
4665,13-02-2021 00:00,24 hrs.,wallstreetbets,LTUM,12,6,6,0,2,2,0,2,OTC
4665,13-02-2021 00:00,24 hrs.,wallstreetbets,MAXD,22,22,0,22,3,3,4,3,OTC
4665,13-02-2021 00:00,24 hrs.,wallstreetbets,MCOA,20,20,0,20,3,3,2,3,OTC
4665,13-02-2021 00:00,24 hrs.,wallstreetbets,MEDH,7,7,0,7,1,1,1,1,OTC
4665,13-02-2021 00:00,24 hrs.,wallstreetbets,MGNT,7,7,0,7,1,1,1,1,OTC
4665,13-02-2021 00:00,24 hrs.,wallstreetbets,MGTI,7,7,0,7,1,1,1,1,OTC
4665,13-02-2021 00:00,24 hrs.,wallstreetbets,MINE,68,48,20,28,10,10,8,7,OTC
4665,13-02-2021 00:00,24 hrs.,wallstreetbets,MJNA,48,27,21,6,7,7,6,7,OTC
4665,13-02-2021 00:00,24 hrs.,wallstreetbets,MKTY,21,21,0,21,3,3,3,2,OTC
4665,13-02-2021 00:00,24 hrs.,wallstreetbets,MMEX,28,0,28,-28,4,4,4,2,OTC
4665,13-02-2021 00:00,24 hrs.,wallstreetbets,MOJO,13,13,0,13,2,2,1,1,OTC
4665,13-02-2021 00:00,24 hrs.,wallstreetbets,MOST,28,28,0,28,4,5,2,4,OTC
4665,13-02-2021 00:00,24 hrs.,wallstreetbets,MTVX,6,0,6,-6,1,1,0,1,OTC
4665,13-02-2021 00:00,24 hrs.,wallstreetbets,NBVG,6,6,0,6,1,1,0,1,OTC
4665,13-02-2021 00:00,24 hrs.,wallstreetbets,NEOM,28,28,0,28,4,4,4,2,OTC
4665,13-02-2021 00:00,24 hrs.,wallstreetbets,NOVC,34,34,0,34,5,5,4,3,OTC
4665,13-02-2021 00:00,24 hrs.,wallstreetbets,NPHC,7,7,0,7,1,1,1,1,OTC
4665,13-02-2021 00:00,24 hrs.,wallstreetbets,NPTX,14,0,14,-14,2,2,2,1,OTC
4665,13-02-2021 00:00,24 hrs.,wallstreetbets,NWPN,6,6,0,6,1,1,0,1,OTC
4665,13-02-2021 00:00,24 hrs.,wallstreetbets,ONPH,6,6,0,6,1,1,0,1,OTC
4665,13-02-2021 00:00,24 hrs.,wallstreetbets,OTTV,14,14,0,14,2,2,2,1,OTC
4665,13-02-2021 00:00,24 hrs.,wallstreetbets,OWPC,6,6,0,6,1,1,0,1,OTC
4665,13-02-2021 00:00,24 hrs.,wallstreetbets,OZSC,14,14,0,14,2,2,2,2,OTC
4665,13-02-2021 00:00,24 hrs.,wallstreetbets,PAOG,7,7,0,7,1,1,1,1,OTC
4665,13-02-2021 00:00,24 hrs.,wallstreetbets,PDMI,7,0,7,-7,1,1,1,1,OTC
4665,13-02-2021 00:00,24 hrs.,wallstreetbets,PHBI,14,14,0,14,2,2,2,1,OTC
4665,13-02-2021 00:00,24 hrs.,wallstreetbets,PNPL,13,0,13,-13,2,2,1,1,OTC
4665,13-02-2021 00:00,24 hrs.,wallstreetbets,PRED,7,0,7,-7,1,1,1,1,OTC
4665,13-02-2021 00:00,24 hrs.,wallstreetbets,PURE,7,0,7,-7,1,1,1,1,OTC
4665,13-02-2021 00:00,24 hrs.,wallstreetbets,QOIL,6,6,0,6,1,1,0,1,OTC
4665,13-02-2021 00:00,24 hrs.,wallstreetbets,RBDC,7,7,0,7,1,1,1,1,OTC
4665,13-02-2021 00:00,24 hrs.,wallstreetbets,RBNW,13,6,7,-1,2,2,1,2,OTC
4665,13-02-2021 00:00,24 hrs.,wallstreetbets,REFG,7,7,0,7,1,1,1,1,OTC
4665,13-02-2021 00:00,24 hrs.,wallstreetbets,RELI,6,6,0,6,1,1,0,1,OTC
4665,13-02-2021 00:00,24 hrs.,wallstreetbets,RIGH,7,0,7,-7,1,1,1,1,OTC
4665,13-02-2021 00:00,24 hrs.,wallstreetbets,RSHN,7,0,7,-7,1,1,1,1,OTC
4665,13-02-2021 00:00,24 hrs.,wallstreetbets,RSSV,9,9,0,9,1,2,1,1,OTC
4665,13-02-2021 00:00,24 hrs.,wallstreetbets,RTON,21,8,13,-5,3,3,3,3,OTC
4665,13-02-2021 00:00,24 hrs.,wallstreetbets,SFOR,14,0,14,-14,2,2,2,1,OTC
4665,13-02-2021 00:00,24 hrs.,wallstreetbets,SGMD,25,0,25,-25,4,4,1,2,OTC
4665,13-02-2021 00:00,24 hrs.,wallstreetbets,SHMP,27,14,13,1,4,4,3,4,OTC
4665,13-02-2021 00:00,24 hrs.,wallstreetbets,SIGN,20,14,6,8,3,3,2,3,OTC
4665,13-02-2021 00:00,24 hrs.,wallstreetbets,SIMP,7,7,0,7,1,1,1,1,OTC
4665,13-02-2021 00:00,24 hrs.,wallstreetbets,SIRR,7,7,0,7,1,1,1,1,OTC
4665,13-02-2021 00:00,24 hrs.,wallstreetbets,SNYR,14,14,0,14,2,2,2,1,OTC
4665,13-02-2021 00:00,24 hrs.,wallstreetbets,SRMX,27,13,14,-1,4,4,3,4,OTC
4665,13-02-2021 00:00,24 hrs.,wallstreetbets,SUIC,6,6,0,6,1,1,0,1,OTC
4665,13-02-2021 00:00,24 hrs.,wallstreetbets,TCHH,6,6,0,6,1,1,0,1,OTC
4665,13-02-2021 00:00,24 hrs.,wallstreetbets,TGLO,7,7,0,7,1,1,1,1,OTC
4665,13-02-2021 00:00,24 hrs.,wallstreetbets,TRNX,7,0,7,-7,1,1,1,1,OTC
4665,13-02-2021 00:00,24 hrs.,wallstreetbets,TRTC,21,21,0,21,3,3,3,2,OTC
4665,13-02-2021 00:00,24 hrs.,wallstreetbets,TSNP,20,14,6,8,3,3,2,3,OTC
4665,13-02-2021 00:00,24 hrs.,wallstreetbets,UBQU,7,7,0,7,1,1,1,1,OTC
4665,13-02-2021 00:00,24 hrs.,wallstreetbets,USDC,8,8,0,8,1,1,2,1,OTC
4665,13-02-2021 00:00,24 hrs.,wallstreetbets,USMJ,13,13,0,13,2,2,1,2,OTC
4665,13-02-2021 00:00,24 hrs.,wallstreetbets,UVSE,7,7,0,7,1,1,1,1,OTC
4665,13-02-2021 00:00,24 hrs.,wallstreetbets,VTLR,7,7,0,7,1,1,1,1,OTC
4665,13-02-2021 00:00,24 hrs.,wallstreetbets,VYST,6,6,0,6,1,1,0,1,OTC
4665,13-02-2021 00:00,24 hrs.,wallstreetbets,WDDD,7,7,0,7,1,1,1,1,OTC
4665,13-02-2021 00:00,24 hrs.,wallstreetbets,WDLF,7,7,0,7,1,1,1,1,OTC
4665,13-02-2021 00:00,24 hrs.,wallstreetbets,WHEN,19,6,13,-7,3,3,1,3,OTC
4665,13-02-2021 00:00,24 hrs.,wallstreetbets,WSSE,7,7,0,7,1,1,1,1,OTC
4665,13-02-2021 00:00,24 hrs.,wallstreetbets,YRIV,5,5,0,5,1,0,1,1,OTC
4665,13-02-2021 00:00,24 hrs.,wallstreetbets,ZMRK,7,7,0,7,1,1,1,1,OTC
4665,13-02-2021 00:00,24 hrs.,wallstreetbets,ZNOG,7,7,0,7,1,1,1,1,OTC
4665,13-02-2021 00:00,24 hrs.,wallstreetbets,AGUNF,6,6,0,6,1,1,0,1,OTC
4665,13-02-2021 00:00,24 hrs.,wallstreetbets,AMYZF,23,23,0,23,3,3,5,2,OTC
4665,13-02-2021 00:00,24 hrs.,wallstreetbets,ARBKF,6,6,0,6,1,1,0,1,OTC
4665,13-02-2021 00:00,24 hrs.,wallstreetbets,ATURF,7,7,0,7,1,1,1,1,OTC
4665,13-02-2021 00:00,24 hrs.,wallstreetbets,AZKLF,18,18,0,18,3,3,0,1,OTC
4665,13-02-2021 00:00,24 hrs.,wallstreetbets,BBKCF,6,6,0,6,1,1,0,1,OTC
4665,13-02-2021 00:00,24 hrs.,wallstreetbets,BDRBF,27,14,13,1,4,4,3,4,OTC
4665,13-02-2021 00:00,24 hrs.,wallstreetbets,CBWTF,11,0,11,-11,1,0,7,1,OTC
4665,13-02-2021 00:00,24 hrs.,wallstreetbets,CLXPF,7,7,0,7,1,1,1,1,OTC
4665,13-02-2021 00:00,24 hrs.,wallstreetbets,CRLBF,12,12,0,12,2,2,0,2,OTC
4665,13-02-2021 00:00,24 hrs.,wallstreetbets,CTTAY,33,33,0,33,1,11,7,1,OTC
4665,13-02-2021 00:00,24 hrs.,wallstreetbets,DFLYF,33,0,33,-33,3,2,17,2,OTC
4665,13-02-2021 00:00,24 hrs.,wallstreetbets,DIAAF,7,7,0,7,1,1,1,1,OTC
4665,13-02-2021 00:00,24 hrs.,wallstreetbets,EPWCF,7,7,0,7,1,1,1,1,OTC
4665,13-02-2021 00:00,24 hrs.,wallstreetbets,FDVRF,6,6,0,6,1,1,0,1,OTC
4665,13-02-2021 00:00,24 hrs.,wallstreetbets,GAYMF,6,6,0,6,1,1,0,1,OTC
4665,13-02-2021 00:00,24 hrs.,wallstreetbets,GGTTF,7,7,0,7,1,1,1,1,OTC
4665,13-02-2021 00:00,24 hrs.,wallstreetbets,GTBIF,7,7,0,7,1,1,1,1,OTC
4665,13-02-2021 00:00,24 hrs.,wallstreetbets,HITIF,7,7,0,7,1,1,1,1,OTC
4665,13-02-2021 00:00,24 hrs.,wallstreetbets,HRSTW,11,11,0,11,2,1,1,1,OTC
4665,13-02-2021 00:00,24 hrs.,wallstreetbets,HUTMF,13,13,0,13,2,2,1,2,OTC
4665,13-02-2021 00:00,24 hrs.,wallstreetbets,HVBTF,22,15,7,8,3,3,4,3,OTC
4665,13-02-2021 00:00,24 hrs.,wallstreetbets,IGCIW,49,49,0,49,7,7,7,2,OTC
4665,13-02-2021 00:00,24 hrs.,wallstreetbets,ISCNF,14,14,0,14,2,2,2,2,OTC
4665,13-02-2021 00:00,24 hrs.,wallstreetbets,ITHUF,7,7,0,7,1,1,1,1,OTC
4665,13-02-2021 00:00,24 hrs.,wallstreetbets,KBEVF,7,7,0,7,1,1,1,1,OTC
4665,13-02-2021 00:00,24 hrs.,wallstreetbets,LHSIF,7,7,0,7,1,1,1,1,OTC
4665,13-02-2021 00:00,24 hrs.,wallstreetbets,LKNCY,187,181,6,175,2,4,171,2,OTC
4665,13-02-2021 00:00,24 hrs.,wallstreetbets,LLKKF,6,0,6,-6,1,1,0,1,OTC
4665,13-02-2021 00:00,24 hrs.,wallstreetbets,LMLLF,6,0,6,-6,1,1,0,1,OTC
4665,13-02-2021 00:00,24 hrs.,wallstreetbets,LTMCF,6,0,6,-6,1,1,0,1,OTC
4665,13-02-2021 00:00,24 hrs.,wallstreetbets,LXXGF,8,0,8,-8,1,1,2,1,OTC
4665,13-02-2021 00:00,24 hrs.,wallstreetbets,MEDIF,6,0,6,-6,1,1,0,1,OTC
4665,13-02-2021 00:00,24 hrs.,wallstreetbets,MMEDF,2947,67,2880,-2813,5,1225,477,4,OTC
4665,13-02-2021 00:00,24 hrs.,wallstreetbets,MOTNF,7,7,0,7,1,1,1,1,OTC
4665,13-02-2021 00:00,24 hrs.,wallstreetbets,NMGRF,6,0,6,-6,1,1,0,1,OTC
4665,13-02-2021 00:00,24 hrs.,wallstreetbets,NTDOY,15,15,0,15,2,2,3,2,OTC
4665,13-02-2021 00:00,24 hrs.,wallstreetbets,NTSFF,6,0,6,-6,1,1,0,1,OTC
4665,13-02-2021 00:00,24 hrs.,wallstreetbets,NXGWF,20,13,7,6,3,3,2,2,OTC
4665,13-02-2021 00:00,24 hrs.,wallstreetbets,NXTTF,14,14,0,14,2,2,2,1,OTC
4665,13-02-2021 00:00,24 hrs.,wallstreetbets,PCLOF,13,13,0,13,2,2,1,1,OTC
4665,13-02-2021 00:00,24 hrs.,wallstreetbets,PDYPF,7,7,0,7,1,1,1,1,OTC
4665,13-02-2021 00:00,24 hrs.,wallstreetbets,PMNXF,6,6,0,6,1,1,0,1,OTC
4665,13-02-2021 00:00,24 hrs.,wallstreetbets,RAZFF,7,7,0,7,1,1,1,1,OTC
4665,13-02-2021 00:00,24 hrs.,wallstreetbets,RLLCF,72,72,0,72,10,10,12,10,OTC
4665,13-02-2021 00:00,24 hrs.,wallstreetbets,RYCEY,466,71,395,-324,16,115,172,14,OTC
4665,13-02-2021 00:00,24 hrs.,wallstreetbets,SBSAA,7,7,0,7,1,1,1,1,OTC
4665,13-02-2021 00:00,24 hrs.,wallstreetbets,SPRWF,60,28,32,-4,9,9,6,8,OTC
4665,13-02-2021 00:00,24 hrs.,wallstreetbets,TBUIF,13,13,0,13,2,2,1,1,OTC
4665,13-02-2021 00:00,24 hrs.,wallstreetbets,TCNNF,4643,4643,0,4643,5,2158,307,1,OTC
4665,13-02-2021 00:00,24 hrs.,wallstreetbets,TGODF,7,7,0,7,1,1,1,1,OTC
4665,13-02-2021 00:00,24 hrs.,wallstreetbets,TPPRF,14,14,0,14,2,2,2,1,OTC
4665,13-02-2021 00:00,24 hrs.,wallstreetbets,TSCRF,46,46,0,46,3,2,30,2,OTC
4665,13-02-2021 00:00,24 hrs.,wallstreetbets,TXLZF,7,7,0,7,1,1,1,1,OTC
4665,13-02-2021 00:00,24 hrs.,wallstreetbets,VALPQ,15,8,7,1,2,3,1,2,OTC
4665,13-02-2021 00:00,24 hrs.,wallstreetbets,VVCIF,13,6,7,-1,2,2,1,2,OTC
4665,13-02-2021 00:00,24 hrs.,wallstreetbets,WDDMF,7,0,7,-7,1,1,1,1,OTC
4665,13-02-2021 00:00,24 hrs.,wallstreetbets,WPMLF,8,0,8,-8,1,1,2,1,OTC
4665,13-02-2021 00:00,24 hrs.,wallstreetbets,AAU,14,14,0,14,2,2,2,2,AMEX
4665,13-02-2021 00:00,24 hrs.,wallstreetbets,BTN,15,15,0,15,2,2,3,1,AMEX
4665,13-02-2021 00:00,24 hrs.,wallstreetbets,DIT,6,6,0,6,1,1,0,1,AMEX
4665,13-02-2021 00:00,24 hrs.,wallstreetbets,DNN,170,144,26,118,25,25,20,21,AMEX
4665,13-02-2021 00:00,24 hrs.,wallstreetbets,DPW,14,14,0,14,2,2,2,2,AMEX
4665,13-02-2021 00:00,24 hrs.,wallstreetbets,FEN,7,0,7,-7,1,1,1,1,AMEX
4665,13-02-2021 00:00,24 hrs.,wallstreetbets,GDP,155,155,0,155,2,40,67,2,AMEX
4665,13-02-2021 00:00,24 hrs.,wallstreetbets,GLU,7,7,0,7,1,1,1,1,AMEX
4665,13-02-2021 00:00,24 hrs.,wallstreetbets,GSV,14,0,14,-14,2,2,2,2,AMEX
4665,13-02-2021 00:00,24 hrs.,wallstreetbets,GTE,80,60,20,40,12,12,8,10,AMEX
4665,13-02-2021 00:00,24 hrs.,wallstreetbets,IGC,7,0,7,-7,1,1,1,1,AMEX
4665,13-02-2021 00:00,24 hrs.,wallstreetbets,ISR,6,0,6,-6,1,1,0,1,AMEX
4665,13-02-2021 00:00,24 hrs.,wallstreetbets,ITP,7,7,0,7,1,1,1,1,AMEX
4665,13-02-2021 00:00,24 hrs.,wallstreetbets,LSF,7,0,7,-7,1,1,1,1,AMEX
4665,13-02-2021 00:00,24 hrs.,wallstreetbets,MSN,7,7,0,7,1,1,1,1,AMEX
4665,13-02-2021 00:00,24 hrs.,wallstreetbets,MXC,21,0,21,-21,3,3,3,3,AMEX
4665,13-02-2021 00:00,24 hrs.,wallstreetbets,MYO,7,7,0,7,1,1,1,1,AMEX
4665,13-02-2021 00:00,24 hrs.,wallstreetbets,NAK,84,57,27,30,13,13,6,12,AMEX
4665,13-02-2021 00:00,24 hrs.,wallstreetbets,PTN,7,7,0,7,1,1,1,1,AMEX
4665,13-02-2021 00:00,24 hrs.,wallstreetbets,REI,7,7,0,7,1,1,1,1,AMEX
4665,13-02-2021 00:00,24 hrs.,wallstreetbets,SYN,14,14,0,14,2,2,2,1,AMEX
4665,13-02-2021 00:00,24 hrs.,wallstreetbets,TGB,6,6,0,6,1,1,0,1,AMEX
4665,13-02-2021 00:00,24 hrs.,wallstreetbets,TMQ,8,0,8,-8,1,1,2,1,AMEX
4665,13-02-2021 00:00,24 hrs.,wallstreetbets,TRX,76,35,41,-6,11,11,10,7,AMEX
4665,13-02-2021 00:00,24 hrs.,wallstreetbets,UUU,6,6,0,6,1,1,0,1,AMEX
4665,13-02-2021 00:00,24 hrs.,wallstreetbets,ZOM,240,165,75,90,26,46,44,25,AMEX
4665,13-02-2021 00:00,24 hrs.,wallstreetbets,AMPE,41,34,7,27,6,6,5,4,AMEX
4665,13-02-2021 00:00,24 hrs.,wallstreetbets,CRMD,7,7,0,7,1,1,1,1,AMEX
4665,13-02-2021 00:00,24 hrs.,wallstreetbets,EMAN,14,7,7,0,2,2,2,2,AMEX
4665,13-02-2021 00:00,24 hrs.,wallstreetbets,GOED,13,13,0,13,2,2,1,2,AMEX
4665,13-02-2021 00:00,24 hrs.,wallstreetbets,GSAT,87,26,61,-35,13,13,9,8,AMEX
4665,13-02-2021 00:00,24 hrs.,wallstreetbets,HUSA,7,7,0,7,1,1,1,1,AMEX
4665,13-02-2021 00:00,24 hrs.,wallstreetbets,LODE,13,13,0,13,2,2,1,2,AMEX
4665,13-02-2021 00:00,24 hrs.,wallstreetbets,NSPR,7,0,7,-7,1,1,1,1,AMEX
4665,13-02-2021 00:00,24 hrs.,wallstreetbets,OGEN,27,20,7,13,4,4,3,4,AMEX
4665,13-02-2021 00:00,24 hrs.,wallstreetbets,RLGT,21,0,21,-21,3,3,3,1,AMEX
4665,13-02-2021 00:00,24 hrs.,wallstreetbets,SENS,220,213,7,206,13,51,66,11,AMEX
4665,13-02-2021 00:00,24 hrs.,wallstreetbets,TMBR,54,34,20,14,8,8,6,4,AMEX
4665,13-02-2021 00:00,24 hrs.,wallstreetbets,TRXC,33,13,20,-7,5,5,3,4,AMEX
4665,13-02-2021 00:00,24 hrs.,wallstreetbets,UAVS,28,21,7,14,4,4,4,3,AMEX
4665,13-02-2021 00:00,24 hrs.,wallstreetbets,UUUU,21,14,7,7,3,3,3,2,AMEX
4665,13-02-2021 00:00,24 hrs.,wallstreetbets,YCBD,14,7,7,0,2,2,2,2,AMEX
4665,13-02-2021 00:00,24 hrs.,wallstreetbets,ABT,13,6,7,-1,2,2,1,2,NYSE
4665,13-02-2021 00:00,24 hrs.,wallstreetbets,ACB,152,138,14,124,22,22,20,18,NYSE
4665,13-02-2021 00:00,24 hrs.,wallstreetbets,ACI,7,7,0,7,1,1,1,1,NYSE
4665,13-02-2021 00:00,24 hrs.,wallstreetbets,AEM,8,8,0,8,1,1,2,1,NYSE
4665,13-02-2021 00:00,24 hrs.,wallstreetbets,AFC,7,7,0,7,1,1,1,1,NYSE
4665,13-02-2021 00:00,24 hrs.,wallstreetbets,AIR,13,6,7,-1,2,2,1,2,NYSE
4665,13-02-2021 00:00,24 hrs.,wallstreetbets,AIV,6,6,0,6,1,1,0,1,NYSE
4665,13-02-2021 00:00,24 hrs.,wallstreetbets,AMC,10049,1122,8927,-7805,224,3937,1279,186,NYSE
4665,13-02-2021 00:00,24 hrs.,wallstreetbets,AMP,43,29,14,15,6,6,7,6,NYSE
4665,13-02-2021 00:00,24 hrs.,wallstreetbets,ASX,21,7,14,-7,3,3,3,3,NYSE
4665,13-02-2021 00:00,24 hrs.,wallstreetbets,ATH,146,30,116,-86,4,42,46,4,NYSE
4665,13-02-2021 00:00,24 hrs.,wallstreetbets,AUY,116,116,0,116,9,19,42,4,NYSE
4665,13-02-2021 00:00,24 hrs.,wallstreetbets,AXP,4622,4622,0,4622,2,2155,304,1,NYSE
4665,13-02-2021 00:00,24 hrs.,SPACs,APEX,33,33,0,33,1,5,19,1,OTC
4665,13-02-2021 00:00,24 hrs.,SPACs,BRRN,11,11,0,11,1,2,3,1,OTC
4665,13-02-2021 00:00,24 hrs.,SPACs,CAGR,114,0,114,-114,1,22,66,1,OTC
4665,13-02-2021 00:00,24 hrs.,SPACs,CIK,53,53,0,53,1,15,19,1,AMEX
4665,13-02-2021 00:00,24 hrs.,SPACs,NBA,299,299,0,299,1,83,129,1,AMEX
4665,13-02-2021 00:00,24 hrs.,SPACs,PTK,299,299,0,299,1,83,129,1,AMEX
4665,13-02-2021 00:00,24 hrs.,SPACs,CHAQ,299,299,0,299,1,83,129,1,AMEX
4665,13-02-2021 00:00,24 hrs.,SPACs,AIR,130,130,0,130,1,48,30,1,NYSE
4665,13-02-2021 00:00,24 hrs.,SPACs,BFT,2441,0,2441,-2441,1,55,2327,1,NYSE
4665,13-02-2021 00:00,24 hrs.,SPACs,BSN,299,299,0,299,1,83,129,1,NYSE
4665,13-02-2021 00:00,24 hrs.,SPACs,CCX,299,299,0,299,1,83,129,1,NYSE
4665,13-02-2021 00:00,24 hrs.,SPACs,COO,40,40,0,40,1,5,26,1,NYSE
4665,13-02-2021 00:00,24 hrs.,SPACs,DEH,299,299,0,299,1,83,129,1,NYSE
4665,13-02-2021 00:00,24 hrs.,SPACs,DFS,130,130,0,130,1,48,30,1,NYSE
4665,13-02-2021 00:00,24 hrs.,SPACs,EQD,2740,299,2441,-2142,2,138,2456,2,NYSE
4665,13-02-2021 00:00,24 hrs.,SPACs,FSR,6,6,0,6,1,1,0,1,NYSE
4665,13-02-2021 00:00,24 hrs.,SPACs,GIK,30,0,30,-30,4,2,10,2,NYSE
4665,13-02-2021 00:00,24 hrs.,SPACs,GIX,299,299,0,299,1,83,129,1,NYSE
4665,13-02-2021 00:00,24 hrs.,SPACs,HPX,299,299,0,299,1,83,129,1,NYSE
4665,13-02-2021 00:00,24 hrs.,SPACs,ICE,41,41,0,41,1,14,9,1,NYSE
4665,13-02-2021 00:00,24 hrs.,SPACs,IRR,65,65,0,65,1,18,25,1,NYSE
4665,13-02-2021 00:00,24 hrs.,SPACs,JWS,2477,36,2441,-2405,6,60,2333,2,NYSE
4665,13-02-2021 00:00,24 hrs.,SPACs,NAV,250,121,129,-8,7,56,110,5,NYSE
4665,13-02-2021 00:00,24 hrs.,SPACs,NGA,77,53,24,29,4,16,29,3,NYSE
4665,13-02-2021 00:00,24 hrs.,SPACs,NSH,299,299,0,299,1,83,129,1,NYSE
4665,13-02-2021 00:00,24 hrs.,SPACs,RSI,139,10,129,-119,2,40,51,2,NYSE
4665,13-02-2021 00:00,24 hrs.,SPACs,RTP,2841,375,2466,-2091,7,210,2393,6,NYSE
4665,13-02-2021 00:00,24 hrs.,SPACs,SBE,84,78,6,72,3,29,14,2,NYSE
4665,13-02-2021 00:00,24 hrs.,SPACs,SBG,299,299,0,299,1,83,129,1,NYSE
4665,13-02-2021 00:00,24 hrs.,SPACs,TDA,7,7,0,7,1,1,1,1,NYSE
4665,13-02-2021 00:00,24 hrs.,SPACs,WPF,299,299,0,299,1,83,129,1,NYSE
4665,13-02-2021 00:00,24 hrs.,SPACs,YAC,299,299,0,299,1,83,129,1,NYSE
4665,13-02-2021 00:00,24 hrs.,SPACs,YUM,30,30,0,30,1,7,12,1,NYSE
4665,13-02-2021 00:00,24 hrs.,SPACs,ACIC,2441,0,2441,-2441,1,55,2327,1,NYSE
4665,13-02-2021 00:00,24 hrs.,SPACs,ACND,299,299,0,299,1,83,129,1,NYSE
4665,13-02-2021 00:00,24 hrs.,SPACs,ALUS,43,43,0,43,1,8,23,1,NYSE
4665,13-02-2021 00:00,24 hrs.,SPACs,AONE,299,299,0,299,1,83,129,1,NYSE
4665,13-02-2021 00:00,24 hrs.,SPACs,APSG,299,299,0,299,1,83,129,1,NYSE
4665,13-02-2021 00:00,24 hrs.,SPACs,ASAQ,299,299,0,299,1,83,129,1,NYSE
4665,13-02-2021 00:00,24 hrs.,SPACs,ASPL,305,299,6,293,2,84,129,2,NYSE
4665,13-02-2021 00:00,24 hrs.,SPACs,ATAC,299,299,0,299,1,83,129,1,NYSE
4665,13-02-2021 00:00,24 hrs.,SPACs,AVAN,299,299,0,299,1,83,129,1,NYSE
4665,13-02-2021 00:00,24 hrs.,SPACs,BOAC,375,375,0,375,2,106,155,2,NYSE
4665,13-02-2021 00:00,24 hrs.,SPACs,CCIV,3525,380,3145,-2765,11,411,2659,11,NYSE
4665,13-02-2021 00:00,24 hrs.,SPACs,CLII,8,0,8,-8,1,1,2,1,NYSE
4665,13-02-2021 00:00,24 hrs.,SPACs,CPSR,299,299,0,299,1,83,129,1,NYSE
4665,13-02-2021 00:00,24 hrs.,SPACs,CTAC,299,299,0,299,1,83,129,1,NYSE
4665,13-02-2021 00:00,24 hrs.,SPACs,DFNS,341,341,0,341,2,99,135,2,NYSE
4665,13-02-2021 00:00,24 hrs.,SPACs,DGNR,354,354,0,354,1,152,46,1,NYSE
4665,13-02-2021 00:00,24 hrs.,SPACs,DMYD,469,354,115,239,2,170,121,2,NYSE
4665,13-02-2021 00:00,24 hrs.,SPACs,EMPW,2740,299,2441,-2142,2,138,2456,2,NYSE
4665,13-02-2021 00:00,24 hrs.,SPACs,ENPC,2441,0,2441,-2441,1,55,2327,1,NYSE
4665,13-02-2021 00:00,24 hrs.,SPACs,FGNA,50,50,0,50,1,17,12,1,NYSE
4665,13-02-2021 00:00,24 hrs.,SPACs,FUSE,4285,1844,2441,-597,16,695,2831,13,NYSE
4665,13-02-2021 00:00,24 hrs.,SPACs,GLEO,299,299,0,299,1,83,129,1,NYSE
4665,13-02-2021 00:00,24 hrs.,SPACs,GOAC,299,299,0,299,1,83,129,1,NYSE
4665,13-02-2021 00:00,24 hrs.,SPACs,GSAH,469,354,115,239,2,170,121,2,NYSE
4665,13-02-2021 00:00,24 hrs.,SPACs,HIGA,299,299,0,299,1,83,129,1,NYSE
4665,13-02-2021 00:00,24 hrs.,SPACs,HZAC,299,299,0,299,1,83,129,1,NYSE
4665,13-02-2021 00:00,24 hrs.,SPACs,HZON,299,299,0,299,1,83,129,1,NYSE
4665,13-02-2021 00:00,24 hrs.,SPACs,IMPX,299,299,0,299,1,83,129,1,NYSE
4665,13-02-2021 00:00,24 hrs.,SPACs,IPOE,6,0,6,-6,1,1,0,1,NYSE
4665,13-02-2021 00:00,24 hrs.,SPACs,LGVW,439,354,85,269,4,175,73,3,NYSE
4665,13-02-2021 00:00,24 hrs.,SPACs,OACB,299,299,0,299,1,83,129,1,NYSE
4665,13-02-2021 00:00,24 hrs.,SPACs,PANA,299,299,0,299,1,83,129,1,NYSE
4665,13-02-2021 00:00,24 hrs.,SPACs,PCPL,299,299,0,299,1,83,129,1,NYSE
4665,13-02-2021 00:00,24 hrs.,wallstreetbets,BBW,19,6,13,-7,3,3,1,3,NYSE
4665,13-02-2021 00:00,24 hrs.,wallstreetbets,BBY,14,0,14,-14,2,2,2,1,NYSE
4665,13-02-2021 00:00,24 hrs.,wallstreetbets,BCH,7,7,0,7,1,1,1,1,NYSE
4665,13-02-2021 00:00,24 hrs.,wallstreetbets,BFT,7,0,7,-7,1,1,1,1,NYSE
4665,13-02-2021 00:00,24 hrs.,wallstreetbets,BGS,8,8,0,8,1,1,2,1,NYSE
4665,13-02-2021 00:00,24 hrs.,wallstreetbets,BHC,445,424,21,403,5,174,77,3,NYSE
4665,13-02-2021 00:00,24 hrs.,wallstreetbets,BIT,7,0,7,-7,1,1,1,1,NYSE
4665,13-02-2021 00:00,24 hrs.,wallstreetbets,BTT,59,33,26,7,9,9,5,9,NYSE
4665,13-02-2021 00:00,24 hrs.,wallstreetbets,BTU,14,14,0,14,2,2,2,1,NYSE
4665,13-02-2021 00:00,24 hrs.,wallstreetbets,CAT,7,7,0,7,1,1,1,1,NYSE
4665,13-02-2021 00:00,24 hrs.,wallstreetbets,CBD,28,0,28,-28,4,4,4,3,NYSE
4665,13-02-2021 00:00,24 hrs.,wallstreetbets,CCL,14,14,0,14,2,2,2,1,NYSE
4665,13-02-2021 00:00,24 hrs.,wallstreetbets,CHS,8,0,8,-8,1,1,2,1,NYSE
4665,13-02-2021 00:00,24 hrs.,wallstreetbets,CMC,15,15,0,15,1,1,9,1,NYSE
4665,13-02-2021 00:00,24 hrs.,wallstreetbets,CPE,7,7,0,7,1,1,1,1,NYSE
4665,13-02-2021 00:00,24 hrs.,wallstreetbets,CPG,7,7,0,7,1,1,1,1,NYSE
4665,13-02-2021 00:00,24 hrs.,wallstreetbets,CVS,7,7,0,7,1,1,1,1,NYSE
4665,13-02-2021 00:00,24 hrs.,wallstreetbets,DAC,20,20,0,20,3,3,2,2,NYSE
4665,13-02-2021 00:00,24 hrs.,wallstreetbets,DAL,13,13,0,13,2,2,1,2,NYSE
4665,13-02-2021 00:00,24 hrs.,wallstreetbets,DAO,12,12,0,12,2,2,0,1,NYSE
4665,13-02-2021 00:00,24 hrs.,wallstreetbets,DHT,7,7,0,7,1,1,1,1,NYSE
4665,13-02-2021 00:00,24 hrs.,wallstreetbets,DIS,1643,437,1206,-769,8,686,239,8,NYSE
4665,13-02-2021 00:00,24 hrs.,wallstreetbets,DNB,7,0,7,-7,1,1,1,1,NYSE
4665,13-02-2021 00:00,24 hrs.,wallstreetbets,DOC,7,0,7,-7,1,1,1,1,NYSE
4665,13-02-2021 00:00,24 hrs.,wallstreetbets,DTE,140,140,0,140,1,40,56,1,NYSE
4665,13-02-2021 00:00,24 hrs.,wallstreetbets,DVN,7,7,0,7,1,1,1,1,NYSE
4665,13-02-2021 00:00,24 hrs.,wallstreetbets,EAT,28,14,14,0,4,4,4,4,NYSE
4665,13-02-2021 00:00,24 hrs.,wallstreetbets,EPD,47,47,0,47,2,12,15,1,NYSE
4665,13-02-2021 00:00,24 hrs.,wallstreetbets,ETN,14,14,0,14,2,2,2,2,NYSE
4665,13-02-2021 00:00,24 hrs.,wallstreetbets,EXP,13,13,0,13,2,2,1,2,NYSE
4665,13-02-2021 00:00,24 hrs.,wallstreetbets,FCX,105,0,105,-105,6,23,35,3,NYSE
4665,13-02-2021 00:00,24 hrs.,wallstreetbets,FDX,7,7,0,7,1,1,1,1,NYSE
4665,13-02-2021 00:00,24 hrs.,wallstreetbets,FLT,7,7,0,7,1,1,1,1,NYSE
4665,13-02-2021 00:00,24 hrs.,wallstreetbets,FMC,13,13,0,13,2,2,1,1,NYSE
4665,13-02-2021 00:00,24 hrs.,wallstreetbets,FMS,7,0,7,-7,1,1,1,1,NYSE
4665,13-02-2021 00:00,24 hrs.,wallstreetbets,FOF,6,0,6,-6,1,1,0,1,NYSE
4665,13-02-2021 00:00,24 hrs.,wallstreetbets,FRO,19,19,0,19,3,3,1,2,NYSE
4665,13-02-2021 00:00,24 hrs.,wallstreetbets,FSD,14,14,0,14,2,2,2,2,NYSE
4665,13-02-2021 00:00,24 hrs.,wallstreetbets,FSR,748,250,498,-248,39,221,150,20,NYSE
4665,13-02-2021 00:00,24 hrs.,wallstreetbets,FTI,20,20,0,20,3,3,2,1,NYSE
4665,13-02-2021 00:00,24 hrs.,wallstreetbets,GAM,7,7,0,7,1,1,1,1,NYSE
4665,13-02-2021 00:00,24 hrs.,wallstreetbets,GEO,42,28,14,14,6,6,6,2,NYSE
4665,13-02-2021 00:00,24 hrs.,wallstreetbets,GLW,14,7,7,0,2,2,2,2,NYSE
4665,13-02-2021 00:00,24 hrs.,wallstreetbets,GME,125300,107306,17994,89312,477,56739,9914,364,NYSE
4665,13-02-2021 00:00,24 hrs.,wallstreetbets,HMC,33,33,0,33,1,11,7,1,NYSE
4665,13-02-2021 00:00,24 hrs.,wallstreetbets,HMI,7,7,0,7,1,1,1,1,NYSE
4665,13-02-2021 00:00,24 hrs.,wallstreetbets,HON,6,0,6,-6,1,1,0,1,NYSE
4665,13-02-2021 00:00,24 hrs.,wallstreetbets,IAG,14,7,7,0,2,2,2,2,NYSE
4665,13-02-2021 00:00,24 hrs.,wallstreetbets,IBM,3860,3860,0,3860,5,1763,314,5,NYSE
4665,13-02-2021 00:00,24 hrs.,wallstreetbets,IGT,7,7,0,7,1,1,1,1,NYSE
4665,13-02-2021 00:00,24 hrs.,wallstreetbets,IRS,6,6,0,6,1,1,0,1,NYSE
4665,13-02-2021 00:00,24 hrs.,wallstreetbets,IVR,55,49,6,43,8,7,9,6,NYSE
4665,13-02-2021 00:00,24 hrs.,wallstreetbets,JNJ,48,42,6,36,3,2,32,3,NYSE
4665,13-02-2021 00:00,24 hrs.,wallstreetbets,JWS,16,16,0,16,2,4,0,1,NYSE
4665,13-02-2021 00:00,24 hrs.,wallstreetbets,KMI,47,47,0,47,2,12,15,1,NYSE
4665,13-02-2021 00:00,24 hrs.,wallstreetbets,KMX,116,0,116,-116,1,35,42,1,NYSE
4665,13-02-2021 00:00,24 hrs.,wallstreetbets,KOS,12,12,0,12,2,2,0,1,NYSE
4665,13-02-2021 00:00,24 hrs.,wallstreetbets,LAC,19,0,19,-19,3,3,1,3,NYSE
4665,13-02-2021 00:00,24 hrs.,wallstreetbets,LEN,6,0,6,-6,1,1,0,1,NYSE
4665,13-02-2021 00:00,24 hrs.,wallstreetbets,LMT,7,0,7,-7,1,1,1,1,NYSE
4665,13-02-2021 00:00,24 hrs.,wallstreetbets,LOW,22,22,0,22,3,3,4,2,NYSE
4665,13-02-2021 00:00,24 hrs.,wallstreetbets,LTC,7,0,7,-7,1,1,1,1,NYSE
4665,13-02-2021 00:00,24 hrs.,wallstreetbets,MAC,9,9,0,9,1,1,3,1,NYSE
4665,13-02-2021 00:00,24 hrs.,wallstreetbets,MBI,14,14,0,14,2,2,2,2,NYSE
4665,13-02-2021 00:00,24 hrs.,wallstreetbets,MCO,417,417,0,417,1,170,73,1,NYSE
4665,13-02-2021 00:00,24 hrs.,wallstreetbets,MFA,7,7,0,7,1,1,1,1,NYSE
4665,13-02-2021 00:00,24 hrs.,wallstreetbets,MIN,7,7,0,7,1,1,1,1,NYSE
4665,13-02-2021 00:00,24 hrs.,wallstreetbets,MRO,429,423,6,417,3,172,73,3,NYSE
4665,13-02-2021 00:00,24 hrs.,wallstreetbets,MSM,7,7,0,7,1,1,1,1,NYSE
4665,13-02-2021 00:00,24 hrs.,wallstreetbets,MTL,6,0,6,-6,1,1,0,1,NYSE
4665,13-02-2021 00:00,24 hrs.,wallstreetbets,NAT,27,20,7,13,4,3,5,4,NYSE
4665,13-02-2021 00:00,24 hrs.,wallstreetbets,NET,76,76,0,76,2,22,24,2,NYSE
4665,13-02-2021 00:00,24 hrs.,wallstreetbets,NGA,12,6,6,0,2,2,0,2,NYSE
4665,13-02-2021 00:00,24 hrs.,wallstreetbets,NIO,1061,618,443,175,17,330,333,15,NYSE
4665,13-02-2021 00:00,24 hrs.,wallstreetbets,NLY,7,7,0,7,1,1,1,1,NYSE
4665,13-02-2021 00:00,24 hrs.,wallstreetbets,NOC,7,0,7,-7,1,1,1,1,NYSE
4665,13-02-2021 00:00,24 hrs.,wallstreetbets,NOK,2468,2386,82,2304,32,979,382,28,NYSE
4665,13-02-2021 00:00,24 hrs.,wallstreetbets,NOV,6,6,0,6,1,1,0,1,NYSE
4665,13-02-2021 00:00,24 hrs.,wallstreetbets,NRG,35,35,0,35,5,5,5,1,NYSE
4665,13-02-2021 00:00,24 hrs.,wallstreetbets,NUS,7,7,0,7,1,1,1,1,NYSE
4665,13-02-2021 00:00,24 hrs.,wallstreetbets,NVO,52,46,6,40,2,12,20,2,NYSE
4665,13-02-2021 00:00,24 hrs.,wallstreetbets,NYC,14,7,7,0,2,2,2,2,NYSE
4665,13-02-2021 00:00,24 hrs.,wallstreetbets,OGE,7,0,7,-7,1,1,1,1,NYSE
4665,13-02-2021 00:00,24 hrs.,wallstreetbets,OPP,7,0,7,-7,1,1,1,1,NYSE
4665,13-02-2021 00:00,24 hrs.,wallstreetbets,OSK,130,130,0,130,1,36,54,1,NYSE
4665,13-02-2021 00:00,24 hrs.,SPACs,PDAC,7,7,0,7,1,1,1,1,NYSE
4665,13-02-2021 00:00,24 hrs.,SPACs,PIAI,299,299,0,299,1,83,129,1,NYSE
4665,13-02-2021 00:00,24 hrs.,SPACs,PRPB,299,299,0,299,1,83,129,1,NYSE
4665,13-02-2021 00:00,24 hrs.,SPACs,PSTH,62,62,0,62,2,16,22,2,NYSE
4665,13-02-2021 00:00,24 hrs.,SPACs,RBAC,299,299,0,299,1,83,129,1,NYSE
4665,13-02-2021 00:00,24 hrs.,SPACs,RPLA,299,299,0,299,1,83,129,1,NYSE
4665,13-02-2021 00:00,24 hrs.,SPACs,SCPE,299,299,0,299,1,83,129,1,NYSE
4665,13-02-2021 00:00,24 hrs.,SPACs,SCVX,299,299,0,299,1,83,129,1,NYSE
4665,13-02-2021 00:00,24 hrs.,SPACs,SEAH,299,299,0,299,1,83,129,1,NYSE
4665,13-02-2021 00:00,24 hrs.,SPACs,SFTW,299,299,0,299,1,83,129,1,NYSE
4665,13-02-2021 00:00,24 hrs.,SPACs,SKLZ,129,0,129,-129,1,39,47,1,NYSE
4665,13-02-2021 00:00,24 hrs.,SPACs,SNPR,2567,120,2447,-2327,8,91,2353,7,NYSE
4665,13-02-2021 00:00,24 hrs.,SPACs,SPCE,7,0,7,-7,1,1,1,1,NYSE
4665,13-02-2021 00:00,24 hrs.,SPACs,STPK,7,7,0,7,1,1,1,1,NYSE
4665,13-02-2021 00:00,24 hrs.,SPACs,TWND,35,35,0,35,1,6,19,1,NYSE
4665,13-02-2021 00:00,24 hrs.,SPACs,VTOL,130,130,0,130,1,48,30,1,NYSE
4665,13-02-2021 00:00,24 hrs.,SPACs,VYGG,29,29,0,29,2,4,13,2,NYSE
4665,13-02-2021 00:00,24 hrs.,SPACs,ADV,2740,299,2441,-2142,2,138,2456,2,NASDAQ
4665,13-02-2021 00:00,24 hrs.,SPACs,CFO,160,160,0,160,2,55,42,2,NASDAQ
4665,13-02-2021 00:00,24 hrs.,SPACs,ESG,123,0,123,-123,1,37,45,1,NASDAQ
4665,13-02-2021 00:00,24 hrs.,SPACs,HOL,2448,0,2448,-2448,2,56,2328,2,NASDAQ
4665,13-02-2021 00:00,24 hrs.,SPACs,III,50,50,0,50,1,17,12,1,NASDAQ
4665,13-02-2021 00:00,24 hrs.,SPACs,LCY,299,299,0,299,1,83,129,1,NASDAQ
4665,13-02-2021 00:00,24 hrs.,SPACs,NPA,96,96,0,96,1,32,28,1,NASDAQ
4665,13-02-2021 00:00,24 hrs.,SPACs,VIH,41,41,0,41,1,14,9,1,NASDAQ
4665,13-02-2021 00:00,24 hrs.,SPACs,AACQ,359,359,0,359,3,116,115,3,NASDAQ
4665,13-02-2021 00:00,24 hrs.,SPACs,ACAC,129,0,129,-129,1,39,47,1,NASDAQ
4665,13-02-2021 00:00,24 hrs.,SPACs,ACEV,48,40,8,32,2,2,36,2,NASDAQ
4665,13-02-2021 00:00,24 hrs.,SPACs,ADOC,299,299,0,299,1,83,129,1,NASDAQ
4665,13-02-2021 00:00,24 hrs.,SPACs,AGBA,299,299,0,299,1,83,129,1,NASDAQ
4665,13-02-2021 00:00,24 hrs.,SPACs,AHAC,299,299,0,299,1,83,129,1,NASDAQ
4665,13-02-2021 00:00,24 hrs.,SPACs,AMHC,299,299,0,299,1,83,129,1,NASDAQ
4665,13-02-2021 00:00,24 hrs.,SPACs,ANDA,114,0,114,-114,1,22,66,1,NASDAQ
4665,13-02-2021 00:00,24 hrs.,SPACs,BHSE,299,299,0,299,1,83,129,1,NASDAQ
4665,13-02-2021 00:00,24 hrs.,SPACs,BLNK,40,40,0,40,1,5,26,1,NASDAQ
4665,13-02-2021 00:00,24 hrs.,SPACs,BOWX,299,299,0,299,1,83,129,1,NASDAQ
4665,13-02-2021 00:00,24 hrs.,SPACs,BREZ,299,299,0,299,1,83,129,1,NASDAQ
4665,13-02-2021 00:00,24 hrs.,SPACs,BRLI,299,299,0,299,1,83,129,1,NASDAQ
4665,13-02-2021 00:00,24 hrs.,SPACs,BRPA,2441,0,2441,-2441,1,55,2327,1,NASDAQ
4665,13-02-2021 00:00,24 hrs.,SPACs,BTAQ,669,669,0,669,3,235,187,3,NASDAQ
4665,13-02-2021 00:00,24 hrs.,SPACs,BTWN,75,7,68,-61,3,13,37,3,NASDAQ
4665,13-02-2021 00:00,24 hrs.,SPACs,BWAC,299,299,0,299,1,83,129,1,NASDAQ
4665,13-02-2021 00:00,24 hrs.,SPACs,CAPA,299,299,0,299,1,83,129,1,NASDAQ
4665,13-02-2021 00:00,24 hrs.,SPACs,CELH,114,0,114,-114,1,22,66,1,NASDAQ
4665,13-02-2021 00:00,24 hrs.,SPACs,CFII,299,299,0,299,1,83,129,1,NASDAQ
4665,13-02-2021 00:00,24 hrs.,SPACs,CHPM,299,299,0,299,1,83,129,1,NASDAQ
4665,13-02-2021 00:00,24 hrs.,SPACs,CIIC,16,0,16,-16,1,4,4,1,NASDAQ
4665,13-02-2021 00:00,24 hrs.,SPACs,CMLF,2441,0,2441,-2441,1,55,2327,1,NASDAQ
4665,13-02-2021 00:00,24 hrs.,SPACs,CONX,299,299,0,299,1,83,129,1,NASDAQ
4665,13-02-2021 00:00,24 hrs.,SPACs,CRSA,299,299,0,299,1,83,129,1,NASDAQ
4665,13-02-2021 00:00,24 hrs.,SPACs,DBDR,299,299,0,299,1,83,129,1,NASDAQ
4665,13-02-2021 00:00,24 hrs.,SPACs,DCRB,16,0,16,-16,1,4,4,1,NASDAQ
4665,13-02-2021 00:00,24 hrs.,SPACs,DFHT,2441,0,2441,-2441,1,55,2327,1,NASDAQ
4665,13-02-2021 00:00,24 hrs.,SPACs,DFPH,299,299,0,299,1,83,129,1,NASDAQ
4665,13-02-2021 00:00,24 hrs.,SPACs,DGNS,469,354,115,239,2,170,121,2,NASDAQ
4665,13-02-2021 00:00,24 hrs.,SPACs,DSAC,299,299,0,299,1,83,129,1,NASDAQ
4665,13-02-2021 00:00,24 hrs.,SPACs,ERES,299,299,0,299,1,83,129,1,NASDAQ
4665,13-02-2021 00:00,24 hrs.,SPACs,ESSC,299,299,0,299,1,83,129,1,NASDAQ
4665,13-02-2021 00:00,24 hrs.,SPACs,ETAC,299,299,0,299,1,83,129,1,NASDAQ
4665,13-02-2021 00:00,24 hrs.,SPACs,EUCR,299,299,0,299,1,83,129,1,NASDAQ
4665,13-02-2021 00:00,24 hrs.,SPACs,FCAC,2869,366,2503,-2137,5,231,2387,4,NASDAQ
4665,13-02-2021 00:00,24 hrs.,SPACs,FTOC,98,98,0,98,4,24,34,3,NASDAQ
4665,13-02-2021 00:00,24 hrs.,SPACs,FVAM,299,299,0,299,1,83,129,1,NASDAQ
4665,13-02-2021 00:00,24 hrs.,SPACs,GNRS,299,299,0,299,1,83,129,1,NASDAQ
4665,13-02-2021 00:00,24 hrs.,SPACs,GRCY,299,299,0,299,1,83,129,1,NASDAQ
4665,13-02-2021 00:00,24 hrs.,SPACs,GRNV,299,299,0,299,1,83,129,1,NASDAQ
4665,13-02-2021 00:00,24 hrs.,SPACs,GRSV,374,374,0,374,4,100,158,4,NASDAQ
4665,13-02-2021 00:00,24 hrs.,SPACs,GWAC,299,299,0,299,1,83,129,1,NASDAQ
4665,13-02-2021 00:00,24 hrs.,SPACs,GXGX,299,299,0,299,1,83,129,1,NASDAQ
4665,13-02-2021 00:00,24 hrs.,SPACs,IGAC,299,299,0,299,1,83,129,1,NASDAQ
4665,13-02-2021 00:00,24 hrs.,SPACs,ITAC,299,299,0,299,1,83,129,1,NASDAQ
4665,13-02-2021 00:00,24 hrs.,SPACs,JYAC,299,299,0,299,1,83,129,1,NASDAQ
4665,13-02-2021 00:00,24 hrs.,SPACs,KERN,40,40,0,40,1,5,26,1,NASDAQ
4665,13-02-2021 00:00,24 hrs.,SPACs,KSMT,299,299,0,299,1,83,129,1,NASDAQ
4665,13-02-2021 00:00,24 hrs.,SPACs,LATN,299,299,0,299,1,83,129,1,NASDAQ
4665,13-02-2021 00:00,24 hrs.,SPACs,LCAP,299,299,0,299,1,83,129,1,NASDAQ
4665,13-02-2021 00:00,24 hrs.,SPACs,LFTR,299,299,0,299,1,83,129,1,NASDAQ
4665,13-02-2021 00:00,24 hrs.,SPACs,LIVK,299,299,0,299,1,83,129,1,NASDAQ
4665,13-02-2021 00:00,24 hrs.,SPACs,MAAC,299,299,0,299,1,83,129,1,NASDAQ
4665,13-02-2021 00:00,24 hrs.,SPACs,MACU,299,299,0,299,1,83,129,1,NASDAQ
4665,13-02-2021 00:00,24 hrs.,SPACs,MCMJ,299,299,0,299,1,83,129,1,NASDAQ
4665,13-02-2021 00:00,24 hrs.,SPACs,MLAC,299,299,0,299,1,83,129,1,NASDAQ
4665,13-02-2021 00:00,24 hrs.,SPACs,MOTN,299,299,0,299,1,83,129,1,NASDAQ
4665,13-02-2021 00:00,24 hrs.,SPACs,NBAC,24,24,0,24,2,5,6,2,NASDAQ
4665,13-02-2021 00:00,24 hrs.,SPACs,OKTA,19,19,0,19,1,5,5,1,NASDAQ
4665,13-02-2021 00:00,24 hrs.,SPACs,OTRA,299,299,0,299,1,83,129,1,NASDAQ
4665,13-02-2021 00:00,24 hrs.,SPACs,PAIC,299,299,0,299,1,83,129,1,NASDAQ
4665,13-02-2021 00:00,24 hrs.,SPACs,PLUG,6,0,6,-6,1,1,0,1,NASDAQ
4665,13-02-2021 00:00,24 hrs.,SPACs,PRCH,30,30,0,30,1,10,6,1,NASDAQ
4665,13-02-2021 00:00,24 hrs.,SPACs,PYPL,61,61,0,61,1,22,13,1,NASDAQ
4665,13-02-2021 00:00,24 hrs.,wallstreetbets,OVV,5,5,0,5,1,0,1,1,NYSE
4665,13-02-2021 00:00,24 hrs.,wallstreetbets,OXY,6,0,6,-6,1,1,0,1,NYSE
4665,13-02-2021 00:00,24 hrs.,wallstreetbets,PCG,142,142,0,142,1,39,60,1,NYSE
4665,13-02-2021 00:00,24 hrs.,wallstreetbets,PDT,13,0,13,-13,2,2,1,2,NYSE
4665,13-02-2021 00:00,24 hrs.,wallstreetbets,PFE,19,13,6,7,3,3,1,3,NYSE
4665,13-02-2021 00:00,24 hrs.,wallstreetbets,PMO,7,0,7,-7,1,1,1,1,NYSE
4665,13-02-2021 00:00,24 hrs.,wallstreetbets,PSA,352,323,29,294,9,101,114,7,NYSE
4665,13-02-2021 00:00,24 hrs.,wallstreetbets,PSX,7638,0,7638,-7638,1,3300,1034,1,NYSE
4665,13-02-2021 00:00,24 hrs.,wallstreetbets,PVL,13,13,0,13,2,2,1,1,NYSE
4665,13-02-2021 00:00,24 hrs.,wallstreetbets,RDY,13,7,6,1,2,2,1,2,NYSE
4665,13-02-2021 00:00,24 hrs.,wallstreetbets,RKT,492,240,252,-12,17,148,128,13,NYSE
4665,13-02-2021 00:00,24 hrs.,wallstreetbets,RMO,83,69,14,55,12,12,11,8,NYSE
4665,13-02-2021 00:00,24 hrs.,wallstreetbets,RPT,7,7,0,7,1,1,1,1,NYSE
4665,13-02-2021 00:00,24 hrs.,wallstreetbets,RSI,12,6,6,0,2,2,0,2,NYSE
4665,13-02-2021 00:00,24 hrs.,wallstreetbets,RTP,6,6,0,6,1,1,0,1,NYSE
4665,13-02-2021 00:00,24 hrs.,wallstreetbets,RTX,7,0,7,-7,1,1,1,1,NYSE
4665,13-02-2021 00:00,24 hrs.,wallstreetbets,SBE,12,6,6,0,2,2,0,2,NYSE
4665,13-02-2021 00:00,24 hrs.,wallstreetbets,SBI,7,0,7,-7,1,1,1,1,NYSE
4665,13-02-2021 00:00,24 hrs.,wallstreetbets,SCI,623,0,623,-623,3,232,147,2,NYSE
4665,13-02-2021 00:00,24 hrs.,wallstreetbets,SKM,30,0,30,-30,1,0,26,1,NYSE
4665,13-02-2021 00:00,24 hrs.,wallstreetbets,SKT,14,0,14,-14,2,2,2,2,NYSE
4665,13-02-2021 00:00,24 hrs.,wallstreetbets,SKY,6,6,0,6,1,1,0,1,NYSE
4665,13-02-2021 00:00,24 hrs.,wallstreetbets,SNE,14,14,0,14,2,2,2,1,NYSE
4665,13-02-2021 00:00,24 hrs.,wallstreetbets,SNX,12,6,6,0,2,2,0,2,NYSE
4665,13-02-2021 00:00,24 hrs.,wallstreetbets,SOL,14,0,14,-14,2,2,2,2,NYSE
4665,13-02-2021 00:00,24 hrs.,wallstreetbets,SOS,251,141,110,31,37,35,33,28,NYSE
4665,13-02-2021 00:00,24 hrs.,wallstreetbets,SPG,54,0,54,-54,1,0,50,1,NYSE
4665,13-02-2021 00:00,24 hrs.,wallstreetbets,SPH,13,0,13,-13,2,2,1,2,NYSE
4665,13-02-2021 00:00,24 hrs.,wallstreetbets,STM,7,7,0,7,1,1,1,1,NYSE
4665,13-02-2021 00:00,24 hrs.,wallstreetbets,SUN,6,0,6,-6,1,1,0,1,NYSE
4665,13-02-2021 00:00,24 hrs.,wallstreetbets,SUP,7,7,0,7,1,1,1,1,NYSE
4665,13-02-2021 00:00,24 hrs.,wallstreetbets,TAK,14,14,0,14,2,2,2,2,NYSE
4665,13-02-2021 00:00,24 hrs.,wallstreetbets,TAP,13,13,0,13,2,2,1,2,NYSE
4665,13-02-2021 00:00,24 hrs.,wallstreetbets,TBC,7,7,0,7,1,1,1,1,NYSE
4665,13-02-2021 00:00,24 hrs.,wallstreetbets,TDA,1333,0,1333,-1333,2,584,157,2,NYSE
4665,13-02-2021 00:00,24 hrs.,wallstreetbets,TDC,6,6,0,6,1,1,0,1,NYSE
4665,13-02-2021 00:00,24 hrs.,wallstreetbets,TFC,7,7,0,7,1,1,1,1,NYSE
4665,13-02-2021 00:00,24 hrs.,wallstreetbets,THC,7,7,0,7,1,1,1,1,NYSE
4665,13-02-2021 00:00,24 hrs.,wallstreetbets,TRQ,6,0,6,-6,1,1,0,1,NYSE
4665,13-02-2021 00:00,24 hrs.,wallstreetbets,TRU,7,7,0,7,1,1,1,1,NYSE
4665,13-02-2021 00:00,24 hrs.,wallstreetbets,TSM,487,475,12,463,4,122,227,3,NYSE
4665,13-02-2021 00:00,24 hrs.,wallstreetbets,TSN,4622,4622,0,4622,2,2155,304,1,NYSE
4665,13-02-2021 00:00,24 hrs.,wallstreetbets,TTM,6,6,0,6,1,1,0,1,NYSE
4665,13-02-2021 00:00,24 hrs.,wallstreetbets,TWO,7,7,0,7,1,1,1,1,NYSE
4665,13-02-2021 00:00,24 hrs.,wallstreetbets,UBS,27,7,20,-13,4,4,3,3,NYSE
4665,13-02-2021 00:00,24 hrs.,wallstreetbets,UNP,7,7,0,7,1,1,1,1,NYSE
4665,13-02-2021 00:00,24 hrs.,wallstreetbets,UTZ,849,849,0,849,1,326,193,1,NYSE
4665,13-02-2021 00:00,24 hrs.,wallstreetbets,VET,7,0,7,-7,1,1,1,1,NYSE
4665,13-02-2021 00:00,24 hrs.,wallstreetbets,VGR,7,7,0,7,1,1,1,1,NYSE
4665,13-02-2021 00:00,24 hrs.,wallstreetbets,VHC,7,7,0,7,1,1,1,1,NYSE
4665,13-02-2021 00:00,24 hrs.,wallstreetbets,VRT,155,155,0,155,2,56,35,1,NYSE
4665,13-02-2021 00:00,24 hrs.,wallstreetbets,VST,35,35,0,35,5,5,5,1,NYSE
4665,13-02-2021 00:00,24 hrs.,wallstreetbets,WFC,7,7,0,7,1,1,1,1,NYSE
4665,13-02-2021 00:00,24 hrs.,wallstreetbets,WLL,6,6,0,6,1,1,0,1,NYSE
4665,13-02-2021 00:00,24 hrs.,wallstreetbets,WMC,8,8,0,8,1,1,2,1,NYSE
4665,13-02-2021 00:00,24 hrs.,wallstreetbets,WMT,20,13,7,6,3,3,2,3,NYSE
4665,13-02-2021 00:00,24 hrs.,wallstreetbets,WWE,7,0,7,-7,1,1,1,1,NYSE
4665,13-02-2021 00:00,24 hrs.,wallstreetbets,ABEV,7,7,0,7,1,1,1,1,NYSE
4665,13-02-2021 00:00,24 hrs.,wallstreetbets,ACIC,27,20,7,13,4,4,3,4,NYSE
4665,13-02-2021 00:00,24 hrs.,wallstreetbets,APRN,6,6,0,6,1,1,0,1,NYSE
4665,13-02-2021 00:00,24 hrs.,wallstreetbets,ARGO,6,6,0,6,1,1,0,1,NYSE
4665,13-02-2021 00:00,24 hrs.,wallstreetbets,ATUS,14,14,0,14,2,2,2,1,NYSE
4665,13-02-2021 00:00,24 hrs.,wallstreetbets,BABA,160,147,13,134,4,43,58,4,NYSE
4665,13-02-2021 00:00,24 hrs.,wallstreetbets,BNED,6,6,0,6,1,1,0,1,NYSE
4665,13-02-2021 00:00,24 hrs.,wallstreetbets,CARS,6,6,0,6,1,1,0,1,NYSE
4665,13-02-2021 00:00,24 hrs.,wallstreetbets,CCIV,288,204,84,120,42,42,36,35,NYSE
4665,13-02-2021 00:00,24 hrs.,wallstreetbets,CHWY,123,7,116,-109,2,36,43,2,NYSE
4665,13-02-2021 00:00,24 hrs.,wallstreetbets,CLDR,171,6,165,-159,2,53,57,2,NYSE
4665,13-02-2021 00:00,24 hrs.,wallstreetbets,CLII,7,7,0,7,1,1,1,1,NYSE
4665,13-02-2021 00:00,24 hrs.,wallstreetbets,CVNA,116,0,116,-116,1,35,42,1,NYSE
4665,13-02-2021 00:00,24 hrs.,wallstreetbets,DASH,32,6,26,-20,4,3,10,3,NYSE
4665,13-02-2021 00:00,24 hrs.,wallstreetbets,EXPR,15,15,0,15,2,2,3,2,NYSE
4665,13-02-2021 00:00,24 hrs.,wallstreetbets,FEDU,7,7,0,7,1,1,1,1,NYSE
4665,13-02-2021 00:00,24 hrs.,wallstreetbets,FENG,6,0,6,-6,1,1,0,1,NYSE
4665,13-02-2021 00:00,24 hrs.,wallstreetbets,FLOW,7,7,0,7,1,1,1,1,NYSE
4665,13-02-2021 00:00,24 hrs.,wallstreetbets,FSLY,14,14,0,14,2,2,2,2,NYSE
4665,13-02-2021 00:00,24 hrs.,wallstreetbets,FUBO,877,863,14,849,5,330,197,5,NYSE
4665,13-02-2021 00:00,24 hrs.,wallstreetbets,FUSE,30,30,0,30,4,4,6,2,NYSE
4665,13-02-2021 00:00,24 hrs.,wallstreetbets,FVRR,15,7,8,-1,2,2,3,2,NYSE
4665,13-02-2021 00:00,24 hrs.,wallstreetbets,GPRK,7,7,0,7,1,1,1,1,NYSE
4665,13-02-2021 00:00,24 hrs.,wallstreetbets,HEXO,13,13,0,13,2,2,1,2,NYSE
4665,13-02-2021 00:00,24 hrs.,wallstreetbets,HUBS,13,13,0,13,2,2,1,2,NYSE
4665,13-02-2021 00:00,24 hrs.,wallstreetbets,HUYA,35,14,21,-7,5,5,5,4,NYSE
4665,13-02-2021 00:00,24 hrs.,wallstreetbets,HYLN,571,509,62,447,20,156,179,17,NYSE
4665,13-02-2021 00:00,24 hrs.,wallstreetbets,IIPR,20,20,0,20,3,3,2,2,NYSE
4665,13-02-2021 00:00,24 hrs.,SPACs,QELL,639,484,155,329,4,219,185,4,NASDAQ
4665,13-02-2021 00:00,24 hrs.,SPACs,RCHG,299,299,0,299,1,83,129,1,NASDAQ
4665,13-02-2021 00:00,24 hrs.,SPACs,RIDE,6,0,6,-6,1,1,0,1,NASDAQ
4665,13-02-2021 00:00,24 hrs.,SPACs,SGAM,299,299,0,299,1,83,129,1,NASDAQ
4665,13-02-2021 00:00,24 hrs.,SPACs,SRAC,104,104,0,104,2,33,30,2,NASDAQ
4665,13-02-2021 00:00,24 hrs.,SPACs,STWO,299,299,0,299,1,83,129,1,NASDAQ
4665,13-02-2021 00:00,24 hrs.,SPACs,SVAC,299,299,0,299,1,83,129,1,NASDAQ
4665,13-02-2021 00:00,24 hrs.,SPACs,TEKK,299,299,0,299,1,83,129,1,NASDAQ
4665,13-02-2021 00:00,24 hrs.,SPACs,THBR,2475,34,2441,-2407,2,61,2345,2,NASDAQ
4665,13-02-2021 00:00,24 hrs.,SPACs,THCA,299,299,0,299,1,83,129,1,NASDAQ
4665,13-02-2021 00:00,24 hrs.,SPACs,THCB,6,6,0,6,1,1,0,1,NASDAQ
4665,13-02-2021 00:00,24 hrs.,SPACs,TMPM,299,299,0,299,1,83,129,1,NASDAQ
4665,13-02-2021 00:00,24 hrs.,SPACs,TMTS,299,299,0,299,1,83,129,1,NASDAQ
4665,13-02-2021 00:00,24 hrs.,SPACs,TTCF,114,0,114,-114,1,22,66,1,NASDAQ
4665,13-02-2021 00:00,24 hrs.,SPACs,TWCT,299,299,0,299,1,83,129,1,NASDAQ
4665,13-02-2021 00:00,24 hrs.,SPACs,VACQ,299,299,0,299,1,83,129,1,NASDAQ
4665,13-02-2021 00:00,24 hrs.,SPACs,VMAC,313,299,14,285,3,85,131,2,NASDAQ
4665,13-02-2021 00:00,24 hrs.,SPACs,VSPR,48,0,48,-48,1,13,18,1,NASDAQ
4665,13-02-2021 00:00,24 hrs.,SPACs,VTIQ,20,20,0,20,1,4,8,1,NASDAQ
4665,13-02-2021 00:00,24 hrs.,SPACs,YSAC,299,299,0,299,1,83,129,1,NASDAQ
4665,13-02-2021 00:00,24 hrs.,SPACs,ZGYH,299,299,0,299,1,83,129,1,NASDAQ
4665,13-02-2021 00:00,24 hrs.,SPACs,CMLFW,2441,0,2441,-2441,1,55,2327,1,NASDAQ
4665,13-02-2021 00:00,24 hrs.,SPACs,DSACW,2441,0,2441,-2441,1,55,2327,1,NASDAQ
4665,13-02-2021 00:00,24 hrs.,SPACs,EXPCW,2441,0,2441,-2441,1,55,2327,1,NASDAQ
4665,13-02-2021 00:00,24 hrs.,SPACs,FCACW,2441,0,2441,-2441,1,55,2327,1,NASDAQ
4665,13-02-2021 00:00,24 hrs.,SPACs,NBACR,5,5,0,5,1,0,1,1,NASDAQ
4665,13-02-2021 00:00,24 hrs.,SPACs,NBACW,5,5,0,5,1,0,1,1,NASDAQ
4665,13-02-2021 00:00,24 hrs.,SPACs,SAIIW,2441,0,2441,-2441,1,55,2327,1,NASDAQ
4665,13-02-2021 00:00,24 hrs.,SPACs,TWCTW,2441,0,2441,-2441,1,55,2327,1,NASDAQ
4665,13-02-2021 00:00,24 hrs.,stocks,ABML,6,6,0,6,1,1,0,1,OTC
4665,13-02-2021 00:00,24 hrs.,stocks,APTY,6,0,6,-6,1,1,0,1,OTC
4665,13-02-2021 00:00,24 hrs.,stocks,BLSP,6,6,0,6,1,1,0,1,OTC
4665,13-02-2021 00:00,24 hrs.,stocks,BONZ,6,6,0,6,1,1,0,1,OTC
4665,13-02-2021 00:00,24 hrs.,stocks,CAGR,25,0,25,-25,1,3,15,1,OTC
4665,13-02-2021 00:00,24 hrs.,stocks,CANN,6,6,0,6,1,1,0,1,OTC
4665,13-02-2021 00:00,24 hrs.,stocks,CAPC,6,6,0,6,1,1,0,1,OTC
4665,13-02-2021 00:00,24 hrs.,stocks,DIGI,6,0,6,-6,1,1,0,1,OTC
4665,13-02-2021 00:00,24 hrs.,stocks,ETCG,6,6,0,6,1,1,0,1,OTC
4665,13-02-2021 00:00,24 hrs.,stocks,FNMA,6,0,6,-6,1,1,0,1,OTC
4665,13-02-2021 00:00,24 hrs.,stocks,GRYN,6,6,0,6,1,1,0,1,OTC
4665,13-02-2021 00:00,24 hrs.,stocks,GTEH,6,6,0,6,1,1,0,1,OTC
4665,13-02-2021 00:00,24 hrs.,stocks,HCMC,12,6,6,0,2,2,0,2,OTC
4665,13-02-2021 00:00,24 hrs.,stocks,HEMP,6,0,6,-6,1,1,0,1,OTC
4665,13-02-2021 00:00,24 hrs.,stocks,IGEN,6,6,0,6,1,1,0,1,OTC
4665,13-02-2021 00:00,24 hrs.,stocks,KGKG,6,0,6,-6,1,1,0,1,OTC
4665,13-02-2021 00:00,24 hrs.,stocks,KYNC,18,0,18,-18,3,3,0,1,OTC
4665,13-02-2021 00:00,24 hrs.,stocks,LINK,10,10,0,10,1,2,2,1,OTC
4665,13-02-2021 00:00,24 hrs.,stocks,MCAP,6,6,0,6,1,1,0,1,OTC
4665,13-02-2021 00:00,24 hrs.,stocks,MINE,6,6,0,6,1,1,0,1,OTC
4665,13-02-2021 00:00,24 hrs.,stocks,MJNA,6,6,0,6,1,1,0,1,OTC
4665,13-02-2021 00:00,24 hrs.,stocks,MOJO,6,6,0,6,1,1,0,1,OTC
4665,13-02-2021 00:00,24 hrs.,stocks,NTRR,6,6,0,6,1,1,0,1,OTC
4665,13-02-2021 00:00,24 hrs.,stocks,OZSC,6,6,0,6,1,1,0,1,OTC
4665,13-02-2021 00:00,24 hrs.,stocks,PZOO,6,0,6,-6,1,1,0,1,OTC
4665,13-02-2021 00:00,24 hrs.,stocks,RSSV,15,15,0,15,1,4,3,1,OTC
4665,13-02-2021 00:00,24 hrs.,stocks,SNYR,6,6,0,6,1,1,0,1,OTC
4665,13-02-2021 00:00,24 hrs.,stocks,SSET,7,7,0,7,1,1,1,1,OTC
4665,13-02-2021 00:00,24 hrs.,stocks,SUIC,6,0,6,-6,1,1,0,1,OTC
4665,13-02-2021 00:00,24 hrs.,stocks,TMRC,6,6,0,6,1,1,0,1,OTC
4665,13-02-2021 00:00,24 hrs.,stocks,ACRDF,6,6,0,6,1,1,0,1,OTC
4665,13-02-2021 00:00,24 hrs.,stocks,ACRHF,6,6,0,6,1,1,0,1,OTC
4665,13-02-2021 00:00,24 hrs.,stocks,BDRBF,6,6,0,6,1,1,0,1,OTC
4665,13-02-2021 00:00,24 hrs.,stocks,CBWTF,12,0,12,-12,2,2,0,2,OTC
4665,13-02-2021 00:00,24 hrs.,stocks,DGTHF,6,6,0,6,1,1,0,1,OTC
4665,13-02-2021 00:00,24 hrs.,stocks,EMHTF,6,6,0,6,1,1,0,1,OTC
4665,13-02-2021 00:00,24 hrs.,stocks,HRSTW,6,6,0,6,1,1,0,1,OTC
4665,13-02-2021 00:00,24 hrs.,stocks,MMEDF,12,12,0,12,2,2,0,1,OTC
4665,13-02-2021 00:00,24 hrs.,stocks,MMNFF,6,0,6,-6,1,1,0,1,OTC
4665,13-02-2021 00:00,24 hrs.,stocks,NXTTF,6,6,0,6,1,1,0,1,OTC
4665,13-02-2021 00:00,24 hrs.,stocks,OILFF,6,6,0,6,1,1,0,1,OTC
4665,13-02-2021 00:00,24 hrs.,stocks,RHDGF,6,6,0,6,1,1,0,1,OTC
4665,13-02-2021 00:00,24 hrs.,stocks,RHHBY,25,25,0,25,1,8,5,1,OTC
4665,13-02-2021 00:00,24 hrs.,stocks,RLLCF,12,6,6,0,2,2,0,2,OTC
4665,13-02-2021 00:00,24 hrs.,stocks,RVVTF,13,13,0,13,2,2,1,2,OTC
4665,13-02-2021 00:00,24 hrs.,stocks,TBUIF,6,6,0,6,1,1,0,1,OTC
4665,13-02-2021 00:00,24 hrs.,stocks,DNN,37,31,6,25,2,8,13,2,AMEX
4665,13-02-2021 00:00,24 hrs.,stocks,DPW,12,0,12,-12,1,3,2,1,AMEX
4665,13-02-2021 00:00,24 hrs.,stocks,DSS,6,6,0,6,1,1,0,1,AMEX
4665,13-02-2021 00:00,24 hrs.,stocks,GDP,33,0,33,-33,1,5,19,1,AMEX
4665,13-02-2021 00:00,24 hrs.,stocks,GTE,6,6,0,6,1,1,0,1,AMEX
4665,13-02-2021 00:00,24 hrs.,stocks,IGC,6,6,0,6,1,1,0,1,AMEX
4665,13-02-2021 00:00,24 hrs.,stocks,MXC,6,0,6,-6,1,1,0,1,AMEX
4665,13-02-2021 00:00,24 hrs.,stocks,PLX,12,12,0,12,1,2,4,1,AMEX
4665,13-02-2021 00:00,24 hrs.,stocks,ZOM,24,6,18,-12,4,4,0,4,AMEX
4665,13-02-2021 00:00,24 hrs.,stocks,GSAT,6,6,0,6,1,1,0,1,AMEX
4665,13-02-2021 00:00,24 hrs.,stocks,TMBR,6,6,0,6,1,1,0,1,AMEX
4665,13-02-2021 00:00,24 hrs.,stocks,ACB,75,0,75,-75,2,19,29,2,NYSE
4665,13-02-2021 00:00,24 hrs.,stocks,ADT,6,6,0,6,1,1,0,1,NYSE
4665,13-02-2021 00:00,24 hrs.,stocks,AMC,177,78,99,-21,9,34,73,9,NYSE
4665,13-02-2021 00:00,24 hrs.,stocks,ASX,13,7,6,1,2,2,1,2,NYSE
4665,13-02-2021 00:00,24 hrs.,stocks,ATH,33,0,33,-33,1,5,19,1,NYSE
4665,13-02-2021 00:00,24 hrs.,stocks,BEP,150,150,0,150,5,31,68,5,NYSE
4665,13-02-2021 00:00,24 hrs.,stocks,BHC,10,10,0,10,1,2,2,1,NYSE
4665,13-02-2021 00:00,24 hrs.,stocks,BTT,6,0,6,-6,1,1,0,1,NYSE
4665,13-02-2021 00:00,24 hrs.,stocks,CBD,6,6,0,6,1,1,0,1,NYSE
4665,13-02-2021 00:00,24 hrs.,wallstreetbets,IPOE,13,7,6,1,2,2,1,2,NYSE
4665,13-02-2021 00:00,24 hrs.,wallstreetbets,JMIA,4664,4664,0,4664,8,2161,310,3,NYSE
4665,13-02-2021 00:00,24 hrs.,wallstreetbets,JNPR,6,6,0,6,1,1,0,1,NYSE
4665,13-02-2021 00:00,24 hrs.,wallstreetbets,KODK,13,13,0,13,2,2,1,1,NYSE
4665,13-02-2021 00:00,24 hrs.,wallstreetbets,LGVW,34,7,27,-20,5,5,4,4,NYSE
4665,13-02-2021 00:00,24 hrs.,wallstreetbets,LSPD,13,6,7,-1,2,2,1,2,NYSE
4665,13-02-2021 00:00,24 hrs.,wallstreetbets,MAIN,7,0,7,-7,1,1,1,1,NYSE
4665,13-02-2021 00:00,24 hrs.,wallstreetbets,MANU,12,12,0,12,2,2,0,2,NYSE
4665,13-02-2021 00:00,24 hrs.,wallstreetbets,PACK,15,15,0,15,2,2,3,1,NYSE
4665,13-02-2021 00:00,24 hrs.,wallstreetbets,PINS,7,0,7,-7,1,1,1,1,NYSE
4665,13-02-2021 00:00,24 hrs.,wallstreetbets,PLTR,2159,2044,115,1929,45,774,431,33,NYSE
4665,13-02-2021 00:00,24 hrs.,wallstreetbets,PRTY,14,14,0,14,2,2,2,2,NYSE
4665,13-02-2021 00:00,24 hrs.,wallstreetbets,PUMP,49,49,0,49,7,7,7,2,NYSE
4665,13-02-2021 00:00,24 hrs.,wallstreetbets,QUAD,8,0,8,-8,1,1,2,1,NYSE
4665,13-02-2021 00:00,24 hrs.,wallstreetbets,SAFE,99,99,0,99,1,23,49,1,NYSE
4665,13-02-2021 00:00,24 hrs.,wallstreetbets,SCVX,6,0,6,-6,1,1,0,1,NYSE
4665,13-02-2021 00:00,24 hrs.,wallstreetbets,SHOP,7,0,7,-7,1,1,1,1,NYSE
4665,13-02-2021 00:00,24 hrs.,wallstreetbets,SPCE,903,161,742,-581,27,300,195,17,NYSE
4665,13-02-2021 00:00,24 hrs.,wallstreetbets,STIC,7,7,0,7,1,1,1,1,NYSE
4665,13-02-2021 00:00,24 hrs.,wallstreetbets,STWD,142,142,0,142,1,39,60,1,NYSE
4665,13-02-2021 00:00,24 hrs.,wallstreetbets,TDOC,6,0,6,-6,1,1,0,1,NYSE
4665,13-02-2021 00:00,24 hrs.,wallstreetbets,TWTR,7,7,0,7,1,1,1,1,NYSE
4665,13-02-2021 00:00,24 hrs.,wallstreetbets,UBER,40,7,33,-26,6,6,4,3,NYSE
4665,13-02-2021 00:00,24 hrs.,wallstreetbets,VALE,7,7,0,7,1,1,1,1,NYSE
4665,13-02-2021 00:00,24 hrs.,wallstreetbets,VGAC,19,19,0,19,3,3,1,3,NYSE
4665,13-02-2021 00:00,24 hrs.,wallstreetbets,WORK,2901,14,2887,-2873,4,1208,469,4,NYSE
4665,13-02-2021 00:00,24 hrs.,wallstreetbets,XPEV,14,7,7,0,2,2,2,2,NYSE
4665,13-02-2021 00:00,24 hrs.,wallstreetbets,YELP,7,7,0,7,1,1,1,1,NYSE
4665,13-02-2021 00:00,24 hrs.,wallstreetbets,AAL,40,13,27,-14,6,6,4,5,NASDAQ
4665,13-02-2021 00:00,24 hrs.,wallstreetbets,AMD,2899,2164,735,1429,28,1012,763,24,NASDAQ
4665,13-02-2021 00:00,24 hrs.,wallstreetbets,AQB,6,0,6,-6,1,1,0,1,NASDAQ
4665,13-02-2021 00:00,24 hrs.,wallstreetbets,ASO,6,6,0,6,1,1,0,1,NASDAQ
4665,13-02-2021 00:00,24 hrs.,wallstreetbets,AZN,466,466,0,466,4,172,106,4,NASDAQ
4665,13-02-2021 00:00,24 hrs.,wallstreetbets,BFI,21,14,7,7,3,3,3,2,NASDAQ
4665,13-02-2021 00:00,24 hrs.,wallstreetbets,BLU,14,14,0,14,2,2,2,1,NASDAQ
4665,13-02-2021 00:00,24 hrs.,wallstreetbets,BUG,12,12,0,12,2,2,0,1,NASDAQ
4665,13-02-2021 00:00,24 hrs.,wallstreetbets,CDC,417,417,0,417,1,170,73,1,NASDAQ
4665,13-02-2021 00:00,24 hrs.,wallstreetbets,CGC,1381,75,1306,-1231,7,478,397,7,NASDAQ
4665,13-02-2021 00:00,24 hrs.,wallstreetbets,CTG,7,7,0,7,1,1,1,1,NASDAQ
4665,13-02-2021 00:00,24 hrs.,wallstreetbets,DBX,7,7,0,7,1,1,1,1,NASDAQ
4665,13-02-2021 00:00,24 hrs.,wallstreetbets,ESG,8,0,8,-8,1,1,2,1,NASDAQ
4665,13-02-2021 00:00,24 hrs.,wallstreetbets,FAT,147,147,0,147,2,41,57,2,NASDAQ
4665,13-02-2021 00:00,24 hrs.,wallstreetbets,FUV,7,7,0,7,1,1,1,1,NASDAQ
4665,13-02-2021 00:00,24 hrs.,wallstreetbets,FWP,14,14,0,14,2,2,2,1,NASDAQ
4665,13-02-2021 00:00,24 hrs.,wallstreetbets,GBT,7,7,0,7,1,1,1,1,NASDAQ
4665,13-02-2021 00:00,24 hrs.,wallstreetbets,GSM,19,13,6,7,3,3,1,3,NASDAQ
4665,13-02-2021 00:00,24 hrs.,wallstreetbets,HAS,20,0,20,-20,3,3,2,3,NASDAQ
4665,13-02-2021 00:00,24 hrs.,wallstreetbets,HPK,6,0,6,-6,1,1,0,1,NASDAQ
4665,13-02-2021 00:00,24 hrs.,wallstreetbets,IEA,7,7,0,7,1,1,1,1,NASDAQ
4665,13-02-2021 00:00,24 hrs.,wallstreetbets,III,122,0,122,-122,2,36,42,2,NASDAQ
4665,13-02-2021 00:00,24 hrs.,wallstreetbets,IIN,6,6,0,6,1,1,0,1,NASDAQ
4665,13-02-2021 00:00,24 hrs.,wallstreetbets,INO,811,117,694,-577,19,270,195,17,NASDAQ
4665,13-02-2021 00:00,24 hrs.,wallstreetbets,KHC,7,7,0,7,1,1,1,1,NASDAQ
4665,13-02-2021 00:00,24 hrs.,wallstreetbets,KOD,6,0,6,-6,1,1,0,1,NASDAQ
4665,13-02-2021 00:00,24 hrs.,wallstreetbets,MGI,9,0,9,-9,1,1,3,1,NASDAQ
4665,13-02-2021 00:00,24 hrs.,wallstreetbets,NPA,6,6,0,6,1,1,0,1,NASDAQ
4665,13-02-2021 00:00,24 hrs.,wallstreetbets,NWL,417,417,0,417,1,170,73,1,NASDAQ
4665,13-02-2021 00:00,24 hrs.,wallstreetbets,OGI,107,66,41,25,16,16,11,16,NASDAQ
4665,13-02-2021 00:00,24 hrs.,wallstreetbets,OPK,7,7,0,7,1,1,1,1,NASDAQ
4665,13-02-2021 00:00,24 hrs.,wallstreetbets,PTE,35,0,35,-35,5,5,5,1,NASDAQ
4665,13-02-2021 00:00,24 hrs.,wallstreetbets,RUN,138,131,7,124,4,38,46,4,NASDAQ
4665,13-02-2021 00:00,24 hrs.,wallstreetbets,RXT,7,7,0,7,1,1,1,1,NASDAQ
4665,13-02-2021 00:00,24 hrs.,wallstreetbets,SDC,7,7,0,7,1,1,1,1,NASDAQ
4665,13-02-2021 00:00,24 hrs.,wallstreetbets,SFT,7,7,0,7,1,1,1,1,NASDAQ
4665,13-02-2021 00:00,24 hrs.,wallstreetbets,SLM,8,8,0,8,1,1,2,1,NASDAQ
4665,13-02-2021 00:00,24 hrs.,wallstreetbets,SMH,7,7,0,7,1,1,1,1,NASDAQ
4665,13-02-2021 00:00,24 hrs.,wallstreetbets,SND,34,20,14,6,5,5,4,5,NASDAQ
4665,13-02-2021 00:00,24 hrs.,wallstreetbets,SPI,7,7,0,7,1,1,1,1,NASDAQ
4665,13-02-2021 00:00,24 hrs.,wallstreetbets,SPT,7,7,0,7,1,1,1,1,NASDAQ
4665,13-02-2021 00:00,24 hrs.,wallstreetbets,UAL,7,0,7,-7,1,1,1,1,NASDAQ
4665,13-02-2021 00:00,24 hrs.,wallstreetbets,UFO,6,0,6,-6,1,1,0,1,NASDAQ
4665,13-02-2021 00:00,24 hrs.,wallstreetbets,VFF,24,24,0,24,3,3,6,2,NASDAQ
4665,13-02-2021 00:00,24 hrs.,wallstreetbets,VRM,116,0,116,-116,1,35,42,1,NASDAQ
4665,13-02-2021 00:00,24 hrs.,wallstreetbets,WBA,7,7,0,7,1,1,1,1,NASDAQ
4665,13-02-2021 00:00,24 hrs.,wallstreetbets,WNW,43,43,0,43,6,6,7,5,NASDAQ
4665,13-02-2021 00:00,24 hrs.,wallstreetbets,WWR,6,6,0,6,1,1,0,1,NASDAQ
4665,13-02-2021 00:00,24 hrs.,wallstreetbets,AACG,7,7,0,7,1,1,1,1,NASDAQ
4665,13-02-2021 00:00,24 hrs.,wallstreetbets,AAPL,279,26,253,-227,7,78,95,7,NASDAQ
4665,13-02-2021 00:00,24 hrs.,wallstreetbets,AAWW,6,6,0,6,1,1,0,1,NASDAQ
4665,13-02-2021 00:00,24 hrs.,wallstreetbets,ABEO,7,7,0,7,1,1,1,1,NASDAQ
4665,13-02-2021 00:00,24 hrs.,wallstreetbets,ABIO,7,0,7,-7,1,1,1,1,NASDAQ
4665,13-02-2021 00:00,24 hrs.,wallstreetbets,ABNB,29,15,14,1,4,4,5,3,NASDAQ
4665,13-02-2021 00:00,24 hrs.,wallstreetbets,ABUS,7,7,0,7,1,1,1,1,NASDAQ
4665,13-02-2021 00:00,24 hrs.,wallstreetbets,ACEV,6,6,0,6,1,1,0,1,NASDAQ
4665,13-02-2021 00:00,24 hrs.,stocks,CIA,8814,0,8814,-8814,1,4119,572,1,NYSE
4665,13-02-2021 00:00,24 hrs.,stocks,CRM,6,6,0,6,1,1,0,1,NYSE
4665,13-02-2021 00:00,24 hrs.,stocks,CVE,6,6,0,6,1,1,0,1,NYSE
4665,13-02-2021 00:00,24 hrs.,stocks,CVS,34,34,0,34,3,6,10,3,NYSE
4665,13-02-2021 00:00,24 hrs.,stocks,DIS,10,10,0,10,1,2,2,1,NYSE
4665,13-02-2021 00:00,24 hrs.,stocks,ETH,6,6,0,6,1,1,0,1,NYSE
4665,13-02-2021 00:00,24 hrs.,stocks,FCF,33,0,33,-33,1,5,19,1,NYSE
4665,13-02-2021 00:00,24 hrs.,stocks,FCX,6,0,6,-6,1,1,0,1,NYSE
4665,13-02-2021 00:00,24 hrs.,stocks,FSR,30,6,24,-18,2,11,0,2,NYSE
4665,13-02-2021 00:00,24 hrs.,stocks,GME,824,560,264,296,19,237,274,17,NYSE
4665,13-02-2021 00:00,24 hrs.,stocks,IBM,9028,214,8814,-8600,2,4208,604,2,NYSE
4665,13-02-2021 00:00,24 hrs.,stocks,ICE,33,0,33,-33,1,5,19,1,NYSE
4665,13-02-2021 00:00,24 hrs.,stocks,IRS,61,0,61,-61,1,23,11,1,NYSE
4665,13-02-2021 00:00,24 hrs.,stocks,KEY,88,0,88,-88,1,34,16,1,NYSE
4665,13-02-2021 00:00,24 hrs.,stocks,KNL,23,0,23,-23,1,6,7,1,NYSE
4665,13-02-2021 00:00,24 hrs.,stocks,LEN,6,0,6,-6,1,1,0,1,NYSE
4665,13-02-2021 00:00,24 hrs.,stocks,LMT,6,0,6,-6,1,1,0,1,NYSE
4665,13-02-2021 00:00,24 hrs.,stocks,LUV,55,0,55,-55,1,12,27,1,NYSE
4665,13-02-2021 00:00,24 hrs.,stocks,MCO,10,10,0,10,1,2,2,1,NYSE
4665,13-02-2021 00:00,24 hrs.,stocks,MFA,8,0,8,-8,1,1,2,1,NYSE
4665,13-02-2021 00:00,24 hrs.,stocks,MGM,11,11,0,11,1,2,3,1,NYSE
4665,13-02-2021 00:00,24 hrs.,stocks,MRO,10,10,0,10,1,2,2,1,NYSE
4665,13-02-2021 00:00,24 hrs.,stocks,NET,11,11,0,11,1,1,5,1,NYSE
4665,13-02-2021 00:00,24 hrs.,stocks,NGL,6,6,0,6,1,1,0,1,NYSE
4665,13-02-2021 00:00,24 hrs.,stocks,NIO,744,744,0,744,9,230,248,6,NYSE
4665,13-02-2021 00:00,24 hrs.,stocks,NOK,131,131,0,131,3,20,79,3,NYSE
4665,13-02-2021 00:00,24 hrs.,stocks,NOM,76,76,0,76,1,28,16,1,NYSE
4665,13-02-2021 00:00,24 hrs.,stocks,NSA,8814,0,8814,-8814,1,4119,572,1,NYSE
4665,13-02-2021 00:00,24 hrs.,stocks,NVS,18,0,18,-18,3,3,0,1,NYSE
4665,13-02-2021 00:00,24 hrs.,stocks,OSK,15,15,0,15,2,1,5,1,NYSE
4665,13-02-2021 00:00,24 hrs.,stocks,PDT,6,0,6,-6,1,1,0,1,NYSE
4665,13-02-2021 00:00,24 hrs.,stocks,PEG,389,389,0,389,1,22,341,1,NYSE
4665,13-02-2021 00:00,24 hrs.,stocks,PFE,7,7,0,7,1,1,1,1,NYSE
4665,13-02-2021 00:00,24 hrs.,stocks,RAD,17,17,0,17,1,4,5,1,NYSE
4665,13-02-2021 00:00,24 hrs.,stocks,RDY,6,6,0,6,1,1,0,1,NYSE
4665,13-02-2021 00:00,24 hrs.,stocks,RKT,109,0,109,-109,1,44,17,1,NYSE
4665,13-02-2021 00:00,24 hrs.,stocks,RSI,23,0,23,-23,1,6,7,1,NYSE
4665,13-02-2021 00:00,24 hrs.,stocks,RTX,24,24,0,24,1,5,10,1,NYSE
4665,13-02-2021 00:00,24 hrs.,stocks,SBE,46,0,46,-46,2,18,2,2,NYSE
4665,13-02-2021 00:00,24 hrs.,stocks,SOI,6,0,6,-6,1,1,0,1,NYSE
4665,13-02-2021 00:00,24 hrs.,stocks,SOS,24,6,18,-12,4,4,0,4,NYSE
4665,13-02-2021 00:00,24 hrs.,stocks,SUP,6,6,0,6,1,1,0,1,NYSE
4665,13-02-2021 00:00,24 hrs.,stocks,TMO,7,0,7,-7,1,1,1,1,NYSE
4665,13-02-2021 00:00,24 hrs.,stocks,TSM,52,52,0,52,1,10,28,1,NYSE
4665,13-02-2021 00:00,24 hrs.,stocks,UBS,14206,14206,0,14206,1,6928,346,1,NYSE
4665,13-02-2021 00:00,24 hrs.,stocks,WLL,6,6,0,6,1,1,0,1,NYSE
4665,13-02-2021 00:00,24 hrs.,stocks,WMT,81,81,0,81,1,24,29,1,NYSE
4665,13-02-2021 00:00,24 hrs.,stocks,AJRD,81,81,0,81,1,24,29,1,NYSE
4665,13-02-2021 00:00,24 hrs.,stocks,ALSN,23,0,23,-23,1,6,7,1,NYSE
4665,13-02-2021 00:00,24 hrs.,stocks,APTV,81,81,0,81,1,24,29,1,NYSE
4665,13-02-2021 00:00,24 hrs.,stocks,BEPC,28,28,0,28,2,2,16,2,NYSE
4665,13-02-2021 00:00,24 hrs.,stocks,BORR,47,47,0,47,3,11,13,3,NYSE
4665,13-02-2021 00:00,24 hrs.,stocks,CACI,8814,0,8814,-8814,1,4119,572,1,NYSE
4665,13-02-2021 00:00,24 hrs.,stocks,CCIV,6,6,0,6,1,1,0,1,NYSE
4665,13-02-2021 00:00,24 hrs.,stocks,CHWY,19,19,0,19,1,5,5,1,NYSE
4665,13-02-2021 00:00,24 hrs.,stocks,COTY,6,6,0,6,1,1,0,1,NYSE
4665,13-02-2021 00:00,24 hrs.,stocks,FTCH,27,0,27,-27,1,5,13,1,NYSE
4665,13-02-2021 00:00,24 hrs.,stocks,FUSE,6,6,0,6,1,1,0,1,NYSE
4665,13-02-2021 00:00,24 hrs.,stocks,FVRR,27,0,27,-27,1,5,13,1,NYSE
4665,13-02-2021 00:00,24 hrs.,stocks,HEXO,6,6,0,6,1,1,0,1,NYSE
4665,13-02-2021 00:00,24 hrs.,stocks,HOME,19,19,0,19,1,5,5,1,NYSE
4665,13-02-2021 00:00,24 hrs.,stocks,HUYA,97,6,91,-85,2,34,21,2,NYSE
4665,13-02-2021 00:00,24 hrs.,stocks,JMIA,6,6,0,6,1,1,0,1,NYSE
4665,13-02-2021 00:00,24 hrs.,stocks,OTIS,23,0,23,-23,1,6,7,1,NYSE
4665,13-02-2021 00:00,24 hrs.,stocks,PLTR,358,352,6,346,4,111,120,4,NYSE
4665,13-02-2021 00:00,24 hrs.,stocks,SPCE,99,92,7,85,3,27,33,3,NYSE
4665,13-02-2021 00:00,24 hrs.,stocks,TWLO,15,15,0,15,2,1,5,1,NYSE
4665,13-02-2021 00:00,24 hrs.,stocks,TWTR,6,6,0,6,1,1,0,1,NYSE
4665,13-02-2021 00:00,24 hrs.,stocks,VGAC,6,6,0,6,1,1,0,1,NYSE
4665,13-02-2021 00:00,24 hrs.,stocks,VOYA,23,0,23,-23,1,6,7,1,NYSE
4665,13-02-2021 00:00,24 hrs.,stocks,XPEV,8893,79,8814,-8735,6,4133,603,3,NYSE
4665,13-02-2021 00:00,24 hrs.,stocks,YETI,55,0,55,-55,1,12,27,1,NYSE
4665,13-02-2021 00:00,24 hrs.,stocks,AAL,53,0,53,-53,2,7,31,2,NASDAQ
4665,13-02-2021 00:00,24 hrs.,stocks,AMD,52,52,0,52,1,10,28,1,NASDAQ
4665,13-02-2021 00:00,24 hrs.,stocks,AZN,10,10,0,10,1,2,2,1,NASDAQ
4665,13-02-2021 00:00,24 hrs.,stocks,CDC,10,10,0,10,1,2,2,1,NASDAQ
4665,13-02-2021 00:00,24 hrs.,stocks,FTC,33,33,0,33,1,10,9,1,NASDAQ
4665,13-02-2021 00:00,24 hrs.,stocks,GAN,7,7,0,7,1,1,1,1,NASDAQ
4665,13-02-2021 00:00,24 hrs.,stocks,GSM,50,50,0,50,2,16,10,1,NASDAQ
4665,13-02-2021 00:00,24 hrs.,stocks,IEA,20,20,0,20,1,5,6,1,NASDAQ
4665,13-02-2021 00:00,24 hrs.,stocks,INO,6,6,0,6,1,1,0,1,NASDAQ
4665,13-02-2021 00:00,24 hrs.,stocks,JFU,6,0,6,-6,1,1,0,1,NASDAQ
4665,13-02-2021 00:00,24 hrs.,stocks,KHC,6,0,6,-6,1,1,0,1,NASDAQ
4665,13-02-2021 00:00,24 hrs.,stocks,LNT,23,0,23,-23,1,6,7,1,NASDAQ
4665,13-02-2021 00:00,24 hrs.,stocks,MIK,6,0,6,-6,1,1,0,1,NASDAQ
4665,13-02-2021 00:00,24 hrs.,stocks,NWL,10,10,0,10,1,2,2,1,NASDAQ
4665,13-02-2021 00:00,24 hrs.,stocks,OGI,31,12,19,-7,5,5,1,5,NASDAQ
4665,13-02-2021 00:00,24 hrs.,stocks,OLB,6,0,6,-6,1,1,0,1,NASDAQ
4665,13-02-2021 00:00,24 hrs.,stocks,PEP,14,14,0,14,1,2,6,1,NASDAQ
4665,13-02-2021 00:00,24 hrs.,stocks,WBA,17,17,0,17,1,4,5,1,NASDAQ
4665,13-02-2021 00:00,24 hrs.,stocks,AAPL,58,0,58,-58,1,11,32,1,NASDAQ
4665,13-02-2021 00:00,24 hrs.,stocks,ABIO,6,0,6,-6,1,1,0,1,NASDAQ
4665,13-02-2021 00:00,24 hrs.,stocks,ABUS,6,6,0,6,1,1,0,1,NASDAQ
4665,13-02-2021 00:00,24 hrs.,stocks,AEZS,159,159,0,159,1,70,15,1,NASDAQ
4665,13-02-2021 00:00,24 hrs.,stocks,AGEN,10,10,0,10,1,3,0,1,NASDAQ
4665,13-02-2021 00:00,24 hrs.,wallstreetbets,ACIU,7,7,0,7,1,1,1,1,NASDAQ
4665,13-02-2021 00:00,24 hrs.,wallstreetbets,ACST,20,20,0,20,3,3,2,3,NASDAQ
4665,13-02-2021 00:00,24 hrs.,wallstreetbets,ADMA,7,7,0,7,1,1,1,1,NASDAQ
4665,13-02-2021 00:00,24 hrs.,wallstreetbets,ADMP,7,7,0,7,1,1,1,1,NASDAQ
4665,13-02-2021 00:00,24 hrs.,wallstreetbets,ADXS,6,6,0,6,1,1,0,1,NASDAQ
4665,13-02-2021 00:00,24 hrs.,wallstreetbets,AEZS,14,14,0,14,2,2,2,1,NASDAQ
4665,13-02-2021 00:00,24 hrs.,wallstreetbets,AGEN,7,7,0,7,1,1,1,1,NASDAQ
4665,13-02-2021 00:00,24 hrs.,wallstreetbets,AGTC,43,36,7,29,6,6,7,4,NASDAQ
4665,13-02-2021 00:00,24 hrs.,wallstreetbets,AIKI,7,7,0,7,1,1,1,1,NASDAQ
4665,13-02-2021 00:00,24 hrs.,wallstreetbets,AKBA,7,7,0,7,1,1,1,1,NASDAQ
4665,13-02-2021 00:00,24 hrs.,wallstreetbets,ALRN,7,7,0,7,1,1,1,1,NASDAQ
4665,13-02-2021 00:00,24 hrs.,wallstreetbets,AMAT,32,13,19,-6,5,5,2,4,NASDAQ
4665,13-02-2021 00:00,24 hrs.,wallstreetbets,AMBC,8,8,0,8,1,1,2,1,NASDAQ
4665,13-02-2021 00:00,24 hrs.,wallstreetbets,AMKR,21,21,0,21,3,3,3,3,NASDAQ
4665,13-02-2021 00:00,24 hrs.,wallstreetbets,AMZN,942,116,826,-710,8,381,148,7,NASDAQ
4665,13-02-2021 00:00,24 hrs.,wallstreetbets,ANCN,7,7,0,7,1,1,1,1,NASDAQ
4665,13-02-2021 00:00,24 hrs.,wallstreetbets,APEN,7,7,0,7,1,1,1,1,NASDAQ
4665,13-02-2021 00:00,24 hrs.,wallstreetbets,APHA,80033,288,79745,-79457,64,37532,4713,52,NASDAQ
4665,13-02-2021 00:00,24 hrs.,wallstreetbets,APRE,7,7,0,7,1,1,1,1,NASDAQ
4665,13-02-2021 00:00,24 hrs.,wallstreetbets,APXT,29,0,29,-29,4,4,5,3,NASDAQ
4665,13-02-2021 00:00,24 hrs.,wallstreetbets,AQMS,7,0,7,-7,1,1,1,1,NASDAQ
4665,13-02-2021 00:00,24 hrs.,wallstreetbets,AQST,13,7,6,1,2,2,1,2,NASDAQ
4665,13-02-2021 00:00,24 hrs.,wallstreetbets,ARTL,89,82,7,75,13,13,11,11,NASDAQ
4665,13-02-2021 00:00,24 hrs.,wallstreetbets,ASML,12,0,12,-12,2,2,0,1,NASDAQ
4665,13-02-2021 00:00,24 hrs.,wallstreetbets,ASRT,41,41,0,41,6,6,5,6,NASDAQ
4665,13-02-2021 00:00,24 hrs.,wallstreetbets,ASYS,6,6,0,6,1,1,0,1,NASDAQ
4665,13-02-2021 00:00,24 hrs.,wallstreetbets,ATHA,7,7,0,7,1,1,1,1,NASDAQ
4665,13-02-2021 00:00,24 hrs.,wallstreetbets,ATHE,12,12,0,12,2,2,0,1,NASDAQ
4665,13-02-2021 00:00,24 hrs.,wallstreetbets,ATHX,7,0,7,-7,1,1,1,1,NASDAQ
4665,13-02-2021 00:00,24 hrs.,wallstreetbets,ATOS,41,34,7,27,6,6,5,5,NASDAQ
4665,13-02-2021 00:00,24 hrs.,wallstreetbets,ATVI,7,7,0,7,1,1,1,1,NASDAQ
4665,13-02-2021 00:00,24 hrs.,wallstreetbets,AUPH,6,6,0,6,1,1,0,1,NASDAQ
4665,13-02-2021 00:00,24 hrs.,wallstreetbets,AUTL,14,0,14,-14,2,2,2,1,NASDAQ
4665,13-02-2021 00:00,24 hrs.,wallstreetbets,AVXL,7,7,0,7,1,1,1,1,NASDAQ
4665,13-02-2021 00:00,24 hrs.,wallstreetbets,AWRE,7,7,0,7,1,1,1,1,NASDAQ
4665,13-02-2021 00:00,24 hrs.,wallstreetbets,AXDX,21,0,21,-21,3,3,3,1,NASDAQ
4665,13-02-2021 00:00,24 hrs.,wallstreetbets,AYRO,7,0,7,-7,1,1,1,1,NASDAQ
4665,13-02-2021 00:00,24 hrs.,wallstreetbets,BBBY,7,7,0,7,1,1,1,1,NASDAQ
4665,13-02-2021 00:00,24 hrs.,wallstreetbets,BEAT,14,8,6,2,2,3,0,2,NASDAQ
4665,13-02-2021 00:00,24 hrs.,wallstreetbets,BIGC,35,0,35,-35,5,5,5,2,NASDAQ
4665,13-02-2021 00:00,24 hrs.,wallstreetbets,BIOC,7,0,7,-7,1,1,1,1,NASDAQ
4665,13-02-2021 00:00,24 hrs.,wallstreetbets,BIVI,6,6,0,6,1,1,0,1,NASDAQ
4665,13-02-2021 00:00,24 hrs.,wallstreetbets,BLCM,6,6,0,6,1,1,0,1,NASDAQ
4665,13-02-2021 00:00,24 hrs.,wallstreetbets,BLNK,7,7,0,7,1,1,1,1,NASDAQ
4665,13-02-2021 00:00,24 hrs.,wallstreetbets,BNGO,148,141,7,134,21,22,20,12,NASDAQ
4665,13-02-2021 00:00,24 hrs.,wallstreetbets,BNTX,13,13,0,13,2,2,1,1,NASDAQ
4665,13-02-2021 00:00,24 hrs.,wallstreetbets,BOXL,7,7,0,7,1,1,1,1,NASDAQ
4665,13-02-2021 00:00,24 hrs.,wallstreetbets,BPTH,7,0,7,-7,1,1,1,1,NASDAQ
4665,13-02-2021 00:00,24 hrs.,wallstreetbets,BRQS,13,6,7,-1,2,2,1,2,NASDAQ
4665,13-02-2021 00:00,24 hrs.,wallstreetbets,BTWN,7,7,0,7,1,1,1,1,NASDAQ
4665,13-02-2021 00:00,24 hrs.,wallstreetbets,CARE,49,49,0,49,7,7,7,2,NASDAQ
4665,13-02-2021 00:00,24 hrs.,wallstreetbets,CARV,14,7,7,0,2,2,2,2,NASDAQ
4665,13-02-2021 00:00,24 hrs.,wallstreetbets,CASH,14,14,0,14,2,2,2,1,NASDAQ
4665,13-02-2021 00:00,24 hrs.,wallstreetbets,CATM,7,7,0,7,1,1,1,1,NASDAQ
4665,13-02-2021 00:00,24 hrs.,wallstreetbets,CBAT,7,7,0,7,1,1,1,1,NASDAQ
4665,13-02-2021 00:00,24 hrs.,wallstreetbets,CCRC,12,12,0,12,2,2,0,1,NASDAQ
4665,13-02-2021 00:00,24 hrs.,wallstreetbets,CGIX,14,0,14,-14,2,2,2,1,NASDAQ
4665,13-02-2021 00:00,24 hrs.,wallstreetbets,CIDM,21,21,0,21,3,3,3,3,NASDAQ
4665,13-02-2021 00:00,24 hrs.,wallstreetbets,CKPT,14,7,7,0,2,2,2,2,NASDAQ
4665,13-02-2021 00:00,24 hrs.,wallstreetbets,CLBS,14,14,0,14,2,2,2,1,NASDAQ
4665,13-02-2021 00:00,24 hrs.,wallstreetbets,CLEU,7,0,7,-7,1,1,1,1,NASDAQ
4665,13-02-2021 00:00,24 hrs.,wallstreetbets,CLGN,7,7,0,7,1,1,1,1,NASDAQ
4665,13-02-2021 00:00,24 hrs.,wallstreetbets,CLSN,7,7,0,7,1,1,1,1,NASDAQ
4665,13-02-2021 00:00,24 hrs.,wallstreetbets,CLVS,14,0,14,-14,2,2,2,1,NASDAQ
4665,13-02-2021 00:00,24 hrs.,wallstreetbets,CMLF,7,0,7,-7,1,1,1,1,NASDAQ
4665,13-02-2021 00:00,24 hrs.,wallstreetbets,CMPS,2923,28,2895,-2867,7,1211,473,6,NASDAQ
4665,13-02-2021 00:00,24 hrs.,wallstreetbets,CNDT,6,6,0,6,1,1,0,1,NASDAQ
4665,13-02-2021 00:00,24 hrs.,wallstreetbets,CNSP,7,0,7,-7,1,1,1,1,NASDAQ
4665,13-02-2021 00:00,24 hrs.,wallstreetbets,COCP,7,7,0,7,1,1,1,1,NASDAQ
4665,13-02-2021 00:00,24 hrs.,wallstreetbets,CODX,7,0,7,-7,1,1,1,1,NASDAQ
4665,13-02-2021 00:00,24 hrs.,wallstreetbets,COHR,417,417,0,417,1,170,73,1,NASDAQ
4665,13-02-2021 00:00,24 hrs.,wallstreetbets,CRBP,28,21,7,14,4,4,4,4,NASDAQ
4665,13-02-2021 00:00,24 hrs.,wallstreetbets,CRNT,13,7,6,1,2,2,1,2,NASDAQ
4665,13-02-2021 00:00,24 hrs.,wallstreetbets,CRON,20,20,0,20,3,3,2,3,NASDAQ
4665,13-02-2021 00:00,24 hrs.,wallstreetbets,CRSR,5655,251,5404,-5153,12,2442,723,8,NASDAQ
4665,13-02-2021 00:00,24 hrs.,wallstreetbets,CTHR,7,7,0,7,1,1,1,1,NASDAQ
4665,13-02-2021 00:00,24 hrs.,wallstreetbets,CTMX,7,7,0,7,1,1,1,1,NASDAQ
4665,13-02-2021 00:00,24 hrs.,wallstreetbets,CTRM,328,212,116,96,48,48,40,41,NASDAQ
4665,13-02-2021 00:00,24 hrs.,wallstreetbets,DBVT,8,0,8,-8,1,1,2,1,NASDAQ
4665,13-02-2021 00:00,24 hrs.,wallstreetbets,DDOG,417,417,0,417,1,170,73,1,NASDAQ
4665,13-02-2021 00:00,24 hrs.,wallstreetbets,DFFN,14,14,0,14,2,2,2,1,NASDAQ
4665,13-02-2021 00:00,24 hrs.,wallstreetbets,DKNG,20,14,6,8,3,3,2,3,NASDAQ
4665,13-02-2021 00:00,24 hrs.,wallstreetbets,DOYU,7,7,0,7,1,1,1,1,NASDAQ
4665,13-02-2021 00:00,24 hrs.,stocks,AGTC,18,12,6,6,3,3,0,2,NASDAQ
4665,13-02-2021 00:00,24 hrs.,stocks,AMZN,81,81,0,81,1,24,29,1,NASDAQ
4665,13-02-2021 00:00,24 hrs.,stocks,APHA,1066,749,317,432,9,324,382,9,NASDAQ
4665,13-02-2021 00:00,24 hrs.,stocks,APXT,6,0,6,-6,1,1,0,1,NASDAQ
4665,13-02-2021 00:00,24 hrs.,stocks,ARTL,18,18,0,18,3,3,0,2,NASDAQ
4665,13-02-2021 00:00,24 hrs.,stocks,ASYS,6,6,0,6,1,1,0,1,NASDAQ
4665,13-02-2021 00:00,24 hrs.,stocks,ATOS,159,159,0,159,1,70,15,1,NASDAQ
4665,13-02-2021 00:00,24 hrs.,stocks,AVGO,6,6,0,6,1,1,0,1,NASDAQ
4665,13-02-2021 00:00,24 hrs.,stocks,BNGO,6,6,0,6,1,1,0,1,NASDAQ
4665,13-02-2021 00:00,24 hrs.,stocks,BYND,6,6,0,6,1,1,0,1,NASDAQ
4665,13-02-2021 00:00,24 hrs.,stocks,CLEU,7,0,7,-7,1,1,1,1,NASDAQ
4665,13-02-2021 00:00,24 hrs.,stocks,CLSK,47,0,47,-47,2,13,13,2,NASDAQ
4665,13-02-2021 00:00,24 hrs.,stocks,CMPS,12,0,12,-12,2,2,0,1,NASDAQ
4665,13-02-2021 00:00,24 hrs.,stocks,CNDT,17,0,17,-17,1,4,5,1,NASDAQ
4665,13-02-2021 00:00,24 hrs.,stocks,COHR,10,10,0,10,1,2,2,1,NASDAQ
4665,13-02-2021 00:00,24 hrs.,stocks,CPST,6,6,0,6,1,1,0,1,NASDAQ
4665,13-02-2021 00:00,24 hrs.,stocks,CRBP,7,7,0,7,1,1,1,1,NASDAQ
4665,13-02-2021 00:00,24 hrs.,stocks,CREE,6,0,6,-6,1,1,0,1,NASDAQ
4665,13-02-2021 00:00,24 hrs.,stocks,CRON,31,31,0,31,1,6,15,1,NASDAQ
4665,13-02-2021 00:00,24 hrs.,stocks,CRSP,81,81,0,81,1,24,29,1,NASDAQ
4665,13-02-2021 00:00,24 hrs.,stocks,CRWD,81,81,0,81,1,24,29,1,NASDAQ
4665,13-02-2021 00:00,24 hrs.,stocks,CTRM,45,13,32,-19,7,7,3,6,NASDAQ
4665,13-02-2021 00:00,24 hrs.,stocks,CVLB,6,0,6,-6,1,1,0,1,NASDAQ
4665,13-02-2021 00:00,24 hrs.,stocks,DDOG,10,10,0,10,1,2,2,1,NASDAQ
4665,13-02-2021 00:00,24 hrs.,stocks,DFFN,15,6,9,-3,2,3,1,2,NASDAQ
4665,13-02-2021 00:00,24 hrs.,stocks,DMTK,25,0,25,-25,1,3,15,1,NASDAQ
4665,13-02-2021 00:00,24 hrs.,stocks,DOCU,6,6,0,6,1,1,0,1,NASDAQ
4665,13-02-2021 00:00,24 hrs.,stocks,EDIT,378,378,0,378,3,125,116,3,NASDAQ
4665,13-02-2021 00:00,24 hrs.,stocks,ENPH,81,81,0,81,1,24,29,1,NASDAQ
4665,13-02-2021 00:00,24 hrs.,stocks,ENTX,7,0,7,-7,1,1,1,1,NASDAQ
4665,13-02-2021 00:00,24 hrs.,stocks,ETSY,27,0,27,-27,1,5,13,1,NASDAQ
4665,13-02-2021 00:00,24 hrs.,stocks,EVFM,22,0,22,-22,2,7,0,2,NASDAQ
4665,13-02-2021 00:00,24 hrs.,stocks,EXAS,25,0,25,-25,1,3,15,1,NASDAQ
4665,13-02-2021 00:00,24 hrs.,stocks,EXPE,10,10,0,10,1,2,2,1,NASDAQ
4665,13-02-2021 00:00,24 hrs.,stocks,EXPI,6,6,0,6,1,1,0,1,NASDAQ
4665,13-02-2021 00:00,24 hrs.,stocks,FLXN,23,0,23,-23,1,6,7,1,NASDAQ
4665,13-02-2021 00:00,24 hrs.,stocks,FNKO,20,20,0,20,1,7,2,1,NASDAQ
4665,13-02-2021 00:00,24 hrs.,stocks,FSRV,6,0,6,-6,1,1,0,1,NASDAQ
4665,13-02-2021 00:00,24 hrs.,stocks,GILT,6,6,0,6,1,1,0,1,NASDAQ
4665,13-02-2021 00:00,24 hrs.,stocks,GLUU,7,7,0,7,1,1,1,1,NASDAQ
4665,13-02-2021 00:00,24 hrs.,stocks,GNUS,6,0,6,-6,1,1,0,1,NASDAQ
4665,13-02-2021 00:00,24 hrs.,stocks,GOEV,118,118,0,118,1,18,78,1,NASDAQ
4665,13-02-2021 00:00,24 hrs.,stocks,HTBX,6,0,6,-6,1,1,0,1,NASDAQ
4665,13-02-2021 00:00,24 hrs.,stocks,ICLN,89,89,0,89,1,27,31,1,NASDAQ
4665,13-02-2021 00:00,24 hrs.,stocks,IIVI,10,10,0,10,1,2,2,1,NASDAQ
4665,13-02-2021 00:00,24 hrs.,stocks,ILMN,21,21,0,21,1,8,1,1,NASDAQ
4665,13-02-2021 00:00,24 hrs.,stocks,INPX,18,0,18,-18,3,3,0,1,NASDAQ
4665,13-02-2021 00:00,24 hrs.,stocks,INTC,100,100,0,100,1,33,30,1,NASDAQ
4665,13-02-2021 00:00,24 hrs.,stocks,INVE,7,7,0,7,1,1,1,1,NASDAQ
4665,13-02-2021 00:00,24 hrs.,stocks,ITRM,9,9,0,9,1,2,1,1,NASDAQ
4665,13-02-2021 00:00,24 hrs.,stocks,KPTI,23,0,23,-23,1,6,7,1,NASDAQ
4665,13-02-2021 00:00,24 hrs.,stocks,LITE,10,10,0,10,1,2,2,1,NASDAQ
4665,13-02-2021 00:00,24 hrs.,stocks,LIVE,10,10,0,10,1,2,2,1,NASDAQ
4665,13-02-2021 00:00,24 hrs.,stocks,LKCO,12,12,0,12,2,2,0,1,NASDAQ
4665,13-02-2021 00:00,24 hrs.,stocks,LLNW,19,19,0,19,1,3,9,1,NASDAQ
4665,13-02-2021 00:00,24 hrs.,stocks,LMPX,20,20,0,20,1,7,2,1,NASDAQ
4665,13-02-2021 00:00,24 hrs.,stocks,LRCX,52,52,0,52,1,10,28,1,NASDAQ
4665,13-02-2021 00:00,24 hrs.,stocks,MGNI,58,0,58,-58,1,11,32,1,NASDAQ
4665,13-02-2021 00:00,24 hrs.,stocks,MITK,6,6,0,6,1,1,0,1,NASDAQ
4665,13-02-2021 00:00,24 hrs.,stocks,MKSI,10,10,0,10,1,2,2,1,NASDAQ
4665,13-02-2021 00:00,24 hrs.,stocks,MNPR,6,0,6,-6,1,1,0,1,NASDAQ
4665,13-02-2021 00:00,24 hrs.,stocks,MSFT,299,214,85,129,3,105,77,3,NASDAQ
4665,13-02-2021 00:00,24 hrs.,stocks,NAKD,6,6,0,6,1,1,0,1,NASDAQ
4665,13-02-2021 00:00,24 hrs.,stocks,NBAC,6,6,0,6,1,1,0,1,NASDAQ
4665,13-02-2021 00:00,24 hrs.,stocks,NCMI,58,58,0,58,2,21,8,1,NASDAQ
4665,13-02-2021 00:00,24 hrs.,stocks,NKLA,6,6,0,6,1,1,0,1,NASDAQ
4665,13-02-2021 00:00,24 hrs.,stocks,NMTR,9,9,0,9,1,1,3,1,NASDAQ
4665,13-02-2021 00:00,24 hrs.,stocks,NVDA,177,92,85,7,5,36,85,5,NASDAQ
4665,13-02-2021 00:00,24 hrs.,stocks,NXTD,12,0,12,-12,2,2,0,1,NASDAQ
4665,13-02-2021 00:00,24 hrs.,stocks,NYMT,8,0,8,-8,1,1,2,1,NASDAQ
4665,13-02-2021 00:00,24 hrs.,stocks,OCSL,12,12,0,12,2,2,0,1,NASDAQ
4665,13-02-2021 00:00,24 hrs.,stocks,OLED,100,100,0,100,1,44,8,1,NASDAQ
4665,13-02-2021 00:00,24 hrs.,stocks,ONTX,6,6,0,6,1,1,0,1,NASDAQ
4665,13-02-2021 00:00,24 hrs.,stocks,ONVO,6,6,0,6,1,1,0,1,NASDAQ
4665,13-02-2021 00:00,24 hrs.,stocks,OPRX,25,0,25,-25,1,3,15,1,NASDAQ
4665,13-02-2021 00:00,24 hrs.,stocks,PAAS,6,6,0,6,1,1,0,1,NASDAQ
4665,13-02-2021 00:00,24 hrs.,stocks,PENN,7,0,7,-7,1,1,1,1,NASDAQ
4665,13-02-2021 00:00,24 hrs.,stocks,PGNY,25,0,25,-25,1,3,15,1,NASDAQ
4665,13-02-2021 00:00,24 hrs.,stocks,PHUN,6,6,0,6,1,1,0,1,NASDAQ
4665,13-02-2021 00:00,24 hrs.,stocks,PLUG,124,124,0,124,2,19,78,2,NASDAQ
4665,13-02-2021 00:00,24 hrs.,stocks,PSTV,6,6,0,6,1,1,0,1,NASDAQ
4665,13-02-2021 00:00,24 hrs.,stocks,QCLN,89,89,0,89,1,27,31,1,NASDAQ
4665,13-02-2021 00:00,24 hrs.,stocks,QCOM,14,0,14,-14,2,2,2,1,NASDAQ
4665,13-02-2021 00:00,24 hrs.,stocks,QFIN,6,6,0,6,1,1,0,1,NASDAQ
4665,13-02-2021 00:00,24 hrs.,stocks,QQQM,31,0,31,-31,1,6,15,1,NASDAQ
4665,13-02-2021 00:00,24 hrs.,stocks,RGEN,25,0,25,-25,1,3,15,1,NASDAQ
4665,13-02-2021 00:00,24 hrs.,stocks,SABR,55,0,55,-55,1,12,27,1,NASDAQ
4665,13-02-2021 00:00,24 hrs.,stocks,SEDG,81,81,0,81,1,24,29,1,NASDAQ
4665,13-02-2021 00:00,24 hrs.,stocks,SEEL,18,0,18,-18,3,3,0,2,NASDAQ
4665,13-02-2021 00:00,24 hrs.,stocks,SESN,7,7,0,7,1,1,1,1,NASDAQ
4665,13-02-2021 00:00,24 hrs.,stocks,SHIP,11,11,0,11,1,2,3,1,NASDAQ
4665,13-02-2021 00:00,24 hrs.,stocks,SNDL,61,30,31,-1,10,10,1,9,NASDAQ
4665,13-02-2021 00:00,24 hrs.,wallstreetbets,DRRX,7,7,0,7,1,1,1,1,NASDAQ
4665,13-02-2021 00:00,24 hrs.,wallstreetbets,DSKE,7,7,0,7,1,1,1,1,NASDAQ
4665,13-02-2021 00:00,24 hrs.,wallstreetbets,DXYN,7,7,0,7,1,1,1,1,NASDAQ
4665,13-02-2021 00:00,24 hrs.,wallstreetbets,EBAY,116,0,116,-116,1,35,42,1,NASDAQ
4665,13-02-2021 00:00,24 hrs.,wallstreetbets,EBON,56,56,0,56,8,8,8,4,NASDAQ
4665,13-02-2021 00:00,24 hrs.,wallstreetbets,EDIT,4565,3287,1278,2009,2,1981,595,2,NASDAQ
4665,13-02-2021 00:00,24 hrs.,wallstreetbets,EDSA,6,6,0,6,1,1,0,1,NASDAQ
4665,13-02-2021 00:00,24 hrs.,wallstreetbets,EHTH,7,7,0,7,1,1,1,1,NASDAQ
4665,13-02-2021 00:00,24 hrs.,wallstreetbets,ELSE,7,7,0,7,1,1,1,1,NASDAQ
4665,13-02-2021 00:00,24 hrs.,wallstreetbets,ENLV,6,6,0,6,1,1,0,1,NASDAQ
4665,13-02-2021 00:00,24 hrs.,wallstreetbets,ENVB,33,26,7,19,5,5,3,4,NASDAQ
4665,13-02-2021 00:00,24 hrs.,wallstreetbets,ERIC,7,0,7,-7,1,1,1,1,NASDAQ
4665,13-02-2021 00:00,24 hrs.,wallstreetbets,ESPR,7,0,7,-7,1,1,1,1,NASDAQ
4665,13-02-2021 00:00,24 hrs.,wallstreetbets,ETSY,122,0,122,-122,2,36,42,2,NASDAQ
4665,13-02-2021 00:00,24 hrs.,wallstreetbets,EVER,27,21,6,15,4,4,3,4,NASDAQ
4665,13-02-2021 00:00,24 hrs.,wallstreetbets,EXPC,7,7,0,7,1,1,1,1,NASDAQ
4665,13-02-2021 00:00,24 hrs.,wallstreetbets,EXPE,417,417,0,417,1,170,73,1,NASDAQ
4665,13-02-2021 00:00,24 hrs.,wallstreetbets,EYES,26,0,26,-26,4,4,2,1,NASDAQ
4665,13-02-2021 00:00,24 hrs.,wallstreetbets,FAMI,6,6,0,6,1,1,0,1,NASDAQ
4665,13-02-2021 00:00,24 hrs.,wallstreetbets,FANG,7,0,7,-7,1,1,1,1,NASDAQ
4665,13-02-2021 00:00,24 hrs.,wallstreetbets,FARM,7,7,0,7,1,1,1,1,NASDAQ
4665,13-02-2021 00:00,24 hrs.,wallstreetbets,FAST,7,7,0,7,1,1,1,1,NASDAQ
4665,13-02-2021 00:00,24 hrs.,wallstreetbets,FCAC,8,8,0,8,1,1,2,1,NASDAQ
4665,13-02-2021 00:00,24 hrs.,wallstreetbets,FCEL,6,6,0,6,1,1,0,1,NASDAQ
4665,13-02-2021 00:00,24 hrs.,wallstreetbets,FLDM,7,0,7,-7,1,1,1,1,NASDAQ
4665,13-02-2021 00:00,24 hrs.,wallstreetbets,FLGT,13,13,0,13,2,2,1,2,NASDAQ
4665,13-02-2021 00:00,24 hrs.,wallstreetbets,FLWS,15,15,0,15,2,2,3,2,NASDAQ
4665,13-02-2021 00:00,24 hrs.,wallstreetbets,FOLD,48,48,0,48,7,7,6,6,NASDAQ
4665,13-02-2021 00:00,24 hrs.,wallstreetbets,FORD,7,7,0,7,1,1,1,1,NASDAQ
4665,13-02-2021 00:00,24 hrs.,wallstreetbets,FORM,108,108,0,108,1,41,22,1,NASDAQ
4665,13-02-2021 00:00,24 hrs.,wallstreetbets,FTFT,14,14,0,14,2,2,2,2,NASDAQ
4665,13-02-2021 00:00,24 hrs.,wallstreetbets,FUTU,849,849,0,849,1,326,193,1,NASDAQ
4665,13-02-2021 00:00,24 hrs.,wallstreetbets,GAIN,28,13,15,-2,4,4,4,4,NASDAQ
4665,13-02-2021 00:00,24 hrs.,wallstreetbets,GERN,13,6,7,-1,2,2,1,2,NASDAQ
4665,13-02-2021 00:00,24 hrs.,wallstreetbets,GEVO,191,184,7,177,10,50,51,8,NASDAQ
4665,13-02-2021 00:00,24 hrs.,wallstreetbets,GILT,14,14,0,14,2,2,2,2,NASDAQ
4665,13-02-2021 00:00,24 hrs.,wallstreetbets,GLBS,21,21,0,21,3,3,3,2,NASDAQ
4665,13-02-2021 00:00,24 hrs.,wallstreetbets,GLMD,21,14,7,7,3,3,3,2,NASDAQ
4665,13-02-2021 00:00,24 hrs.,wallstreetbets,GLPG,7,0,7,-7,1,1,1,1,NASDAQ
4665,13-02-2021 00:00,24 hrs.,wallstreetbets,GLUU,31,31,0,31,2,1,21,1,NASDAQ
4665,13-02-2021 00:00,24 hrs.,wallstreetbets,GMBL,7,7,0,7,1,1,1,1,NASDAQ
4665,13-02-2021 00:00,24 hrs.,wallstreetbets,GNOG,13,0,13,-13,2,2,1,2,NASDAQ
4665,13-02-2021 00:00,24 hrs.,wallstreetbets,GNRS,14,14,0,14,2,2,2,1,NASDAQ
4665,13-02-2021 00:00,24 hrs.,wallstreetbets,GNUS,13,13,0,13,2,2,1,2,NASDAQ
4665,13-02-2021 00:00,24 hrs.,wallstreetbets,GOEV,7,7,0,7,1,1,1,1,NASDAQ
4665,13-02-2021 00:00,24 hrs.,wallstreetbets,GOGO,50,31,19,12,8,8,2,4,NASDAQ
4665,13-02-2021 00:00,24 hrs.,wallstreetbets,GOLD,29,13,16,-3,4,4,5,4,NASDAQ
4665,13-02-2021 00:00,24 hrs.,wallstreetbets,GRIL,7,7,0,7,1,1,1,1,NASDAQ
4665,13-02-2021 00:00,24 hrs.,wallstreetbets,GRTS,6,6,0,6,1,1,0,1,NASDAQ
4665,13-02-2021 00:00,24 hrs.,wallstreetbets,GTEC,8,8,0,8,1,1,2,1,NASDAQ
4665,13-02-2021 00:00,24 hrs.,wallstreetbets,GTHX,37,37,0,37,6,6,1,4,NASDAQ
4665,13-02-2021 00:00,24 hrs.,wallstreetbets,GWPH,13,0,13,-13,1,0,9,1,NASDAQ
4665,13-02-2021 00:00,24 hrs.,wallstreetbets,HALO,14,14,0,14,2,2,2,2,NASDAQ
4665,13-02-2021 00:00,24 hrs.,wallstreetbets,HDSN,7,7,0,7,1,1,1,1,NASDAQ
4665,13-02-2021 00:00,24 hrs.,wallstreetbets,HEAR,6,6,0,6,1,1,0,1,NASDAQ
4665,13-02-2021 00:00,24 hrs.,wallstreetbets,HIMX,7,0,7,-7,1,1,1,1,NASDAQ
4665,13-02-2021 00:00,24 hrs.,wallstreetbets,HJLI,14,7,7,0,2,2,2,2,NASDAQ
4665,13-02-2021 00:00,24 hrs.,wallstreetbets,HSTO,26,19,7,12,4,4,2,3,NASDAQ
4665,13-02-2021 00:00,24 hrs.,wallstreetbets,HTBX,14,8,6,2,2,2,2,2,NASDAQ
4665,13-02-2021 00:00,24 hrs.,wallstreetbets,ICLN,6,6,0,6,1,1,0,1,NASDAQ
4665,13-02-2021 00:00,24 hrs.,wallstreetbets,ICON,7,7,0,7,1,1,1,1,NASDAQ
4665,13-02-2021 00:00,24 hrs.,wallstreetbets,ICPT,7,7,0,7,1,1,1,1,NASDAQ
4665,13-02-2021 00:00,24 hrs.,wallstreetbets,IDEX,190,155,35,120,8,46,66,6,NASDAQ
4665,13-02-2021 00:00,24 hrs.,wallstreetbets,IIVI,417,417,0,417,1,170,73,1,NASDAQ
4665,13-02-2021 00:00,24 hrs.,wallstreetbets,ILMN,7,7,0,7,1,1,1,1,NASDAQ
4665,13-02-2021 00:00,24 hrs.,wallstreetbets,IMGN,21,21,0,21,3,3,3,3,NASDAQ
4665,13-02-2021 00:00,24 hrs.,wallstreetbets,INFI,21,0,21,-21,3,3,3,1,NASDAQ
4665,13-02-2021 00:00,24 hrs.,wallstreetbets,INFO,8,0,8,-8,1,1,2,1,NASDAQ
4665,13-02-2021 00:00,24 hrs.,wallstreetbets,INPX,26,7,19,-12,4,4,2,3,NASDAQ
4665,13-02-2021 00:00,24 hrs.,wallstreetbets,INTC,132,125,7,118,3,2,116,3,NASDAQ
4665,13-02-2021 00:00,24 hrs.,wallstreetbets,IPWR,6,6,0,6,1,1,0,1,NASDAQ
4665,13-02-2021 00:00,24 hrs.,wallstreetbets,IRBT,7,0,7,-7,1,1,1,1,NASDAQ
4665,13-02-2021 00:00,24 hrs.,wallstreetbets,ITRM,35,35,0,35,5,5,5,3,NASDAQ
4665,13-02-2021 00:00,24 hrs.,wallstreetbets,JAGX,32,32,0,32,5,5,2,2,NASDAQ
4665,13-02-2021 00:00,24 hrs.,wallstreetbets,JBLU,12,0,12,-12,2,2,0,2,NASDAQ
4665,13-02-2021 00:00,24 hrs.,wallstreetbets,JNCE,12,6,6,0,2,2,0,2,NASDAQ
4665,13-02-2021 00:00,24 hrs.,wallstreetbets,KERN,7,0,7,-7,1,1,1,1,NASDAQ
4665,13-02-2021 00:00,24 hrs.,wallstreetbets,KOPN,15,15,0,15,2,2,3,2,NASDAQ
4665,13-02-2021 00:00,24 hrs.,wallstreetbets,KOSS,131,131,0,131,2,35,53,2,NASDAQ
4665,13-02-2021 00:00,24 hrs.,wallstreetbets,LAKE,6,0,6,-6,1,1,0,1,NASDAQ
4665,13-02-2021 00:00,24 hrs.,wallstreetbets,LAZR,15,8,7,1,2,2,3,2,NASDAQ
4665,13-02-2021 00:00,24 hrs.,wallstreetbets,LEGN,7,7,0,7,1,1,1,1,NASDAQ
4665,13-02-2021 00:00,24 hrs.,wallstreetbets,LGND,13,7,6,1,2,2,1,2,NASDAQ
4665,13-02-2021 00:00,24 hrs.,stocks,SNGX,23,12,11,1,3,5,1,3,NASDAQ
4665,13-02-2021 00:00,24 hrs.,stocks,SPRO,25,0,25,-25,1,3,15,1,NASDAQ
4665,13-02-2021 00:00,24 hrs.,stocks,SRAC,14,6,8,-2,2,3,0,2,NASDAQ
4665,13-02-2021 00:00,24 hrs.,stocks,SRNE,81,81,0,81,1,24,29,1,NASDAQ
4665,13-02-2021 00:00,24 hrs.,stocks,SVMK,10,10,0,10,1,2,2,1,NASDAQ
4665,13-02-2021 00:00,24 hrs.,stocks,SWAV,25,0,25,-25,1,3,15,1,NASDAQ
4665,13-02-2021 00:00,24 hrs.,stocks,SWKS,52,52,0,52,1,10,28,1,NASDAQ
4665,13-02-2021 00:00,24 hrs.,stocks,TIGR,6,6,0,6,1,1,0,1,NASDAQ
4665,13-02-2021 00:00,24 hrs.,stocks,TLRY,986,664,322,342,7,315,328,7,NASDAQ
4665,13-02-2021 00:00,24 hrs.,stocks,TMDX,25,0,25,-25,1,3,15,1,NASDAQ
4665,13-02-2021 00:00,24 hrs.,stocks,TRCH,7,7,0,7,1,1,1,1,NASDAQ
4665,13-02-2021 00:00,24 hrs.,stocks,TRVG,12,12,0,12,2,2,0,2,NASDAQ
4665,13-02-2021 00:00,24 hrs.,stocks,TSLA,371,257,114,143,9,83,169,8,NASDAQ
4665,13-02-2021 00:00,24 hrs.,stocks,TTGT,6,6,0,6,1,1,0,1,NASDAQ
4665,13-02-2021 00:00,24 hrs.,stocks,VCEL,25,0,25,-25,1,3,15,1,NASDAQ
4665,13-02-2021 00:00,24 hrs.,stocks,VECO,6,0,6,-6,1,1,0,1,NASDAQ
4665,13-02-2021 00:00,24 hrs.,stocks,VRNT,14,14,0,14,1,3,4,1,NASDAQ
4665,13-02-2021 00:00,24 hrs.,stocks,VRSN,10,10,0,10,1,2,2,1,NASDAQ
4665,13-02-2021 00:00,24 hrs.,stocks,VUZI,6,6,0,6,1,1,0,1,NASDAQ
4665,13-02-2021 00:00,24 hrs.,stocks,VXRT,6,6,0,6,1,1,0,1,NASDAQ
4665,13-02-2021 00:00,24 hrs.,stocks,VXUS,7,7,0,7,1,1,1,1,NASDAQ
4665,13-02-2021 00:00,24 hrs.,stocks,WDAY,10,10,0,10,1,2,2,1,NASDAQ
4665,13-02-2021 00:00,24 hrs.,stocks,WISH,6,6,0,6,1,1,0,1,NASDAQ
4665,13-02-2021 00:00,24 hrs.,stocks,XCUR,6,0,6,-6,1,1,0,1,NASDAQ
4665,13-02-2021 00:00,24 hrs.,stocks,XERS,6,0,6,-6,1,1,0,1,NASDAQ
4665,13-02-2021 00:00,24 hrs.,stocks,ZGNX,6,6,0,6,1,1,0,1,NASDAQ
4665,13-02-2021 00:00,24 hrs.,stocks,ZYXI,25,0,25,-25,1,3,15,1,NASDAQ
4665,13-02-2021 00:00,24 hrs.,stocks,DISCA,12,12,0,12,2,2,0,2,NASDAQ
4665,13-02-2021 00:00,24 hrs.,stocks,SRACU,6,6,0,6,1,1,0,1,NASDAQ
4665,13-02-2021 00:00,24 hrs.,stocks,SRACW,6,6,0,6,1,1,0,1,NASDAQ
4665,13-02-2021 00:00,24 hrs.,Daytrading,AABB,29,0,29,-29,1,9,7,1,OTC
4665,13-02-2021 00:00,24 hrs.,Daytrading,HCMC,29,0,29,-29,1,9,7,1,OTC
4665,13-02-2021 00:00,24 hrs.,Daytrading,IDEA,6,0,6,-6,1,1,0,1,OTC
4665,13-02-2021 00:00,24 hrs.,Daytrading,INKW,8,0,8,-8,1,2,0,1,OTC
4665,13-02-2021 00:00,24 hrs.,Daytrading,LVVV,29,0,29,-29,1,9,7,1,OTC
4665,13-02-2021 00:00,24 hrs.,Daytrading,RLTR,6,0,6,-6,1,1,0,1,OTC
4665,13-02-2021 00:00,24 hrs.,Daytrading,SGMD,7,7,0,7,1,1,1,1,OTC
4665,13-02-2021 00:00,24 hrs.,Daytrading,TSTS,29,0,29,-29,1,9,7,1,OTC
4665,13-02-2021 00:00,24 hrs.,Daytrading,DNN,465,465,0,465,2,191,75,2,AMEX
4665,13-02-2021 00:00,24 hrs.,Daytrading,DSS,459,459,0,459,1,190,75,1,AMEX
4665,13-02-2021 00:00,24 hrs.,Daytrading,MXC,6,0,6,-6,1,1,0,1,AMEX
4665,13-02-2021 00:00,24 hrs.,Daytrading,TRX,6,0,6,-6,1,1,0,1,AMEX
4665,13-02-2021 00:00,24 hrs.,Daytrading,TRXC,6,0,6,-6,1,1,0,1,AMEX
4665,13-02-2021 00:00,24 hrs.,Daytrading,ACB,465,465,0,465,2,191,75,2,NYSE
4665,13-02-2021 00:00,24 hrs.,Daytrading,ADX,9,9,0,9,1,2,1,1,NYSE
4665,13-02-2021 00:00,24 hrs.,Daytrading,AMC,6,6,0,6,1,1,0,1,NYSE
4665,13-02-2021 00:00,24 hrs.,Daytrading,BDX,7,7,0,7,1,1,1,1,NYSE
4665,13-02-2021 00:00,24 hrs.,Daytrading,BFT,12,0,12,-12,1,3,2,1,NYSE
4665,13-02-2021 00:00,24 hrs.,Daytrading,FSR,459,459,0,459,1,190,75,1,NYSE
4665,13-02-2021 00:00,24 hrs.,Daytrading,GME,20,14,6,8,3,4,0,3,NYSE
4665,13-02-2021 00:00,24 hrs.,Daytrading,NOK,18,0,18,-18,1,0,14,1,NYSE
4665,13-02-2021 00:00,24 hrs.,Daytrading,PDT,24,24,0,24,1,5,10,1,NYSE
4665,13-02-2021 00:00,24 hrs.,Daytrading,RTP,459,459,0,459,1,190,75,1,NYSE
4665,13-02-2021 00:00,24 hrs.,Daytrading,SCI,6,0,6,-6,1,1,0,1,NYSE
4665,13-02-2021 00:00,24 hrs.,Daytrading,WLL,6,6,0,6,1,1,0,1,NYSE
4665,13-02-2021 00:00,24 hrs.,Daytrading,CCIV,459,459,0,459,1,190,75,1,NYSE
4665,13-02-2021 00:00,24 hrs.,Daytrading,CHWY,6,6,0,6,1,1,0,1,NYSE
4665,13-02-2021 00:00,24 hrs.,Daytrading,SPCE,466,459,7,452,2,191,76,2,NYSE
4665,13-02-2021 00:00,24 hrs.,Daytrading,AMD,10,0,10,-10,1,0,6,1,NASDAQ
4665,13-02-2021 00:00,24 hrs.,Daytrading,API,183,183,0,183,1,77,25,1,NASDAQ
4665,13-02-2021 00:00,24 hrs.,Daytrading,INO,459,459,0,459,1,190,75,1,NASDAQ
4665,13-02-2021 00:00,24 hrs.,Daytrading,OGI,13,0,13,-13,1,1,7,1,NASDAQ
4665,13-02-2021 00:00,24 hrs.,Daytrading,ACST,6,6,0,6,1,1,0,1,NASDAQ
4665,13-02-2021 00:00,24 hrs.,Daytrading,APDN,459,459,0,459,1,190,75,1,NASDAQ
4665,13-02-2021 00:00,24 hrs.,Daytrading,APHA,459,459,0,459,1,190,75,1,NASDAQ
4665,13-02-2021 00:00,24 hrs.,Daytrading,ARTL,555,555,0,555,6,221,89,6,NASDAQ
4665,13-02-2021 00:00,24 hrs.,Daytrading,BNGO,56,56,0,56,1,23,6,1,NASDAQ
4665,13-02-2021 00:00,24 hrs.,Daytrading,BYND,6,0,6,-6,1,1,0,1,NASDAQ
4665,13-02-2021 00:00,24 hrs.,Daytrading,CLEU,513,513,0,513,2,211,83,2,NASDAQ
4665,13-02-2021 00:00,24 hrs.,Daytrading,CLGN,459,459,0,459,1,190,75,1,NASDAQ
4665,13-02-2021 00:00,24 hrs.,Daytrading,CLSN,459,459,0,459,1,190,75,1,NASDAQ
4665,13-02-2021 00:00,24 hrs.,Daytrading,CMLF,459,459,0,459,1,190,75,1,NASDAQ
4665,13-02-2021 00:00,24 hrs.,Daytrading,CRSR,459,459,0,459,1,190,75,1,NASDAQ
4665,13-02-2021 00:00,24 hrs.,Daytrading,EBON,6,6,0,6,1,1,0,1,NASDAQ
4665,13-02-2021 00:00,24 hrs.,Daytrading,EXPE,4,0,4,-4,1,0,0,1,NASDAQ
4665,13-02-2021 00:00,24 hrs.,Daytrading,FOLD,465,465,0,465,2,191,75,2,NASDAQ
4665,13-02-2021 00:00,24 hrs.,Daytrading,FTFT,459,459,0,459,1,190,75,1,NASDAQ
4665,13-02-2021 00:00,24 hrs.,Daytrading,IBKR,23,0,23,-23,1,6,7,1,NASDAQ
4665,13-02-2021 00:00,24 hrs.,Daytrading,LIVE,95,95,0,95,2,36,15,1,NASDAQ
4665,13-02-2021 00:00,24 hrs.,Daytrading,MARA,459,459,0,459,1,190,75,1,NASDAQ
4665,13-02-2021 00:00,24 hrs.,Daytrading,NOVN,459,459,0,459,1,190,75,1,NASDAQ
4665,13-02-2021 00:00,24 hrs.,Daytrading,OCGN,21,21,0,21,1,2,13,1,NASDAQ
4665,13-02-2021 00:00,24 hrs.,Daytrading,PLAY,10,0,10,-10,1,0,6,1,NASDAQ
4665,13-02-2021 00:00,24 hrs.,Daytrading,PLUS,11,0,11,-11,1,2,3,1,NASDAQ
4665,13-02-2021 00:00,24 hrs.,Daytrading,PYPL,459,459,0,459,1,190,75,1,NASDAQ
4665,13-02-2021 00:00,24 hrs.,Daytrading,RIDE,459,459,0,459,1,190,75,1,NASDAQ
4665,13-02-2021 00:00,24 hrs.,Daytrading,RIOT,459,459,0,459,1,190,75,1,NASDAQ
4665,13-02-2021 00:00,24 hrs.,Daytrading,SNDL,13,0,13,-13,1,1,7,1,NASDAQ
4665,13-02-2021 00:00,24 hrs.,Daytrading,STAY,35,35,0,35,1,15,1,1,NASDAQ
4665,13-02-2021 00:00,24 hrs.,wallstreetbets,LIFE,20,7,13,-6,3,3,2,3,NASDAQ
4665,13-02-2021 00:00,24 hrs.,wallstreetbets,LITE,417,417,0,417,1,170,73,1,NASDAQ
4665,13-02-2021 00:00,24 hrs.,wallstreetbets,LIVE,424,424,0,424,2,171,74,2,NASDAQ
4665,13-02-2021 00:00,24 hrs.,wallstreetbets,LIVX,15,0,15,-15,2,2,3,1,NASDAQ
4665,13-02-2021 00:00,24 hrs.,wallstreetbets,LKCO,48,42,6,36,7,7,6,6,NASDAQ
4665,13-02-2021 00:00,24 hrs.,wallstreetbets,LLIT,7,7,0,7,1,1,1,1,NASDAQ
4665,13-02-2021 00:00,24 hrs.,wallstreetbets,LLNW,34,20,14,6,5,5,4,4,NASDAQ
4665,13-02-2021 00:00,24 hrs.,wallstreetbets,LOAN,14,14,0,14,2,2,2,2,NASDAQ
4665,13-02-2021 00:00,24 hrs.,wallstreetbets,LPCN,7,7,0,7,1,1,1,1,NASDAQ
4665,13-02-2021 00:00,24 hrs.,wallstreetbets,LRCX,469,469,0,469,1,119,227,1,NASDAQ
4665,13-02-2021 00:00,24 hrs.,wallstreetbets,MARA,26,14,12,2,4,4,2,4,NASDAQ
4665,13-02-2021 00:00,24 hrs.,wallstreetbets,MARK,14,7,7,0,2,2,2,2,NASDAQ
4665,13-02-2021 00:00,24 hrs.,wallstreetbets,MBIO,6,6,0,6,1,1,0,1,NASDAQ
4665,13-02-2021 00:00,24 hrs.,wallstreetbets,MBRX,38,19,19,0,6,6,2,5,NASDAQ
4665,13-02-2021 00:00,24 hrs.,wallstreetbets,MGNI,14,14,0,14,2,2,2,2,NASDAQ
4665,13-02-2021 00:00,24 hrs.,wallstreetbets,MKSI,417,417,0,417,1,170,73,1,NASDAQ
4665,13-02-2021 00:00,24 hrs.,wallstreetbets,MNPR,6,0,6,-6,1,1,0,1,NASDAQ
4665,13-02-2021 00:00,24 hrs.,wallstreetbets,MOGO,7,0,7,-7,1,1,1,1,NASDAQ
4665,13-02-2021 00:00,24 hrs.,wallstreetbets,MOSY,7,0,7,-7,1,1,1,1,NASDAQ
4665,13-02-2021 00:00,24 hrs.,wallstreetbets,MRNA,6,6,0,6,1,1,0,1,NASDAQ
4665,13-02-2021 00:00,24 hrs.,wallstreetbets,MRVL,7,7,0,7,1,1,1,1,NASDAQ
4665,13-02-2021 00:00,24 hrs.,wallstreetbets,MSFT,3294,3287,7,3280,2,1527,232,2,NASDAQ
4665,13-02-2021 00:00,24 hrs.,wallstreetbets,MSTR,46,13,33,-20,7,7,4,5,NASDAQ
4665,13-02-2021 00:00,24 hrs.,wallstreetbets,MTCH,7,7,0,7,1,1,1,1,NASDAQ
4665,13-02-2021 00:00,24 hrs.,wallstreetbets,MVIS,426,418,8,410,8,138,118,7,NASDAQ
4665,13-02-2021 00:00,24 hrs.,wallstreetbets,NAKD,174,96,78,18,25,25,24,18,NASDAQ
4665,13-02-2021 00:00,24 hrs.,wallstreetbets,NBAC,14,14,0,14,2,2,2,1,NASDAQ
4665,13-02-2021 00:00,24 hrs.,wallstreetbets,NCLH,28,28,0,28,4,4,4,3,NASDAQ
4665,13-02-2021 00:00,24 hrs.,wallstreetbets,NDRA,7,0,7,-7,1,1,1,1,NASDAQ
4665,13-02-2021 00:00,24 hrs.,wallstreetbets,NEOS,7,7,0,7,1,1,1,1,NASDAQ
4665,13-02-2021 00:00,24 hrs.,wallstreetbets,NFLX,7,7,0,7,1,1,1,1,NASDAQ
4665,13-02-2021 00:00,24 hrs.,wallstreetbets,NLOK,7,7,0,7,1,1,1,1,NASDAQ
4665,13-02-2021 00:00,24 hrs.,wallstreetbets,NMRK,6,6,0,6,1,1,0,1,NASDAQ
4665,13-02-2021 00:00,24 hrs.,wallstreetbets,NNDM,28,21,7,14,4,4,4,2,NASDAQ
4665,13-02-2021 00:00,24 hrs.,wallstreetbets,NOVN,14,14,0,14,2,2,2,1,NASDAQ
4665,13-02-2021 00:00,24 hrs.,wallstreetbets,NUAN,552,552,0,552,1,234,80,1,NASDAQ
4665,13-02-2021 00:00,24 hrs.,wallstreetbets,NVAX,6,0,6,-6,1,1,0,1,NASDAQ
4665,13-02-2021 00:00,24 hrs.,wallstreetbets,NVCN,6,0,6,-6,1,1,0,1,NASDAQ
4665,13-02-2021 00:00,24 hrs.,wallstreetbets,NVDA,594,594,0,594,3,120,342,3,NASDAQ
4665,13-02-2021 00:00,24 hrs.,wallstreetbets,OCGN,45,45,0,45,7,7,3,6,NASDAQ
4665,13-02-2021 00:00,24 hrs.,wallstreetbets,ONTX,7,7,0,7,1,1,1,1,NASDAQ
4665,13-02-2021 00:00,24 hrs.,wallstreetbets,ONVO,7,0,7,-7,1,1,1,1,NASDAQ
4665,13-02-2021 00:00,24 hrs.,wallstreetbets,OPGN,14,7,7,0,2,2,2,2,NASDAQ
4665,13-02-2021 00:00,24 hrs.,wallstreetbets,OPTT,6,6,0,6,1,1,0,1,NASDAQ
4665,13-02-2021 00:00,24 hrs.,wallstreetbets,PENN,4650,4650,0,4650,6,2159,308,2,NASDAQ
4665,13-02-2021 00:00,24 hrs.,wallstreetbets,PGNY,7,7,0,7,1,1,1,1,NASDAQ
4665,13-02-2021 00:00,24 hrs.,wallstreetbets,PHUN,7,7,0,7,1,1,1,1,NASDAQ
4665,13-02-2021 00:00,24 hrs.,wallstreetbets,PLAY,13,7,6,1,2,2,1,2,NASDAQ
4665,13-02-2021 00:00,24 hrs.,wallstreetbets,PLUG,7,7,0,7,1,1,1,1,NASDAQ
4665,13-02-2021 00:00,24 hrs.,wallstreetbets,PLYA,20,20,0,20,3,3,2,2,NASDAQ
4665,13-02-2021 00:00,24 hrs.,wallstreetbets,POTX,7,7,0,7,1,1,1,1,NASDAQ
4665,13-02-2021 00:00,24 hrs.,wallstreetbets,POWW,55,27,28,-1,8,8,7,7,NASDAQ
4665,13-02-2021 00:00,24 hrs.,wallstreetbets,PRCH,82,76,6,70,4,17,32,2,NASDAQ
4665,13-02-2021 00:00,24 hrs.,wallstreetbets,PRPL,849,849,0,849,1,326,193,1,NASDAQ
4665,13-02-2021 00:00,24 hrs.,wallstreetbets,PRTS,15,15,0,15,2,2,3,1,NASDAQ
4665,13-02-2021 00:00,24 hrs.,wallstreetbets,PSAC,7,7,0,7,1,1,1,1,NASDAQ
4665,13-02-2021 00:00,24 hrs.,wallstreetbets,PSEC,25,6,19,-13,2,0,17,2,NASDAQ
4665,13-02-2021 00:00,24 hrs.,wallstreetbets,PSTV,7,0,7,-7,1,1,1,1,NASDAQ
4665,13-02-2021 00:00,24 hrs.,wallstreetbets,PTCT,7,7,0,7,1,1,1,1,NASDAQ
4665,13-02-2021 00:00,24 hrs.,wallstreetbets,PTON,4643,4643,0,4643,5,2158,307,1,NASDAQ
4665,13-02-2021 00:00,24 hrs.,wallstreetbets,PZZA,7,0,7,-7,1,1,1,1,NASDAQ
4665,13-02-2021 00:00,24 hrs.,wallstreetbets,QCOM,7,7,0,7,1,1,1,1,NASDAQ
4665,13-02-2021 00:00,24 hrs.,wallstreetbets,QFIN,7,7,0,7,1,1,1,1,NASDAQ
4665,13-02-2021 00:00,24 hrs.,wallstreetbets,QQQJ,22,22,0,22,1,6,6,1,NASDAQ
4665,13-02-2021 00:00,24 hrs.,wallstreetbets,QUIK,13,7,6,1,2,2,1,2,NASDAQ
4665,13-02-2021 00:00,24 hrs.,wallstreetbets,RAVE,14,14,0,14,2,2,2,2,NASDAQ
4665,13-02-2021 00:00,24 hrs.,wallstreetbets,RCMT,7,0,7,-7,1,1,1,1,NASDAQ
4665,13-02-2021 00:00,24 hrs.,wallstreetbets,RDHL,13,13,0,13,2,2,1,2,NASDAQ
4665,13-02-2021 00:00,24 hrs.,wallstreetbets,REAL,112,83,29,54,6,9,70,6,NASDAQ
4665,13-02-2021 00:00,24 hrs.,wallstreetbets,REGI,6,0,6,-6,1,1,0,1,NASDAQ
4665,13-02-2021 00:00,24 hrs.,wallstreetbets,REGN,21,14,7,7,3,3,3,2,NASDAQ
4665,13-02-2021 00:00,24 hrs.,wallstreetbets,RIDE,95,89,6,83,14,14,11,11,NASDAQ
4665,13-02-2021 00:00,24 hrs.,wallstreetbets,RIOT,4734,4728,6,4722,18,2171,320,13,NASDAQ
4665,13-02-2021 00:00,24 hrs.,wallstreetbets,RKDA,7,7,0,7,1,1,1,1,NASDAQ
4665,13-02-2021 00:00,24 hrs.,wallstreetbets,RMTI,20,0,20,-20,3,3,2,2,NASDAQ
4665,13-02-2021 00:00,24 hrs.,wallstreetbets,ROKU,6,6,0,6,1,1,0,1,NASDAQ
4665,13-02-2021 00:00,24 hrs.,wallstreetbets,ROOT,14,14,0,14,2,2,2,1,NASDAQ
4665,13-02-2021 00:00,24 hrs.,wallstreetbets,RWLK,21,21,0,21,3,3,3,3,NASDAQ
4665,13-02-2021 00:00,24 hrs.,wallstreetbets,SABR,7,0,7,-7,1,1,1,1,NASDAQ
4665,13-02-2021 00:00,24 hrs.,wallstreetbets,SAVA,13,7,6,1,2,2,1,2,NASDAQ
4665,13-02-2021 00:00,24 hrs.,wallstreetbets,SAVE,7,7,0,7,1,1,1,1,NASDAQ
4665,13-02-2021 00:00,24 hrs.,wallstreetbets,SBUX,7,7,0,7,1,1,1,1,NASDAQ
4665,13-02-2021 00:00,24 hrs.,wallstreetbets,SEAC,7,7,0,7,1,1,1,1,NASDAQ
4665,13-02-2021 00:00,24 hrs.,Daytrading,TLRY,472,459,13,446,2,191,82,2,NASDAQ
4665,13-02-2021 00:00,24 hrs.,Daytrading,WAFU,54,54,0,54,1,21,8,1,NASDAQ
4665,13-02-2021 00:00,24 hrs.,Daytrading,XERS,459,459,0,459,1,190,75,1,NASDAQ
4665,13-02-2021 00:00,24 hrs.,trakstocks,ALPP,6,6,0,6,1,1,0,1,OTC
4665,13-02-2021 00:00,24 hrs.,trakstocks,BRTX,6,6,0,6,1,1,0,1,OTC
4665,13-02-2021 00:00,24 hrs.,trakstocks,MMEX,20,20,0,20,2,3,6,2,OTC
4665,13-02-2021 00:00,24 hrs.,trakstocks,MOST,6,6,0,6,1,1,0,1,OTC
4665,13-02-2021 00:00,24 hrs.,trakstocks,SUIC,6,0,6,-6,1,1,0,1,OTC
4665,13-02-2021 00:00,24 hrs.,trakstocks,ARBKF,6,6,0,6,1,1,0,1,OTC
4665,13-02-2021 00:00,24 hrs.,trakstocks,BBXIA,6,6,0,6,1,1,0,1,OTC
4665,13-02-2021 00:00,24 hrs.,trakstocks,NMGRF,35,35,0,35,1,12,7,1,OTC
4665,13-02-2021 00:00,24 hrs.,trakstocks,NXTTF,14,14,0,14,1,5,0,1,OTC
4665,13-02-2021 00:00,24 hrs.,trakstocks,PYRNF,12,12,0,12,2,2,0,2,OTC
4665,13-02-2021 00:00,24 hrs.,trakstocks,DNN,59,59,0,59,1,21,13,1,AMEX
4665,13-02-2021 00:00,24 hrs.,trakstocks,DPW,6,6,0,6,1,1,0,1,AMEX
4665,13-02-2021 00:00,24 hrs.,trakstocks,TRXC,174,97,77,20,2,61,44,2,AMEX
4665,13-02-2021 00:00,24 hrs.,trakstocks,AMC,25,25,0,25,1,2,17,1,NYSE
4665,13-02-2021 00:00,24 hrs.,trakstocks,CPS,93,0,93,-93,1,41,7,1,NYSE
4665,13-02-2021 00:00,24 hrs.,trakstocks,GME,25,25,0,25,1,2,17,1,NYSE
4665,13-02-2021 00:00,24 hrs.,trakstocks,LEN,13,0,13,-13,1,4,1,1,NYSE
4665,13-02-2021 00:00,24 hrs.,trakstocks,SOL,8,8,0,8,1,2,0,1,NYSE
4665,13-02-2021 00:00,24 hrs.,trakstocks,SOS,20,20,0,20,1,8,0,1,NYSE
4665,13-02-2021 00:00,24 hrs.,trakstocks,SPH,13,0,13,-13,1,4,1,1,NYSE
4665,13-02-2021 00:00,24 hrs.,trakstocks,ARGO,6,6,0,6,1,1,0,1,NYSE
4665,13-02-2021 00:00,24 hrs.,trakstocks,CCIV,29,0,29,-29,3,6,5,3,NYSE
4665,13-02-2021 00:00,24 hrs.,trakstocks,SKLZ,6,0,6,-6,1,1,0,1,NYSE
4665,13-02-2021 00:00,24 hrs.,trakstocks,STIC,29,0,29,-29,1,9,7,1,NYSE
4665,13-02-2021 00:00,24 hrs.,trakstocks,STPK,18,18,0,18,1,5,4,1,NYSE
4665,13-02-2021 00:00,24 hrs.,trakstocks,AQB,8,8,0,8,1,2,0,1,NASDAQ
4665,13-02-2021 00:00,24 hrs.,trakstocks,OEG,24,24,0,24,1,8,4,1,NASDAQ
4665,13-02-2021 00:00,24 hrs.,trakstocks,ABEO,8,0,8,-8,1,2,0,1,NASDAQ
4665,13-02-2021 00:00,24 hrs.,trakstocks,APPS,6,6,0,6,1,1,0,1,NASDAQ
4665,13-02-2021 00:00,24 hrs.,trakstocks,AYRO,86,86,0,86,2,28,22,2,NASDAQ
4665,13-02-2021 00:00,24 hrs.,trakstocks,BHTG,318,318,0,318,1,117,80,1,NASDAQ
4665,13-02-2021 00:00,24 hrs.,trakstocks,CFII,57,57,0,57,1,19,15,1,NASDAQ
4665,13-02-2021 00:00,24 hrs.,trakstocks,CHEF,30,0,30,-30,1,10,6,1,NASDAQ
4665,13-02-2021 00:00,24 hrs.,trakstocks,CPSH,143,34,109,-75,4,55,17,4,NASDAQ
4665,13-02-2021 00:00,24 hrs.,trakstocks,EXPC,35,6,29,-23,2,13,1,2,NASDAQ
4665,13-02-2021 00:00,24 hrs.,trakstocks,GEVO,90,0,90,-90,1,38,10,1,NASDAQ
4665,13-02-2021 00:00,24 hrs.,trakstocks,GTHX,6,6,0,6,1,1,0,1,NASDAQ
4665,13-02-2021 00:00,24 hrs.,trakstocks,IMMR,15,15,0,15,1,4,3,1,NASDAQ
4665,13-02-2021 00:00,24 hrs.,trakstocks,MARA,9,9,0,9,1,2,1,1,NASDAQ
4665,13-02-2021 00:00,24 hrs.,trakstocks,OPRX,10,10,0,10,1,2,2,1,NASDAQ
4665,13-02-2021 00:00,24 hrs.,trakstocks,RIOT,17,17,0,17,2,3,3,2,NASDAQ
4665,13-02-2021 00:00,24 hrs.,trakstocks,TTCF,30,0,30,-30,1,10,6,1,NASDAQ
4665,13-02-2021 00:00,24 hrs.,trakstocks,VNDA,10,0,10,-10,1,3,0,1,NASDAQ
4665,13-02-2021 00:00,24 hrs.,trakstocks,VRME,8,0,8,-8,1,2,0,1,NASDAQ
4665,13-02-2021 00:00,24 hrs.,trakstocks,XSPA,21,0,21,-21,1,6,5,1,NASDAQ
4665,13-02-2021 00:00,24 hrs.,StockMarket,ABML,6,6,0,6,1,1,0,1,OTC
4665,13-02-2021 00:00,24 hrs.,StockMarket,BOTY,42,8,34,-26,3,5,20,2,OTC
4665,13-02-2021 00:00,24 hrs.,StockMarket,DIGI,6,0,6,-6,1,1,0,1,OTC
4665,13-02-2021 00:00,24 hrs.,StockMarket,FMCC,100,0,100,-100,1,27,42,1,OTC
4665,13-02-2021 00:00,24 hrs.,StockMarket,FNMA,100,0,100,-100,1,27,42,1,OTC
4665,13-02-2021 00:00,24 hrs.,StockMarket,GTEH,6,6,0,6,1,1,0,1,OTC
4665,13-02-2021 00:00,24 hrs.,StockMarket,GTVH,6,6,0,6,1,1,0,1,OTC
4665,13-02-2021 00:00,24 hrs.,StockMarket,HCMC,59,0,59,-59,2,21,9,2,OTC
4665,13-02-2021 00:00,24 hrs.,StockMarket,HEMP,6,6,0,6,1,1,0,1,OTC
4665,13-02-2021 00:00,24 hrs.,StockMarket,KGET,6,6,0,6,1,1,0,1,OTC
4665,13-02-2021 00:00,24 hrs.,StockMarket,KWBT,6,6,0,6,1,1,0,1,OTC
4665,13-02-2021 00:00,24 hrs.,StockMarket,LINK,11,11,0,11,1,2,3,1,OTC
4665,13-02-2021 00:00,24 hrs.,StockMarket,MAXD,49,49,0,49,4,13,7,3,OTC
4665,13-02-2021 00:00,24 hrs.,StockMarket,MOST,11,11,0,11,1,2,3,1,OTC
4665,13-02-2021 00:00,24 hrs.,StockMarket,PCTL,6,6,0,6,1,1,0,1,OTC
4665,13-02-2021 00:00,24 hrs.,StockMarket,PHIL,6,6,0,6,1,1,0,1,OTC
4665,13-02-2021 00:00,24 hrs.,StockMarket,RLTR,6,0,6,-6,1,1,0,1,OTC
4665,13-02-2021 00:00,24 hrs.,StockMarket,RSSV,20,20,0,20,1,7,2,1,OTC
4665,13-02-2021 00:00,24 hrs.,StockMarket,RTON,6,0,6,-6,1,1,0,1,OTC
4665,13-02-2021 00:00,24 hrs.,StockMarket,SGMD,136,136,0,136,6,31,50,2,OTC
4665,13-02-2021 00:00,24 hrs.,StockMarket,SUIC,6,0,6,-6,1,1,0,1,OTC
4665,13-02-2021 00:00,24 hrs.,StockMarket,AYRWF,9,9,0,9,1,2,1,1,OTC
4665,13-02-2021 00:00,24 hrs.,StockMarket,BMWLF,9,9,0,9,1,2,1,1,OTC
4665,13-02-2021 00:00,24 hrs.,StockMarket,CRLBF,9,9,0,9,1,2,1,1,OTC
4665,13-02-2021 00:00,24 hrs.,StockMarket,CURLF,9,9,0,9,1,2,1,1,OTC
4665,13-02-2021 00:00,24 hrs.,StockMarket,DIGAF,6,6,0,6,1,1,0,1,OTC
4665,13-02-2021 00:00,24 hrs.,StockMarket,GTBIF,9,9,0,9,1,2,1,1,OTC
4665,13-02-2021 00:00,24 hrs.,StockMarket,HTZGQ,6,6,0,6,1,1,0,1,OTC
4665,13-02-2021 00:00,24 hrs.,StockMarket,LHSIF,9,9,0,9,1,2,1,1,OTC
4665,13-02-2021 00:00,24 hrs.,StockMarket,NMGRF,6,6,0,6,1,1,0,1,OTC
4665,13-02-2021 00:00,24 hrs.,StockMarket,NXGWF,15,0,15,-15,1,5,1,1,OTC
4665,13-02-2021 00:00,24 hrs.,StockMarket,RAZFF,6,6,0,6,1,1,0,1,OTC
4665,13-02-2021 00:00,24 hrs.,StockMarket,RHDGF,18,18,0,18,2,3,4,1,OTC
4665,13-02-2021 00:00,24 hrs.,StockMarket,RWBYF,9,9,0,9,1,2,1,1,OTC
4665,13-02-2021 00:00,24 hrs.,StockMarket,RYCEY,18,12,6,6,3,3,0,3,OTC
4665,13-02-2021 00:00,24 hrs.,StockMarket,TCNNF,9,9,0,9,1,2,1,1,OTC
4665,13-02-2021 00:00,24 hrs.,StockMarket,TFECY,18,18,0,18,3,3,0,1,OTC
4665,13-02-2021 00:00,24 hrs.,StockMarket,ZBISF,21,21,0,21,1,6,5,1,OTC
4665,13-02-2021 00:00,24 hrs.,StockMarket,DNN,37,12,25,-13,3,8,9,3,AMEX
4665,13-02-2021 00:00,24 hrs.,StockMarket,DSS,6,6,0,6,1,1,0,1,AMEX
4665,13-02-2021 00:00,24 hrs.,StockMarket,ITP,8,0,8,-8,1,1,2,1,AMEX
4665,13-02-2021 00:00,24 hrs.,StockMarket,REI,10,0,10,-10,1,3,0,1,AMEX
4665,13-02-2021 00:00,24 hrs.,wallstreetbets,SEEL,7,7,0,7,1,1,1,1,NASDAQ
4665,13-02-2021 00:00,24 hrs.,wallstreetbets,SHIP,144,124,20,104,21,21,18,17,NASDAQ
4665,13-02-2021 00:00,24 hrs.,wallstreetbets,SINT,6,0,6,-6,1,1,0,1,NASDAQ
4665,13-02-2021 00:00,24 hrs.,wallstreetbets,SIRI,7,7,0,7,1,1,1,1,NASDAQ
4665,13-02-2021 00:00,24 hrs.,wallstreetbets,SLRX,7,7,0,7,1,1,1,1,NASDAQ
4665,13-02-2021 00:00,24 hrs.,wallstreetbets,SNCA,6,6,0,6,1,1,0,1,NASDAQ
4665,13-02-2021 00:00,24 hrs.,wallstreetbets,SNDL,7941,1933,6008,-4075,285,2683,1435,216,NASDAQ
4665,13-02-2021 00:00,24 hrs.,wallstreetbets,SNGX,22,15,7,8,3,3,4,3,NASDAQ
4665,13-02-2021 00:00,24 hrs.,wallstreetbets,SQQQ,14,7,7,0,2,2,2,2,NASDAQ
4665,13-02-2021 00:00,24 hrs.,wallstreetbets,SRAC,6,6,0,6,1,1,0,1,NASDAQ
4665,13-02-2021 00:00,24 hrs.,wallstreetbets,SRGA,7,7,0,7,1,1,1,1,NASDAQ
4665,13-02-2021 00:00,24 hrs.,wallstreetbets,SRNE,29,7,22,-15,3,6,5,3,NASDAQ
4665,13-02-2021 00:00,24 hrs.,wallstreetbets,STAF,7,7,0,7,1,1,1,1,NASDAQ
4665,13-02-2021 00:00,24 hrs.,wallstreetbets,STAY,12,6,6,0,2,2,0,2,NASDAQ
4665,13-02-2021 00:00,24 hrs.,wallstreetbets,STEP,15,15,0,15,1,0,11,1,NASDAQ
4665,13-02-2021 00:00,24 hrs.,wallstreetbets,STLD,7,7,0,7,1,1,1,1,NASDAQ
4665,13-02-2021 00:00,24 hrs.,wallstreetbets,SVMK,417,417,0,417,1,170,73,1,NASDAQ
4665,13-02-2021 00:00,24 hrs.,wallstreetbets,SWBI,7,7,0,7,1,1,1,1,NASDAQ
4665,13-02-2021 00:00,24 hrs.,wallstreetbets,SWKS,469,469,0,469,1,119,227,1,NASDAQ
4665,13-02-2021 00:00,24 hrs.,wallstreetbets,TEAM,12,0,12,-12,2,2,0,1,NASDAQ
4665,13-02-2021 00:00,24 hrs.,wallstreetbets,TELL,35176,7,35169,-35162,4,16809,1542,4,NASDAQ
4665,13-02-2021 00:00,24 hrs.,wallstreetbets,THBR,7,0,7,-7,1,1,1,1,NASDAQ
4665,13-02-2021 00:00,24 hrs.,wallstreetbets,THCB,6,6,0,6,1,1,0,1,NASDAQ
4665,13-02-2021 00:00,24 hrs.,wallstreetbets,THMO,13,13,0,13,2,2,1,1,NASDAQ
4665,13-02-2021 00:00,24 hrs.,wallstreetbets,TLGT,7,7,0,7,1,1,1,1,NASDAQ
4665,13-02-2021 00:00,24 hrs.,wallstreetbets,TLRY,78877,352,78525,-78173,83,37099,4347,72,NASDAQ
4665,13-02-2021 00:00,24 hrs.,wallstreetbets,TLSA,7,7,0,7,1,1,1,1,NASDAQ
4665,13-02-2021 00:00,24 hrs.,wallstreetbets,TNXP,90,56,34,22,13,13,12,8,NASDAQ
4665,13-02-2021 00:00,24 hrs.,wallstreetbets,TOPS,93,86,7,79,13,14,13,10,NASDAQ
4665,13-02-2021 00:00,24 hrs.,wallstreetbets,TOWN,140,140,0,140,1,40,56,1,NASDAQ
4665,13-02-2021 00:00,24 hrs.,wallstreetbets,TQQQ,14,14,0,14,2,2,2,1,NASDAQ
4665,13-02-2021 00:00,24 hrs.,wallstreetbets,TRCH,21,14,7,7,3,3,3,3,NASDAQ
4665,13-02-2021 00:00,24 hrs.,wallstreetbets,TRIT,46,39,7,32,7,7,4,6,NASDAQ
4665,13-02-2021 00:00,24 hrs.,wallstreetbets,TRVG,2450,2450,0,2450,29,875,584,19,NASDAQ
4665,13-02-2021 00:00,24 hrs.,wallstreetbets,TSLA,7007,6639,368,6271,40,3000,847,31,NASDAQ
4665,13-02-2021 00:00,24 hrs.,wallstreetbets,TTCF,14,7,7,0,2,2,2,2,NASDAQ
4665,13-02-2021 00:00,24 hrs.,wallstreetbets,TTOO,7,7,0,7,1,1,1,1,NASDAQ
4665,13-02-2021 00:00,24 hrs.,wallstreetbets,TTWO,7,0,7,-7,1,1,1,1,NASDAQ
4665,13-02-2021 00:00,24 hrs.,wallstreetbets,TURN,12,0,12,-12,2,2,0,1,NASDAQ
4665,13-02-2021 00:00,24 hrs.,wallstreetbets,TXMD,43,14,29,-15,6,6,7,5,NASDAQ
4665,13-02-2021 00:00,24 hrs.,wallstreetbets,UNFI,292,292,0,292,1,132,24,1,NASDAQ
4665,13-02-2021 00:00,24 hrs.,wallstreetbets,VEON,6,6,0,6,1,1,0,1,NASDAQ
4665,13-02-2021 00:00,24 hrs.,wallstreetbets,VERU,7,7,0,7,1,1,1,1,NASDAQ
4665,13-02-2021 00:00,24 hrs.,wallstreetbets,VISL,7,7,0,7,1,1,1,1,NASDAQ
4665,13-02-2021 00:00,24 hrs.,wallstreetbets,VKTX,7,7,0,7,1,1,1,1,NASDAQ
4665,13-02-2021 00:00,24 hrs.,wallstreetbets,VLDR,7,7,0,7,1,1,1,1,NASDAQ
4665,13-02-2021 00:00,24 hrs.,wallstreetbets,VNDA,36,0,36,-36,5,5,6,1,NASDAQ
4665,13-02-2021 00:00,24 hrs.,wallstreetbets,VRSN,417,417,0,417,1,170,73,1,NASDAQ
4665,13-02-2021 00:00,24 hrs.,wallstreetbets,VSAT,14,14,0,14,2,2,2,1,NASDAQ
4665,13-02-2021 00:00,24 hrs.,wallstreetbets,VXRT,27,21,6,15,4,4,3,4,NASDAQ
4665,13-02-2021 00:00,24 hrs.,wallstreetbets,WATT,7,7,0,7,1,1,1,1,NASDAQ
4665,13-02-2021 00:00,24 hrs.,wallstreetbets,WKHS,4639,4639,0,4639,2,2101,429,2,NASDAQ
4665,13-02-2021 00:00,24 hrs.,wallstreetbets,WRAP,7,7,0,7,1,1,1,1,NASDAQ
4665,13-02-2021 00:00,24 hrs.,wallstreetbets,WTER,7,0,7,-7,1,1,1,1,NASDAQ
4665,13-02-2021 00:00,24 hrs.,wallstreetbets,XENE,14,14,0,14,2,2,2,1,NASDAQ
4665,13-02-2021 00:00,24 hrs.,wallstreetbets,XERS,15,7,8,-1,2,2,3,2,NASDAQ
4665,13-02-2021 00:00,24 hrs.,wallstreetbets,XNET,14,14,0,14,2,2,2,1,NASDAQ
4665,13-02-2021 00:00,24 hrs.,wallstreetbets,XSPA,71,52,19,33,11,11,5,10,NASDAQ
4665,13-02-2021 00:00,24 hrs.,wallstreetbets,YNDX,506,0,506,-506,1,191,120,1,NASDAQ
4665,13-02-2021 00:00,24 hrs.,wallstreetbets,ZNGA,14,7,7,0,2,2,2,2,NASDAQ
4665,13-02-2021 00:00,24 hrs.,wallstreetbets,ZYNE,7,7,0,7,1,1,1,1,NASDAQ
4665,13-02-2021 00:00,24 hrs.,wallstreetbets,CMCSA,7,7,0,7,1,1,1,1,NASDAQ
4665,13-02-2021 00:00,24 hrs.,wallstreetbets,GOOGL,6,6,0,6,1,1,0,1,NASDAQ
4665,13-02-2021 00:00,24 hrs.,wallstreetbets,SRACU,6,6,0,6,1,1,0,1,NASDAQ
4665,13-02-2021 00:00,24 hrs.,wallstreetbets,SRACW,6,6,0,6,1,1,0,1,NASDAQ
4665,13-02-2021 00:00,24 hrs.,RobinHoodPennyStocks,AZFL,6,0,6,-6,1,0,2,1,OTC
4665,13-02-2021 00:00,24 hrs.,RobinHoodPennyStocks,BGMD,4,4,0,4,1,0,0,1,OTC
4665,13-02-2021 00:00,24 hrs.,RobinHoodPennyStocks,BLXX,6,6,0,6,1,1,0,1,OTC
4665,13-02-2021 00:00,24 hrs.,RobinHoodPennyStocks,CAPS,6,0,6,-6,1,1,0,1,OTC
4665,13-02-2021 00:00,24 hrs.,RobinHoodPennyStocks,CBDD,6,6,0,6,1,1,0,1,OTC
4665,13-02-2021 00:00,24 hrs.,RobinHoodPennyStocks,DIGI,6,0,6,-6,1,1,0,1,OTC
4665,13-02-2021 00:00,24 hrs.,RobinHoodPennyStocks,GLEC,6,6,0,6,1,1,0,1,OTC
4665,13-02-2021 00:00,24 hrs.,RobinHoodPennyStocks,GPFT,34,24,10,14,5,5,4,2,OTC
4665,13-02-2021 00:00,24 hrs.,RobinHoodPennyStocks,GSPH,6,6,0,6,1,1,0,1,OTC
4665,13-02-2021 00:00,24 hrs.,RobinHoodPennyStocks,HCMC,12,12,0,12,2,2,0,2,OTC
4665,13-02-2021 00:00,24 hrs.,RobinHoodPennyStocks,INKW,6,6,0,6,1,1,0,1,OTC
4665,13-02-2021 00:00,24 hrs.,RobinHoodPennyStocks,LTUM,6,6,0,6,1,1,0,1,OTC
4665,13-02-2021 00:00,24 hrs.,RobinHoodPennyStocks,MJNA,6,6,0,6,1,1,0,1,OTC
4665,13-02-2021 00:00,24 hrs.,RobinHoodPennyStocks,NUUU,6,6,0,6,1,1,0,1,OTC
4665,13-02-2021 00:00,24 hrs.,RobinHoodPennyStocks,OPTI,6,0,6,-6,1,1,0,1,OTC
4665,13-02-2021 00:00,24 hrs.,RobinHoodPennyStocks,PHIL,6,6,0,6,1,1,0,1,OTC
4665,13-02-2021 00:00,24 hrs.,RobinHoodPennyStocks,BDRBF,30,12,18,-6,5,5,0,5,OTC
4665,13-02-2021 00:00,24 hrs.,StockMarket,TRX,6,6,0,6,1,1,0,1,AMEX
4665,13-02-2021 00:00,24 hrs.,StockMarket,URG,25,0,25,-25,1,6,9,1,AMEX
4665,13-02-2021 00:00,24 hrs.,StockMarket,GSAT,62,62,0,62,1,16,26,1,AMEX
4665,13-02-2021 00:00,24 hrs.,StockMarket,LODE,6,6,0,6,1,1,0,1,AMEX
4665,13-02-2021 00:00,24 hrs.,StockMarket,NSPR,6,6,0,6,1,1,0,1,AMEX
4665,13-02-2021 00:00,24 hrs.,StockMarket,RLGT,6,0,6,-6,1,1,0,1,AMEX
4665,13-02-2021 00:00,24 hrs.,StockMarket,UAVS,11,11,0,11,1,2,3,1,AMEX
4665,13-02-2021 00:00,24 hrs.,StockMarket,UUUU,25,0,25,-25,1,6,9,1,AMEX
4665,13-02-2021 00:00,24 hrs.,StockMarket,ACB,16,16,0,16,1,6,0,1,NYSE
4665,13-02-2021 00:00,24 hrs.,StockMarket,AFC,6,6,0,6,1,1,0,1,NYSE
4665,13-02-2021 00:00,24 hrs.,StockMarket,AGX,6,6,0,6,1,1,0,1,NYSE
4665,13-02-2021 00:00,24 hrs.,StockMarket,ALV,20,0,20,-20,1,3,10,1,NYSE
4665,13-02-2021 00:00,24 hrs.,StockMarket,AMC,524,31,493,-462,4,219,70,4,NYSE
4665,13-02-2021 00:00,24 hrs.,StockMarket,BHC,11,11,0,11,1,2,3,1,NYSE
4665,13-02-2021 00:00,24 hrs.,StockMarket,CIA,446,0,446,-446,1,200,42,1,NYSE
4665,13-02-2021 00:00,24 hrs.,StockMarket,DIS,27,27,0,27,2,8,3,2,NYSE
4665,13-02-2021 00:00,24 hrs.,StockMarket,FSR,11,11,0,11,1,2,3,1,NYSE
4665,13-02-2021 00:00,24 hrs.,StockMarket,GME,588,39,549,-510,9,232,88,9,NYSE
4665,13-02-2021 00:00,24 hrs.,StockMarket,IBM,462,16,446,-430,2,206,42,2,NYSE
4665,13-02-2021 00:00,24 hrs.,StockMarket,JNJ,6,6,0,6,1,1,0,1,NYSE
4665,13-02-2021 00:00,24 hrs.,StockMarket,LAC,4,0,4,-4,1,0,0,1,NYSE
4665,13-02-2021 00:00,24 hrs.,StockMarket,LLY,16,16,0,16,1,6,0,1,NYSE
4665,13-02-2021 00:00,24 hrs.,StockMarket,LMT,23,0,23,-23,1,4,11,1,NYSE
4665,13-02-2021 00:00,24 hrs.,StockMarket,MAX,11,11,0,11,1,3,1,1,NYSE
4665,13-02-2021 00:00,24 hrs.,StockMarket,MCO,11,11,0,11,1,2,3,1,NYSE
4665,13-02-2021 00:00,24 hrs.,StockMarket,MRO,11,11,0,11,1,2,3,1,NYSE
4665,13-02-2021 00:00,24 hrs.,StockMarket,NIO,37,37,0,37,3,7,11,3,NYSE
4665,13-02-2021 00:00,24 hrs.,StockMarket,NSA,446,0,446,-446,1,200,42,1,NYSE
4665,13-02-2021 00:00,24 hrs.,StockMarket,PDT,8,0,8,-8,1,1,2,1,NYSE
4665,13-02-2021 00:00,24 hrs.,StockMarket,PHI,6,6,0,6,1,1,0,1,NYSE
4665,13-02-2021 00:00,24 hrs.,StockMarket,PSA,6,6,0,6,1,1,0,1,NYSE
4665,13-02-2021 00:00,24 hrs.,StockMarket,RSI,6,0,6,-6,1,1,0,1,NYSE
4665,13-02-2021 00:00,24 hrs.,StockMarket,SBE,6,6,0,6,1,1,0,1,NYSE
4665,13-02-2021 00:00,24 hrs.,StockMarket,SMG,9,9,0,9,1,2,1,1,NYSE
4665,13-02-2021 00:00,24 hrs.,StockMarket,SOS,29,17,12,5,4,5,3,4,NYSE
4665,13-02-2021 00:00,24 hrs.,StockMarket,TDA,12,12,0,12,1,1,6,1,NYSE
4665,13-02-2021 00:00,24 hrs.,StockMarket,TSE,33,0,33,-33,1,10,9,1,NYSE
4665,13-02-2021 00:00,24 hrs.,StockMarket,TTM,19,0,19,-19,1,3,9,1,NYSE
4665,13-02-2021 00:00,24 hrs.,StockMarket,XPO,16,16,0,16,1,6,0,1,NYSE
4665,13-02-2021 00:00,24 hrs.,StockMarket,CACI,446,0,446,-446,1,200,42,1,NYSE
4665,13-02-2021 00:00,24 hrs.,StockMarket,CCIV,30,30,0,30,2,9,4,1,NYSE
4665,13-02-2021 00:00,24 hrs.,StockMarket,CHWY,6,6,0,6,1,1,0,1,NYSE
4665,13-02-2021 00:00,24 hrs.,StockMarket,COTY,12,12,0,12,2,2,0,1,NYSE
4665,13-02-2021 00:00,24 hrs.,StockMarket,DSSI,6,6,0,6,1,1,0,1,NYSE
4665,13-02-2021 00:00,24 hrs.,StockMarket,FUSE,12,12,0,12,2,2,0,2,NYSE
4665,13-02-2021 00:00,24 hrs.,StockMarket,GDDY,16,16,0,16,1,6,0,1,NYSE
4665,13-02-2021 00:00,24 hrs.,StockMarket,GNRC,16,16,0,16,1,6,0,1,NYSE
4665,13-02-2021 00:00,24 hrs.,StockMarket,HEXO,9,9,0,9,1,2,1,1,NYSE
4665,13-02-2021 00:00,24 hrs.,StockMarket,HYLN,11,11,0,11,1,2,3,1,NYSE
4665,13-02-2021 00:00,24 hrs.,StockMarket,LAIX,13,13,0,13,1,0,9,1,NYSE
4665,13-02-2021 00:00,24 hrs.,StockMarket,PINS,10,10,0,10,1,2,2,1,NYSE
4665,13-02-2021 00:00,24 hrs.,StockMarket,PLTR,16,16,0,16,1,6,0,1,NYSE
4665,13-02-2021 00:00,24 hrs.,StockMarket,UBER,16,16,0,16,1,6,0,1,NYSE
4665,13-02-2021 00:00,24 hrs.,StockMarket,VGAC,8,8,0,8,1,0,4,1,NYSE
4665,13-02-2021 00:00,24 hrs.,StockMarket,XPEV,446,0,446,-446,1,200,42,1,NYSE
4665,13-02-2021 00:00,24 hrs.,StockMarket,YETI,4,0,4,-4,1,0,0,1,NYSE
4665,13-02-2021 00:00,24 hrs.,StockMarket,AMD,24,6,18,-12,3,2,8,3,NASDAQ
4665,13-02-2021 00:00,24 hrs.,StockMarket,AZN,11,11,0,11,1,2,3,1,NASDAQ
4665,13-02-2021 00:00,24 hrs.,StockMarket,CDC,11,11,0,11,1,2,3,1,NASDAQ
4665,13-02-2021 00:00,24 hrs.,StockMarket,HAS,6,0,6,-6,1,1,0,1,NASDAQ
4665,13-02-2021 00:00,24 hrs.,StockMarket,INO,11,11,0,11,1,2,3,1,NASDAQ
4665,13-02-2021 00:00,24 hrs.,StockMarket,JFU,62,62,0,62,1,16,26,1,NASDAQ
4665,13-02-2021 00:00,24 hrs.,StockMarket,MGI,5,0,5,-5,1,0,1,1,NASDAQ
4665,13-02-2021 00:00,24 hrs.,StockMarket,NWL,11,11,0,11,1,2,3,1,NASDAQ
4665,13-02-2021 00:00,24 hrs.,StockMarket,OGI,41,10,31,-21,3,11,7,3,NASDAQ
4665,13-02-2021 00:00,24 hrs.,StockMarket,OPK,6,6,0,6,1,1,0,1,NASDAQ
4665,13-02-2021 00:00,24 hrs.,StockMarket,QQQ,26,26,0,26,2,8,2,2,NASDAQ
4665,13-02-2021 00:00,24 hrs.,StockMarket,RCM,6,0,6,-6,1,1,0,1,NASDAQ
4665,13-02-2021 00:00,24 hrs.,StockMarket,SFT,6,6,0,6,1,1,0,1,NASDAQ
4665,13-02-2021 00:00,24 hrs.,StockMarket,SND,10,0,10,-10,1,3,0,1,NASDAQ
4665,13-02-2021 00:00,24 hrs.,StockMarket,VFF,9,9,0,9,1,2,1,1,NASDAQ
4665,13-02-2021 00:00,24 hrs.,StockMarket,AAPL,10,10,0,10,1,2,2,1,NASDAQ
4665,13-02-2021 00:00,24 hrs.,StockMarket,AEZS,6,0,6,-6,1,1,0,1,NASDAQ
4665,13-02-2021 00:00,24 hrs.,StockMarket,AMAT,16,16,0,16,1,6,0,1,NASDAQ
4665,13-02-2021 00:00,24 hrs.,StockMarket,AMZN,16,16,0,16,1,6,0,1,NASDAQ
4665,13-02-2021 00:00,24 hrs.,StockMarket,APHA,6,6,0,6,1,1,0,1,NASDAQ
4665,13-02-2021 00:00,24 hrs.,StockMarket,ARTL,80,80,0,80,1,19,38,1,NASDAQ
4665,13-02-2021 00:00,24 hrs.,StockMarket,ATHX,6,6,0,6,1,1,0,1,NASDAQ
4665,13-02-2021 00:00,24 hrs.,StockMarket,ATOS,23,16,7,9,2,7,1,2,NASDAQ
4665,13-02-2021 00:00,24 hrs.,StockMarket,AVGO,7,7,0,7,1,1,1,1,NASDAQ
4665,13-02-2021 00:00,24 hrs.,StockMarket,BBBY,6,6,0,6,1,1,0,1,NASDAQ
4665,13-02-2021 00:00,24 hrs.,StockMarket,BPTH,6,6,0,6,1,1,0,1,NASDAQ
4665,13-02-2021 00:00,24 hrs.,StockMarket,BSQR,8,8,0,8,1,2,0,1,NASDAQ
4665,13-02-2021 00:00,24 hrs.,StockMarket,BYND,6,6,0,6,1,1,0,1,NASDAQ
4665,13-02-2021 00:00,24 hrs.,StockMarket,CECE,12,0,12,-12,1,4,0,1,NASDAQ
4665,13-02-2021 00:00,24 hrs.,StockMarket,CLEU,93,93,0,93,2,19,47,2,NASDAQ
4665,13-02-2021 00:00,24 hrs.,StockMarket,CLSK,8,0,8,-8,1,1,2,1,NASDAQ
4665,13-02-2021 00:00,24 hrs.,StockMarket,COHR,11,11,0,11,1,2,3,1,NASDAQ
4665,13-02-2021 00:00,24 hrs.,StockMarket,CPLP,20,20,0,20,3,4,0,2,NASDAQ
4665,13-02-2021 00:00,24 hrs.,RobinHoodPennyStocks,NXTTF,6,6,0,6,1,1,0,1,OTC
4665,13-02-2021 00:00,24 hrs.,RobinHoodPennyStocks,PMEDF,6,6,0,6,1,1,0,1,OTC
4665,13-02-2021 00:00,24 hrs.,RobinHoodPennyStocks,RYCEY,18,18,0,18,3,3,0,3,OTC
4665,13-02-2021 00:00,24 hrs.,RobinHoodPennyStocks,SHCAY,21,21,0,21,1,8,1,1,OTC
4665,13-02-2021 00:00,24 hrs.,RobinHoodPennyStocks,TLOFF,6,0,6,-6,1,1,0,1,OTC
4665,13-02-2021 00:00,24 hrs.,RobinHoodPennyStocks,ZBISF,6,6,0,6,1,1,0,1,OTC
4665,13-02-2021 00:00,24 hrs.,RobinHoodPennyStocks,AAU,119,0,119,-119,1,44,27,1,AMEX
4665,13-02-2021 00:00,24 hrs.,RobinHoodPennyStocks,DNN,527,35,492,-457,9,181,129,8,AMEX
4665,13-02-2021 00:00,24 hrs.,RobinHoodPennyStocks,DPW,119,0,119,-119,1,44,27,1,AMEX
4665,13-02-2021 00:00,24 hrs.,RobinHoodPennyStocks,GSV,125,6,119,-113,2,45,27,2,AMEX
4665,13-02-2021 00:00,24 hrs.,RobinHoodPennyStocks,GTE,844,580,264,316,19,246,276,18,AMEX
4665,13-02-2021 00:00,24 hrs.,RobinHoodPennyStocks,ITP,6,6,0,6,1,1,0,1,AMEX
4665,13-02-2021 00:00,24 hrs.,RobinHoodPennyStocks,NAK,208,89,119,-30,7,61,58,7,AMEX
4665,13-02-2021 00:00,24 hrs.,RobinHoodPennyStocks,REI,22,22,0,22,2,5,4,2,AMEX
4665,13-02-2021 00:00,24 hrs.,RobinHoodPennyStocks,RHE,119,0,119,-119,1,44,27,1,AMEX
4665,13-02-2021 00:00,24 hrs.,RobinHoodPennyStocks,SYN,12,6,6,0,2,2,0,2,AMEX
4665,13-02-2021 00:00,24 hrs.,RobinHoodPennyStocks,TGB,105,0,105,-105,2,39,19,2,AMEX
4665,13-02-2021 00:00,24 hrs.,RobinHoodPennyStocks,TRT,119,0,119,-119,1,44,27,1,AMEX
4665,13-02-2021 00:00,24 hrs.,RobinHoodPennyStocks,TRX,258,38,220,-182,3,83,80,3,AMEX
4665,13-02-2021 00:00,24 hrs.,RobinHoodPennyStocks,XPL,119,0,119,-119,1,44,27,1,AMEX
4665,13-02-2021 00:00,24 hrs.,RobinHoodPennyStocks,ZOM,1099,1064,35,1029,12,414,223,11,AMEX
4665,13-02-2021 00:00,24 hrs.,RobinHoodPennyStocks,AMBO,119,0,119,-119,1,44,27,1,AMEX
4665,13-02-2021 00:00,24 hrs.,RobinHoodPennyStocks,AUMN,220,0,220,-220,2,74,64,2,AMEX
4665,13-02-2021 00:00,24 hrs.,RobinHoodPennyStocks,IBIO,35,35,0,35,1,13,5,1,AMEX
4665,13-02-2021 00:00,24 hrs.,RobinHoodPennyStocks,NSPR,37,30,7,23,2,9,11,2,AMEX
4665,13-02-2021 00:00,24 hrs.,RobinHoodPennyStocks,OGEN,18,18,0,18,3,3,0,3,AMEX
4665,13-02-2021 00:00,24 hrs.,RobinHoodPennyStocks,PLAG,119,0,119,-119,1,44,27,1,AMEX
4665,13-02-2021 00:00,24 hrs.,RobinHoodPennyStocks,SENS,63,63,0,63,3,23,5,3,AMEX
4665,13-02-2021 00:00,24 hrs.,RobinHoodPennyStocks,SMTS,6,0,6,-6,1,1,0,1,AMEX
4665,13-02-2021 00:00,24 hrs.,RobinHoodPennyStocks,TKAT,119,0,119,-119,1,44,27,1,AMEX
4665,13-02-2021 00:00,24 hrs.,RobinHoodPennyStocks,TRXC,173,6,167,-161,3,65,31,3,AMEX
4665,13-02-2021 00:00,24 hrs.,RobinHoodPennyStocks,YCBD,6,0,6,-6,1,1,0,1,AMEX
4665,13-02-2021 00:00,24 hrs.,RobinHoodPennyStocks,AIV,6,6,0,6,1,1,0,1,NYSE
4665,13-02-2021 00:00,24 hrs.,RobinHoodPennyStocks,AMC,159,0,159,-159,2,53,45,2,NYSE
4665,13-02-2021 00:00,24 hrs.,RobinHoodPennyStocks,AUY,101,0,101,-101,1,30,37,1,NYSE
4665,13-02-2021 00:00,24 hrs.,RobinHoodPennyStocks,BTU,119,0,119,-119,1,44,27,1,NYSE
4665,13-02-2021 00:00,24 hrs.,RobinHoodPennyStocks,CCM,119,0,119,-119,1,44,27,1,NYSE
4665,13-02-2021 00:00,24 hrs.,RobinHoodPennyStocks,COO,101,0,101,-101,1,30,37,1,NYSE
4665,13-02-2021 00:00,24 hrs.,RobinHoodPennyStocks,CTK,119,0,119,-119,1,44,27,1,NYSE
4665,13-02-2021 00:00,24 hrs.,RobinHoodPennyStocks,DNK,6,6,0,6,1,1,0,1,NYSE
4665,13-02-2021 00:00,24 hrs.,RobinHoodPennyStocks,FSR,125,6,119,-113,2,45,27,2,NYSE
4665,13-02-2021 00:00,24 hrs.,RobinHoodPennyStocks,GME,90,50,40,10,3,21,36,3,NYSE
4665,13-02-2021 00:00,24 hrs.,RobinHoodPennyStocks,GSX,119,0,119,-119,1,44,27,1,NYSE
4665,13-02-2021 00:00,24 hrs.,RobinHoodPennyStocks,IRS,225,225,0,225,1,101,19,1,NYSE
4665,13-02-2021 00:00,24 hrs.,RobinHoodPennyStocks,IVR,6,0,6,-6,1,1,0,1,NYSE
4665,13-02-2021 00:00,24 hrs.,RobinHoodPennyStocks,LOW,6,0,6,-6,1,1,0,1,NYSE
4665,13-02-2021 00:00,24 hrs.,RobinHoodPennyStocks,LYG,6,0,6,-6,1,1,0,1,NYSE
4665,13-02-2021 00:00,24 hrs.,RobinHoodPennyStocks,MTL,19,19,0,19,2,2,7,2,NYSE
4665,13-02-2021 00:00,24 hrs.,RobinHoodPennyStocks,NAT,6,6,0,6,1,1,0,1,NYSE
4665,13-02-2021 00:00,24 hrs.,RobinHoodPennyStocks,NBB,6,6,0,6,1,1,0,1,NYSE
4665,13-02-2021 00:00,24 hrs.,RobinHoodPennyStocks,NIO,119,0,119,-119,1,44,27,1,NYSE
4665,13-02-2021 00:00,24 hrs.,RobinHoodPennyStocks,PHI,6,6,0,6,1,1,0,1,NYSE
4665,13-02-2021 00:00,24 hrs.,RobinHoodPennyStocks,PSA,18,0,18,-18,1,5,4,1,NYSE
4665,13-02-2021 00:00,24 hrs.,RobinHoodPennyStocks,RFP,119,0,119,-119,1,44,27,1,NYSE
4665,13-02-2021 00:00,24 hrs.,RobinHoodPennyStocks,SOS,182,36,146,-110,4,59,48,4,NYSE
4665,13-02-2021 00:00,24 hrs.,RobinHoodPennyStocks,SUZ,119,0,119,-119,1,44,27,1,NYSE
4665,13-02-2021 00:00,24 hrs.,RobinHoodPennyStocks,TAL,119,0,119,-119,1,44,27,1,NYSE
4665,13-02-2021 00:00,24 hrs.,RobinHoodPennyStocks,WEI,119,0,119,-119,1,44,27,1,NYSE
4665,13-02-2021 00:00,24 hrs.,RobinHoodPennyStocks,BABA,119,0,119,-119,1,44,27,1,NYSE
4665,13-02-2021 00:00,24 hrs.,RobinHoodPennyStocks,CCIV,39,39,0,39,1,10,15,1,NYSE
4665,13-02-2021 00:00,24 hrs.,RobinHoodPennyStocks,CEIX,119,0,119,-119,1,44,27,1,NYSE
4665,13-02-2021 00:00,24 hrs.,RobinHoodPennyStocks,CMCM,119,0,119,-119,1,44,27,1,NYSE
4665,13-02-2021 00:00,24 hrs.,RobinHoodPennyStocks,FUBO,119,0,119,-119,1,44,27,1,NYSE
4665,13-02-2021 00:00,24 hrs.,RobinHoodPennyStocks,LAIX,119,0,119,-119,1,44,27,1,NYSE
4665,13-02-2021 00:00,24 hrs.,RobinHoodPennyStocks,PLTR,6,6,0,6,1,1,0,1,NYSE
4665,13-02-2021 00:00,24 hrs.,RobinHoodPennyStocks,RLGY,119,0,119,-119,1,44,27,1,NYSE
4665,13-02-2021 00:00,24 hrs.,RobinHoodPennyStocks,XPEV,119,0,119,-119,1,44,27,1,NYSE
4665,13-02-2021 00:00,24 hrs.,RobinHoodPennyStocks,AIH,119,0,119,-119,1,44,27,1,NASDAQ
4665,13-02-2021 00:00,24 hrs.,RobinHoodPennyStocks,BBI,6,6,0,6,1,1,0,1,NASDAQ
4665,13-02-2021 00:00,24 hrs.,RobinHoodPennyStocks,ENG,119,0,119,-119,1,44,27,1,NASDAQ
4665,13-02-2021 00:00,24 hrs.,RobinHoodPennyStocks,EVK,119,0,119,-119,1,44,27,1,NASDAQ
4665,13-02-2021 00:00,24 hrs.,RobinHoodPennyStocks,MGI,119,0,119,-119,1,44,27,1,NASDAQ
4665,13-02-2021 00:00,24 hrs.,RobinHoodPennyStocks,OCG,119,0,119,-119,1,44,27,1,NASDAQ
4665,13-02-2021 00:00,24 hrs.,RobinHoodPennyStocks,OEG,119,0,119,-119,1,44,27,1,NASDAQ
4665,13-02-2021 00:00,24 hrs.,RobinHoodPennyStocks,OGI,6,6,0,6,1,1,0,1,NASDAQ
4665,13-02-2021 00:00,24 hrs.,RobinHoodPennyStocks,PTE,12,0,12,-12,2,2,0,1,NASDAQ
4665,13-02-2021 00:00,24 hrs.,RobinHoodPennyStocks,QTT,119,0,119,-119,1,44,27,1,NASDAQ
4665,13-02-2021 00:00,24 hrs.,RobinHoodPennyStocks,SND,34,34,0,34,4,7,4,2,NASDAQ
4665,13-02-2021 00:00,24 hrs.,StockMarket,CRSP,4,0,4,-4,1,0,0,1,NASDAQ
4665,13-02-2021 00:00,24 hrs.,StockMarket,CRSR,10,10,0,10,1,2,2,1,NASDAQ
4665,13-02-2021 00:00,24 hrs.,StockMarket,CTRM,6,6,0,6,1,1,0,1,NASDAQ
4665,13-02-2021 00:00,24 hrs.,StockMarket,CWCO,12,12,0,12,2,2,0,1,NASDAQ
4665,13-02-2021 00:00,24 hrs.,StockMarket,DDOG,27,27,0,27,2,8,3,2,NASDAQ
4665,13-02-2021 00:00,24 hrs.,StockMarket,ENTX,8,0,8,-8,1,2,0,1,NASDAQ
4665,13-02-2021 00:00,24 hrs.,StockMarket,EXPE,11,11,0,11,1,2,3,1,NASDAQ
4665,13-02-2021 00:00,24 hrs.,StockMarket,FROG,16,16,0,16,1,6,0,1,NASDAQ
4665,13-02-2021 00:00,24 hrs.,StockMarket,GBIO,7,7,0,7,1,1,1,1,NASDAQ
4665,13-02-2021 00:00,24 hrs.,StockMarket,HTBX,74,68,6,62,3,18,26,3,NASDAQ
4665,13-02-2021 00:00,24 hrs.,StockMarket,IDEX,6,6,0,6,1,1,0,1,NASDAQ
4665,13-02-2021 00:00,24 hrs.,StockMarket,IIVI,11,11,0,11,1,2,3,1,NASDAQ
4665,13-02-2021 00:00,24 hrs.,StockMarket,INPX,6,6,0,6,1,1,0,1,NASDAQ
4665,13-02-2021 00:00,24 hrs.,StockMarket,INTZ,4,0,4,-4,1,0,0,1,NASDAQ
4665,13-02-2021 00:00,24 hrs.,StockMarket,INVE,24,0,24,-24,2,6,4,1,NASDAQ
4665,13-02-2021 00:00,24 hrs.,StockMarket,LAZR,6,0,6,-6,1,1,0,1,NASDAQ
4665,13-02-2021 00:00,24 hrs.,StockMarket,LGND,6,0,6,-6,1,1,0,1,NASDAQ
4665,13-02-2021 00:00,24 hrs.,StockMarket,LIFE,3965,0,3965,-3965,1,1937,87,1,NASDAQ
4665,13-02-2021 00:00,24 hrs.,StockMarket,LITE,11,11,0,11,1,2,3,1,NASDAQ
4665,13-02-2021 00:00,24 hrs.,StockMarket,LIVE,11,11,0,11,1,2,3,1,NASDAQ
4665,13-02-2021 00:00,24 hrs.,StockMarket,LLNW,25,13,12,1,4,4,1,2,NASDAQ
4665,13-02-2021 00:00,24 hrs.,StockMarket,MKSI,11,11,0,11,1,2,3,1,NASDAQ
4665,13-02-2021 00:00,24 hrs.,StockMarket,MSFT,10,10,0,10,1,2,2,1,NASDAQ
4665,13-02-2021 00:00,24 hrs.,StockMarket,MSTR,12,0,12,-12,2,2,0,1,NASDAQ
4665,13-02-2021 00:00,24 hrs.,StockMarket,MTCH,7,7,0,7,1,0,3,1,NASDAQ
4665,13-02-2021 00:00,24 hrs.,StockMarket,OCGN,25,25,0,25,3,2,9,3,NASDAQ
4665,13-02-2021 00:00,24 hrs.,StockMarket,PACB,4,0,4,-4,1,0,0,1,NASDAQ
4665,13-02-2021 00:00,24 hrs.,StockMarket,PTON,10,10,0,10,1,2,2,1,NASDAQ
4665,13-02-2021 00:00,24 hrs.,StockMarket,PYPL,20,0,20,-20,1,6,4,1,NASDAQ
4665,13-02-2021 00:00,24 hrs.,StockMarket,RARE,16,16,0,16,1,6,0,1,NASDAQ
4665,13-02-2021 00:00,24 hrs.,StockMarket,RBBN,6,6,0,6,1,1,0,1,NASDAQ
4665,13-02-2021 00:00,24 hrs.,StockMarket,RCMT,4,0,4,-4,1,0,0,1,NASDAQ
4665,13-02-2021 00:00,24 hrs.,StockMarket,REAL,34,34,0,34,1,0,30,1,NASDAQ
4665,13-02-2021 00:00,24 hrs.,StockMarket,RIDE,17,17,0,17,2,3,3,2,NASDAQ
4665,13-02-2021 00:00,24 hrs.,StockMarket,RIGL,6,0,6,-6,1,1,0,1,NASDAQ
4665,13-02-2021 00:00,24 hrs.,StockMarket,SBUX,10,10,0,10,1,2,2,1,NASDAQ
4665,13-02-2021 00:00,24 hrs.,StockMarket,SESN,18,18,0,18,2,4,2,1,NASDAQ
4665,13-02-2021 00:00,24 hrs.,StockMarket,SNDL,415,12,403,-391,8,132,119,8,NASDAQ
4665,13-02-2021 00:00,24 hrs.,StockMarket,SPSC,16,16,0,16,1,6,0,1,NASDAQ
4665,13-02-2021 00:00,24 hrs.,StockMarket,SRAC,8,8,0,8,1,0,4,1,NASDAQ
4665,13-02-2021 00:00,24 hrs.,StockMarket,SVMK,11,11,0,11,1,2,3,1,NASDAQ
4665,13-02-2021 00:00,24 hrs.,StockMarket,TLRY,89,58,31,27,7,21,19,7,NASDAQ
4665,13-02-2021 00:00,24 hrs.,StockMarket,TLSA,4,0,4,-4,1,0,0,1,NASDAQ
4665,13-02-2021 00:00,24 hrs.,StockMarket,TNXP,6,6,0,6,1,1,0,1,NASDAQ
4665,13-02-2021 00:00,24 hrs.,StockMarket,TRVG,6,6,0,6,1,1,0,1,NASDAQ
4665,13-02-2021 00:00,24 hrs.,StockMarket,TSLA,6,6,0,6,1,1,0,1,NASDAQ
4665,13-02-2021 00:00,24 hrs.,StockMarket,VITL,6,6,0,6,1,1,0,1,NASDAQ
4665,13-02-2021 00:00,24 hrs.,StockMarket,VRSN,11,11,0,11,1,2,3,1,NASDAQ
4665,13-02-2021 00:00,24 hrs.,StockMarket,VUZI,6,6,0,6,1,1,0,1,NASDAQ
4665,13-02-2021 00:00,24 hrs.,StockMarket,WAFU,80,80,0,80,1,19,38,1,NASDAQ
4665,13-02-2021 00:00,24 hrs.,StockMarket,ZIOP,6,6,0,6,1,1,0,1,NASDAQ
4665,13-02-2021 00:00,24 hrs.,StockMarket,SRACU,8,8,0,8,1,0,4,1,NASDAQ
4665,13-02-2021 00:00,24 hrs.,StockMarket,SRACW,8,8,0,8,1,0,4,1,NASDAQ
4665,13-02-2021 00:00,24 hrs.,pennystocks,AABB,18,0,18,-18,3,3,0,2,OTC
4665,13-02-2021 00:00,24 hrs.,pennystocks,ABML,114,114,0,114,2,34,38,2,OTC
4665,13-02-2021 00:00,24 hrs.,pennystocks,ADTM,13,13,0,13,2,2,1,1,OTC
4665,13-02-2021 00:00,24 hrs.,pennystocks,AEPT,6,0,6,-6,1,1,0,1,OTC
4665,13-02-2021 00:00,24 hrs.,pennystocks,AFPW,6,6,0,6,1,1,0,1,OTC
4665,13-02-2021 00:00,24 hrs.,pennystocks,AITX,522,346,176,170,6,153,192,6,OTC
4665,13-02-2021 00:00,24 hrs.,pennystocks,ALKM,26,7,19,-12,4,4,2,2,OTC
4665,13-02-2021 00:00,24 hrs.,pennystocks,ALPP,362,362,0,362,6,121,96,5,OTC
4665,13-02-2021 00:00,24 hrs.,pennystocks,ALST,26,26,0,26,2,3,12,1,OTC
4665,13-02-2021 00:00,24 hrs.,pennystocks,ALYI,187,44,143,-99,4,61,49,4,OTC
4665,13-02-2021 00:00,24 hrs.,pennystocks,ANDI,7,0,7,-7,1,1,1,1,OTC
4665,13-02-2021 00:00,24 hrs.,pennystocks,APPZ,7,7,0,7,1,1,1,1,OTC
4665,13-02-2021 00:00,24 hrs.,pennystocks,ASCK,6,6,0,6,1,1,0,1,OTC
4665,13-02-2021 00:00,24 hrs.,pennystocks,ASTI,18,18,0,18,3,3,0,3,OTC
4665,13-02-2021 00:00,24 hrs.,pennystocks,ATDS,6,6,0,6,1,1,0,1,OTC
4665,13-02-2021 00:00,24 hrs.,pennystocks,ATNP,26,26,0,26,1,4,14,1,OTC
4665,13-02-2021 00:00,24 hrs.,pennystocks,AXXA,18,18,0,18,1,5,4,1,OTC
4665,13-02-2021 00:00,24 hrs.,pennystocks,AZFL,101,44,57,-13,4,12,61,3,OTC
4665,13-02-2021 00:00,24 hrs.,pennystocks,BANT,25,6,19,-13,2,4,9,2,OTC
4665,13-02-2021 00:00,24 hrs.,pennystocks,BBRW,156,156,0,156,4,35,70,4,OTC
4665,13-02-2021 00:00,24 hrs.,pennystocks,BDGR,6,6,0,6,1,1,0,1,OTC
4665,13-02-2021 00:00,24 hrs.,pennystocks,BFRE,16,16,0,16,1,0,12,1,OTC
4665,13-02-2021 00:00,24 hrs.,pennystocks,BGMD,6,6,0,6,1,1,0,1,OTC
4665,13-02-2021 00:00,24 hrs.,pennystocks,BIEL,107,107,0,107,4,27,37,3,OTC
4665,13-02-2021 00:00,24 hrs.,pennystocks,BKMP,6,0,6,-6,1,1,0,1,OTC
4665,13-02-2021 00:00,24 hrs.,pennystocks,BLDV,48,48,0,48,1,14,16,1,OTC
4665,13-02-2021 00:00,24 hrs.,pennystocks,BLSP,13,6,7,-1,2,2,1,2,OTC
4665,13-02-2021 00:00,24 hrs.,pennystocks,BMCS,10,10,0,10,1,2,2,1,OTC
4665,13-02-2021 00:00,24 hrs.,pennystocks,BMIX,45,0,45,-45,2,8,21,2,OTC
4665,13-02-2021 00:00,24 hrs.,pennystocks,BMMJ,6,6,0,6,1,1,0,1,OTC
4665,13-02-2021 00:00,24 hrs.,pennystocks,BONZ,6,6,0,6,1,0,2,1,OTC
4665,13-02-2021 00:00,24 hrs.,pennystocks,BOTY,20,0,20,-20,3,3,2,2,OTC
4665,13-02-2021 00:00,24 hrs.,pennystocks,BRGO,19,0,19,-19,1,6,3,1,OTC
4665,13-02-2021 00:00,24 hrs.,pennystocks,BRLL,45,45,0,45,2,3,31,2,OTC
4665,13-02-2021 00:00,24 hrs.,pennystocks,BRTX,12,12,0,12,2,2,0,2,OTC
4665,13-02-2021 00:00,24 hrs.,RobinHoodPennyStocks,SPI,119,0,119,-119,1,44,27,1,NASDAQ
4665,13-02-2021 00:00,24 hrs.,RobinHoodPennyStocks,WNW,119,0,119,-119,1,44,27,1,NASDAQ
4665,13-02-2021 00:00,24 hrs.,RobinHoodPennyStocks,WWR,119,0,119,-119,1,44,27,1,NASDAQ
4665,13-02-2021 00:00,24 hrs.,RobinHoodPennyStocks,AAOI,119,0,119,-119,1,44,27,1,NASDAQ
4665,13-02-2021 00:00,24 hrs.,RobinHoodPennyStocks,ABEO,169,169,0,169,3,54,49,3,NASDAQ
4665,13-02-2021 00:00,24 hrs.,RobinHoodPennyStocks,ABIO,28,0,28,-28,1,4,16,1,NASDAQ
4665,13-02-2021 00:00,24 hrs.,RobinHoodPennyStocks,ACOR,119,0,119,-119,1,44,27,1,NASDAQ
4665,13-02-2021 00:00,24 hrs.,RobinHoodPennyStocks,ACRX,20,20,0,20,1,6,4,1,NASDAQ
4665,13-02-2021 00:00,24 hrs.,RobinHoodPennyStocks,ACST,6,6,0,6,1,1,0,1,NASDAQ
4665,13-02-2021 00:00,24 hrs.,RobinHoodPennyStocks,ADXS,18,18,0,18,3,3,0,2,NASDAQ
4665,13-02-2021 00:00,24 hrs.,RobinHoodPennyStocks,AEHR,119,0,119,-119,1,44,27,1,NASDAQ
4665,13-02-2021 00:00,24 hrs.,RobinHoodPennyStocks,AEZS,101,101,0,101,1,42,13,1,NASDAQ
4665,13-02-2021 00:00,24 hrs.,RobinHoodPennyStocks,AGTC,2061,1095,966,129,20,820,341,18,NASDAQ
4665,13-02-2021 00:00,24 hrs.,RobinHoodPennyStocks,AIHS,119,0,119,-119,1,44,27,1,NASDAQ
4665,13-02-2021 00:00,24 hrs.,RobinHoodPennyStocks,ALAC,119,0,119,-119,1,44,27,1,NASDAQ
4665,13-02-2021 00:00,24 hrs.,RobinHoodPennyStocks,AMTX,119,0,119,-119,1,44,27,1,NASDAQ
4665,13-02-2021 00:00,24 hrs.,RobinHoodPennyStocks,APHA,12,6,6,0,2,2,0,2,NASDAQ
4665,13-02-2021 00:00,24 hrs.,RobinHoodPennyStocks,ARPO,6,0,6,-6,1,1,0,1,NASDAQ
4665,13-02-2021 00:00,24 hrs.,RobinHoodPennyStocks,ARTL,18,18,0,18,3,3,0,3,NASDAQ
4665,13-02-2021 00:00,24 hrs.,RobinHoodPennyStocks,ASRT,55,55,0,55,4,17,5,3,NASDAQ
4665,13-02-2021 00:00,24 hrs.,RobinHoodPennyStocks,ASYS,119,0,119,-119,1,44,27,1,NASDAQ
4665,13-02-2021 00:00,24 hrs.,RobinHoodPennyStocks,ATIF,119,0,119,-119,1,44,27,1,NASDAQ
4665,13-02-2021 00:00,24 hrs.,RobinHoodPennyStocks,ATNI,119,0,119,-119,1,44,27,1,NASDAQ
4665,13-02-2021 00:00,24 hrs.,RobinHoodPennyStocks,ATOS,528,504,24,480,15,188,92,15,NASDAQ
4665,13-02-2021 00:00,24 hrs.,RobinHoodPennyStocks,AVCO,119,0,119,-119,1,44,27,1,NASDAQ
4665,13-02-2021 00:00,24 hrs.,RobinHoodPennyStocks,BBIG,6,0,6,-6,1,1,0,1,NASDAQ
4665,13-02-2021 00:00,24 hrs.,RobinHoodPennyStocks,BFRA,119,0,119,-119,1,44,27,1,NASDAQ
4665,13-02-2021 00:00,24 hrs.,RobinHoodPennyStocks,BHAT,119,0,119,-119,1,44,27,1,NASDAQ
4665,13-02-2021 00:00,24 hrs.,RobinHoodPennyStocks,BHTG,66,66,0,66,2,22,14,2,NASDAQ
4665,13-02-2021 00:00,24 hrs.,RobinHoodPennyStocks,BIOL,6,6,0,6,1,1,0,1,NASDAQ
4665,13-02-2021 00:00,24 hrs.,RobinHoodPennyStocks,BNGO,40,40,0,40,3,10,8,3,NASDAQ
4665,13-02-2021 00:00,24 hrs.,RobinHoodPennyStocks,BRQS,152,6,146,-140,3,50,40,3,NASDAQ
4665,13-02-2021 00:00,24 hrs.,RobinHoodPennyStocks,BYFC,119,0,119,-119,1,44,27,1,NASDAQ
4665,13-02-2021 00:00,24 hrs.,RobinHoodPennyStocks,CAAS,119,0,119,-119,1,44,27,1,NASDAQ
4665,13-02-2021 00:00,24 hrs.,RobinHoodPennyStocks,CARV,119,0,119,-119,1,44,27,1,NASDAQ
4665,13-02-2021 00:00,24 hrs.,RobinHoodPennyStocks,CBAT,119,0,119,-119,1,44,27,1,NASDAQ
4665,13-02-2021 00:00,24 hrs.,RobinHoodPennyStocks,CCNC,119,0,119,-119,1,44,27,1,NASDAQ
4665,13-02-2021 00:00,24 hrs.,RobinHoodPennyStocks,CDTX,6,6,0,6,1,1,0,1,NASDAQ
4665,13-02-2021 00:00,24 hrs.,RobinHoodPennyStocks,CHNR,119,0,119,-119,1,44,27,1,NASDAQ
4665,13-02-2021 00:00,24 hrs.,RobinHoodPennyStocks,CIDM,6,6,0,6,1,1,0,1,NASDAQ
4665,13-02-2021 00:00,24 hrs.,RobinHoodPennyStocks,CKPT,64,64,0,64,2,22,12,2,NASDAQ
4665,13-02-2021 00:00,24 hrs.,RobinHoodPennyStocks,CLBS,14,14,0,14,2,3,0,2,NASDAQ
4665,13-02-2021 00:00,24 hrs.,RobinHoodPennyStocks,CLEU,119,0,119,-119,1,44,27,1,NASDAQ
4665,13-02-2021 00:00,24 hrs.,RobinHoodPennyStocks,CLSK,119,0,119,-119,1,44,27,1,NASDAQ
4665,13-02-2021 00:00,24 hrs.,RobinHoodPennyStocks,CMLF,119,0,119,-119,1,44,27,1,NASDAQ
4665,13-02-2021 00:00,24 hrs.,RobinHoodPennyStocks,CSCW,119,0,119,-119,1,44,27,1,NASDAQ
4665,13-02-2021 00:00,24 hrs.,RobinHoodPennyStocks,CTRM,584,256,328,-72,11,183,174,11,NASDAQ
4665,13-02-2021 00:00,24 hrs.,RobinHoodPennyStocks,DFFN,690,684,6,678,9,255,144,8,NASDAQ
4665,13-02-2021 00:00,24 hrs.,RobinHoodPennyStocks,EAST,54,0,54,-54,1,17,16,1,NASDAQ
4665,13-02-2021 00:00,24 hrs.,RobinHoodPennyStocks,ENTX,62,62,0,62,1,24,10,1,NASDAQ
4665,13-02-2021 00:00,24 hrs.,RobinHoodPennyStocks,EQOS,119,0,119,-119,1,44,27,1,NASDAQ
4665,13-02-2021 00:00,24 hrs.,RobinHoodPennyStocks,FCEL,164,45,119,-74,2,51,54,2,NASDAQ
4665,13-02-2021 00:00,24 hrs.,RobinHoodPennyStocks,GLBS,6,6,0,6,1,1,0,1,NASDAQ
4665,13-02-2021 00:00,24 hrs.,RobinHoodPennyStocks,GMDA,6,0,6,-6,1,1,0,1,NASDAQ
4665,13-02-2021 00:00,24 hrs.,RobinHoodPennyStocks,GRIL,119,0,119,-119,1,44,27,1,NASDAQ
4665,13-02-2021 00:00,24 hrs.,RobinHoodPennyStocks,HCDI,119,0,119,-119,1,44,27,1,NASDAQ
4665,13-02-2021 00:00,24 hrs.,RobinHoodPennyStocks,HGSH,119,0,119,-119,1,44,27,1,NASDAQ
4665,13-02-2021 00:00,24 hrs.,RobinHoodPennyStocks,IDEX,132,13,119,-106,2,46,32,2,NASDAQ
4665,13-02-2021 00:00,24 hrs.,RobinHoodPennyStocks,IFMK,119,0,119,-119,1,44,27,1,NASDAQ
4665,13-02-2021 00:00,24 hrs.,RobinHoodPennyStocks,IMTE,119,0,119,-119,1,44,27,1,NASDAQ
4665,13-02-2021 00:00,24 hrs.,RobinHoodPennyStocks,ITRM,6,6,0,6,1,1,0,1,NASDAQ
4665,13-02-2021 00:00,24 hrs.,RobinHoodPennyStocks,IZEA,119,0,119,-119,1,44,27,1,NASDAQ
4665,13-02-2021 00:00,24 hrs.,RobinHoodPennyStocks,JFIN,119,0,119,-119,1,44,27,1,NASDAQ
4665,13-02-2021 00:00,24 hrs.,RobinHoodPennyStocks,JRJC,119,0,119,-119,1,44,27,1,NASDAQ
4665,13-02-2021 00:00,24 hrs.,RobinHoodPennyStocks,KNDI,119,0,119,-119,1,44,27,1,NASDAQ
4665,13-02-2021 00:00,24 hrs.,RobinHoodPennyStocks,KTRA,59,10,49,-39,2,20,11,2,NASDAQ
4665,13-02-2021 00:00,24 hrs.,RobinHoodPennyStocks,KXIN,119,0,119,-119,1,44,27,1,NASDAQ
4665,13-02-2021 00:00,24 hrs.,RobinHoodPennyStocks,LEDS,119,0,119,-119,1,44,27,1,NASDAQ
4665,13-02-2021 00:00,24 hrs.,RobinHoodPennyStocks,LKCO,101,95,6,89,9,26,13,9,NASDAQ
4665,13-02-2021 00:00,24 hrs.,RobinHoodPennyStocks,LMFA,119,0,119,-119,1,44,27,1,NASDAQ
4665,13-02-2021 00:00,24 hrs.,RobinHoodPennyStocks,LXEH,119,0,119,-119,1,44,27,1,NASDAQ
4665,13-02-2021 00:00,24 hrs.,RobinHoodPennyStocks,MARA,119,0,119,-119,1,44,27,1,NASDAQ
4665,13-02-2021 00:00,24 hrs.,RobinHoodPennyStocks,METX,119,0,119,-119,1,44,27,1,NASDAQ
4665,13-02-2021 00:00,24 hrs.,RobinHoodPennyStocks,MMLP,6,6,0,6,1,1,0,1,NASDAQ
4665,13-02-2021 00:00,24 hrs.,RobinHoodPennyStocks,MOGO,119,0,119,-119,1,44,27,1,NASDAQ
4665,13-02-2021 00:00,24 hrs.,RobinHoodPennyStocks,MOMO,119,0,119,-119,1,44,27,1,NASDAQ
4665,13-02-2021 00:00,24 hrs.,pennystocks,BRZL,6,6,0,6,1,1,0,1,OTC
4665,13-02-2021 00:00,24 hrs.,pennystocks,BTZI,6,6,0,6,1,1,0,1,OTC
4665,13-02-2021 00:00,24 hrs.,pennystocks,BUDZ,24,13,11,2,3,4,4,3,OTC
4665,13-02-2021 00:00,24 hrs.,pennystocks,BWMG,59,59,0,59,2,15,21,2,OTC
4665,13-02-2021 00:00,24 hrs.,pennystocks,BZWR,15,15,0,15,1,0,11,1,OTC
4665,13-02-2021 00:00,24 hrs.,pennystocks,CANN,6,6,0,6,1,1,0,1,OTC
4665,13-02-2021 00:00,24 hrs.,pennystocks,CAPC,7,7,0,7,1,1,1,1,OTC
4665,13-02-2021 00:00,24 hrs.,pennystocks,CATV,71,71,0,71,1,30,7,1,OTC
4665,13-02-2021 00:00,24 hrs.,pennystocks,CAVR,6,6,0,6,1,1,0,1,OTC
4665,13-02-2021 00:00,24 hrs.,pennystocks,CBBT,492,363,129,234,7,190,84,6,OTC
4665,13-02-2021 00:00,24 hrs.,pennystocks,CBDD,5,0,5,-5,1,0,1,1,OTC
4665,13-02-2021 00:00,24 hrs.,pennystocks,CBDL,416,246,170,76,5,113,170,5,OTC
4665,13-02-2021 00:00,24 hrs.,pennystocks,CCTL,12,12,0,12,1,3,2,1,OTC
4665,13-02-2021 00:00,24 hrs.,pennystocks,CELZ,7,7,0,7,1,1,1,1,OTC
4665,13-02-2021 00:00,24 hrs.,pennystocks,CHNC,22,22,0,22,1,6,6,1,OTC
4665,13-02-2021 00:00,24 hrs.,pennystocks,CLWD,6,6,0,6,1,1,0,1,OTC
4665,13-02-2021 00:00,24 hrs.,pennystocks,CNNA,29,0,29,-29,2,5,11,2,OTC
4665,13-02-2021 00:00,24 hrs.,pennystocks,CORG,37,37,0,37,3,4,17,3,OTC
4665,13-02-2021 00:00,24 hrs.,pennystocks,CRTG,33,33,0,33,1,10,9,1,OTC
4665,13-02-2021 00:00,24 hrs.,pennystocks,CRWG,6,6,0,6,1,1,0,1,OTC
4665,13-02-2021 00:00,24 hrs.,pennystocks,CSLI,43,43,0,43,1,12,15,1,OTC
4665,13-02-2021 00:00,24 hrs.,pennystocks,CTLE,12,6,6,0,2,2,0,2,OTC
4665,13-02-2021 00:00,24 hrs.,pennystocks,CYDY,7,7,0,7,1,1,1,1,OTC
4665,13-02-2021 00:00,24 hrs.,pennystocks,CYPW,6,0,6,-6,1,1,0,1,OTC
4665,13-02-2021 00:00,24 hrs.,pennystocks,DGMA,6,0,6,-6,1,1,0,1,OTC
4665,13-02-2021 00:00,24 hrs.,pennystocks,DIGI,13,0,13,-13,2,2,1,1,OTC
4665,13-02-2021 00:00,24 hrs.,pennystocks,DMAN,15,15,0,15,1,3,5,1,OTC
4665,13-02-2021 00:00,24 hrs.,pennystocks,DPLS,396,115,281,-166,11,113,126,9,OTC
4665,13-02-2021 00:00,24 hrs.,pennystocks,ECCI,6,0,6,-6,1,1,0,1,OTC
4665,13-02-2021 00:00,24 hrs.,pennystocks,ECEZ,122,0,122,-122,1,45,28,1,OTC
4665,13-02-2021 00:00,24 hrs.,pennystocks,ELTP,16,16,0,16,1,4,4,1,OTC
4665,13-02-2021 00:00,24 hrs.,pennystocks,ENCS,6,0,6,-6,1,1,0,1,OTC
4665,13-02-2021 00:00,24 hrs.,pennystocks,ENDV,6,0,6,-6,1,1,0,1,OTC
4665,13-02-2021 00:00,24 hrs.,pennystocks,ENRT,6,6,0,6,1,1,0,1,OTC
4665,13-02-2021 00:00,24 hrs.,pennystocks,ENZC,12,12,0,12,2,2,0,2,OTC
4665,13-02-2021 00:00,24 hrs.,pennystocks,ERBB,12,12,0,12,1,0,8,1,OTC
4665,13-02-2021 00:00,24 hrs.,pennystocks,ETFM,153,147,6,141,4,48,41,3,OTC
4665,13-02-2021 00:00,24 hrs.,pennystocks,ETHE,35,35,0,35,1,3,25,1,OTC
4665,13-02-2021 00:00,24 hrs.,pennystocks,EWKS,7,7,0,7,1,1,1,1,OTC
4665,13-02-2021 00:00,24 hrs.,pennystocks,FBEC,6,0,6,-6,1,1,0,1,OTC
4665,13-02-2021 00:00,24 hrs.,pennystocks,FDBH,7,0,7,-7,1,1,1,1,OTC
4665,13-02-2021 00:00,24 hrs.,pennystocks,FLXT,6,6,0,6,1,1,0,1,OTC
4665,13-02-2021 00:00,24 hrs.,pennystocks,FTEG,6,6,0,6,1,1,0,1,OTC
4665,13-02-2021 00:00,24 hrs.,pennystocks,FTFY,6,0,6,-6,1,1,0,1,OTC
4665,13-02-2021 00:00,24 hrs.,pennystocks,FUST,7,7,0,7,1,1,1,1,OTC
4665,13-02-2021 00:00,24 hrs.,pennystocks,FUTL,7,0,7,-7,1,1,1,1,OTC
4665,13-02-2021 00:00,24 hrs.,pennystocks,GBTC,35,35,0,35,1,3,25,1,OTC
4665,13-02-2021 00:00,24 hrs.,pennystocks,GHMP,44,44,0,44,3,7,18,2,OTC
4665,13-02-2021 00:00,24 hrs.,pennystocks,GLCO,6,6,0,6,1,1,0,1,OTC
4665,13-02-2021 00:00,24 hrs.,pennystocks,GLEC,6,6,0,6,1,1,0,1,OTC
4665,13-02-2021 00:00,24 hrs.,pennystocks,GMEV,677,0,677,-677,1,264,145,1,OTC
4665,13-02-2021 00:00,24 hrs.,pennystocks,GPFT,41,0,41,-41,1,9,19,1,OTC
4665,13-02-2021 00:00,24 hrs.,pennystocks,GRCU,18,12,6,6,2,3,4,2,OTC
4665,13-02-2021 00:00,24 hrs.,pennystocks,GRST,72,72,0,72,2,22,20,1,OTC
4665,13-02-2021 00:00,24 hrs.,pennystocks,GTBP,21,21,0,21,1,3,11,1,OTC
4665,13-02-2021 00:00,24 hrs.,pennystocks,GTCH,22,0,22,-22,1,1,16,1,OTC
4665,13-02-2021 00:00,24 hrs.,pennystocks,GTEH,97,0,97,-97,1,38,17,1,OTC
4665,13-02-2021 00:00,24 hrs.,pennystocks,GTLL,120,69,51,18,4,37,30,4,OTC
4665,13-02-2021 00:00,24 hrs.,pennystocks,HALB,31,31,0,31,2,8,7,1,OTC
4665,13-02-2021 00:00,24 hrs.,pennystocks,HCMC,134,84,50,34,21,21,8,18,OTC
4665,13-02-2021 00:00,24 hrs.,pennystocks,HEMP,14,7,7,0,2,2,2,2,OTC
4665,13-02-2021 00:00,24 hrs.,pennystocks,HIPH,12,6,6,0,2,2,0,2,OTC
4665,13-02-2021 00:00,24 hrs.,pennystocks,HMMR,7,7,0,7,1,1,1,1,OTC
4665,13-02-2021 00:00,24 hrs.,pennystocks,HMNY,6,6,0,6,1,1,0,1,OTC
4665,13-02-2021 00:00,24 hrs.,pennystocks,HPTY,45,45,0,45,1,14,13,1,OTC
4665,13-02-2021 00:00,24 hrs.,pennystocks,HQGE,6,0,6,-6,1,1,0,1,OTC
4665,13-02-2021 00:00,24 hrs.,pennystocks,HYII,7,0,7,-7,1,1,1,1,OTC
4665,13-02-2021 00:00,24 hrs.,pennystocks,HYSR,155,6,149,-143,3,51,41,3,OTC
4665,13-02-2021 00:00,24 hrs.,pennystocks,ICBU,6,6,0,6,1,1,0,1,OTC
4665,13-02-2021 00:00,24 hrs.,pennystocks,ICLD,6,6,0,6,1,1,0,1,OTC
4665,13-02-2021 00:00,24 hrs.,pennystocks,ICNM,15,15,0,15,1,3,5,1,OTC
4665,13-02-2021 00:00,24 hrs.,pennystocks,IMJX,94,88,6,82,2,25,36,2,OTC
4665,13-02-2021 00:00,24 hrs.,pennystocks,IMTL,6,6,0,6,1,1,0,1,OTC
4665,13-02-2021 00:00,24 hrs.,pennystocks,INKW,56,50,6,44,9,9,2,7,OTC
4665,13-02-2021 00:00,24 hrs.,pennystocks,INND,184,145,39,106,9,30,88,9,OTC
4665,13-02-2021 00:00,24 hrs.,pennystocks,INTV,12,12,0,12,2,2,0,2,OTC
4665,13-02-2021 00:00,24 hrs.,pennystocks,IPIX,73,6,67,-61,2,16,33,2,OTC
4665,13-02-2021 00:00,24 hrs.,pennystocks,IPSI,21,15,6,9,2,5,3,2,OTC
4665,13-02-2021 00:00,24 hrs.,pennystocks,IQST,51,51,0,51,4,3,29,3,OTC
4665,13-02-2021 00:00,24 hrs.,pennystocks,ITCJ,7,7,0,7,1,1,1,1,OTC
4665,13-02-2021 00:00,24 hrs.,pennystocks,JSDA,6,6,0,6,1,1,0,1,OTC
4665,13-02-2021 00:00,24 hrs.,pennystocks,KGKG,25,0,25,-25,4,4,1,2,OTC
4665,13-02-2021 00:00,24 hrs.,pennystocks,KWBT,13,6,7,-1,2,2,1,2,OTC
4665,13-02-2021 00:00,24 hrs.,pennystocks,KYNC,37,6,31,-25,6,6,1,2,OTC
4665,13-02-2021 00:00,24 hrs.,pennystocks,LITH,6,6,0,6,1,1,0,1,OTC
4665,13-02-2021 00:00,24 hrs.,pennystocks,LQMT,98,6,92,-86,2,29,32,2,OTC
4665,13-02-2021 00:00,24 hrs.,pennystocks,LTNC,6,0,6,-6,1,1,0,1,OTC
4665,13-02-2021 00:00,24 hrs.,pennystocks,LUVU,14,14,0,14,2,3,0,2,OTC
4665,13-02-2021 00:00,24 hrs.,pennystocks,LVVV,24,0,24,-24,4,4,0,2,OTC
4665,13-02-2021 00:00,24 hrs.,pennystocks,MAXD,56,56,0,56,6,13,6,6,OTC
4665,13-02-2021 00:00,24 hrs.,RobinHoodPennyStocks,MOSY,119,0,119,-119,1,44,27,1,NASDAQ
4665,13-02-2021 00:00,24 hrs.,RobinHoodPennyStocks,MOXC,119,0,119,-119,1,44,27,1,NASDAQ
4665,13-02-2021 00:00,24 hrs.,RobinHoodPennyStocks,MVIS,119,0,119,-119,1,44,27,1,NASDAQ
4665,13-02-2021 00:00,24 hrs.,RobinHoodPennyStocks,NAKD,137,6,131,-125,4,47,27,4,NASDAQ
4665,13-02-2021 00:00,24 hrs.,RobinHoodPennyStocks,NCTY,119,0,119,-119,1,44,27,1,NASDAQ
4665,13-02-2021 00:00,24 hrs.,RobinHoodPennyStocks,NMTR,108,108,0,108,1,36,32,1,NASDAQ
4665,13-02-2021 00:00,24 hrs.,RobinHoodPennyStocks,NOVN,176,0,176,-176,4,62,36,3,NASDAQ
4665,13-02-2021 00:00,24 hrs.,RobinHoodPennyStocks,NVCN,66,66,0,66,2,17,24,2,NASDAQ
4665,13-02-2021 00:00,24 hrs.,RobinHoodPennyStocks,NVIV,12,0,12,-12,1,2,4,1,NASDAQ
4665,13-02-2021 00:00,24 hrs.,RobinHoodPennyStocks,NXTD,119,0,119,-119,1,44,27,1,NASDAQ
4665,13-02-2021 00:00,24 hrs.,RobinHoodPennyStocks,OCGN,39,39,0,39,1,10,15,1,NASDAQ
4665,13-02-2021 00:00,24 hrs.,RobinHoodPennyStocks,ONTX,6,0,6,-6,1,1,0,1,NASDAQ
4665,13-02-2021 00:00,24 hrs.,RobinHoodPennyStocks,OPGN,30,24,6,18,5,5,0,2,NASDAQ
4665,13-02-2021 00:00,24 hrs.,RobinHoodPennyStocks,OPTT,125,6,119,-113,2,45,27,2,NASDAQ
4665,13-02-2021 00:00,24 hrs.,RobinHoodPennyStocks,OVID,6,6,0,6,1,1,0,1,NASDAQ
4665,13-02-2021 00:00,24 hrs.,RobinHoodPennyStocks,PECK,119,0,119,-119,1,44,27,1,NASDAQ
4665,13-02-2021 00:00,24 hrs.,RobinHoodPennyStocks,PEIX,119,0,119,-119,1,44,27,1,NASDAQ
4665,13-02-2021 00:00,24 hrs.,RobinHoodPennyStocks,PETZ,119,0,119,-119,1,44,27,1,NASDAQ
4665,13-02-2021 00:00,24 hrs.,RobinHoodPennyStocks,PHUN,125,6,119,-113,2,45,27,2,NASDAQ
4665,13-02-2021 00:00,24 hrs.,RobinHoodPennyStocks,PIXY,119,0,119,-119,1,44,27,1,NASDAQ
4665,13-02-2021 00:00,24 hrs.,RobinHoodPennyStocks,PLIN,119,0,119,-119,1,44,27,1,NASDAQ
4665,13-02-2021 00:00,24 hrs.,RobinHoodPennyStocks,PLUG,119,0,119,-119,1,44,27,1,NASDAQ
4665,13-02-2021 00:00,24 hrs.,RobinHoodPennyStocks,PSEC,51,51,0,51,3,11,17,2,NASDAQ
4665,13-02-2021 00:00,24 hrs.,RobinHoodPennyStocks,PSTV,157,0,157,-157,1,64,25,1,NASDAQ
4665,13-02-2021 00:00,24 hrs.,RobinHoodPennyStocks,PXLW,6,0,6,-6,1,1,0,1,NASDAQ
4665,13-02-2021 00:00,24 hrs.,RobinHoodPennyStocks,QUIK,119,0,119,-119,1,44,27,1,NASDAQ
4665,13-02-2021 00:00,24 hrs.,RobinHoodPennyStocks,RAVE,119,0,119,-119,1,44,27,1,NASDAQ
4665,13-02-2021 00:00,24 hrs.,RobinHoodPennyStocks,RCMT,119,0,119,-119,1,44,27,1,NASDAQ
4665,13-02-2021 00:00,24 hrs.,RobinHoodPennyStocks,REAL,75,0,75,-75,1,25,21,1,NASDAQ
4665,13-02-2021 00:00,24 hrs.,RobinHoodPennyStocks,RIOT,126,7,119,-112,2,44,30,2,NASDAQ
4665,13-02-2021 00:00,24 hrs.,RobinHoodPennyStocks,SALM,119,0,119,-119,1,44,27,1,NASDAQ
4665,13-02-2021 00:00,24 hrs.,RobinHoodPennyStocks,SAVA,119,0,119,-119,1,44,27,1,NASDAQ
4665,13-02-2021 00:00,24 hrs.,RobinHoodPennyStocks,SEED,119,0,119,-119,1,44,27,1,NASDAQ
4665,13-02-2021 00:00,24 hrs.,RobinHoodPennyStocks,SGOC,119,0,119,-119,1,44,27,1,NASDAQ
4665,13-02-2021 00:00,24 hrs.,RobinHoodPennyStocks,SHIP,48,42,6,36,8,8,0,6,NASDAQ
4665,13-02-2021 00:00,24 hrs.,RobinHoodPennyStocks,SNDL,1424,1261,163,1098,31,491,318,28,NASDAQ
4665,13-02-2021 00:00,24 hrs.,RobinHoodPennyStocks,SNGX,218,116,102,14,4,84,34,4,NASDAQ
4665,13-02-2021 00:00,24 hrs.,RobinHoodPennyStocks,SRAX,6,6,0,6,1,1,0,1,NASDAQ
4665,13-02-2021 00:00,24 hrs.,RobinHoodPennyStocks,SRGA,6,6,0,6,1,1,0,1,NASDAQ
4665,13-02-2021 00:00,24 hrs.,RobinHoodPennyStocks,SUNW,119,0,119,-119,1,44,27,1,NASDAQ
4665,13-02-2021 00:00,24 hrs.,RobinHoodPennyStocks,SXTC,119,0,119,-119,1,44,27,1,NASDAQ
4665,13-02-2021 00:00,24 hrs.,RobinHoodPennyStocks,SYPR,119,0,119,-119,1,44,27,1,NASDAQ
4665,13-02-2021 00:00,24 hrs.,RobinHoodPennyStocks,TAIT,119,0,119,-119,1,44,27,1,NASDAQ
4665,13-02-2021 00:00,24 hrs.,RobinHoodPennyStocks,TANH,119,0,119,-119,1,44,27,1,NASDAQ
4665,13-02-2021 00:00,24 hrs.,RobinHoodPennyStocks,TAOP,119,0,119,-119,1,44,27,1,NASDAQ
4665,13-02-2021 00:00,24 hrs.,RobinHoodPennyStocks,TBLT,80,80,0,80,1,25,26,1,NASDAQ
4665,13-02-2021 00:00,24 hrs.,RobinHoodPennyStocks,TEDU,119,0,119,-119,1,44,27,1,NASDAQ
4665,13-02-2021 00:00,24 hrs.,RobinHoodPennyStocks,TIGR,119,0,119,-119,1,44,27,1,NASDAQ
4665,13-02-2021 00:00,24 hrs.,RobinHoodPennyStocks,TNXP,314,56,258,-202,4,110,78,4,NASDAQ
4665,13-02-2021 00:00,24 hrs.,RobinHoodPennyStocks,TRCH,194,75,119,-44,4,61,56,3,NASDAQ
4665,13-02-2021 00:00,24 hrs.,RobinHoodPennyStocks,TTOO,34,34,0,34,1,12,6,1,NASDAQ
4665,13-02-2021 00:00,24 hrs.,RobinHoodPennyStocks,TXMD,76,24,52,-28,6,18,16,6,NASDAQ
4665,13-02-2021 00:00,24 hrs.,RobinHoodPennyStocks,TYME,28,0,28,-28,1,5,14,1,NASDAQ
4665,13-02-2021 00:00,24 hrs.,RobinHoodPennyStocks,UONE,119,0,119,-119,1,44,27,1,NASDAQ
4665,13-02-2021 00:00,24 hrs.,RobinHoodPennyStocks,USEG,119,0,119,-119,1,44,27,1,NASDAQ
4665,13-02-2021 00:00,24 hrs.,RobinHoodPennyStocks,UXIN,119,0,119,-119,1,44,27,1,NASDAQ
4665,13-02-2021 00:00,24 hrs.,RobinHoodPennyStocks,WATT,119,0,119,-119,1,44,27,1,NASDAQ
4665,13-02-2021 00:00,24 hrs.,RobinHoodPennyStocks,WIMI,119,0,119,-119,1,44,27,1,NASDAQ
4665,13-02-2021 00:00,24 hrs.,RobinHoodPennyStocks,WKEY,119,0,119,-119,1,44,27,1,NASDAQ
4665,13-02-2021 00:00,24 hrs.,RobinHoodPennyStocks,WRAP,119,0,119,-119,1,44,27,1,NASDAQ
4665,13-02-2021 00:00,24 hrs.,RobinHoodPennyStocks,XSPA,23,23,0,23,1,9,1,1,NASDAQ
4665,13-02-2021 00:00,24 hrs.,RobinHoodPennyStocks,YGMZ,119,0,119,-119,1,44,27,1,NASDAQ
4665,13-02-2021 00:00,24 hrs.,RobinHoodPennyStocks,ZSAN,647,593,54,539,4,272,87,4,NASDAQ
4665,13-02-2021 00:00,24 hrs.,RobinHoodPennyStocks,UONEK,119,0,119,-119,1,44,27,1,NASDAQ
4665,13-02-2021 00:00,24 hrs.,pennystocks,MCOA,14,7,7,0,2,2,2,2,OTC
4665,13-02-2021 00:00,24 hrs.,pennystocks,MDCN,13,13,0,13,2,2,1,2,OTC
4665,13-02-2021 00:00,24 hrs.,pennystocks,MEDH,72,72,0,72,1,15,38,1,OTC
4665,13-02-2021 00:00,24 hrs.,pennystocks,MGLG,6,0,6,-6,1,1,0,1,OTC
4665,13-02-2021 00:00,24 hrs.,pennystocks,MGTI,17,17,0,17,1,5,3,1,OTC
4665,13-02-2021 00:00,24 hrs.,pennystocks,MIHI,6,6,0,6,1,1,0,1,OTC
4665,13-02-2021 00:00,24 hrs.,pennystocks,MIKP,6,0,6,-6,1,1,0,1,OTC
4665,13-02-2021 00:00,24 hrs.,pennystocks,MINE,133,75,58,17,8,29,43,7,OTC
4665,13-02-2021 00:00,24 hrs.,pennystocks,MJNA,99,25,74,-49,6,21,33,5,OTC
4665,13-02-2021 00:00,24 hrs.,pennystocks,MJTV,7,7,0,7,1,1,1,1,OTC
4665,13-02-2021 00:00,24 hrs.,pennystocks,MKTY,7,7,0,7,1,1,1,1,OTC
4665,13-02-2021 00:00,24 hrs.,pennystocks,MLFB,144,144,0,144,3,42,48,3,OTC
4665,13-02-2021 00:00,24 hrs.,pennystocks,MMEX,157,129,28,101,4,29,83,3,OTC
4665,13-02-2021 00:00,24 hrs.,pennystocks,MODC,6,0,6,-6,1,1,0,1,OTC
4665,13-02-2021 00:00,24 hrs.,pennystocks,MOJO,12,12,0,12,2,2,0,1,OTC
4665,13-02-2021 00:00,24 hrs.,pennystocks,MRMD,49,0,49,-49,1,20,5,1,OTC
4665,13-02-2021 00:00,24 hrs.,pennystocks,MRNJ,13,0,13,-13,2,2,1,1,OTC
4665,13-02-2021 00:00,24 hrs.,pennystocks,MTVX,6,6,0,6,1,1,0,1,OTC
4665,13-02-2021 00:00,24 hrs.,pennystocks,NBVG,7,7,0,7,1,1,1,1,OTC
4665,13-02-2021 00:00,24 hrs.,pennystocks,NOVC,54,54,0,54,2,16,14,2,OTC
4665,13-02-2021 00:00,24 hrs.,pennystocks,NSAV,13,13,0,13,2,2,1,2,OTC
4665,13-02-2021 00:00,24 hrs.,pennystocks,NSEO,6,0,6,-6,1,1,0,1,OTC
4665,13-02-2021 00:00,24 hrs.,pennystocks,NSPT,6,6,0,6,1,1,0,1,OTC
4665,13-02-2021 00:00,24 hrs.,pennystocks,OZSC,214,6,208,-202,4,52,94,4,OTC
4665,13-02-2021 00:00,24 hrs.,pennystocks,PAOG,7,7,0,7,1,1,1,1,OTC
4665,13-02-2021 00:00,24 hrs.,pennystocks,PASO,72,0,72,-72,2,18,28,2,OTC
4665,13-02-2021 00:00,24 hrs.,pennystocks,PDXP,7,7,0,7,1,1,1,1,OTC
4665,13-02-2021 00:00,24 hrs.,pennystocks,PHIL,6,6,0,6,1,1,0,1,OTC
4665,13-02-2021 00:00,24 hrs.,pennystocks,PLSB,6,0,6,-6,1,1,0,1,OTC
4665,13-02-2021 00:00,24 hrs.,pennystocks,PMCB,6,6,0,6,1,1,0,1,OTC
4665,13-02-2021 00:00,24 hrs.,pennystocks,PPJE,6,6,0,6,1,1,0,1,OTC
4665,13-02-2021 00:00,24 hrs.,pennystocks,PUGE,45,39,6,33,3,12,9,2,OTC
4665,13-02-2021 00:00,24 hrs.,pennystocks,PURA,13,13,0,13,2,2,1,2,OTC
4665,13-02-2021 00:00,24 hrs.,pennystocks,PVDG,25,25,0,25,1,2,17,1,OTC
4665,13-02-2021 00:00,24 hrs.,pennystocks,PZOO,7,0,7,-7,1,1,1,1,OTC
4665,13-02-2021 00:00,24 hrs.,pennystocks,QOIL,7,7,0,7,1,1,1,1,OTC
4665,13-02-2021 00:00,24 hrs.,pennystocks,RDGL,6,6,0,6,1,1,0,1,OTC
4665,13-02-2021 00:00,24 hrs.,pennystocks,RELI,15,15,0,15,1,0,11,1,OTC
4665,13-02-2021 00:00,24 hrs.,pennystocks,RGBP,21,21,0,21,2,5,3,1,OTC
4665,13-02-2021 00:00,24 hrs.,pennystocks,RITE,39,0,39,-39,1,7,21,1,OTC
4665,13-02-2021 00:00,24 hrs.,pennystocks,RLBD,18,0,18,-18,1,5,4,1,OTC
4665,13-02-2021 00:00,24 hrs.,pennystocks,RMTD,6,0,6,-6,1,1,0,1,OTC
4665,13-02-2021 00:00,24 hrs.,pennystocks,RNVA,6,6,0,6,1,1,0,1,OTC
4665,13-02-2021 00:00,24 hrs.,pennystocks,RSHN,17,17,0,17,1,1,11,1,OTC
4665,13-02-2021 00:00,24 hrs.,pennystocks,RSSV,295,289,6,283,3,107,69,3,OTC
4665,13-02-2021 00:00,24 hrs.,pennystocks,RTON,19,13,6,7,3,3,1,3,OTC
4665,13-02-2021 00:00,24 hrs.,pennystocks,SCIE,367,0,367,-367,2,157,45,2,OTC
4665,13-02-2021 00:00,24 hrs.,pennystocks,SFOR,15,15,0,15,1,0,11,1,OTC
4665,13-02-2021 00:00,24 hrs.,pennystocks,SGMD,335,335,0,335,9,106,87,9,OTC
4665,13-02-2021 00:00,24 hrs.,pennystocks,SGSI,6,0,6,-6,1,1,0,1,OTC
4665,13-02-2021 00:00,24 hrs.,pennystocks,SHMP,12,6,6,0,2,2,0,2,OTC
4665,13-02-2021 00:00,24 hrs.,pennystocks,SHWZ,7,7,0,7,1,1,1,1,OTC
4665,13-02-2021 00:00,24 hrs.,pennystocks,SIML,94,94,0,94,2,25,36,2,OTC
4665,13-02-2021 00:00,24 hrs.,pennystocks,SING,65,65,0,65,3,4,45,3,OTC
4665,13-02-2021 00:00,24 hrs.,pennystocks,SNPW,393,34,359,-325,5,146,81,5,OTC
4665,13-02-2021 00:00,24 hrs.,pennystocks,SNRS,14,14,0,14,2,2,2,2,OTC
4665,13-02-2021 00:00,24 hrs.,pennystocks,SNWV,12,12,0,12,2,2,0,1,OTC
4665,13-02-2021 00:00,24 hrs.,pennystocks,SNYR,6,6,0,6,1,1,0,1,OTC
4665,13-02-2021 00:00,24 hrs.,pennystocks,SRMX,237,60,177,-117,8,51,103,7,OTC
4665,13-02-2021 00:00,24 hrs.,pennystocks,SRNA,6,6,0,6,1,1,0,1,OTC
4665,13-02-2021 00:00,24 hrs.,pennystocks,SSFT,15,15,0,15,1,0,11,1,OTC
4665,13-02-2021 00:00,24 hrs.,pennystocks,SSOK,15,15,0,15,1,0,11,1,OTC
4665,13-02-2021 00:00,24 hrs.,pennystocks,STEV,12,12,0,12,1,3,2,1,OTC
4665,13-02-2021 00:00,24 hrs.,pennystocks,SUIC,7,0,7,-7,1,1,1,1,OTC
4665,13-02-2021 00:00,24 hrs.,pennystocks,TCHH,7,7,0,7,1,1,1,1,OTC
4665,13-02-2021 00:00,24 hrs.,pennystocks,TFZI,6,0,6,-6,1,1,0,1,OTC
4665,13-02-2021 00:00,24 hrs.,pennystocks,TGHI,11,11,0,11,1,2,3,1,OTC
4665,13-02-2021 00:00,24 hrs.,pennystocks,TLGN,58,58,0,58,3,12,22,2,OTC
4665,13-02-2021 00:00,24 hrs.,pennystocks,TLSS,258,88,170,-82,3,66,114,3,OTC
4665,13-02-2021 00:00,24 hrs.,pennystocks,TPAC,1776,1770,6,1764,2,792,184,2,OTC
4665,13-02-2021 00:00,24 hrs.,pennystocks,TREP,6,0,6,-6,1,1,0,1,OTC
4665,13-02-2021 00:00,24 hrs.,pennystocks,TSNP,51,45,6,39,4,3,29,4,OTC
4665,13-02-2021 00:00,24 hrs.,pennystocks,TSTS,12,0,12,-12,2,2,0,1,OTC
4665,13-02-2021 00:00,24 hrs.,pennystocks,USMJ,39,39,0,39,2,8,15,2,OTC
4665,13-02-2021 00:00,24 hrs.,pennystocks,USRM,6,0,6,-6,1,1,0,1,OTC
4665,13-02-2021 00:00,24 hrs.,pennystocks,VFRM,6,6,0,6,1,1,0,1,OTC
4665,13-02-2021 00:00,24 hrs.,pennystocks,VPLM,6,6,0,6,1,1,0,1,OTC
4665,13-02-2021 00:00,24 hrs.,pennystocks,VTLR,6,0,6,-6,1,1,0,1,OTC
4665,13-02-2021 00:00,24 hrs.,pennystocks,WCVC,88,88,0,88,1,24,36,1,OTC
4665,13-02-2021 00:00,24 hrs.,pennystocks,WDLF,189,0,189,-189,4,42,89,4,OTC
4665,13-02-2021 00:00,24 hrs.,pennystocks,WHEN,7,0,7,-7,1,1,1,1,OTC
4665,13-02-2021 00:00,24 hrs.,pennystocks,WIZD,20,20,0,20,1,6,4,1,OTC
4665,13-02-2021 00:00,24 hrs.,pennystocks,WTII,39,39,0,39,1,12,11,1,OTC
4665,13-02-2021 00:00,24 hrs.,pennystocks,XMET,14,6,8,-2,2,1,4,2,OTC
4665,13-02-2021 00:00,24 hrs.,pennystocks,XTRM,6,0,6,-6,1,1,0,1,OTC
4665,13-02-2021 00:00,24 hrs.,pennystocks,ZHUD,8,8,0,8,1,1,2,1,OTC
4665,13-02-2021 00:00,24 hrs.,pennystocks,ZPAS,6,0,6,-6,1,1,0,1,OTC
4665,13-02-2021 00:00,24 hrs.,pennystocks,ABEPF,40,0,40,-40,1,12,12,1,OTC
4665,13-02-2021 00:00,24 hrs.,pennystocks,AGGHF,19,19,0,19,1,4,7,1,OTC
4665,13-02-2021 00:00,24 hrs.,pennystocks,ALLIF,122,0,122,-122,1,35,48,1,OTC
4665,13-02-2021 00:00,24 hrs.,pennystocks,ARBKF,174,41,133,-92,3,38,86,3,OTC
4665,13-02-2021 00:00,24 hrs.,pennystocks,BDRBF,6,6,0,6,1,1,0,1,OTC
4665,13-02-2021 00:00,24 hrs.,pennystocks,BFARF,12,12,0,12,1,2,4,1,OTC
4665,13-02-2021 00:00,24 hrs.,pennystocks,BKLLF,82,82,0,82,1,26,26,1,OTC
4665,13-02-2021 00:00,24 hrs.,pennystocks,BNCHF,6,6,0,6,1,1,0,1,OTC
4665,13-02-2021 00:00,24 hrs.,pennystocks,BRPHF,35,35,0,35,1,3,25,1,OTC
4665,13-02-2021 00:00,24 hrs.,pennystocks,BVNNF,7,7,0,7,1,1,1,1,OTC
4665,13-02-2021 00:00,24 hrs.,pennystocks,CANSF,5,5,0,5,1,0,1,1,OTC
4665,13-02-2021 00:00,24 hrs.,pennystocks,CBULF,6,6,0,6,1,1,0,1,OTC
4665,13-02-2021 00:00,24 hrs.,pennystocks,CBWTF,13,13,0,13,2,2,1,2,OTC
4665,13-02-2021 00:00,24 hrs.,pennystocks,CIOXY,7,7,0,7,1,1,1,1,OTC
4665,13-02-2021 00:00,24 hrs.,pennystocks,CLUBQ,21,21,0,21,2,5,3,1,OTC
4665,13-02-2021 00:00,24 hrs.,pennystocks,COCSF,6,0,6,-6,1,1,0,1,OTC
4665,13-02-2021 00:00,24 hrs.,pennystocks,CPHRF,6,6,0,6,1,1,0,1,OTC
4665,13-02-2021 00:00,24 hrs.,pennystocks,CRLBF,23,23,0,23,1,2,15,1,OTC
4665,13-02-2021 00:00,24 hrs.,pennystocks,CWGYF,6,6,0,6,1,1,0,1,OTC
4665,13-02-2021 00:00,24 hrs.,pennystocks,CWSFF,6,6,0,6,1,1,0,1,OTC
4665,13-02-2021 00:00,24 hrs.,pennystocks,CXXIF,6,0,6,-6,1,1,0,1,OTC
4665,13-02-2021 00:00,24 hrs.,pennystocks,DFLYF,48,0,48,-48,1,17,10,1,OTC
4665,13-02-2021 00:00,24 hrs.,pennystocks,DFODQ,21,21,0,21,1,4,9,1,OTC
4665,13-02-2021 00:00,24 hrs.,pennystocks,DMGGF,35,35,0,35,1,3,25,1,OTC
4665,13-02-2021 00:00,24 hrs.,pennystocks,EHVVF,15,15,0,15,1,0,11,1,OTC
4665,13-02-2021 00:00,24 hrs.,pennystocks,ELRRF,12,12,0,12,2,2,0,2,OTC
4665,13-02-2021 00:00,24 hrs.,pennystocks,EMHTF,6,6,0,6,1,1,0,1,OTC
4665,13-02-2021 00:00,24 hrs.,pennystocks,EVKIF,33,33,0,33,1,10,9,1,OTC
4665,13-02-2021 00:00,24 hrs.,pennystocks,FIORF,8,0,8,-8,1,1,2,1,OTC
4665,13-02-2021 00:00,24 hrs.,pennystocks,FLWPF,22,22,0,22,1,4,10,1,OTC
4665,13-02-2021 00:00,24 hrs.,pennystocks,FUNFF,12,12,0,12,1,3,2,1,OTC
4665,13-02-2021 00:00,24 hrs.,pennystocks,GLDFF,6,6,0,6,1,1,0,1,OTC
4665,13-02-2021 00:00,24 hrs.,pennystocks,GUESF,7,0,7,-7,1,1,1,1,OTC
4665,13-02-2021 00:00,24 hrs.,pennystocks,HITIF,1785,1750,35,1715,13,627,479,12,OTC
4665,13-02-2021 00:00,24 hrs.,pennystocks,HRVSF,6,6,0,6,1,1,0,1,OTC
4665,13-02-2021 00:00,24 hrs.,pennystocks,IDXAF,6,0,6,-6,1,1,0,1,OTC
4665,13-02-2021 00:00,24 hrs.,pennystocks,INTEQ,6,6,0,6,1,1,0,1,OTC
4665,13-02-2021 00:00,24 hrs.,pennystocks,KCCFF,25,25,0,25,1,9,3,1,OTC
4665,13-02-2021 00:00,24 hrs.,pennystocks,LLKKF,30,24,6,18,5,5,0,2,OTC
4665,13-02-2021 00:00,24 hrs.,pennystocks,LXXGF,93,93,0,93,1,20,49,1,OTC
4665,13-02-2021 00:00,24 hrs.,pennystocks,MEDIF,6,6,0,6,1,1,0,1,OTC
4665,13-02-2021 00:00,24 hrs.,pennystocks,MMEDF,9,9,0,9,1,2,1,1,OTC
4665,13-02-2021 00:00,24 hrs.,pennystocks,MMNFF,6,0,6,-6,1,1,0,1,OTC
4665,13-02-2021 00:00,24 hrs.,pennystocks,MNXXF,52,14,38,-24,3,9,22,2,OTC
4665,13-02-2021 00:00,24 hrs.,pennystocks,NMGRF,18,12,6,6,3,3,0,3,OTC
4665,13-02-2021 00:00,24 hrs.,pennystocks,NOSUF,40,40,0,40,2,10,12,2,OTC
4665,13-02-2021 00:00,24 hrs.,pennystocks,NRGOF,7,0,7,-7,1,1,1,1,OTC
4665,13-02-2021 00:00,24 hrs.,pennystocks,NTSFF,6,0,6,-6,1,1,0,1,OTC
4665,13-02-2021 00:00,24 hrs.,pennystocks,NXTTF,18,12,6,6,3,3,0,3,OTC
4665,13-02-2021 00:00,24 hrs.,pennystocks,OILFF,6,6,0,6,1,1,0,1,OTC
4665,13-02-2021 00:00,24 hrs.,pennystocks,PFWIQ,88,88,0,88,1,24,36,1,OTC
4665,13-02-2021 00:00,24 hrs.,pennystocks,PMNXF,6,6,0,6,1,1,0,1,OTC
4665,13-02-2021 00:00,24 hrs.,pennystocks,PYRNF,6,0,6,-6,1,1,0,1,OTC
4665,13-02-2021 00:00,24 hrs.,pennystocks,QYOUF,6,6,0,6,1,1,0,1,OTC
4665,13-02-2021 00:00,24 hrs.,pennystocks,RACMF,15,0,15,-15,1,4,3,1,OTC
4665,13-02-2021 00:00,24 hrs.,pennystocks,RAZFF,7,7,0,7,1,1,1,1,OTC
4665,13-02-2021 00:00,24 hrs.,pennystocks,RHDGF,9,9,0,9,1,1,3,1,OTC
4665,13-02-2021 00:00,24 hrs.,pennystocks,RLFTF,6,6,0,6,1,1,0,1,OTC
4665,13-02-2021 00:00,24 hrs.,pennystocks,RLLCF,62,62,0,62,8,9,12,7,OTC
4665,13-02-2021 00:00,24 hrs.,pennystocks,RVVTF,7,7,0,7,1,1,1,1,OTC
4665,13-02-2021 00:00,24 hrs.,pennystocks,SNNAF,13,13,0,13,1,4,1,1,OTC
4665,13-02-2021 00:00,24 hrs.,pennystocks,SPFYF,9,9,0,9,1,1,3,1,OTC
4665,13-02-2021 00:00,24 hrs.,pennystocks,SPMTF,18,18,0,18,1,2,10,1,OTC
4665,13-02-2021 00:00,24 hrs.,pennystocks,SPRWF,363,62,301,-239,10,137,49,9,OTC
4665,13-02-2021 00:00,24 hrs.,pennystocks,TAKOF,33,33,0,33,1,11,7,1,OTC
4665,13-02-2021 00:00,24 hrs.,pennystocks,TLOFF,12,0,12,-12,2,2,0,1,OTC
4665,13-02-2021 00:00,24 hrs.,pennystocks,TOBAF,13,13,0,13,1,2,5,1,OTC
4665,13-02-2021 00:00,24 hrs.,pennystocks,TSCRF,104,75,29,46,4,29,30,4,OTC
4665,13-02-2021 00:00,24 hrs.,pennystocks,TSKFF,46,0,46,-46,1,16,10,1,OTC
4665,13-02-2021 00:00,24 hrs.,pennystocks,TTTSF,6,0,6,-6,1,1,0,1,OTC
4665,13-02-2021 00:00,24 hrs.,pennystocks,VRNDF,18,18,0,18,1,5,4,1,OTC
4665,13-02-2021 00:00,24 hrs.,pennystocks,XELAW,201,0,201,-201,1,90,17,1,OTC
4665,13-02-2021 00:00,24 hrs.,pennystocks,ZBISF,51,51,0,51,1,19,9,1,OTC
4665,13-02-2021 00:00,24 hrs.,pennystocks,AIM,8,0,8,-8,1,1,2,1,AMEX
4665,13-02-2021 00:00,24 hrs.,pennystocks,CTO,22,0,22,-22,1,1,16,1,AMEX
4665,13-02-2021 00:00,24 hrs.,pennystocks,DNN,289,37,252,-215,8,82,93,8,AMEX
4665,13-02-2021 00:00,24 hrs.,pennystocks,DPW,6,0,6,-6,1,1,0,1,AMEX
4665,13-02-2021 00:00,24 hrs.,pennystocks,DSS,30,30,0,30,1,9,8,1,AMEX
4665,13-02-2021 00:00,24 hrs.,pennystocks,GPL,35,0,35,-35,1,13,5,1,AMEX
4665,13-02-2021 00:00,24 hrs.,pennystocks,GTE,13,6,7,-1,2,2,1,2,AMEX
4665,13-02-2021 00:00,24 hrs.,pennystocks,ITP,29,0,29,-29,2,2,17,2,AMEX
4665,13-02-2021 00:00,24 hrs.,pennystocks,MCF,6,6,0,6,1,1,0,1,AMEX
4665,13-02-2021 00:00,24 hrs.,pennystocks,MXC,7,0,7,-7,1,1,1,1,AMEX
4665,13-02-2021 00:00,24 hrs.,pennystocks,NAK,39,33,6,27,2,8,15,2,AMEX
4665,13-02-2021 00:00,24 hrs.,pennystocks,NBY,11,11,0,11,1,3,1,1,AMEX
4665,13-02-2021 00:00,24 hrs.,pennystocks,PTN,26,26,0,26,1,8,6,1,AMEX
4665,13-02-2021 00:00,24 hrs.,pennystocks,TGB,24,24,0,24,1,7,6,1,AMEX
4665,13-02-2021 00:00,24 hrs.,pennystocks,TRX,15,8,7,1,2,2,3,2,AMEX
4665,13-02-2021 00:00,24 hrs.,pennystocks,ZOM,150,13,137,-124,4,57,20,4,AMEX
4665,13-02-2021 00:00,24 hrs.,pennystocks,GSAT,41,41,0,41,1,10,17,1,AMEX
4665,13-02-2021 00:00,24 hrs.,pennystocks,IBIO,15,15,0,15,1,4,3,1,AMEX
4665,13-02-2021 00:00,24 hrs.,pennystocks,INUV,63,0,63,-63,1,22,15,1,AMEX
4665,13-02-2021 00:00,24 hrs.,pennystocks,NSPR,22,22,0,22,1,7,4,1,AMEX
4665,13-02-2021 00:00,24 hrs.,pennystocks,SDPI,6,6,0,6,1,1,0,1,AMEX
4665,13-02-2021 00:00,24 hrs.,pennystocks,SENS,69,32,37,-5,4,19,15,4,AMEX
4665,13-02-2021 00:00,24 hrs.,pennystocks,TRXC,12,6,6,0,2,2,0,2,AMEX
4665,13-02-2021 00:00,24 hrs.,pennystocks,UAVS,107,107,0,107,1,36,31,1,AMEX
4665,13-02-2021 00:00,24 hrs.,pennystocks,XXII,6,6,0,6,1,0,2,1,AMEX
4665,13-02-2021 00:00,24 hrs.,pennystocks,ACB,21,21,0,21,1,2,13,1,NYSE
4665,13-02-2021 00:00,24 hrs.,pennystocks,AHT,6,6,0,6,1,1,0,1,NYSE
4665,13-02-2021 00:00,24 hrs.,pennystocks,AMC,82,82,0,82,5,14,34,5,NYSE
4665,13-02-2021 00:00,24 hrs.,pennystocks,ASX,24,24,0,24,4,4,0,2,NYSE
4665,13-02-2021 00:00,24 hrs.,pennystocks,ATH,12,12,0,12,1,3,2,1,NYSE
4665,13-02-2021 00:00,24 hrs.,pennystocks,BIO,320,0,320,-320,1,133,50,1,NYSE
4665,13-02-2021 00:00,24 hrs.,pennystocks,BTU,6,6,0,6,1,1,0,1,NYSE
4665,13-02-2021 00:00,24 hrs.,pennystocks,CBD,25,12,13,-1,3,4,5,3,NYSE
4665,13-02-2021 00:00,24 hrs.,pennystocks,CHS,33,33,0,33,1,10,9,1,NYSE
4665,13-02-2021 00:00,24 hrs.,pennystocks,CLI,51,51,0,51,1,16,15,1,NYSE
4665,13-02-2021 00:00,24 hrs.,pennystocks,CMD,51,51,0,51,1,16,15,1,NYSE
4665,13-02-2021 00:00,24 hrs.,pennystocks,CVE,33,18,15,3,4,7,3,2,NYSE
4665,13-02-2021 00:00,24 hrs.,pennystocks,CVX,31,31,0,31,1,10,7,1,NYSE
4665,13-02-2021 00:00,24 hrs.,pennystocks,ETH,6,6,0,6,1,1,0,1,NYSE
4665,13-02-2021 00:00,24 hrs.,pennystocks,FLT,33,33,0,33,1,11,7,1,NYSE
4665,13-02-2021 00:00,24 hrs.,pennystocks,GME,36,24,12,12,6,6,0,5,NYSE
4665,13-02-2021 00:00,24 hrs.,pennystocks,IRR,25,25,0,25,1,9,3,1,NYSE
4665,13-02-2021 00:00,24 hrs.,pennystocks,KOS,7,7,0,7,1,1,1,1,NYSE
4665,13-02-2021 00:00,24 hrs.,pennystocks,MDC,19,19,0,19,1,6,3,1,NYSE
4665,13-02-2021 00:00,24 hrs.,pennystocks,NAT,7,7,0,7,1,1,1,1,NYSE
4665,13-02-2021 00:00,24 hrs.,pennystocks,NOK,6,6,0,6,1,1,0,1,NYSE
4665,13-02-2021 00:00,24 hrs.,pennystocks,NPV,25,25,0,25,1,9,3,1,NYSE
4665,13-02-2021 00:00,24 hrs.,pennystocks,PSA,7,0,7,-7,1,1,1,1,NYSE
4665,13-02-2021 00:00,24 hrs.,pennystocks,RKT,82,82,0,82,1,26,26,1,NYSE
4665,13-02-2021 00:00,24 hrs.,pennystocks,RSI,171,150,21,129,2,68,27,2,NYSE
4665,13-02-2021 00:00,24 hrs.,pennystocks,SOS,59,53,6,47,5,10,19,5,NYSE
4665,13-02-2021 00:00,24 hrs.,pennystocks,SUM,150,150,0,150,1,62,22,1,NYSE
4665,13-02-2021 00:00,24 hrs.,pennystocks,TSM,35,35,0,35,1,10,11,1,NYSE
4665,13-02-2021 00:00,24 hrs.,pennystocks,VET,7,7,0,7,1,1,1,1,NYSE
4665,13-02-2021 00:00,24 hrs.,pennystocks,WEI,19,19,0,19,1,7,1,1,NYSE
4665,13-02-2021 00:00,24 hrs.,pennystocks,WLL,6,6,0,6,1,1,0,1,NYSE
4665,13-02-2021 00:00,24 hrs.,pennystocks,WWE,7,0,7,-7,1,1,1,1,NYSE
4665,13-02-2021 00:00,24 hrs.,pennystocks,ARGO,35,35,0,35,1,3,25,1,NYSE
4665,13-02-2021 00:00,24 hrs.,pennystocks,CCIV,7,7,0,7,1,1,1,1,NYSE
4665,13-02-2021 00:00,24 hrs.,pennystocks,FINV,15,15,0,15,1,4,3,1,NYSE
4665,13-02-2021 00:00,24 hrs.,pennystocks,HEXO,23,23,0,23,1,2,15,1,NYSE
4665,13-02-2021 00:00,24 hrs.,pennystocks,PUMP,13,13,0,13,2,2,1,1,NYSE
4665,13-02-2021 00:00,24 hrs.,pennystocks,SHOP,12,12,0,12,2,2,0,1,NYSE
4665,13-02-2021 00:00,24 hrs.,pennystocks,VIST,12,0,12,-12,1,2,4,1,NYSE
4665,13-02-2021 00:00,24 hrs.,pennystocks,WELL,1006,1006,0,1006,1,410,182,1,NYSE
4665,13-02-2021 00:00,24 hrs.,pennystocks,AQB,6,0,6,-6,1,1,0,1,NASDAQ
4665,13-02-2021 00:00,24 hrs.,pennystocks,BBI,53,0,53,-53,1,20,9,1,NASDAQ
4665,13-02-2021 00:00,24 hrs.,pennystocks,FWP,10,10,0,10,1,0,6,1,NASDAQ
4665,13-02-2021 00:00,24 hrs.,pennystocks,GBT,6,6,0,6,1,1,0,1,NASDAQ
4665,13-02-2021 00:00,24 hrs.,pennystocks,KOD,6,0,6,-6,1,1,0,1,NASDAQ
4665,13-02-2021 00:00,24 hrs.,pennystocks,MKD,23,23,0,23,1,6,7,1,NASDAQ
4665,13-02-2021 00:00,24 hrs.,pennystocks,MYT,11,11,0,11,1,1,5,1,NASDAQ
4665,13-02-2021 00:00,24 hrs.,pennystocks,OGI,7,0,7,-7,1,1,1,1,NASDAQ
4665,13-02-2021 00:00,24 hrs.,pennystocks,UFO,6,0,6,-6,1,1,0,1,NASDAQ
4665,13-02-2021 00:00,24 hrs.,pennystocks,ABEO,7,7,0,7,1,1,1,1,NASDAQ
4665,13-02-2021 00:00,24 hrs.,pennystocks,ABIO,20,0,20,-20,1,6,4,1,NASDAQ
4665,13-02-2021 00:00,24 hrs.,pennystocks,ACST,13,6,7,-1,2,2,1,2,NASDAQ
4665,13-02-2021 00:00,24 hrs.,pennystocks,AGEN,10,10,0,10,1,3,0,1,NASDAQ
4665,13-02-2021 00:00,24 hrs.,pennystocks,AGTC,33,14,19,-5,3,6,9,3,NASDAQ
4665,13-02-2021 00:00,24 hrs.,pennystocks,ALRN,16,0,16,-16,1,1,10,1,NASDAQ
4665,13-02-2021 00:00,24 hrs.,pennystocks,AMTX,70,70,0,70,1,24,18,1,NASDAQ
4665,13-02-2021 00:00,24 hrs.,pennystocks,APHA,64,64,0,64,3,20,12,3,NASDAQ
4665,13-02-2021 00:00,24 hrs.,pennystocks,ARTL,49,49,0,49,5,11,7,3,NASDAQ
4665,13-02-2021 00:00,24 hrs.,pennystocks,ASRT,1835,445,1390,-945,15,714,347,9,NASDAQ
4665,13-02-2021 00:00,24 hrs.,pennystocks,ATOS,122,122,0,122,3,41,28,3,NASDAQ
4665,13-02-2021 00:00,24 hrs.,pennystocks,BBIG,6,0,6,-6,1,1,0,1,NASDAQ
4665,13-02-2021 00:00,24 hrs.,pennystocks,BIOL,6,6,0,6,1,1,0,1,NASDAQ
4665,13-02-2021 00:00,24 hrs.,pennystocks,BKEP,12,0,12,-12,1,2,4,1,NASDAQ
4665,13-02-2021 00:00,24 hrs.,pennystocks,BNGO,37,37,0,37,3,11,3,3,NASDAQ
4665,13-02-2021 00:00,24 hrs.,pennystocks,CFMS,12,12,0,12,2,2,0,2,NASDAQ
4665,13-02-2021 00:00,24 hrs.,pennystocks,CIDM,115,115,0,115,2,26,55,2,NASDAQ
4665,13-02-2021 00:00,24 hrs.,pennystocks,CKPT,33,27,6,21,4,5,7,4,NASDAQ
4665,13-02-2021 00:00,24 hrs.,pennystocks,CLBS,190,190,0,190,3,68,42,3,NASDAQ
4665,13-02-2021 00:00,24 hrs.,pennystocks,CLEU,7,7,0,7,1,1,1,1,NASDAQ
4665,13-02-2021 00:00,24 hrs.,pennystocks,COCP,35,35,0,35,2,12,3,2,NASDAQ
4665,13-02-2021 00:00,24 hrs.,pennystocks,CPLP,20,20,0,20,2,1,10,1,NASDAQ
4665,13-02-2021 00:00,24 hrs.,pennystocks,CRBP,58,58,0,58,1,25,4,1,NASDAQ
4665,13-02-2021 00:00,24 hrs.,pennystocks,CRWS,6,6,0,6,1,1,0,1,NASDAQ
4665,13-02-2021 00:00,24 hrs.,pennystocks,CSCW,7,7,0,7,1,1,1,1,NASDAQ
4665,13-02-2021 00:00,24 hrs.,pennystocks,CSTR,6,6,0,6,1,1,0,1,NASDAQ
4665,13-02-2021 00:00,24 hrs.,pennystocks,CTHR,16,16,0,16,1,4,4,1,NASDAQ
4665,13-02-2021 00:00,24 hrs.,pennystocks,CTMX,18,18,0,18,1,4,6,1,NASDAQ
4665,13-02-2021 00:00,24 hrs.,pennystocks,CTRM,128,50,78,-28,7,35,30,7,NASDAQ
4665,13-02-2021 00:00,24 hrs.,pennystocks,CTXR,22,22,0,22,1,7,4,1,NASDAQ
4665,13-02-2021 00:00,24 hrs.,pennystocks,CYTH,8,8,0,8,1,1,2,1,NASDAQ
4665,13-02-2021 00:00,24 hrs.,pennystocks,DFFN,245,224,21,203,7,89,39,7,NASDAQ
4665,13-02-2021 00:00,24 hrs.,pennystocks,EBON,6,6,0,6,1,1,0,1,NASDAQ
4653,12-02-2021 22:00,24 hrs.,SPACs,ACAC,128,0,128,-128,1,39,46,1,NASDAQ
4653,12-02-2021 22:00,24 hrs.,SPACs,ACEV,48,40,8,32,2,2,36,2,NASDAQ
4653,12-02-2021 22:00,24 hrs.,SPACs,ADOC,273,273,0,273,1,74,121,1,NASDAQ
4653,12-02-2021 22:00,24 hrs.,SPACs,AGBA,273,273,0,273,1,74,121,1,NASDAQ
4653,12-02-2021 22:00,24 hrs.,SPACs,AHAC,273,273,0,273,1,74,121,1,NASDAQ
4653,12-02-2021 22:00,24 hrs.,SPACs,AMHC,273,273,0,273,1,74,121,1,NASDAQ
4653,12-02-2021 22:00,24 hrs.,SPACs,ANDA,116,0,116,-116,1,23,66,1,NASDAQ
4653,12-02-2021 22:00,24 hrs.,SPACs,BHSE,273,273,0,273,1,74,121,1,NASDAQ
4653,12-02-2021 22:00,24 hrs.,SPACs,BLNK,35,35,0,35,1,5,21,1,NASDAQ
4653,12-02-2021 22:00,24 hrs.,SPACs,BOWX,273,273,0,273,1,74,121,1,NASDAQ
4653,12-02-2021 22:00,24 hrs.,SPACs,BREZ,273,273,0,273,1,74,121,1,NASDAQ
4653,12-02-2021 22:00,24 hrs.,SPACs,BRLI,273,273,0,273,1,74,121,1,NASDAQ
4653,12-02-2021 22:00,24 hrs.,SPACs,BRPA,2147,0,2147,-2147,1,50,2043,1,NASDAQ
4653,12-02-2021 22:00,24 hrs.,SPACs,BTAQ,506,506,0,506,3,164,166,3,NASDAQ
4653,12-02-2021 22:00,24 hrs.,SPACs,BTWN,75,9,66,-57,3,13,37,3,NASDAQ
4653,12-02-2021 22:00,24 hrs.,SPACs,BWAC,273,273,0,273,1,74,121,1,NASDAQ
4653,12-02-2021 22:00,24 hrs.,SPACs,CAPA,273,273,0,273,1,74,121,1,NASDAQ
4653,12-02-2021 22:00,24 hrs.,SPACs,CELH,116,0,116,-116,1,23,66,1,NASDAQ
4653,12-02-2021 22:00,24 hrs.,SPACs,CFII,273,273,0,273,1,74,121,1,NASDAQ
4653,12-02-2021 22:00,24 hrs.,SPACs,CHPM,273,273,0,273,1,74,121,1,NASDAQ
4653,12-02-2021 22:00,24 hrs.,SPACs,CIIC,16,16,0,16,1,4,4,1,NASDAQ
4653,12-02-2021 22:00,24 hrs.,SPACs,CMLF,2147,0,2147,-2147,1,50,2043,1,NASDAQ
4653,12-02-2021 22:00,24 hrs.,SPACs,CONX,273,273,0,273,1,74,121,1,NASDAQ
4653,12-02-2021 22:00,24 hrs.,SPACs,CRSA,273,273,0,273,1,74,121,1,NASDAQ
4653,12-02-2021 22:00,24 hrs.,SPACs,DBDR,273,273,0,273,1,74,121,1,NASDAQ
4653,12-02-2021 22:00,24 hrs.,SPACs,DCRB,16,16,0,16,1,4,4,1,NASDAQ
4653,12-02-2021 22:00,24 hrs.,SPACs,DFHT,2147,0,2147,-2147,1,50,2043,1,NASDAQ
4653,12-02-2021 22:00,24 hrs.,SPACs,DFPH,273,273,0,273,1,74,121,1,NASDAQ
4653,12-02-2021 22:00,24 hrs.,SPACs,DGNS,446,337,109,228,2,162,114,2,NASDAQ
4653,12-02-2021 22:00,24 hrs.,SPACs,DSAC,273,273,0,273,1,74,121,1,NASDAQ
4653,12-02-2021 22:00,24 hrs.,SPACs,ERES,273,273,0,273,1,74,121,1,NASDAQ
4653,12-02-2021 22:00,24 hrs.,SPACs,ESSC,273,273,0,273,1,74,121,1,NASDAQ
4653,12-02-2021 22:00,24 hrs.,SPACs,ETAC,273,273,0,273,1,74,121,1,NASDAQ
4653,12-02-2021 22:00,24 hrs.,SPACs,EUCR,273,273,0,273,1,74,121,1,NASDAQ
4653,12-02-2021 22:00,24 hrs.,SPACs,FCAC,2554,407,2147,-1740,5,217,2100,4,NASDAQ
4653,12-02-2021 22:00,24 hrs.,SPACs,FTOC,55,55,0,55,2,12,23,2,NASDAQ
4653,12-02-2021 22:00,24 hrs.,SPACs,FVAM,273,273,0,273,1,74,121,1,NASDAQ
4653,12-02-2021 22:00,24 hrs.,SPACs,GNRS,273,273,0,273,1,74,121,1,NASDAQ
4653,12-02-2021 22:00,24 hrs.,SPACs,GRCY,273,273,0,273,1,74,121,1,NASDAQ
4653,12-02-2021 22:00,24 hrs.,SPACs,GRNV,273,273,0,273,1,74,121,1,NASDAQ
4653,12-02-2021 22:00,24 hrs.,SPACs,GRSV,319,319,0,319,4,82,139,4,NASDAQ
4653,12-02-2021 22:00,24 hrs.,stocks,HRSTW,6,6,0,6,1,1,0,1,OTC
4653,12-02-2021 22:00,24 hrs.,stocks,MMEDF,12,12,0,12,2,2,0,1,OTC
4653,12-02-2021 22:00,24 hrs.,stocks,MMNFF,6,0,6,-6,1,1,0,1,OTC
4653,12-02-2021 22:00,24 hrs.,stocks,NXTTF,6,6,0,6,1,1,0,1,OTC
4653,12-02-2021 22:00,24 hrs.,stocks,OILFF,6,6,0,6,1,1,0,1,OTC
4653,12-02-2021 22:00,24 hrs.,stocks,RHDGF,6,6,0,6,1,1,0,1,OTC
4653,12-02-2021 22:00,24 hrs.,stocks,RHHBY,24,24,0,24,1,8,4,1,OTC
4653,12-02-2021 22:00,24 hrs.,stocks,RLLCF,12,6,6,0,2,2,0,2,OTC
4653,12-02-2021 22:00,24 hrs.,stocks,RVVTF,13,13,0,13,2,2,1,2,OTC
4653,12-02-2021 22:00,24 hrs.,stocks,DNN,6,0,6,-6,1,1,0,1,AMEX
4653,12-02-2021 22:00,24 hrs.,stocks,DPW,12,0,12,-12,1,3,2,1,AMEX
4653,12-02-2021 22:00,24 hrs.,stocks,DSS,6,6,0,6,1,1,0,1,AMEX
4653,12-02-2021 22:00,24 hrs.,stocks,GDP,31,0,31,-31,1,4,19,1,AMEX
4653,12-02-2021 22:00,24 hrs.,stocks,GTE,6,6,0,6,1,1,0,1,AMEX
4653,12-02-2021 22:00,24 hrs.,stocks,IGC,6,6,0,6,1,1,0,1,AMEX
4653,12-02-2021 22:00,24 hrs.,SPACs,GWAC,273,273,0,273,1,74,121,1,NASDAQ
4653,12-02-2021 22:00,24 hrs.,SPACs,GXGX,273,273,0,273,1,74,121,1,NASDAQ
4653,12-02-2021 22:00,24 hrs.,SPACs,IGAC,273,273,0,273,1,74,121,1,NASDAQ
4653,12-02-2021 22:00,24 hrs.,SPACs,ITAC,273,273,0,273,1,74,121,1,NASDAQ
4653,12-02-2021 22:00,24 hrs.,SPACs,JYAC,273,273,0,273,1,74,121,1,NASDAQ
4653,12-02-2021 22:00,24 hrs.,SPACs,KERN,35,35,0,35,1,5,21,1,NASDAQ
4653,12-02-2021 22:00,24 hrs.,SPACs,KSMT,273,273,0,273,1,74,121,1,NASDAQ
4653,12-02-2021 22:00,24 hrs.,SPACs,LATN,273,273,0,273,1,74,121,1,NASDAQ
4653,12-02-2021 22:00,24 hrs.,SPACs,LCAP,273,273,0,273,1,74,121,1,NASDAQ
4653,12-02-2021 22:00,24 hrs.,SPACs,LFTR,273,273,0,273,1,74,121,1,NASDAQ
4653,12-02-2021 22:00,24 hrs.,SPACs,LIVK,273,273,0,273,1,74,121,1,NASDAQ
4653,12-02-2021 22:00,24 hrs.,SPACs,MAAC,273,273,0,273,1,74,121,1,NASDAQ
4653,12-02-2021 22:00,24 hrs.,SPACs,MACU,273,273,0,273,1,74,121,1,NASDAQ
4653,12-02-2021 22:00,24 hrs.,SPACs,MCMJ,273,273,0,273,1,74,121,1,NASDAQ
4653,12-02-2021 22:00,24 hrs.,SPACs,MLAC,273,273,0,273,1,74,121,1,NASDAQ
4653,12-02-2021 22:00,24 hrs.,SPACs,MOTN,273,273,0,273,1,74,121,1,NASDAQ
4653,12-02-2021 22:00,24 hrs.,SPACs,NBAC,20,20,0,20,2,5,2,2,NASDAQ
4653,12-02-2021 22:00,24 hrs.,SPACs,NGAC,58,0,58,-58,1,26,2,1,NASDAQ
4653,12-02-2021 22:00,24 hrs.,SPACs,OTRA,273,273,0,273,1,74,121,1,NASDAQ
4653,12-02-2021 22:00,24 hrs.,SPACs,PAIC,273,273,0,273,1,74,121,1,NASDAQ
4653,12-02-2021 22:00,24 hrs.,SPACs,PLUG,6,0,6,-6,1,1,0,1,NASDAQ
4653,12-02-2021 22:00,24 hrs.,SPACs,PRCH,30,30,0,30,1,10,6,1,NASDAQ
4653,12-02-2021 22:00,24 hrs.,SPACs,PYPL,34,34,0,34,1,12,6,1,NASDAQ
4653,12-02-2021 22:00,24 hrs.,SPACs,QELL,577,429,148,281,4,194,173,4,NASDAQ
4653,12-02-2021 22:00,24 hrs.,SPACs,RCHG,273,273,0,273,1,74,121,1,NASDAQ
4653,12-02-2021 22:00,24 hrs.,SPACs,RIDE,6,0,6,-6,1,1,0,1,NASDAQ
4653,12-02-2021 22:00,24 hrs.,SPACs,SGAM,273,273,0,273,1,74,121,1,NASDAQ
4653,12-02-2021 22:00,24 hrs.,SPACs,SRAC,83,83,0,83,1,28,23,1,NASDAQ
4653,12-02-2021 22:00,24 hrs.,SPACs,STWO,273,273,0,273,1,74,121,1,NASDAQ
4653,12-02-2021 22:00,24 hrs.,SPACs,SVAC,273,273,0,273,1,74,121,1,NASDAQ
4653,12-02-2021 22:00,24 hrs.,SPACs,TEKK,273,273,0,273,1,74,121,1,NASDAQ
4653,12-02-2021 22:00,24 hrs.,SPACs,THBR,2174,27,2147,-2120,2,53,2060,2,NASDAQ
4653,12-02-2021 22:00,24 hrs.,SPACs,THCA,273,273,0,273,1,74,121,1,NASDAQ
4653,12-02-2021 22:00,24 hrs.,SPACs,THCB,6,6,0,6,1,1,0,1,NASDAQ
4653,12-02-2021 22:00,24 hrs.,SPACs,TLRY,14,0,14,-14,1,0,10,1,NASDAQ
4653,12-02-2021 22:00,24 hrs.,SPACs,TMPM,273,273,0,273,1,74,121,1,NASDAQ
4653,12-02-2021 22:00,24 hrs.,SPACs,TMTS,273,273,0,273,1,74,121,1,NASDAQ
4653,12-02-2021 22:00,24 hrs.,SPACs,TTCF,116,0,116,-116,1,23,66,1,NASDAQ
4653,12-02-2021 22:00,24 hrs.,SPACs,TWCT,273,273,0,273,1,74,121,1,NASDAQ
4653,12-02-2021 22:00,24 hrs.,SPACs,VACQ,273,273,0,273,1,74,121,1,NASDAQ
4653,12-02-2021 22:00,24 hrs.,SPACs,VMAC,287,280,7,273,3,76,123,3,NASDAQ
4653,12-02-2021 22:00,24 hrs.,SPACs,VYGG,24,24,0,24,2,3,10,2,NYSE
4653,12-02-2021 22:00,24 hrs.,SPACs,ADV,2420,273,2147,-1874,2,124,2164,2,NASDAQ
4653,12-02-2021 22:00,24 hrs.,SPACs,CFO,118,118,0,118,2,40,30,2,NASDAQ
4653,12-02-2021 22:00,24 hrs.,SPACs,ESG,120,120,0,120,1,36,44,1,NASDAQ
4653,12-02-2021 22:00,24 hrs.,SPACs,HOL,2154,0,2154,-2154,2,51,2044,2,NASDAQ
4653,12-02-2021 22:00,24 hrs.,SPACs,LCY,273,273,0,273,1,74,121,1,NASDAQ
4653,12-02-2021 22:00,24 hrs.,SPACs,NPA,83,83,0,83,1,28,23,1,NASDAQ
4653,12-02-2021 22:00,24 hrs.,SPACs,VIH,35,35,0,35,1,11,9,1,NASDAQ
4653,12-02-2021 22:00,24 hrs.,stocks,CVS,32,32,0,32,3,5,10,3,NYSE
4653,12-02-2021 22:00,24 hrs.,stocks,DDD,38,0,38,-38,1,8,18,1,NYSE
4653,12-02-2021 22:00,24 hrs.,stocks,DIS,63,10,53,-43,2,19,17,2,NYSE
4653,12-02-2021 22:00,24 hrs.,stocks,EOS,12,0,12,-12,2,2,0,1,NYSE
4653,12-02-2021 22:00,24 hrs.,stocks,ETH,6,6,0,6,1,1,0,1,NYSE
4653,12-02-2021 22:00,24 hrs.,stocks,FCF,31,0,31,-31,1,4,19,1,NYSE
4653,12-02-2021 22:00,24 hrs.,stocks,FCX,6,0,6,-6,1,1,0,1,NYSE
4653,12-02-2021 22:00,24 hrs.,stocks,FSR,30,6,24,-18,2,11,0,2,NYSE
4653,12-02-2021 22:00,24 hrs.,stocks,GME,698,346,352,-6,20,167,284,19,NYSE
4653,12-02-2021 22:00,24 hrs.,stocks,IBM,8828,146,8682,-8536,2,4115,590,2,NYSE
4653,12-02-2021 22:00,24 hrs.,stocks,ICE,31,0,31,-31,1,4,19,1,NYSE
4653,12-02-2021 22:00,24 hrs.,stocks,IRS,61,0,61,-61,1,23,11,1,NYSE
4653,12-02-2021 22:00,24 hrs.,stocks,KEY,82,0,82,-82,1,31,16,1,NYSE
4653,12-02-2021 22:00,24 hrs.,stocks,KNL,25,0,25,-25,1,7,7,1,NYSE
4653,12-02-2021 22:00,24 hrs.,stocks,LEN,6,0,6,-6,1,1,0,1,NYSE
4653,12-02-2021 22:00,24 hrs.,SPACs,VSPR,43,0,43,-43,1,11,17,1,NASDAQ
4653,12-02-2021 22:00,24 hrs.,SPACs,VTIQ,20,20,0,20,1,4,8,1,NASDAQ
4653,12-02-2021 22:00,24 hrs.,SPACs,YSAC,273,273,0,273,1,74,121,1,NASDAQ
4653,12-02-2021 22:00,24 hrs.,SPACs,ZGYH,273,273,0,273,1,74,121,1,NASDAQ
4653,12-02-2021 22:00,24 hrs.,SPACs,CMLFW,2147,0,2147,-2147,1,50,2043,1,NASDAQ
4653,12-02-2021 22:00,24 hrs.,SPACs,DSACW,2147,0,2147,-2147,1,50,2043,1,NASDAQ
4653,12-02-2021 22:00,24 hrs.,SPACs,EXPCW,2147,0,2147,-2147,1,50,2043,1,NASDAQ
4653,12-02-2021 22:00,24 hrs.,SPACs,FCACW,2147,0,2147,-2147,1,50,2043,1,NASDAQ
4653,12-02-2021 22:00,24 hrs.,SPACs,NBACR,5,5,0,5,1,0,1,1,NASDAQ
4653,12-02-2021 22:00,24 hrs.,SPACs,NBACW,5,5,0,5,1,0,1,1,NASDAQ
4653,12-02-2021 22:00,24 hrs.,SPACs,SAIIW,2147,0,2147,-2147,1,50,2043,1,NASDAQ
4653,12-02-2021 22:00,24 hrs.,SPACs,TWCTW,2147,0,2147,-2147,1,50,2043,1,NASDAQ
4653,12-02-2021 22:00,24 hrs.,stocks,ABML,6,6,0,6,1,1,0,1,OTC
4653,12-02-2021 22:00,24 hrs.,stocks,APTY,6,6,0,6,1,1,0,1,OTC
4653,12-02-2021 22:00,24 hrs.,stocks,BIEL,6,0,6,-6,1,1,0,1,OTC
4653,12-02-2021 22:00,24 hrs.,stocks,BLSP,6,6,0,6,1,1,0,1,OTC
4653,12-02-2021 22:00,24 hrs.,stocks,CAGR,25,0,25,-25,1,3,15,1,OTC
4653,12-02-2021 22:00,24 hrs.,stocks,CANN,6,6,0,6,1,1,0,1,OTC
4653,12-02-2021 22:00,24 hrs.,stocks,CAPC,6,6,0,6,1,1,0,1,OTC
4653,12-02-2021 22:00,24 hrs.,stocks,CORG,6,0,6,-6,1,1,0,1,OTC
4653,12-02-2021 22:00,24 hrs.,stocks,DIGI,6,0,6,-6,1,1,0,1,OTC
4653,12-02-2021 22:00,24 hrs.,stocks,ETCG,6,6,0,6,1,1,0,1,OTC
4653,12-02-2021 22:00,24 hrs.,stocks,FNMA,6,0,6,-6,1,1,0,1,OTC
4653,12-02-2021 22:00,24 hrs.,stocks,GRYN,6,6,0,6,1,1,0,1,OTC
4653,12-02-2021 22:00,24 hrs.,stocks,GTEH,6,6,0,6,1,1,0,1,OTC
4653,12-02-2021 22:00,24 hrs.,stocks,HCMC,18,6,12,-6,3,3,0,3,OTC
4653,12-02-2021 22:00,24 hrs.,stocks,HEMP,6,0,6,-6,1,1,0,1,OTC
4653,12-02-2021 22:00,24 hrs.,stocks,IGEN,6,6,0,6,1,1,0,1,OTC
4653,12-02-2021 22:00,24 hrs.,stocks,KGKG,6,0,6,-6,1,1,0,1,OTC
4653,12-02-2021 22:00,24 hrs.,stocks,KYNC,18,0,18,-18,3,3,0,1,OTC
4653,12-02-2021 22:00,24 hrs.,stocks,LINK,10,10,0,10,1,2,2,1,OTC
4653,12-02-2021 22:00,24 hrs.,stocks,MCAP,6,6,0,6,1,1,0,1,OTC
4653,12-02-2021 22:00,24 hrs.,stocks,MINE,6,6,0,6,1,1,0,1,OTC
4653,12-02-2021 22:00,24 hrs.,stocks,MJNA,6,6,0,6,1,1,0,1,OTC
4653,12-02-2021 22:00,24 hrs.,stocks,MOJO,6,6,0,6,1,1,0,1,OTC
4653,12-02-2021 22:00,24 hrs.,stocks,NTRR,6,6,0,6,1,1,0,1,OTC
4653,12-02-2021 22:00,24 hrs.,stocks,OZSC,6,6,0,6,1,1,0,1,OTC
4653,12-02-2021 22:00,24 hrs.,stocks,PZOO,6,0,6,-6,1,1,0,1,OTC
4653,12-02-2021 22:00,24 hrs.,stocks,RSSV,19,19,0,19,1,6,3,1,OTC
4653,12-02-2021 22:00,24 hrs.,stocks,SNYR,6,6,0,6,1,1,0,1,OTC
4653,12-02-2021 22:00,24 hrs.,stocks,SSET,7,7,0,7,1,1,1,1,OTC
4653,12-02-2021 22:00,24 hrs.,stocks,SUIC,6,0,6,-6,1,1,0,1,OTC
4653,12-02-2021 22:00,24 hrs.,stocks,TMRC,6,6,0,6,1,1,0,1,OTC
4653,12-02-2021 22:00,24 hrs.,stocks,ACRDF,6,6,0,6,1,1,0,1,OTC
4653,12-02-2021 22:00,24 hrs.,stocks,ACRHF,6,6,0,6,1,1,0,1,OTC
4653,12-02-2021 22:00,24 hrs.,stocks,BDRBF,6,6,0,6,1,1,0,1,OTC
4653,12-02-2021 22:00,24 hrs.,stocks,CBWTF,12,0,12,-12,2,2,0,2,OTC
4653,12-02-2021 22:00,24 hrs.,stocks,DGTHF,6,6,0,6,1,1,0,1,OTC
4653,12-02-2021 22:00,24 hrs.,stocks,EMHTF,6,6,0,6,1,1,0,1,OTC
4653,12-02-2021 22:00,24 hrs.,stocks,ABUS,6,6,0,6,1,1,0,1,NASDAQ
4653,12-02-2021 22:00,24 hrs.,stocks,AEZS,157,157,0,157,1,69,15,1,NASDAQ
4653,12-02-2021 22:00,24 hrs.,stocks,AGEN,10,10,0,10,1,3,0,1,NASDAQ
4653,12-02-2021 22:00,24 hrs.,stocks,AGTC,18,12,6,6,3,3,0,2,NASDAQ
4653,12-02-2021 22:00,24 hrs.,stocks,ALJJ,6,0,6,-6,1,1,0,1,NASDAQ
4653,12-02-2021 22:00,24 hrs.,stocks,ALOT,165,0,165,-165,1,38,85,1,NASDAQ
4653,12-02-2021 22:00,24 hrs.,stocks,AMZN,70,70,0,70,1,20,26,1,NASDAQ
4653,12-02-2021 22:00,24 hrs.,stocks,APHA,1098,707,391,316,10,319,420,10,NASDAQ
4653,12-02-2021 22:00,24 hrs.,stocks,APXT,6,0,6,-6,1,1,0,1,NASDAQ
4653,12-02-2021 22:00,24 hrs.,stocks,ARTL,18,18,0,18,3,3,0,2,NASDAQ
4653,12-02-2021 22:00,24 hrs.,stocks,ASYS,6,6,0,6,1,1,0,1,NASDAQ
4653,12-02-2021 22:00,24 hrs.,stocks,ATOS,157,157,0,157,1,69,15,1,NASDAQ
4653,12-02-2021 22:00,24 hrs.,stocks,AVGO,6,6,0,6,1,1,0,1,NASDAQ
4653,12-02-2021 22:00,24 hrs.,stocks,AZRX,12,0,12,-12,1,2,4,1,NASDAQ
4653,12-02-2021 22:00,24 hrs.,stocks,BNGO,6,6,0,6,1,1,0,1,NASDAQ
4653,12-02-2021 22:00,24 hrs.,stocks,BYND,6,6,0,6,1,1,0,1,NASDAQ
4653,12-02-2021 22:00,24 hrs.,stocks,CLEU,7,0,7,-7,1,1,1,1,NASDAQ
4653,12-02-2021 22:00,24 hrs.,stocks,LMT,6,0,6,-6,1,1,0,1,NYSE
4653,12-02-2021 22:00,24 hrs.,stocks,LUV,55,0,55,-55,1,12,27,1,NYSE
4653,12-02-2021 22:00,24 hrs.,stocks,MCO,10,10,0,10,1,2,2,1,NYSE
4653,12-02-2021 22:00,24 hrs.,stocks,MFA,8,0,8,-8,1,1,2,1,NYSE
4653,12-02-2021 22:00,24 hrs.,stocks,MGM,30,11,19,-8,2,6,10,2,NYSE
4653,12-02-2021 22:00,24 hrs.,stocks,MRO,10,10,0,10,1,2,2,1,NYSE
4653,12-02-2021 22:00,24 hrs.,stocks,NAT,25,0,25,-25,1,5,11,1,NYSE
4653,12-02-2021 22:00,24 hrs.,stocks,NET,11,11,0,11,1,1,5,1,NYSE
4653,12-02-2021 22:00,24 hrs.,stocks,NGL,6,6,0,6,1,1,0,1,NYSE
4653,12-02-2021 22:00,24 hrs.,stocks,NIO,666,666,0,666,8,210,214,5,NYSE
4653,12-02-2021 22:00,24 hrs.,stocks,NOK,129,129,0,129,3,19,79,3,NYSE
4653,12-02-2021 22:00,24 hrs.,stocks,NOM,67,67,0,67,1,24,15,1,NYSE
4653,12-02-2021 22:00,24 hrs.,stocks,NSA,8682,0,8682,-8682,1,4058,562,1,NYSE
4653,12-02-2021 22:00,24 hrs.,stocks,NVS,18,0,18,-18,3,3,0,1,NYSE
4653,12-02-2021 22:00,24 hrs.,stocks,PDT,6,0,6,-6,1,1,0,1,NYSE
4653,12-02-2021 22:00,24 hrs.,stocks,PEG,325,325,0,325,1,17,287,1,NYSE
4653,12-02-2021 22:00,24 hrs.,stocks,PFE,7,7,0,7,1,1,1,1,NYSE
4653,12-02-2021 22:00,24 hrs.,stocks,RAD,15,15,0,15,1,3,5,1,NYSE
4653,12-02-2021 22:00,24 hrs.,stocks,RDY,6,6,0,6,1,1,0,1,NYSE
4653,12-02-2021 22:00,24 hrs.,stocks,RKT,103,0,103,-103,1,41,17,1,NYSE
4653,12-02-2021 22:00,24 hrs.,stocks,RSI,25,0,25,-25,1,7,7,1,NYSE
4653,12-02-2021 22:00,24 hrs.,stocks,RTX,21,21,0,21,1,4,9,1,NYSE
4653,12-02-2021 22:00,24 hrs.,stocks,SBE,62,0,62,-62,5,20,2,3,NYSE
4653,12-02-2021 22:00,24 hrs.,stocks,SOI,6,0,6,-6,1,1,0,1,NYSE
4653,12-02-2021 22:00,24 hrs.,stocks,SOS,30,12,18,-6,5,5,0,5,NYSE
4653,12-02-2021 22:00,24 hrs.,stocks,SUP,6,6,0,6,1,1,0,1,NYSE
4653,12-02-2021 22:00,24 hrs.,stocks,TMO,7,0,7,-7,1,1,1,1,NYSE
4653,12-02-2021 22:00,24 hrs.,stocks,TSM,46,46,0,46,1,7,28,1,NYSE
4653,12-02-2021 22:00,24 hrs.,stocks,UBS,6987,6987,0,6987,1,3392,199,1,NYSE
4653,12-02-2021 22:00,24 hrs.,stocks,WLL,6,6,0,6,1,1,0,1,NYSE
4653,12-02-2021 22:00,24 hrs.,stocks,MXC,6,6,0,6,1,1,0,1,AMEX
4653,12-02-2021 22:00,24 hrs.,stocks,PLX,12,12,0,12,1,2,4,1,AMEX
4653,12-02-2021 22:00,24 hrs.,stocks,ZOM,31,6,25,-19,5,5,1,5,AMEX
4653,12-02-2021 22:00,24 hrs.,stocks,GSAT,6,6,0,6,1,1,0,1,AMEX
4653,12-02-2021 22:00,24 hrs.,stocks,TMBR,6,6,0,6,1,1,0,1,AMEX
4653,12-02-2021 22:00,24 hrs.,stocks,ACB,73,0,73,-73,2,18,29,2,NYSE
4653,12-02-2021 22:00,24 hrs.,stocks,ADT,6,6,0,6,1,1,0,1,NYSE
4653,12-02-2021 22:00,24 hrs.,stocks,AMC,223,75,148,-73,10,49,85,10,NYSE
4653,12-02-2021 22:00,24 hrs.,stocks,ASX,13,7,6,1,2,2,1,2,NYSE
4653,12-02-2021 22:00,24 hrs.,stocks,ATH,31,0,31,-31,1,4,19,1,NYSE
4653,12-02-2021 22:00,24 hrs.,stocks,BEP,139,139,0,139,5,27,65,5,NYSE
4653,12-02-2021 22:00,24 hrs.,stocks,BHC,10,10,0,10,1,2,2,1,NYSE
4653,12-02-2021 22:00,24 hrs.,stocks,BTT,6,0,6,-6,1,1,0,1,NYSE
4653,12-02-2021 22:00,24 hrs.,stocks,CBD,6,6,0,6,1,1,0,1,NYSE
4653,12-02-2021 22:00,24 hrs.,stocks,CIA,8682,0,8682,-8682,1,4058,562,1,NYSE
4653,12-02-2021 22:00,24 hrs.,stocks,CRM,6,6,0,6,1,1,0,1,NYSE
4653,12-02-2021 22:00,24 hrs.,stocks,CVE,6,6,0,6,1,1,0,1,NYSE
4653,12-02-2021 22:00,24 hrs.,SPACs,NAV,225,96,129,-33,6,53,95,5,NYSE
4653,12-02-2021 22:00,24 hrs.,SPACs,NGA,75,51,24,27,4,16,27,3,NYSE
4653,12-02-2021 22:00,24 hrs.,SPACs,NSH,273,273,0,273,1,74,121,1,NYSE
4653,12-02-2021 22:00,24 hrs.,SPACs,RSI,136,8,128,-120,2,39,50,2,NYSE
4653,12-02-2021 22:00,24 hrs.,SPACs,RTP,2537,358,2179,-1821,8,199,2107,7,NYSE
4653,12-02-2021 22:00,24 hrs.,SPACs,SBE,58,0,58,-58,4,17,8,3,NYSE
4653,12-02-2021 22:00,24 hrs.,SPACs,SBG,273,273,0,273,1,74,121,1,NYSE
4653,12-02-2021 22:00,24 hrs.,SPACs,TDA,7,7,0,7,1,1,1,1,NYSE
4653,12-02-2021 22:00,24 hrs.,SPACs,WPF,279,273,6,267,2,75,121,2,NYSE
4653,12-02-2021 22:00,24 hrs.,SPACs,YAC,273,273,0,273,1,74,121,1,NYSE
4653,12-02-2021 22:00,24 hrs.,SPACs,ACIC,2147,0,2147,-2147,1,50,2043,1,NYSE
4653,12-02-2021 22:00,24 hrs.,SPACs,ACND,273,273,0,273,1,74,121,1,NYSE
4653,12-02-2021 22:00,24 hrs.,SPACs,ALUS,41,41,0,41,1,7,23,1,NYSE
4653,12-02-2021 22:00,24 hrs.,SPACs,AONE,273,273,0,273,1,74,121,1,NYSE
4653,12-02-2021 22:00,24 hrs.,SPACs,APSG,273,273,0,273,1,74,121,1,NYSE
4653,12-02-2021 22:00,24 hrs.,SPACs,ASAQ,273,273,0,273,1,74,121,1,NYSE
4653,12-02-2021 22:00,24 hrs.,SPACs,ASPL,279,273,6,267,2,75,121,2,NYSE
4653,12-02-2021 22:00,24 hrs.,stocks,WMT,70,70,0,70,1,20,26,1,NYSE
4653,12-02-2021 22:00,24 hrs.,stocks,AJRD,70,70,0,70,1,20,26,1,NYSE
4653,12-02-2021 22:00,24 hrs.,stocks,ALSN,25,0,25,-25,1,7,7,1,NYSE
4653,12-02-2021 22:00,24 hrs.,stocks,APTV,70,70,0,70,1,20,26,1,NYSE
4653,12-02-2021 22:00,24 hrs.,stocks,BEPC,26,26,0,26,2,1,16,2,NYSE
4653,12-02-2021 22:00,24 hrs.,stocks,BORR,47,47,0,47,3,11,13,3,NYSE
4653,12-02-2021 22:00,24 hrs.,stocks,CACI,8682,0,8682,-8682,1,4058,562,1,NYSE
4653,12-02-2021 22:00,24 hrs.,stocks,CCIV,18,6,12,-6,3,3,0,3,NYSE
4653,12-02-2021 22:00,24 hrs.,stocks,CHWY,9,9,0,9,1,0,5,1,NYSE
4653,12-02-2021 22:00,24 hrs.,stocks,COTY,6,6,0,6,1,1,0,1,NYSE
4653,12-02-2021 22:00,24 hrs.,stocks,FTCH,23,0,23,-23,1,3,13,1,NYSE
4653,12-02-2021 22:00,24 hrs.,stocks,FUSE,6,6,0,6,1,1,0,1,NYSE
4653,12-02-2021 22:00,24 hrs.,stocks,FVRR,23,0,23,-23,1,3,13,1,NYSE
4653,12-02-2021 22:00,24 hrs.,stocks,HEXO,6,6,0,6,1,1,0,1,NYSE
4653,12-02-2021 22:00,24 hrs.,stocks,HOME,9,9,0,9,1,0,5,1,NYSE
4653,12-02-2021 22:00,24 hrs.,stocks,HUYA,91,91,0,91,1,33,21,1,NYSE
4653,12-02-2021 22:00,24 hrs.,stocks,JMIA,6,6,0,6,1,1,0,1,NYSE
4653,12-02-2021 22:00,24 hrs.,stocks,OTIS,25,0,25,-25,1,7,7,1,NYSE
4653,12-02-2021 22:00,24 hrs.,stocks,PLTR,283,277,6,271,3,83,105,3,NYSE
4653,12-02-2021 22:00,24 hrs.,stocks,SPCE,83,70,13,57,3,22,27,3,NYSE
4653,12-02-2021 22:00,24 hrs.,stocks,SPOT,6,0,6,-6,1,1,0,1,NYSE
4653,12-02-2021 22:00,24 hrs.,stocks,VGAC,6,6,0,6,1,1,0,1,NYSE
4653,12-02-2021 22:00,24 hrs.,stocks,VOYA,25,0,25,-25,1,7,7,1,NYSE
4653,12-02-2021 22:00,24 hrs.,stocks,WORK,6,0,6,-6,1,1,0,1,NYSE
4653,12-02-2021 22:00,24 hrs.,stocks,XPEV,8754,72,8682,-8610,6,4074,582,3,NYSE
4653,12-02-2021 22:00,24 hrs.,stocks,YETI,55,0,55,-55,1,12,27,1,NYSE
4653,12-02-2021 22:00,24 hrs.,stocks,AAL,57,0,57,-57,2,9,31,2,NASDAQ
4653,12-02-2021 22:00,24 hrs.,stocks,AMD,60,46,14,32,3,8,32,2,NASDAQ
4653,12-02-2021 22:00,24 hrs.,stocks,AZN,10,10,0,10,1,2,2,1,NASDAQ
4653,12-02-2021 22:00,24 hrs.,stocks,CDC,10,10,0,10,1,2,2,1,NASDAQ
4653,12-02-2021 22:00,24 hrs.,stocks,FTC,31,31,0,31,1,9,9,1,NASDAQ
4653,12-02-2021 22:00,24 hrs.,stocks,GAN,7,7,0,7,1,1,1,1,NASDAQ
4653,12-02-2021 22:00,24 hrs.,stocks,GSM,41,41,0,41,2,13,7,1,NASDAQ
4653,12-02-2021 22:00,24 hrs.,stocks,IEA,20,20,0,20,1,5,6,1,NASDAQ
4653,12-02-2021 22:00,24 hrs.,stocks,INO,6,6,0,6,1,1,0,1,NASDAQ
4653,12-02-2021 22:00,24 hrs.,stocks,JFU,6,0,6,-6,1,1,0,1,NASDAQ
4653,12-02-2021 22:00,24 hrs.,stocks,KHC,6,0,6,-6,1,1,0,1,NASDAQ
4653,12-02-2021 22:00,24 hrs.,stocks,LNT,25,0,25,-25,1,7,7,1,NASDAQ
4653,12-02-2021 22:00,24 hrs.,stocks,MIK,6,0,6,-6,1,1,0,1,NASDAQ
4653,12-02-2021 22:00,24 hrs.,stocks,NPA,6,0,6,-6,1,1,0,1,NASDAQ
4653,12-02-2021 22:00,24 hrs.,stocks,NWL,10,10,0,10,1,2,2,1,NASDAQ
4653,12-02-2021 22:00,24 hrs.,stocks,OGI,31,12,19,-7,5,5,1,5,NASDAQ
4653,12-02-2021 22:00,24 hrs.,stocks,OLB,6,0,6,-6,1,1,0,1,NASDAQ
4653,12-02-2021 22:00,24 hrs.,stocks,PEP,4,4,0,4,1,0,0,1,NASDAQ
4653,12-02-2021 22:00,24 hrs.,stocks,WBA,15,15,0,15,1,3,5,1,NASDAQ
4653,12-02-2021 22:00,24 hrs.,stocks,AAPL,60,0,60,-60,1,12,32,1,NASDAQ
4653,12-02-2021 22:00,24 hrs.,stocks,ABIO,6,0,6,-6,1,1,0,1,NASDAQ
4653,12-02-2021 22:00,24 hrs.,StockMarket,RIGL,6,0,6,-6,1,1,0,1,NASDAQ
4653,12-02-2021 22:00,24 hrs.,StockMarket,SNDL,475,12,463,-451,10,152,131,10,NASDAQ
4653,12-02-2021 22:00,24 hrs.,StockMarket,SRAC,10,10,0,10,1,1,4,1,NASDAQ
4653,12-02-2021 22:00,24 hrs.,StockMarket,SVMK,13,13,0,13,1,3,3,1,NASDAQ
4653,12-02-2021 22:00,24 hrs.,SPACs,ATAC,273,273,0,273,1,74,121,1,NYSE
4653,12-02-2021 22:00,24 hrs.,SPACs,AVAN,273,273,0,273,1,74,121,1,NYSE
4653,12-02-2021 22:00,24 hrs.,SPACs,BOAC,342,342,0,342,2,95,144,2,NYSE
4653,12-02-2021 22:00,24 hrs.,SPACs,CCIV,4707,884,3823,-2939,20,953,2721,19,NYSE
4653,12-02-2021 22:00,24 hrs.,SPACs,CLII,8,0,8,-8,1,1,2,1,NYSE
4653,12-02-2021 22:00,24 hrs.,SPACs,CPSR,273,273,0,273,1,74,121,1,NYSE
4653,12-02-2021 22:00,24 hrs.,SPACs,CTAC,273,273,0,273,1,74,121,1,NYSE
4653,12-02-2021 22:00,24 hrs.,SPACs,DFNS,311,311,0,311,2,89,125,2,NYSE
4653,12-02-2021 22:00,24 hrs.,SPACs,DGNR,337,337,0,337,1,145,43,1,NYSE
4653,12-02-2021 22:00,24 hrs.,SPACs,DMYD,446,337,109,228,2,162,114,2,NYSE
4653,12-02-2021 22:00,24 hrs.,SPACs,EMPW,2420,273,2147,-1874,2,124,2164,2,NYSE
4653,12-02-2021 22:00,24 hrs.,SPACs,ENPC,2147,0,2147,-2147,1,50,2043,1,NYSE
4653,12-02-2021 22:00,24 hrs.,SPACs,FUSE,3925,1778,2147,-369,16,668,2525,13,NYSE
4653,12-02-2021 22:00,24 hrs.,SPACs,GLEO,273,273,0,273,1,74,121,1,NYSE
4653,12-02-2021 22:00,24 hrs.,SPACs,GOAC,273,273,0,273,1,74,121,1,NYSE
4653,12-02-2021 22:00,24 hrs.,SPACs,GSAH,446,337,109,228,2,162,114,2,NYSE
4653,12-02-2021 22:00,24 hrs.,SPACs,HIGA,273,273,0,273,1,74,121,1,NYSE
4653,12-02-2021 22:00,24 hrs.,SPACs,HZAC,273,273,0,273,1,74,121,1,NYSE
4653,12-02-2021 22:00,24 hrs.,SPACs,HZON,273,273,0,273,1,74,121,1,NYSE
4653,12-02-2021 22:00,24 hrs.,SPACs,IMPX,273,273,0,273,1,74,121,1,NYSE
4653,12-02-2021 22:00,24 hrs.,SPACs,IPOE,6,0,6,-6,1,1,0,1,NYSE
4653,12-02-2021 22:00,24 hrs.,SPACs,LGVW,420,337,83,254,4,167,70,3,NYSE
4653,12-02-2021 22:00,24 hrs.,SPACs,OACB,273,273,0,273,1,74,121,1,NYSE
4653,12-02-2021 22:00,24 hrs.,SPACs,PANA,273,273,0,273,1,74,121,1,NYSE
4653,12-02-2021 22:00,24 hrs.,SPACs,PCPL,273,273,0,273,1,74,121,1,NYSE
4653,12-02-2021 22:00,24 hrs.,SPACs,PDAC,7,7,0,7,1,1,1,1,NYSE
4653,12-02-2021 22:00,24 hrs.,SPACs,PIAI,273,273,0,273,1,74,121,1,NYSE
4653,12-02-2021 22:00,24 hrs.,SPACs,PRPB,273,273,0,273,1,74,121,1,NYSE
4653,12-02-2021 22:00,24 hrs.,SPACs,RBAC,273,273,0,273,1,74,121,1,NYSE
4653,12-02-2021 22:00,24 hrs.,SPACs,RPLA,273,273,0,273,1,74,121,1,NYSE
4653,12-02-2021 22:00,24 hrs.,SPACs,SCPE,273,273,0,273,1,74,121,1,NYSE
4653,12-02-2021 22:00,24 hrs.,SPACs,SCVX,273,273,0,273,1,74,121,1,NYSE
4653,12-02-2021 22:00,24 hrs.,SPACs,SEAH,273,273,0,273,1,74,121,1,NYSE
4653,12-02-2021 22:00,24 hrs.,SPACs,SFTW,273,273,0,273,1,74,121,1,NYSE
4653,12-02-2021 22:00,24 hrs.,SPACs,SKLZ,128,0,128,-128,1,39,46,1,NYSE
4653,12-02-2021 22:00,24 hrs.,SPACs,SNPR,2195,42,2153,-2111,6,58,2055,5,NYSE
4653,12-02-2021 22:00,24 hrs.,SPACs,SPCE,7,0,7,-7,1,1,1,1,NYSE
4653,12-02-2021 22:00,24 hrs.,SPACs,TWND,38,31,7,24,2,5,20,2,NYSE
4653,12-02-2021 22:00,24 hrs.,SPACs,VTOL,92,92,0,92,1,33,22,1,NYSE
4653,12-02-2021 22:00,24 hrs.,SPACs,APEX,31,31,0,31,1,4,19,1,OTC
4653,12-02-2021 22:00,24 hrs.,SPACs,CAGR,116,0,116,-116,1,23,66,1,OTC
4653,12-02-2021 22:00,24 hrs.,SPACs,CIK,51,51,0,51,1,15,17,1,AMEX
4653,12-02-2021 22:00,24 hrs.,SPACs,NBA,273,273,0,273,1,74,121,1,AMEX
4653,12-02-2021 22:00,24 hrs.,SPACs,PTK,273,273,0,273,1,74,121,1,AMEX
4653,12-02-2021 22:00,24 hrs.,SPACs,CHAQ,273,273,0,273,1,74,121,1,AMEX
4653,12-02-2021 22:00,24 hrs.,SPACs,AIR,92,92,0,92,1,33,22,1,NYSE
4653,12-02-2021 22:00,24 hrs.,SPACs,BFT,2147,0,2147,-2147,1,50,2043,1,NYSE
4653,12-02-2021 22:00,24 hrs.,SPACs,BSN,273,273,0,273,1,74,121,1,NYSE
4653,12-02-2021 22:00,24 hrs.,SPACs,CCX,273,273,0,273,1,74,121,1,NYSE
4653,12-02-2021 22:00,24 hrs.,SPACs,COO,35,35,0,35,1,5,21,1,NYSE
4653,12-02-2021 22:00,24 hrs.,SPACs,DEH,273,273,0,273,1,74,121,1,NYSE
4653,12-02-2021 22:00,24 hrs.,SPACs,DFS,92,92,0,92,1,33,22,1,NYSE
4653,12-02-2021 22:00,24 hrs.,SPACs,EQD,2420,273,2147,-1874,2,124,2164,2,NYSE
4653,12-02-2021 22:00,24 hrs.,SPACs,FSR,6,6,0,6,1,1,0,1,NYSE
4653,12-02-2021 22:00,24 hrs.,SPACs,GIK,30,0,30,-30,4,2,10,2,NYSE
4653,12-02-2021 22:00,24 hrs.,SPACs,GIX,273,273,0,273,1,74,121,1,NYSE
4653,12-02-2021 22:00,24 hrs.,SPACs,HPX,273,273,0,273,1,74,121,1,NYSE
4653,12-02-2021 22:00,24 hrs.,SPACs,ICE,35,35,0,35,1,11,9,1,NYSE
4653,12-02-2021 22:00,24 hrs.,SPACs,IRR,58,58,0,58,1,18,18,1,NYSE
4653,12-02-2021 22:00,24 hrs.,SPACs,JWS,2147,0,2147,-2147,1,50,2043,1,NYSE
4653,12-02-2021 22:00,24 hrs.,StockMarket,ZNGA,6,0,6,-6,1,1,0,1,NASDAQ
4653,12-02-2021 22:00,24 hrs.,StockMarket,SRACU,10,10,0,10,1,1,4,1,NASDAQ
4653,12-02-2021 22:00,24 hrs.,StockMarket,SRACW,10,10,0,10,1,1,4,1,NASDAQ
4653,12-02-2021 22:00,24 hrs.,pennystocks,AABB,18,0,18,-18,3,3,0,2,OTC
4653,12-02-2021 22:00,24 hrs.,pennystocks,ABML,99,99,0,99,2,30,31,2,OTC
4653,12-02-2021 22:00,24 hrs.,pennystocks,ADGO,14,0,14,-14,1,2,6,1,OTC
4653,12-02-2021 22:00,24 hrs.,pennystocks,ADTM,118,13,105,-92,3,35,36,2,OTC
4653,12-02-2021 22:00,24 hrs.,pennystocks,AEPT,6,0,6,-6,1,1,0,1,OTC
4653,12-02-2021 22:00,24 hrs.,pennystocks,AFPW,6,6,0,6,1,1,0,1,OTC
4653,12-02-2021 22:00,24 hrs.,pennystocks,AHFD,6,0,6,-6,1,1,0,1,OTC
4653,12-02-2021 22:00,24 hrs.,pennystocks,AITX,482,312,170,142,7,135,184,7,OTC
4653,12-02-2021 22:00,24 hrs.,pennystocks,ALKM,26,7,19,-12,4,4,2,2,OTC
4653,12-02-2021 22:00,24 hrs.,pennystocks,ALPP,354,354,0,354,6,117,96,5,OTC
4653,12-02-2021 22:00,24 hrs.,pennystocks,ALST,24,24,0,24,2,2,12,1,OTC
4653,12-02-2021 22:00,24 hrs.,pennystocks,ALYI,189,42,147,-105,4,62,49,4,OTC
4653,12-02-2021 22:00,24 hrs.,pennystocks,ANDI,7,7,0,7,1,1,1,1,OTC
4653,12-02-2021 22:00,24 hrs.,pennystocks,APPZ,7,7,0,7,1,1,1,1,OTC
4653,12-02-2021 22:00,24 hrs.,pennystocks,ASCK,6,6,0,6,1,1,0,1,OTC
4653,12-02-2021 22:00,24 hrs.,pennystocks,ASTI,18,18,0,18,3,3,0,3,OTC
4653,12-02-2021 22:00,24 hrs.,pennystocks,ATDS,6,6,0,6,1,1,0,1,OTC
4653,12-02-2021 22:00,24 hrs.,pennystocks,ATNP,17,17,0,17,1,3,7,1,OTC
4653,12-02-2021 22:00,24 hrs.,pennystocks,AXXA,14,14,0,14,1,4,2,1,OTC
4653,12-02-2021 22:00,24 hrs.,pennystocks,AZFL,95,36,59,-23,4,9,61,3,OTC
4653,12-02-2021 22:00,24 hrs.,pennystocks,BANT,27,6,21,-15,2,5,9,2,OTC
4653,12-02-2021 22:00,24 hrs.,pennystocks,BBRW,128,128,0,128,4,24,64,4,OTC
4653,12-02-2021 22:00,24 hrs.,pennystocks,BCCI,7,0,7,-7,1,1,1,1,OTC
4653,12-02-2021 22:00,24 hrs.,pennystocks,BDGR,6,6,0,6,1,1,0,1,OTC
4653,12-02-2021 22:00,24 hrs.,pennystocks,BFRE,16,16,0,16,1,0,12,1,OTC
4653,12-02-2021 22:00,24 hrs.,pennystocks,BGMD,6,6,0,6,1,1,0,1,OTC
4653,12-02-2021 22:00,24 hrs.,pennystocks,BIEL,110,110,0,110,4,29,36,3,OTC
4653,12-02-2021 22:00,24 hrs.,pennystocks,BKMP,6,0,6,-6,1,1,0,1,OTC
4653,12-02-2021 22:00,24 hrs.,pennystocks,BLDV,128,23,105,-82,2,40,40,2,OTC
4653,12-02-2021 22:00,24 hrs.,pennystocks,BLSP,13,6,7,-1,2,2,1,2,OTC
4653,12-02-2021 22:00,24 hrs.,pennystocks,BMCS,10,10,0,10,1,2,2,1,OTC
4653,12-02-2021 22:00,24 hrs.,pennystocks,BMIX,45,6,39,-33,2,8,21,2,OTC
4653,12-02-2021 22:00,24 hrs.,pennystocks,BONZ,6,6,0,6,1,0,2,1,OTC
4653,12-02-2021 22:00,24 hrs.,pennystocks,BOTY,131,0,131,-131,5,37,37,4,OTC
4653,12-02-2021 22:00,24 hrs.,pennystocks,BRGO,17,0,17,-17,1,5,3,1,OTC
4653,12-02-2021 22:00,24 hrs.,pennystocks,BRLL,46,46,0,46,2,4,30,2,OTC
4653,12-02-2021 22:00,24 hrs.,pennystocks,BRTX,12,12,0,12,2,2,0,2,OTC
4653,12-02-2021 22:00,24 hrs.,pennystocks,BRZL,6,6,0,6,1,1,0,1,OTC
4653,12-02-2021 22:00,24 hrs.,pennystocks,BUDZ,24,24,0,24,3,4,4,3,OTC
4653,12-02-2021 22:00,24 hrs.,pennystocks,BWMG,56,56,0,56,2,14,20,2,OTC
4653,12-02-2021 22:00,24 hrs.,pennystocks,BXNG,25,0,25,-25,1,4,13,1,OTC
4653,12-02-2021 22:00,24 hrs.,pennystocks,BZWR,14,14,0,14,1,0,10,1,OTC
4653,12-02-2021 22:00,24 hrs.,pennystocks,CANN,6,6,0,6,1,1,0,1,OTC
4653,12-02-2021 22:00,24 hrs.,pennystocks,CAPC,7,7,0,7,1,1,1,1,OTC
4653,12-02-2021 22:00,24 hrs.,pennystocks,CATV,11,11,0,11,1,2,3,1,OTC
4653,12-02-2021 22:00,24 hrs.,pennystocks,CAVR,6,6,0,6,1,1,0,1,OTC
4653,12-02-2021 22:00,24 hrs.,pennystocks,CBBT,667,325,342,-17,9,245,141,8,OTC
4653,12-02-2021 22:00,24 hrs.,pennystocks,CBDD,64,0,64,-64,3,19,14,3,OTC
4653,12-02-2021 22:00,24 hrs.,pennystocks,CBDL,392,228,164,64,6,104,160,6,OTC
4653,12-02-2021 22:00,24 hrs.,pennystocks,CCTL,10,10,0,10,1,2,2,1,OTC
4653,12-02-2021 22:00,24 hrs.,pennystocks,CELZ,7,7,0,7,1,1,1,1,OTC
4653,12-02-2021 22:00,24 hrs.,StockMarket,MKSI,13,13,0,13,1,3,3,1,NASDAQ
4653,12-02-2021 22:00,24 hrs.,StockMarket,MSTR,12,0,12,-12,2,2,0,1,NASDAQ
4653,12-02-2021 22:00,24 hrs.,StockMarket,MTCH,7,7,0,7,1,0,3,1,NASDAQ
4653,12-02-2021 22:00,24 hrs.,StockMarket,OCGN,25,25,0,25,3,2,9,3,NASDAQ
4653,12-02-2021 22:00,24 hrs.,StockMarket,PACB,4,0,4,-4,1,0,0,1,NASDAQ
4653,12-02-2021 22:00,24 hrs.,StockMarket,PYPL,18,0,18,-18,1,5,4,1,NASDAQ
4653,12-02-2021 22:00,24 hrs.,StockMarket,RBBN,6,6,0,6,1,1,0,1,NASDAQ
4653,12-02-2021 22:00,24 hrs.,StockMarket,RCMT,4,0,4,-4,1,0,0,1,NASDAQ
4653,12-02-2021 22:00,24 hrs.,StockMarket,REAL,34,34,0,34,1,0,30,1,NASDAQ
4653,12-02-2021 22:00,24 hrs.,StockMarket,RIDE,19,19,0,19,2,4,3,2,NASDAQ
4653,12-02-2021 22:00,24 hrs.,pennystocks,CYPW,6,0,6,-6,1,1,0,1,OTC
4653,12-02-2021 22:00,24 hrs.,wallstreetbets,WATT,23,7,16,-9,2,2,11,2,NASDAQ
4653,12-02-2021 22:00,24 hrs.,wallstreetbets,WKHS,2571,2571,0,2571,2,1142,279,2,NASDAQ
4653,12-02-2021 22:00,24 hrs.,wallstreetbets,WRAP,7,7,0,7,1,1,1,1,NASDAQ
4653,12-02-2021 22:00,24 hrs.,wallstreetbets,WTER,7,0,7,-7,1,1,1,1,NASDAQ
4653,12-02-2021 22:00,24 hrs.,wallstreetbets,XENE,14,14,0,14,2,2,2,1,NASDAQ
4653,12-02-2021 22:00,24 hrs.,wallstreetbets,XERS,15,15,0,15,2,2,3,2,NASDAQ
4653,12-02-2021 22:00,24 hrs.,wallstreetbets,XNET,14,14,0,14,2,2,2,1,NASDAQ
4653,12-02-2021 22:00,24 hrs.,wallstreetbets,XSPA,60,34,26,8,9,9,6,8,NASDAQ
4653,12-02-2021 22:00,24 hrs.,wallstreetbets,YNDX,499,0,499,-499,1,188,119,1,NASDAQ
4653,12-02-2021 22:00,24 hrs.,wallstreetbets,ZNGA,20,7,13,-6,3,3,2,3,NASDAQ
4653,12-02-2021 22:00,24 hrs.,wallstreetbets,ZYNE,7,7,0,7,1,1,1,1,NASDAQ
4653,12-02-2021 22:00,24 hrs.,wallstreetbets,CMCSA,7,7,0,7,1,1,1,1,NASDAQ
4653,12-02-2021 22:00,24 hrs.,wallstreetbets,GOOGL,6,6,0,6,1,1,0,1,NASDAQ
4653,12-02-2021 22:00,24 hrs.,wallstreetbets,SRACU,6,6,0,6,1,1,0,1,NASDAQ
4653,12-02-2021 22:00,24 hrs.,wallstreetbets,SRACW,6,6,0,6,1,1,0,1,NASDAQ
4653,12-02-2021 22:00,24 hrs.,RobinHoodPennyStocks,AHFD,6,0,6,-6,1,1,0,1,OTC
4653,12-02-2021 22:00,24 hrs.,RobinHoodPennyStocks,AZFL,6,0,6,-6,1,0,2,1,OTC
4653,12-02-2021 22:00,24 hrs.,RobinHoodPennyStocks,BGMD,4,4,0,4,1,0,0,1,OTC
4653,12-02-2021 22:00,24 hrs.,RobinHoodPennyStocks,BLXX,6,6,0,6,1,1,0,1,OTC
4653,12-02-2021 22:00,24 hrs.,RobinHoodPennyStocks,CAPS,6,0,6,-6,1,1,0,1,OTC
4653,12-02-2021 22:00,24 hrs.,RobinHoodPennyStocks,CBDD,6,6,0,6,1,1,0,1,OTC
4653,12-02-2021 22:00,24 hrs.,RobinHoodPennyStocks,DIGI,6,0,6,-6,1,1,0,1,OTC
4653,12-02-2021 22:00,24 hrs.,RobinHoodPennyStocks,GLEC,6,6,0,6,1,1,0,1,OTC
4653,12-02-2021 22:00,24 hrs.,RobinHoodPennyStocks,GPFT,28,28,0,28,4,4,4,2,OTC
4653,12-02-2021 22:00,24 hrs.,RobinHoodPennyStocks,GSPH,6,6,0,6,1,1,0,1,OTC
4653,12-02-2021 22:00,24 hrs.,RobinHoodPennyStocks,HCMC,18,12,6,6,3,3,0,3,OTC
4653,12-02-2021 22:00,24 hrs.,RobinHoodPennyStocks,INKW,6,6,0,6,1,1,0,1,OTC
4653,12-02-2021 22:00,24 hrs.,RobinHoodPennyStocks,LTUM,6,6,0,6,1,1,0,1,OTC
4653,12-02-2021 22:00,24 hrs.,RobinHoodPennyStocks,MJNA,6,6,0,6,1,1,0,1,OTC
4653,12-02-2021 22:00,24 hrs.,RobinHoodPennyStocks,OPTI,6,0,6,-6,1,1,0,1,OTC
4653,12-02-2021 22:00,24 hrs.,RobinHoodPennyStocks,PHIL,6,6,0,6,1,1,0,1,OTC
4653,12-02-2021 22:00,24 hrs.,RobinHoodPennyStocks,BDRBF,36,12,24,-12,6,6,0,6,OTC
4653,12-02-2021 22:00,24 hrs.,RobinHoodPennyStocks,NXTTF,6,6,0,6,1,1,0,1,OTC
4653,12-02-2021 22:00,24 hrs.,RobinHoodPennyStocks,PMEDF,6,6,0,6,1,1,0,1,OTC
4653,12-02-2021 22:00,24 hrs.,RobinHoodPennyStocks,RYCEY,18,18,0,18,3,3,0,3,OTC
4653,12-02-2021 22:00,24 hrs.,RobinHoodPennyStocks,SHCAY,19,19,0,19,1,7,1,1,OTC
4653,12-02-2021 22:00,24 hrs.,RobinHoodPennyStocks,TLOFF,6,0,6,-6,1,1,0,1,OTC
4653,12-02-2021 22:00,24 hrs.,RobinHoodPennyStocks,ZBISF,6,6,0,6,1,1,0,1,OTC
4653,12-02-2021 22:00,24 hrs.,RobinHoodPennyStocks,AAU,111,0,111,-111,1,40,27,1,AMEX
4653,12-02-2021 22:00,24 hrs.,RobinHoodPennyStocks,DNN,540,12,528,-516,8,184,140,7,AMEX
4653,12-02-2021 22:00,24 hrs.,RobinHoodPennyStocks,DPW,111,0,111,-111,1,40,27,1,AMEX
4653,12-02-2021 22:00,24 hrs.,RobinHoodPennyStocks,GSV,117,6,111,-105,2,41,27,2,AMEX
4653,12-02-2021 22:00,24 hrs.,RobinHoodPennyStocks,GTE,871,559,312,247,19,257,281,18,AMEX
4653,12-02-2021 22:00,24 hrs.,RobinHoodPennyStocks,ITP,6,6,0,6,1,1,0,1,AMEX
4653,12-02-2021 22:00,24 hrs.,RobinHoodPennyStocks,NAK,206,83,123,-40,9,56,58,9,AMEX
4653,12-02-2021 22:00,24 hrs.,RobinHoodPennyStocks,PLM,42,0,42,-42,1,16,6,1,AMEX
4653,12-02-2021 22:00,24 hrs.,RobinHoodPennyStocks,REI,18,18,0,18,1,5,4,1,AMEX
4653,12-02-2021 22:00,24 hrs.,RobinHoodPennyStocks,RHE,111,0,111,-111,1,40,27,1,AMEX
4653,12-02-2021 22:00,24 hrs.,RobinHoodPennyStocks,SYN,12,6,6,0,2,2,0,2,AMEX
4653,12-02-2021 22:00,24 hrs.,RobinHoodPennyStocks,TGB,103,0,103,-103,2,38,19,2,AMEX
4653,12-02-2021 22:00,24 hrs.,RobinHoodPennyStocks,TRT,111,0,111,-111,1,40,27,1,AMEX
4653,12-02-2021 22:00,24 hrs.,RobinHoodPennyStocks,TRX,246,36,210,-174,3,77,80,3,AMEX
4653,12-02-2021 22:00,24 hrs.,RobinHoodPennyStocks,XPL,111,0,111,-111,1,40,27,1,AMEX
4653,12-02-2021 22:00,24 hrs.,StockMarket,TLRY,117,58,59,-1,8,32,21,8,NASDAQ
4653,12-02-2021 22:00,24 hrs.,StockMarket,TLSA,4,0,4,-4,1,0,0,1,NASDAQ
4653,12-02-2021 22:00,24 hrs.,StockMarket,TNXP,6,6,0,6,1,1,0,1,NASDAQ
4653,12-02-2021 22:00,24 hrs.,StockMarket,TRVG,6,6,0,6,1,1,0,1,NASDAQ
4653,12-02-2021 22:00,24 hrs.,StockMarket,TSLA,6,6,0,6,1,1,0,1,NASDAQ
4653,12-02-2021 22:00,24 hrs.,StockMarket,VITL,6,6,0,6,1,1,0,1,NASDAQ
4653,12-02-2021 22:00,24 hrs.,StockMarket,VRSN,13,13,0,13,1,3,3,1,NASDAQ
4653,12-02-2021 22:00,24 hrs.,StockMarket,VXRT,31,0,31,-31,1,11,5,1,NASDAQ
4653,12-02-2021 22:00,24 hrs.,StockMarket,WAFU,79,79,0,79,1,19,37,1,NASDAQ
4653,12-02-2021 22:00,24 hrs.,StockMarket,ZIOP,6,6,0,6,1,1,0,1,NASDAQ
4653,12-02-2021 22:00,24 hrs.,RobinHoodPennyStocks,TKAT,111,0,111,-111,1,40,27,1,AMEX
4653,12-02-2021 22:00,24 hrs.,RobinHoodPennyStocks,TRXC,177,6,171,-165,3,67,31,3,AMEX
4653,12-02-2021 22:00,24 hrs.,RobinHoodPennyStocks,YCBD,6,0,6,-6,1,1,0,1,AMEX
4653,12-02-2021 22:00,24 hrs.,RobinHoodPennyStocks,AIV,6,6,0,6,1,1,0,1,NYSE
4653,12-02-2021 22:00,24 hrs.,RobinHoodPennyStocks,AMC,151,0,151,-151,2,49,45,2,NYSE
4653,12-02-2021 22:00,24 hrs.,RobinHoodPennyStocks,AUY,99,0,99,-99,1,29,37,1,NYSE
4653,12-02-2021 22:00,24 hrs.,RobinHoodPennyStocks,BTU,111,0,111,-111,1,40,27,1,NYSE
4653,12-02-2021 22:00,24 hrs.,RobinHoodPennyStocks,CCM,111,0,111,-111,1,40,27,1,NYSE
4653,12-02-2021 22:00,24 hrs.,RobinHoodPennyStocks,COO,99,0,99,-99,1,29,37,1,NYSE
4653,12-02-2021 22:00,24 hrs.,RobinHoodPennyStocks,CTK,111,0,111,-111,1,40,27,1,NYSE
4653,12-02-2021 22:00,24 hrs.,RobinHoodPennyStocks,FSR,117,6,111,-105,2,41,27,2,NYSE
4653,12-02-2021 22:00,24 hrs.,RobinHoodPennyStocks,GME,73,33,40,-7,2,18,29,2,NYSE
4653,12-02-2021 22:00,24 hrs.,RobinHoodPennyStocks,GSX,111,0,111,-111,1,40,27,1,NYSE
4653,12-02-2021 22:00,24 hrs.,RobinHoodPennyStocks,IRS,206,206,0,206,1,94,14,1,NYSE
4653,12-02-2021 22:00,24 hrs.,RobinHoodPennyStocks,IVR,6,0,6,-6,1,1,0,1,NYSE
4653,12-02-2021 22:00,24 hrs.,RobinHoodPennyStocks,LOW,6,0,6,-6,1,1,0,1,NYSE
4653,12-02-2021 22:00,24 hrs.,RobinHoodPennyStocks,LYG,6,0,6,-6,1,1,0,1,NYSE
4653,12-02-2021 22:00,24 hrs.,pennystocks,DGMA,6,0,6,-6,1,1,0,1,OTC
4653,12-02-2021 22:00,24 hrs.,pennystocks,DIGI,13,0,13,-13,2,2,1,1,OTC
4653,12-02-2021 22:00,24 hrs.,pennystocks,DMAN,17,17,0,17,1,4,5,1,OTC
4653,12-02-2021 22:00,24 hrs.,pennystocks,DPLS,371,106,265,-159,11,102,123,8,OTC
4653,12-02-2021 22:00,24 hrs.,pennystocks,ECCI,6,0,6,-6,1,1,0,1,OTC
4653,12-02-2021 22:00,24 hrs.,pennystocks,ECEZ,136,0,136,-136,3,48,28,2,OTC
4653,12-02-2021 22:00,24 hrs.,pennystocks,ELTP,18,18,0,18,1,5,4,1,OTC
4653,12-02-2021 22:00,24 hrs.,pennystocks,ENCS,6,0,6,-6,1,1,0,1,OTC
4653,12-02-2021 22:00,24 hrs.,pennystocks,ENDV,6,0,6,-6,1,1,0,1,OTC
4653,12-02-2021 22:00,24 hrs.,pennystocks,ENRT,6,6,0,6,1,1,0,1,OTC
4653,12-02-2021 22:00,24 hrs.,pennystocks,ENZC,12,12,0,12,2,2,0,2,OTC
4653,12-02-2021 22:00,24 hrs.,pennystocks,ERBB,14,14,0,14,1,1,8,1,OTC
4653,12-02-2021 22:00,24 hrs.,pennystocks,ETFM,192,81,111,-30,5,59,54,4,OTC
4653,12-02-2021 22:00,24 hrs.,pennystocks,ETHE,40,40,0,40,1,6,24,1,OTC
4653,12-02-2021 22:00,24 hrs.,pennystocks,EWKS,7,7,0,7,1,1,1,1,OTC
4653,12-02-2021 22:00,24 hrs.,pennystocks,FBEC,6,6,0,6,1,1,0,1,OTC
4653,12-02-2021 22:00,24 hrs.,pennystocks,FDBH,7,0,7,-7,1,1,1,1,OTC
4653,12-02-2021 22:00,24 hrs.,pennystocks,FLXT,6,6,0,6,1,1,0,1,OTC
4653,12-02-2021 22:00,24 hrs.,pennystocks,FPVD,9,0,9,-9,1,2,1,1,OTC
4653,12-02-2021 22:00,24 hrs.,pennystocks,FTFY,6,0,6,-6,1,1,0,1,OTC
4653,12-02-2021 22:00,24 hrs.,pennystocks,FUST,7,7,0,7,1,1,1,1,OTC
4653,12-02-2021 22:00,24 hrs.,pennystocks,FUTL,7,0,7,-7,1,1,1,1,OTC
4653,12-02-2021 22:00,24 hrs.,pennystocks,GBTC,40,40,0,40,1,6,24,1,OTC
4653,12-02-2021 22:00,24 hrs.,pennystocks,GDET,7,0,7,-7,1,1,1,1,OTC
4653,12-02-2021 22:00,24 hrs.,pennystocks,GHMP,50,50,0,50,3,10,18,2,OTC
4653,12-02-2021 22:00,24 hrs.,pennystocks,GLCO,6,6,0,6,1,1,0,1,OTC
4653,12-02-2021 22:00,24 hrs.,pennystocks,GLEC,6,6,0,6,1,1,0,1,OTC
4653,12-02-2021 22:00,24 hrs.,pennystocks,GMEV,677,0,677,-677,1,264,145,1,OTC
4653,12-02-2021 22:00,24 hrs.,pennystocks,GNCP,10,0,10,-10,1,1,4,1,OTC
4653,12-02-2021 22:00,24 hrs.,pennystocks,GPFT,37,0,37,-37,1,7,19,1,OTC
4653,12-02-2021 22:00,24 hrs.,pennystocks,GRCU,16,10,6,4,2,2,4,2,OTC
4653,12-02-2021 22:00,24 hrs.,pennystocks,GRST,46,46,0,46,2,15,8,1,OTC
4653,12-02-2021 22:00,24 hrs.,pennystocks,GTBP,21,21,0,21,1,3,11,1,OTC
4653,12-02-2021 22:00,24 hrs.,pennystocks,GTCH,38,0,38,-38,4,3,16,1,OTC
4653,12-02-2021 22:00,24 hrs.,pennystocks,GTEH,96,0,96,-96,1,38,16,1,OTC
4653,12-02-2021 22:00,24 hrs.,pennystocks,GTLL,113,65,48,17,4,38,21,4,OTC
4653,12-02-2021 22:00,24 hrs.,pennystocks,HALB,30,30,0,30,2,8,6,1,OTC
4653,12-02-2021 22:00,24 hrs.,pennystocks,CHNC,17,17,0,17,1,4,5,1,OTC
4653,12-02-2021 22:00,24 hrs.,pennystocks,CLIS,6,0,6,-6,1,1,0,1,OTC
4653,12-02-2021 22:00,24 hrs.,pennystocks,CLWD,6,6,0,6,1,1,0,1,OTC
4653,12-02-2021 22:00,24 hrs.,pennystocks,CNNA,25,0,25,-25,2,3,11,2,OTC
4653,12-02-2021 22:00,24 hrs.,pennystocks,CORG,51,39,12,27,5,7,17,5,OTC
4653,12-02-2021 22:00,24 hrs.,pennystocks,CRTG,31,31,0,31,1,9,9,1,OTC
4653,12-02-2021 22:00,24 hrs.,pennystocks,CRWG,6,6,0,6,1,1,0,1,OTC
4653,12-02-2021 22:00,24 hrs.,pennystocks,CSLI,39,39,0,39,1,11,13,1,OTC
4653,12-02-2021 22:00,24 hrs.,pennystocks,CTLE,12,6,6,0,2,2,0,2,OTC
4653,12-02-2021 22:00,24 hrs.,pennystocks,CYDY,7,7,0,7,1,1,1,1,OTC
4653,12-02-2021 22:00,24 hrs.,pennystocks,ICLD,6,6,0,6,1,1,0,1,OTC
4653,12-02-2021 22:00,24 hrs.,pennystocks,ICNM,15,15,0,15,1,3,5,1,OTC
4653,12-02-2021 22:00,24 hrs.,pennystocks,IMJX,97,91,6,85,2,27,35,2,OTC
4653,12-02-2021 22:00,24 hrs.,pennystocks,IMTL,6,6,0,6,1,1,0,1,OTC
4653,12-02-2021 22:00,24 hrs.,pennystocks,INCT,7,0,7,-7,1,1,1,1,OTC
4653,12-02-2021 22:00,24 hrs.,pennystocks,INKW,56,50,6,44,9,9,2,7,OTC
4653,12-02-2021 22:00,24 hrs.,pennystocks,INND,214,131,83,48,10,39,96,10,OTC
4653,12-02-2021 22:00,24 hrs.,pennystocks,INTV,12,12,0,12,2,2,0,2,OTC
4653,12-02-2021 22:00,24 hrs.,pennystocks,INVU,6,0,6,-6,1,1,0,1,OTC
4653,12-02-2021 22:00,24 hrs.,pennystocks,IPIX,71,6,65,-59,2,15,33,2,OTC
4653,12-02-2021 22:00,24 hrs.,pennystocks,IPSI,17,11,6,5,2,4,1,2,OTC
4653,12-02-2021 22:00,24 hrs.,pennystocks,IQST,51,51,0,51,4,3,29,3,OTC
4653,12-02-2021 22:00,24 hrs.,pennystocks,ITCJ,7,7,0,7,1,1,1,1,OTC
4653,12-02-2021 22:00,24 hrs.,pennystocks,JETR,6,0,6,-6,1,1,0,1,OTC
4653,12-02-2021 22:00,24 hrs.,pennystocks,JSDA,6,6,0,6,1,1,0,1,OTC
4653,12-02-2021 22:00,24 hrs.,pennystocks,KGKG,25,0,25,-25,4,4,1,2,OTC
4653,12-02-2021 22:00,24 hrs.,pennystocks,KWBT,7,7,0,7,1,1,1,1,OTC
4653,12-02-2021 22:00,24 hrs.,pennystocks,KYNC,37,6,31,-25,6,6,1,2,OTC
4653,12-02-2021 22:00,24 hrs.,pennystocks,LITH,6,6,0,6,1,1,0,1,OTC
4653,12-02-2021 22:00,24 hrs.,pennystocks,LQMT,108,6,102,-96,2,34,32,2,OTC
4653,12-02-2021 22:00,24 hrs.,pennystocks,LTNC,6,0,6,-6,1,1,0,1,OTC
4653,12-02-2021 22:00,24 hrs.,pennystocks,LUVU,14,14,0,14,2,3,0,2,OTC
4653,12-02-2021 22:00,24 hrs.,pennystocks,LVVV,24,0,24,-24,4,4,0,2,OTC
4653,12-02-2021 22:00,24 hrs.,pennystocks,MAXD,58,58,0,58,6,14,6,6,OTC
4653,12-02-2021 22:00,24 hrs.,pennystocks,MCOA,14,7,7,0,2,2,2,2,OTC
4653,12-02-2021 22:00,24 hrs.,pennystocks,MDCN,13,13,0,13,2,2,1,2,OTC
4653,12-02-2021 22:00,24 hrs.,pennystocks,MEDH,75,75,0,75,1,20,31,1,OTC
4653,12-02-2021 22:00,24 hrs.,pennystocks,MGLG,6,0,6,-6,1,1,0,1,OTC
4653,12-02-2021 22:00,24 hrs.,pennystocks,MGTI,13,13,0,13,1,4,1,1,OTC
4653,12-02-2021 22:00,24 hrs.,pennystocks,MIHI,6,6,0,6,1,1,0,1,OTC
4653,12-02-2021 22:00,24 hrs.,pennystocks,MIKP,6,0,6,-6,1,1,0,1,OTC
4653,12-02-2021 22:00,24 hrs.,pennystocks,MINE,523,67,456,-389,9,196,95,8,OTC
4653,12-02-2021 22:00,24 hrs.,pennystocks,MJNA,97,25,72,-47,6,20,33,5,OTC
4653,12-02-2021 22:00,24 hrs.,pennystocks,MJTV,7,7,0,7,1,1,1,1,OTC
4653,12-02-2021 22:00,24 hrs.,pennystocks,MKTY,7,7,0,7,1,1,1,1,OTC
4653,12-02-2021 22:00,24 hrs.,pennystocks,MLFB,144,138,6,132,4,40,48,4,OTC
4653,12-02-2021 22:00,24 hrs.,pennystocks,MMEX,159,131,28,103,4,30,83,3,OTC
4653,12-02-2021 22:00,24 hrs.,pennystocks,MODC,6,0,6,-6,1,1,0,1,OTC
4653,12-02-2021 22:00,24 hrs.,pennystocks,MOJO,12,12,0,12,2,2,0,1,OTC
4653,12-02-2021 22:00,24 hrs.,pennystocks,MRMD,47,0,47,-47,1,19,5,1,OTC
4653,12-02-2021 22:00,24 hrs.,pennystocks,MRNJ,13,0,13,-13,2,2,1,1,OTC
4653,12-02-2021 22:00,24 hrs.,pennystocks,MTVX,6,6,0,6,1,1,0,1,OTC
4653,12-02-2021 22:00,24 hrs.,pennystocks,NBVG,7,7,0,7,1,1,1,1,OTC
4653,12-02-2021 22:00,24 hrs.,RobinHoodPennyStocks,MTL,19,19,0,19,2,2,7,2,NYSE
4653,12-02-2021 22:00,24 hrs.,RobinHoodPennyStocks,NAT,6,6,0,6,1,1,0,1,NYSE
4653,12-02-2021 22:00,24 hrs.,RobinHoodPennyStocks,NIO,111,0,111,-111,1,40,27,1,NYSE
4653,12-02-2021 22:00,24 hrs.,RobinHoodPennyStocks,PHI,6,6,0,6,1,1,0,1,NYSE
4653,12-02-2021 22:00,24 hrs.,RobinHoodPennyStocks,PSA,18,0,18,-18,1,5,4,1,NYSE
4653,12-02-2021 22:00,24 hrs.,RobinHoodPennyStocks,RFP,111,0,111,-111,1,40,27,1,NYSE
4653,12-02-2021 22:00,24 hrs.,RobinHoodPennyStocks,SOS,191,50,141,-91,8,58,43,6,NYSE
4653,12-02-2021 22:00,24 hrs.,RobinHoodPennyStocks,SUZ,111,0,111,-111,1,40,27,1,NYSE
4653,12-02-2021 22:00,24 hrs.,RobinHoodPennyStocks,TAL,111,0,111,-111,1,40,27,1,NYSE
4653,12-02-2021 22:00,24 hrs.,RobinHoodPennyStocks,WEI,111,0,111,-111,1,40,27,1,NYSE
4653,12-02-2021 22:00,24 hrs.,RobinHoodPennyStocks,BABA,111,0,111,-111,1,40,27,1,NYSE
4653,12-02-2021 22:00,24 hrs.,RobinHoodPennyStocks,ZOM,1481,999,482,517,15,502,417,15,AMEX
4653,12-02-2021 22:00,24 hrs.,RobinHoodPennyStocks,AMBO,111,0,111,-111,1,40,27,1,AMEX
4653,12-02-2021 22:00,24 hrs.,RobinHoodPennyStocks,AUMN,210,0,210,-210,2,69,64,2,AMEX
4653,12-02-2021 22:00,24 hrs.,RobinHoodPennyStocks,GSAT,26,0,26,-26,1,5,12,1,AMEX
4653,12-02-2021 22:00,24 hrs.,RobinHoodPennyStocks,IBIO,35,35,0,35,1,13,5,1,AMEX
4653,12-02-2021 22:00,24 hrs.,RobinHoodPennyStocks,NSPR,39,32,7,25,2,10,11,2,AMEX
4653,12-02-2021 22:00,24 hrs.,RobinHoodPennyStocks,OGEN,18,18,0,18,3,3,0,3,AMEX
4653,12-02-2021 22:00,24 hrs.,RobinHoodPennyStocks,PLAG,111,0,111,-111,1,40,27,1,AMEX
4653,12-02-2021 22:00,24 hrs.,RobinHoodPennyStocks,SENS,61,61,0,61,3,22,5,3,AMEX
4653,12-02-2021 22:00,24 hrs.,RobinHoodPennyStocks,SMTS,6,0,6,-6,1,1,0,1,AMEX
4653,12-02-2021 22:00,24 hrs.,RobinHoodPennyStocks,ENG,111,0,111,-111,1,40,27,1,NASDAQ
4653,12-02-2021 22:00,24 hrs.,RobinHoodPennyStocks,EVK,111,0,111,-111,1,40,27,1,NASDAQ
4653,12-02-2021 22:00,24 hrs.,RobinHoodPennyStocks,MGI,111,0,111,-111,1,40,27,1,NASDAQ
4653,12-02-2021 22:00,24 hrs.,RobinHoodPennyStocks,OCG,111,0,111,-111,1,40,27,1,NASDAQ
4653,12-02-2021 22:00,24 hrs.,RobinHoodPennyStocks,OEG,111,0,111,-111,1,40,27,1,NASDAQ
4653,12-02-2021 22:00,24 hrs.,RobinHoodPennyStocks,OGI,6,6,0,6,1,1,0,1,NASDAQ
4653,12-02-2021 22:00,24 hrs.,RobinHoodPennyStocks,PTE,12,0,12,-12,2,2,0,1,NASDAQ
4653,12-02-2021 22:00,24 hrs.,RobinHoodPennyStocks,QTT,111,0,111,-111,1,40,27,1,NASDAQ
4653,12-02-2021 22:00,24 hrs.,RobinHoodPennyStocks,SND,36,36,0,36,4,8,4,2,NASDAQ
4653,12-02-2021 22:00,24 hrs.,RobinHoodPennyStocks,SPI,111,0,111,-111,1,40,27,1,NASDAQ
4653,12-02-2021 22:00,24 hrs.,RobinHoodPennyStocks,WNW,111,0,111,-111,1,40,27,1,NASDAQ
4653,12-02-2021 22:00,24 hrs.,RobinHoodPennyStocks,WWR,111,0,111,-111,1,40,27,1,NASDAQ
4653,12-02-2021 22:00,24 hrs.,RobinHoodPennyStocks,AAOI,111,0,111,-111,1,40,27,1,NASDAQ
4653,12-02-2021 22:00,24 hrs.,RobinHoodPennyStocks,ABEO,156,156,0,156,3,48,48,3,NASDAQ
4653,12-02-2021 22:00,24 hrs.,RobinHoodPennyStocks,ABIO,26,0,26,-26,1,3,16,1,NASDAQ
4653,12-02-2021 22:00,24 hrs.,RobinHoodPennyStocks,ACOR,111,0,111,-111,1,40,27,1,NASDAQ
4653,12-02-2021 22:00,24 hrs.,RobinHoodPennyStocks,ACRX,19,19,0,19,1,6,3,1,NASDAQ
4653,12-02-2021 22:00,24 hrs.,RobinHoodPennyStocks,ACST,6,6,0,6,1,1,0,1,NASDAQ
4653,12-02-2021 22:00,24 hrs.,RobinHoodPennyStocks,ADXS,18,18,0,18,3,3,0,2,NASDAQ
4653,12-02-2021 22:00,24 hrs.,RobinHoodPennyStocks,AEHR,111,0,111,-111,1,40,27,1,NASDAQ
4653,12-02-2021 22:00,24 hrs.,RobinHoodPennyStocks,AGTC,2273,1025,1248,-223,22,846,493,22,NASDAQ
4653,12-02-2021 22:00,24 hrs.,RobinHoodPennyStocks,AIHS,111,0,111,-111,1,40,27,1,NASDAQ
4653,12-02-2021 22:00,24 hrs.,RobinHoodPennyStocks,ALAC,111,0,111,-111,1,40,27,1,NASDAQ
4653,12-02-2021 22:00,24 hrs.,RobinHoodPennyStocks,AMTX,111,0,111,-111,1,40,27,1,NASDAQ
4653,12-02-2021 22:00,24 hrs.,RobinHoodPennyStocks,APHA,18,12,6,6,3,3,0,2,NASDAQ
4653,12-02-2021 22:00,24 hrs.,RobinHoodPennyStocks,ARPO,6,6,0,6,1,1,0,1,NASDAQ
4653,12-02-2021 22:00,24 hrs.,RobinHoodPennyStocks,ARTL,18,18,0,18,3,3,0,3,NASDAQ
4653,12-02-2021 22:00,24 hrs.,RobinHoodPennyStocks,ASRT,49,43,6,37,4,14,5,3,NASDAQ
4653,12-02-2021 22:00,24 hrs.,RobinHoodPennyStocks,ASYS,111,0,111,-111,1,40,27,1,NASDAQ
4653,12-02-2021 22:00,24 hrs.,RobinHoodPennyStocks,ATIF,111,0,111,-111,1,40,27,1,NASDAQ
4653,12-02-2021 22:00,24 hrs.,RobinHoodPennyStocks,ATNI,111,0,111,-111,1,40,27,1,NASDAQ
4653,12-02-2021 22:00,24 hrs.,RobinHoodPennyStocks,ATOS,573,514,59,455,16,200,109,16,NASDAQ
4653,12-02-2021 22:00,24 hrs.,RobinHoodPennyStocks,AVCO,111,0,111,-111,1,40,27,1,NASDAQ
4653,12-02-2021 22:00,24 hrs.,RobinHoodPennyStocks,BBIG,6,0,6,-6,1,1,0,1,NASDAQ
4653,12-02-2021 22:00,24 hrs.,RobinHoodPennyStocks,BCRX,42,0,42,-42,1,8,22,1,NASDAQ
4653,12-02-2021 22:00,24 hrs.,RobinHoodPennyStocks,BFRA,111,0,111,-111,1,40,27,1,NASDAQ
4653,12-02-2021 22:00,24 hrs.,RobinHoodPennyStocks,BHAT,111,0,111,-111,1,40,27,1,NASDAQ
4653,12-02-2021 22:00,24 hrs.,RobinHoodPennyStocks,BHTG,63,63,0,63,2,21,13,2,NASDAQ
4653,12-02-2021 22:00,24 hrs.,RobinHoodPennyStocks,BIOL,6,6,0,6,1,1,0,1,NASDAQ
4653,12-02-2021 22:00,24 hrs.,RobinHoodPennyStocks,BNGO,40,40,0,40,3,10,8,3,NASDAQ
4653,12-02-2021 22:00,24 hrs.,RobinHoodPennyStocks,BRQS,141,30,111,-81,3,45,39,3,NASDAQ
4653,12-02-2021 22:00,24 hrs.,RobinHoodPennyStocks,BYFC,111,0,111,-111,1,40,27,1,NASDAQ
4653,12-02-2021 22:00,24 hrs.,RobinHoodPennyStocks,CAAS,111,0,111,-111,1,40,27,1,NASDAQ
4653,12-02-2021 22:00,24 hrs.,RobinHoodPennyStocks,CARV,111,0,111,-111,1,40,27,1,NASDAQ
4653,12-02-2021 22:00,24 hrs.,RobinHoodPennyStocks,CBAT,111,0,111,-111,1,40,27,1,NASDAQ
4653,12-02-2021 22:00,24 hrs.,RobinHoodPennyStocks,CCNC,111,0,111,-111,1,40,27,1,NASDAQ
4653,12-02-2021 22:00,24 hrs.,RobinHoodPennyStocks,CDTX,6,6,0,6,1,1,0,1,NASDAQ
4653,12-02-2021 22:00,24 hrs.,RobinHoodPennyStocks,CHNR,111,0,111,-111,1,40,27,1,NASDAQ
4653,12-02-2021 22:00,24 hrs.,RobinHoodPennyStocks,CIDM,6,0,6,-6,1,1,0,1,NASDAQ
4653,12-02-2021 22:00,24 hrs.,RobinHoodPennyStocks,CKPT,333,60,273,-213,3,75,171,3,NASDAQ
4653,12-02-2021 22:00,24 hrs.,RobinHoodPennyStocks,CLBS,6,6,0,6,1,1,0,1,NASDAQ
4653,12-02-2021 22:00,24 hrs.,RobinHoodPennyStocks,CLEU,111,0,111,-111,1,40,27,1,NASDAQ
4653,12-02-2021 22:00,24 hrs.,RobinHoodPennyStocks,CLSK,111,0,111,-111,1,40,27,1,NASDAQ
4653,12-02-2021 22:00,24 hrs.,RobinHoodPennyStocks,CMLF,111,0,111,-111,1,40,27,1,NASDAQ
4653,12-02-2021 22:00,24 hrs.,pennystocks,HCMC,146,84,62,22,23,23,8,20,OTC
4653,12-02-2021 22:00,24 hrs.,pennystocks,HEMP,14,7,7,0,2,2,2,2,OTC
4653,12-02-2021 22:00,24 hrs.,pennystocks,HIPH,45,6,39,-33,4,7,15,3,OTC
4653,12-02-2021 22:00,24 hrs.,pennystocks,HMMR,7,7,0,7,1,1,1,1,OTC
4653,12-02-2021 22:00,24 hrs.,pennystocks,HMNY,6,6,0,6,1,1,0,1,OTC
4653,12-02-2021 22:00,24 hrs.,pennystocks,HPTY,39,39,0,39,1,11,13,1,OTC
4653,12-02-2021 22:00,24 hrs.,pennystocks,HQGE,6,0,6,-6,1,1,0,1,OTC
4653,12-02-2021 22:00,24 hrs.,pennystocks,HYII,7,0,7,-7,1,1,1,1,OTC
4653,12-02-2021 22:00,24 hrs.,pennystocks,HYSR,165,6,159,-153,4,54,41,4,OTC
4653,12-02-2021 22:00,24 hrs.,pennystocks,ICBU,6,6,0,6,1,1,0,1,OTC
4653,12-02-2021 22:00,24 hrs.,pennystocks,PLSB,6,0,6,-6,1,1,0,1,OTC
4653,12-02-2021 22:00,24 hrs.,pennystocks,PMCB,6,6,0,6,1,1,0,1,OTC
4653,12-02-2021 22:00,24 hrs.,pennystocks,PPJE,6,6,0,6,1,1,0,1,OTC
4653,12-02-2021 22:00,24 hrs.,pennystocks,PUGE,35,29,6,23,2,9,9,2,OTC
4653,12-02-2021 22:00,24 hrs.,pennystocks,PURA,13,13,0,13,2,2,1,2,OTC
4653,12-02-2021 22:00,24 hrs.,pennystocks,PVDG,23,23,0,23,1,1,17,1,OTC
4653,12-02-2021 22:00,24 hrs.,pennystocks,PZOO,7,0,7,-7,1,1,1,1,OTC
4653,12-02-2021 22:00,24 hrs.,pennystocks,QOIL,7,7,0,7,1,1,1,1,OTC
4653,12-02-2021 22:00,24 hrs.,pennystocks,RDGL,6,6,0,6,1,1,0,1,OTC
4653,12-02-2021 22:00,24 hrs.,pennystocks,RELI,15,15,0,15,1,0,11,1,OTC
4653,12-02-2021 22:00,24 hrs.,pennystocks,RGBP,23,23,0,23,2,6,3,1,OTC
4653,12-02-2021 22:00,24 hrs.,pennystocks,RITE,39,0,39,-39,1,7,21,1,OTC
4653,12-02-2021 22:00,24 hrs.,pennystocks,RLBD,20,20,0,20,1,6,4,1,OTC
4653,12-02-2021 22:00,24 hrs.,pennystocks,RLTR,6,0,6,-6,1,1,0,1,OTC
4653,12-02-2021 22:00,24 hrs.,pennystocks,RMTD,6,6,0,6,1,1,0,1,OTC
4653,12-02-2021 22:00,24 hrs.,pennystocks,RSHN,15,15,0,15,1,0,11,1,OTC
4653,12-02-2021 22:00,24 hrs.,pennystocks,RSSV,266,260,6,254,3,94,66,3,OTC
4653,12-02-2021 22:00,24 hrs.,pennystocks,RTON,124,13,111,-98,4,36,36,4,OTC
4653,12-02-2021 22:00,24 hrs.,pennystocks,SCIE,359,6,353,-347,2,153,45,2,OTC
4653,12-02-2021 22:00,24 hrs.,pennystocks,SFOR,20,14,6,8,2,1,10,2,OTC
4653,12-02-2021 22:00,24 hrs.,pennystocks,SGMD,362,310,52,258,11,110,98,11,OTC
4653,12-02-2021 22:00,24 hrs.,pennystocks,SGSI,25,0,25,-25,3,5,3,2,OTC
4653,12-02-2021 22:00,24 hrs.,pennystocks,SHMP,12,6,6,0,2,2,0,2,OTC
4653,12-02-2021 22:00,24 hrs.,pennystocks,SHWZ,7,7,0,7,1,1,1,1,OTC
4653,12-02-2021 22:00,24 hrs.,pennystocks,SILO,20,0,20,-20,1,5,6,1,OTC
4653,12-02-2021 22:00,24 hrs.,pennystocks,SIML,97,97,0,97,2,27,35,2,OTC
4653,12-02-2021 22:00,24 hrs.,pennystocks,SING,67,67,0,67,3,5,45,3,OTC
4653,12-02-2021 22:00,24 hrs.,pennystocks,SNPW,399,34,365,-331,5,149,81,5,OTC
4653,12-02-2021 22:00,24 hrs.,pennystocks,SNRS,14,14,0,14,2,2,2,2,OTC
4653,12-02-2021 22:00,24 hrs.,pennystocks,SNWV,12,12,0,12,2,2,0,1,OTC
4653,12-02-2021 22:00,24 hrs.,pennystocks,SNYR,6,6,0,6,1,1,0,1,OTC
4653,12-02-2021 22:00,24 hrs.,pennystocks,SRMX,243,62,181,-119,8,54,103,7,OTC
4653,12-02-2021 22:00,24 hrs.,pennystocks,SRNA,6,6,0,6,1,1,0,1,OTC
4653,12-02-2021 22:00,24 hrs.,pennystocks,SSFT,14,14,0,14,1,0,10,1,OTC
4653,12-02-2021 22:00,24 hrs.,pennystocks,SSOK,14,14,0,14,1,0,10,1,OTC
4653,12-02-2021 22:00,24 hrs.,pennystocks,STEV,28,12,16,-4,2,8,4,2,OTC
4653,12-02-2021 22:00,24 hrs.,pennystocks,SUIC,7,0,7,-7,1,1,1,1,OTC
4653,12-02-2021 22:00,24 hrs.,pennystocks,TCHH,7,7,0,7,1,1,1,1,OTC
4653,12-02-2021 22:00,24 hrs.,pennystocks,TFZI,6,0,6,-6,1,1,0,1,OTC
4653,12-02-2021 22:00,24 hrs.,pennystocks,TGHI,11,11,0,11,1,2,3,1,OTC
4653,12-02-2021 22:00,24 hrs.,pennystocks,TLGN,63,63,0,63,3,15,21,2,OTC
4653,12-02-2021 22:00,24 hrs.,pennystocks,TLSS,244,86,158,-72,3,59,114,3,OTC
4653,12-02-2021 22:00,24 hrs.,pennystocks,TPAC,624,618,6,612,2,271,74,2,OTC
4653,12-02-2021 22:00,24 hrs.,pennystocks,TREP,6,0,6,-6,1,1,0,1,OTC
4653,12-02-2021 22:00,24 hrs.,pennystocks,TSNP,51,45,6,39,4,3,29,4,OTC
4653,12-02-2021 22:00,24 hrs.,pennystocks,TSTS,12,0,12,-12,2,2,0,1,OTC
4653,12-02-2021 22:00,24 hrs.,pennystocks,UATG,12,0,12,-12,2,2,0,2,OTC
4653,12-02-2021 22:00,24 hrs.,pennystocks,USMJ,41,41,0,41,2,9,15,2,OTC
4653,12-02-2021 22:00,24 hrs.,pennystocks,USRM,6,0,6,-6,1,1,0,1,OTC
4653,12-02-2021 22:00,24 hrs.,pennystocks,UVSE,7,0,7,-7,1,1,1,1,OTC
4653,12-02-2021 22:00,24 hrs.,pennystocks,VFRM,6,6,0,6,1,1,0,1,OTC
4653,12-02-2021 22:00,24 hrs.,pennystocks,VPLM,6,6,0,6,1,1,0,1,OTC
4653,12-02-2021 22:00,24 hrs.,pennystocks,VTLR,6,6,0,6,1,1,0,1,OTC
4653,12-02-2021 22:00,24 hrs.,pennystocks,WCVC,91,91,0,91,1,26,35,1,OTC
4653,12-02-2021 22:00,24 hrs.,RobinHoodPennyStocks,CCIV,39,39,0,39,1,10,15,1,NYSE
4653,12-02-2021 22:00,24 hrs.,RobinHoodPennyStocks,CEIX,111,0,111,-111,1,40,27,1,NYSE
4653,12-02-2021 22:00,24 hrs.,RobinHoodPennyStocks,CMCM,111,0,111,-111,1,40,27,1,NYSE
4653,12-02-2021 22:00,24 hrs.,RobinHoodPennyStocks,FUBO,117,0,117,-117,2,41,27,2,NYSE
4653,12-02-2021 22:00,24 hrs.,RobinHoodPennyStocks,LAIX,111,0,111,-111,1,40,27,1,NYSE
4653,12-02-2021 22:00,24 hrs.,RobinHoodPennyStocks,PLTR,6,6,0,6,1,1,0,1,NYSE
4653,12-02-2021 22:00,24 hrs.,RobinHoodPennyStocks,RLGY,111,0,111,-111,1,40,27,1,NYSE
4653,12-02-2021 22:00,24 hrs.,RobinHoodPennyStocks,XPEV,111,0,111,-111,1,40,27,1,NYSE
4653,12-02-2021 22:00,24 hrs.,RobinHoodPennyStocks,AIH,111,0,111,-111,1,40,27,1,NASDAQ
4653,12-02-2021 22:00,24 hrs.,RobinHoodPennyStocks,BBI,6,6,0,6,1,1,0,1,NASDAQ
4653,12-02-2021 22:00,24 hrs.,pennystocks,ALLIF,124,0,124,-124,1,36,48,1,OTC
4653,12-02-2021 22:00,24 hrs.,pennystocks,ARBKF,175,46,129,-83,3,40,83,3,OTC
4653,12-02-2021 22:00,24 hrs.,pennystocks,BDRBF,6,6,0,6,1,1,0,1,OTC
4653,12-02-2021 22:00,24 hrs.,pennystocks,BKLLF,80,80,0,80,1,25,26,1,OTC
4653,12-02-2021 22:00,24 hrs.,pennystocks,BNCHF,6,6,0,6,1,1,0,1,OTC
4653,12-02-2021 22:00,24 hrs.,pennystocks,BRPHF,40,40,0,40,1,6,24,1,OTC
4653,12-02-2021 22:00,24 hrs.,pennystocks,BVNNF,7,7,0,7,1,1,1,1,OTC
4653,12-02-2021 22:00,24 hrs.,pennystocks,CANSF,5,5,0,5,1,0,1,1,OTC
4653,12-02-2021 22:00,24 hrs.,pennystocks,CBULF,6,6,0,6,1,1,0,1,OTC
4653,12-02-2021 22:00,24 hrs.,pennystocks,CBWTF,19,13,6,7,3,3,1,3,OTC
4653,12-02-2021 22:00,24 hrs.,pennystocks,CIOXY,7,7,0,7,1,1,1,1,OTC
4653,12-02-2021 22:00,24 hrs.,pennystocks,CLUBQ,6,6,0,6,1,1,0,1,OTC
4653,12-02-2021 22:00,24 hrs.,pennystocks,COCSF,6,0,6,-6,1,1,0,1,OTC
4653,12-02-2021 22:00,24 hrs.,pennystocks,CPHRF,35,0,35,-35,1,10,11,1,OTC
4653,12-02-2021 22:00,24 hrs.,pennystocks,CRLBF,21,21,0,21,1,1,15,1,OTC
4653,12-02-2021 22:00,24 hrs.,pennystocks,CWGYF,6,6,0,6,1,1,0,1,OTC
4653,12-02-2021 22:00,24 hrs.,pennystocks,CWSFF,6,6,0,6,1,1,0,1,OTC
4653,12-02-2021 22:00,24 hrs.,RobinHoodPennyStocks,CTRM,900,397,503,-106,15,245,350,15,NASDAQ
4653,12-02-2021 22:00,24 hrs.,RobinHoodPennyStocks,DFFN,601,595,6,589,8,219,131,7,NASDAQ
4653,12-02-2021 22:00,24 hrs.,RobinHoodPennyStocks,EAST,56,0,56,-56,1,18,16,1,NASDAQ
4653,12-02-2021 22:00,24 hrs.,RobinHoodPennyStocks,ENTX,59,59,0,59,1,23,9,1,NASDAQ
4653,12-02-2021 22:00,24 hrs.,RobinHoodPennyStocks,EQOS,111,0,111,-111,1,40,27,1,NASDAQ
4653,12-02-2021 22:00,24 hrs.,RobinHoodPennyStocks,FCEL,158,47,111,-64,2,48,54,2,NASDAQ
4653,12-02-2021 22:00,24 hrs.,RobinHoodPennyStocks,GLBS,6,6,0,6,1,1,0,1,NASDAQ
4653,12-02-2021 22:00,24 hrs.,RobinHoodPennyStocks,GLMD,273,0,273,-273,1,55,159,1,NASDAQ
4653,12-02-2021 22:00,24 hrs.,RobinHoodPennyStocks,GMDA,6,0,6,-6,1,1,0,1,NASDAQ
4653,12-02-2021 22:00,24 hrs.,RobinHoodPennyStocks,GRIL,111,0,111,-111,1,40,27,1,NASDAQ
4653,12-02-2021 22:00,24 hrs.,RobinHoodPennyStocks,HCDI,111,0,111,-111,1,40,27,1,NASDAQ
4653,12-02-2021 22:00,24 hrs.,RobinHoodPennyStocks,HGSH,111,0,111,-111,1,40,27,1,NASDAQ
4653,12-02-2021 22:00,24 hrs.,RobinHoodPennyStocks,IDEX,124,13,111,-98,2,42,32,2,NASDAQ
4653,12-02-2021 22:00,24 hrs.,RobinHoodPennyStocks,IFMK,111,0,111,-111,1,40,27,1,NASDAQ
4653,12-02-2021 22:00,24 hrs.,RobinHoodPennyStocks,IMTE,111,0,111,-111,1,40,27,1,NASDAQ
4653,12-02-2021 22:00,24 hrs.,RobinHoodPennyStocks,ITRM,6,6,0,6,1,1,0,1,NASDAQ
4653,12-02-2021 22:00,24 hrs.,RobinHoodPennyStocks,IZEA,111,0,111,-111,1,40,27,1,NASDAQ
4653,12-02-2021 22:00,24 hrs.,RobinHoodPennyStocks,JFIN,111,0,111,-111,1,40,27,1,NASDAQ
4653,12-02-2021 22:00,24 hrs.,RobinHoodPennyStocks,JRJC,111,0,111,-111,1,40,27,1,NASDAQ
4653,12-02-2021 22:00,24 hrs.,RobinHoodPennyStocks,KNDI,111,0,111,-111,1,40,27,1,NASDAQ
4653,12-02-2021 22:00,24 hrs.,RobinHoodPennyStocks,KTRA,53,0,53,-53,2,19,7,2,NASDAQ
4653,12-02-2021 22:00,24 hrs.,RobinHoodPennyStocks,KXIN,111,0,111,-111,1,40,27,1,NASDAQ
4653,12-02-2021 22:00,24 hrs.,RobinHoodPennyStocks,LEDS,111,0,111,-111,1,40,27,1,NASDAQ
4653,12-02-2021 22:00,24 hrs.,RobinHoodPennyStocks,LKCO,97,91,6,85,9,24,13,9,NASDAQ
4653,12-02-2021 22:00,24 hrs.,RobinHoodPennyStocks,LLNW,45,0,45,-45,1,13,15,1,NASDAQ
4653,12-02-2021 22:00,24 hrs.,RobinHoodPennyStocks,LMFA,111,0,111,-111,1,40,27,1,NASDAQ
4653,12-02-2021 22:00,24 hrs.,RobinHoodPennyStocks,LXEH,111,0,111,-111,1,40,27,1,NASDAQ
4653,12-02-2021 22:00,24 hrs.,RobinHoodPennyStocks,MARA,111,0,111,-111,1,40,27,1,NASDAQ
4653,12-02-2021 22:00,24 hrs.,RobinHoodPennyStocks,METX,111,0,111,-111,1,40,27,1,NASDAQ
4653,12-02-2021 22:00,24 hrs.,RobinHoodPennyStocks,MMLP,6,6,0,6,1,1,0,1,NASDAQ
4653,12-02-2021 22:00,24 hrs.,RobinHoodPennyStocks,MOGO,111,0,111,-111,1,40,27,1,NASDAQ
4653,12-02-2021 22:00,24 hrs.,RobinHoodPennyStocks,MOMO,111,0,111,-111,1,40,27,1,NASDAQ
4653,12-02-2021 22:00,24 hrs.,RobinHoodPennyStocks,MOSY,111,0,111,-111,1,40,27,1,NASDAQ
4653,12-02-2021 22:00,24 hrs.,RobinHoodPennyStocks,MOXC,111,0,111,-111,1,40,27,1,NASDAQ
4653,12-02-2021 22:00,24 hrs.,RobinHoodPennyStocks,MVIS,111,0,111,-111,1,40,27,1,NASDAQ
4653,12-02-2021 22:00,24 hrs.,RobinHoodPennyStocks,NAKD,129,12,117,-105,4,43,27,4,NASDAQ
4653,12-02-2021 22:00,24 hrs.,RobinHoodPennyStocks,NCTY,111,0,111,-111,1,40,27,1,NASDAQ
4653,12-02-2021 22:00,24 hrs.,RobinHoodPennyStocks,CSCW,111,0,111,-111,1,40,27,1,NASDAQ
4653,12-02-2021 22:00,24 hrs.,pennystocks,NOVC,53,53,0,53,2,16,13,2,OTC
4653,12-02-2021 22:00,24 hrs.,pennystocks,NSAV,13,13,0,13,2,2,1,2,OTC
4653,12-02-2021 22:00,24 hrs.,pennystocks,NSEO,6,0,6,-6,1,1,0,1,OTC
4653,12-02-2021 22:00,24 hrs.,pennystocks,NSPT,6,6,0,6,1,1,0,1,OTC
4653,12-02-2021 22:00,24 hrs.,pennystocks,OZSC,194,0,194,-194,3,44,94,3,OTC
4653,12-02-2021 22:00,24 hrs.,pennystocks,PAOG,7,7,0,7,1,1,1,1,OTC
4653,12-02-2021 22:00,24 hrs.,pennystocks,PASO,72,0,72,-72,2,18,28,2,OTC
4653,12-02-2021 22:00,24 hrs.,pennystocks,PDXP,7,7,0,7,1,1,1,1,OTC
4653,12-02-2021 22:00,24 hrs.,pennystocks,PHIL,6,6,0,6,1,1,0,1,OTC
4653,12-02-2021 22:00,24 hrs.,RobinHoodPennyStocks,PECK,111,0,111,-111,1,40,27,1,NASDAQ
4653,12-02-2021 22:00,24 hrs.,RobinHoodPennyStocks,PEIX,111,0,111,-111,1,40,27,1,NASDAQ
4653,12-02-2021 22:00,24 hrs.,RobinHoodPennyStocks,PETZ,111,0,111,-111,1,40,27,1,NASDAQ
4653,12-02-2021 22:00,24 hrs.,RobinHoodPennyStocks,PHUN,111,0,111,-111,1,40,27,1,NASDAQ
4653,12-02-2021 22:00,24 hrs.,RobinHoodPennyStocks,PIXY,111,0,111,-111,1,40,27,1,NASDAQ
4653,12-02-2021 22:00,24 hrs.,RobinHoodPennyStocks,PLIN,111,0,111,-111,1,40,27,1,NASDAQ
4653,12-02-2021 22:00,24 hrs.,RobinHoodPennyStocks,PLUG,111,0,111,-111,1,40,27,1,NASDAQ
4653,12-02-2021 22:00,24 hrs.,RobinHoodPennyStocks,PSEC,51,51,0,51,3,11,17,2,NASDAQ
4653,12-02-2021 22:00,24 hrs.,RobinHoodPennyStocks,PSTV,155,155,0,155,1,63,25,1,NASDAQ
4653,12-02-2021 22:00,24 hrs.,RobinHoodPennyStocks,PXLW,6,0,6,-6,1,1,0,1,NASDAQ
4653,12-02-2021 22:00,24 hrs.,RobinHoodPennyStocks,QUIK,111,0,111,-111,1,40,27,1,NASDAQ
4653,12-02-2021 22:00,24 hrs.,RobinHoodPennyStocks,RAVE,111,0,111,-111,1,40,27,1,NASDAQ
4653,12-02-2021 22:00,24 hrs.,RobinHoodPennyStocks,RCMT,111,0,111,-111,1,40,27,1,NASDAQ
4653,12-02-2021 22:00,24 hrs.,RobinHoodPennyStocks,REAL,79,0,79,-79,1,27,21,1,NASDAQ
4653,12-02-2021 22:00,24 hrs.,RobinHoodPennyStocks,RIOT,118,7,111,-104,2,40,30,2,NASDAQ
4653,12-02-2021 22:00,24 hrs.,RobinHoodPennyStocks,SALM,111,0,111,-111,1,40,27,1,NASDAQ
4653,12-02-2021 22:00,24 hrs.,RobinHoodPennyStocks,SAVA,111,0,111,-111,1,40,27,1,NASDAQ
4653,12-02-2021 22:00,24 hrs.,RobinHoodPennyStocks,SEED,111,0,111,-111,1,40,27,1,NASDAQ
4653,12-02-2021 22:00,24 hrs.,RobinHoodPennyStocks,SGOC,111,0,111,-111,1,40,27,1,NASDAQ
4653,12-02-2021 22:00,24 hrs.,RobinHoodPennyStocks,SHIP,54,48,6,42,9,9,0,6,NASDAQ
4653,12-02-2021 22:00,24 hrs.,RobinHoodPennyStocks,SNDL,1382,1231,151,1080,32,473,308,28,NASDAQ
4653,12-02-2021 22:00,24 hrs.,RobinHoodPennyStocks,SNGX,218,162,56,106,3,88,30,2,NASDAQ
4653,12-02-2021 22:00,24 hrs.,RobinHoodPennyStocks,SRAX,6,6,0,6,1,1,0,1,NASDAQ
4653,12-02-2021 22:00,24 hrs.,RobinHoodPennyStocks,SRGA,6,6,0,6,1,1,0,1,NASDAQ
4653,12-02-2021 22:00,24 hrs.,RobinHoodPennyStocks,SUNW,111,0,111,-111,1,40,27,1,NASDAQ
4653,12-02-2021 22:00,24 hrs.,RobinHoodPennyStocks,SXTC,111,0,111,-111,1,40,27,1,NASDAQ
4653,12-02-2021 22:00,24 hrs.,RobinHoodPennyStocks,SYPR,111,0,111,-111,1,40,27,1,NASDAQ
4653,12-02-2021 22:00,24 hrs.,RobinHoodPennyStocks,TAIT,111,0,111,-111,1,40,27,1,NASDAQ
4653,12-02-2021 22:00,24 hrs.,pennystocks,CXXIF,6,0,6,-6,1,1,0,1,OTC
4653,12-02-2021 22:00,24 hrs.,pennystocks,DFLYF,46,0,46,-46,1,16,10,1,OTC
4653,12-02-2021 22:00,24 hrs.,pennystocks,DFODQ,21,21,0,21,1,4,9,1,OTC
4653,12-02-2021 22:00,24 hrs.,pennystocks,DMGGF,40,40,0,40,1,6,24,1,OTC
4653,12-02-2021 22:00,24 hrs.,pennystocks,EHVVF,14,14,0,14,1,0,10,1,OTC
4653,12-02-2021 22:00,24 hrs.,pennystocks,ELRRF,12,12,0,12,2,2,0,2,OTC
4653,12-02-2021 22:00,24 hrs.,pennystocks,EMHTF,6,6,0,6,1,1,0,1,OTC
4653,12-02-2021 22:00,24 hrs.,pennystocks,EVKIF,31,31,0,31,1,9,9,1,OTC
4653,12-02-2021 22:00,24 hrs.,pennystocks,FIORF,8,0,8,-8,1,1,2,1,OTC
4653,12-02-2021 22:00,24 hrs.,pennystocks,FLWPF,28,28,0,28,1,7,10,1,OTC
4653,12-02-2021 22:00,24 hrs.,pennystocks,FUNFF,12,12,0,12,1,3,2,1,OTC
4653,12-02-2021 22:00,24 hrs.,pennystocks,GCPEF,23,0,23,-23,1,6,7,1,OTC
4653,12-02-2021 22:00,24 hrs.,pennystocks,GLDFF,12,6,6,0,2,2,0,2,OTC
4653,12-02-2021 22:00,24 hrs.,pennystocks,GUESF,7,0,7,-7,1,1,1,1,OTC
4653,12-02-2021 22:00,24 hrs.,pennystocks,HITIF,1430,1349,81,1268,14,487,400,13,OTC
4653,12-02-2021 22:00,24 hrs.,pennystocks,HRVSF,6,6,0,6,1,1,0,1,OTC
4653,12-02-2021 22:00,24 hrs.,pennystocks,IDXAF,6,6,0,6,1,1,0,1,OTC
4653,12-02-2021 22:00,24 hrs.,pennystocks,INTEQ,6,6,0,6,1,1,0,1,OTC
4653,12-02-2021 22:00,24 hrs.,pennystocks,KCCFF,25,25,0,25,1,9,3,1,OTC
4653,12-02-2021 22:00,24 hrs.,pennystocks,LLKKF,30,24,6,18,5,5,0,2,OTC
4653,12-02-2021 22:00,24 hrs.,pennystocks,LXXGF,88,88,0,88,1,18,48,1,OTC
4653,12-02-2021 22:00,24 hrs.,pennystocks,MEDIF,6,6,0,6,1,1,0,1,OTC
4653,12-02-2021 22:00,24 hrs.,pennystocks,MMEDF,8,8,0,8,1,2,0,1,OTC
4653,12-02-2021 22:00,24 hrs.,pennystocks,MMNFF,56,0,56,-56,2,22,4,2,OTC
4653,12-02-2021 22:00,24 hrs.,pennystocks,MNXXF,50,50,0,50,3,8,22,3,OTC
4653,12-02-2021 22:00,24 hrs.,pennystocks,NMGRF,124,6,118,-112,3,40,32,3,OTC
4653,12-02-2021 22:00,24 hrs.,pennystocks,WDLF,177,0,177,-177,4,36,89,4,OTC
4653,12-02-2021 22:00,24 hrs.,pennystocks,WHEN,7,0,7,-7,1,1,1,1,OTC
4653,12-02-2021 22:00,24 hrs.,pennystocks,WIZD,18,18,0,18,1,5,4,1,OTC
4653,12-02-2021 22:00,24 hrs.,pennystocks,WTII,37,37,0,37,1,11,11,1,OTC
4653,12-02-2021 22:00,24 hrs.,pennystocks,XMET,14,6,8,-2,2,1,4,2,OTC
4653,12-02-2021 22:00,24 hrs.,pennystocks,XTRM,6,0,6,-6,1,1,0,1,OTC
4653,12-02-2021 22:00,24 hrs.,pennystocks,ZHUD,8,8,0,8,1,1,2,1,OTC
4653,12-02-2021 22:00,24 hrs.,pennystocks,ZPAS,6,0,6,-6,1,1,0,1,OTC
4653,12-02-2021 22:00,24 hrs.,pennystocks,ABEPF,77,0,77,-77,3,19,27,3,OTC
4653,12-02-2021 22:00,24 hrs.,pennystocks,AGGHF,23,23,0,23,1,6,7,1,OTC
4653,12-02-2021 22:00,24 hrs.,pennystocks,RAZFF,7,7,0,7,1,1,1,1,OTC
4653,12-02-2021 22:00,24 hrs.,pennystocks,RHDGF,9,9,0,9,1,1,3,1,OTC
4653,12-02-2021 22:00,24 hrs.,pennystocks,RLFTF,6,6,0,6,1,1,0,1,OTC
4653,12-02-2021 22:00,24 hrs.,pennystocks,RLLCF,62,62,0,62,8,9,12,7,OTC
4653,12-02-2021 22:00,24 hrs.,pennystocks,RVVTF,7,7,0,7,1,1,1,1,OTC
4653,12-02-2021 22:00,24 hrs.,pennystocks,RYCEY,6,0,6,-6,1,1,0,1,OTC
4653,12-02-2021 22:00,24 hrs.,pennystocks,SBSAA,5,0,5,-5,1,0,1,1,OTC
4653,12-02-2021 22:00,24 hrs.,pennystocks,SNNAF,9,9,0,9,1,2,1,1,OTC
4653,12-02-2021 22:00,24 hrs.,pennystocks,SPFYF,9,9,0,9,1,1,3,1,OTC
4653,12-02-2021 22:00,24 hrs.,pennystocks,SPMTF,18,18,0,18,1,2,10,1,OTC
4653,12-02-2021 22:00,24 hrs.,pennystocks,SPRWF,2255,63,2192,-2129,13,962,279,12,OTC
4653,12-02-2021 22:00,24 hrs.,pennystocks,TAKOF,29,23,6,17,2,7,7,2,OTC
4653,12-02-2021 22:00,24 hrs.,pennystocks,TFECF,4,0,4,-4,1,0,0,1,OTC
4653,12-02-2021 22:00,24 hrs.,pennystocks,TFECY,4,0,4,-4,1,0,0,1,OTC
4653,12-02-2021 22:00,24 hrs.,pennystocks,TLOFF,12,0,12,-12,2,2,0,1,OTC
4653,12-02-2021 22:00,24 hrs.,pennystocks,TSCRF,102,69,33,36,4,28,30,4,OTC
4653,12-02-2021 22:00,24 hrs.,pennystocks,TSKFF,46,0,46,-46,1,16,10,1,OTC
4653,12-02-2021 22:00,24 hrs.,pennystocks,TTTSF,6,0,6,-6,1,1,0,1,OTC
4653,12-02-2021 22:00,24 hrs.,pennystocks,VRNDF,20,20,0,20,1,6,4,1,OTC
4653,12-02-2021 22:00,24 hrs.,pennystocks,XELAW,197,197,0,197,1,89,15,1,OTC
4653,12-02-2021 22:00,24 hrs.,pennystocks,ZBISF,45,45,0,45,1,16,9,1,OTC
4653,12-02-2021 22:00,24 hrs.,pennystocks,AIM,8,8,0,8,1,1,2,1,AMEX
4653,12-02-2021 22:00,24 hrs.,pennystocks,CTO,38,0,38,-38,4,3,16,1,AMEX
4653,12-02-2021 22:00,24 hrs.,pennystocks,DNN,430,37,393,-356,9,134,126,9,AMEX
4653,12-02-2021 22:00,24 hrs.,pennystocks,DPW,6,0,6,-6,1,1,0,1,AMEX
4653,12-02-2021 22:00,24 hrs.,pennystocks,DSS,28,28,0,28,1,8,8,1,AMEX
4653,12-02-2021 22:00,24 hrs.,pennystocks,GPL,35,0,35,-35,1,13,5,1,AMEX
4653,12-02-2021 22:00,24 hrs.,pennystocks,GTE,13,6,7,-1,2,2,1,2,AMEX
4653,12-02-2021 22:00,24 hrs.,pennystocks,ITP,31,12,19,-7,2,3,17,2,AMEX
4653,12-02-2021 22:00,24 hrs.,pennystocks,MCF,6,6,0,6,1,1,0,1,AMEX
4653,12-02-2021 22:00,24 hrs.,pennystocks,MXC,7,7,0,7,1,1,1,1,AMEX
4653,12-02-2021 22:00,24 hrs.,pennystocks,NAK,39,33,6,27,2,8,15,2,AMEX
4653,12-02-2021 22:00,24 hrs.,pennystocks,PTN,26,26,0,26,1,8,6,1,AMEX
4653,12-02-2021 22:00,24 hrs.,pennystocks,TGB,29,29,0,29,1,10,5,1,AMEX
4653,12-02-2021 22:00,24 hrs.,pennystocks,TGC,50,0,50,-50,1,21,4,1,AMEX
4653,12-02-2021 22:00,24 hrs.,pennystocks,TRX,22,8,14,-6,3,3,4,3,AMEX
4653,12-02-2021 22:00,24 hrs.,pennystocks,ZOM,181,13,168,-155,6,62,33,6,AMEX
4653,12-02-2021 22:00,24 hrs.,pennystocks,IBIO,10,10,0,10,1,2,2,1,AMEX
4653,12-02-2021 22:00,24 hrs.,pennystocks,INUV,63,63,0,63,1,22,15,1,AMEX
4653,12-02-2021 22:00,24 hrs.,pennystocks,NSPR,20,20,0,20,1,6,4,1,AMEX
4653,12-02-2021 22:00,24 hrs.,pennystocks,SDPI,6,6,0,6,1,1,0,1,AMEX
4653,12-02-2021 22:00,24 hrs.,pennystocks,SENS,73,32,41,-9,4,21,15,4,AMEX
4653,12-02-2021 22:00,24 hrs.,pennystocks,TMBR,50,0,50,-50,1,21,4,1,AMEX
4653,12-02-2021 22:00,24 hrs.,pennystocks,TRXC,12,12,0,12,2,2,0,2,AMEX
4653,12-02-2021 22:00,24 hrs.,pennystocks,UAVS,107,107,0,107,1,36,31,1,AMEX
4653,12-02-2021 22:00,24 hrs.,pennystocks,XXII,6,6,0,6,1,0,2,1,AMEX
4653,12-02-2021 22:00,24 hrs.,pennystocks,ACB,9,9,0,9,1,2,1,1,NYSE
4653,12-02-2021 22:00,24 hrs.,pennystocks,AHT,6,6,0,6,1,1,0,1,NYSE
4653,12-02-2021 22:00,24 hrs.,pennystocks,AMC,82,82,0,82,5,14,34,5,NYSE
4653,12-02-2021 22:00,24 hrs.,pennystocks,ASX,24,24,0,24,4,4,0,2,NYSE
4653,12-02-2021 22:00,24 hrs.,pennystocks,ATH,12,12,0,12,1,3,2,1,NYSE
4653,12-02-2021 22:00,24 hrs.,pennystocks,BIO,319,0,319,-319,1,133,49,1,NYSE
4653,12-02-2021 22:00,24 hrs.,pennystocks,BTU,6,6,0,6,1,1,0,1,NYSE
4653,12-02-2021 22:00,24 hrs.,RobinHoodPennyStocks,TANH,111,0,111,-111,1,40,27,1,NASDAQ
4653,12-02-2021 22:00,24 hrs.,RobinHoodPennyStocks,NMTR,71,71,0,71,1,26,15,1,NASDAQ
4653,12-02-2021 22:00,24 hrs.,RobinHoodPennyStocks,NOVN,177,45,132,-87,5,59,39,4,NASDAQ
4653,12-02-2021 22:00,24 hrs.,RobinHoodPennyStocks,NVCN,62,56,6,50,3,13,24,3,NASDAQ
4653,12-02-2021 22:00,24 hrs.,RobinHoodPennyStocks,NVIV,12,0,12,-12,1,2,4,1,NASDAQ
4653,12-02-2021 22:00,24 hrs.,RobinHoodPennyStocks,NXTD,111,0,111,-111,1,40,27,1,NASDAQ
4653,12-02-2021 22:00,24 hrs.,RobinHoodPennyStocks,OCGN,45,39,6,33,2,11,15,2,NASDAQ
4653,12-02-2021 22:00,24 hrs.,RobinHoodPennyStocks,ONTX,6,0,6,-6,1,1,0,1,NASDAQ
4653,12-02-2021 22:00,24 hrs.,RobinHoodPennyStocks,OPGN,36,30,6,24,6,6,0,2,NASDAQ
4653,12-02-2021 22:00,24 hrs.,RobinHoodPennyStocks,OPTT,117,6,111,-105,2,41,27,2,NASDAQ
4653,12-02-2021 22:00,24 hrs.,RobinHoodPennyStocks,OVID,6,6,0,6,1,1,0,1,NASDAQ
4653,12-02-2021 22:00,24 hrs.,RobinHoodPennyStocks,UONE,111,0,111,-111,1,40,27,1,NASDAQ
4653,12-02-2021 22:00,24 hrs.,RobinHoodPennyStocks,USEG,111,0,111,-111,1,40,27,1,NASDAQ
4653,12-02-2021 22:00,24 hrs.,RobinHoodPennyStocks,UXIN,111,0,111,-111,1,40,27,1,NASDAQ
4653,12-02-2021 22:00,24 hrs.,RobinHoodPennyStocks,WATT,111,0,111,-111,1,40,27,1,NASDAQ
4653,12-02-2021 22:00,24 hrs.,RobinHoodPennyStocks,WIMI,111,0,111,-111,1,40,27,1,NASDAQ
4653,12-02-2021 22:00,24 hrs.,RobinHoodPennyStocks,WKEY,111,0,111,-111,1,40,27,1,NASDAQ
4653,12-02-2021 22:00,24 hrs.,RobinHoodPennyStocks,WRAP,111,0,111,-111,1,40,27,1,NASDAQ
4653,12-02-2021 22:00,24 hrs.,RobinHoodPennyStocks,XSPA,23,23,0,23,1,9,1,1,NASDAQ
4653,12-02-2021 22:00,24 hrs.,RobinHoodPennyStocks,YGMZ,111,0,111,-111,1,40,27,1,NASDAQ
4653,12-02-2021 22:00,24 hrs.,RobinHoodPennyStocks,ZSAN,611,555,56,499,4,256,83,4,NASDAQ
4653,12-02-2021 22:00,24 hrs.,RobinHoodPennyStocks,UONEK,111,0,111,-111,1,40,27,1,NASDAQ
4653,12-02-2021 22:00,24 hrs.,pennystocks,CBD,76,10,66,-56,4,21,18,4,NYSE
4653,12-02-2021 22:00,24 hrs.,pennystocks,CHS,31,31,0,31,1,9,9,1,NYSE
4653,12-02-2021 22:00,24 hrs.,pennystocks,CLI,40,40,0,40,1,11,14,1,NYSE
4653,12-02-2021 22:00,24 hrs.,pennystocks,CMD,40,40,0,40,1,11,14,1,NYSE
4653,12-02-2021 22:00,24 hrs.,pennystocks,CMO,35,0,35,-35,1,10,11,1,NYSE
4653,12-02-2021 22:00,24 hrs.,pennystocks,CTK,50,0,50,-50,1,21,4,1,NYSE
4653,12-02-2021 22:00,24 hrs.,pennystocks,CVE,35,18,17,1,4,8,3,2,NYSE
4653,12-02-2021 22:00,24 hrs.,pennystocks,CVX,35,35,0,35,1,12,7,1,NYSE
4653,12-02-2021 22:00,24 hrs.,pennystocks,ESE,9,9,0,9,1,1,3,1,NYSE
4653,12-02-2021 22:00,24 hrs.,pennystocks,ETH,6,6,0,6,1,1,0,1,NYSE
4653,12-02-2021 22:00,24 hrs.,pennystocks,FLT,29,23,6,17,2,7,7,2,NYSE
4653,12-02-2021 22:00,24 hrs.,pennystocks,GME,24,12,12,0,4,4,0,4,NYSE
4653,12-02-2021 22:00,24 hrs.,pennystocks,IRR,25,25,0,25,1,9,3,1,NYSE
4653,12-02-2021 22:00,24 hrs.,pennystocks,MDC,15,15,0,15,1,4,3,1,NYSE
4653,12-02-2021 22:00,24 hrs.,pennystocks,NAT,7,7,0,7,1,1,1,1,NYSE
4653,12-02-2021 22:00,24 hrs.,pennystocks,NOK,6,6,0,6,1,1,0,1,NYSE
4653,12-02-2021 22:00,24 hrs.,pennystocks,NPV,25,25,0,25,1,9,3,1,NYSE
4653,12-02-2021 22:00,24 hrs.,pennystocks,PSA,7,0,7,-7,1,1,1,1,NYSE
4653,12-02-2021 22:00,24 hrs.,pennystocks,RKT,80,80,0,80,1,25,26,1,NYSE
4653,12-02-2021 22:00,24 hrs.,pennystocks,RSI,119,98,21,77,2,46,19,2,NYSE
4653,12-02-2021 22:00,24 hrs.,pennystocks,SOS,51,45,6,39,4,8,19,4,NYSE
4653,12-02-2021 22:00,24 hrs.,pennystocks,SUM,98,98,0,98,1,40,14,1,NYSE
4653,12-02-2021 22:00,24 hrs.,pennystocks,TGS,9,9,0,9,1,1,3,1,NYSE
4653,12-02-2021 22:00,24 hrs.,pennystocks,TSM,38,38,0,38,1,12,10,1,NYSE
4653,12-02-2021 22:00,24 hrs.,pennystocks,VST,9,9,0,9,1,1,3,1,NYSE
4653,12-02-2021 22:00,24 hrs.,pennystocks,WEI,21,21,0,21,1,8,1,1,NYSE
4653,12-02-2021 22:00,24 hrs.,pennystocks,WLL,6,6,0,6,1,1,0,1,NYSE
4653,12-02-2021 22:00,24 hrs.,pennystocks,WWE,7,0,7,-7,1,1,1,1,NYSE
4653,12-02-2021 22:00,24 hrs.,pennystocks,ARGO,40,40,0,40,1,6,24,1,NYSE
4653,12-02-2021 22:00,24 hrs.,pennystocks,CCIV,7,7,0,7,1,1,1,1,NYSE
4653,12-02-2021 22:00,24 hrs.,pennystocks,FINV,11,11,0,11,1,2,3,1,NYSE
4653,12-02-2021 22:00,24 hrs.,pennystocks,HEXO,21,21,0,21,1,1,15,1,NYSE
4653,12-02-2021 22:00,24 hrs.,pennystocks,HYLN,7,0,7,-7,1,1,1,1,NYSE
4653,12-02-2021 22:00,24 hrs.,pennystocks,PUMP,13,13,0,13,2,2,1,1,NYSE
4653,12-02-2021 22:00,24 hrs.,pennystocks,VIST,12,12,0,12,1,2,4,1,NYSE
4653,12-02-2021 22:00,24 hrs.,pennystocks,WELL,509,509,0,509,1,191,123,1,NYSE
4653,12-02-2021 22:00,24 hrs.,pennystocks,AQB,6,0,6,-6,1,1,0,1,NASDAQ
4653,12-02-2021 22:00,24 hrs.,pennystocks,AZN,30,0,30,-30,1,6,14,1,NASDAQ
4653,12-02-2021 22:00,24 hrs.,pennystocks,BBI,49,0,49,-49,1,18,9,1,NASDAQ
4653,12-02-2021 22:00,24 hrs.,pennystocks,CFO,44,9,35,-26,2,11,14,2,NASDAQ
4653,12-02-2021 22:00,24 hrs.,pennystocks,FWP,10,10,0,10,1,0,6,1,NASDAQ
4653,12-02-2021 22:00,24 hrs.,pennystocks,GBT,6,6,0,6,1,1,0,1,NASDAQ
4653,12-02-2021 22:00,24 hrs.,pennystocks,KOD,6,6,0,6,1,1,0,1,NASDAQ
4653,12-02-2021 22:00,24 hrs.,pennystocks,NOSUF,20,20,0,20,1,5,6,1,OTC
4653,12-02-2021 22:00,24 hrs.,pennystocks,NRGOF,7,0,7,-7,1,1,1,1,OTC
4653,12-02-2021 22:00,24 hrs.,pennystocks,NTSFF,6,0,6,-6,1,1,0,1,OTC
4653,12-02-2021 22:00,24 hrs.,pennystocks,NXTTF,18,12,6,6,3,3,0,3,OTC
4653,12-02-2021 22:00,24 hrs.,pennystocks,OILFF,6,6,0,6,1,1,0,1,OTC
4653,12-02-2021 22:00,24 hrs.,pennystocks,PFWIQ,196,91,105,-14,2,59,70,2,OTC
4653,12-02-2021 22:00,24 hrs.,pennystocks,PMNXF,6,6,0,6,1,1,0,1,OTC
4653,12-02-2021 22:00,24 hrs.,pennystocks,PYRNF,6,0,6,-6,1,1,0,1,OTC
4653,12-02-2021 22:00,24 hrs.,pennystocks,QYOUF,6,6,0,6,1,1,0,1,OTC
4653,12-02-2021 22:00,24 hrs.,pennystocks,RACMF,17,0,17,-17,1,5,3,1,OTC
4653,12-02-2021 22:00,24 hrs.,pennystocks,ALRN,18,0,18,-18,1,2,10,1,NASDAQ
4653,12-02-2021 22:00,24 hrs.,pennystocks,AMTX,62,62,0,62,1,20,18,1,NASDAQ
4653,12-02-2021 22:00,24 hrs.,pennystocks,APHA,64,64,0,64,3,20,12,3,NASDAQ
4653,12-02-2021 22:00,24 hrs.,pennystocks,ARTL,49,49,0,49,5,11,7,3,NASDAQ
4653,12-02-2021 22:00,24 hrs.,pennystocks,ASRT,1710,404,1306,-902,15,658,334,9,NASDAQ
4653,12-02-2021 22:00,24 hrs.,pennystocks,ATOS,270,112,158,-46,4,101,52,4,NASDAQ
4653,12-02-2021 22:00,24 hrs.,pennystocks,AZRX,9,0,9,-9,1,1,3,1,NASDAQ
4653,12-02-2021 22:00,24 hrs.,pennystocks,BBIG,6,0,6,-6,1,1,0,1,NASDAQ
4653,12-02-2021 22:00,24 hrs.,pennystocks,BIOL,6,6,0,6,1,1,0,1,NASDAQ
4653,12-02-2021 22:00,24 hrs.,pennystocks,BKEP,16,0,16,-16,1,4,4,1,NASDAQ
4653,12-02-2021 22:00,24 hrs.,pennystocks,BLCM,50,0,50,-50,1,21,4,1,NASDAQ
4653,12-02-2021 22:00,24 hrs.,pennystocks,BNGO,39,39,0,39,3,12,3,3,NASDAQ
4653,12-02-2021 22:00,24 hrs.,pennystocks,CFMS,12,12,0,12,2,2,0,2,NASDAQ
4653,12-02-2021 22:00,24 hrs.,pennystocks,CIDM,95,95,0,95,2,19,49,2,NASDAQ
4653,12-02-2021 22:00,24 hrs.,pennystocks,CJJD,50,0,50,-50,1,21,4,1,NASDAQ
4653,12-02-2021 22:00,24 hrs.,pennystocks,CKPT,89,27,62,-35,6,27,11,5,NASDAQ
4653,12-02-2021 22:00,24 hrs.,pennystocks,CLBS,147,140,7,133,3,52,31,3,NASDAQ
4653,12-02-2021 22:00,24 hrs.,pennystocks,CLEU,7,7,0,7,1,1,1,1,NASDAQ
4653,12-02-2021 22:00,24 hrs.,pennystocks,COCP,37,37,0,37,2,13,3,2,NASDAQ
4653,12-02-2021 22:00,24 hrs.,pennystocks,CPLP,22,22,0,22,2,2,10,1,NASDAQ
4653,12-02-2021 22:00,24 hrs.,pennystocks,CRBP,17,17,0,17,1,6,1,1,NASDAQ
4653,12-02-2021 22:00,24 hrs.,pennystocks,CRWS,6,6,0,6,1,1,0,1,NASDAQ
4653,12-02-2021 22:00,24 hrs.,pennystocks,CSCW,7,7,0,7,1,1,1,1,NASDAQ
4653,12-02-2021 22:00,24 hrs.,pennystocks,CSTR,6,6,0,6,1,1,0,1,NASDAQ
4653,12-02-2021 22:00,24 hrs.,pennystocks,CTHR,18,18,0,18,1,5,4,1,NASDAQ
4653,12-02-2021 22:00,24 hrs.,pennystocks,CTMX,10,10,0,10,1,1,4,1,NASDAQ
4653,12-02-2021 22:00,24 hrs.,pennystocks,CTRM,135,48,87,-39,8,36,31,8,NASDAQ
4653,12-02-2021 22:00,24 hrs.,pennystocks,CTXR,20,20,0,20,1,6,4,1,NASDAQ
4653,12-02-2021 22:00,24 hrs.,pennystocks,CYTH,8,8,0,8,1,1,2,1,NASDAQ
4653,12-02-2021 22:00,24 hrs.,pennystocks,DFFN,196,173,23,150,6,70,32,6,NASDAQ
4653,12-02-2021 22:00,24 hrs.,pennystocks,DYNT,50,0,50,-50,1,21,4,1,NASDAQ
4653,12-02-2021 22:00,24 hrs.,pennystocks,EBON,6,6,0,6,1,1,0,1,NASDAQ
4653,12-02-2021 22:00,24 hrs.,pennystocks,EDIT,197,197,0,197,1,89,15,1,NASDAQ
4653,12-02-2021 22:00,24 hrs.,pennystocks,ENPH,94,0,94,-94,1,18,54,1,NASDAQ
4653,12-02-2021 22:00,24 hrs.,pennystocks,ENTX,28,28,0,28,1,10,4,1,NASDAQ
4653,12-02-2021 22:00,24 hrs.,pennystocks,ENVB,6,6,0,6,1,1,0,1,NASDAQ
4653,12-02-2021 22:00,24 hrs.,pennystocks,EPSN,12,12,0,12,2,2,0,2,NASDAQ
4653,12-02-2021 22:00,24 hrs.,pennystocks,EVFM,6,0,6,-6,1,1,0,1,NASDAQ
4653,12-02-2021 22:00,24 hrs.,pennystocks,FAMI,13,13,0,13,2,2,1,2,NASDAQ
4653,12-02-2021 22:00,24 hrs.,pennystocks,FAST,6,6,0,6,1,1,0,1,NASDAQ
4653,12-02-2021 22:00,24 hrs.,pennystocks,FATE,21,21,0,21,1,8,1,1,NASDAQ
4653,12-02-2021 22:00,24 hrs.,pennystocks,FCEL,94,0,94,-94,1,18,54,1,NASDAQ
4653,12-02-2021 22:00,24 hrs.,pennystocks,GAIN,7,7,0,7,1,1,1,1,NASDAQ
4653,12-02-2021 22:00,24 hrs.,pennystocks,GALT,7,7,0,7,1,1,1,1,NASDAQ
4653,12-02-2021 22:00,24 hrs.,pennystocks,GEVO,67,6,61,-55,4,16,19,3,NASDAQ
4653,12-02-2021 22:00,24 hrs.,pennystocks,GHSI,65,59,6,53,2,27,3,2,NASDAQ
4653,12-02-2021 22:00,24 hrs.,pennystocks,GLBS,23,23,0,23,1,0,19,1,NASDAQ
4653,12-02-2021 22:00,24 hrs.,pennystocks,GOEV,87,87,0,87,2,26,27,2,NASDAQ
4653,12-02-2021 22:00,24 hrs.,pennystocks,GRIL,45,0,45,-45,2,13,11,2,NASDAQ
4653,12-02-2021 22:00,24 hrs.,pennystocks,GRNQ,50,0,50,-50,1,21,4,1,NASDAQ
4653,12-02-2021 22:00,24 hrs.,pennystocks,HALO,6,0,6,-6,1,1,0,1,NASDAQ
4653,12-02-2021 22:00,24 hrs.,pennystocks,HRTX,14,14,0,14,1,2,6,1,NASDAQ
4653,12-02-2021 22:00,24 hrs.,pennystocks,HSTO,12,6,6,0,2,2,0,2,NASDAQ
4653,12-02-2021 22:00,24 hrs.,pennystocks,IFMK,89,0,89,-89,2,33,15,2,NASDAQ
4653,12-02-2021 22:00,24 hrs.,RobinHoodPennyStocks,TAOP,111,0,111,-111,1,40,27,1,NASDAQ
4653,12-02-2021 22:00,24 hrs.,RobinHoodPennyStocks,TBLT,77,77,0,77,1,24,25,1,NASDAQ
4653,12-02-2021 22:00,24 hrs.,RobinHoodPennyStocks,TEDU,111,0,111,-111,1,40,27,1,NASDAQ
4653,12-02-2021 22:00,24 hrs.,RobinHoodPennyStocks,TIGR,111,0,111,-111,1,40,27,1,NASDAQ
4653,12-02-2021 22:00,24 hrs.,RobinHoodPennyStocks,TLRY,6,0,6,-6,1,1,0,1,NASDAQ
4653,12-02-2021 22:00,24 hrs.,RobinHoodPennyStocks,TNXP,304,56,248,-192,4,105,78,4,NASDAQ
4653,12-02-2021 22:00,24 hrs.,RobinHoodPennyStocks,TRCH,166,55,111,-56,3,54,46,3,NASDAQ
4653,12-02-2021 22:00,24 hrs.,RobinHoodPennyStocks,TTOO,34,34,0,34,1,12,6,1,NASDAQ
4653,12-02-2021 22:00,24 hrs.,RobinHoodPennyStocks,TXMD,383,18,365,-347,7,79,197,7,NASDAQ
4653,12-02-2021 22:00,24 hrs.,RobinHoodPennyStocks,TYME,28,0,28,-28,1,5,14,1,NASDAQ
4653,12-02-2021 22:00,24 hrs.,pennystocks,LPTH,62,62,0,62,1,24,10,1,NASDAQ
4653,12-02-2021 22:00,24 hrs.,pennystocks,MARK,94,0,94,-94,1,18,54,1,NASDAQ
4653,12-02-2021 22:00,24 hrs.,pennystocks,MDGS,6,0,6,-6,1,1,0,1,NASDAQ
4653,12-02-2021 22:00,24 hrs.,pennystocks,MOSY,50,0,50,-50,1,21,4,1,NASDAQ
4653,12-02-2021 22:00,24 hrs.,pennystocks,MTRX,17,0,17,-17,1,5,3,1,NASDAQ
4653,12-02-2021 22:00,24 hrs.,pennystocks,MVIS,56,0,56,-56,2,22,4,2,NASDAQ
4653,12-02-2021 22:00,24 hrs.,pennystocks,NAKD,46,40,6,34,3,9,16,3,NASDAQ
4653,12-02-2021 22:00,24 hrs.,pennystocks,NAOV,6,6,0,6,1,1,0,1,NASDAQ
4653,12-02-2021 22:00,24 hrs.,pennystocks,NCMI,21,21,0,21,1,7,3,1,NASDAQ
4653,12-02-2021 22:00,24 hrs.,pennystocks,NDAQ,21,21,0,21,1,8,1,1,NASDAQ
4653,12-02-2021 22:00,24 hrs.,pennystocks,NOVN,34,6,28,-22,3,7,8,3,NASDAQ
4653,12-02-2021 22:00,24 hrs.,pennystocks,NTEC,50,0,50,-50,1,21,4,1,NASDAQ
4653,12-02-2021 22:00,24 hrs.,pennystocks,NVCN,56,49,7,42,2,17,14,2,NASDAQ
4653,12-02-2021 22:00,24 hrs.,pennystocks,NXTD,50,0,50,-50,1,21,4,1,NASDAQ
4653,12-02-2021 22:00,24 hrs.,pennystocks,OCGN,58,58,0,58,3,14,18,3,NASDAQ
4653,12-02-2021 22:00,24 hrs.,pennystocks,ONTX,12,6,6,0,2,2,0,2,NASDAQ
4653,12-02-2021 22:00,24 hrs.,pennystocks,OPTT,22,22,0,22,1,7,4,1,NASDAQ
4653,12-02-2021 22:00,24 hrs.,pennystocks,OTIC,10,10,0,10,1,1,4,1,NASDAQ
4653,12-02-2021 22:00,24 hrs.,pennystocks,PHIO,50,0,50,-50,1,21,4,1,NASDAQ
4653,12-02-2021 22:00,24 hrs.,pennystocks,PHUN,13,0,13,-13,2,2,1,2,NASDAQ
4653,12-02-2021 22:00,24 hrs.,pennystocks,PLAY,6,6,0,6,1,1,0,1,NASDAQ
4653,12-02-2021 22:00,24 hrs.,pennystocks,PLUG,115,21,94,-73,2,26,55,2,NASDAQ
4653,12-02-2021 22:00,24 hrs.,pennystocks,PPBT,10,0,10,-10,1,2,2,1,NASDAQ
4653,12-02-2021 22:00,24 hrs.,pennystocks,PSTV,80,6,74,-68,2,30,12,2,NASDAQ
4653,12-02-2021 22:00,24 hrs.,pennystocks,PULM,231,181,50,131,5,56,99,5,NASDAQ
4653,12-02-2021 22:00,24 hrs.,pennystocks,RAVE,39,0,39,-39,1,12,11,1,NASDAQ
4653,12-02-2021 22:00,24 hrs.,pennystocks,REAL,50,0,50,-50,1,6,34,1,NASDAQ
4653,12-02-2021 22:00,24 hrs.,pennystocks,RIBT,7,7,0,7,1,1,1,1,NASDAQ
4653,12-02-2021 22:00,24 hrs.,pennystocks,RIDE,6,6,0,6,1,1,0,1,NASDAQ
4653,12-02-2021 22:00,24 hrs.,pennystocks,RIGL,12,0,12,-12,2,2,0,2,NASDAQ
4653,12-02-2021 22:00,24 hrs.,pennystocks,RMTI,6,0,6,-6,1,1,0,1,NASDAQ
4653,12-02-2021 22:00,24 hrs.,pennystocks,SEAC,12,12,0,12,1,2,4,1,NASDAQ
4653,12-02-2021 22:00,24 hrs.,pennystocks,SELB,20,20,0,20,1,6,4,1,NASDAQ
4653,12-02-2021 22:00,24 hrs.,pennystocks,SFET,27,27,0,27,2,4,11,2,NASDAQ
4653,12-02-2021 22:00,24 hrs.,pennystocks,SHIP,20,20,0,20,3,3,2,2,NASDAQ
4653,12-02-2021 22:00,24 hrs.,pennystocks,SNDL,206,106,100,6,26,46,10,23,NASDAQ
4653,12-02-2021 22:00,24 hrs.,pennystocks,SNGX,1509,1509,0,1509,7,601,279,5,NASDAQ
4653,12-02-2021 22:00,24 hrs.,pennystocks,SOLO,21,21,0,21,1,8,1,1,NASDAQ
4653,12-02-2021 22:00,24 hrs.,pennystocks,SRGA,6,6,0,6,1,1,0,1,NASDAQ
4653,12-02-2021 22:00,24 hrs.,pennystocks,STCN,6,6,0,6,1,1,0,1,NASDAQ
4653,12-02-2021 22:00,24 hrs.,pennystocks,SXTC,13,0,13,-13,2,2,1,1,NASDAQ
4653,12-02-2021 22:00,24 hrs.,pennystocks,TBLT,6,6,0,6,1,1,0,1,NASDAQ
4653,12-02-2021 22:00,24 hrs.,pennystocks,TLRY,77,7,70,-63,4,27,7,4,NASDAQ
4653,12-02-2021 22:00,24 hrs.,pennystocks,TMDI,6,0,6,-6,1,1,0,1,NASDAQ
4653,12-02-2021 22:00,24 hrs.,pennystocks,TNXP,468,85,383,-298,12,170,80,9,NASDAQ
4653,12-02-2021 22:00,24 hrs.,pennystocks,TRCH,13,7,6,1,2,2,1,2,NASDAQ
4653,12-02-2021 22:00,24 hrs.,pennystocks,TRVG,19,19,0,19,3,3,1,2,NASDAQ
4653,12-02-2021 22:00,24 hrs.,pennystocks,TSLA,6,6,0,6,1,1,0,1,NASDAQ
4653,12-02-2021 22:00,24 hrs.,pennystocks,TXMD,7,7,0,7,1,1,1,1,NASDAQ
4653,12-02-2021 22:00,24 hrs.,pennystocks,TYME,20,20,0,20,1,6,4,1,NASDAQ
4653,12-02-2021 22:00,24 hrs.,pennystocks,USWS,12,0,12,-12,2,2,0,2,NASDAQ
4653,12-02-2021 22:00,24 hrs.,pennystocks,VEON,7,7,0,7,1,1,1,1,NASDAQ
4653,12-02-2021 22:00,24 hrs.,pennystocks,VETS,509,509,0,509,1,191,123,1,NASDAQ
4653,12-02-2021 22:00,24 hrs.,pennystocks,VRME,21,0,21,-21,1,6,5,1,NASDAQ
4653,12-02-2021 22:00,24 hrs.,pennystocks,MFH,50,0,50,-50,1,21,4,1,NASDAQ
4653,12-02-2021 22:00,24 hrs.,pennystocks,MKD,23,23,0,23,1,6,7,1,NASDAQ
4653,12-02-2021 22:00,24 hrs.,pennystocks,MYT,11,11,0,11,1,1,5,1,NASDAQ
4653,12-02-2021 22:00,24 hrs.,pennystocks,OGI,7,0,7,-7,1,1,1,1,NASDAQ
4653,12-02-2021 22:00,24 hrs.,pennystocks,UFO,6,0,6,-6,1,1,0,1,NASDAQ
4653,12-02-2021 22:00,24 hrs.,pennystocks,ABEO,7,7,0,7,1,1,1,1,NASDAQ
4653,12-02-2021 22:00,24 hrs.,pennystocks,ABIO,24,0,24,-24,1,8,4,1,NASDAQ
4653,12-02-2021 22:00,24 hrs.,pennystocks,ACST,13,6,7,-1,2,2,1,2,NASDAQ
4653,12-02-2021 22:00,24 hrs.,pennystocks,AGEN,10,10,0,10,1,3,0,1,NASDAQ
4653,12-02-2021 22:00,24 hrs.,pennystocks,AGTC,29,14,15,-1,3,4,9,3,NASDAQ
4653,12-02-2021 22:00,24 hrs.,wallstreetbets,AHFD,7,0,7,-7,1,1,1,1,OTC
4653,12-02-2021 22:00,24 hrs.,wallstreetbets,AITX,20,0,20,-20,3,3,2,3,OTC
4653,12-02-2021 22:00,24 hrs.,wallstreetbets,ALPP,14,14,0,14,2,2,2,2,OTC
4653,12-02-2021 22:00,24 hrs.,wallstreetbets,ALYI,14,7,7,0,2,2,2,2,OTC
4653,12-02-2021 22:00,24 hrs.,wallstreetbets,AMNE,13,13,0,13,2,2,1,1,OTC
4653,12-02-2021 22:00,24 hrs.,wallstreetbets,ANTI,6,0,6,-6,1,1,0,1,OTC
4653,12-02-2021 22:00,24 hrs.,wallstreetbets,APCX,7,7,0,7,1,1,1,1,OTC
4653,12-02-2021 22:00,24 hrs.,wallstreetbets,ASTI,18,0,18,-18,3,3,0,1,OTC
4653,12-02-2021 22:00,24 hrs.,wallstreetbets,BANT,6,6,0,6,1,1,0,1,OTC
4653,12-02-2021 22:00,24 hrs.,wallstreetbets,BBRW,6,0,6,-6,1,1,0,1,OTC
4653,12-02-2021 22:00,24 hrs.,wallstreetbets,BCCI,14,0,14,-14,2,2,2,1,OTC
4653,12-02-2021 22:00,24 hrs.,wallstreetbets,BFCH,7,0,7,-7,1,1,1,1,OTC
4653,12-02-2021 22:00,24 hrs.,wallstreetbets,BIEL,19,12,7,5,3,3,1,3,OTC
4653,12-02-2021 22:00,24 hrs.,wallstreetbets,BIGG,6,0,6,-6,1,1,0,1,OTC
4653,12-02-2021 22:00,24 hrs.,wallstreetbets,BLPG,7,0,7,-7,1,1,1,1,OTC
4653,12-02-2021 22:00,24 hrs.,wallstreetbets,BLSP,21,21,0,21,3,3,3,1,OTC
4653,12-02-2021 22:00,24 hrs.,wallstreetbets,BMIX,11,11,0,11,1,1,5,1,OTC
4653,12-02-2021 22:00,24 hrs.,wallstreetbets,BOTH,7,7,0,7,1,1,1,1,OTC
4653,12-02-2021 22:00,24 hrs.,wallstreetbets,BOTY,19,6,13,-7,3,3,1,3,OTC
4653,12-02-2021 22:00,24 hrs.,wallstreetbets,BRLL,7,7,0,7,1,1,1,1,OTC
4653,12-02-2021 22:00,24 hrs.,wallstreetbets,BTCS,21,21,0,21,3,3,3,1,OTC
4653,12-02-2021 22:00,24 hrs.,wallstreetbets,BTSC,7,7,0,7,1,1,1,1,OTC
4653,12-02-2021 22:00,24 hrs.,wallstreetbets,BTZI,13,13,0,13,2,2,1,2,OTC
4653,12-02-2021 22:00,24 hrs.,wallstreetbets,BUDZ,6,6,0,6,1,1,0,1,OTC
4653,12-02-2021 22:00,24 hrs.,wallstreetbets,CBDD,7,7,0,7,1,1,1,1,OTC
4653,12-02-2021 22:00,24 hrs.,wallstreetbets,CBDL,55,55,0,55,8,8,7,5,OTC
4653,12-02-2021 22:00,24 hrs.,wallstreetbets,CCTC,7,7,0,7,1,1,1,1,OTC
4653,12-02-2021 22:00,24 hrs.,wallstreetbets,CCTL,6,0,6,-6,1,1,0,1,OTC
4653,12-02-2021 22:00,24 hrs.,wallstreetbets,CGEI,7,0,7,-7,1,1,1,1,OTC
4653,12-02-2021 22:00,24 hrs.,wallstreetbets,CGLD,7,7,0,7,1,1,1,1,OTC
4653,12-02-2021 22:00,24 hrs.,wallstreetbets,CHUC,7,7,0,7,1,1,1,1,OTC
4653,12-02-2021 22:00,24 hrs.,wallstreetbets,CLIS,14,14,0,14,2,2,2,1,OTC
4653,12-02-2021 22:00,24 hrs.,wallstreetbets,CLSH,7,0,7,-7,1,1,1,1,OTC
4653,12-02-2021 22:00,24 hrs.,wallstreetbets,CLWD,7,7,0,7,1,1,1,1,OTC
4653,12-02-2021 22:00,24 hrs.,wallstreetbets,COMS,19,19,0,19,3,3,1,2,OTC
4653,12-02-2021 22:00,24 hrs.,wallstreetbets,CYDY,14,7,7,0,2,2,2,2,OTC
4653,12-02-2021 22:00,24 hrs.,wallstreetbets,CYLC,7,7,0,7,1,1,1,1,OTC
4653,12-02-2021 22:00,24 hrs.,wallstreetbets,DGWR,7,7,0,7,1,1,1,1,OTC
4653,12-02-2021 22:00,24 hrs.,wallstreetbets,DIGI,14,0,14,-14,2,2,2,1,OTC
4653,12-02-2021 22:00,24 hrs.,wallstreetbets,DPLS,13,13,0,13,2,2,1,2,OTC
4653,12-02-2021 22:00,24 hrs.,wallstreetbets,DPWW,7,7,0,7,1,1,1,1,OTC
4653,12-02-2021 22:00,24 hrs.,wallstreetbets,DWOG,7,0,7,-7,1,1,1,1,OTC
4653,12-02-2021 22:00,24 hrs.,wallstreetbets,ELCR,28,7,21,-14,4,4,4,2,OTC
4653,12-02-2021 22:00,24 hrs.,wallstreetbets,ELTP,24,24,0,24,3,3,6,3,OTC
4653,12-02-2021 22:00,24 hrs.,wallstreetbets,ENZN,7,7,0,7,1,1,1,1,OTC
4653,12-02-2021 22:00,24 hrs.,wallstreetbets,ETFM,23,17,6,11,3,3,5,2,OTC
4653,12-02-2021 22:00,24 hrs.,wallstreetbets,EWKS,6,6,0,6,1,1,0,1,OTC
4653,12-02-2021 22:00,24 hrs.,wallstreetbets,FBSE,8,0,8,-8,1,1,2,1,OTC
4653,12-02-2021 22:00,24 hrs.,wallstreetbets,FTEG,7,7,0,7,1,1,1,1,OTC
4653,12-02-2021 22:00,24 hrs.,wallstreetbets,FTPM,7,7,0,7,1,1,1,1,OTC
4653,12-02-2021 22:00,24 hrs.,wallstreetbets,GARB,7,7,0,7,1,1,1,1,OTC
4653,12-02-2021 22:00,24 hrs.,wallstreetbets,GBLX,6,0,6,-6,1,1,0,1,OTC
4653,12-02-2021 22:00,24 hrs.,wallstreetbets,GBTC,3840,3840,0,3840,3,1781,266,2,OTC
4653,12-02-2021 22:00,24 hrs.,wallstreetbets,GMEV,14,14,0,14,2,2,2,2,OTC
4653,12-02-2021 22:00,24 hrs.,pennystocks,INFI,63,13,50,-37,2,22,11,2,NASDAQ
4653,12-02-2021 22:00,24 hrs.,pennystocks,INOD,69,69,0,69,1,11,43,1,NASDAQ
4653,12-02-2021 22:00,24 hrs.,pennystocks,INPX,63,0,63,-63,3,23,5,3,NASDAQ
4653,12-02-2021 22:00,24 hrs.,pennystocks,IRDM,21,21,0,21,1,8,1,1,NASDAQ
4653,12-02-2021 22:00,24 hrs.,pennystocks,IZEA,6,6,0,6,1,1,0,1,NASDAQ
4653,12-02-2021 22:00,24 hrs.,pennystocks,JAGX,6,0,6,-6,1,1,0,1,NASDAQ
4653,12-02-2021 22:00,24 hrs.,pennystocks,KTRA,168,51,117,-66,5,48,52,5,NASDAQ
4653,12-02-2021 22:00,24 hrs.,pennystocks,KXIN,21,21,0,21,1,8,1,1,NASDAQ
4653,12-02-2021 22:00,24 hrs.,pennystocks,LKCO,59,0,59,-59,2,23,5,2,NASDAQ
4653,12-02-2021 22:00,24 hrs.,pennystocks,LPCN,54,0,54,-54,1,19,12,1,NASDAQ
4653,12-02-2021 22:00,24 hrs.,wallstreetbets,HIHI,7,7,0,7,1,1,1,1,OTC
4653,12-02-2021 22:00,24 hrs.,wallstreetbets,HIPH,14,7,7,0,2,2,2,2,OTC
4653,12-02-2021 22:00,24 hrs.,wallstreetbets,HMNY,69,42,27,15,10,10,9,6,OTC
4653,12-02-2021 22:00,24 hrs.,wallstreetbets,HMPQ,7,7,0,7,1,1,1,1,OTC
4653,12-02-2021 22:00,24 hrs.,wallstreetbets,HQGE,28,28,0,28,4,4,4,3,OTC
4653,12-02-2021 22:00,24 hrs.,wallstreetbets,HRBR,6,6,0,6,1,1,0,1,OTC
4653,12-02-2021 22:00,24 hrs.,wallstreetbets,HYSR,13,7,6,1,2,2,1,2,OTC
4653,12-02-2021 22:00,24 hrs.,wallstreetbets,ICBU,7,7,0,7,1,1,1,1,OTC
4653,12-02-2021 22:00,24 hrs.,wallstreetbets,INCT,27,21,6,15,4,4,3,3,OTC
4653,12-02-2021 22:00,24 hrs.,wallstreetbets,INKW,7,7,0,7,1,1,1,1,OTC
4653,12-02-2021 22:00,24 hrs.,wallstreetbets,INND,27,14,13,1,4,4,3,3,OTC
4653,12-02-2021 22:00,24 hrs.,wallstreetbets,INTV,21,21,0,21,3,3,3,2,OTC
4653,12-02-2021 22:00,24 hrs.,wallstreetbets,IPIX,10,10,0,10,1,3,0,1,OTC
4653,12-02-2021 22:00,24 hrs.,wallstreetbets,IQST,13,13,0,13,2,2,1,1,OTC
4653,12-02-2021 22:00,24 hrs.,wallstreetbets,ITCJ,6,6,0,6,1,1,0,1,OTC
4653,12-02-2021 22:00,24 hrs.,wallstreetbets,KALY,7,7,0,7,1,1,1,1,OTC
4653,12-02-2021 22:00,24 hrs.,wallstreetbets,KGKG,7,0,7,-7,1,1,1,1,OTC
4653,12-02-2021 22:00,24 hrs.,wallstreetbets,KRFG,7,0,7,-7,1,1,1,1,OTC
4653,12-02-2021 22:00,24 hrs.,wallstreetbets,KWBT,7,7,0,7,1,1,1,1,OTC
4653,12-02-2021 22:00,24 hrs.,wallstreetbets,KYNC,14,7,7,0,2,2,2,2,OTC
4653,12-02-2021 22:00,24 hrs.,wallstreetbets,LBCC,7,7,0,7,1,1,1,1,OTC
4653,12-02-2021 22:00,24 hrs.,wallstreetbets,LINK,436,436,0,436,4,173,74,4,OTC
4653,12-02-2021 22:00,24 hrs.,wallstreetbets,LITH,7,7,0,7,1,1,1,1,OTC
4653,12-02-2021 22:00,24 hrs.,wallstreetbets,LOTE,7,0,7,-7,1,1,1,1,OTC
4653,12-02-2021 22:00,24 hrs.,wallstreetbets,LQWC,6,0,6,-6,1,1,0,1,OTC
4653,12-02-2021 22:00,24 hrs.,wallstreetbets,LSCG,7,0,7,-7,1,1,1,1,OTC
4653,12-02-2021 22:00,24 hrs.,wallstreetbets,LTNC,14,14,0,14,2,2,2,2,OTC
4653,12-02-2021 22:00,24 hrs.,wallstreetbets,LTUM,12,6,6,0,2,2,0,2,OTC
4653,12-02-2021 22:00,24 hrs.,wallstreetbets,MAXD,22,22,0,22,3,3,4,3,OTC
4653,12-02-2021 22:00,24 hrs.,wallstreetbets,MCOA,20,20,0,20,3,3,2,3,OTC
4653,12-02-2021 22:00,24 hrs.,wallstreetbets,MEDH,7,7,0,7,1,1,1,1,OTC
4653,12-02-2021 22:00,24 hrs.,wallstreetbets,MGNT,7,7,0,7,1,1,1,1,OTC
4653,12-02-2021 22:00,24 hrs.,wallstreetbets,MGTI,7,7,0,7,1,1,1,1,OTC
4653,12-02-2021 22:00,24 hrs.,wallstreetbets,MINE,68,48,20,28,10,10,8,7,OTC
4653,12-02-2021 22:00,24 hrs.,wallstreetbets,MJNA,48,27,21,6,7,7,6,7,OTC
4653,12-02-2021 22:00,24 hrs.,wallstreetbets,MKTY,21,21,0,21,3,3,3,2,OTC
4653,12-02-2021 22:00,24 hrs.,wallstreetbets,MMEX,35,0,35,-35,5,5,5,3,OTC
4653,12-02-2021 22:00,24 hrs.,wallstreetbets,MOJO,13,13,0,13,2,2,1,1,OTC
4653,12-02-2021 22:00,24 hrs.,wallstreetbets,MOST,26,26,0,26,4,4,2,4,OTC
4653,12-02-2021 22:00,24 hrs.,wallstreetbets,MTVX,15,0,15,-15,2,3,1,2,OTC
4653,12-02-2021 22:00,24 hrs.,wallstreetbets,NBVG,6,6,0,6,1,1,0,1,OTC
4653,12-02-2021 22:00,24 hrs.,wallstreetbets,NEOM,21,21,0,21,3,3,3,2,OTC
4653,12-02-2021 22:00,24 hrs.,wallstreetbets,NOVC,34,34,0,34,5,5,4,3,OTC
4653,12-02-2021 22:00,24 hrs.,wallstreetbets,NPHC,7,7,0,7,1,1,1,1,OTC
4653,12-02-2021 22:00,24 hrs.,wallstreetbets,NPTX,14,0,14,-14,2,2,2,1,OTC
4653,12-02-2021 22:00,24 hrs.,wallstreetbets,NWPN,6,6,0,6,1,1,0,1,OTC
4653,12-02-2021 22:00,24 hrs.,wallstreetbets,ONPH,6,6,0,6,1,1,0,1,OTC
4653,12-02-2021 22:00,24 hrs.,wallstreetbets,OTTV,14,14,0,14,2,2,2,1,OTC
4653,12-02-2021 22:00,24 hrs.,wallstreetbets,OWPC,6,6,0,6,1,1,0,1,OTC
4653,12-02-2021 22:00,24 hrs.,wallstreetbets,OZSC,7,7,0,7,1,1,1,1,OTC
4653,12-02-2021 22:00,24 hrs.,wallstreetbets,PAOG,7,7,0,7,1,1,1,1,OTC
4653,12-02-2021 22:00,24 hrs.,wallstreetbets,PDMI,7,0,7,-7,1,1,1,1,OTC
4653,12-02-2021 22:00,24 hrs.,wallstreetbets,PHBI,14,14,0,14,2,2,2,1,OTC
4653,12-02-2021 22:00,24 hrs.,wallstreetbets,PNPL,13,0,13,-13,2,2,1,1,OTC
4653,12-02-2021 22:00,24 hrs.,pennystocks,WTRH,39,0,39,-39,1,12,11,1,NASDAQ
4653,12-02-2021 22:00,24 hrs.,pennystocks,XELA,197,197,0,197,1,89,15,1,NASDAQ
4653,12-02-2021 22:00,24 hrs.,pennystocks,XSPA,34,34,0,34,1,13,4,1,NASDAQ
4653,12-02-2021 22:00,24 hrs.,pennystocks,ZSAN,213,86,127,-41,5,66,61,5,NASDAQ
4653,12-02-2021 22:00,24 hrs.,pennystocks,ZYNE,50,0,50,-50,1,21,4,1,NASDAQ
4653,12-02-2021 22:00,24 hrs.,wallstreetbets,ABML,27,14,13,1,4,4,3,4,OTC
4653,12-02-2021 22:00,24 hrs.,wallstreetbets,ABQQ,7,0,7,-7,1,1,1,1,OTC
4653,12-02-2021 22:00,24 hrs.,wallstreetbets,ACRL,6,6,0,6,1,1,0,1,OTC
4653,12-02-2021 22:00,24 hrs.,wallstreetbets,ACTX,8,8,0,8,1,1,2,1,OTC
4653,12-02-2021 22:00,24 hrs.,wallstreetbets,AEGY,6,0,6,-6,1,1,0,1,OTC
4653,12-02-2021 22:00,24 hrs.,wallstreetbets,RTON,20,7,13,-6,3,3,2,3,OTC
4653,12-02-2021 22:00,24 hrs.,wallstreetbets,SFOR,14,0,14,-14,2,2,2,1,OTC
4653,12-02-2021 22:00,24 hrs.,wallstreetbets,SGMD,25,6,19,-13,4,4,1,3,OTC
4653,12-02-2021 22:00,24 hrs.,wallstreetbets,SHMP,27,14,13,1,4,4,3,4,OTC
4653,12-02-2021 22:00,24 hrs.,wallstreetbets,SIGN,27,14,13,1,4,4,3,4,OTC
4653,12-02-2021 22:00,24 hrs.,wallstreetbets,SIRR,7,7,0,7,1,1,1,1,OTC
4653,12-02-2021 22:00,24 hrs.,wallstreetbets,SNYR,14,14,0,14,2,2,2,1,OTC
4653,12-02-2021 22:00,24 hrs.,wallstreetbets,SRMX,33,13,20,-7,5,5,3,5,OTC
4653,12-02-2021 22:00,24 hrs.,wallstreetbets,SUIC,6,6,0,6,1,1,0,1,OTC
4653,12-02-2021 22:00,24 hrs.,wallstreetbets,TCHH,6,6,0,6,1,1,0,1,OTC
4653,12-02-2021 22:00,24 hrs.,wallstreetbets,TGLO,7,7,0,7,1,1,1,1,OTC
4653,12-02-2021 22:00,24 hrs.,wallstreetbets,TRNX,7,0,7,-7,1,1,1,1,OTC
4653,12-02-2021 22:00,24 hrs.,wallstreetbets,TRTC,21,21,0,21,3,3,3,2,OTC
4653,12-02-2021 22:00,24 hrs.,wallstreetbets,TSNP,20,14,6,8,3,3,2,3,OTC
4653,12-02-2021 22:00,24 hrs.,wallstreetbets,UBQU,7,7,0,7,1,1,1,1,OTC
4653,12-02-2021 22:00,24 hrs.,wallstreetbets,USDC,8,8,0,8,1,1,2,1,OTC
4653,12-02-2021 22:00,24 hrs.,wallstreetbets,USMJ,13,13,0,13,2,2,1,2,OTC
4653,12-02-2021 22:00,24 hrs.,wallstreetbets,UVSE,7,7,0,7,1,1,1,1,OTC
4653,12-02-2021 22:00,24 hrs.,wallstreetbets,VTLR,7,7,0,7,1,1,1,1,OTC
4653,12-02-2021 22:00,24 hrs.,wallstreetbets,VYST,6,6,0,6,1,1,0,1,OTC
4653,12-02-2021 22:00,24 hrs.,wallstreetbets,WDDD,7,7,0,7,1,1,1,1,OTC
4653,12-02-2021 22:00,24 hrs.,wallstreetbets,WDLF,7,7,0,7,1,1,1,1,OTC
4653,12-02-2021 22:00,24 hrs.,wallstreetbets,WHEN,19,6,13,-7,3,3,1,3,OTC
4653,12-02-2021 22:00,24 hrs.,wallstreetbets,WSSE,7,7,0,7,1,1,1,1,OTC
4653,12-02-2021 22:00,24 hrs.,wallstreetbets,YRIV,5,5,0,5,1,0,1,1,OTC
4653,12-02-2021 22:00,24 hrs.,wallstreetbets,ZMRK,7,7,0,7,1,1,1,1,OTC
4653,12-02-2021 22:00,24 hrs.,wallstreetbets,ZNOG,7,7,0,7,1,1,1,1,OTC
4653,12-02-2021 22:00,24 hrs.,wallstreetbets,AGUNF,6,6,0,6,1,1,0,1,OTC
4653,12-02-2021 22:00,24 hrs.,wallstreetbets,AMYZF,23,23,0,23,3,3,5,2,OTC
4653,12-02-2021 22:00,24 hrs.,wallstreetbets,ARBKF,13,6,7,-1,2,2,1,2,OTC
4653,12-02-2021 22:00,24 hrs.,wallstreetbets,ATURF,7,7,0,7,1,1,1,1,OTC
4653,12-02-2021 22:00,24 hrs.,wallstreetbets,AZKLF,18,18,0,18,3,3,0,1,OTC
4653,12-02-2021 22:00,24 hrs.,wallstreetbets,BBKCF,6,6,0,6,1,1,0,1,OTC
4653,12-02-2021 22:00,24 hrs.,wallstreetbets,BDRBF,27,14,13,1,4,4,3,4,OTC
4653,12-02-2021 22:00,24 hrs.,wallstreetbets,CBWTF,11,0,11,-11,1,0,7,1,OTC
4653,12-02-2021 22:00,24 hrs.,wallstreetbets,CLXPF,7,7,0,7,1,1,1,1,OTC
4653,12-02-2021 22:00,24 hrs.,wallstreetbets,CRLBF,12,12,0,12,2,2,0,2,OTC
4653,12-02-2021 22:00,24 hrs.,wallstreetbets,DFLYF,33,0,33,-33,3,2,17,2,OTC
4653,12-02-2021 22:00,24 hrs.,wallstreetbets,DIAAF,7,7,0,7,1,1,1,1,OTC
4653,12-02-2021 22:00,24 hrs.,wallstreetbets,FDVRF,6,6,0,6,1,1,0,1,OTC
4653,12-02-2021 22:00,24 hrs.,wallstreetbets,FLWPF,7,0,7,-7,1,1,1,1,OTC
4653,12-02-2021 22:00,24 hrs.,wallstreetbets,GAYMF,20,6,14,-8,3,3,2,3,OTC
4653,12-02-2021 22:00,24 hrs.,wallstreetbets,GGTTF,7,7,0,7,1,1,1,1,OTC
4653,12-02-2021 22:00,24 hrs.,wallstreetbets,GTBIF,7,7,0,7,1,1,1,1,OTC
4653,12-02-2021 22:00,24 hrs.,wallstreetbets,HITIF,7,7,0,7,1,1,1,1,OTC
4653,12-02-2021 22:00,24 hrs.,wallstreetbets,HRSTW,11,11,0,11,2,1,1,1,OTC
4653,12-02-2021 22:00,24 hrs.,wallstreetbets,HUTMF,13,13,0,13,2,2,1,2,OTC
4653,12-02-2021 22:00,24 hrs.,wallstreetbets,HVBTF,22,22,0,22,3,3,4,3,OTC
4653,12-02-2021 22:00,24 hrs.,wallstreetbets,IGCIW,49,49,0,49,7,7,7,2,OTC
4653,12-02-2021 22:00,24 hrs.,wallstreetbets,ISCNF,14,14,0,14,2,2,2,2,OTC
4653,12-02-2021 22:00,24 hrs.,wallstreetbets,ITHUF,7,7,0,7,1,1,1,1,OTC
4653,12-02-2021 22:00,24 hrs.,wallstreetbets,KBEVF,7,7,0,7,1,1,1,1,OTC
4653,12-02-2021 22:00,24 hrs.,wallstreetbets,KPIFF,6,0,6,-6,1,1,0,1,OTC
4653,12-02-2021 22:00,24 hrs.,wallstreetbets,LHSIF,7,7,0,7,1,1,1,1,OTC
4653,12-02-2021 22:00,24 hrs.,wallstreetbets,GMSC,14,14,0,14,2,2,2,1,OTC
4653,12-02-2021 22:00,24 hrs.,wallstreetbets,GPFT,27,20,7,13,4,4,3,4,OTC
4653,12-02-2021 22:00,24 hrs.,wallstreetbets,GRNH,6,0,6,-6,1,1,0,1,OTC
4653,12-02-2021 22:00,24 hrs.,wallstreetbets,GTCH,7,7,0,7,1,1,1,1,OTC
4653,12-02-2021 22:00,24 hrs.,wallstreetbets,GTEH,6,6,0,6,1,1,0,1,OTC
4653,12-02-2021 22:00,24 hrs.,wallstreetbets,GTII,1269,0,1269,-1269,1,453,359,1,OTC
4653,12-02-2021 22:00,24 hrs.,wallstreetbets,GTLL,13,6,7,-1,2,2,1,2,OTC
4653,12-02-2021 22:00,24 hrs.,wallstreetbets,GTXO,14,14,0,14,2,2,2,1,OTC
4653,12-02-2021 22:00,24 hrs.,wallstreetbets,HCMC,413,252,161,91,61,61,47,58,OTC
4653,12-02-2021 22:00,24 hrs.,wallstreetbets,HEMP,21,21,0,21,3,3,3,2,OTC
4653,12-02-2021 22:00,24 hrs.,wallstreetbets,NTDOY,15,15,0,15,2,2,3,2,OTC
4653,12-02-2021 22:00,24 hrs.,wallstreetbets,NTSFF,6,0,6,-6,1,1,0,1,OTC
4653,12-02-2021 22:00,24 hrs.,wallstreetbets,NXGWF,20,13,7,6,3,3,2,2,OTC
4653,12-02-2021 22:00,24 hrs.,wallstreetbets,NXTTF,14,14,0,14,2,2,2,1,OTC
4653,12-02-2021 22:00,24 hrs.,wallstreetbets,PCLOF,7,7,0,7,1,1,1,1,OTC
4653,12-02-2021 22:00,24 hrs.,wallstreetbets,PDYPF,7,7,0,7,1,1,1,1,OTC
4653,12-02-2021 22:00,24 hrs.,wallstreetbets,PMNXF,6,6,0,6,1,1,0,1,OTC
4653,12-02-2021 22:00,24 hrs.,wallstreetbets,RAZFF,14,7,7,0,2,2,2,2,OTC
4653,12-02-2021 22:00,24 hrs.,wallstreetbets,RLLCF,72,72,0,72,10,10,12,10,OTC
4653,12-02-2021 22:00,24 hrs.,wallstreetbets,RYCEY,474,64,410,-346,18,117,168,16,OTC
4653,12-02-2021 22:00,24 hrs.,wallstreetbets,SPRWF,90,28,62,-34,13,15,8,10,OTC
4653,12-02-2021 22:00,24 hrs.,wallstreetbets,TCNNF,3854,3854,0,3854,5,1783,268,1,OTC
4653,12-02-2021 22:00,24 hrs.,wallstreetbets,TGODF,7,7,0,7,1,1,1,1,OTC
4653,12-02-2021 22:00,24 hrs.,wallstreetbets,TLOFF,7,0,7,-7,1,1,1,1,OTC
4653,12-02-2021 22:00,24 hrs.,wallstreetbets,TPPRF,14,14,0,14,2,2,2,1,OTC
4653,12-02-2021 22:00,24 hrs.,wallstreetbets,TSCRF,54,47,7,40,4,4,30,3,OTC
4653,12-02-2021 22:00,24 hrs.,wallstreetbets,TXLZF,7,7,0,7,1,1,1,1,OTC
4653,12-02-2021 22:00,24 hrs.,wallstreetbets,VALPQ,15,8,7,1,2,3,1,2,OTC
4653,12-02-2021 22:00,24 hrs.,wallstreetbets,VVCIF,7,0,7,-7,1,1,1,1,OTC
4653,12-02-2021 22:00,24 hrs.,wallstreetbets,WDDMF,7,7,0,7,1,1,1,1,OTC
4653,12-02-2021 22:00,24 hrs.,wallstreetbets,WPMLF,8,0,8,-8,1,1,2,1,OTC
4653,12-02-2021 22:00,24 hrs.,wallstreetbets,AAU,14,14,0,14,2,2,2,2,AMEX
4653,12-02-2021 22:00,24 hrs.,wallstreetbets,BTN,15,15,0,15,2,2,3,1,AMEX
4653,12-02-2021 22:00,24 hrs.,wallstreetbets,DIT,6,6,0,6,1,1,0,1,AMEX
4653,12-02-2021 22:00,24 hrs.,wallstreetbets,DNN,199,144,55,89,29,29,25,24,AMEX
4653,12-02-2021 22:00,24 hrs.,wallstreetbets,DPW,21,14,7,7,3,3,3,3,AMEX
4653,12-02-2021 22:00,24 hrs.,wallstreetbets,FEN,7,0,7,-7,1,1,1,1,AMEX
4653,12-02-2021 22:00,24 hrs.,wallstreetbets,GDP,159,159,0,159,2,42,67,2,AMEX
4653,12-02-2021 22:00,24 hrs.,wallstreetbets,GSV,21,0,21,-21,3,3,3,3,AMEX
4653,12-02-2021 22:00,24 hrs.,wallstreetbets,GTE,87,47,40,7,13,13,9,11,AMEX
4653,12-02-2021 22:00,24 hrs.,wallstreetbets,IGC,7,0,7,-7,1,1,1,1,AMEX
4653,12-02-2021 22:00,24 hrs.,wallstreetbets,ISR,6,0,6,-6,1,1,0,1,AMEX
4653,12-02-2021 22:00,24 hrs.,wallstreetbets,ITP,7,7,0,7,1,1,1,1,AMEX
4653,12-02-2021 22:00,24 hrs.,wallstreetbets,LSF,7,0,7,-7,1,1,1,1,AMEX
4653,12-02-2021 22:00,24 hrs.,wallstreetbets,MSN,7,7,0,7,1,1,1,1,AMEX
4653,12-02-2021 22:00,24 hrs.,wallstreetbets,MXC,21,14,7,7,3,3,3,3,AMEX
4653,12-02-2021 22:00,24 hrs.,wallstreetbets,MYO,7,7,0,7,1,1,1,1,AMEX
4653,12-02-2021 22:00,24 hrs.,wallstreetbets,NAK,109,50,59,-9,17,17,7,15,AMEX
4653,12-02-2021 22:00,24 hrs.,wallstreetbets,NGD,15,0,15,-15,2,2,3,1,AMEX
4653,12-02-2021 22:00,24 hrs.,wallstreetbets,PTN,7,7,0,7,1,1,1,1,AMEX
4653,12-02-2021 22:00,24 hrs.,wallstreetbets,REI,7,7,0,7,1,1,1,1,AMEX
4653,12-02-2021 22:00,24 hrs.,wallstreetbets,SYN,14,14,0,14,2,2,2,1,AMEX
4653,12-02-2021 22:00,24 hrs.,wallstreetbets,TGB,6,6,0,6,1,1,0,1,AMEX
4653,12-02-2021 22:00,24 hrs.,wallstreetbets,TMQ,8,0,8,-8,1,1,2,1,AMEX
4653,12-02-2021 22:00,24 hrs.,wallstreetbets,TRX,75,35,40,-5,11,11,9,8,AMEX
4653,12-02-2021 22:00,24 hrs.,wallstreetbets,URG,7,0,7,-7,1,1,1,1,AMEX
4653,12-02-2021 22:00,24 hrs.,wallstreetbets,UUU,6,6,0,6,1,1,0,1,AMEX
4653,12-02-2021 22:00,24 hrs.,wallstreetbets,ZOM,249,131,118,13,33,41,35,30,AMEX
4653,12-02-2021 22:00,24 hrs.,wallstreetbets,AMPE,41,41,0,41,6,6,5,4,AMEX
4653,12-02-2021 22:00,24 hrs.,wallstreetbets,CRMD,7,7,0,7,1,1,1,1,AMEX
4653,12-02-2021 22:00,24 hrs.,wallstreetbets,EMAN,14,7,7,0,2,2,2,2,AMEX
4653,12-02-2021 22:00,24 hrs.,wallstreetbets,GOED,13,13,0,13,2,2,1,2,AMEX
4653,12-02-2021 22:00,24 hrs.,wallstreetbets,GSAT,99,20,79,-59,15,15,9,7,AMEX
4653,12-02-2021 22:00,24 hrs.,wallstreetbets,HUSA,7,7,0,7,1,1,1,1,AMEX
4653,12-02-2021 22:00,24 hrs.,wallstreetbets,PRED,7,0,7,-7,1,1,1,1,OTC
4653,12-02-2021 22:00,24 hrs.,wallstreetbets,PURE,7,0,7,-7,1,1,1,1,OTC
4653,12-02-2021 22:00,24 hrs.,wallstreetbets,QOIL,6,6,0,6,1,1,0,1,OTC
4653,12-02-2021 22:00,24 hrs.,wallstreetbets,RBDC,7,7,0,7,1,1,1,1,OTC
4653,12-02-2021 22:00,24 hrs.,wallstreetbets,RBNW,13,6,7,-1,2,2,1,2,OTC
4653,12-02-2021 22:00,24 hrs.,wallstreetbets,REFG,7,7,0,7,1,1,1,1,OTC
4653,12-02-2021 22:00,24 hrs.,wallstreetbets,RELI,6,6,0,6,1,1,0,1,OTC
4653,12-02-2021 22:00,24 hrs.,wallstreetbets,RIGH,7,0,7,-7,1,1,1,1,OTC
4653,12-02-2021 22:00,24 hrs.,wallstreetbets,RSHN,7,0,7,-7,1,1,1,1,OTC
4653,12-02-2021 22:00,24 hrs.,wallstreetbets,RSSV,9,9,0,9,1,2,1,1,OTC
4653,12-02-2021 22:00,24 hrs.,wallstreetbets,ABT,13,13,0,13,2,2,1,2,NYSE
4653,12-02-2021 22:00,24 hrs.,wallstreetbets,ACB,157,131,26,105,23,23,19,19,NYSE
4653,12-02-2021 22:00,24 hrs.,wallstreetbets,ACI,7,7,0,7,1,1,1,1,NYSE
4653,12-02-2021 22:00,24 hrs.,wallstreetbets,AEM,8,8,0,8,1,1,2,1,NYSE
4653,12-02-2021 22:00,24 hrs.,wallstreetbets,AFC,7,7,0,7,1,1,1,1,NYSE
4653,12-02-2021 22:00,24 hrs.,wallstreetbets,AHT,14,0,14,-14,2,2,2,2,NYSE
4653,12-02-2021 22:00,24 hrs.,wallstreetbets,AIR,13,6,7,-1,2,2,1,2,NYSE
4653,12-02-2021 22:00,24 hrs.,wallstreetbets,AIV,6,6,0,6,1,1,0,1,NYSE
4653,12-02-2021 22:00,24 hrs.,wallstreetbets,AMC,9975,4929,5046,-117,232,3907,1233,190,NYSE
4653,12-02-2021 22:00,24 hrs.,wallstreetbets,AMP,48,21,27,-6,7,7,6,7,NYSE
4653,12-02-2021 22:00,24 hrs.,wallstreetbets,ASX,21,7,14,-7,3,3,3,3,NYSE
4653,12-02-2021 22:00,24 hrs.,wallstreetbets,ATH,135,26,109,-83,5,38,39,5,NYSE
4653,12-02-2021 22:00,24 hrs.,wallstreetbets,AUY,109,109,0,109,9,16,41,4,NYSE
4653,12-02-2021 22:00,24 hrs.,wallstreetbets,AXP,3833,3833,0,3833,2,1780,265,1,NYSE
4653,12-02-2021 22:00,24 hrs.,wallstreetbets,BBW,19,6,13,-7,3,3,1,3,NYSE
4653,12-02-2021 22:00,24 hrs.,wallstreetbets,BBY,14,0,14,-14,2,2,2,1,NYSE
4653,12-02-2021 22:00,24 hrs.,wallstreetbets,BCH,7,7,0,7,1,1,1,1,NYSE
4653,12-02-2021 22:00,24 hrs.,wallstreetbets,BFT,7,0,7,-7,1,1,1,1,NYSE
4653,12-02-2021 22:00,24 hrs.,wallstreetbets,BGS,8,8,0,8,1,1,2,1,NYSE
4653,12-02-2021 22:00,24 hrs.,wallstreetbets,BHC,445,424,21,403,5,174,77,3,NYSE
4653,12-02-2021 22:00,24 hrs.,wallstreetbets,BIT,7,0,7,-7,1,1,1,1,NYSE
4653,12-02-2021 22:00,24 hrs.,wallstreetbets,BTT,52,19,33,-14,8,8,4,8,NYSE
4653,12-02-2021 22:00,24 hrs.,wallstreetbets,BTU,14,14,0,14,2,2,2,1,NYSE
4653,12-02-2021 22:00,24 hrs.,wallstreetbets,BUD,8,0,8,-8,1,1,2,1,NYSE
4653,12-02-2021 22:00,24 hrs.,wallstreetbets,CAT,7,7,0,7,1,1,1,1,NYSE
4653,12-02-2021 22:00,24 hrs.,wallstreetbets,CBD,28,7,21,-14,4,4,4,3,NYSE
4653,12-02-2021 22:00,24 hrs.,wallstreetbets,CCL,14,14,0,14,2,2,2,1,NYSE
4653,12-02-2021 22:00,24 hrs.,wallstreetbets,CHS,8,0,8,-8,1,1,2,1,NYSE
4653,12-02-2021 22:00,24 hrs.,wallstreetbets,CMC,15,15,0,15,1,1,9,1,NYSE
4653,12-02-2021 22:00,24 hrs.,wallstreetbets,CPE,7,7,0,7,1,1,1,1,NYSE
4653,12-02-2021 22:00,24 hrs.,wallstreetbets,CPG,7,7,0,7,1,1,1,1,NYSE
4653,12-02-2021 22:00,24 hrs.,wallstreetbets,CVA,7,0,7,-7,1,1,1,1,NYSE
4653,12-02-2021 22:00,24 hrs.,wallstreetbets,DAC,20,20,0,20,3,3,2,2,NYSE
4653,12-02-2021 22:00,24 hrs.,wallstreetbets,DAL,13,13,0,13,2,2,1,2,NYSE
4653,12-02-2021 22:00,24 hrs.,wallstreetbets,DAO,12,12,0,12,2,2,0,1,NYSE
4653,12-02-2021 22:00,24 hrs.,wallstreetbets,DHT,7,7,0,7,1,1,1,1,NYSE
4653,12-02-2021 22:00,24 hrs.,wallstreetbets,DIS,1650,444,1206,-762,12,680,242,12,NYSE
4653,12-02-2021 22:00,24 hrs.,wallstreetbets,DNB,7,0,7,-7,1,1,1,1,NYSE
4653,12-02-2021 22:00,24 hrs.,wallstreetbets,DOC,7,0,7,-7,1,1,1,1,NYSE
4653,12-02-2021 22:00,24 hrs.,wallstreetbets,DTE,144,144,0,144,1,42,56,1,NYSE
4653,12-02-2021 22:00,24 hrs.,wallstreetbets,DVN,7,7,0,7,1,1,1,1,NYSE
4653,12-02-2021 22:00,24 hrs.,wallstreetbets,EAT,28,14,14,0,4,4,4,4,NYSE
4653,12-02-2021 22:00,24 hrs.,wallstreetbets,EOS,13,0,13,-13,2,2,1,2,NYSE
4653,12-02-2021 22:00,24 hrs.,wallstreetbets,EPD,45,45,0,45,2,11,15,1,NYSE
4653,12-02-2021 22:00,24 hrs.,wallstreetbets,ETN,14,14,0,14,2,2,2,2,NYSE
4653,12-02-2021 22:00,24 hrs.,wallstreetbets,EXP,13,13,0,13,2,2,1,2,NYSE
4653,12-02-2021 22:00,24 hrs.,wallstreetbets,FAF,6,0,6,-6,1,1,0,1,NYSE
4653,12-02-2021 22:00,24 hrs.,wallstreetbets,FCX,103,0,103,-103,6,22,35,3,NYSE
4653,12-02-2021 22:00,24 hrs.,wallstreetbets,FDX,7,7,0,7,1,1,1,1,NYSE
4653,12-02-2021 22:00,24 hrs.,wallstreetbets,FLT,13,7,6,1,2,2,1,2,NYSE
4653,12-02-2021 22:00,24 hrs.,wallstreetbets,FMC,13,13,0,13,2,2,1,1,NYSE
4653,12-02-2021 22:00,24 hrs.,wallstreetbets,FMS,7,0,7,-7,1,1,1,1,NYSE
4653,12-02-2021 22:00,24 hrs.,wallstreetbets,FOF,6,0,6,-6,1,1,0,1,NYSE
4653,12-02-2021 22:00,24 hrs.,wallstreetbets,FRO,19,19,0,19,3,3,1,2,NYSE
4653,12-02-2021 22:00,24 hrs.,wallstreetbets,LKNCY,129,123,6,117,2,3,115,2,OTC
4653,12-02-2021 22:00,24 hrs.,wallstreetbets,LLKKF,6,0,6,-6,1,1,0,1,OTC
4653,12-02-2021 22:00,24 hrs.,wallstreetbets,LMLLF,6,0,6,-6,1,1,0,1,OTC
4653,12-02-2021 22:00,24 hrs.,wallstreetbets,LTMCF,6,0,6,-6,1,1,0,1,OTC
4653,12-02-2021 22:00,24 hrs.,wallstreetbets,LXXGF,8,0,8,-8,1,1,2,1,OTC
4653,12-02-2021 22:00,24 hrs.,wallstreetbets,MEDIF,6,0,6,-6,1,1,0,1,OTC
4653,12-02-2021 22:00,24 hrs.,wallstreetbets,MMEDF,2794,2794,0,2794,4,1162,454,3,OTC
4653,12-02-2021 22:00,24 hrs.,wallstreetbets,MNKKQ,14,0,14,-14,2,2,2,1,OTC
4653,12-02-2021 22:00,24 hrs.,wallstreetbets,MOTNF,7,7,0,7,1,1,1,1,OTC
4653,12-02-2021 22:00,24 hrs.,wallstreetbets,NMGRF,6,0,6,-6,1,1,0,1,OTC
4653,12-02-2021 22:00,24 hrs.,wallstreetbets,IBM,1828,1828,0,1828,5,800,208,5,NYSE
4653,12-02-2021 22:00,24 hrs.,wallstreetbets,IVR,55,49,6,43,8,7,9,6,NYSE
4653,12-02-2021 22:00,24 hrs.,wallstreetbets,JNJ,13,7,6,1,2,2,1,2,NYSE
4653,12-02-2021 22:00,24 hrs.,wallstreetbets,KMI,45,45,0,45,2,11,15,1,NYSE
4653,12-02-2021 22:00,24 hrs.,wallstreetbets,KMX,103,0,103,-103,1,32,35,1,NYSE
4653,12-02-2021 22:00,24 hrs.,wallstreetbets,KOS,12,12,0,12,2,2,0,1,NYSE
4653,12-02-2021 22:00,24 hrs.,wallstreetbets,LAC,19,0,19,-19,3,3,1,3,NYSE
4653,12-02-2021 22:00,24 hrs.,wallstreetbets,LEN,6,0,6,-6,1,1,0,1,NYSE
4653,12-02-2021 22:00,24 hrs.,wallstreetbets,LMT,7,0,7,-7,1,1,1,1,NYSE
4653,12-02-2021 22:00,24 hrs.,wallstreetbets,LOW,22,22,0,22,3,3,4,2,NYSE
4653,12-02-2021 22:00,24 hrs.,wallstreetbets,LTC,7,0,7,-7,1,1,1,1,NYSE
4653,12-02-2021 22:00,24 hrs.,wallstreetbets,MAC,9,9,0,9,1,1,3,1,NYSE
4653,12-02-2021 22:00,24 hrs.,wallstreetbets,MBI,14,14,0,14,2,2,2,2,NYSE
4653,12-02-2021 22:00,24 hrs.,wallstreetbets,MCO,417,417,0,417,1,170,73,1,NYSE
4653,12-02-2021 22:00,24 hrs.,wallstreetbets,MFA,7,7,0,7,1,1,1,1,NYSE
4653,12-02-2021 22:00,24 hrs.,wallstreetbets,MIN,7,7,0,7,1,1,1,1,NYSE
4653,12-02-2021 22:00,24 hrs.,wallstreetbets,MRO,429,423,6,417,3,172,73,3,NYSE
4653,12-02-2021 22:00,24 hrs.,wallstreetbets,MSM,7,7,0,7,1,1,1,1,NYSE
4653,12-02-2021 22:00,24 hrs.,wallstreetbets,MTL,6,0,6,-6,1,1,0,1,NYSE
4653,12-02-2021 22:00,24 hrs.,wallstreetbets,NAT,27,20,7,13,4,3,5,4,NYSE
4653,12-02-2021 22:00,24 hrs.,wallstreetbets,NET,13,7,6,1,2,2,1,2,NYSE
4653,12-02-2021 22:00,24 hrs.,wallstreetbets,NGA,12,6,6,0,2,2,0,2,NYSE
4653,12-02-2021 22:00,24 hrs.,wallstreetbets,NIO,959,528,431,97,16,288,319,15,NYSE
4653,12-02-2021 22:00,24 hrs.,wallstreetbets,NLY,7,7,0,7,1,1,1,1,NYSE
4653,12-02-2021 22:00,24 hrs.,wallstreetbets,NOC,7,0,7,-7,1,1,1,1,NYSE
4653,12-02-2021 22:00,24 hrs.,wallstreetbets,NOK,2111,2024,87,1937,32,824,335,28,NYSE
4653,12-02-2021 22:00,24 hrs.,wallstreetbets,NOV,6,6,0,6,1,1,0,1,NYSE
4653,12-02-2021 22:00,24 hrs.,wallstreetbets,NRG,35,35,0,35,5,5,5,1,NYSE
4653,12-02-2021 22:00,24 hrs.,wallstreetbets,NUS,7,7,0,7,1,1,1,1,NYSE
4653,12-02-2021 22:00,24 hrs.,wallstreetbets,NVO,35,29,6,23,2,7,13,2,NYSE
4653,12-02-2021 22:00,24 hrs.,wallstreetbets,NYC,14,7,7,0,2,2,2,2,NYSE
4653,12-02-2021 22:00,24 hrs.,wallstreetbets,OGE,7,0,7,-7,1,1,1,1,NYSE
4653,12-02-2021 22:00,24 hrs.,wallstreetbets,OPP,7,0,7,-7,1,1,1,1,NYSE
4653,12-02-2021 22:00,24 hrs.,wallstreetbets,OSK,113,113,0,113,1,30,49,1,NYSE
4653,12-02-2021 22:00,24 hrs.,wallstreetbets,OVV,5,5,0,5,1,0,1,1,NYSE
4653,12-02-2021 22:00,24 hrs.,wallstreetbets,OXY,13,0,13,-13,2,2,1,2,NYSE
4653,12-02-2021 22:00,24 hrs.,wallstreetbets,PCG,145,145,0,145,1,41,59,1,NYSE
4653,12-02-2021 22:00,24 hrs.,wallstreetbets,PDT,13,0,13,-13,2,2,1,2,NYSE
4653,12-02-2021 22:00,24 hrs.,wallstreetbets,PFE,19,13,6,7,3,3,1,3,NYSE
4653,12-02-2021 22:00,24 hrs.,wallstreetbets,PMO,7,0,7,-7,1,1,1,1,NYSE
4653,12-02-2021 22:00,24 hrs.,wallstreetbets,PSA,75,68,7,61,8,9,25,6,NYSE
4653,12-02-2021 22:00,24 hrs.,wallstreetbets,PSX,7420,0,7420,-7420,1,3200,1016,1,NYSE
4653,12-02-2021 22:00,24 hrs.,wallstreetbets,PVL,13,13,0,13,2,2,1,1,NYSE
4653,12-02-2021 22:00,24 hrs.,wallstreetbets,RDY,13,7,6,1,2,2,1,2,NYSE
4653,12-02-2021 22:00,24 hrs.,wallstreetbets,RKT,293,54,239,-185,15,84,65,11,NYSE
4653,12-02-2021 22:00,24 hrs.,wallstreetbets,RMO,83,69,14,55,12,12,11,8,NYSE
4653,12-02-2021 22:00,24 hrs.,wallstreetbets,RPT,7,7,0,7,1,1,1,1,NYSE
4653,12-02-2021 22:00,24 hrs.,wallstreetbets,RSI,12,6,6,0,2,2,0,2,NYSE
4653,12-02-2021 22:00,24 hrs.,wallstreetbets,RTP,6,6,0,6,1,1,0,1,NYSE
4653,12-02-2021 22:00,24 hrs.,wallstreetbets,RTX,7,0,7,-7,1,1,1,1,NYSE
4653,12-02-2021 22:00,24 hrs.,wallstreetbets,SBE,18,6,12,-6,3,3,0,3,NYSE
4653,12-02-2021 22:00,24 hrs.,wallstreetbets,SBI,7,0,7,-7,1,1,1,1,NYSE
4653,12-02-2021 22:00,24 hrs.,wallstreetbets,SCI,611,0,611,-611,3,228,143,2,NYSE
4653,12-02-2021 22:00,24 hrs.,wallstreetbets,SKM,30,0,30,-30,1,0,26,1,NYSE
4653,12-02-2021 22:00,24 hrs.,wallstreetbets,LODE,13,13,0,13,2,2,1,2,AMEX
4653,12-02-2021 22:00,24 hrs.,wallstreetbets,NSPR,7,0,7,-7,1,1,1,1,AMEX
4653,12-02-2021 22:00,24 hrs.,wallstreetbets,OGEN,27,20,7,13,4,4,3,4,AMEX
4653,12-02-2021 22:00,24 hrs.,wallstreetbets,RLGT,21,0,21,-21,3,3,3,1,AMEX
4653,12-02-2021 22:00,24 hrs.,wallstreetbets,SENS,223,216,7,209,13,53,65,11,AMEX
4653,12-02-2021 22:00,24 hrs.,wallstreetbets,TMBR,20,7,13,-6,3,3,2,3,AMEX
4653,12-02-2021 22:00,24 hrs.,wallstreetbets,TRXC,40,19,21,-2,6,6,4,5,AMEX
4653,12-02-2021 22:00,24 hrs.,wallstreetbets,UAVS,34,21,13,8,5,5,4,4,AMEX
4653,12-02-2021 22:00,24 hrs.,wallstreetbets,UUUU,35,21,14,7,5,5,5,3,AMEX
4653,12-02-2021 22:00,24 hrs.,wallstreetbets,YCBD,14,7,7,0,2,2,2,2,AMEX
4653,12-02-2021 22:00,24 hrs.,wallstreetbets,SUP,7,7,0,7,1,1,1,1,NYSE
4653,12-02-2021 22:00,24 hrs.,wallstreetbets,TAK,14,14,0,14,2,2,2,2,NYSE
4653,12-02-2021 22:00,24 hrs.,wallstreetbets,TAP,13,13,0,13,2,2,1,2,NYSE
4653,12-02-2021 22:00,24 hrs.,wallstreetbets,TDA,1353,0,1353,-1353,3,592,157,3,NYSE
4653,12-02-2021 22:00,24 hrs.,wallstreetbets,TDC,6,6,0,6,1,1,0,1,NYSE
4653,12-02-2021 22:00,24 hrs.,wallstreetbets,TFC,7,7,0,7,1,1,1,1,NYSE
4653,12-02-2021 22:00,24 hrs.,wallstreetbets,THC,7,7,0,7,1,1,1,1,NYSE
4653,12-02-2021 22:00,24 hrs.,wallstreetbets,THR,8,0,8,-8,1,1,2,1,NYSE
4653,12-02-2021 22:00,24 hrs.,wallstreetbets,TRQ,6,6,0,6,1,1,0,1,NYSE
4653,12-02-2021 22:00,24 hrs.,wallstreetbets,TRU,7,7,0,7,1,1,1,1,NYSE
4653,12-02-2021 22:00,24 hrs.,wallstreetbets,TSM,468,456,12,444,4,117,218,3,NYSE
4653,12-02-2021 22:00,24 hrs.,wallstreetbets,TSN,3833,3833,0,3833,2,1780,265,1,NYSE
4653,12-02-2021 22:00,24 hrs.,wallstreetbets,TTM,6,6,0,6,1,1,0,1,NYSE
4653,12-02-2021 22:00,24 hrs.,wallstreetbets,TWO,7,7,0,7,1,1,1,1,NYSE
4653,12-02-2021 22:00,24 hrs.,wallstreetbets,UBS,20,7,13,-6,3,3,2,2,NYSE
4653,12-02-2021 22:00,24 hrs.,wallstreetbets,UNP,7,7,0,7,1,1,1,1,NYSE
4653,12-02-2021 22:00,24 hrs.,wallstreetbets,UTZ,771,771,0,771,1,291,185,1,NYSE
4653,12-02-2021 22:00,24 hrs.,wallstreetbets,VET,14,0,14,-14,2,2,2,2,NYSE
4653,12-02-2021 22:00,24 hrs.,wallstreetbets,VGR,7,7,0,7,1,1,1,1,NYSE
4653,12-02-2021 22:00,24 hrs.,wallstreetbets,VHC,7,7,0,7,1,1,1,1,NYSE
4653,12-02-2021 22:00,24 hrs.,wallstreetbets,VRT,126,126,0,126,2,45,28,1,NYSE
4653,12-02-2021 22:00,24 hrs.,wallstreetbets,VST,35,35,0,35,5,5,5,1,NYSE
4653,12-02-2021 22:00,24 hrs.,wallstreetbets,WFC,7,7,0,7,1,1,1,1,NYSE
4653,12-02-2021 22:00,24 hrs.,wallstreetbets,WLL,6,6,0,6,1,1,0,1,NYSE
4653,12-02-2021 22:00,24 hrs.,wallstreetbets,WMC,8,8,0,8,1,1,2,1,NYSE
4653,12-02-2021 22:00,24 hrs.,wallstreetbets,WMT,20,13,7,6,3,3,2,3,NYSE
4653,12-02-2021 22:00,24 hrs.,wallstreetbets,WWE,7,0,7,-7,1,1,1,1,NYSE
4653,12-02-2021 22:00,24 hrs.,wallstreetbets,ABEV,7,7,0,7,1,1,1,1,NYSE
4653,12-02-2021 22:00,24 hrs.,wallstreetbets,ACIC,27,20,7,13,4,4,3,4,NYSE
4653,12-02-2021 22:00,24 hrs.,wallstreetbets,APRN,6,6,0,6,1,1,0,1,NYSE
4653,12-02-2021 22:00,24 hrs.,wallstreetbets,ARGO,6,6,0,6,1,1,0,1,NYSE
4653,12-02-2021 22:00,24 hrs.,wallstreetbets,ATUS,14,14,0,14,2,2,2,1,NYSE
4653,12-02-2021 22:00,24 hrs.,wallstreetbets,BABA,164,158,6,152,4,45,58,4,NYSE
4653,12-02-2021 22:00,24 hrs.,wallstreetbets,BNED,6,6,0,6,1,1,0,1,NYSE
4653,12-02-2021 22:00,24 hrs.,wallstreetbets,CARS,6,6,0,6,1,1,0,1,NYSE
4653,12-02-2021 22:00,24 hrs.,wallstreetbets,CCIV,337,177,160,17,49,49,43,39,NYSE
4653,12-02-2021 22:00,24 hrs.,wallstreetbets,CHWY,110,7,103,-96,2,33,36,2,NYSE
4653,12-02-2021 22:00,24 hrs.,wallstreetbets,CLDR,161,6,155,-149,2,48,57,2,NYSE
4653,12-02-2021 22:00,24 hrs.,wallstreetbets,CLII,7,7,0,7,1,1,1,1,NYSE
4653,12-02-2021 22:00,24 hrs.,wallstreetbets,COTY,6,0,6,-6,1,1,0,1,NYSE
4653,12-02-2021 22:00,24 hrs.,wallstreetbets,CVNA,103,0,103,-103,1,32,35,1,NYSE
4653,12-02-2021 22:00,24 hrs.,wallstreetbets,DASH,26,0,26,-26,3,2,10,2,NYSE
4653,12-02-2021 22:00,24 hrs.,wallstreetbets,DECK,7,0,7,-7,1,1,1,1,NYSE
4653,12-02-2021 22:00,24 hrs.,wallstreetbets,EXPR,15,15,0,15,2,2,3,2,NYSE
4653,12-02-2021 22:00,24 hrs.,wallstreetbets,FEDU,7,7,0,7,1,1,1,1,NYSE
4653,12-02-2021 22:00,24 hrs.,wallstreetbets,FENG,6,0,6,-6,1,1,0,1,NYSE
4653,12-02-2021 22:00,24 hrs.,wallstreetbets,FINV,14,0,14,-14,2,2,2,1,NYSE
4653,12-02-2021 22:00,24 hrs.,wallstreetbets,FLOW,7,7,0,7,1,1,1,1,NYSE
4653,12-02-2021 22:00,24 hrs.,wallstreetbets,FSLY,14,14,0,14,2,2,2,2,NYSE
4653,12-02-2021 22:00,24 hrs.,wallstreetbets,FUBO,805,785,20,765,6,296,189,6,NYSE
4653,12-02-2021 22:00,24 hrs.,wallstreetbets,FUSE,30,30,0,30,4,4,6,2,NYSE
4653,12-02-2021 22:00,24 hrs.,wallstreetbets,FVRR,15,7,8,-1,2,2,3,2,NYSE
4653,12-02-2021 22:00,24 hrs.,wallstreetbets,GPRK,7,7,0,7,1,1,1,1,NYSE
4653,12-02-2021 22:00,24 hrs.,wallstreetbets,HEXO,7,7,0,7,1,1,1,1,NYSE
4653,12-02-2021 22:00,24 hrs.,wallstreetbets,FSD,14,14,0,14,2,2,2,2,NYSE
4653,12-02-2021 22:00,24 hrs.,wallstreetbets,FSR,747,239,508,-269,41,217,149,21,NYSE
4653,12-02-2021 22:00,24 hrs.,wallstreetbets,FTI,27,20,7,13,4,4,3,2,NYSE
4653,12-02-2021 22:00,24 hrs.,wallstreetbets,GAM,7,7,0,7,1,1,1,1,NYSE
4653,12-02-2021 22:00,24 hrs.,wallstreetbets,GEO,42,28,14,14,6,6,6,2,NYSE
4653,12-02-2021 22:00,24 hrs.,wallstreetbets,GLW,14,7,7,0,2,2,2,2,NYSE
4653,12-02-2021 22:00,24 hrs.,wallstreetbets,GME,121574,81635,39939,41696,484,54643,10352,371,NYSE
4653,12-02-2021 22:00,24 hrs.,wallstreetbets,HMI,7,7,0,7,1,1,1,1,NYSE
4653,12-02-2021 22:00,24 hrs.,wallstreetbets,HON,6,0,6,-6,1,1,0,1,NYSE
4653,12-02-2021 22:00,24 hrs.,wallstreetbets,IAG,14,7,7,0,2,2,2,2,NYSE
4653,12-02-2021 22:00,24 hrs.,wallstreetbets,LSPD,13,6,7,-1,2,2,1,2,NYSE
4653,12-02-2021 22:00,24 hrs.,wallstreetbets,MAIN,14,0,14,-14,2,2,2,2,NYSE
4653,12-02-2021 22:00,24 hrs.,wallstreetbets,MANU,12,12,0,12,2,2,0,2,NYSE
4653,12-02-2021 22:00,24 hrs.,wallstreetbets,PACK,15,15,0,15,2,2,3,1,NYSE
4653,12-02-2021 22:00,24 hrs.,wallstreetbets,PINS,7,0,7,-7,1,1,1,1,NYSE
4653,12-02-2021 22:00,24 hrs.,wallstreetbets,PLTR,1457,1266,191,1075,56,471,291,37,NYSE
4653,12-02-2021 22:00,24 hrs.,wallstreetbets,PRTY,14,14,0,14,2,2,2,2,NYSE
4653,12-02-2021 22:00,24 hrs.,wallstreetbets,PUMP,49,49,0,49,7,7,7,2,NYSE
4653,12-02-2021 22:00,24 hrs.,wallstreetbets,QUAD,8,0,8,-8,1,1,2,1,NYSE
4653,12-02-2021 22:00,24 hrs.,wallstreetbets,SAFE,97,97,0,97,1,24,45,1,NYSE
4653,12-02-2021 22:00,24 hrs.,wallstreetbets,SCVX,6,0,6,-6,1,1,0,1,NYSE
4653,12-02-2021 22:00,24 hrs.,wallstreetbets,SHOP,7,0,7,-7,1,1,1,1,NYSE
4653,12-02-2021 22:00,24 hrs.,wallstreetbets,SPCE,907,132,775,-643,31,299,185,21,NYSE
4653,12-02-2021 22:00,24 hrs.,wallstreetbets,SPOT,7,0,7,-7,1,1,1,1,NYSE
4653,12-02-2021 22:00,24 hrs.,wallstreetbets,STWD,145,145,0,145,1,41,59,1,NYSE
4653,12-02-2021 22:00,24 hrs.,wallstreetbets,TDOC,6,0,6,-6,1,1,0,1,NYSE
4653,12-02-2021 22:00,24 hrs.,wallstreetbets,TWTR,7,7,0,7,1,1,1,1,NYSE
4653,12-02-2021 22:00,24 hrs.,wallstreetbets,UBER,40,7,33,-26,6,6,4,3,NYSE
4653,12-02-2021 22:00,24 hrs.,wallstreetbets,VALE,7,7,0,7,1,1,1,1,NYSE
4653,12-02-2021 22:00,24 hrs.,wallstreetbets,VGAC,19,19,0,19,3,3,1,3,NYSE
4653,12-02-2021 22:00,24 hrs.,wallstreetbets,WORK,2758,2744,14,2730,4,1148,446,4,NYSE
4653,12-02-2021 22:00,24 hrs.,wallstreetbets,XPEV,14,7,7,0,2,2,2,2,NYSE
4653,12-02-2021 22:00,24 hrs.,wallstreetbets,YELP,7,7,0,7,1,1,1,1,NYSE
4653,12-02-2021 22:00,24 hrs.,wallstreetbets,AAL,40,19,21,-2,6,6,4,5,NASDAQ
4653,12-02-2021 22:00,24 hrs.,wallstreetbets,AMD,2871,2051,820,1231,31,979,789,27,NASDAQ
4653,12-02-2021 22:00,24 hrs.,wallstreetbets,AQB,6,0,6,-6,1,1,0,1,NASDAQ
4653,12-02-2021 22:00,24 hrs.,wallstreetbets,ASO,6,6,0,6,1,1,0,1,NASDAQ
4653,12-02-2021 22:00,24 hrs.,wallstreetbets,AWH,13,0,13,-13,2,2,1,1,NASDAQ
4653,12-02-2021 22:00,24 hrs.,wallstreetbets,AZN,424,424,0,424,2,171,74,2,NASDAQ
4653,12-02-2021 22:00,24 hrs.,wallstreetbets,BFI,21,14,7,7,3,3,3,2,NASDAQ
4653,12-02-2021 22:00,24 hrs.,wallstreetbets,BLU,14,14,0,14,2,2,2,1,NASDAQ
4653,12-02-2021 22:00,24 hrs.,wallstreetbets,BUG,12,12,0,12,2,2,0,1,NASDAQ
4653,12-02-2021 22:00,24 hrs.,wallstreetbets,CDC,417,417,0,417,1,170,73,1,NASDAQ
4653,12-02-2021 22:00,24 hrs.,wallstreetbets,CGC,1372,82,1290,-1208,7,476,392,7,NASDAQ
4653,12-02-2021 22:00,24 hrs.,wallstreetbets,CTG,7,7,0,7,1,1,1,1,NASDAQ
4653,12-02-2021 22:00,24 hrs.,wallstreetbets,DBX,7,7,0,7,1,1,1,1,NASDAQ
4653,12-02-2021 22:00,24 hrs.,wallstreetbets,ESG,8,0,8,-8,1,1,2,1,NASDAQ
4653,12-02-2021 22:00,24 hrs.,wallstreetbets,FAT,151,151,0,151,2,43,57,2,NASDAQ
4653,12-02-2021 22:00,24 hrs.,wallstreetbets,FUV,7,7,0,7,1,1,1,1,NASDAQ
4653,12-02-2021 22:00,24 hrs.,wallstreetbets,FWP,14,14,0,14,2,2,2,1,NASDAQ
4653,12-02-2021 22:00,24 hrs.,wallstreetbets,GBT,7,7,0,7,1,1,1,1,NASDAQ
4653,12-02-2021 22:00,24 hrs.,wallstreetbets,GSM,19,13,6,7,3,3,1,3,NASDAQ
4653,12-02-2021 22:00,24 hrs.,wallstreetbets,HAS,34,0,34,-34,5,5,4,5,NASDAQ
4653,12-02-2021 22:00,24 hrs.,wallstreetbets,HPK,6,0,6,-6,1,1,0,1,NASDAQ
4653,12-02-2021 22:00,24 hrs.,wallstreetbets,IEA,7,7,0,7,1,1,1,1,NASDAQ
4653,12-02-2021 22:00,24 hrs.,wallstreetbets,III,109,0,109,-109,2,33,35,2,NASDAQ
4653,12-02-2021 22:00,24 hrs.,wallstreetbets,IIN,6,6,0,6,1,1,0,1,NASDAQ
4653,12-02-2021 22:00,24 hrs.,wallstreetbets,INO,788,88,700,-612,21,268,168,19,NASDAQ
4653,12-02-2021 22:00,24 hrs.,wallstreetbets,IPA,7,0,7,-7,1,1,1,1,NASDAQ
4653,12-02-2021 22:00,24 hrs.,wallstreetbets,KHC,13,7,6,1,2,2,1,2,NASDAQ
4653,12-02-2021 22:00,24 hrs.,wallstreetbets,KOD,6,6,0,6,1,1,0,1,NASDAQ
4653,12-02-2021 22:00,24 hrs.,wallstreetbets,MGI,9,0,9,-9,1,1,3,1,NASDAQ
4653,12-02-2021 22:00,24 hrs.,wallstreetbets,NPA,13,6,7,-1,2,2,1,2,NASDAQ
4653,12-02-2021 22:00,24 hrs.,wallstreetbets,NWL,417,417,0,417,1,170,73,1,NASDAQ
4653,12-02-2021 22:00,24 hrs.,wallstreetbets,SKT,14,0,14,-14,2,2,2,2,NYSE
4653,12-02-2021 22:00,24 hrs.,wallstreetbets,SKY,6,6,0,6,1,1,0,1,NYSE
4653,12-02-2021 22:00,24 hrs.,wallstreetbets,SNE,14,14,0,14,2,2,2,1,NYSE
4653,12-02-2021 22:00,24 hrs.,wallstreetbets,SNX,6,0,6,-6,1,1,0,1,NYSE
4653,12-02-2021 22:00,24 hrs.,wallstreetbets,SOL,14,0,14,-14,2,2,2,2,NYSE
4653,12-02-2021 22:00,24 hrs.,wallstreetbets,SOS,271,141,130,11,40,38,35,32,NYSE
4653,12-02-2021 22:00,24 hrs.,wallstreetbets,SPG,54,0,54,-54,1,0,50,1,NYSE
4653,12-02-2021 22:00,24 hrs.,wallstreetbets,SPH,13,0,13,-13,2,2,1,2,NYSE
4653,12-02-2021 22:00,24 hrs.,wallstreetbets,STM,7,7,0,7,1,1,1,1,NYSE
4653,12-02-2021 22:00,24 hrs.,wallstreetbets,SUN,6,6,0,6,1,1,0,1,NYSE
4653,12-02-2021 22:00,24 hrs.,stocks,CRSP,70,70,0,70,1,20,26,1,NASDAQ
4653,12-02-2021 22:00,24 hrs.,stocks,CRWD,70,70,0,70,1,20,26,1,NASDAQ
4653,12-02-2021 22:00,24 hrs.,stocks,CTRM,45,13,32,-19,7,7,3,6,NASDAQ
4653,12-02-2021 22:00,24 hrs.,stocks,CVLB,6,6,0,6,1,1,0,1,NASDAQ
4653,12-02-2021 22:00,24 hrs.,stocks,DDOG,10,10,0,10,1,2,2,1,NASDAQ
4653,12-02-2021 22:00,24 hrs.,stocks,DFFN,15,6,9,-3,2,3,1,2,NASDAQ
4653,12-02-2021 22:00,24 hrs.,stocks,DMTK,25,0,25,-25,1,3,15,1,NASDAQ
4653,12-02-2021 22:00,24 hrs.,stocks,DOCU,6,6,0,6,1,1,0,1,NASDAQ
4653,12-02-2021 22:00,24 hrs.,stocks,EDIT,364,364,0,364,3,120,112,3,NASDAQ
4653,12-02-2021 22:00,24 hrs.,stocks,ENPH,70,70,0,70,1,20,26,1,NASDAQ
4653,12-02-2021 22:00,24 hrs.,stocks,ENTX,7,0,7,-7,1,1,1,1,NASDAQ
4653,12-02-2021 22:00,24 hrs.,stocks,ETSY,23,0,23,-23,1,3,13,1,NASDAQ
4653,12-02-2021 22:00,24 hrs.,stocks,EVFM,20,0,20,-20,2,6,0,2,NASDAQ
4653,12-02-2021 22:00,24 hrs.,stocks,EXAS,25,0,25,-25,1,3,15,1,NASDAQ
4653,12-02-2021 22:00,24 hrs.,stocks,EXPE,10,10,0,10,1,2,2,1,NASDAQ
4653,12-02-2021 22:00,24 hrs.,stocks,EXPI,6,6,0,6,1,1,0,1,NASDAQ
4653,12-02-2021 22:00,24 hrs.,stocks,FLXN,25,0,25,-25,1,7,7,1,NASDAQ
4653,12-02-2021 22:00,24 hrs.,stocks,FNKO,20,20,0,20,1,7,2,1,NASDAQ
4653,12-02-2021 22:00,24 hrs.,stocks,FSRV,6,0,6,-6,1,1,0,1,NASDAQ
4653,12-02-2021 22:00,24 hrs.,stocks,GILT,6,6,0,6,1,1,0,1,NASDAQ
4653,12-02-2021 22:00,24 hrs.,stocks,GLUU,7,7,0,7,1,1,1,1,NASDAQ
4653,12-02-2021 22:00,24 hrs.,stocks,GNUS,6,0,6,-6,1,1,0,1,NASDAQ
4653,12-02-2021 22:00,24 hrs.,stocks,GOEV,116,116,0,116,1,17,78,1,NASDAQ
4653,12-02-2021 22:00,24 hrs.,stocks,GTHX,6,0,6,-6,1,1,0,1,NASDAQ
4653,12-02-2021 22:00,24 hrs.,stocks,HTBX,6,0,6,-6,1,1,0,1,NASDAQ
4653,12-02-2021 22:00,24 hrs.,stocks,ICLN,75,75,0,75,1,22,27,1,NASDAQ
4653,12-02-2021 22:00,24 hrs.,stocks,IIVI,10,10,0,10,1,2,2,1,NASDAQ
4653,12-02-2021 22:00,24 hrs.,stocks,ILMN,15,15,0,15,1,5,1,1,NASDAQ
4653,12-02-2021 22:00,24 hrs.,stocks,INPX,18,0,18,-18,3,3,0,1,NASDAQ
4653,12-02-2021 22:00,24 hrs.,stocks,INTC,99,99,0,99,1,34,27,1,NASDAQ
4653,12-02-2021 22:00,24 hrs.,stocks,INVE,7,7,0,7,1,1,1,1,NASDAQ
4653,12-02-2021 22:00,24 hrs.,stocks,ITRM,9,9,0,9,1,2,1,1,NASDAQ
4653,12-02-2021 22:00,24 hrs.,stocks,KPTI,25,0,25,-25,1,7,7,1,NASDAQ
4653,12-02-2021 22:00,24 hrs.,stocks,LITE,10,10,0,10,1,2,2,1,NASDAQ
4653,12-02-2021 22:00,24 hrs.,stocks,LIVE,10,10,0,10,1,2,2,1,NASDAQ
4653,12-02-2021 22:00,24 hrs.,stocks,LKCO,12,12,0,12,2,2,0,1,NASDAQ
4653,12-02-2021 22:00,24 hrs.,stocks,LLNW,16,16,0,16,1,2,8,1,NASDAQ
4653,12-02-2021 22:00,24 hrs.,stocks,LMPX,20,20,0,20,1,7,2,1,NASDAQ
4653,12-02-2021 22:00,24 hrs.,stocks,LRCX,46,46,0,46,1,7,28,1,NASDAQ
4653,12-02-2021 22:00,24 hrs.,stocks,MGNI,60,0,60,-60,1,12,32,1,NASDAQ
4653,12-02-2021 22:00,24 hrs.,stocks,MKSI,10,10,0,10,1,2,2,1,NASDAQ
4653,12-02-2021 22:00,24 hrs.,stocks,MNPR,6,0,6,-6,1,1,0,1,NASDAQ
4653,12-02-2021 22:00,24 hrs.,stocks,MSFT,229,146,83,63,3,72,73,3,NASDAQ
4653,12-02-2021 22:00,24 hrs.,stocks,MSTR,6,0,6,-6,1,1,0,1,NASDAQ
4653,12-02-2021 22:00,24 hrs.,stocks,NAKD,6,6,0,6,1,1,0,1,NASDAQ
4653,12-02-2021 22:00,24 hrs.,stocks,NBAC,6,6,0,6,1,1,0,1,NASDAQ
4653,12-02-2021 22:00,24 hrs.,stocks,NCMI,58,58,0,58,2,21,8,1,NASDAQ
4653,12-02-2021 22:00,24 hrs.,stocks,NMTR,9,9,0,9,1,1,3,1,NASDAQ
4653,12-02-2021 22:00,24 hrs.,stocks,NVDA,156,73,83,-10,4,28,84,4,NASDAQ
4653,12-02-2021 22:00,24 hrs.,stocks,NXTD,12,12,0,12,2,2,0,1,NASDAQ
4653,12-02-2021 22:00,24 hrs.,stocks,NYMT,8,0,8,-8,1,1,2,1,NASDAQ
4653,12-02-2021 22:00,24 hrs.,stocks,OCSL,12,12,0,12,2,2,0,1,NASDAQ
4653,12-02-2021 22:00,24 hrs.,stocks,OLED,100,100,0,100,1,45,6,1,NASDAQ
4653,12-02-2021 22:00,24 hrs.,stocks,ONTX,6,6,0,6,1,1,0,1,NASDAQ
4653,12-02-2021 22:00,24 hrs.,wallstreetbets,HUBS,13,13,0,13,2,2,1,2,NYSE
4653,12-02-2021 22:00,24 hrs.,wallstreetbets,HUYA,36,21,15,6,5,5,6,4,NYSE
4653,12-02-2021 22:00,24 hrs.,wallstreetbets,HYLN,560,447,113,334,28,154,140,24,NYSE
4653,12-02-2021 22:00,24 hrs.,wallstreetbets,IIPR,20,20,0,20,3,3,2,2,NYSE
4653,12-02-2021 22:00,24 hrs.,wallstreetbets,IPOE,13,7,6,1,2,2,1,2,NYSE
4653,12-02-2021 22:00,24 hrs.,wallstreetbets,JMIA,3875,3875,0,3875,8,1786,271,3,NYSE
4653,12-02-2021 22:00,24 hrs.,wallstreetbets,JNPR,6,6,0,6,1,1,0,1,NYSE
4653,12-02-2021 22:00,24 hrs.,wallstreetbets,KODK,13,13,0,13,2,2,1,1,NYSE
4653,12-02-2021 22:00,24 hrs.,wallstreetbets,LGVW,41,7,34,-27,6,6,5,5,NYSE
4653,12-02-2021 22:00,24 hrs.,wallstreetbets,LMND,6,0,6,-6,1,1,0,1,NYSE
4653,12-02-2021 22:00,24 hrs.,stocks,QCOM,14,0,14,-14,2,2,2,1,NASDAQ
4653,12-02-2021 22:00,24 hrs.,stocks,QQQM,31,0,31,-31,1,6,15,1,NASDAQ
4653,12-02-2021 22:00,24 hrs.,stocks,RGEN,25,0,25,-25,1,3,15,1,NASDAQ
4653,12-02-2021 22:00,24 hrs.,stocks,RIOT,6,0,6,-6,1,1,0,1,NASDAQ
4653,12-02-2021 22:00,24 hrs.,stocks,SABR,55,0,55,-55,1,12,27,1,NASDAQ
4653,12-02-2021 22:00,24 hrs.,stocks,SEDG,70,70,0,70,1,20,26,1,NASDAQ
4653,12-02-2021 22:00,24 hrs.,stocks,SEEL,18,0,18,-18,3,3,0,2,NASDAQ
4653,12-02-2021 22:00,24 hrs.,stocks,SESN,7,7,0,7,1,1,1,1,NASDAQ
4653,12-02-2021 22:00,24 hrs.,stocks,SHIP,11,11,0,11,1,2,3,1,NASDAQ
4653,12-02-2021 22:00,24 hrs.,stocks,SNDL,74,30,44,-14,12,12,2,11,NASDAQ
4653,12-02-2021 22:00,24 hrs.,stocks,SNGX,23,12,11,1,3,5,1,3,NASDAQ
4653,12-02-2021 22:00,24 hrs.,stocks,SPRO,25,0,25,-25,1,3,15,1,NASDAQ
4653,12-02-2021 22:00,24 hrs.,stocks,SQQQ,7,0,7,-7,1,1,1,1,NASDAQ
4653,12-02-2021 22:00,24 hrs.,stocks,SRAC,14,6,8,-2,2,3,0,2,NASDAQ
4653,12-02-2021 22:00,24 hrs.,stocks,SRNE,70,70,0,70,1,20,26,1,NASDAQ
4653,12-02-2021 22:00,24 hrs.,stocks,SSPK,49,0,49,-49,1,15,15,1,NASDAQ
4653,12-02-2021 22:00,24 hrs.,stocks,SSYS,38,0,38,-38,1,8,18,1,NASDAQ
4653,12-02-2021 22:00,24 hrs.,stocks,SVMK,10,10,0,10,1,2,2,1,NASDAQ
4653,12-02-2021 22:00,24 hrs.,stocks,SWAV,25,0,25,-25,1,3,15,1,NASDAQ
4653,12-02-2021 22:00,24 hrs.,stocks,SWKS,46,46,0,46,1,7,28,1,NASDAQ
4653,12-02-2021 22:00,24 hrs.,stocks,TLRY,1024,628,396,232,8,313,366,8,NASDAQ
4653,12-02-2021 22:00,24 hrs.,wallstreetbets,PTE,35,0,35,-35,5,5,5,1,NASDAQ
4653,12-02-2021 22:00,24 hrs.,wallstreetbets,RUN,21,14,7,7,3,3,3,3,NASDAQ
4653,12-02-2021 22:00,24 hrs.,wallstreetbets,RXT,7,7,0,7,1,1,1,1,NASDAQ
4653,12-02-2021 22:00,24 hrs.,wallstreetbets,SDC,6,6,0,6,1,1,0,1,NASDAQ
4653,12-02-2021 22:00,24 hrs.,wallstreetbets,SFT,7,7,0,7,1,1,1,1,NASDAQ
4653,12-02-2021 22:00,24 hrs.,wallstreetbets,SLM,8,8,0,8,1,1,2,1,NASDAQ
4653,12-02-2021 22:00,24 hrs.,wallstreetbets,SMH,7,7,0,7,1,1,1,1,NASDAQ
4653,12-02-2021 22:00,24 hrs.,wallstreetbets,SND,34,27,7,20,5,5,4,5,NASDAQ
4653,12-02-2021 22:00,24 hrs.,wallstreetbets,SPI,7,7,0,7,1,1,1,1,NASDAQ
4653,12-02-2021 22:00,24 hrs.,wallstreetbets,SPT,7,7,0,7,1,1,1,1,NASDAQ
4653,12-02-2021 22:00,24 hrs.,wallstreetbets,UAL,7,0,7,-7,1,1,1,1,NASDAQ
4653,12-02-2021 22:00,24 hrs.,wallstreetbets,UFO,6,0,6,-6,1,1,0,1,NASDAQ
4653,12-02-2021 22:00,24 hrs.,wallstreetbets,VFF,22,14,8,6,3,3,4,3,NASDAQ
4653,12-02-2021 22:00,24 hrs.,wallstreetbets,VRM,103,0,103,-103,1,32,35,1,NASDAQ
4653,12-02-2021 22:00,24 hrs.,wallstreetbets,WBA,7,7,0,7,1,1,1,1,NASDAQ
4653,12-02-2021 22:00,24 hrs.,wallstreetbets,WNW,36,36,0,36,5,5,6,4,NASDAQ
4653,12-02-2021 22:00,24 hrs.,wallstreetbets,WWR,6,6,0,6,1,1,0,1,NASDAQ
4653,12-02-2021 22:00,24 hrs.,wallstreetbets,AACG,7,7,0,7,1,1,1,1,NASDAQ
4653,12-02-2021 22:00,24 hrs.,wallstreetbets,AAPL,275,26,249,-223,7,76,95,7,NASDAQ
4653,12-02-2021 22:00,24 hrs.,wallstreetbets,AAWW,6,6,0,6,1,1,0,1,NASDAQ
4653,12-02-2021 22:00,24 hrs.,wallstreetbets,ABEO,7,7,0,7,1,1,1,1,NASDAQ
4653,12-02-2021 22:00,24 hrs.,wallstreetbets,ABIO,7,0,7,-7,1,1,1,1,NASDAQ
4653,12-02-2021 22:00,24 hrs.,wallstreetbets,ABNB,29,15,14,1,4,4,5,3,NASDAQ
4653,12-02-2021 22:00,24 hrs.,wallstreetbets,ABUS,7,7,0,7,1,1,1,1,NASDAQ
4653,12-02-2021 22:00,24 hrs.,wallstreetbets,ACEV,6,6,0,6,1,1,0,1,NASDAQ
4653,12-02-2021 22:00,24 hrs.,wallstreetbets,ACIU,7,7,0,7,1,1,1,1,NASDAQ
4653,12-02-2021 22:00,24 hrs.,wallstreetbets,ACST,20,20,0,20,3,3,2,3,NASDAQ
4653,12-02-2021 22:00,24 hrs.,wallstreetbets,ADMP,7,7,0,7,1,1,1,1,NASDAQ
4653,12-02-2021 22:00,24 hrs.,wallstreetbets,ADXS,6,6,0,6,1,1,0,1,NASDAQ
4653,12-02-2021 22:00,24 hrs.,wallstreetbets,AEZS,14,14,0,14,2,2,2,1,NASDAQ
4653,12-02-2021 22:00,24 hrs.,wallstreetbets,AGEN,7,7,0,7,1,1,1,1,NASDAQ
4653,12-02-2021 22:00,24 hrs.,wallstreetbets,AGTC,50,36,14,22,7,7,8,5,NASDAQ
4653,12-02-2021 22:00,24 hrs.,wallstreetbets,AIKI,7,7,0,7,1,1,1,1,NASDAQ
4653,12-02-2021 22:00,24 hrs.,wallstreetbets,OGI,122,52,70,-18,18,18,14,16,NASDAQ
4653,12-02-2021 22:00,24 hrs.,wallstreetbets,OPK,7,7,0,7,1,1,1,1,NASDAQ
4653,12-02-2021 22:00,24 hrs.,wallstreetbets,OPT,7,0,7,-7,1,1,1,1,NASDAQ
4653,12-02-2021 22:00,24 hrs.,stocks,CLSK,45,0,45,-45,2,12,13,2,NASDAQ
4653,12-02-2021 22:00,24 hrs.,stocks,CLVS,6,0,6,-6,1,1,0,1,NASDAQ
4653,12-02-2021 22:00,24 hrs.,stocks,CMPS,12,0,12,-12,2,2,0,1,NASDAQ
4653,12-02-2021 22:00,24 hrs.,stocks,CNDT,15,0,15,-15,1,3,5,1,NASDAQ
4653,12-02-2021 22:00,24 hrs.,stocks,COHR,10,10,0,10,1,2,2,1,NASDAQ
4653,12-02-2021 22:00,24 hrs.,stocks,CPST,6,6,0,6,1,1,0,1,NASDAQ
4653,12-02-2021 22:00,24 hrs.,stocks,CREE,6,0,6,-6,1,1,0,1,NASDAQ
4653,12-02-2021 22:00,24 hrs.,wallstreetbets,APXT,29,0,29,-29,4,4,5,3,NASDAQ
4653,12-02-2021 22:00,24 hrs.,wallstreetbets,AQMS,7,0,7,-7,1,1,1,1,NASDAQ
4653,12-02-2021 22:00,24 hrs.,wallstreetbets,AQST,13,7,6,1,2,2,1,2,NASDAQ
4653,12-02-2021 22:00,24 hrs.,wallstreetbets,ARTL,89,89,0,89,13,13,11,11,NASDAQ
4653,12-02-2021 22:00,24 hrs.,wallstreetbets,ASML,12,0,12,-12,2,2,0,1,NASDAQ
4653,12-02-2021 22:00,24 hrs.,wallstreetbets,ASRT,47,41,6,35,7,7,5,7,NASDAQ
4653,12-02-2021 22:00,24 hrs.,wallstreetbets,ASYS,6,6,0,6,1,1,0,1,NASDAQ
4653,12-02-2021 22:00,24 hrs.,wallstreetbets,ATHA,7,7,0,7,1,1,1,1,NASDAQ
4653,12-02-2021 22:00,24 hrs.,wallstreetbets,ATHE,12,12,0,12,2,2,0,1,NASDAQ
4653,12-02-2021 22:00,24 hrs.,wallstreetbets,ATHX,7,0,7,-7,1,1,1,1,NASDAQ
4653,12-02-2021 22:00,24 hrs.,wallstreetbets,ATNF,7,0,7,-7,1,1,1,1,NASDAQ
4653,12-02-2021 22:00,24 hrs.,wallstreetbets,ATOS,41,34,7,27,6,6,5,5,NASDAQ
4653,12-02-2021 22:00,24 hrs.,wallstreetbets,AUPH,6,6,0,6,1,1,0,1,NASDAQ
4653,12-02-2021 22:00,24 hrs.,wallstreetbets,AUTL,14,0,14,-14,2,2,2,1,NASDAQ
4653,12-02-2021 22:00,24 hrs.,wallstreetbets,AVXL,7,7,0,7,1,1,1,1,NASDAQ
4653,12-02-2021 22:00,24 hrs.,wallstreetbets,AWRE,7,7,0,7,1,1,1,1,NASDAQ
4653,12-02-2021 22:00,24 hrs.,wallstreetbets,AXDX,21,0,21,-21,3,3,3,1,NASDAQ
4653,12-02-2021 22:00,24 hrs.,wallstreetbets,AYRO,7,7,0,7,1,1,1,1,NASDAQ
4653,12-02-2021 22:00,24 hrs.,wallstreetbets,BEAT,14,8,6,2,2,3,0,2,NASDAQ
4653,12-02-2021 22:00,24 hrs.,wallstreetbets,BIGC,35,0,35,-35,5,5,5,2,NASDAQ
4653,12-02-2021 22:00,24 hrs.,wallstreetbets,BIOC,14,7,7,0,2,2,2,2,NASDAQ
4653,12-02-2021 22:00,24 hrs.,wallstreetbets,BIVI,6,6,0,6,1,1,0,1,NASDAQ
4653,12-02-2021 22:00,24 hrs.,wallstreetbets,BLCM,6,6,0,6,1,1,0,1,NASDAQ
4653,12-02-2021 22:00,24 hrs.,wallstreetbets,BLNK,7,7,0,7,1,1,1,1,NASDAQ
4653,12-02-2021 22:00,24 hrs.,wallstreetbets,BNGO,134,127,7,120,19,20,18,11,NASDAQ
4653,12-02-2021 22:00,24 hrs.,wallstreetbets,BNTX,13,13,0,13,2,2,1,1,NASDAQ
4653,12-02-2021 22:00,24 hrs.,wallstreetbets,BOXL,7,7,0,7,1,1,1,1,NASDAQ
4653,12-02-2021 22:00,24 hrs.,wallstreetbets,BPTH,7,7,0,7,1,1,1,1,NASDAQ
4653,12-02-2021 22:00,24 hrs.,wallstreetbets,BRQS,13,6,7,-1,2,2,1,2,NASDAQ
4653,12-02-2021 22:00,24 hrs.,wallstreetbets,BTWN,7,7,0,7,1,1,1,1,NASDAQ
4653,12-02-2021 22:00,24 hrs.,wallstreetbets,CARE,49,49,0,49,7,7,7,2,NASDAQ
4653,12-02-2021 22:00,24 hrs.,wallstreetbets,CARV,14,7,7,0,2,2,2,2,NASDAQ
4653,12-02-2021 22:00,24 hrs.,wallstreetbets,CASH,14,14,0,14,2,2,2,1,NASDAQ
4653,12-02-2021 22:00,24 hrs.,wallstreetbets,CATM,7,7,0,7,1,1,1,1,NASDAQ
4653,12-02-2021 22:00,24 hrs.,wallstreetbets,CBAT,7,7,0,7,1,1,1,1,NASDAQ
4653,12-02-2021 22:00,24 hrs.,wallstreetbets,CCRC,12,12,0,12,2,2,0,1,NASDAQ
4653,12-02-2021 22:00,24 hrs.,wallstreetbets,CGIX,14,0,14,-14,2,2,2,1,NASDAQ
4653,12-02-2021 22:00,24 hrs.,wallstreetbets,CIDM,14,14,0,14,2,2,2,2,NASDAQ
4653,12-02-2021 22:00,24 hrs.,wallstreetbets,CKPT,14,14,0,14,2,2,2,2,NASDAQ
4653,12-02-2021 22:00,24 hrs.,wallstreetbets,CLBS,14,14,0,14,2,2,2,1,NASDAQ
4653,12-02-2021 22:00,24 hrs.,wallstreetbets,CLCT,6,0,6,-6,1,1,0,1,NASDAQ
4653,12-02-2021 22:00,24 hrs.,stocks,TMDX,25,0,25,-25,1,3,15,1,NASDAQ
4653,12-02-2021 22:00,24 hrs.,stocks,TNXP,6,0,6,-6,1,1,0,1,NASDAQ
4653,12-02-2021 22:00,24 hrs.,stocks,TRCH,7,7,0,7,1,1,1,1,NASDAQ
4653,12-02-2021 22:00,24 hrs.,stocks,TRVG,6,6,0,6,1,1,0,1,NASDAQ
4653,12-02-2021 22:00,24 hrs.,stocks,TSLA,262,156,106,50,9,45,136,8,NASDAQ
4653,12-02-2021 22:00,24 hrs.,stocks,VCEL,25,0,25,-25,1,3,15,1,NASDAQ
4653,12-02-2021 22:00,24 hrs.,stocks,VECO,6,0,6,-6,1,1,0,1,NASDAQ
4653,12-02-2021 22:00,24 hrs.,stocks,VRNT,14,14,0,14,1,3,4,1,NASDAQ
4653,12-02-2021 22:00,24 hrs.,stocks,VRSN,10,10,0,10,1,2,2,1,NASDAQ
4653,12-02-2021 22:00,24 hrs.,stocks,VUZI,6,6,0,6,1,1,0,1,NASDAQ
4653,12-02-2021 22:00,24 hrs.,stocks,VXRT,6,0,6,-6,1,1,0,1,NASDAQ
4653,12-02-2021 22:00,24 hrs.,stocks,VXUS,7,7,0,7,1,1,1,1,NASDAQ
4653,12-02-2021 22:00,24 hrs.,stocks,WISH,6,6,0,6,1,1,0,1,NASDAQ
4653,12-02-2021 22:00,24 hrs.,stocks,ONVO,6,6,0,6,1,1,0,1,NASDAQ
4653,12-02-2021 22:00,24 hrs.,stocks,OPRX,25,0,25,-25,1,3,15,1,NASDAQ
4653,12-02-2021 22:00,24 hrs.,stocks,PAAS,6,6,0,6,1,1,0,1,NASDAQ
4653,12-02-2021 22:00,24 hrs.,stocks,PENN,7,0,7,-7,1,1,1,1,NASDAQ
4653,12-02-2021 22:00,24 hrs.,stocks,PGNY,25,0,25,-25,1,3,15,1,NASDAQ
4653,12-02-2021 22:00,24 hrs.,stocks,PHUN,6,6,0,6,1,1,0,1,NASDAQ
4653,12-02-2021 22:00,24 hrs.,stocks,PLUG,122,122,0,122,2,18,78,2,NASDAQ
4653,12-02-2021 22:00,24 hrs.,stocks,PSTV,6,6,0,6,1,1,0,1,NASDAQ
4653,12-02-2021 22:00,24 hrs.,stocks,PYPL,636,0,636,-636,1,261,110,1,NASDAQ
4653,12-02-2021 22:00,24 hrs.,stocks,QCLN,75,75,0,75,1,22,27,1,NASDAQ
4653,12-02-2021 22:00,24 hrs.,Daytrading,INKW,8,0,8,-8,1,2,0,1,OTC
4653,12-02-2021 22:00,24 hrs.,Daytrading,LVVV,25,0,25,-25,1,7,7,1,OTC
4653,12-02-2021 22:00,24 hrs.,Daytrading,RLTR,6,0,6,-6,1,1,0,1,OTC
4653,12-02-2021 22:00,24 hrs.,Daytrading,TSTS,25,0,25,-25,1,7,7,1,OTC
4653,12-02-2021 22:00,24 hrs.,Daytrading,MNKKQ,6,0,6,-6,1,1,0,1,OTC
4653,12-02-2021 22:00,24 hrs.,Daytrading,DNN,453,453,0,453,2,186,73,2,AMEX
4653,12-02-2021 22:00,24 hrs.,Daytrading,DSS,447,447,0,447,1,185,73,1,AMEX
4653,12-02-2021 22:00,24 hrs.,Daytrading,MXC,6,6,0,6,1,1,0,1,AMEX
4653,12-02-2021 22:00,24 hrs.,Daytrading,TRX,6,0,6,-6,1,1,0,1,AMEX
4653,12-02-2021 22:00,24 hrs.,Daytrading,TRXC,6,0,6,-6,1,1,0,1,AMEX
4653,12-02-2021 22:00,24 hrs.,Daytrading,ACB,453,453,0,453,2,186,73,2,NYSE
4653,12-02-2021 22:00,24 hrs.,Daytrading,ADX,9,9,0,9,1,2,1,1,NYSE
4653,12-02-2021 22:00,24 hrs.,Daytrading,AMC,12,6,6,0,2,2,0,2,NYSE
4653,12-02-2021 22:00,24 hrs.,Daytrading,BDX,7,7,0,7,1,1,1,1,NYSE
4653,12-02-2021 22:00,24 hrs.,Daytrading,BFT,12,0,12,-12,1,3,2,1,NYSE
4653,12-02-2021 22:00,24 hrs.,Daytrading,FSR,447,447,0,447,1,185,73,1,NYSE
4653,12-02-2021 22:00,24 hrs.,Daytrading,GME,6,0,6,-6,1,1,0,1,NYSE
4653,12-02-2021 22:00,24 hrs.,Daytrading,NOK,18,0,18,-18,1,0,14,1,NYSE
4653,12-02-2021 22:00,24 hrs.,Daytrading,PDT,22,22,0,22,1,4,10,1,NYSE
4653,12-02-2021 22:00,24 hrs.,Daytrading,RTP,447,447,0,447,1,185,73,1,NYSE
4653,12-02-2021 22:00,24 hrs.,Daytrading,SCI,6,0,6,-6,1,1,0,1,NYSE
4653,12-02-2021 22:00,24 hrs.,Daytrading,WLL,6,6,0,6,1,1,0,1,NYSE
4653,12-02-2021 22:00,24 hrs.,Daytrading,CCIV,447,447,0,447,1,185,73,1,NYSE
4653,12-02-2021 22:00,24 hrs.,Daytrading,CHWY,6,6,0,6,1,1,0,1,NYSE
4653,12-02-2021 22:00,24 hrs.,Daytrading,SPCE,454,447,7,440,2,186,74,2,NYSE
4653,12-02-2021 22:00,24 hrs.,Daytrading,AMD,10,0,10,-10,1,0,6,1,NASDAQ
4653,12-02-2021 22:00,24 hrs.,Daytrading,API,131,131,0,131,1,54,19,1,NASDAQ
4653,12-02-2021 22:00,24 hrs.,Daytrading,INO,447,447,0,447,1,185,73,1,NASDAQ
4653,12-02-2021 22:00,24 hrs.,Daytrading,OGI,13,0,13,-13,1,1,7,1,NASDAQ
4653,12-02-2021 22:00,24 hrs.,Daytrading,ACST,6,6,0,6,1,1,0,1,NASDAQ
4653,12-02-2021 22:00,24 hrs.,Daytrading,APDN,447,447,0,447,1,185,73,1,NASDAQ
4653,12-02-2021 22:00,24 hrs.,Daytrading,APHA,447,447,0,447,1,185,73,1,NASDAQ
4653,12-02-2021 22:00,24 hrs.,Daytrading,ARTL,545,545,0,545,6,217,87,6,NASDAQ
4653,12-02-2021 22:00,24 hrs.,Daytrading,AZRX,7,0,7,-7,1,1,1,1,NASDAQ
4653,12-02-2021 22:00,24 hrs.,Daytrading,BNGO,39,39,0,39,1,15,5,1,NASDAQ
4653,12-02-2021 22:00,24 hrs.,Daytrading,BYND,6,0,6,-6,1,1,0,1,NASDAQ
4653,12-02-2021 22:00,24 hrs.,Daytrading,CLEU,501,501,0,501,2,206,81,2,NASDAQ
4653,12-02-2021 22:00,24 hrs.,Daytrading,CLGN,447,447,0,447,1,185,73,1,NASDAQ
4653,12-02-2021 22:00,24 hrs.,Daytrading,CLSN,447,447,0,447,1,185,73,1,NASDAQ
4653,12-02-2021 22:00,24 hrs.,Daytrading,CMLF,447,447,0,447,1,185,73,1,NASDAQ
4653,12-02-2021 22:00,24 hrs.,Daytrading,CRSR,447,447,0,447,1,185,73,1,NASDAQ
4653,12-02-2021 22:00,24 hrs.,Daytrading,EBON,6,6,0,6,1,1,0,1,NASDAQ
4653,12-02-2021 22:00,24 hrs.,Daytrading,EXPE,4,0,4,-4,1,0,0,1,NASDAQ
4653,12-02-2021 22:00,24 hrs.,Daytrading,FOLD,453,453,0,453,2,186,73,2,NASDAQ
4653,12-02-2021 22:00,24 hrs.,Daytrading,FTFT,447,447,0,447,1,185,73,1,NASDAQ
4653,12-02-2021 22:00,24 hrs.,Daytrading,IBKR,19,0,19,-19,1,4,7,1,NASDAQ
4653,12-02-2021 22:00,24 hrs.,Daytrading,LIVE,81,81,0,81,2,30,13,1,NASDAQ
4653,12-02-2021 22:00,24 hrs.,Daytrading,MARA,447,447,0,447,1,185,73,1,NASDAQ
4653,12-02-2021 22:00,24 hrs.,Daytrading,NOVN,447,447,0,447,1,185,73,1,NASDAQ
4653,12-02-2021 22:00,24 hrs.,Daytrading,OCGN,25,25,0,25,1,4,13,1,NASDAQ
4653,12-02-2021 22:00,24 hrs.,Daytrading,PLAY,10,0,10,-10,1,0,6,1,NASDAQ
4653,12-02-2021 22:00,24 hrs.,Daytrading,PLUS,11,0,11,-11,1,2,3,1,NASDAQ
4653,12-02-2021 22:00,24 hrs.,Daytrading,PYPL,447,447,0,447,1,185,73,1,NASDAQ
4653,12-02-2021 22:00,24 hrs.,Daytrading,RIDE,447,447,0,447,1,185,73,1,NASDAQ
4653,12-02-2021 22:00,24 hrs.,wallstreetbets,AKBA,7,7,0,7,1,1,1,1,NASDAQ
4653,12-02-2021 22:00,24 hrs.,wallstreetbets,ALGM,6,0,6,-6,1,1,0,1,NASDAQ
4653,12-02-2021 22:00,24 hrs.,wallstreetbets,ALJJ,7,0,7,-7,1,1,1,1,NASDAQ
4653,12-02-2021 22:00,24 hrs.,wallstreetbets,AMAT,32,13,19,-6,5,5,2,4,NASDAQ
4653,12-02-2021 22:00,24 hrs.,wallstreetbets,AMBC,8,8,0,8,1,1,2,1,NASDAQ
4653,12-02-2021 22:00,24 hrs.,wallstreetbets,AMKR,21,21,0,21,3,3,3,3,NASDAQ
4653,12-02-2021 22:00,24 hrs.,wallstreetbets,AMZN,928,109,819,-710,8,374,148,7,NASDAQ
4653,12-02-2021 22:00,24 hrs.,wallstreetbets,ANCN,7,7,0,7,1,1,1,1,NASDAQ
4653,12-02-2021 22:00,24 hrs.,wallstreetbets,APHA,79584,288,79296,-79008,71,37273,4754,59,NASDAQ
4653,12-02-2021 22:00,24 hrs.,wallstreetbets,APRE,7,7,0,7,1,1,1,1,NASDAQ
4653,12-02-2021 22:00,24 hrs.,trakstocks,SUIC,6,0,6,-6,1,1,0,1,OTC
4653,12-02-2021 22:00,24 hrs.,trakstocks,ARBKF,6,6,0,6,1,1,0,1,OTC
4653,12-02-2021 22:00,24 hrs.,wallstreetbets,CLEU,7,7,0,7,1,1,1,1,NASDAQ
4653,12-02-2021 22:00,24 hrs.,wallstreetbets,CLGN,7,7,0,7,1,1,1,1,NASDAQ
4653,12-02-2021 22:00,24 hrs.,wallstreetbets,CLSN,7,7,0,7,1,1,1,1,NASDAQ
4653,12-02-2021 22:00,24 hrs.,wallstreetbets,CLVS,28,0,28,-28,4,4,4,3,NASDAQ
4653,12-02-2021 22:00,24 hrs.,wallstreetbets,CMLF,7,0,7,-7,1,1,1,1,NASDAQ
4653,12-02-2021 22:00,24 hrs.,wallstreetbets,CMPS,2780,2765,15,2750,7,1151,450,6,NASDAQ
4653,12-02-2021 22:00,24 hrs.,wallstreetbets,CNDT,13,6,7,-1,2,2,1,2,NASDAQ
4653,12-02-2021 22:00,24 hrs.,wallstreetbets,CNSP,7,0,7,-7,1,1,1,1,NASDAQ
4653,12-02-2021 22:00,24 hrs.,wallstreetbets,COCP,7,7,0,7,1,1,1,1,NASDAQ
4653,12-02-2021 22:00,24 hrs.,wallstreetbets,CODX,7,0,7,-7,1,1,1,1,NASDAQ
4653,12-02-2021 22:00,24 hrs.,wallstreetbets,COHR,417,417,0,417,1,170,73,1,NASDAQ
4653,12-02-2021 22:00,24 hrs.,wallstreetbets,CRBP,28,21,7,14,4,4,4,4,NASDAQ
4653,12-02-2021 22:00,24 hrs.,wallstreetbets,CRNT,13,13,0,13,2,2,1,2,NASDAQ
4653,12-02-2021 22:00,24 hrs.,wallstreetbets,CRON,6,6,0,6,1,1,0,1,NASDAQ
4653,12-02-2021 22:00,24 hrs.,wallstreetbets,CRSR,5576,209,5367,-5158,12,2413,702,8,NASDAQ
4653,12-02-2021 22:00,24 hrs.,wallstreetbets,CTHR,7,7,0,7,1,1,1,1,NASDAQ
4653,12-02-2021 22:00,24 hrs.,wallstreetbets,CTMX,7,7,0,7,1,1,1,1,NASDAQ
4653,12-02-2021 22:00,24 hrs.,wallstreetbets,CTRM,370,218,152,66,55,55,40,46,NASDAQ
4653,12-02-2021 22:00,24 hrs.,wallstreetbets,DBVT,14,0,14,-14,2,2,2,1,NASDAQ
4653,12-02-2021 22:00,24 hrs.,wallstreetbets,DDOG,417,417,0,417,1,170,73,1,NASDAQ
4653,12-02-2021 22:00,24 hrs.,wallstreetbets,DFFN,14,14,0,14,2,2,2,1,NASDAQ
4653,12-02-2021 22:00,24 hrs.,wallstreetbets,DKNG,20,14,6,8,3,3,2,3,NASDAQ
4653,12-02-2021 22:00,24 hrs.,wallstreetbets,DOYU,7,7,0,7,1,1,1,1,NASDAQ
4653,12-02-2021 22:00,24 hrs.,wallstreetbets,DRRX,7,7,0,7,1,1,1,1,NASDAQ
4653,12-02-2021 22:00,24 hrs.,wallstreetbets,DSKE,7,7,0,7,1,1,1,1,NASDAQ
4653,12-02-2021 22:00,24 hrs.,wallstreetbets,DXYN,7,7,0,7,1,1,1,1,NASDAQ
4653,12-02-2021 22:00,24 hrs.,wallstreetbets,EBAY,103,0,103,-103,1,32,35,1,NASDAQ
4653,12-02-2021 22:00,24 hrs.,wallstreetbets,EBON,49,49,0,49,7,7,7,3,NASDAQ
4653,12-02-2021 22:00,24 hrs.,wallstreetbets,EDIT,2601,1332,1269,63,2,1051,491,2,NASDAQ
4653,12-02-2021 22:00,24 hrs.,wallstreetbets,EDSA,6,6,0,6,1,1,0,1,NASDAQ
4653,12-02-2021 22:00,24 hrs.,wallstreetbets,EHTH,7,7,0,7,1,1,1,1,NASDAQ
4653,12-02-2021 22:00,24 hrs.,wallstreetbets,ELSE,7,7,0,7,1,1,1,1,NASDAQ
4653,12-02-2021 22:00,24 hrs.,wallstreetbets,ENLV,8,8,0,8,1,2,0,1,NASDAQ
4653,12-02-2021 22:00,24 hrs.,wallstreetbets,ENVB,33,26,7,19,5,5,3,4,NASDAQ
4653,12-02-2021 22:00,24 hrs.,wallstreetbets,ERIC,7,0,7,-7,1,1,1,1,NASDAQ
4653,12-02-2021 22:00,24 hrs.,wallstreetbets,ESPR,7,7,0,7,1,1,1,1,NASDAQ
4653,12-02-2021 22:00,24 hrs.,wallstreetbets,ETSY,109,0,109,-109,2,33,35,2,NASDAQ
4653,12-02-2021 22:00,24 hrs.,wallstreetbets,EVER,27,21,6,15,4,4,3,4,NASDAQ
4653,12-02-2021 22:00,24 hrs.,wallstreetbets,EXPC,7,7,0,7,1,1,1,1,NASDAQ
4653,12-02-2021 22:00,24 hrs.,wallstreetbets,EXPE,417,417,0,417,1,170,73,1,NASDAQ
4653,12-02-2021 22:00,24 hrs.,wallstreetbets,EYES,26,0,26,-26,4,4,2,1,NASDAQ
4653,12-02-2021 22:00,24 hrs.,wallstreetbets,FAMI,6,6,0,6,1,1,0,1,NASDAQ
4653,12-02-2021 22:00,24 hrs.,wallstreetbets,FANG,7,0,7,-7,1,1,1,1,NASDAQ
4653,12-02-2021 22:00,24 hrs.,wallstreetbets,FARM,7,7,0,7,1,1,1,1,NASDAQ
4653,12-02-2021 22:00,24 hrs.,wallstreetbets,FAST,7,7,0,7,1,1,1,1,NASDAQ
4653,12-02-2021 22:00,24 hrs.,wallstreetbets,FCAC,8,8,0,8,1,1,2,1,NASDAQ
4653,12-02-2021 22:00,24 hrs.,wallstreetbets,FCEL,13,6,7,-1,2,2,1,2,NASDAQ
4653,12-02-2021 22:00,24 hrs.,wallstreetbets,FLDM,7,0,7,-7,1,1,1,1,NASDAQ
4653,12-02-2021 22:00,24 hrs.,wallstreetbets,FLGT,13,13,0,13,2,2,1,2,NASDAQ
4653,12-02-2021 22:00,24 hrs.,wallstreetbets,FLWS,15,15,0,15,2,2,3,2,NASDAQ
4653,12-02-2021 22:00,24 hrs.,wallstreetbets,FNKO,6,0,6,-6,1,1,0,1,NASDAQ
4653,12-02-2021 22:00,24 hrs.,wallstreetbets,FOLD,47,41,6,35,7,7,5,6,NASDAQ
4653,12-02-2021 22:00,24 hrs.,stocks,XCUR,6,0,6,-6,1,1,0,1,NASDAQ
4653,12-02-2021 22:00,24 hrs.,stocks,XERS,6,6,0,6,1,1,0,1,NASDAQ
4653,12-02-2021 22:00,24 hrs.,stocks,ZGNX,6,6,0,6,1,1,0,1,NASDAQ
4653,12-02-2021 22:00,24 hrs.,stocks,ZYXI,25,0,25,-25,1,3,15,1,NASDAQ
4653,12-02-2021 22:00,24 hrs.,stocks,DISCA,12,12,0,12,2,2,0,2,NASDAQ
4653,12-02-2021 22:00,24 hrs.,stocks,SRACU,6,6,0,6,1,1,0,1,NASDAQ
4653,12-02-2021 22:00,24 hrs.,stocks,SRACW,6,6,0,6,1,1,0,1,NASDAQ
4653,12-02-2021 22:00,24 hrs.,Daytrading,AABB,25,0,25,-25,1,7,7,1,OTC
4653,12-02-2021 22:00,24 hrs.,Daytrading,HCMC,25,0,25,-25,1,7,7,1,OTC
4653,12-02-2021 22:00,24 hrs.,Daytrading,IDEA,6,0,6,-6,1,1,0,1,OTC
4653,12-02-2021 22:00,24 hrs.,wallstreetbets,GLMD,21,21,0,21,3,3,3,1,NASDAQ
4653,12-02-2021 22:00,24 hrs.,wallstreetbets,GLPG,7,7,0,7,1,1,1,1,NASDAQ
4653,12-02-2021 22:00,24 hrs.,wallstreetbets,GLSI,8,0,8,-8,1,1,2,1,NASDAQ
4653,12-02-2021 22:00,24 hrs.,wallstreetbets,GLUU,31,31,0,31,2,1,21,1,NASDAQ
4653,12-02-2021 22:00,24 hrs.,wallstreetbets,GMBL,7,7,0,7,1,1,1,1,NASDAQ
4653,12-02-2021 22:00,24 hrs.,wallstreetbets,GNOG,13,0,13,-13,2,2,1,2,NASDAQ
4653,12-02-2021 22:00,24 hrs.,wallstreetbets,GNRS,14,14,0,14,2,2,2,1,NASDAQ
4653,12-02-2021 22:00,24 hrs.,wallstreetbets,GNUS,13,13,0,13,2,2,1,2,NASDAQ
4653,12-02-2021 22:00,24 hrs.,wallstreetbets,GOGO,32,13,19,-6,5,5,2,4,NASDAQ
4653,12-02-2021 22:00,24 hrs.,wallstreetbets,GOLD,29,13,16,-3,4,4,5,4,NASDAQ
4653,12-02-2021 22:00,24 hrs.,wallstreetbets,GRIL,26,7,19,-12,4,4,2,4,NASDAQ
4653,12-02-2021 22:00,24 hrs.,wallstreetbets,GRTS,6,6,0,6,1,1,0,1,NASDAQ
4653,12-02-2021 22:00,24 hrs.,wallstreetbets,GRWG,13,0,13,-13,2,2,1,2,NASDAQ
4653,12-02-2021 22:00,24 hrs.,wallstreetbets,GTEC,8,8,0,8,1,1,2,1,NASDAQ
4653,12-02-2021 22:00,24 hrs.,wallstreetbets,GTHX,32,25,7,18,5,5,2,4,NASDAQ
4653,12-02-2021 22:00,24 hrs.,wallstreetbets,GWPH,13,13,0,13,1,0,9,1,NASDAQ
4653,12-02-2021 22:00,24 hrs.,wallstreetbets,HALO,14,14,0,14,2,2,2,2,NASDAQ
4653,12-02-2021 22:00,24 hrs.,wallstreetbets,HDSN,7,7,0,7,1,1,1,1,NASDAQ
4653,12-02-2021 22:00,24 hrs.,wallstreetbets,HEPA,9,0,9,-9,1,1,3,1,NASDAQ
4653,12-02-2021 22:00,24 hrs.,wallstreetbets,HIMX,7,0,7,-7,1,1,1,1,NASDAQ
4653,12-02-2021 22:00,24 hrs.,wallstreetbets,HJLI,14,14,0,14,2,2,2,1,NASDAQ
4653,12-02-2021 22:00,24 hrs.,trakstocks,BBXIA,6,6,0,6,1,1,0,1,OTC
4653,12-02-2021 22:00,24 hrs.,trakstocks,HUTMF,16,0,16,-16,1,3,6,1,OTC
4653,12-02-2021 22:00,24 hrs.,trakstocks,NMGRF,33,33,0,33,1,11,7,1,OTC
4653,12-02-2021 22:00,24 hrs.,trakstocks,NXTTF,14,14,0,14,1,5,0,1,OTC
4653,12-02-2021 22:00,24 hrs.,trakstocks,PYRNF,6,6,0,6,1,1,0,1,OTC
4653,12-02-2021 22:00,24 hrs.,trakstocks,DNN,48,48,0,48,1,18,8,1,AMEX
4653,12-02-2021 22:00,24 hrs.,trakstocks,TRXC,163,82,81,1,2,57,41,2,AMEX
4653,12-02-2021 22:00,24 hrs.,trakstocks,UUUU,49,0,49,-49,1,13,19,1,AMEX
4653,12-02-2021 22:00,24 hrs.,trakstocks,AMC,72,25,47,-22,2,16,32,2,NYSE
4653,12-02-2021 22:00,24 hrs.,trakstocks,CPS,93,0,93,-93,1,42,5,1,NYSE
4653,12-02-2021 22:00,24 hrs.,trakstocks,GME,72,25,47,-22,2,16,32,2,NYSE
4653,12-02-2021 22:00,24 hrs.,trakstocks,LEN,9,0,9,-9,1,2,1,1,NYSE
4653,12-02-2021 22:00,24 hrs.,trakstocks,NAV,47,0,47,-47,1,14,15,1,NYSE
4653,12-02-2021 22:00,24 hrs.,trakstocks,PCG,47,0,47,-47,1,14,15,1,NYSE
4653,12-02-2021 22:00,24 hrs.,trakstocks,RKT,47,0,47,-47,1,14,15,1,NYSE
4653,12-02-2021 22:00,24 hrs.,trakstocks,SOL,8,8,0,8,1,2,0,1,NYSE
4653,12-02-2021 22:00,24 hrs.,trakstocks,SOS,16,16,0,16,1,6,0,1,NYSE
4653,12-02-2021 22:00,24 hrs.,trakstocks,SPH,14,0,14,-14,1,5,0,1,NYSE
4653,12-02-2021 22:00,24 hrs.,trakstocks,WPF,6,0,6,-6,1,1,0,1,NYSE
4653,12-02-2021 22:00,24 hrs.,trakstocks,ARGO,6,6,0,6,1,1,0,1,NYSE
4653,12-02-2021 22:00,24 hrs.,trakstocks,BEKE,47,0,47,-47,1,14,15,1,NYSE
4653,12-02-2021 22:00,24 hrs.,trakstocks,CCIV,41,0,41,-41,4,9,7,3,NYSE
4653,12-02-2021 22:00,24 hrs.,trakstocks,MDLY,6,0,6,-6,1,1,0,1,NYSE
4653,12-02-2021 22:00,24 hrs.,trakstocks,SKLZ,6,0,6,-6,1,1,0,1,NYSE
4653,12-02-2021 22:00,24 hrs.,trakstocks,STIC,29,0,29,-29,1,9,7,1,NYSE
4653,12-02-2021 22:00,24 hrs.,trakstocks,AQB,6,6,0,6,1,1,0,1,NASDAQ
4653,12-02-2021 22:00,24 hrs.,trakstocks,OEG,13,13,0,13,1,3,3,1,NASDAQ
4653,12-02-2021 22:00,24 hrs.,trakstocks,ABEO,12,0,12,-12,1,4,0,1,NASDAQ
4653,12-02-2021 22:00,24 hrs.,trakstocks,APPS,6,6,0,6,1,1,0,1,NASDAQ
4653,12-02-2021 22:00,24 hrs.,trakstocks,AYRO,49,49,0,49,1,15,15,1,NASDAQ
4653,12-02-2021 22:00,24 hrs.,trakstocks,BHTG,265,265,0,265,1,97,67,1,NASDAQ
4653,12-02-2021 22:00,24 hrs.,trakstocks,CFII,47,47,0,47,1,15,13,1,NASDAQ
4653,12-02-2021 22:00,24 hrs.,trakstocks,CHEF,26,0,26,-26,1,8,6,1,NASDAQ
4653,12-02-2021 22:00,24 hrs.,Daytrading,RIOT,447,447,0,447,1,185,73,1,NASDAQ
4653,12-02-2021 22:00,24 hrs.,Daytrading,SNDL,13,0,13,-13,1,1,7,1,NASDAQ
4653,12-02-2021 22:00,24 hrs.,Daytrading,STAY,35,35,0,35,1,15,1,1,NASDAQ
4653,12-02-2021 22:00,24 hrs.,Daytrading,TLRY,460,447,13,434,2,186,80,2,NASDAQ
4653,12-02-2021 22:00,24 hrs.,Daytrading,WAFU,54,54,0,54,1,21,8,1,NASDAQ
4653,12-02-2021 22:00,24 hrs.,Daytrading,XERS,447,447,0,447,1,185,73,1,NASDAQ
4653,12-02-2021 22:00,24 hrs.,trakstocks,ALPP,6,6,0,6,1,1,0,1,OTC
4653,12-02-2021 22:00,24 hrs.,trakstocks,BRTX,6,6,0,6,1,1,0,1,OTC
4653,12-02-2021 22:00,24 hrs.,trakstocks,MMEX,20,20,0,20,2,3,6,2,OTC
4653,12-02-2021 22:00,24 hrs.,trakstocks,MOST,6,6,0,6,1,1,0,1,OTC
4653,12-02-2021 22:00,24 hrs.,trakstocks,RIOT,30,14,16,-2,3,5,8,3,NASDAQ
4653,12-02-2021 22:00,24 hrs.,trakstocks,TTCF,26,0,26,-26,1,8,6,1,NASDAQ
4653,12-02-2021 22:00,24 hrs.,trakstocks,USWS,257,0,257,-257,2,98,53,2,NASDAQ
4653,12-02-2021 22:00,24 hrs.,trakstocks,VNDA,10,0,10,-10,1,3,0,1,NASDAQ
4653,12-02-2021 22:00,24 hrs.,trakstocks,VRME,8,0,8,-8,1,2,0,1,NASDAQ
4653,12-02-2021 22:00,24 hrs.,trakstocks,XSPA,25,0,25,-25,1,8,5,1,NASDAQ
4653,12-02-2021 22:00,24 hrs.,StockMarket,ABML,6,6,0,6,1,1,0,1,OTC
4653,12-02-2021 22:00,24 hrs.,StockMarket,BOTY,42,8,34,-26,3,5,20,2,OTC
4653,12-02-2021 22:00,24 hrs.,StockMarket,DIGI,6,0,6,-6,1,1,0,1,OTC
4653,12-02-2021 22:00,24 hrs.,StockMarket,FMCC,98,0,98,-98,1,27,40,1,OTC
4653,12-02-2021 22:00,24 hrs.,StockMarket,FNMA,98,0,98,-98,1,27,40,1,OTC
4653,12-02-2021 22:00,24 hrs.,StockMarket,GTVH,6,6,0,6,1,1,0,1,OTC
4653,12-02-2021 22:00,24 hrs.,StockMarket,HCMC,52,0,52,-52,2,18,8,2,OTC
4653,12-02-2021 22:00,24 hrs.,StockMarket,HEMP,6,6,0,6,1,1,0,1,OTC
4653,12-02-2021 22:00,24 hrs.,StockMarket,KGET,6,6,0,6,1,1,0,1,OTC
4653,12-02-2021 22:00,24 hrs.,StockMarket,KWBT,6,6,0,6,1,1,0,1,OTC
4653,12-02-2021 22:00,24 hrs.,StockMarket,LINK,13,13,0,13,1,3,3,1,OTC
4653,12-02-2021 22:00,24 hrs.,StockMarket,MAXD,35,35,0,35,3,9,5,3,OTC
4653,12-02-2021 22:00,24 hrs.,StockMarket,MOST,13,13,0,13,1,3,3,1,OTC
4653,12-02-2021 22:00,24 hrs.,StockMarket,PCTL,6,6,0,6,1,1,0,1,OTC
4653,12-02-2021 22:00,24 hrs.,StockMarket,PHIL,6,6,0,6,1,1,0,1,OTC
4653,12-02-2021 22:00,24 hrs.,StockMarket,RLTR,6,0,6,-6,1,1,0,1,OTC
4653,12-02-2021 22:00,24 hrs.,StockMarket,RSSV,22,22,0,22,1,8,2,1,OTC
4653,12-02-2021 22:00,24 hrs.,StockMarket,RTON,6,0,6,-6,1,1,0,1,OTC
4653,12-02-2021 22:00,24 hrs.,StockMarket,SGMD,129,129,0,129,6,29,47,2,OTC
4653,12-02-2021 22:00,24 hrs.,StockMarket,SUIC,6,0,6,-6,1,1,0,1,OTC
4653,12-02-2021 22:00,24 hrs.,StockMarket,DIGAF,6,6,0,6,1,1,0,1,OTC
4653,12-02-2021 22:00,24 hrs.,StockMarket,HTZGQ,6,6,0,6,1,1,0,1,OTC
4653,12-02-2021 22:00,24 hrs.,StockMarket,NMGRF,6,6,0,6,1,1,0,1,OTC
4653,12-02-2021 22:00,24 hrs.,StockMarket,NXGWF,23,0,23,-23,1,9,1,1,OTC
4653,12-02-2021 22:00,24 hrs.,StockMarket,RAZFF,6,6,0,6,1,1,0,1,OTC
4653,12-02-2021 22:00,24 hrs.,StockMarket,RHDGF,18,18,0,18,2,3,4,1,OTC
4653,12-02-2021 22:00,24 hrs.,StockMarket,RYCEY,12,6,6,0,2,2,0,2,OTC
4653,12-02-2021 22:00,24 hrs.,StockMarket,TFECY,18,18,0,18,3,3,0,1,OTC
4653,12-02-2021 22:00,24 hrs.,StockMarket,ZBISF,16,16,0,16,1,4,4,1,OTC
4653,12-02-2021 22:00,24 hrs.,StockMarket,DNN,29,6,23,-17,2,6,9,2,AMEX
4653,12-02-2021 22:00,24 hrs.,StockMarket,DSS,6,6,0,6,1,1,0,1,AMEX
4653,12-02-2021 22:00,24 hrs.,StockMarket,ITP,8,0,8,-8,1,1,2,1,AMEX
4653,12-02-2021 22:00,24 hrs.,StockMarket,REI,10,0,10,-10,1,3,0,1,AMEX
4653,12-02-2021 22:00,24 hrs.,StockMarket,TRX,6,6,0,6,1,1,0,1,AMEX
4653,12-02-2021 22:00,24 hrs.,StockMarket,URG,23,0,23,-23,1,5,9,1,AMEX
4653,12-02-2021 22:00,24 hrs.,StockMarket,ZOM,56,0,56,-56,3,11,22,3,AMEX
4653,12-02-2021 22:00,24 hrs.,StockMarket,GSAT,57,57,0,57,1,15,23,1,AMEX
4653,12-02-2021 22:00,24 hrs.,StockMarket,LODE,6,6,0,6,1,1,0,1,AMEX
4653,12-02-2021 22:00,24 hrs.,StockMarket,NSPR,6,6,0,6,1,1,0,1,AMEX
4653,12-02-2021 22:00,24 hrs.,StockMarket,RLGT,6,0,6,-6,1,1,0,1,AMEX
4653,12-02-2021 22:00,24 hrs.,wallstreetbets,HSTO,26,19,7,12,4,4,2,3,NASDAQ
4653,12-02-2021 22:00,24 hrs.,wallstreetbets,HTBX,14,8,6,2,2,2,2,2,NASDAQ
4653,12-02-2021 22:00,24 hrs.,wallstreetbets,ICLN,12,6,6,0,2,2,0,2,NASDAQ
4653,12-02-2021 22:00,24 hrs.,wallstreetbets,ICON,7,7,0,7,1,1,1,1,NASDAQ
4653,12-02-2021 22:00,24 hrs.,wallstreetbets,ICPT,7,7,0,7,1,1,1,1,NASDAQ
4653,12-02-2021 22:00,24 hrs.,wallstreetbets,IDEX,193,158,35,123,8,48,65,6,NASDAQ
4653,12-02-2021 22:00,24 hrs.,wallstreetbets,IFMK,14,0,14,-14,2,2,2,1,NASDAQ
4653,12-02-2021 22:00,24 hrs.,wallstreetbets,IIVI,417,417,0,417,1,170,73,1,NASDAQ
4653,12-02-2021 22:00,24 hrs.,wallstreetbets,FORD,7,7,0,7,1,1,1,1,NASDAQ
4653,12-02-2021 22:00,24 hrs.,wallstreetbets,FORM,77,77,0,77,1,28,17,1,NASDAQ
4653,12-02-2021 22:00,24 hrs.,wallstreetbets,FTFT,14,14,0,14,2,2,2,2,NASDAQ
4653,12-02-2021 22:00,24 hrs.,wallstreetbets,FUTU,771,771,0,771,1,291,185,1,NASDAQ
4653,12-02-2021 22:00,24 hrs.,wallstreetbets,GAIN,29,7,22,-15,4,4,5,4,NASDAQ
4653,12-02-2021 22:00,24 hrs.,wallstreetbets,GERN,13,6,7,-1,2,2,1,2,NASDAQ
4653,12-02-2021 22:00,24 hrs.,wallstreetbets,GEVO,186,179,7,172,10,49,48,8,NASDAQ
4653,12-02-2021 22:00,24 hrs.,wallstreetbets,GHSI,14,0,14,-14,2,2,2,1,NASDAQ
4653,12-02-2021 22:00,24 hrs.,wallstreetbets,GILT,14,14,0,14,2,2,2,2,NASDAQ
4653,12-02-2021 22:00,24 hrs.,wallstreetbets,GLBS,21,21,0,21,3,3,3,2,NASDAQ
4653,12-02-2021 22:00,24 hrs.,wallstreetbets,JAGX,20,20,0,20,3,3,2,1,NASDAQ
4653,12-02-2021 22:00,24 hrs.,wallstreetbets,JBLU,12,0,12,-12,2,2,0,2,NASDAQ
4653,12-02-2021 22:00,24 hrs.,wallstreetbets,JNCE,12,6,6,0,2,2,0,2,NASDAQ
4653,12-02-2021 22:00,24 hrs.,wallstreetbets,KERN,13,0,13,-13,2,2,1,2,NASDAQ
4653,12-02-2021 22:00,24 hrs.,wallstreetbets,KOPN,15,15,0,15,2,2,3,2,NASDAQ
4653,12-02-2021 22:00,24 hrs.,wallstreetbets,KOSS,134,134,0,134,2,37,52,2,NASDAQ
4653,12-02-2021 22:00,24 hrs.,wallstreetbets,LAKE,6,0,6,-6,1,1,0,1,NASDAQ
4653,12-02-2021 22:00,24 hrs.,wallstreetbets,LAZR,7,0,7,-7,1,1,1,1,NASDAQ
4653,12-02-2021 22:00,24 hrs.,wallstreetbets,LEGN,7,7,0,7,1,1,1,1,NASDAQ
4653,12-02-2021 22:00,24 hrs.,wallstreetbets,LGND,13,7,6,1,2,2,1,2,NASDAQ
4653,12-02-2021 22:00,24 hrs.,wallstreetbets,LIFE,20,7,13,-6,3,3,2,3,NASDAQ
4653,12-02-2021 22:00,24 hrs.,wallstreetbets,LITE,417,417,0,417,1,170,73,1,NASDAQ
4653,12-02-2021 22:00,24 hrs.,wallstreetbets,LIVE,424,424,0,424,2,171,74,2,NASDAQ
4653,12-02-2021 22:00,24 hrs.,wallstreetbets,LIVX,15,0,15,-15,2,2,3,1,NASDAQ
4653,12-02-2021 22:00,24 hrs.,wallstreetbets,LKCO,48,42,6,36,7,7,6,6,NASDAQ
4653,12-02-2021 22:00,24 hrs.,wallstreetbets,LLIT,7,7,0,7,1,1,1,1,NASDAQ
4653,12-02-2021 22:00,24 hrs.,wallstreetbets,LLNW,49,27,22,5,7,7,7,7,NASDAQ
4653,12-02-2021 22:00,24 hrs.,wallstreetbets,LOAN,14,14,0,14,2,2,2,2,NASDAQ
4653,12-02-2021 22:00,24 hrs.,wallstreetbets,LPCN,7,7,0,7,1,1,1,1,NASDAQ
4653,12-02-2021 22:00,24 hrs.,wallstreetbets,LRCX,450,450,0,450,1,114,218,1,NASDAQ
4653,12-02-2021 22:00,24 hrs.,wallstreetbets,MARA,52,14,38,-24,8,8,4,7,NASDAQ
4653,12-02-2021 22:00,24 hrs.,wallstreetbets,MARK,14,14,0,14,2,2,2,2,NASDAQ
4653,12-02-2021 22:00,24 hrs.,wallstreetbets,MBRX,38,19,19,0,6,6,2,5,NASDAQ
4653,12-02-2021 22:00,24 hrs.,wallstreetbets,MGNI,21,14,7,7,3,3,3,3,NASDAQ
4653,12-02-2021 22:00,24 hrs.,wallstreetbets,MKSI,417,417,0,417,1,170,73,1,NASDAQ
4653,12-02-2021 22:00,24 hrs.,wallstreetbets,MNPR,6,0,6,-6,1,1,0,1,NASDAQ
4653,12-02-2021 22:00,24 hrs.,wallstreetbets,MOGO,7,0,7,-7,1,1,1,1,NASDAQ
4653,12-02-2021 22:00,24 hrs.,wallstreetbets,MOSY,7,0,7,-7,1,1,1,1,NASDAQ
4653,12-02-2021 22:00,24 hrs.,wallstreetbets,MRNA,6,6,0,6,1,1,0,1,NASDAQ
4653,12-02-2021 22:00,24 hrs.,wallstreetbets,MRVL,7,7,0,7,1,1,1,1,NASDAQ
4653,12-02-2021 22:00,24 hrs.,wallstreetbets,MSFT,1339,1332,7,1325,2,599,133,2,NASDAQ
4653,12-02-2021 22:00,24 hrs.,wallstreetbets,MSTR,39,6,33,-27,6,6,3,4,NASDAQ
4653,12-02-2021 22:00,24 hrs.,wallstreetbets,MTCH,7,7,0,7,1,1,1,1,NASDAQ
4653,12-02-2021 22:00,24 hrs.,wallstreetbets,MVIS,386,357,29,328,11,120,102,9,NASDAQ
4653,12-02-2021 22:00,24 hrs.,wallstreetbets,NAKD,193,104,89,15,28,28,25,21,NASDAQ
4653,12-02-2021 22:00,24 hrs.,wallstreetbets,NBAC,14,14,0,14,2,2,2,1,NASDAQ
4653,12-02-2021 22:00,24 hrs.,wallstreetbets,NBEV,8,0,8,-8,1,2,0,1,NASDAQ
4653,12-02-2021 22:00,24 hrs.,wallstreetbets,NCLH,14,14,0,14,2,2,2,2,NASDAQ
4653,12-02-2021 22:00,24 hrs.,wallstreetbets,NDRA,7,0,7,-7,1,1,1,1,NASDAQ
4653,12-02-2021 22:00,24 hrs.,wallstreetbets,NEOS,7,7,0,7,1,1,1,1,NASDAQ
4653,12-02-2021 22:00,24 hrs.,wallstreetbets,NEPT,7,0,7,-7,1,1,1,1,NASDAQ
4653,12-02-2021 22:00,24 hrs.,wallstreetbets,NFLX,7,7,0,7,1,1,1,1,NASDAQ
4653,12-02-2021 22:00,24 hrs.,wallstreetbets,NKLA,14,0,14,-14,2,2,2,2,NASDAQ
4653,12-02-2021 22:00,24 hrs.,wallstreetbets,NLOK,7,7,0,7,1,1,1,1,NASDAQ
4653,12-02-2021 22:00,24 hrs.,wallstreetbets,NMRK,6,6,0,6,1,1,0,1,NASDAQ
4653,12-02-2021 22:00,24 hrs.,wallstreetbets,NNDM,28,21,7,14,4,4,4,2,NASDAQ
4653,12-02-2021 22:00,24 hrs.,wallstreetbets,NOVN,7,0,7,-7,1,1,1,1,NASDAQ
4653,12-02-2021 22:00,24 hrs.,wallstreetbets,NUAN,475,475,0,475,1,199,73,1,NASDAQ
4653,12-02-2021 22:00,24 hrs.,wallstreetbets,NVAX,6,0,6,-6,1,1,0,1,NASDAQ
4653,12-02-2021 22:00,24 hrs.,wallstreetbets,NVCN,20,0,20,-20,3,3,2,3,NASDAQ
4653,12-02-2021 22:00,24 hrs.,wallstreetbets,NVDA,563,563,0,563,3,115,321,3,NASDAQ
4653,12-02-2021 22:00,24 hrs.,wallstreetbets,OCGN,38,38,0,38,6,6,2,5,NASDAQ
4653,12-02-2021 22:00,24 hrs.,wallstreetbets,ONTX,7,7,0,7,1,1,1,1,NASDAQ
4653,12-02-2021 22:00,24 hrs.,wallstreetbets,ONVO,7,0,7,-7,1,1,1,1,NASDAQ
4653,12-02-2021 22:00,24 hrs.,trakstocks,CPSH,139,30,109,-79,4,54,15,4,NASDAQ
4653,12-02-2021 22:00,24 hrs.,trakstocks,EXPC,23,0,23,-23,1,9,1,1,NASDAQ
4653,12-02-2021 22:00,24 hrs.,trakstocks,FUTU,47,0,47,-47,1,14,15,1,NASDAQ
4653,12-02-2021 22:00,24 hrs.,trakstocks,GEVO,82,0,82,-82,1,34,10,1,NASDAQ
4653,12-02-2021 22:00,24 hrs.,trakstocks,GHIV,47,0,47,-47,1,14,15,1,NASDAQ
4653,12-02-2021 22:00,24 hrs.,trakstocks,GMDA,12,0,12,-12,1,1,6,1,NASDAQ
4653,12-02-2021 22:00,24 hrs.,trakstocks,GTHX,6,6,0,6,1,1,0,1,NASDAQ
4653,12-02-2021 22:00,24 hrs.,trakstocks,IBKR,47,0,47,-47,1,14,15,1,NASDAQ
4653,12-02-2021 22:00,24 hrs.,trakstocks,MARA,22,6,16,-10,2,4,6,2,NASDAQ
4653,12-02-2021 22:00,24 hrs.,trakstocks,OPRX,12,12,0,12,1,3,2,1,NASDAQ
4653,12-02-2021 22:00,24 hrs.,wallstreetbets,PLYA,20,20,0,20,3,3,2,2,NASDAQ
4653,12-02-2021 22:00,24 hrs.,StockMarket,UAVS,11,11,0,11,1,2,3,1,AMEX
4653,12-02-2021 22:00,24 hrs.,StockMarket,UUUU,23,0,23,-23,1,5,9,1,AMEX
4653,12-02-2021 22:00,24 hrs.,StockMarket,AFC,6,6,0,6,1,1,0,1,NYSE
4653,12-02-2021 22:00,24 hrs.,StockMarket,AGX,6,6,0,6,1,1,0,1,NYSE
4653,12-02-2021 22:00,24 hrs.,StockMarket,ALV,20,0,20,-20,1,3,10,1,NYSE
4653,12-02-2021 22:00,24 hrs.,StockMarket,AMC,485,29,456,-427,5,200,65,5,NYSE
4653,12-02-2021 22:00,24 hrs.,StockMarket,BHC,13,13,0,13,1,3,3,1,NYSE
4653,12-02-2021 22:00,24 hrs.,StockMarket,CIA,444,0,444,-444,1,200,40,1,NYSE
4653,12-02-2021 22:00,24 hrs.,StockMarket,DIS,13,13,0,13,1,3,3,1,NYSE
4653,12-02-2021 22:00,24 hrs.,StockMarket,FAF,6,0,6,-6,1,1,0,1,NYSE
4653,12-02-2021 22:00,24 hrs.,StockMarket,FSR,13,13,0,13,1,3,3,1,NYSE
4653,12-02-2021 22:00,24 hrs.,StockMarket,GME,545,37,508,-471,9,213,83,9,NYSE
4653,12-02-2021 22:00,24 hrs.,StockMarket,IBM,444,0,444,-444,1,200,40,1,NYSE
4653,12-02-2021 22:00,24 hrs.,StockMarket,JNJ,6,6,0,6,1,1,0,1,NYSE
4653,12-02-2021 22:00,24 hrs.,StockMarket,LAC,4,0,4,-4,1,0,0,1,NYSE
4653,12-02-2021 22:00,24 hrs.,StockMarket,LMT,23,0,23,-23,1,4,11,1,NYSE
4653,12-02-2021 22:00,24 hrs.,StockMarket,MCO,13,13,0,13,1,3,3,1,NYSE
4653,12-02-2021 22:00,24 hrs.,StockMarket,MRO,13,13,0,13,1,3,3,1,NYSE
4653,12-02-2021 22:00,24 hrs.,StockMarket,NIO,15,15,0,15,2,2,3,2,NYSE
4653,12-02-2021 22:00,24 hrs.,StockMarket,NSA,444,0,444,-444,1,200,40,1,NYSE
4653,12-02-2021 22:00,24 hrs.,StockMarket,PDT,12,0,12,-12,1,3,2,1,NYSE
4653,12-02-2021 22:00,24 hrs.,StockMarket,PHI,6,6,0,6,1,1,0,1,NYSE
4653,12-02-2021 22:00,24 hrs.,StockMarket,PSA,6,6,0,6,1,1,0,1,NYSE
4653,12-02-2021 22:00,24 hrs.,StockMarket,RSI,6,0,6,-6,1,1,0,1,NYSE
4653,12-02-2021 22:00,24 hrs.,StockMarket,SBE,6,6,0,6,1,1,0,1,NYSE
4653,12-02-2021 22:00,24 hrs.,StockMarket,SOS,31,25,6,19,4,6,3,4,NYSE
4653,12-02-2021 22:00,24 hrs.,StockMarket,TDA,12,12,0,12,1,1,6,1,NYSE
4653,12-02-2021 22:00,24 hrs.,StockMarket,TSE,41,0,41,-41,2,12,9,2,NYSE
4653,12-02-2021 22:00,24 hrs.,StockMarket,TTM,19,0,19,-19,1,3,9,1,NYSE
4653,12-02-2021 22:00,24 hrs.,StockMarket,CACI,444,0,444,-444,1,200,40,1,NYSE
4653,12-02-2021 22:00,24 hrs.,StockMarket,CCIV,32,32,0,32,2,10,4,1,NYSE
4653,12-02-2021 22:00,24 hrs.,StockMarket,CHWY,6,6,0,6,1,1,0,1,NYSE
4653,12-02-2021 22:00,24 hrs.,StockMarket,COTY,8,8,0,8,1,2,0,1,NYSE
4653,12-02-2021 22:00,24 hrs.,StockMarket,DSSI,6,6,0,6,1,1,0,1,NYSE
4653,12-02-2021 22:00,24 hrs.,StockMarket,FUSE,12,12,0,12,2,2,0,2,NYSE
4653,12-02-2021 22:00,24 hrs.,StockMarket,HYLN,13,13,0,13,1,3,3,1,NYSE
4653,12-02-2021 22:00,24 hrs.,StockMarket,LAIX,13,13,0,13,1,0,9,1,NYSE
4653,12-02-2021 22:00,24 hrs.,StockMarket,MDLY,6,0,6,-6,1,0,2,1,NYSE
4653,12-02-2021 22:00,24 hrs.,StockMarket,VGAC,10,10,0,10,1,1,4,1,NYSE
4653,12-02-2021 22:00,24 hrs.,StockMarket,XPEV,444,0,444,-444,1,200,40,1,NYSE
4653,12-02-2021 22:00,24 hrs.,StockMarket,YETI,4,0,4,-4,1,0,0,1,NYSE
4653,12-02-2021 22:00,24 hrs.,StockMarket,AMD,24,6,18,-12,3,2,8,3,NASDAQ
4653,12-02-2021 22:00,24 hrs.,StockMarket,AZN,13,13,0,13,1,3,3,1,NASDAQ
4653,12-02-2021 22:00,24 hrs.,StockMarket,CDC,13,13,0,13,1,3,3,1,NASDAQ
4653,12-02-2021 22:00,24 hrs.,StockMarket,HAS,6,0,6,-6,1,1,0,1,NASDAQ
4653,12-02-2021 22:00,24 hrs.,StockMarket,INO,13,13,0,13,1,3,3,1,NASDAQ
4653,12-02-2021 22:00,24 hrs.,StockMarket,JFU,57,57,0,57,1,15,23,1,NASDAQ
4653,12-02-2021 22:00,24 hrs.,StockMarket,MGI,5,0,5,-5,1,0,1,1,NASDAQ
4653,12-02-2021 22:00,24 hrs.,StockMarket,NWL,13,13,0,13,1,3,3,1,NASDAQ
4653,12-02-2021 22:00,24 hrs.,StockMarket,OGI,37,10,27,-17,3,9,7,3,NASDAQ
4653,12-02-2021 22:00,24 hrs.,StockMarket,OPK,6,6,0,6,1,1,0,1,NASDAQ
4653,12-02-2021 22:00,24 hrs.,StockMarket,RCM,6,0,6,-6,1,1,0,1,NASDAQ
4653,12-02-2021 22:00,24 hrs.,StockMarket,SFT,6,6,0,6,1,1,0,1,NASDAQ
4653,12-02-2021 22:00,24 hrs.,wallstreetbets,ILMN,7,7,0,7,1,1,1,1,NASDAQ
4653,12-02-2021 22:00,24 hrs.,wallstreetbets,IMGN,111,21,90,-69,4,31,33,4,NASDAQ
4653,12-02-2021 22:00,24 hrs.,wallstreetbets,IMMR,8,0,8,-8,1,1,2,1,NASDAQ
4653,12-02-2021 22:00,24 hrs.,wallstreetbets,INFI,21,0,21,-21,3,3,3,1,NASDAQ
4653,12-02-2021 22:00,24 hrs.,wallstreetbets,INFO,8,0,8,-8,1,1,2,1,NASDAQ
4653,12-02-2021 22:00,24 hrs.,wallstreetbets,INPX,26,7,19,-12,4,4,2,3,NASDAQ
4653,12-02-2021 22:00,24 hrs.,wallstreetbets,INTC,120,113,7,106,3,2,104,3,NASDAQ
4653,12-02-2021 22:00,24 hrs.,wallstreetbets,IPWR,6,6,0,6,1,1,0,1,NASDAQ
4653,12-02-2021 22:00,24 hrs.,wallstreetbets,IRBT,14,0,14,-14,2,2,2,2,NASDAQ
4653,12-02-2021 22:00,24 hrs.,wallstreetbets,ITRM,35,35,0,35,5,5,5,3,NASDAQ
4653,12-02-2021 22:00,24 hrs.,StockMarket,CECE,12,0,12,-12,1,4,0,1,NASDAQ
4653,12-02-2021 22:00,24 hrs.,StockMarket,CLEU,92,92,0,92,2,19,46,2,NASDAQ
4653,12-02-2021 22:00,24 hrs.,StockMarket,CLSK,8,0,8,-8,1,1,2,1,NASDAQ
4653,12-02-2021 22:00,24 hrs.,StockMarket,COHR,13,13,0,13,1,3,3,1,NASDAQ
4653,12-02-2021 22:00,24 hrs.,StockMarket,CPLP,20,20,0,20,3,4,0,2,NASDAQ
4653,12-02-2021 22:00,24 hrs.,StockMarket,CRSP,4,0,4,-4,1,0,0,1,NASDAQ
4653,12-02-2021 22:00,24 hrs.,StockMarket,CTHR,23,0,23,-23,1,6,7,1,NASDAQ
4653,12-02-2021 22:00,24 hrs.,StockMarket,CWCO,12,12,0,12,2,2,0,1,NASDAQ
4653,12-02-2021 22:00,24 hrs.,StockMarket,DDOG,13,13,0,13,1,3,3,1,NASDAQ
4653,12-02-2021 22:00,24 hrs.,StockMarket,ENTX,8,0,8,-8,1,2,0,1,NASDAQ
4653,12-02-2021 22:00,24 hrs.,StockMarket,EXPE,13,13,0,13,1,3,3,1,NASDAQ
4653,12-02-2021 22:00,24 hrs.,StockMarket,FNKO,27,0,27,-27,1,8,7,1,NASDAQ
4653,12-02-2021 22:00,24 hrs.,StockMarket,GBIO,7,7,0,7,1,1,1,1,NASDAQ
4653,12-02-2021 22:00,24 hrs.,StockMarket,HTBX,69,63,6,57,3,17,23,3,NASDAQ
4653,12-02-2021 22:00,24 hrs.,StockMarket,IDEX,6,6,0,6,1,1,0,1,NASDAQ
4653,12-02-2021 22:00,24 hrs.,StockMarket,IIVI,13,13,0,13,1,3,3,1,NASDAQ
4653,12-02-2021 22:00,24 hrs.,StockMarket,INPX,6,6,0,6,1,1,0,1,NASDAQ
4653,12-02-2021 22:00,24 hrs.,StockMarket,INTZ,4,4,0,4,1,0,0,1,NASDAQ
4653,12-02-2021 22:00,24 hrs.,StockMarket,INVE,24,0,24,-24,2,6,4,1,NASDAQ
4653,12-02-2021 22:00,24 hrs.,StockMarket,LAZR,6,0,6,-6,1,1,0,1,NASDAQ
4653,12-02-2021 22:00,24 hrs.,StockMarket,LGND,6,0,6,-6,1,1,0,1,NASDAQ
4653,12-02-2021 22:00,24 hrs.,StockMarket,LIFE,3950,0,3950,-3950,1,1930,86,1,NASDAQ
4653,12-02-2021 22:00,24 hrs.,StockMarket,LITE,13,13,0,13,1,3,3,1,NASDAQ
4653,12-02-2021 22:00,24 hrs.,StockMarket,LIVE,13,13,0,13,1,3,3,1,NASDAQ
4653,12-02-2021 22:00,24 hrs.,StockMarket,LLNW,25,25,0,25,4,4,1,1,NASDAQ
4653,12-02-2021 22:00,24 hrs.,wallstreetbets,POTX,7,7,0,7,1,1,1,1,NASDAQ
4653,12-02-2021 22:00,24 hrs.,wallstreetbets,POWW,61,27,34,-7,9,9,7,8,NASDAQ
4653,12-02-2021 22:00,24 hrs.,wallstreetbets,PRCH,80,74,6,68,4,16,32,3,NASDAQ
4653,12-02-2021 22:00,24 hrs.,wallstreetbets,PRPL,771,771,0,771,1,291,185,1,NASDAQ
4653,12-02-2021 22:00,24 hrs.,wallstreetbets,PRTS,15,15,0,15,2,2,3,1,NASDAQ
4653,12-02-2021 22:00,24 hrs.,wallstreetbets,PSAC,7,7,0,7,1,1,1,1,NASDAQ
4653,12-02-2021 22:00,24 hrs.,wallstreetbets,PSEC,19,0,19,-19,1,0,15,1,NASDAQ
4653,12-02-2021 22:00,24 hrs.,wallstreetbets,PSTV,7,0,7,-7,1,1,1,1,NASDAQ
4653,12-02-2021 22:00,24 hrs.,wallstreetbets,PTCT,7,7,0,7,1,1,1,1,NASDAQ
4653,12-02-2021 22:00,24 hrs.,wallstreetbets,PTON,3854,3854,0,3854,5,1783,268,1,NASDAQ
4653,12-02-2021 22:00,24 hrs.,wallstreetbets,PYPL,7,0,7,-7,1,1,1,1,NASDAQ
4653,12-02-2021 22:00,24 hrs.,wallstreetbets,PZZA,7,0,7,-7,1,1,1,1,NASDAQ
4653,12-02-2021 22:00,24 hrs.,wallstreetbets,QCOM,7,7,0,7,1,1,1,1,NASDAQ
4653,12-02-2021 22:00,24 hrs.,wallstreetbets,QQQJ,22,22,0,22,1,6,6,1,NASDAQ
4653,12-02-2021 22:00,24 hrs.,wallstreetbets,QUIK,20,13,7,6,3,3,2,3,NASDAQ
4653,12-02-2021 22:00,24 hrs.,wallstreetbets,RAVE,14,14,0,14,2,2,2,2,NASDAQ
4653,12-02-2021 22:00,24 hrs.,wallstreetbets,RCMT,14,0,14,-14,2,2,2,2,NASDAQ
4653,12-02-2021 22:00,24 hrs.,wallstreetbets,RDHL,13,13,0,13,2,2,1,2,NASDAQ
4653,12-02-2021 22:00,24 hrs.,wallstreetbets,REAL,90,55,35,20,7,7,48,7,NASDAQ
4653,12-02-2021 22:00,24 hrs.,wallstreetbets,REGI,6,0,6,-6,1,1,0,1,NASDAQ
4653,12-02-2021 22:00,24 hrs.,wallstreetbets,REGN,21,21,0,21,3,3,3,2,NASDAQ
4653,12-02-2021 22:00,24 hrs.,wallstreetbets,RIDE,95,89,6,83,14,14,11,11,NASDAQ
4653,12-02-2021 22:00,24 hrs.,wallstreetbets,RIOT,3946,3933,13,3920,18,1796,282,13,NASDAQ
4653,12-02-2021 22:00,24 hrs.,wallstreetbets,RKDA,7,7,0,7,1,1,1,1,NASDAQ
4653,12-02-2021 22:00,24 hrs.,wallstreetbets,RMTI,20,0,20,-20,3,3,2,2,NASDAQ
4653,12-02-2021 22:00,24 hrs.,wallstreetbets,ROKU,6,6,0,6,1,1,0,1,NASDAQ
4653,12-02-2021 22:00,24 hrs.,wallstreetbets,ROOT,14,14,0,14,2,2,2,1,NASDAQ
4653,12-02-2021 22:00,24 hrs.,wallstreetbets,RWLK,21,21,0,21,3,3,3,3,NASDAQ
4653,12-02-2021 22:00,24 hrs.,wallstreetbets,SABR,7,0,7,-7,1,1,1,1,NASDAQ
4653,12-02-2021 22:00,24 hrs.,wallstreetbets,OPGN,14,14,0,14,2,2,2,1,NASDAQ
4653,12-02-2021 22:00,24 hrs.,wallstreetbets,OPTT,6,6,0,6,1,1,0,1,NASDAQ
4653,12-02-2021 22:00,24 hrs.,wallstreetbets,OSTK,9,0,9,-9,1,1,3,1,NASDAQ
4653,12-02-2021 22:00,24 hrs.,wallstreetbets,PACB,14,0,14,-14,2,2,2,1,NASDAQ
4653,12-02-2021 22:00,24 hrs.,wallstreetbets,PENN,3861,3861,0,3861,6,1784,269,2,NASDAQ
4653,12-02-2021 22:00,24 hrs.,wallstreetbets,PGNY,7,7,0,7,1,1,1,1,NASDAQ
4653,12-02-2021 22:00,24 hrs.,wallstreetbets,PHIO,7,0,7,-7,1,1,1,1,NASDAQ
4653,12-02-2021 22:00,24 hrs.,wallstreetbets,PHUN,7,7,0,7,1,1,1,1,NASDAQ
4653,12-02-2021 22:00,24 hrs.,wallstreetbets,PLAY,20,7,13,-6,3,3,2,3,NASDAQ
4653,12-02-2021 22:00,24 hrs.,wallstreetbets,PLUG,7,7,0,7,1,1,1,1,NASDAQ
4653,12-02-2021 22:00,24 hrs.,wallstreetbets,SAVA,13,7,6,1,2,2,1,2,NASDAQ
4653,12-02-2021 22:00,24 hrs.,wallstreetbets,SAVE,28,7,21,-14,4,4,4,2,NASDAQ
4653,12-02-2021 22:00,24 hrs.,wallstreetbets,SBUX,7,7,0,7,1,1,1,1,NASDAQ
4653,12-02-2021 22:00,24 hrs.,wallstreetbets,SEAC,7,7,0,7,1,1,1,1,NASDAQ
4653,12-02-2021 22:00,24 hrs.,wallstreetbets,SEEL,7,7,0,7,1,1,1,1,NASDAQ
4653,12-02-2021 22:00,24 hrs.,wallstreetbets,SHIP,138,131,7,124,20,20,18,15,NASDAQ
4653,12-02-2021 22:00,24 hrs.,wallstreetbets,SINT,6,0,6,-6,1,1,0,1,NASDAQ
4653,12-02-2021 22:00,24 hrs.,wallstreetbets,SIRI,7,7,0,7,1,1,1,1,NASDAQ
4653,12-02-2021 22:00,24 hrs.,wallstreetbets,SLRX,7,7,0,7,1,1,1,1,NASDAQ
4653,12-02-2021 22:00,24 hrs.,wallstreetbets,SNCA,6,6,0,6,1,1,0,1,NASDAQ
4653,12-02-2021 22:00,24 hrs.,wallstreetbets,SNDL,7995,1768,6227,-4459,310,2628,1499,232,NASDAQ
4653,12-02-2021 22:00,24 hrs.,wallstreetbets,SNGX,15,8,7,1,2,2,3,2,NASDAQ
4653,12-02-2021 22:00,24 hrs.,wallstreetbets,SQQQ,14,7,7,0,2,2,2,2,NASDAQ
4653,12-02-2021 22:00,24 hrs.,wallstreetbets,SRAC,6,6,0,6,1,1,0,1,NASDAQ
4653,12-02-2021 22:00,24 hrs.,wallstreetbets,SRGA,7,7,0,7,1,1,1,1,NASDAQ
4653,12-02-2021 22:00,24 hrs.,wallstreetbets,SRNE,29,7,22,-15,3,6,5,3,NASDAQ
4653,12-02-2021 22:00,24 hrs.,wallstreetbets,STAF,14,7,7,0,2,2,2,2,NASDAQ
4653,12-02-2021 22:00,24 hrs.,wallstreetbets,STAY,12,6,6,0,2,2,0,2,NASDAQ
4653,12-02-2021 22:00,24 hrs.,wallstreetbets,STEP,15,15,0,15,1,0,11,1,NASDAQ
4653,12-02-2021 22:00,24 hrs.,wallstreetbets,STLD,7,7,0,7,1,1,1,1,NASDAQ
4653,12-02-2021 22:00,24 hrs.,wallstreetbets,SVMK,417,417,0,417,1,170,73,1,NASDAQ
4653,12-02-2021 22:00,24 hrs.,wallstreetbets,SWBI,7,7,0,7,1,1,1,1,NASDAQ
4653,12-02-2021 22:00,24 hrs.,wallstreetbets,SWKS,450,450,0,450,1,114,218,1,NASDAQ
4653,12-02-2021 22:00,24 hrs.,wallstreetbets,TEAM,12,0,12,-12,2,2,0,1,NASDAQ
4653,12-02-2021 22:00,24 hrs.,wallstreetbets,TELL,34346,13,34333,-34320,4,16414,1502,4,NASDAQ
4653,12-02-2021 22:00,24 hrs.,wallstreetbets,THBR,13,0,13,-13,2,2,1,2,NASDAQ
4653,12-02-2021 22:00,24 hrs.,wallstreetbets,THCB,6,6,0,6,1,1,0,1,NASDAQ
4653,12-02-2021 22:00,24 hrs.,wallstreetbets,THMO,13,13,0,13,2,2,1,1,NASDAQ
4653,12-02-2021 22:00,24 hrs.,wallstreetbets,TIGR,7,0,7,-7,1,1,1,1,NASDAQ
4653,12-02-2021 22:00,24 hrs.,wallstreetbets,TLRY,81194,369,80825,-80456,94,37962,4894,81,NASDAQ
4653,12-02-2021 22:00,24 hrs.,wallstreetbets,TNXP,90,56,34,22,13,13,12,8,NASDAQ
4653,12-02-2021 22:00,24 hrs.,wallstreetbets,TOPS,93,86,7,79,13,14,13,10,NASDAQ
4653,12-02-2021 22:00,24 hrs.,wallstreetbets,TOWN,144,144,0,144,1,42,56,1,NASDAQ
4653,12-02-2021 22:00,24 hrs.,wallstreetbets,TRCH,33,14,19,-5,5,5,3,4,NASDAQ
4653,12-02-2021 22:00,24 hrs.,wallstreetbets,TRIT,60,39,21,18,9,9,6,7,NASDAQ
4653,12-02-2021 22:00,24 hrs.,wallstreetbets,TRVG,2163,2163,0,2163,29,764,519,19,NASDAQ
4653,12-02-2021 22:00,24 hrs.,wallstreetbets,TSLA,5712,5366,346,5020,37,2415,734,28,NASDAQ
4653,12-02-2021 22:00,24 hrs.,wallstreetbets,TTCF,14,7,7,0,2,2,2,2,NASDAQ
4653,12-02-2021 22:00,24 hrs.,wallstreetbets,TTOO,7,7,0,7,1,1,1,1,NASDAQ
4653,12-02-2021 22:00,24 hrs.,wallstreetbets,TTWO,7,0,7,-7,1,1,1,1,NASDAQ
4653,12-02-2021 22:00,24 hrs.,wallstreetbets,TURN,20,0,20,-20,3,3,2,2,NASDAQ
4653,12-02-2021 22:00,24 hrs.,wallstreetbets,TXMD,57,29,28,1,8,8,9,6,NASDAQ
4653,12-02-2021 22:00,24 hrs.,wallstreetbets,UNFI,237,237,0,237,1,105,23,1,NASDAQ
4653,12-02-2021 22:00,24 hrs.,wallstreetbets,VEON,6,6,0,6,1,1,0,1,NASDAQ
4653,12-02-2021 22:00,24 hrs.,wallstreetbets,VERU,7,7,0,7,1,1,1,1,NASDAQ
4653,12-02-2021 22:00,24 hrs.,wallstreetbets,VISL,13,7,6,1,2,2,1,2,NASDAQ
4653,12-02-2021 22:00,24 hrs.,wallstreetbets,VKTX,7,7,0,7,1,1,1,1,NASDAQ
4653,12-02-2021 22:00,24 hrs.,wallstreetbets,VLDR,7,7,0,7,1,1,1,1,NASDAQ
4653,12-02-2021 22:00,24 hrs.,wallstreetbets,VNDA,36,0,36,-36,5,5,6,1,NASDAQ
4653,12-02-2021 22:00,24 hrs.,wallstreetbets,VRSN,417,417,0,417,1,170,73,1,NASDAQ
4653,12-02-2021 22:00,24 hrs.,wallstreetbets,VSAT,14,14,0,14,2,2,2,1,NASDAQ
4653,12-02-2021 22:00,24 hrs.,wallstreetbets,VUZI,9,0,9,-9,1,1,3,1,NASDAQ
4653,12-02-2021 22:00,24 hrs.,wallstreetbets,VXRT,27,21,6,15,4,4,3,4,NASDAQ
4653,12-02-2021 22:00,24 hrs.,wallstreetbets,VYNE,7,0,7,-7,1,1,1,1,NASDAQ
4653,12-02-2021 22:00,24 hrs.,StockMarket,SND,10,0,10,-10,1,3,0,1,NASDAQ
4653,12-02-2021 22:00,24 hrs.,StockMarket,AEZS,6,0,6,-6,1,1,0,1,NASDAQ
4653,12-02-2021 22:00,24 hrs.,StockMarket,APHA,38,6,32,-26,2,14,2,2,NASDAQ
4653,12-02-2021 22:00,24 hrs.,StockMarket,ARTL,79,79,0,79,1,19,37,1,NASDAQ
4653,12-02-2021 22:00,24 hrs.,StockMarket,ATHX,6,6,0,6,1,1,0,1,NASDAQ
4653,12-02-2021 22:00,24 hrs.,StockMarket,ATOS,21,14,7,7,2,6,1,2,NASDAQ
4653,12-02-2021 22:00,24 hrs.,StockMarket,AVGO,7,7,0,7,1,1,1,1,NASDAQ
4653,12-02-2021 22:00,24 hrs.,StockMarket,BBBY,6,6,0,6,1,1,0,1,NASDAQ
4653,12-02-2021 22:00,24 hrs.,StockMarket,BPTH,6,6,0,6,1,1,0,1,NASDAQ
4653,12-02-2021 22:00,24 hrs.,StockMarket,BYND,6,6,0,6,1,1,0,1,NASDAQ
4642,12-02-2021 20:00,24 hrs.,stocks,RGEN,25,0,25,-25,1,3,15,1,NASDAQ
4642,12-02-2021 20:00,24 hrs.,stocks,RIOT,6,0,6,-6,1,1,0,1,NASDAQ
4642,12-02-2021 20:00,24 hrs.,stocks,SABR,57,57,0,57,1,13,27,1,NASDAQ
4642,12-02-2021 20:00,24 hrs.,stocks,SEDG,52,52,0,52,1,14,20,1,NASDAQ
4642,12-02-2021 20:00,24 hrs.,stocks,SEEL,18,12,6,6,3,3,0,2,NASDAQ
4642,12-02-2021 20:00,24 hrs.,stocks,SESN,7,7,0,7,1,1,1,1,NASDAQ
4642,12-02-2021 20:00,24 hrs.,stocks,SHIP,9,9,0,9,1,2,1,1,NASDAQ
4642,12-02-2021 20:00,24 hrs.,stocks,SNDL,92,37,55,-18,15,15,2,13,NASDAQ
4642,12-02-2021 20:00,24 hrs.,stocks,SNGX,23,23,0,23,3,5,1,3,NASDAQ
4642,12-02-2021 20:00,24 hrs.,stocks,SPRO,25,0,25,-25,1,3,15,1,NASDAQ
4642,12-02-2021 20:00,24 hrs.,stocks,SQQQ,7,0,7,-7,1,1,1,1,NASDAQ
4642,12-02-2021 20:00,24 hrs.,stocks,SRAC,14,6,8,-2,2,3,0,2,NASDAQ
4642,12-02-2021 20:00,24 hrs.,stocks,SRNE,52,52,0,52,1,14,20,1,NASDAQ
4642,12-02-2021 20:00,24 hrs.,stocks,SSPK,53,0,53,-53,1,17,15,1,NASDAQ
4642,12-02-2021 20:00,24 hrs.,stocks,SSYS,42,0,42,-42,1,10,18,1,NASDAQ
4642,12-02-2021 20:00,24 hrs.,stocks,SVMK,10,10,0,10,1,2,2,1,NASDAQ
4642,12-02-2021 20:00,24 hrs.,stocks,SWAV,25,0,25,-25,1,3,15,1,NASDAQ
4642,12-02-2021 20:00,24 hrs.,stocks,SWBI,7,0,7,-7,1,1,1,1,NASDAQ
4642,12-02-2021 20:00,24 hrs.,stocks,SWKS,44,44,0,44,1,7,26,1,NASDAQ
4642,12-02-2021 20:00,24 hrs.,stocks,TLRY,977,574,403,171,8,301,343,8,NASDAQ
4642,12-02-2021 20:00,24 hrs.,stocks,TMDX,25,0,25,-25,1,3,15,1,NASDAQ
4642,12-02-2021 20:00,24 hrs.,stocks,TNXP,6,0,6,-6,1,1,0,1,NASDAQ
4642,12-02-2021 20:00,24 hrs.,stocks,TRVG,6,6,0,6,1,1,0,1,NASDAQ
4642,12-02-2021 20:00,24 hrs.,stocks,TSLA,192,117,75,42,7,25,114,6,NASDAQ
4642,12-02-2021 20:00,24 hrs.,stocks,TTWO,6,0,6,-6,1,1,0,1,NASDAQ
4642,12-02-2021 20:00,24 hrs.,stocks,CRWD,52,52,0,52,1,14,20,1,NASDAQ
4642,12-02-2021 20:00,24 hrs.,stocks,CTRM,51,13,38,-25,8,8,3,7,NASDAQ
4642,12-02-2021 20:00,24 hrs.,stocks,CVLB,6,6,0,6,1,1,0,1,NASDAQ
4642,12-02-2021 20:00,24 hrs.,stocks,DDOG,10,10,0,10,1,2,2,1,NASDAQ
4642,12-02-2021 20:00,24 hrs.,stocks,DFFN,15,15,0,15,2,3,1,2,NASDAQ
4642,12-02-2021 20:00,24 hrs.,stocks,DMTK,25,0,25,-25,1,3,15,1,NASDAQ
4642,12-02-2021 20:00,24 hrs.,stocks,DOCU,6,6,0,6,1,1,0,1,NASDAQ
4642,12-02-2021 20:00,24 hrs.,stocks,EDIT,320,320,0,320,3,106,96,3,NASDAQ
4642,12-02-2021 20:00,24 hrs.,stocks,ENPH,52,52,0,52,1,14,20,1,NASDAQ
4642,12-02-2021 20:00,24 hrs.,stocks,ENTX,7,7,0,7,1,1,1,1,NASDAQ
4642,12-02-2021 20:00,24 hrs.,stocks,ETSY,29,0,29,-29,1,6,13,1,NASDAQ
4642,12-02-2021 20:00,24 hrs.,stocks,EVFM,20,0,20,-20,2,6,0,2,NASDAQ
4642,12-02-2021 20:00,24 hrs.,stocks,EXAS,25,0,25,-25,1,3,15,1,NASDAQ
4642,12-02-2021 20:00,24 hrs.,stocks,EXPE,10,10,0,10,1,2,2,1,NASDAQ
4642,12-02-2021 20:00,24 hrs.,stocks,EXPI,6,6,0,6,1,1,0,1,NASDAQ
4642,12-02-2021 20:00,24 hrs.,stocks,FLXN,31,0,31,-31,1,10,7,1,NASDAQ
4642,12-02-2021 20:00,24 hrs.,stocks,FSRV,6,0,6,-6,1,1,0,1,NASDAQ
4642,12-02-2021 20:00,24 hrs.,stocks,GILT,53,6,47,-41,2,16,13,2,NASDAQ
4642,12-02-2021 20:00,24 hrs.,stocks,GLUU,7,7,0,7,1,1,1,1,NASDAQ
4642,12-02-2021 20:00,24 hrs.,stocks,GNUS,6,0,6,-6,1,1,0,1,NASDAQ
4642,12-02-2021 20:00,24 hrs.,stocks,GOEV,111,111,0,111,1,19,69,1,NASDAQ
4642,12-02-2021 20:00,24 hrs.,stocks,GTHX,6,0,6,-6,1,1,0,1,NASDAQ
4642,12-02-2021 20:00,24 hrs.,stocks,HTBX,6,0,6,-6,1,1,0,1,NASDAQ
4642,12-02-2021 20:00,24 hrs.,stocks,ICLN,68,68,0,68,1,21,22,1,NASDAQ
4642,12-02-2021 20:00,24 hrs.,wallstreetbets,AWH,13,0,13,-13,2,2,1,1,NASDAQ
4642,12-02-2021 20:00,24 hrs.,wallstreetbets,AZN,414,408,6,402,3,164,74,3,NASDAQ
4642,12-02-2021 20:00,24 hrs.,wallstreetbets,BFI,21,14,7,7,3,3,3,2,NASDAQ
4642,12-02-2021 20:00,24 hrs.,wallstreetbets,BLU,14,14,0,14,2,2,2,1,NASDAQ
4642,12-02-2021 20:00,24 hrs.,wallstreetbets,BUG,12,12,0,12,2,2,0,1,NASDAQ
4642,12-02-2021 20:00,24 hrs.,wallstreetbets,CDC,401,401,0,401,1,162,73,1,NASDAQ
4642,12-02-2021 20:00,24 hrs.,wallstreetbets,CGC,1359,89,1270,-1181,8,470,387,8,NASDAQ
4642,12-02-2021 20:00,24 hrs.,wallstreetbets,CTG,7,7,0,7,1,1,1,1,NASDAQ
4642,12-02-2021 20:00,24 hrs.,wallstreetbets,DBX,7,7,0,7,1,1,1,1,NASDAQ
4642,12-02-2021 20:00,24 hrs.,wallstreetbets,ESG,8,0,8,-8,1,1,2,1,NASDAQ
4642,12-02-2021 20:00,24 hrs.,wallstreetbets,FAT,133,133,0,133,1,39,51,1,NASDAQ
4642,12-02-2021 20:00,24 hrs.,wallstreetbets,FUV,7,7,0,7,1,1,1,1,NASDAQ
4642,12-02-2021 20:00,24 hrs.,wallstreetbets,FWP,14,14,0,14,2,2,2,1,NASDAQ
4642,12-02-2021 20:00,24 hrs.,wallstreetbets,GSM,12,6,6,0,2,2,0,2,NASDAQ
4642,12-02-2021 20:00,24 hrs.,wallstreetbets,HAS,40,0,40,-40,6,6,4,6,NASDAQ
4642,12-02-2021 20:00,24 hrs.,wallstreetbets,HPK,6,6,0,6,1,1,0,1,NASDAQ
4642,12-02-2021 20:00,24 hrs.,wallstreetbets,IEA,7,7,0,7,1,1,1,1,NASDAQ
4642,12-02-2021 20:00,24 hrs.,wallstreetbets,III,66,0,66,-66,2,19,20,2,NASDAQ
4642,12-02-2021 20:00,24 hrs.,wallstreetbets,INO,770,74,696,-622,21,263,160,19,NASDAQ
4642,12-02-2021 20:00,24 hrs.,wallstreetbets,IPA,7,0,7,-7,1,1,1,1,NASDAQ
4642,12-02-2021 20:00,24 hrs.,wallstreetbets,KHC,12,0,12,-12,2,2,0,2,NASDAQ
4642,12-02-2021 20:00,24 hrs.,wallstreetbets,KOD,6,6,0,6,1,1,0,1,NASDAQ
4642,12-02-2021 20:00,24 hrs.,wallstreetbets,MGI,9,9,0,9,1,1,3,1,NASDAQ
4642,12-02-2021 20:00,24 hrs.,wallstreetbets,NPA,13,6,7,-1,2,2,1,2,NASDAQ
4642,12-02-2021 20:00,24 hrs.,wallstreetbets,NWL,401,401,0,401,1,162,73,1,NASDAQ
4642,12-02-2021 20:00,24 hrs.,stocks,ICPT,17,0,17,-17,1,4,5,1,NASDAQ
4642,12-02-2021 20:00,24 hrs.,stocks,IIVI,10,10,0,10,1,2,2,1,NASDAQ
4642,12-02-2021 20:00,24 hrs.,stocks,ILMN,19,19,0,19,1,7,1,1,NASDAQ
4642,12-02-2021 20:00,24 hrs.,stocks,INPX,18,18,0,18,3,3,0,1,NASDAQ
4642,12-02-2021 20:00,24 hrs.,stocks,INTC,84,84,0,84,1,29,22,1,NASDAQ
4642,12-02-2021 20:00,24 hrs.,stocks,INVE,7,7,0,7,1,1,1,1,NASDAQ
4642,12-02-2021 20:00,24 hrs.,stocks,ITRM,9,9,0,9,1,2,1,1,NASDAQ
4642,12-02-2021 20:00,24 hrs.,stocks,KPTI,31,0,31,-31,1,10,7,1,NASDAQ
4642,12-02-2021 20:00,24 hrs.,stocks,LITE,10,10,0,10,1,2,2,1,NASDAQ
4642,12-02-2021 20:00,24 hrs.,stocks,LIVE,10,10,0,10,1,2,2,1,NASDAQ
4642,12-02-2021 20:00,24 hrs.,stocks,LKCO,12,12,0,12,2,2,0,1,NASDAQ
4642,12-02-2021 20:00,24 hrs.,stocks,LLNW,17,17,0,17,1,4,5,1,NASDAQ
4642,12-02-2021 20:00,24 hrs.,stocks,LRCX,44,44,0,44,1,7,26,1,NASDAQ
4642,12-02-2021 20:00,24 hrs.,stocks,MGNI,64,0,64,-64,1,14,32,1,NASDAQ
4642,12-02-2021 20:00,24 hrs.,stocks,MKSI,10,10,0,10,1,2,2,1,NASDAQ
4642,12-02-2021 20:00,24 hrs.,stocks,MNPR,6,0,6,-6,1,1,0,1,NASDAQ
4642,12-02-2021 20:00,24 hrs.,stocks,MSFT,191,98,93,5,3,60,59,3,NASDAQ
4642,12-02-2021 20:00,24 hrs.,stocks,MSTR,6,0,6,-6,1,1,0,1,NASDAQ
4642,12-02-2021 20:00,24 hrs.,stocks,MVIS,6,0,6,-6,1,1,0,1,NASDAQ
4642,12-02-2021 20:00,24 hrs.,stocks,NAKD,25,6,19,-13,3,3,7,3,NASDAQ
4642,12-02-2021 20:00,24 hrs.,stocks,NCMI,55,55,0,55,2,20,7,1,NASDAQ
4642,12-02-2021 20:00,24 hrs.,stocks,NMTR,9,9,0,9,1,1,3,1,NASDAQ
4642,12-02-2021 20:00,24 hrs.,stocks,NVDA,149,56,93,-37,4,30,73,4,NASDAQ
4642,12-02-2021 20:00,24 hrs.,stocks,NXTD,12,12,0,12,2,2,0,1,NASDAQ
4642,12-02-2021 20:00,24 hrs.,stocks,NYMT,8,8,0,8,1,1,2,1,NASDAQ
4642,12-02-2021 20:00,24 hrs.,stocks,OLED,102,102,0,102,1,46,6,1,NASDAQ
4642,12-02-2021 20:00,24 hrs.,stocks,ONTX,6,6,0,6,1,1,0,1,NASDAQ
4642,12-02-2021 20:00,24 hrs.,stocks,ONVO,6,6,0,6,1,1,0,1,NASDAQ
4642,12-02-2021 20:00,24 hrs.,stocks,OPRX,25,0,25,-25,1,3,15,1,NASDAQ
4642,12-02-2021 20:00,24 hrs.,stocks,PAAS,6,6,0,6,1,1,0,1,NASDAQ
4642,12-02-2021 20:00,24 hrs.,stocks,PENN,7,0,7,-7,1,1,1,1,NASDAQ
4642,12-02-2021 20:00,24 hrs.,stocks,PGNY,25,0,25,-25,1,3,15,1,NASDAQ
4642,12-02-2021 20:00,24 hrs.,stocks,PHUN,6,6,0,6,1,1,0,1,NASDAQ
4642,12-02-2021 20:00,24 hrs.,stocks,PLUG,117,117,0,117,2,20,69,2,NASDAQ
4642,12-02-2021 20:00,24 hrs.,stocks,PSTV,6,6,0,6,1,1,0,1,NASDAQ
4642,12-02-2021 20:00,24 hrs.,stocks,PYPL,634,0,634,-634,1,260,110,1,NASDAQ
4642,12-02-2021 20:00,24 hrs.,stocks,QCLN,68,68,0,68,1,21,22,1,NASDAQ
4642,12-02-2021 20:00,24 hrs.,stocks,QCOM,14,0,14,-14,2,2,2,1,NASDAQ
4642,12-02-2021 20:00,24 hrs.,stocks,QQQM,26,0,26,-26,1,4,14,1,NASDAQ
4642,12-02-2021 20:00,24 hrs.,Daytrading,CMLF,409,409,0,409,1,171,63,1,NASDAQ
4642,12-02-2021 20:00,24 hrs.,wallstreetbets,OGI,127,39,88,-49,19,19,13,17,NASDAQ
4642,12-02-2021 20:00,24 hrs.,wallstreetbets,OPK,7,7,0,7,1,1,1,1,NASDAQ
4642,12-02-2021 20:00,24 hrs.,wallstreetbets,OPT,7,0,7,-7,1,1,1,1,NASDAQ
4642,12-02-2021 20:00,24 hrs.,wallstreetbets,PTE,35,0,35,-35,5,5,5,1,NASDAQ
4642,12-02-2021 20:00,24 hrs.,wallstreetbets,RCM,6,0,6,-6,1,1,0,1,NASDAQ
4642,12-02-2021 20:00,24 hrs.,wallstreetbets,RUN,7,0,7,-7,1,1,1,1,NASDAQ
4642,12-02-2021 20:00,24 hrs.,wallstreetbets,SFT,7,7,0,7,1,1,1,1,NASDAQ
4642,12-02-2021 20:00,24 hrs.,wallstreetbets,SLS,6,0,6,-6,1,1,0,1,NASDAQ
4642,12-02-2021 20:00,24 hrs.,wallstreetbets,SMH,7,7,0,7,1,1,1,1,NASDAQ
4642,12-02-2021 20:00,24 hrs.,wallstreetbets,SND,34,27,7,20,5,5,4,5,NASDAQ
4642,12-02-2021 20:00,24 hrs.,wallstreetbets,SPI,7,7,0,7,1,1,1,1,NASDAQ
4642,12-02-2021 20:00,24 hrs.,wallstreetbets,UAL,7,0,7,-7,1,1,1,1,NASDAQ
4642,12-02-2021 20:00,24 hrs.,wallstreetbets,UFO,6,0,6,-6,1,1,0,1,NASDAQ
4642,12-02-2021 20:00,24 hrs.,wallstreetbets,VFF,22,14,8,6,3,3,4,3,NASDAQ
4642,12-02-2021 20:00,24 hrs.,wallstreetbets,VRM,60,0,60,-60,1,18,20,1,NASDAQ
4642,12-02-2021 20:00,24 hrs.,wallstreetbets,WDC,6,0,6,-6,1,1,0,1,NASDAQ
4642,12-02-2021 20:00,24 hrs.,wallstreetbets,WNW,21,15,6,9,3,3,3,3,NASDAQ
4642,12-02-2021 20:00,24 hrs.,wallstreetbets,WVE,6,0,6,-6,1,1,0,1,NASDAQ
4642,12-02-2021 20:00,24 hrs.,wallstreetbets,AACG,7,7,0,7,1,1,1,1,NASDAQ
4642,12-02-2021 20:00,24 hrs.,wallstreetbets,AAPL,267,13,254,-241,5,77,93,5,NASDAQ
4642,12-02-2021 20:00,24 hrs.,wallstreetbets,AAWW,6,6,0,6,1,1,0,1,NASDAQ
4642,12-02-2021 20:00,24 hrs.,wallstreetbets,ABEO,13,7,6,1,2,2,1,2,NASDAQ
4642,12-02-2021 20:00,24 hrs.,wallstreetbets,ABIO,7,0,7,-7,1,1,1,1,NASDAQ
4642,12-02-2021 20:00,24 hrs.,wallstreetbets,ABNB,29,15,14,1,4,4,5,3,NASDAQ
4642,12-02-2021 20:00,24 hrs.,stocks,TXMD,6,0,6,-6,1,1,0,1,NASDAQ
4642,12-02-2021 20:00,24 hrs.,stocks,VCEL,25,0,25,-25,1,3,15,1,NASDAQ
4642,12-02-2021 20:00,24 hrs.,stocks,VECO,6,0,6,-6,1,1,0,1,NASDAQ
4642,12-02-2021 20:00,24 hrs.,stocks,VRNT,6,6,0,6,1,1,0,1,NASDAQ
4642,12-02-2021 20:00,24 hrs.,wallstreetbets,LGVW,41,7,34,-27,6,6,5,5,NYSE
4642,12-02-2021 20:00,24 hrs.,wallstreetbets,LMND,12,0,12,-12,2,2,0,1,NYSE
4642,12-02-2021 20:00,24 hrs.,wallstreetbets,LSPD,13,6,7,-1,2,2,1,2,NYSE
4642,12-02-2021 20:00,24 hrs.,wallstreetbets,MAIN,14,0,14,-14,2,2,2,2,NYSE
4642,12-02-2021 20:00,24 hrs.,wallstreetbets,MANU,12,12,0,12,2,2,0,2,NYSE
4642,12-02-2021 20:00,24 hrs.,wallstreetbets,MDLY,13,0,13,-13,2,2,1,1,NYSE
4642,12-02-2021 20:00,24 hrs.,wallstreetbets,NVTA,12,0,12,-12,2,2,0,1,NYSE
4642,12-02-2021 20:00,24 hrs.,wallstreetbets,PACK,15,15,0,15,2,2,3,1,NYSE
4642,12-02-2021 20:00,24 hrs.,wallstreetbets,PINS,7,0,7,-7,1,1,1,1,NYSE
4642,12-02-2021 20:00,24 hrs.,wallstreetbets,PLTR,2206,825,1381,-556,52,743,512,37,NYSE
4642,12-02-2021 20:00,24 hrs.,wallstreetbets,PRTY,14,14,0,14,2,2,2,2,NYSE
4642,12-02-2021 20:00,24 hrs.,wallstreetbets,PSXP,6,0,6,-6,1,1,0,1,NYSE
4642,12-02-2021 20:00,24 hrs.,wallstreetbets,PUMP,49,49,0,49,7,7,7,2,NYSE
4642,12-02-2021 20:00,24 hrs.,wallstreetbets,QUAD,8,0,8,-8,1,1,2,1,NYSE
4642,12-02-2021 20:00,24 hrs.,wallstreetbets,SAFE,82,82,0,82,1,18,42,1,NYSE
4642,12-02-2021 20:00,24 hrs.,wallstreetbets,SCVX,6,0,6,-6,1,1,0,1,NYSE
4642,12-02-2021 20:00,24 hrs.,wallstreetbets,SHOP,7,0,7,-7,1,1,1,1,NYSE
4642,12-02-2021 20:00,24 hrs.,wallstreetbets,SNPR,6,0,6,-6,1,1,0,1,NYSE
4642,12-02-2021 20:00,24 hrs.,wallstreetbets,SPCE,1468,125,1343,-1218,37,532,256,26,NYSE
4642,12-02-2021 20:00,24 hrs.,wallstreetbets,SPOT,7,0,7,-7,1,1,1,1,NYSE
4642,12-02-2021 20:00,24 hrs.,wallstreetbets,STPK,6,0,6,-6,1,1,0,1,NYSE
4642,12-02-2021 20:00,24 hrs.,wallstreetbets,STWD,131,131,0,131,1,35,57,1,NYSE
4642,12-02-2021 20:00,24 hrs.,wallstreetbets,TDOC,6,0,6,-6,1,1,0,1,NYSE
4642,12-02-2021 20:00,24 hrs.,wallstreetbets,TEVA,6,0,6,-6,1,1,0,1,NYSE
4642,12-02-2021 20:00,24 hrs.,wallstreetbets,TWTR,7,7,0,7,1,1,1,1,NYSE
4642,12-02-2021 20:00,24 hrs.,wallstreetbets,UBER,40,7,33,-26,6,6,4,3,NYSE
4642,12-02-2021 20:00,24 hrs.,wallstreetbets,VGAC,19,19,0,19,3,3,1,3,NYSE
4642,12-02-2021 20:00,24 hrs.,wallstreetbets,VSTO,8,0,8,-8,1,1,2,1,NYSE
4642,12-02-2021 20:00,24 hrs.,wallstreetbets,WELL,325,0,325,-325,1,123,75,1,NYSE
4642,12-02-2021 20:00,24 hrs.,wallstreetbets,WORK,2524,2510,14,2496,4,1055,398,4,NYSE
4642,12-02-2021 20:00,24 hrs.,wallstreetbets,XPEV,14,7,7,0,2,2,2,2,NYSE
4642,12-02-2021 20:00,24 hrs.,wallstreetbets,AAL,46,19,27,-8,7,7,4,6,NASDAQ
4642,12-02-2021 20:00,24 hrs.,wallstreetbets,AMD,3851,1839,2012,-173,33,1363,993,28,NASDAQ
4642,12-02-2021 20:00,24 hrs.,wallstreetbets,AQB,6,0,6,-6,1,1,0,1,NASDAQ
4642,12-02-2021 20:00,24 hrs.,wallstreetbets,ASO,6,6,0,6,1,1,0,1,NASDAQ
4642,12-02-2021 20:00,24 hrs.,wallstreetbets,AQST,13,13,0,13,2,2,1,2,NASDAQ
4642,12-02-2021 20:00,24 hrs.,wallstreetbets,ARTL,89,89,0,89,13,13,11,11,NASDAQ
4642,12-02-2021 20:00,24 hrs.,wallstreetbets,ASML,21,0,21,-21,3,3,3,2,NASDAQ
4642,12-02-2021 20:00,24 hrs.,wallstreetbets,ASRT,34,28,6,22,5,5,4,5,NASDAQ
4642,12-02-2021 20:00,24 hrs.,wallstreetbets,ASYS,6,6,0,6,1,1,0,1,NASDAQ
4642,12-02-2021 20:00,24 hrs.,wallstreetbets,ATHA,7,7,0,7,1,1,1,1,NASDAQ
4642,12-02-2021 20:00,24 hrs.,wallstreetbets,ATHE,12,12,0,12,2,2,0,1,NASDAQ
4642,12-02-2021 20:00,24 hrs.,wallstreetbets,ATHX,13,0,13,-13,2,2,1,2,NASDAQ
4642,12-02-2021 20:00,24 hrs.,wallstreetbets,ATNF,7,0,7,-7,1,1,1,1,NASDAQ
4642,12-02-2021 20:00,24 hrs.,stocks,VRSN,10,10,0,10,1,2,2,1,NASDAQ
4642,12-02-2021 20:00,24 hrs.,stocks,VXRT,12,0,12,-12,2,2,0,2,NASDAQ
4642,12-02-2021 20:00,24 hrs.,stocks,VXUS,30,0,30,-30,1,8,10,1,NASDAQ
4642,12-02-2021 20:00,24 hrs.,stocks,WISH,6,6,0,6,1,1,0,1,NASDAQ
4642,12-02-2021 20:00,24 hrs.,stocks,XCUR,6,0,6,-6,1,1,0,1,NASDAQ
4642,12-02-2021 20:00,24 hrs.,stocks,XERS,6,6,0,6,1,1,0,1,NASDAQ
4642,12-02-2021 20:00,24 hrs.,stocks,ZGNX,6,6,0,6,1,1,0,1,NASDAQ
4642,12-02-2021 20:00,24 hrs.,stocks,ZSAN,6,0,6,-6,1,1,0,1,NASDAQ
4642,12-02-2021 20:00,24 hrs.,stocks,ZYXI,25,0,25,-25,1,3,15,1,NASDAQ
4642,12-02-2021 20:00,24 hrs.,stocks,DISCA,12,12,0,12,2,2,0,2,NASDAQ
4642,12-02-2021 20:00,24 hrs.,stocks,SRACU,6,6,0,6,1,1,0,1,NASDAQ
4642,12-02-2021 20:00,24 hrs.,stocks,SRACW,6,6,0,6,1,1,0,1,NASDAQ
4642,12-02-2021 20:00,24 hrs.,Daytrading,AABB,27,0,27,-27,1,8,7,1,OTC
4642,12-02-2021 20:00,24 hrs.,Daytrading,HCMC,27,0,27,-27,1,8,7,1,OTC
4642,12-02-2021 20:00,24 hrs.,Daytrading,HMPQ,16,0,16,-16,1,3,6,1,OTC
4642,12-02-2021 20:00,24 hrs.,Daytrading,IDEA,6,0,6,-6,1,1,0,1,OTC
4642,12-02-2021 20:00,24 hrs.,Daytrading,INKW,8,0,8,-8,1,2,0,1,OTC
4642,12-02-2021 20:00,24 hrs.,Daytrading,LVVV,27,0,27,-27,1,8,7,1,OTC
4642,12-02-2021 20:00,24 hrs.,Daytrading,RLTR,6,0,6,-6,1,1,0,1,OTC
4642,12-02-2021 20:00,24 hrs.,Daytrading,TSTS,33,0,33,-33,2,9,7,2,OTC
4642,12-02-2021 20:00,24 hrs.,Daytrading,MNKKQ,6,0,6,-6,1,1,0,1,OTC
4642,12-02-2021 20:00,24 hrs.,Daytrading,DNN,415,415,0,415,2,172,63,2,AMEX
4642,12-02-2021 20:00,24 hrs.,Daytrading,DSS,409,409,0,409,1,171,63,1,AMEX
4642,12-02-2021 20:00,24 hrs.,Daytrading,MXC,6,6,0,6,1,1,0,1,AMEX
4642,12-02-2021 20:00,24 hrs.,Daytrading,TRX,6,0,6,-6,1,1,0,1,AMEX
4642,12-02-2021 20:00,24 hrs.,Daytrading,TRXC,6,0,6,-6,1,1,0,1,AMEX
4642,12-02-2021 20:00,24 hrs.,Daytrading,ACB,415,415,0,415,2,172,63,2,NYSE
4642,12-02-2021 20:00,24 hrs.,Daytrading,ADX,9,9,0,9,1,2,1,1,NYSE
4642,12-02-2021 20:00,24 hrs.,Daytrading,AMC,6,0,6,-6,1,1,0,1,NYSE
4642,12-02-2021 20:00,24 hrs.,Daytrading,BDX,7,7,0,7,1,1,1,1,NYSE
4642,12-02-2021 20:00,24 hrs.,Daytrading,BFT,12,0,12,-12,1,3,2,1,NYSE
4642,12-02-2021 20:00,24 hrs.,Daytrading,FSR,409,409,0,409,1,171,63,1,NYSE
4642,12-02-2021 20:00,24 hrs.,Daytrading,GME,6,0,6,-6,1,1,0,1,NYSE
4642,12-02-2021 20:00,24 hrs.,Daytrading,NOK,18,0,18,-18,1,0,14,1,NYSE
4642,12-02-2021 20:00,24 hrs.,Daytrading,PDT,21,21,0,21,1,5,7,1,NYSE
4642,12-02-2021 20:00,24 hrs.,Daytrading,RTP,409,409,0,409,1,171,63,1,NYSE
4642,12-02-2021 20:00,24 hrs.,Daytrading,SCI,6,0,6,-6,1,1,0,1,NYSE
4642,12-02-2021 20:00,24 hrs.,Daytrading,WLL,6,6,0,6,1,1,0,1,NYSE
4642,12-02-2021 20:00,24 hrs.,Daytrading,CCIV,409,409,0,409,1,171,63,1,NYSE
4642,12-02-2021 20:00,24 hrs.,Daytrading,CHWY,6,6,0,6,1,1,0,1,NYSE
4642,12-02-2021 20:00,24 hrs.,Daytrading,SPCE,416,409,7,402,2,172,64,2,NYSE
4642,12-02-2021 20:00,24 hrs.,Daytrading,AMD,10,0,10,-10,1,0,6,1,NASDAQ
4642,12-02-2021 20:00,24 hrs.,Daytrading,API,97,97,0,97,1,42,9,1,NASDAQ
4642,12-02-2021 20:00,24 hrs.,Daytrading,INO,409,409,0,409,1,171,63,1,NASDAQ
4642,12-02-2021 20:00,24 hrs.,Daytrading,OGI,13,0,13,-13,1,1,7,1,NASDAQ
4642,12-02-2021 20:00,24 hrs.,Daytrading,ACST,6,6,0,6,1,1,0,1,NASDAQ
4642,12-02-2021 20:00,24 hrs.,Daytrading,APDN,409,409,0,409,1,171,63,1,NASDAQ
4642,12-02-2021 20:00,24 hrs.,Daytrading,APHA,438,409,29,380,3,178,70,2,NASDAQ
4642,12-02-2021 20:00,24 hrs.,Daytrading,ARTL,502,502,0,502,6,201,76,6,NASDAQ
4642,12-02-2021 20:00,24 hrs.,Daytrading,AZRX,7,0,7,-7,1,1,1,1,NASDAQ
4642,12-02-2021 20:00,24 hrs.,Daytrading,BNGO,14,14,0,14,1,5,0,1,NASDAQ
4642,12-02-2021 20:00,24 hrs.,Daytrading,BYND,6,0,6,-6,1,1,0,1,NASDAQ
4642,12-02-2021 20:00,24 hrs.,Daytrading,CLEU,462,462,0,462,2,192,70,2,NASDAQ
4642,12-02-2021 20:00,24 hrs.,Daytrading,CLGN,409,409,0,409,1,171,63,1,NASDAQ
4642,12-02-2021 20:00,24 hrs.,Daytrading,CLSN,409,409,0,409,1,171,63,1,NASDAQ
4642,12-02-2021 20:00,24 hrs.,wallstreetbets,CRBP,21,14,7,7,3,3,3,3,NASDAQ
4642,12-02-2021 20:00,24 hrs.,wallstreetbets,CRNT,13,13,0,13,2,2,1,2,NASDAQ
4642,12-02-2021 20:00,24 hrs.,wallstreetbets,CRON,6,6,0,6,1,1,0,1,NASDAQ
4642,12-02-2021 20:00,24 hrs.,wallstreetbets,CRSR,5339,41,5298,-5257,7,2332,647,6,NASDAQ
4642,12-02-2021 20:00,24 hrs.,wallstreetbets,CTHR,7,7,0,7,1,1,1,1,NASDAQ
4642,12-02-2021 20:00,24 hrs.,wallstreetbets,CTRM,422,218,204,14,64,64,38,53,NASDAQ
4642,12-02-2021 20:00,24 hrs.,wallstreetbets,CTRN,6,0,6,-6,1,1,0,1,NASDAQ
4642,12-02-2021 20:00,24 hrs.,wallstreetbets,DBVT,14,0,14,-14,2,2,2,1,NASDAQ
4642,12-02-2021 20:00,24 hrs.,wallstreetbets,DDOG,414,401,13,388,3,164,74,3,NASDAQ
4642,12-02-2021 20:00,24 hrs.,Daytrading,CRSR,409,409,0,409,1,171,63,1,NASDAQ
4642,12-02-2021 20:00,24 hrs.,Daytrading,EBON,6,6,0,6,1,1,0,1,NASDAQ
4642,12-02-2021 20:00,24 hrs.,Daytrading,EXPE,4,0,4,-4,1,0,0,1,NASDAQ
4642,12-02-2021 20:00,24 hrs.,Daytrading,FOLD,415,415,0,415,2,172,63,2,NASDAQ
4642,12-02-2021 20:00,24 hrs.,Daytrading,FTFT,409,409,0,409,1,171,63,1,NASDAQ
4642,12-02-2021 20:00,24 hrs.,Daytrading,IBKR,23,0,23,-23,1,6,7,1,NASDAQ
4642,12-02-2021 20:00,24 hrs.,Daytrading,LIVE,72,72,0,72,2,26,12,1,NASDAQ
4642,12-02-2021 20:00,24 hrs.,Daytrading,MARA,409,409,0,409,1,171,63,1,NASDAQ
4642,12-02-2021 20:00,24 hrs.,Daytrading,NOVN,409,409,0,409,1,171,63,1,NASDAQ
4642,12-02-2021 20:00,24 hrs.,Daytrading,OCGN,21,21,0,21,1,2,13,1,NASDAQ
4642,12-02-2021 20:00,24 hrs.,Daytrading,PLAY,10,0,10,-10,1,0,6,1,NASDAQ
4642,12-02-2021 20:00,24 hrs.,Daytrading,PLUS,11,0,11,-11,1,2,3,1,NASDAQ
4642,12-02-2021 20:00,24 hrs.,Daytrading,PYPL,409,409,0,409,1,171,63,1,NASDAQ
4642,12-02-2021 20:00,24 hrs.,Daytrading,RIDE,409,409,0,409,1,171,63,1,NASDAQ
4642,12-02-2021 20:00,24 hrs.,Daytrading,RIOT,409,409,0,409,1,171,63,1,NASDAQ
4642,12-02-2021 20:00,24 hrs.,Daytrading,SNDL,13,0,13,-13,1,1,7,1,NASDAQ
4642,12-02-2021 20:00,24 hrs.,Daytrading,STAY,35,35,0,35,1,15,1,1,NASDAQ
4642,12-02-2021 20:00,24 hrs.,Daytrading,TLRY,447,409,38,371,3,179,77,3,NASDAQ
4642,12-02-2021 20:00,24 hrs.,Daytrading,WAFU,53,53,0,53,1,21,7,1,NASDAQ
4642,12-02-2021 20:00,24 hrs.,Daytrading,XERS,409,409,0,409,1,171,63,1,NASDAQ
4642,12-02-2021 20:00,24 hrs.,trakstocks,ALPP,6,6,0,6,1,1,0,1,OTC
4642,12-02-2021 20:00,24 hrs.,trakstocks,BRGO,6,0,6,-6,1,1,0,1,OTC
4642,12-02-2021 20:00,24 hrs.,trakstocks,BRTX,6,6,0,6,1,1,0,1,OTC
4642,12-02-2021 20:00,24 hrs.,trakstocks,MMEX,16,16,0,16,2,3,2,2,OTC
4642,12-02-2021 20:00,24 hrs.,trakstocks,MOST,6,6,0,6,1,1,0,1,OTC
4642,12-02-2021 20:00,24 hrs.,trakstocks,SGSI,16,0,16,-16,1,6,0,1,OTC
4642,12-02-2021 20:00,24 hrs.,trakstocks,SMVI,6,0,6,-6,1,1,0,1,OTC
4642,12-02-2021 20:00,24 hrs.,trakstocks,SUIC,6,0,6,-6,1,1,0,1,OTC
4642,12-02-2021 20:00,24 hrs.,trakstocks,ARBKF,6,6,0,6,1,1,0,1,OTC
4642,12-02-2021 20:00,24 hrs.,trakstocks,BBXIA,6,6,0,6,1,1,0,1,OTC
4642,12-02-2021 20:00,24 hrs.,trakstocks,HUTMF,16,0,16,-16,1,3,6,1,OTC
4642,12-02-2021 20:00,24 hrs.,trakstocks,NMGRF,27,27,0,27,1,8,7,1,OTC
4642,12-02-2021 20:00,24 hrs.,trakstocks,NXTTF,12,12,0,12,1,4,0,1,OTC
4642,12-02-2021 20:00,24 hrs.,wallstreetbets,ABUS,7,7,0,7,1,1,1,1,NASDAQ
4642,12-02-2021 20:00,24 hrs.,wallstreetbets,ACEV,6,6,0,6,1,1,0,1,NASDAQ
4642,12-02-2021 20:00,24 hrs.,wallstreetbets,ACIU,13,7,6,1,2,2,1,2,NASDAQ
4642,12-02-2021 20:00,24 hrs.,wallstreetbets,ACST,26,20,6,14,4,4,2,4,NASDAQ
4642,12-02-2021 20:00,24 hrs.,wallstreetbets,ADMP,7,7,0,7,1,1,1,1,NASDAQ
4642,12-02-2021 20:00,24 hrs.,wallstreetbets,ADXS,6,6,0,6,1,1,0,1,NASDAQ
4642,12-02-2021 20:00,24 hrs.,wallstreetbets,AESE,24,0,24,-24,4,4,0,1,NASDAQ
4642,12-02-2021 20:00,24 hrs.,wallstreetbets,AEZS,14,14,0,14,2,2,2,1,NASDAQ
4642,12-02-2021 20:00,24 hrs.,wallstreetbets,AGEN,7,7,0,7,1,1,1,1,NASDAQ
4642,12-02-2021 20:00,24 hrs.,wallstreetbets,AGTC,50,36,14,22,7,7,8,5,NASDAQ
4642,12-02-2021 20:00,24 hrs.,wallstreetbets,AIKI,7,7,0,7,1,1,1,1,NASDAQ
4642,12-02-2021 20:00,24 hrs.,wallstreetbets,ALGM,6,0,6,-6,1,1,0,1,NASDAQ
4642,12-02-2021 20:00,24 hrs.,wallstreetbets,ALJJ,7,0,7,-7,1,1,1,1,NASDAQ
4642,12-02-2021 20:00,24 hrs.,wallstreetbets,AMAT,32,13,19,-6,5,5,2,4,NASDAQ
4642,12-02-2021 20:00,24 hrs.,wallstreetbets,AMBC,8,8,0,8,1,1,2,1,NASDAQ
4642,12-02-2021 20:00,24 hrs.,wallstreetbets,AMKR,575,21,554,-533,8,192,159,6,NASDAQ
4642,12-02-2021 20:00,24 hrs.,wallstreetbets,AMZN,881,94,787,-693,6,358,141,6,NASDAQ
4642,12-02-2021 20:00,24 hrs.,wallstreetbets,ANCN,7,7,0,7,1,1,1,1,NASDAQ
4642,12-02-2021 20:00,24 hrs.,wallstreetbets,APHA,78956,281,78675,-78394,85,36958,4700,73,NASDAQ
4642,12-02-2021 20:00,24 hrs.,wallstreetbets,APRE,7,7,0,7,1,1,1,1,NASDAQ
4642,12-02-2021 20:00,24 hrs.,wallstreetbets,APXT,29,0,29,-29,4,4,5,3,NASDAQ
4642,12-02-2021 20:00,24 hrs.,wallstreetbets,AQMS,7,0,7,-7,1,1,1,1,NASDAQ
4642,12-02-2021 20:00,24 hrs.,trakstocks,CPS,85,0,85,-85,1,38,5,1,NYSE
4642,12-02-2021 20:00,24 hrs.,trakstocks,GME,72,25,47,-22,2,16,32,2,NYSE
4642,12-02-2021 20:00,24 hrs.,trakstocks,LEN,13,0,13,-13,1,4,1,1,NYSE
4642,12-02-2021 20:00,24 hrs.,trakstocks,NAV,47,0,47,-47,1,14,15,1,NYSE
4642,12-02-2021 20:00,24 hrs.,trakstocks,PCG,47,0,47,-47,1,14,15,1,NYSE
4642,12-02-2021 20:00,24 hrs.,trakstocks,RKT,47,0,47,-47,1,14,15,1,NYSE
4642,12-02-2021 20:00,24 hrs.,trakstocks,SOL,8,8,0,8,1,2,0,1,NYSE
4642,12-02-2021 20:00,24 hrs.,trakstocks,SOS,8,8,0,8,1,2,0,1,NYSE
4642,12-02-2021 20:00,24 hrs.,trakstocks,SPH,12,0,12,-12,1,4,0,1,NYSE
4642,12-02-2021 20:00,24 hrs.,trakstocks,WPF,6,0,6,-6,1,1,0,1,NYSE
4642,12-02-2021 20:00,24 hrs.,trakstocks,ARGO,6,6,0,6,1,1,0,1,NYSE
4642,12-02-2021 20:00,24 hrs.,trakstocks,BEKE,47,0,47,-47,1,14,15,1,NYSE
4642,12-02-2021 20:00,24 hrs.,trakstocks,CCIV,39,0,39,-39,4,8,7,3,NYSE
4642,12-02-2021 20:00,24 hrs.,trakstocks,MDLY,6,0,6,-6,1,1,0,1,NYSE
4642,12-02-2021 20:00,24 hrs.,trakstocks,SKLZ,6,0,6,-6,1,1,0,1,NYSE
4642,12-02-2021 20:00,24 hrs.,trakstocks,STIC,27,0,27,-27,1,8,7,1,NYSE
4642,12-02-2021 20:00,24 hrs.,trakstocks,STPK,22,0,22,-22,1,9,0,1,NYSE
4642,12-02-2021 20:00,24 hrs.,trakstocks,CFO,398,0,398,-398,1,175,44,1,NASDAQ
4642,12-02-2021 20:00,24 hrs.,trakstocks,OEG,12,12,0,12,1,3,2,1,NASDAQ
4642,12-02-2021 20:00,24 hrs.,trakstocks,ABEO,12,12,0,12,1,4,0,1,NASDAQ
4642,12-02-2021 20:00,24 hrs.,trakstocks,APPS,6,6,0,6,1,1,0,1,NASDAQ
4642,12-02-2021 20:00,24 hrs.,wallstreetbets,ATOS,28,21,7,14,4,4,4,3,NASDAQ
4642,12-02-2021 20:00,24 hrs.,wallstreetbets,AUPH,6,6,0,6,1,1,0,1,NASDAQ
4642,12-02-2021 20:00,24 hrs.,wallstreetbets,AUTL,14,0,14,-14,2,2,2,1,NASDAQ
4642,12-02-2021 20:00,24 hrs.,wallstreetbets,AVAV,6,0,6,-6,1,1,0,1,NASDAQ
4642,12-02-2021 20:00,24 hrs.,wallstreetbets,AVXL,7,7,0,7,1,1,1,1,NASDAQ
4642,12-02-2021 20:00,24 hrs.,wallstreetbets,AWRE,7,7,0,7,1,1,1,1,NASDAQ
4642,12-02-2021 20:00,24 hrs.,wallstreetbets,AXDX,21,0,21,-21,3,3,3,1,NASDAQ
4642,12-02-2021 20:00,24 hrs.,wallstreetbets,AYRO,7,7,0,7,1,1,1,1,NASDAQ
4642,12-02-2021 20:00,24 hrs.,wallstreetbets,BEAT,14,8,6,2,2,3,0,2,NASDAQ
4642,12-02-2021 20:00,24 hrs.,wallstreetbets,BIGC,35,0,35,-35,5,5,5,2,NASDAQ
4642,12-02-2021 20:00,24 hrs.,wallstreetbets,BIOC,14,7,7,0,2,2,2,2,NASDAQ
4642,12-02-2021 20:00,24 hrs.,wallstreetbets,BLNK,7,7,0,7,1,1,1,1,NASDAQ
4642,12-02-2021 20:00,24 hrs.,wallstreetbets,BLUE,6,0,6,-6,1,1,0,1,NASDAQ
4642,12-02-2021 20:00,24 hrs.,wallstreetbets,BNGO,92,79,13,66,13,14,12,10,NASDAQ
4642,12-02-2021 20:00,24 hrs.,wallstreetbets,BNTX,13,13,0,13,2,2,1,1,NASDAQ
4642,12-02-2021 20:00,24 hrs.,wallstreetbets,BOXL,7,7,0,7,1,1,1,1,NASDAQ
4642,12-02-2021 20:00,24 hrs.,wallstreetbets,BPTH,13,7,6,1,2,2,1,2,NASDAQ
4642,12-02-2021 20:00,24 hrs.,wallstreetbets,BRQS,19,6,13,-7,3,3,1,3,NASDAQ
4642,12-02-2021 20:00,24 hrs.,wallstreetbets,BSGM,6,0,6,-6,1,1,0,1,NASDAQ
4642,12-02-2021 20:00,24 hrs.,wallstreetbets,BTWN,7,7,0,7,1,1,1,1,NASDAQ
4642,12-02-2021 20:00,24 hrs.,wallstreetbets,CARE,49,49,0,49,7,7,7,2,NASDAQ
4642,12-02-2021 20:00,24 hrs.,wallstreetbets,CARV,20,7,13,-6,3,3,2,3,NASDAQ
4642,12-02-2021 20:00,24 hrs.,wallstreetbets,CASH,14,14,0,14,2,2,2,2,NASDAQ
4642,12-02-2021 20:00,24 hrs.,wallstreetbets,CATM,7,7,0,7,1,1,1,1,NASDAQ
4642,12-02-2021 20:00,24 hrs.,wallstreetbets,CBAT,7,7,0,7,1,1,1,1,NASDAQ
4642,12-02-2021 20:00,24 hrs.,wallstreetbets,CCNC,6,0,6,-6,1,1,0,1,NASDAQ
4642,12-02-2021 20:00,24 hrs.,wallstreetbets,CCRC,12,12,0,12,2,2,0,1,NASDAQ
4642,12-02-2021 20:00,24 hrs.,wallstreetbets,CGIX,14,0,14,-14,2,2,2,1,NASDAQ
4642,12-02-2021 20:00,24 hrs.,wallstreetbets,CGRO,6,0,6,-6,1,1,0,1,NASDAQ
4642,12-02-2021 20:00,24 hrs.,wallstreetbets,CIDM,14,14,0,14,2,2,2,2,NASDAQ
4642,12-02-2021 20:00,24 hrs.,wallstreetbets,CKPT,14,14,0,14,2,2,2,2,NASDAQ
4642,12-02-2021 20:00,24 hrs.,wallstreetbets,CLBS,14,14,0,14,2,2,2,1,NASDAQ
4642,12-02-2021 20:00,24 hrs.,wallstreetbets,CLCT,6,0,6,-6,1,1,0,1,NASDAQ
4642,12-02-2021 20:00,24 hrs.,wallstreetbets,CLEU,7,7,0,7,1,1,1,1,NASDAQ
4642,12-02-2021 20:00,24 hrs.,wallstreetbets,CLGN,7,7,0,7,1,1,1,1,NASDAQ
4642,12-02-2021 20:00,24 hrs.,wallstreetbets,CLSN,7,7,0,7,1,1,1,1,NASDAQ
4642,12-02-2021 20:00,24 hrs.,wallstreetbets,CLVS,34,0,34,-34,5,5,4,4,NASDAQ
4642,12-02-2021 20:00,24 hrs.,wallstreetbets,CMLF,7,0,7,-7,1,1,1,1,NASDAQ
4642,12-02-2021 20:00,24 hrs.,wallstreetbets,CMPS,2538,2523,15,2508,6,1057,400,5,NASDAQ
4642,12-02-2021 20:00,24 hrs.,wallstreetbets,CNDT,13,6,7,-1,2,2,1,2,NASDAQ
4642,12-02-2021 20:00,24 hrs.,wallstreetbets,CNSP,7,0,7,-7,1,1,1,1,NASDAQ
4642,12-02-2021 20:00,24 hrs.,wallstreetbets,CODX,7,7,0,7,1,1,1,1,NASDAQ
4642,12-02-2021 20:00,24 hrs.,wallstreetbets,COHR,401,401,0,401,1,162,73,1,NASDAQ
4642,12-02-2021 20:00,24 hrs.,trakstocks,CPSH,124,23,101,-78,4,48,12,4,NASDAQ
4642,12-02-2021 20:00,24 hrs.,trakstocks,CTRM,63,0,63,-63,2,25,5,1,NASDAQ
4642,12-02-2021 20:00,24 hrs.,trakstocks,EXPC,25,0,25,-25,1,10,1,1,NASDAQ
4642,12-02-2021 20:00,24 hrs.,trakstocks,FUTU,47,0,47,-47,1,14,15,1,NASDAQ
4642,12-02-2021 20:00,24 hrs.,trakstocks,GEVO,79,0,79,-79,1,33,9,1,NASDAQ
4642,12-02-2021 20:00,24 hrs.,trakstocks,GHIV,47,0,47,-47,1,14,15,1,NASDAQ
4642,12-02-2021 20:00,24 hrs.,trakstocks,GMDA,12,0,12,-12,1,1,6,1,NASDAQ
4642,12-02-2021 20:00,24 hrs.,trakstocks,GTHX,6,6,0,6,1,1,0,1,NASDAQ
4642,12-02-2021 20:00,24 hrs.,trakstocks,IBKR,47,0,47,-47,1,14,15,1,NASDAQ
4642,12-02-2021 20:00,24 hrs.,trakstocks,MARA,29,0,29,-29,2,6,9,2,NASDAQ
4642,12-02-2021 20:00,24 hrs.,trakstocks,OPRX,11,11,0,11,1,3,1,1,NASDAQ
4642,12-02-2021 20:00,24 hrs.,trakstocks,RIOT,29,0,29,-29,2,6,9,2,NASDAQ
4642,12-02-2021 20:00,24 hrs.,trakstocks,SNGX,34,0,34,-34,1,13,4,1,NASDAQ
4642,12-02-2021 20:00,24 hrs.,trakstocks,TTCF,30,0,30,-30,1,10,6,1,NASDAQ
4642,12-02-2021 20:00,24 hrs.,trakstocks,USWS,242,0,242,-242,2,91,52,2,NASDAQ
4642,12-02-2021 20:00,24 hrs.,trakstocks,VNDA,10,0,10,-10,1,3,0,1,NASDAQ
4642,12-02-2021 20:00,24 hrs.,trakstocks,VRME,8,0,8,-8,1,2,0,1,NASDAQ
4642,12-02-2021 20:00,24 hrs.,trakstocks,VTRS,7,0,7,-7,1,1,1,1,NASDAQ
4642,12-02-2021 20:00,24 hrs.,trakstocks,XSPA,23,0,23,-23,1,7,5,1,NASDAQ
4642,12-02-2021 20:00,24 hrs.,StockMarket,ABML,6,6,0,6,1,1,0,1,OTC
4642,12-02-2021 20:00,24 hrs.,StockMarket,BOTY,40,6,34,-28,3,4,20,2,OTC
4642,12-02-2021 20:00,24 hrs.,StockMarket,DIGI,6,0,6,-6,1,1,0,1,OTC
4642,12-02-2021 20:00,24 hrs.,StockMarket,FMCC,95,0,95,-95,1,27,37,1,OTC
4642,12-02-2021 20:00,24 hrs.,StockMarket,FNMA,95,0,95,-95,1,27,37,1,OTC
4642,12-02-2021 20:00,24 hrs.,StockMarket,GTSO,11,0,11,-11,1,3,1,1,OTC
4642,12-02-2021 20:00,24 hrs.,StockMarket,GTVH,6,6,0,6,1,1,0,1,OTC
4642,12-02-2021 20:00,24 hrs.,StockMarket,HCMC,58,58,0,58,2,21,8,2,OTC
4642,12-02-2021 20:00,24 hrs.,StockMarket,HEMP,6,6,0,6,1,1,0,1,OTC
4642,12-02-2021 20:00,24 hrs.,StockMarket,KWBT,6,6,0,6,1,1,0,1,OTC
4642,12-02-2021 20:00,24 hrs.,StockMarket,LINK,15,15,0,15,1,4,3,1,OTC
4642,12-02-2021 20:00,24 hrs.,StockMarket,MAXD,17,17,0,17,1,5,3,1,OTC
4642,12-02-2021 20:00,24 hrs.,StockMarket,MOST,15,15,0,15,1,4,3,1,OTC
4642,12-02-2021 20:00,24 hrs.,StockMarket,PCTL,6,6,0,6,1,1,0,1,OTC
4642,12-02-2021 20:00,24 hrs.,StockMarket,PHIL,6,6,0,6,1,1,0,1,OTC
4642,12-02-2021 20:00,24 hrs.,StockMarket,RLTR,6,0,6,-6,1,1,0,1,OTC
4642,12-02-2021 20:00,24 hrs.,StockMarket,RSSV,16,16,0,16,1,5,2,1,OTC
4642,12-02-2021 20:00,24 hrs.,StockMarket,RTON,6,0,6,-6,1,1,0,1,OTC
4642,12-02-2021 20:00,24 hrs.,StockMarket,SGMD,121,121,0,121,6,26,45,2,OTC
4642,12-02-2021 20:00,24 hrs.,StockMarket,SUIC,6,0,6,-6,1,1,0,1,OTC
4642,12-02-2021 20:00,24 hrs.,StockMarket,CLUBQ,9,0,9,-9,1,2,1,1,OTC
4642,12-02-2021 20:00,24 hrs.,StockMarket,DIGAF,6,6,0,6,1,1,0,1,OTC
4642,12-02-2021 20:00,24 hrs.,StockMarket,HITIF,87,0,87,-87,1,21,41,1,OTC
4642,12-02-2021 20:00,24 hrs.,StockMarket,HTZGQ,6,6,0,6,1,1,0,1,OTC
4642,12-02-2021 20:00,24 hrs.,StockMarket,NMGRF,6,6,0,6,1,1,0,1,OTC
4642,12-02-2021 20:00,24 hrs.,StockMarket,NXGWF,19,0,19,-19,1,7,1,1,OTC
4642,12-02-2021 20:00,24 hrs.,StockMarket,RAZFF,6,6,0,6,1,1,0,1,OTC
4642,12-02-2021 20:00,24 hrs.,StockMarket,RHDGF,16,16,0,16,2,3,2,1,OTC
4642,12-02-2021 20:00,24 hrs.,StockMarket,RYCEY,12,6,6,0,2,2,0,2,OTC
4642,12-02-2021 20:00,24 hrs.,StockMarket,TFECY,18,18,0,18,3,3,0,1,OTC
4642,12-02-2021 20:00,24 hrs.,StockMarket,DNN,33,6,27,-21,2,8,9,2,AMEX
4642,12-02-2021 20:00,24 hrs.,StockMarket,GSV,35,0,35,-35,1,8,15,1,AMEX
4642,12-02-2021 20:00,24 hrs.,StockMarket,ITP,8,0,8,-8,1,1,2,1,AMEX
4642,12-02-2021 20:00,24 hrs.,StockMarket,REI,10,0,10,-10,1,3,0,1,AMEX
4642,12-02-2021 20:00,24 hrs.,StockMarket,URG,27,0,27,-27,1,7,9,1,AMEX
4642,12-02-2021 20:00,24 hrs.,StockMarket,ZOM,54,0,54,-54,3,10,22,3,AMEX
4642,12-02-2021 20:00,24 hrs.,StockMarket,GSAT,51,51,0,51,1,13,21,1,AMEX
4642,12-02-2021 20:00,24 hrs.,StockMarket,LODE,6,6,0,6,1,1,0,1,AMEX
4642,12-02-2021 20:00,24 hrs.,StockMarket,NSPR,6,6,0,6,1,1,0,1,AMEX
4642,12-02-2021 20:00,24 hrs.,wallstreetbets,DFFN,14,14,0,14,2,2,2,1,NASDAQ
4642,12-02-2021 20:00,24 hrs.,trakstocks,PYRNF,6,6,0,6,1,1,0,1,OTC
4642,12-02-2021 20:00,24 hrs.,trakstocks,DNN,39,39,0,39,1,15,5,1,AMEX
4642,12-02-2021 20:00,24 hrs.,trakstocks,TRXC,148,67,81,-14,2,54,32,2,AMEX
4642,12-02-2021 20:00,24 hrs.,trakstocks,UUUU,45,0,45,-45,1,11,19,1,AMEX
4642,12-02-2021 20:00,24 hrs.,trakstocks,AMC,72,25,47,-22,2,16,32,2,NYSE
4642,12-02-2021 20:00,24 hrs.,wallstreetbets,EBAY,60,0,60,-60,1,18,20,1,NASDAQ
4642,12-02-2021 20:00,24 hrs.,wallstreetbets,EBON,7,7,0,7,1,1,1,1,NASDAQ
4642,12-02-2021 20:00,24 hrs.,wallstreetbets,EDIT,1575,0,1575,-1575,2,569,429,2,NASDAQ
4642,12-02-2021 20:00,24 hrs.,wallstreetbets,EDSA,6,6,0,6,1,1,0,1,NASDAQ
4642,12-02-2021 20:00,24 hrs.,wallstreetbets,EHTH,7,7,0,7,1,1,1,1,NASDAQ
4642,12-02-2021 20:00,24 hrs.,wallstreetbets,ELSE,7,7,0,7,1,1,1,1,NASDAQ
4642,12-02-2021 20:00,24 hrs.,wallstreetbets,ENLV,6,0,6,-6,1,1,0,1,NASDAQ
4642,12-02-2021 20:00,24 hrs.,wallstreetbets,ENVB,33,26,7,19,5,5,3,4,NASDAQ
4642,12-02-2021 20:00,24 hrs.,wallstreetbets,ERIC,7,0,7,-7,1,1,1,1,NASDAQ
4642,12-02-2021 20:00,24 hrs.,wallstreetbets,ESPR,19,7,12,-5,3,3,1,3,NASDAQ
4642,12-02-2021 20:00,24 hrs.,wallstreetbets,ETSY,66,0,66,-66,2,19,20,2,NASDAQ
4642,12-02-2021 20:00,24 hrs.,wallstreetbets,EVER,27,21,6,15,4,4,3,4,NASDAQ
4642,12-02-2021 20:00,24 hrs.,wallstreetbets,EVFM,6,0,6,-6,1,1,0,1,NASDAQ
4642,12-02-2021 20:00,24 hrs.,wallstreetbets,EXPC,7,7,0,7,1,1,1,1,NASDAQ
4642,12-02-2021 20:00,24 hrs.,wallstreetbets,EXPE,401,401,0,401,1,162,73,1,NASDAQ
4642,12-02-2021 20:00,24 hrs.,wallstreetbets,EYES,26,0,26,-26,4,4,2,1,NASDAQ
4642,12-02-2021 20:00,24 hrs.,wallstreetbets,FAMI,6,6,0,6,1,1,0,1,NASDAQ
4642,12-02-2021 20:00,24 hrs.,wallstreetbets,FANG,7,0,7,-7,1,1,1,1,NASDAQ
4642,12-02-2021 20:00,24 hrs.,wallstreetbets,FARM,7,7,0,7,1,1,1,1,NASDAQ
4642,12-02-2021 20:00,24 hrs.,wallstreetbets,FCAC,8,8,0,8,1,1,2,1,NASDAQ
4642,12-02-2021 20:00,24 hrs.,wallstreetbets,FCEL,13,6,7,-1,2,2,1,2,NASDAQ
4642,12-02-2021 20:00,24 hrs.,wallstreetbets,FLDM,7,7,0,7,1,1,1,1,NASDAQ
4642,12-02-2021 20:00,24 hrs.,wallstreetbets,FLGT,13,13,0,13,2,2,1,2,NASDAQ
4642,12-02-2021 20:00,24 hrs.,wallstreetbets,FLWS,7,7,0,7,1,1,1,1,NASDAQ
4642,12-02-2021 20:00,24 hrs.,wallstreetbets,FNKO,6,0,6,-6,1,1,0,1,NASDAQ
4642,12-02-2021 20:00,24 hrs.,wallstreetbets,FOLD,40,34,6,28,6,6,4,5,NASDAQ
4642,12-02-2021 20:00,24 hrs.,wallstreetbets,FORD,7,7,0,7,1,1,1,1,NASDAQ
4642,12-02-2021 20:00,24 hrs.,wallstreetbets,FTFT,7,7,0,7,1,1,1,1,NASDAQ
4642,12-02-2021 20:00,24 hrs.,wallstreetbets,FUTU,924,525,399,126,2,309,298,2,NASDAQ
4642,12-02-2021 20:00,24 hrs.,wallstreetbets,GAIN,35,7,28,-21,5,5,5,5,NASDAQ
4642,12-02-2021 20:00,24 hrs.,wallstreetbets,GDRX,7,0,7,-7,1,1,1,1,NASDAQ
4642,12-02-2021 20:00,24 hrs.,wallstreetbets,GERN,7,0,7,-7,1,1,1,1,NASDAQ
4642,12-02-2021 20:00,24 hrs.,wallstreetbets,GEVO,165,158,7,151,9,42,45,7,NASDAQ
4642,12-02-2021 20:00,24 hrs.,wallstreetbets,GHIV,399,0,399,-399,1,122,151,1,NASDAQ
4642,12-02-2021 20:00,24 hrs.,wallstreetbets,GHSI,20,0,20,-20,3,3,2,2,NASDAQ
4642,12-02-2021 20:00,24 hrs.,wallstreetbets,GILT,14,14,0,14,2,2,2,2,NASDAQ
4642,12-02-2021 20:00,24 hrs.,wallstreetbets,GLMD,21,21,0,21,3,3,3,1,NASDAQ
4642,12-02-2021 20:00,24 hrs.,wallstreetbets,GLPG,7,7,0,7,1,1,1,1,NASDAQ
4642,12-02-2021 20:00,24 hrs.,wallstreetbets,GLSI,8,0,8,-8,1,1,2,1,NASDAQ
4642,12-02-2021 20:00,24 hrs.,wallstreetbets,GLUU,31,31,0,31,2,1,21,1,NASDAQ
4642,12-02-2021 20:00,24 hrs.,wallstreetbets,GMBL,7,7,0,7,1,1,1,1,NASDAQ
4642,12-02-2021 20:00,24 hrs.,wallstreetbets,GNOG,13,0,13,-13,2,2,1,2,NASDAQ
4642,12-02-2021 20:00,24 hrs.,wallstreetbets,GNRS,14,14,0,14,2,2,2,1,NASDAQ
4642,12-02-2021 20:00,24 hrs.,wallstreetbets,GNUS,6,6,0,6,1,1,0,1,NASDAQ
4642,12-02-2021 20:00,24 hrs.,wallstreetbets,GOGO,32,13,19,-6,5,5,2,4,NASDAQ
4642,12-02-2021 20:00,24 hrs.,wallstreetbets,GOLD,267,13,254,-241,6,86,71,6,NASDAQ
4642,12-02-2021 20:00,24 hrs.,wallstreetbets,GRIL,25,0,25,-25,4,4,1,3,NASDAQ
4642,12-02-2021 20:00,24 hrs.,wallstreetbets,GRMN,6,0,6,-6,1,1,0,1,NASDAQ
4642,12-02-2021 20:00,24 hrs.,wallstreetbets,GRTS,6,6,0,6,1,1,0,1,NASDAQ
4642,12-02-2021 20:00,24 hrs.,wallstreetbets,GRWG,13,0,13,-13,2,2,1,2,NASDAQ
4642,12-02-2021 20:00,24 hrs.,wallstreetbets,GTHX,32,25,7,18,5,5,2,4,NASDAQ
4642,12-02-2021 20:00,24 hrs.,wallstreetbets,GWPH,13,13,0,13,1,0,9,1,NASDAQ
4642,12-02-2021 20:00,24 hrs.,wallstreetbets,HALO,14,14,0,14,2,2,2,2,NASDAQ
4642,12-02-2021 20:00,24 hrs.,wallstreetbets,HDSN,7,7,0,7,1,1,1,1,NASDAQ
4642,12-02-2021 20:00,24 hrs.,wallstreetbets,HEPA,9,0,9,-9,1,1,3,1,NASDAQ
4642,12-02-2021 20:00,24 hrs.,wallstreetbets,HIMX,7,0,7,-7,1,1,1,1,NASDAQ
4642,12-02-2021 20:00,24 hrs.,wallstreetbets,HJLI,14,14,0,14,2,2,2,1,NASDAQ
4642,12-02-2021 20:00,24 hrs.,wallstreetbets,HSTO,26,26,0,26,4,4,2,3,NASDAQ
4642,12-02-2021 20:00,24 hrs.,wallstreetbets,HTBX,14,8,6,2,2,2,2,2,NASDAQ
4642,12-02-2021 20:00,24 hrs.,trakstocks,AYRO,29,29,0,29,1,8,9,1,NASDAQ
4642,12-02-2021 20:00,24 hrs.,trakstocks,BHTG,173,173,0,173,1,72,25,1,NASDAQ
4642,12-02-2021 20:00,24 hrs.,trakstocks,BTBT,13,0,13,-13,1,3,3,1,NASDAQ
4642,12-02-2021 20:00,24 hrs.,trakstocks,CFII,27,27,0,27,1,7,9,1,NASDAQ
4642,12-02-2021 20:00,24 hrs.,trakstocks,CHEF,30,0,30,-30,1,10,6,1,NASDAQ
4642,12-02-2021 20:00,24 hrs.,StockMarket,MRO,15,15,0,15,1,4,3,1,NYSE
4642,12-02-2021 20:00,24 hrs.,StockMarket,NIO,6,6,0,6,1,1,0,1,NYSE
4642,12-02-2021 20:00,24 hrs.,StockMarket,NSA,428,0,428,-428,1,194,36,1,NYSE
4642,12-02-2021 20:00,24 hrs.,StockMarket,PDT,12,0,12,-12,1,3,2,1,NYSE
4642,12-02-2021 20:00,24 hrs.,StockMarket,PHI,6,6,0,6,1,1,0,1,NYSE
4642,12-02-2021 20:00,24 hrs.,StockMarket,RSI,6,0,6,-6,1,1,0,1,NYSE
4642,12-02-2021 20:00,24 hrs.,StockMarket,SBE,6,6,0,6,1,1,0,1,NYSE
4642,12-02-2021 20:00,24 hrs.,StockMarket,SOS,33,27,6,21,4,7,3,4,NYSE
4642,12-02-2021 20:00,24 hrs.,StockMarket,TDA,12,12,0,12,1,1,6,1,NYSE
4642,12-02-2021 20:00,24 hrs.,StockMarket,TSE,39,0,39,-39,2,11,9,2,NYSE
4642,12-02-2021 20:00,24 hrs.,StockMarket,TTM,19,0,19,-19,1,3,9,1,NYSE
4642,12-02-2021 20:00,24 hrs.,StockMarket,UBS,60,0,60,-60,1,20,16,1,NYSE
4642,12-02-2021 20:00,24 hrs.,StockMarket,AVLR,60,0,60,-60,1,20,16,1,NYSE
4642,12-02-2021 20:00,24 hrs.,StockMarket,CACI,428,0,428,-428,1,194,36,1,NYSE
4642,12-02-2021 20:00,24 hrs.,StockMarket,CCIV,16,16,0,16,1,5,2,1,NYSE
4642,12-02-2021 20:00,24 hrs.,StockMarket,COTY,8,8,0,8,1,2,0,1,NYSE
4642,12-02-2021 20:00,24 hrs.,StockMarket,FUSE,12,12,0,12,2,2,0,2,NYSE
4642,12-02-2021 20:00,24 hrs.,StockMarket,HYLN,15,15,0,15,1,4,3,1,NYSE
4642,12-02-2021 20:00,24 hrs.,StockMarket,LAIX,12,12,0,12,1,0,8,1,NYSE
4642,12-02-2021 20:00,24 hrs.,StockMarket,MDLY,6,0,6,-6,1,0,2,1,NYSE
4642,12-02-2021 20:00,24 hrs.,StockMarket,PAYC,60,0,60,-60,1,20,16,1,NYSE
4642,12-02-2021 20:00,24 hrs.,StockMarket,TEVA,6,0,6,-6,1,1,0,1,NYSE
4642,12-02-2021 20:00,24 hrs.,StockMarket,UBER,60,0,60,-60,1,20,16,1,NYSE
4642,12-02-2021 20:00,24 hrs.,StockMarket,VGAC,10,10,0,10,1,1,4,1,NYSE
4642,12-02-2021 20:00,24 hrs.,StockMarket,XPEV,428,0,428,-428,1,194,36,1,NYSE
4642,12-02-2021 20:00,24 hrs.,StockMarket,YETI,4,4,0,4,1,0,0,1,NYSE
4642,12-02-2021 20:00,24 hrs.,StockMarket,AMD,24,6,18,-12,3,2,8,3,NASDAQ
4642,12-02-2021 20:00,24 hrs.,StockMarket,AZN,15,15,0,15,1,4,3,1,NASDAQ
4642,12-02-2021 20:00,24 hrs.,StockMarket,CDC,15,15,0,15,1,4,3,1,NASDAQ
4642,12-02-2021 20:00,24 hrs.,StockMarket,HAS,6,0,6,-6,1,1,0,1,NASDAQ
4642,12-02-2021 20:00,24 hrs.,StockMarket,INO,15,15,0,15,1,4,3,1,NASDAQ
4642,12-02-2021 20:00,24 hrs.,StockMarket,JFU,51,51,0,51,1,13,21,1,NASDAQ
4642,12-02-2021 20:00,24 hrs.,StockMarket,MGI,9,9,0,9,1,2,1,1,NASDAQ
4642,12-02-2021 20:00,24 hrs.,StockMarket,NWL,15,15,0,15,1,4,3,1,NASDAQ
4642,12-02-2021 20:00,24 hrs.,StockMarket,OGI,45,10,35,-25,3,13,7,3,NASDAQ
4642,12-02-2021 20:00,24 hrs.,StockMarket,OPK,6,6,0,6,1,1,0,1,NASDAQ
4642,12-02-2021 20:00,24 hrs.,StockMarket,RCM,6,0,6,-6,1,1,0,1,NASDAQ
4642,12-02-2021 20:00,24 hrs.,StockMarket,SFT,6,6,0,6,1,1,0,1,NASDAQ
4642,12-02-2021 20:00,24 hrs.,StockMarket,SND,10,0,10,-10,1,3,0,1,NASDAQ
4642,12-02-2021 20:00,24 hrs.,StockMarket,AAPL,60,0,60,-60,1,20,16,1,NASDAQ
4642,12-02-2021 20:00,24 hrs.,StockMarket,AEZS,4,4,0,4,1,0,0,1,NASDAQ
4642,12-02-2021 20:00,24 hrs.,wallstreetbets,IBKR,572,0,572,-572,3,186,188,3,NASDAQ
4642,12-02-2021 20:00,24 hrs.,wallstreetbets,ICLN,12,6,6,0,2,2,0,2,NASDAQ
4642,12-02-2021 20:00,24 hrs.,wallstreetbets,ICON,7,7,0,7,1,1,1,1,NASDAQ
4642,12-02-2021 20:00,24 hrs.,wallstreetbets,ICPT,13,7,6,1,2,2,1,2,NASDAQ
4642,12-02-2021 20:00,24 hrs.,wallstreetbets,IDEX,185,144,41,103,9,43,63,7,NASDAQ
4642,12-02-2021 20:00,24 hrs.,wallstreetbets,IFMK,20,0,20,-20,3,3,2,2,NASDAQ
4642,12-02-2021 20:00,24 hrs.,wallstreetbets,IIVI,401,401,0,401,1,162,73,1,NASDAQ
4642,12-02-2021 20:00,24 hrs.,wallstreetbets,ILMN,7,7,0,7,1,1,1,1,NASDAQ
4642,12-02-2021 20:00,24 hrs.,wallstreetbets,IMGN,125,21,104,-83,4,38,33,4,NASDAQ
4642,12-02-2021 20:00,24 hrs.,wallstreetbets,IMMR,8,0,8,-8,1,1,2,1,NASDAQ
4642,12-02-2021 20:00,24 hrs.,wallstreetbets,INFI,21,21,0,21,3,3,3,1,NASDAQ
4642,12-02-2021 20:00,24 hrs.,wallstreetbets,INFO,8,0,8,-8,1,1,2,1,NASDAQ
4642,12-02-2021 20:00,24 hrs.,wallstreetbets,INPX,19,19,0,19,3,3,1,2,NASDAQ
4642,12-02-2021 20:00,24 hrs.,wallstreetbets,INTC,113,98,15,83,4,4,89,4,NASDAQ
4642,12-02-2021 20:00,24 hrs.,wallstreetbets,IPWR,6,6,0,6,1,1,0,1,NASDAQ
4642,12-02-2021 20:00,24 hrs.,wallstreetbets,IRBT,14,0,14,-14,2,2,2,2,NASDAQ
4642,12-02-2021 20:00,24 hrs.,wallstreetbets,IRDM,6,0,6,-6,1,1,0,1,NASDAQ
4642,12-02-2021 20:00,24 hrs.,wallstreetbets,ITRM,35,35,0,35,5,5,5,3,NASDAQ
4642,12-02-2021 20:00,24 hrs.,wallstreetbets,DKNG,20,14,6,8,3,3,2,3,NASDAQ
4642,12-02-2021 20:00,24 hrs.,wallstreetbets,DLPN,6,0,6,-6,1,1,0,1,NASDAQ
4642,12-02-2021 20:00,24 hrs.,wallstreetbets,DOYU,7,7,0,7,1,1,1,1,NASDAQ
4642,12-02-2021 20:00,24 hrs.,wallstreetbets,DRRX,7,7,0,7,1,1,1,1,NASDAQ
4642,12-02-2021 20:00,24 hrs.,wallstreetbets,DSKE,7,7,0,7,1,1,1,1,NASDAQ
4642,12-02-2021 20:00,24 hrs.,StockMarket,DDOG,15,15,0,15,1,4,3,1,NASDAQ
4642,12-02-2021 20:00,24 hrs.,StockMarket,ENTX,8,8,0,8,1,2,0,1,NASDAQ
4642,12-02-2021 20:00,24 hrs.,StockMarket,EXPE,15,15,0,15,1,4,3,1,NASDAQ
4642,12-02-2021 20:00,24 hrs.,StockMarket,FNKO,29,0,29,-29,1,9,7,1,NASDAQ
4642,12-02-2021 20:00,24 hrs.,StockMarket,GBIO,7,7,0,7,1,1,1,1,NASDAQ
4642,12-02-2021 20:00,24 hrs.,StockMarket,HTBX,63,57,6,51,3,15,21,3,NASDAQ
4642,12-02-2021 20:00,24 hrs.,StockMarket,IBKR,6,0,6,-6,1,1,0,1,NASDAQ
4642,12-02-2021 20:00,24 hrs.,StockMarket,IIVI,15,15,0,15,1,4,3,1,NASDAQ
4642,12-02-2021 20:00,24 hrs.,StockMarket,INMD,60,0,60,-60,1,20,16,1,NASDAQ
4642,12-02-2021 20:00,24 hrs.,StockMarket,INTZ,4,4,0,4,1,0,0,1,NASDAQ
4642,12-02-2021 20:00,24 hrs.,StockMarket,INVE,24,0,24,-24,2,6,4,1,NASDAQ
4642,12-02-2021 20:00,24 hrs.,StockMarket,LAZR,6,0,6,-6,1,1,0,1,NASDAQ
4642,12-02-2021 20:00,24 hrs.,StockMarket,LGND,6,0,6,-6,1,1,0,1,NASDAQ
4642,12-02-2021 20:00,24 hrs.,wallstreetbets,JBLU,12,0,12,-12,2,2,0,2,NASDAQ
4642,12-02-2021 20:00,24 hrs.,wallstreetbets,JNCE,12,6,6,0,2,2,0,2,NASDAQ
4642,12-02-2021 20:00,24 hrs.,wallstreetbets,KERN,13,0,13,-13,2,2,1,2,NASDAQ
4642,12-02-2021 20:00,24 hrs.,wallstreetbets,KOSS,136,136,0,136,2,44,40,2,NASDAQ
4642,12-02-2021 20:00,24 hrs.,wallstreetbets,LAKE,6,0,6,-6,1,1,0,1,NASDAQ
4642,12-02-2021 20:00,24 hrs.,wallstreetbets,LAZR,7,0,7,-7,1,1,1,1,NASDAQ
4642,12-02-2021 20:00,24 hrs.,wallstreetbets,LEGN,7,7,0,7,1,1,1,1,NASDAQ
4642,12-02-2021 20:00,24 hrs.,wallstreetbets,LGHL,6,0,6,-6,1,1,0,1,NASDAQ
4642,12-02-2021 20:00,24 hrs.,wallstreetbets,LGND,13,13,0,13,2,2,1,2,NASDAQ
4642,12-02-2021 20:00,24 hrs.,wallstreetbets,LIFE,20,14,6,8,3,3,2,3,NASDAQ
4642,12-02-2021 20:00,24 hrs.,wallstreetbets,LITE,401,401,0,401,1,162,73,1,NASDAQ
4642,12-02-2021 20:00,24 hrs.,wallstreetbets,LIVE,733,408,325,83,3,286,149,3,NASDAQ
4642,12-02-2021 20:00,24 hrs.,wallstreetbets,LIVX,15,0,15,-15,2,2,3,1,NASDAQ
4642,12-02-2021 20:00,24 hrs.,wallstreetbets,LKCO,48,42,6,36,7,7,6,6,NASDAQ
4642,12-02-2021 20:00,24 hrs.,wallstreetbets,LLIT,7,7,0,7,1,1,1,1,NASDAQ
4642,12-02-2021 20:00,24 hrs.,wallstreetbets,LLNW,55,27,28,-1,8,8,7,8,NASDAQ
4642,12-02-2021 20:00,24 hrs.,wallstreetbets,LOAN,7,7,0,7,1,1,1,1,NASDAQ
4642,12-02-2021 20:00,24 hrs.,wallstreetbets,LPCN,7,7,0,7,1,1,1,1,NASDAQ
4642,12-02-2021 20:00,24 hrs.,wallstreetbets,LRCX,432,432,0,432,1,109,210,1,NASDAQ
4642,12-02-2021 20:00,24 hrs.,wallstreetbets,MARA,52,14,38,-24,8,8,4,7,NASDAQ
4642,12-02-2021 20:00,24 hrs.,wallstreetbets,MARK,14,14,0,14,2,2,2,2,NASDAQ
4642,12-02-2021 20:00,24 hrs.,wallstreetbets,MBRX,38,19,19,0,6,6,2,5,NASDAQ
4642,12-02-2021 20:00,24 hrs.,wallstreetbets,MGNI,21,14,7,7,3,3,3,3,NASDAQ
4642,12-02-2021 20:00,24 hrs.,wallstreetbets,MKSI,401,401,0,401,1,162,73,1,NASDAQ
4642,12-02-2021 20:00,24 hrs.,wallstreetbets,MNPR,6,0,6,-6,1,1,0,1,NASDAQ
4642,12-02-2021 20:00,24 hrs.,wallstreetbets,MOGO,7,0,7,-7,1,1,1,1,NASDAQ
4642,12-02-2021 20:00,24 hrs.,wallstreetbets,MOSY,7,0,7,-7,1,1,1,1,NASDAQ
4642,12-02-2021 20:00,24 hrs.,wallstreetbets,MOTS,12,0,12,-12,2,2,0,1,NASDAQ
4642,12-02-2021 20:00,24 hrs.,wallstreetbets,MRNA,6,6,0,6,1,1,0,1,NASDAQ
4642,12-02-2021 20:00,24 hrs.,wallstreetbets,MRVL,7,7,0,7,1,1,1,1,NASDAQ
4642,12-02-2021 20:00,24 hrs.,wallstreetbets,MSFT,175,168,7,161,2,68,31,2,NASDAQ
4642,12-02-2021 20:00,24 hrs.,wallstreetbets,MSTR,39,27,12,15,6,6,3,4,NASDAQ
4642,12-02-2021 20:00,24 hrs.,wallstreetbets,MTCH,7,7,0,7,1,1,1,1,NASDAQ
4642,12-02-2021 20:00,24 hrs.,wallstreetbets,MVIS,333,291,42,249,12,103,79,10,NASDAQ
4642,12-02-2021 20:00,24 hrs.,StockMarket,RLGT,6,0,6,-6,1,1,0,1,AMEX
4642,12-02-2021 20:00,24 hrs.,StockMarket,UUUU,27,0,27,-27,1,7,9,1,AMEX
4642,12-02-2021 20:00,24 hrs.,StockMarket,AFC,6,6,0,6,1,1,0,1,NYSE
4642,12-02-2021 20:00,24 hrs.,StockMarket,AGX,6,6,0,6,1,1,0,1,NYSE
4642,12-02-2021 20:00,24 hrs.,StockMarket,ALV,20,0,20,-20,1,3,10,1,NYSE
4642,12-02-2021 20:00,24 hrs.,StockMarket,AMC,441,12,429,-417,3,187,55,3,NYSE
4642,12-02-2021 20:00,24 hrs.,StockMarket,BHC,15,15,0,15,1,4,3,1,NYSE
4642,12-02-2021 20:00,24 hrs.,StockMarket,CIA,428,0,428,-428,1,194,36,1,NYSE
4642,12-02-2021 20:00,24 hrs.,StockMarket,CMI,60,0,60,-60,1,20,16,1,NYSE
4642,12-02-2021 20:00,24 hrs.,StockMarket,DIS,15,15,0,15,1,4,3,1,NYSE
4642,12-02-2021 20:00,24 hrs.,StockMarket,FAF,6,0,6,-6,1,1,0,1,NYSE
4642,12-02-2021 20:00,24 hrs.,StockMarket,FSR,15,15,0,15,1,4,3,1,NYSE
4642,12-02-2021 20:00,24 hrs.,StockMarket,GME,541,20,521,-501,9,209,87,9,NYSE
4642,12-02-2021 20:00,24 hrs.,StockMarket,IBM,428,0,428,-428,1,194,36,1,NYSE
4642,12-02-2021 20:00,24 hrs.,StockMarket,LAC,4,4,0,4,1,0,0,1,NYSE
4642,12-02-2021 20:00,24 hrs.,StockMarket,LMT,19,0,19,-19,1,2,11,1,NYSE
4642,12-02-2021 20:00,24 hrs.,StockMarket,MCO,15,15,0,15,1,4,3,1,NYSE
4642,12-02-2021 20:00,24 hrs.,wallstreetbets,NCLH,7,7,0,7,1,1,1,1,NASDAQ
4642,12-02-2021 20:00,24 hrs.,wallstreetbets,NDRA,13,0,13,-13,2,2,1,2,NASDAQ
4642,12-02-2021 20:00,24 hrs.,wallstreetbets,NEOS,7,7,0,7,1,1,1,1,NASDAQ
4642,12-02-2021 20:00,24 hrs.,wallstreetbets,NEPT,13,0,13,-13,2,2,1,2,NASDAQ
4642,12-02-2021 20:00,24 hrs.,wallstreetbets,NFLX,7,7,0,7,1,1,1,1,NASDAQ
4642,12-02-2021 20:00,24 hrs.,wallstreetbets,NKLA,14,0,14,-14,2,2,2,2,NASDAQ
4642,12-02-2021 20:00,24 hrs.,wallstreetbets,NLOK,7,7,0,7,1,1,1,1,NASDAQ
4642,12-02-2021 20:00,24 hrs.,wallstreetbets,NMRK,6,6,0,6,1,1,0,1,NASDAQ
4642,12-02-2021 20:00,24 hrs.,wallstreetbets,NNDM,28,21,7,14,4,4,4,2,NASDAQ
4642,12-02-2021 20:00,24 hrs.,wallstreetbets,NNOX,6,0,6,-6,1,1,0,1,NASDAQ
4642,12-02-2021 20:00,24 hrs.,wallstreetbets,NOVN,7,0,7,-7,1,1,1,1,NASDAQ
4642,12-02-2021 20:00,24 hrs.,wallstreetbets,NUAN,381,381,0,381,1,156,65,1,NASDAQ
4642,12-02-2021 20:00,24 hrs.,wallstreetbets,NVAX,6,0,6,-6,1,1,0,1,NASDAQ
4642,12-02-2021 20:00,24 hrs.,wallstreetbets,NVCN,20,0,20,-20,3,3,2,3,NASDAQ
4642,12-02-2021 20:00,24 hrs.,wallstreetbets,NVDA,530,530,0,530,3,110,298,3,NASDAQ
4642,12-02-2021 20:00,24 hrs.,wallstreetbets,NXTD,12,0,12,-12,2,2,0,2,NASDAQ
4642,12-02-2021 20:00,24 hrs.,wallstreetbets,OCGN,38,38,0,38,6,6,2,5,NASDAQ
4642,12-02-2021 20:00,24 hrs.,wallstreetbets,ONVO,7,7,0,7,1,1,1,1,NASDAQ
4642,12-02-2021 20:00,24 hrs.,wallstreetbets,OPGN,14,14,0,14,2,2,2,1,NASDAQ
4642,12-02-2021 20:00,24 hrs.,wallstreetbets,OPTT,6,6,0,6,1,1,0,1,NASDAQ
4642,12-02-2021 20:00,24 hrs.,wallstreetbets,OSTK,9,0,9,-9,1,1,3,1,NASDAQ
4642,12-02-2021 20:00,24 hrs.,wallstreetbets,PACB,14,0,14,-14,2,2,2,1,NASDAQ
4642,12-02-2021 20:00,24 hrs.,wallstreetbets,PENN,2616,2616,0,2616,6,1188,216,2,NASDAQ
4642,12-02-2021 20:00,24 hrs.,wallstreetbets,PHIO,7,0,7,-7,1,1,1,1,NASDAQ
4642,12-02-2021 20:00,24 hrs.,wallstreetbets,PHUN,7,7,0,7,1,1,1,1,NASDAQ
4642,12-02-2021 20:00,24 hrs.,wallstreetbets,PLAY,20,7,13,-6,3,3,2,3,NASDAQ
4642,12-02-2021 20:00,24 hrs.,wallstreetbets,PLUG,7,7,0,7,1,1,1,1,NASDAQ
4642,12-02-2021 20:00,24 hrs.,wallstreetbets,PLYA,7,7,0,7,1,1,1,1,NASDAQ
4642,12-02-2021 20:00,24 hrs.,wallstreetbets,POTX,7,7,0,7,1,1,1,1,NASDAQ
4642,12-02-2021 20:00,24 hrs.,wallstreetbets,POWW,54,20,34,-14,8,8,6,7,NASDAQ
4642,12-02-2021 20:00,24 hrs.,wallstreetbets,PRCH,19,13,6,7,3,3,1,3,NASDAQ
4642,12-02-2021 20:00,24 hrs.,wallstreetbets,PRPL,525,525,0,525,1,187,147,1,NASDAQ
4642,12-02-2021 20:00,24 hrs.,wallstreetbets,PRTS,15,15,0,15,2,2,3,1,NASDAQ
4642,12-02-2021 20:00,24 hrs.,wallstreetbets,PSAC,7,7,0,7,1,1,1,1,NASDAQ
4642,12-02-2021 20:00,24 hrs.,wallstreetbets,PSEC,19,0,19,-19,1,0,15,1,NASDAQ
4642,12-02-2021 20:00,24 hrs.,wallstreetbets,PSTV,13,0,13,-13,2,2,1,2,NASDAQ
4642,12-02-2021 20:00,24 hrs.,wallstreetbets,PTCT,7,7,0,7,1,1,1,1,NASDAQ
4642,12-02-2021 20:00,24 hrs.,wallstreetbets,PTON,2609,2609,0,2609,5,1187,215,1,NASDAQ
4642,12-02-2021 20:00,24 hrs.,wallstreetbets,PYPL,7,0,7,-7,1,1,1,1,NASDAQ
4642,12-02-2021 20:00,24 hrs.,wallstreetbets,PZZA,7,0,7,-7,1,1,1,1,NASDAQ
4642,12-02-2021 20:00,24 hrs.,wallstreetbets,QCOM,7,7,0,7,1,1,1,1,NASDAQ
4642,12-02-2021 20:00,24 hrs.,wallstreetbets,QQQJ,22,22,0,22,1,6,6,1,NASDAQ
4642,12-02-2021 20:00,24 hrs.,wallstreetbets,QRVO,6,0,6,-6,1,1,0,1,NASDAQ
4642,12-02-2021 20:00,24 hrs.,wallstreetbets,QUIK,26,13,13,0,4,4,2,3,NASDAQ
4642,12-02-2021 20:00,24 hrs.,wallstreetbets,RCMT,14,0,14,-14,2,2,2,2,NASDAQ
4642,12-02-2021 20:00,24 hrs.,wallstreetbets,RDHL,13,13,0,13,2,2,1,2,NASDAQ
4642,12-02-2021 20:00,24 hrs.,wallstreetbets,REAL,41,0,41,-41,6,6,5,6,NASDAQ
4642,12-02-2021 20:00,24 hrs.,StockMarket,APHA,449,6,443,-437,4,124,185,4,NASDAQ
4642,12-02-2021 20:00,24 hrs.,StockMarket,ARTL,67,67,0,67,1,15,33,1,NASDAQ
4642,12-02-2021 20:00,24 hrs.,StockMarket,ASYS,4,0,4,-4,1,0,0,1,NASDAQ
4642,12-02-2021 20:00,24 hrs.,StockMarket,ATOM,25,0,25,-25,1,9,3,1,NASDAQ
4642,12-02-2021 20:00,24 hrs.,StockMarket,ATOS,21,21,0,21,2,6,1,2,NASDAQ
4642,12-02-2021 20:00,24 hrs.,StockMarket,AVGO,6,6,0,6,1,1,0,1,NASDAQ
4642,12-02-2021 20:00,24 hrs.,StockMarket,BPTH,6,6,0,6,1,1,0,1,NASDAQ
4642,12-02-2021 20:00,24 hrs.,StockMarket,BYND,6,6,0,6,1,1,0,1,NASDAQ
4642,12-02-2021 20:00,24 hrs.,StockMarket,CECE,16,0,16,-16,1,6,0,1,NASDAQ
4642,12-02-2021 20:00,24 hrs.,StockMarket,CLEU,79,79,0,79,2,15,41,2,NASDAQ
4642,12-02-2021 20:00,24 hrs.,StockMarket,CLNE,60,0,60,-60,1,20,16,1,NASDAQ
4642,12-02-2021 20:00,24 hrs.,StockMarket,CLSK,8,0,8,-8,1,1,2,1,NASDAQ
4642,12-02-2021 20:00,24 hrs.,StockMarket,COHR,15,15,0,15,1,4,3,1,NASDAQ
4642,12-02-2021 20:00,24 hrs.,StockMarket,CPLP,12,12,0,12,2,2,0,2,NASDAQ
4642,12-02-2021 20:00,24 hrs.,StockMarket,CRSP,4,4,0,4,1,0,0,1,NASDAQ
4642,12-02-2021 20:00,24 hrs.,StockMarket,CTHR,21,0,21,-21,1,5,7,1,NASDAQ
4642,12-02-2021 20:00,24 hrs.,StockMarket,CTRM,18,0,18,-18,3,3,0,3,NASDAQ
4642,12-02-2021 20:00,24 hrs.,pennystocks,BLSP,13,6,7,-1,2,2,1,2,OTC
4642,12-02-2021 20:00,24 hrs.,pennystocks,BMCS,10,10,0,10,1,2,2,1,OTC
4642,12-02-2021 20:00,24 hrs.,pennystocks,BMIX,45,6,39,-33,2,8,21,2,OTC
4642,12-02-2021 20:00,24 hrs.,pennystocks,BONZ,6,6,0,6,1,0,2,1,OTC
4642,12-02-2021 20:00,24 hrs.,pennystocks,BOTY,125,0,125,-125,5,34,37,4,OTC
4642,12-02-2021 20:00,24 hrs.,pennystocks,BRGO,17,0,17,-17,1,5,3,1,OTC
4642,12-02-2021 20:00,24 hrs.,pennystocks,BRLL,52,46,6,40,3,5,30,3,OTC
4642,12-02-2021 20:00,24 hrs.,pennystocks,BRTX,6,6,0,6,1,1,0,1,OTC
4642,12-02-2021 20:00,24 hrs.,pennystocks,BUDZ,24,24,0,24,3,4,4,3,OTC
4642,12-02-2021 20:00,24 hrs.,pennystocks,BWMG,62,52,10,42,3,14,22,3,OTC
4642,12-02-2021 20:00,24 hrs.,pennystocks,BXNG,21,0,21,-21,1,2,13,1,OTC
4642,12-02-2021 20:00,24 hrs.,pennystocks,BZWR,12,12,0,12,1,0,8,1,OTC
4642,12-02-2021 20:00,24 hrs.,pennystocks,CANN,6,6,0,6,1,1,0,1,OTC
4642,12-02-2021 20:00,24 hrs.,pennystocks,CAPC,7,7,0,7,1,1,1,1,OTC
4642,12-02-2021 20:00,24 hrs.,pennystocks,CAVR,6,6,0,6,1,1,0,1,OTC
4642,12-02-2021 20:00,24 hrs.,pennystocks,CBBT,677,299,378,-79,12,240,149,11,OTC
4642,12-02-2021 20:00,24 hrs.,pennystocks,CBDD,64,5,59,-54,3,19,14,3,OTC
4642,12-02-2021 20:00,24 hrs.,pennystocks,CBDL,343,175,168,7,6,88,143,6,OTC
4642,12-02-2021 20:00,24 hrs.,pennystocks,CBDS,6,0,6,-6,1,1,0,1,OTC
4642,12-02-2021 20:00,24 hrs.,pennystocks,CCTL,7,7,0,7,1,1,1,1,OTC
4642,12-02-2021 20:00,24 hrs.,pennystocks,CELZ,7,7,0,7,1,1,1,1,OTC
4642,12-02-2021 20:00,24 hrs.,pennystocks,CHNC,15,15,0,15,1,4,3,1,OTC
4642,12-02-2021 20:00,24 hrs.,pennystocks,CLIS,6,0,6,-6,1,1,0,1,OTC
4642,12-02-2021 20:00,24 hrs.,pennystocks,CLWD,6,6,0,6,1,1,0,1,OTC
4642,12-02-2021 20:00,24 hrs.,pennystocks,CNNA,25,0,25,-25,2,3,11,2,OTC
4642,12-02-2021 20:00,24 hrs.,pennystocks,COMS,28,0,28,-28,1,5,14,1,OTC
4642,12-02-2021 20:00,24 hrs.,pennystocks,CORG,45,33,12,21,5,4,17,5,OTC
4642,12-02-2021 20:00,24 hrs.,RobinHoodPennyStocks,GMDA,6,0,6,-6,1,1,0,1,NASDAQ
4642,12-02-2021 20:00,24 hrs.,RobinHoodPennyStocks,GRIL,112,0,112,-112,1,41,26,1,NASDAQ
4642,12-02-2021 20:00,24 hrs.,RobinHoodPennyStocks,HCDI,112,0,112,-112,1,41,26,1,NASDAQ
4642,12-02-2021 20:00,24 hrs.,RobinHoodPennyStocks,HGSH,112,0,112,-112,1,41,26,1,NASDAQ
4642,12-02-2021 20:00,24 hrs.,RobinHoodPennyStocks,IDEX,124,12,112,-100,2,43,30,2,NASDAQ
4642,12-02-2021 20:00,24 hrs.,StockMarket,LIFE,3959,0,3959,-3959,1,1934,87,1,NASDAQ
4642,12-02-2021 20:00,24 hrs.,StockMarket,LITE,15,15,0,15,1,4,3,1,NASDAQ
4642,12-02-2021 20:00,24 hrs.,StockMarket,LIVE,15,15,0,15,1,4,3,1,NASDAQ
4642,12-02-2021 20:00,24 hrs.,StockMarket,LLNW,25,25,0,25,4,4,1,1,NASDAQ
4642,12-02-2021 20:00,24 hrs.,StockMarket,LYFT,60,0,60,-60,1,20,16,1,NASDAQ
4642,12-02-2021 20:00,24 hrs.,StockMarket,MKSI,15,15,0,15,1,4,3,1,NASDAQ
4642,12-02-2021 20:00,24 hrs.,StockMarket,MSTR,12,12,0,12,2,2,0,1,NASDAQ
4642,12-02-2021 20:00,24 hrs.,StockMarket,MTCH,7,7,0,7,1,0,3,1,NASDAQ
4642,12-02-2021 20:00,24 hrs.,StockMarket,OCGN,18,18,0,18,2,1,8,2,NASDAQ
4642,12-02-2021 20:00,24 hrs.,StockMarket,PACB,4,4,0,4,1,0,0,1,NASDAQ
4642,12-02-2021 20:00,24 hrs.,StockMarket,PYPL,14,14,0,14,1,3,4,1,NASDAQ
4642,12-02-2021 20:00,24 hrs.,StockMarket,RBBN,6,6,0,6,1,1,0,1,NASDAQ
4642,12-02-2021 20:00,24 hrs.,StockMarket,RCMT,4,4,0,4,1,0,0,1,NASDAQ
4642,12-02-2021 20:00,24 hrs.,StockMarket,REAL,33,33,0,33,1,0,29,1,NASDAQ
4642,12-02-2021 20:00,24 hrs.,StockMarket,RIDE,21,21,0,21,2,5,3,2,NASDAQ
4642,12-02-2021 20:00,24 hrs.,StockMarket,RIGL,6,0,6,-6,1,1,0,1,NASDAQ
4642,12-02-2021 20:00,24 hrs.,StockMarket,SNDL,834,22,812,-790,11,247,296,11,NASDAQ
4642,12-02-2021 20:00,24 hrs.,StockMarket,SONO,60,0,60,-60,1,20,16,1,NASDAQ
4642,12-02-2021 20:00,24 hrs.,StockMarket,SRAC,10,10,0,10,1,1,4,1,NASDAQ
4642,12-02-2021 20:00,24 hrs.,StockMarket,SVMK,15,15,0,15,1,4,3,1,NASDAQ
4642,12-02-2021 20:00,24 hrs.,StockMarket,TLRY,524,46,478,-432,8,144,204,8,NASDAQ
4642,12-02-2021 20:00,24 hrs.,StockMarket,TLSA,4,4,0,4,1,0,0,1,NASDAQ
4642,12-02-2021 20:00,24 hrs.,StockMarket,TNXP,6,6,0,6,1,1,0,1,NASDAQ
4642,12-02-2021 20:00,24 hrs.,StockMarket,TSLA,12,6,6,0,2,2,0,2,NASDAQ
4642,12-02-2021 20:00,24 hrs.,StockMarket,TXMD,6,0,6,-6,1,1,0,1,NASDAQ
4642,12-02-2021 20:00,24 hrs.,StockMarket,VITL,6,6,0,6,1,1,0,1,NASDAQ
4642,12-02-2021 20:00,24 hrs.,StockMarket,VRSN,15,15,0,15,1,4,3,1,NASDAQ
4642,12-02-2021 20:00,24 hrs.,StockMarket,VXRT,23,0,23,-23,1,7,5,1,NASDAQ
4642,12-02-2021 20:00,24 hrs.,StockMarket,WAFU,67,67,0,67,1,15,33,1,NASDAQ
4642,12-02-2021 20:00,24 hrs.,StockMarket,ZNGA,6,0,6,-6,1,1,0,1,NASDAQ
4642,12-02-2021 20:00,24 hrs.,wallstreetbets,NAKD,205,97,108,-11,30,31,23,24,NASDAQ
4642,12-02-2021 20:00,24 hrs.,wallstreetbets,NBEV,8,0,8,-8,1,2,0,1,NASDAQ
4642,12-02-2021 20:00,24 hrs.,RobinHoodPennyStocks,OVID,6,6,0,6,1,1,0,1,NASDAQ
4642,12-02-2021 20:00,24 hrs.,RobinHoodPennyStocks,PECK,112,0,112,-112,1,41,26,1,NASDAQ
4642,12-02-2021 20:00,24 hrs.,RobinHoodPennyStocks,PEIX,112,0,112,-112,1,41,26,1,NASDAQ
4642,12-02-2021 20:00,24 hrs.,RobinHoodPennyStocks,PETZ,112,0,112,-112,1,41,26,1,NASDAQ
4642,12-02-2021 20:00,24 hrs.,RobinHoodPennyStocks,PHUN,112,0,112,-112,1,41,26,1,NASDAQ
4642,12-02-2021 20:00,24 hrs.,RobinHoodPennyStocks,PIXY,112,0,112,-112,1,41,26,1,NASDAQ
4642,12-02-2021 20:00,24 hrs.,RobinHoodPennyStocks,PLIN,112,0,112,-112,1,41,26,1,NASDAQ
4642,12-02-2021 20:00,24 hrs.,RobinHoodPennyStocks,PLUG,112,0,112,-112,1,41,26,1,NASDAQ
4642,12-02-2021 20:00,24 hrs.,RobinHoodPennyStocks,PSEC,49,49,0,49,3,10,17,2,NASDAQ
4642,12-02-2021 20:00,24 hrs.,RobinHoodPennyStocks,PSTV,151,151,0,151,1,61,25,1,NASDAQ
4642,12-02-2021 20:00,24 hrs.,RobinHoodPennyStocks,PXLW,6,0,6,-6,1,1,0,1,NASDAQ
4642,12-02-2021 20:00,24 hrs.,RobinHoodPennyStocks,QUIK,112,0,112,-112,1,41,26,1,NASDAQ
4642,12-02-2021 20:00,24 hrs.,RobinHoodPennyStocks,RAVE,112,0,112,-112,1,41,26,1,NASDAQ
4642,12-02-2021 20:00,24 hrs.,RobinHoodPennyStocks,RCMT,112,0,112,-112,1,41,26,1,NASDAQ
4642,12-02-2021 20:00,24 hrs.,RobinHoodPennyStocks,REAL,79,0,79,-79,1,27,21,1,NASDAQ
4642,12-02-2021 20:00,24 hrs.,RobinHoodPennyStocks,RIOT,119,7,112,-105,2,41,29,2,NASDAQ
4642,12-02-2021 20:00,24 hrs.,RobinHoodPennyStocks,SALM,112,0,112,-112,1,41,26,1,NASDAQ
4642,12-02-2021 20:00,24 hrs.,RobinHoodPennyStocks,SAVA,112,0,112,-112,1,41,26,1,NASDAQ
4642,12-02-2021 20:00,24 hrs.,RobinHoodPennyStocks,SEED,112,0,112,-112,1,41,26,1,NASDAQ
4642,12-02-2021 20:00,24 hrs.,RobinHoodPennyStocks,SGOC,112,0,112,-112,1,41,26,1,NASDAQ
4642,12-02-2021 20:00,24 hrs.,RobinHoodPennyStocks,SHIP,42,36,6,30,7,7,0,5,NASDAQ
4642,12-02-2021 20:00,24 hrs.,RobinHoodPennyStocks,SNDL,1443,1135,308,827,37,468,359,33,NASDAQ
4642,12-02-2021 20:00,24 hrs.,RobinHoodPennyStocks,SNGX,202,196,6,190,4,78,30,3,NASDAQ
4642,12-02-2021 20:00,24 hrs.,RobinHoodPennyStocks,SONM,59,0,59,-59,1,23,9,1,NASDAQ
4642,12-02-2021 20:00,24 hrs.,RobinHoodPennyStocks,SRGA,6,6,0,6,1,1,0,1,NASDAQ
4642,12-02-2021 20:00,24 hrs.,RobinHoodPennyStocks,SUNW,112,0,112,-112,1,41,26,1,NASDAQ
4642,12-02-2021 20:00,24 hrs.,RobinHoodPennyStocks,SXTC,112,0,112,-112,1,41,26,1,NASDAQ
4642,12-02-2021 20:00,24 hrs.,RobinHoodPennyStocks,SYPR,112,0,112,-112,1,41,26,1,NASDAQ
4642,12-02-2021 20:00,24 hrs.,RobinHoodPennyStocks,TAIT,112,0,112,-112,1,41,26,1,NASDAQ
4642,12-02-2021 20:00,24 hrs.,RobinHoodPennyStocks,TANH,112,0,112,-112,1,41,26,1,NASDAQ
4642,12-02-2021 20:00,24 hrs.,RobinHoodPennyStocks,TAOP,112,0,112,-112,1,41,26,1,NASDAQ
4642,12-02-2021 20:00,24 hrs.,RobinHoodPennyStocks,TBLT,73,73,0,73,1,23,23,1,NASDAQ
4642,12-02-2021 20:00,24 hrs.,StockMarket,SRACU,10,10,0,10,1,1,4,1,NASDAQ
4642,12-02-2021 20:00,24 hrs.,StockMarket,SRACW,10,10,0,10,1,1,4,1,NASDAQ
4642,12-02-2021 20:00,24 hrs.,pennystocks,AABB,18,0,18,-18,3,3,0,2,OTC
4642,12-02-2021 20:00,24 hrs.,pennystocks,ABML,72,72,0,72,1,23,22,1,OTC
4642,12-02-2021 20:00,24 hrs.,pennystocks,ABQQ,6,0,6,-6,1,1,0,1,OTC
4642,12-02-2021 20:00,24 hrs.,pennystocks,ACRL,48,0,48,-48,2,15,10,2,OTC
4642,12-02-2021 20:00,24 hrs.,pennystocks,ADGO,12,0,12,-12,1,1,6,1,OTC
4642,12-02-2021 20:00,24 hrs.,pennystocks,ADTM,112,13,99,-86,3,32,36,2,OTC
4642,12-02-2021 20:00,24 hrs.,pennystocks,AEPT,6,0,6,-6,1,1,0,1,OTC
4642,12-02-2021 20:00,24 hrs.,pennystocks,AFPW,6,6,0,6,1,1,0,1,OTC
4642,12-02-2021 20:00,24 hrs.,pennystocks,AHFD,6,0,6,-6,1,1,0,1,OTC
4642,12-02-2021 20:00,24 hrs.,pennystocks,AITX,429,255,174,81,7,127,147,7,OTC
4642,12-02-2021 20:00,24 hrs.,pennystocks,ALKM,26,7,19,-12,4,4,2,2,OTC
4642,12-02-2021 20:00,24 hrs.,pennystocks,ALPP,263,263,0,263,6,84,71,5,OTC
4642,12-02-2021 20:00,24 hrs.,pennystocks,ALST,26,26,0,26,2,3,12,1,OTC
4642,12-02-2021 20:00,24 hrs.,pennystocks,ALYI,187,44,143,-99,4,61,49,4,OTC
4642,12-02-2021 20:00,24 hrs.,pennystocks,ANDI,7,7,0,7,1,1,1,1,OTC
4642,12-02-2021 20:00,24 hrs.,pennystocks,APEX,129,0,129,-129,1,46,33,1,OTC
4642,12-02-2021 20:00,24 hrs.,pennystocks,APPZ,7,7,0,7,1,1,1,1,OTC
4642,12-02-2021 20:00,24 hrs.,pennystocks,ASTI,18,18,0,18,3,3,0,3,OTC
4642,12-02-2021 20:00,24 hrs.,pennystocks,ATDS,6,6,0,6,1,1,0,1,OTC
4642,12-02-2021 20:00,24 hrs.,pennystocks,AXXA,6,6,0,6,1,1,0,1,OTC
4642,12-02-2021 20:00,24 hrs.,pennystocks,AZFL,97,38,59,-21,4,10,61,3,OTC
4642,12-02-2021 20:00,24 hrs.,pennystocks,BANT,25,6,19,-13,2,4,9,2,OTC
4642,12-02-2021 20:00,24 hrs.,pennystocks,BBRW,114,114,0,114,4,23,52,4,OTC
4642,12-02-2021 20:00,24 hrs.,pennystocks,BCCI,7,0,7,-7,1,1,1,1,OTC
4642,12-02-2021 20:00,24 hrs.,pennystocks,BDGR,6,6,0,6,1,1,0,1,OTC
4642,12-02-2021 20:00,24 hrs.,pennystocks,BFRE,16,16,0,16,1,0,12,1,OTC
4642,12-02-2021 20:00,24 hrs.,pennystocks,BGMD,6,6,0,6,1,1,0,1,OTC
4642,12-02-2021 20:00,24 hrs.,pennystocks,BIEL,109,109,0,109,4,29,35,3,OTC
4642,12-02-2021 20:00,24 hrs.,pennystocks,BKMP,6,0,6,-6,1,1,0,1,OTC
4642,12-02-2021 20:00,24 hrs.,pennystocks,BLDV,99,0,99,-99,1,30,35,1,OTC
4642,12-02-2021 20:00,24 hrs.,pennystocks,ICNM,15,15,0,15,1,3,5,1,OTC
4642,12-02-2021 20:00,24 hrs.,pennystocks,IMJX,96,90,6,84,2,27,34,2,OTC
4642,12-02-2021 20:00,24 hrs.,pennystocks,IMTL,6,6,0,6,1,1,0,1,OTC
4642,12-02-2021 20:00,24 hrs.,pennystocks,INCT,7,0,7,-7,1,1,1,1,OTC
4642,12-02-2021 20:00,24 hrs.,pennystocks,INKW,62,50,12,38,10,10,2,8,OTC
4642,12-02-2021 20:00,24 hrs.,pennystocks,INND,167,94,73,21,9,28,75,9,OTC
4642,12-02-2021 20:00,24 hrs.,pennystocks,INTV,12,12,0,12,2,2,0,2,OTC
4642,12-02-2021 20:00,24 hrs.,pennystocks,INVU,6,0,6,-6,1,1,0,1,OTC
4642,12-02-2021 20:00,24 hrs.,pennystocks,IPIX,69,6,63,-57,2,14,33,2,OTC
4642,12-02-2021 20:00,24 hrs.,pennystocks,IPSI,19,13,6,7,2,5,1,2,OTC
4642,12-02-2021 20:00,24 hrs.,pennystocks,IQST,28,28,0,28,4,3,6,3,OTC
4642,12-02-2021 20:00,24 hrs.,pennystocks,ITCJ,7,7,0,7,1,1,1,1,OTC
4642,12-02-2021 20:00,24 hrs.,pennystocks,JETR,6,0,6,-6,1,1,0,1,OTC
4642,12-02-2021 20:00,24 hrs.,pennystocks,JSDA,6,6,0,6,1,1,0,1,OTC
4642,12-02-2021 20:00,24 hrs.,pennystocks,KGKG,25,0,25,-25,4,4,1,2,OTC
4642,12-02-2021 20:00,24 hrs.,pennystocks,CRTG,29,29,0,29,1,8,9,1,OTC
4642,12-02-2021 20:00,24 hrs.,pennystocks,CRWG,6,6,0,6,1,1,0,1,OTC
4642,12-02-2021 20:00,24 hrs.,pennystocks,CTLE,12,6,6,0,2,2,0,2,OTC
4642,12-02-2021 20:00,24 hrs.,pennystocks,CVAT,6,0,6,-6,1,1,0,1,OTC
4642,12-02-2021 20:00,24 hrs.,pennystocks,CYDY,7,7,0,7,1,1,1,1,OTC
4642,12-02-2021 20:00,24 hrs.,pennystocks,CYPW,6,0,6,-6,1,1,0,1,OTC
4642,12-02-2021 20:00,24 hrs.,pennystocks,DGMA,6,0,6,-6,1,1,0,1,OTC
4642,12-02-2021 20:00,24 hrs.,pennystocks,DIGI,13,0,13,-13,2,2,1,1,OTC
4642,12-02-2021 20:00,24 hrs.,pennystocks,DMAN,17,17,0,17,1,4,5,1,OTC
4642,12-02-2021 20:00,24 hrs.,pennystocks,DPLS,366,105,261,-156,11,100,122,8,OTC
4642,12-02-2021 20:00,24 hrs.,pennystocks,ECCI,6,0,6,-6,1,1,0,1,OTC
4642,12-02-2021 20:00,24 hrs.,RobinHoodPennyStocks,TEDU,112,0,112,-112,1,41,26,1,NASDAQ
4642,12-02-2021 20:00,24 hrs.,RobinHoodPennyStocks,TIGR,112,0,112,-112,1,41,26,1,NASDAQ
4642,12-02-2021 20:00,24 hrs.,RobinHoodPennyStocks,TLRY,6,0,6,-6,1,1,0,1,NASDAQ
4642,12-02-2021 20:00,24 hrs.,RobinHoodPennyStocks,TNXP,318,54,264,-210,5,110,78,5,NASDAQ
4642,12-02-2021 20:00,24 hrs.,RobinHoodPennyStocks,TRCH,168,50,118,-68,4,55,42,4,NASDAQ
4642,12-02-2021 20:00,24 hrs.,RobinHoodPennyStocks,TTOO,36,36,0,36,1,13,6,1,NASDAQ
4642,12-02-2021 20:00,24 hrs.,RobinHoodPennyStocks,IFMK,112,0,112,-112,1,41,26,1,NASDAQ
4642,12-02-2021 20:00,24 hrs.,RobinHoodPennyStocks,IMTE,112,0,112,-112,1,41,26,1,NASDAQ
4642,12-02-2021 20:00,24 hrs.,RobinHoodPennyStocks,INPX,6,0,6,-6,1,1,0,1,NASDAQ
4642,12-02-2021 20:00,24 hrs.,RobinHoodPennyStocks,IZEA,112,0,112,-112,1,41,26,1,NASDAQ
4642,12-02-2021 20:00,24 hrs.,RobinHoodPennyStocks,JFIN,112,0,112,-112,1,41,26,1,NASDAQ
4642,12-02-2021 20:00,24 hrs.,RobinHoodPennyStocks,JRJC,112,0,112,-112,1,41,26,1,NASDAQ
4642,12-02-2021 20:00,24 hrs.,RobinHoodPennyStocks,KNDI,112,0,112,-112,1,41,26,1,NASDAQ
4642,12-02-2021 20:00,24 hrs.,RobinHoodPennyStocks,KTRA,53,0,53,-53,2,19,7,2,NASDAQ
4642,12-02-2021 20:00,24 hrs.,RobinHoodPennyStocks,KXIN,112,0,112,-112,1,41,26,1,NASDAQ
4642,12-02-2021 20:00,24 hrs.,RobinHoodPennyStocks,LEDS,112,0,112,-112,1,41,26,1,NASDAQ
4642,12-02-2021 20:00,24 hrs.,RobinHoodPennyStocks,LKCO,97,91,6,85,9,24,13,9,NASDAQ
4642,12-02-2021 20:00,24 hrs.,RobinHoodPennyStocks,LLNW,43,0,43,-43,1,12,15,1,NASDAQ
4642,12-02-2021 20:00,24 hrs.,RobinHoodPennyStocks,LMFA,112,0,112,-112,1,41,26,1,NASDAQ
4642,12-02-2021 20:00,24 hrs.,RobinHoodPennyStocks,LXEH,112,0,112,-112,1,41,26,1,NASDAQ
4642,12-02-2021 20:00,24 hrs.,RobinHoodPennyStocks,MARA,112,0,112,-112,1,41,26,1,NASDAQ
4642,12-02-2021 20:00,24 hrs.,RobinHoodPennyStocks,METX,112,0,112,-112,1,41,26,1,NASDAQ
4642,12-02-2021 20:00,24 hrs.,RobinHoodPennyStocks,MMLP,6,6,0,6,1,1,0,1,NASDAQ
4642,12-02-2021 20:00,24 hrs.,RobinHoodPennyStocks,MOGO,112,0,112,-112,1,41,26,1,NASDAQ
4642,12-02-2021 20:00,24 hrs.,RobinHoodPennyStocks,MOMO,112,0,112,-112,1,41,26,1,NASDAQ
4642,12-02-2021 20:00,24 hrs.,RobinHoodPennyStocks,MOSY,112,0,112,-112,1,41,26,1,NASDAQ
4642,12-02-2021 20:00,24 hrs.,RobinHoodPennyStocks,MOXC,112,0,112,-112,1,41,26,1,NASDAQ
4642,12-02-2021 20:00,24 hrs.,RobinHoodPennyStocks,MVIS,112,0,112,-112,1,41,26,1,NASDAQ
4642,12-02-2021 20:00,24 hrs.,RobinHoodPennyStocks,NAKD,222,12,210,-198,6,58,82,6,NASDAQ
4642,12-02-2021 20:00,24 hrs.,RobinHoodPennyStocks,NCTY,112,0,112,-112,1,41,26,1,NASDAQ
4642,12-02-2021 20:00,24 hrs.,RobinHoodPennyStocks,NOVN,178,45,133,-88,5,60,38,4,NASDAQ
4642,12-02-2021 20:00,24 hrs.,RobinHoodPennyStocks,NVCN,79,34,45,-11,3,20,27,3,NASDAQ
4642,12-02-2021 20:00,24 hrs.,RobinHoodPennyStocks,NVIV,12,0,12,-12,1,2,4,1,NASDAQ
4642,12-02-2021 20:00,24 hrs.,RobinHoodPennyStocks,NXTD,112,0,112,-112,1,41,26,1,NASDAQ
4642,12-02-2021 20:00,24 hrs.,RobinHoodPennyStocks,OCGN,45,39,6,33,2,11,15,2,NASDAQ
4642,12-02-2021 20:00,24 hrs.,RobinHoodPennyStocks,ONTX,28,0,28,-28,2,8,4,2,NASDAQ
4642,12-02-2021 20:00,24 hrs.,RobinHoodPennyStocks,OPGN,30,24,6,18,5,5,0,2,NASDAQ
4642,12-02-2021 20:00,24 hrs.,RobinHoodPennyStocks,OPTT,118,6,112,-106,2,42,26,2,NASDAQ
4642,12-02-2021 20:00,24 hrs.,pennystocks,KWBT,136,7,129,-122,2,47,34,2,OTC
4642,12-02-2021 20:00,24 hrs.,pennystocks,KYNC,37,6,31,-25,6,6,1,2,OTC
4642,12-02-2021 20:00,24 hrs.,pennystocks,LITH,6,6,0,6,1,1,0,1,OTC
4642,12-02-2021 20:00,24 hrs.,pennystocks,LQMT,102,6,96,-90,2,31,32,2,OTC
4642,12-02-2021 20:00,24 hrs.,pennystocks,LTNC,6,0,6,-6,1,1,0,1,OTC
4642,12-02-2021 20:00,24 hrs.,pennystocks,LUVU,163,14,149,-135,6,53,33,5,OTC
4642,12-02-2021 20:00,24 hrs.,pennystocks,LVVV,24,0,24,-24,4,4,0,2,OTC
4642,12-02-2021 20:00,24 hrs.,pennystocks,MAXD,35,35,0,35,5,7,1,5,OTC
4642,12-02-2021 20:00,24 hrs.,pennystocks,MCOA,14,7,7,0,2,2,2,2,OTC
4642,12-02-2021 20:00,24 hrs.,pennystocks,MDCN,13,13,0,13,2,2,1,2,OTC
4642,12-02-2021 20:00,24 hrs.,pennystocks,MEDH,69,69,0,69,1,18,29,1,OTC
4642,12-02-2021 20:00,24 hrs.,pennystocks,MGLG,6,0,6,-6,1,1,0,1,OTC
4642,12-02-2021 20:00,24 hrs.,pennystocks,MIHI,6,6,0,6,1,1,0,1,OTC
4642,12-02-2021 20:00,24 hrs.,pennystocks,MIKP,6,0,6,-6,1,1,0,1,OTC
4642,12-02-2021 20:00,24 hrs.,pennystocks,MINE,725,63,662,-599,9,281,127,9,OTC
4642,12-02-2021 20:00,24 hrs.,pennystocks,ECEZ,128,0,128,-128,3,44,28,2,OTC
4642,12-02-2021 20:00,24 hrs.,pennystocks,ELTP,16,16,0,16,1,4,4,1,OTC
4642,12-02-2021 20:00,24 hrs.,pennystocks,ENCS,6,0,6,-6,1,1,0,1,OTC
4642,12-02-2021 20:00,24 hrs.,pennystocks,ENDV,6,0,6,-6,1,1,0,1,OTC
4642,12-02-2021 20:00,24 hrs.,pennystocks,ENRT,6,6,0,6,1,1,0,1,OTC
4642,12-02-2021 20:00,24 hrs.,pennystocks,ENTI,13,0,13,-13,2,2,1,1,OTC
4642,12-02-2021 20:00,24 hrs.,pennystocks,ENZC,12,12,0,12,2,2,0,2,OTC
4642,12-02-2021 20:00,24 hrs.,pennystocks,ERBB,14,14,0,14,1,1,8,1,OTC
4642,12-02-2021 20:00,24 hrs.,pennystocks,ETFM,105,0,105,-105,2,31,35,2,OTC
4642,12-02-2021 20:00,24 hrs.,pennystocks,ETHE,40,40,0,40,1,6,24,1,OTC
4642,12-02-2021 20:00,24 hrs.,pennystocks,EWKS,7,7,0,7,1,1,1,1,OTC
4642,12-02-2021 20:00,24 hrs.,pennystocks,FBEC,6,6,0,6,1,1,0,1,OTC
4642,12-02-2021 20:00,24 hrs.,pennystocks,FDBH,7,7,0,7,1,1,1,1,OTC
4642,12-02-2021 20:00,24 hrs.,pennystocks,FLXT,6,6,0,6,1,1,0,1,OTC
4642,12-02-2021 20:00,24 hrs.,pennystocks,FMCC,129,0,129,-129,1,46,33,1,OTC
4642,12-02-2021 20:00,24 hrs.,pennystocks,FNMA,129,0,129,-129,1,46,33,1,OTC
4642,12-02-2021 20:00,24 hrs.,pennystocks,FPVD,9,0,9,-9,1,2,1,1,OTC
4642,12-02-2021 20:00,24 hrs.,pennystocks,FTFY,6,0,6,-6,1,1,0,1,OTC
4642,12-02-2021 20:00,24 hrs.,pennystocks,FUST,7,7,0,7,1,1,1,1,OTC
4642,12-02-2021 20:00,24 hrs.,pennystocks,FUTL,7,0,7,-7,1,1,1,1,OTC
4642,12-02-2021 20:00,24 hrs.,pennystocks,GBTC,40,40,0,40,1,6,24,1,OTC
4642,12-02-2021 20:00,24 hrs.,pennystocks,GDET,7,0,7,-7,1,1,1,1,OTC
4642,12-02-2021 20:00,24 hrs.,pennystocks,GHMP,50,50,0,50,3,10,18,2,OTC
4642,12-02-2021 20:00,24 hrs.,pennystocks,GLCO,6,6,0,6,1,1,0,1,OTC
4642,12-02-2021 20:00,24 hrs.,pennystocks,GLEC,6,6,0,6,1,1,0,1,OTC
4642,12-02-2021 20:00,24 hrs.,pennystocks,GLGI,129,0,129,-129,1,46,33,1,OTC
4642,12-02-2021 20:00,24 hrs.,pennystocks,GMEV,674,0,674,-674,1,263,144,1,OTC
4642,12-02-2021 20:00,24 hrs.,pennystocks,GNCP,10,0,10,-10,1,1,4,1,OTC
4642,12-02-2021 20:00,24 hrs.,pennystocks,GPFT,44,0,44,-44,2,9,18,2,OTC
4642,12-02-2021 20:00,24 hrs.,pennystocks,GRCU,16,10,6,4,2,2,4,2,OTC
4642,12-02-2021 20:00,24 hrs.,pennystocks,GRST,6,6,0,6,1,1,0,1,OTC
4642,12-02-2021 20:00,24 hrs.,pennystocks,GTCH,42,24,18,6,4,5,16,2,OTC
4642,12-02-2021 20:00,24 hrs.,pennystocks,GTEH,102,0,102,-102,2,37,20,2,OTC
4642,12-02-2021 20:00,24 hrs.,pennystocks,GTLL,90,48,42,6,3,31,16,3,OTC
4642,12-02-2021 20:00,24 hrs.,pennystocks,HALB,32,32,0,32,2,9,6,1,OTC
4642,12-02-2021 20:00,24 hrs.,pennystocks,HCMC,139,71,68,3,22,22,7,20,OTC
4642,12-02-2021 20:00,24 hrs.,pennystocks,HEMP,14,7,7,0,2,2,2,2,OTC
4642,12-02-2021 20:00,24 hrs.,pennystocks,HIPH,1371,12,1359,-1347,7,606,131,4,OTC
4642,12-02-2021 20:00,24 hrs.,pennystocks,HMMR,7,7,0,7,1,1,1,1,OTC
4642,12-02-2021 20:00,24 hrs.,pennystocks,HMNY,20,6,14,-8,3,3,2,3,OTC
4642,12-02-2021 20:00,24 hrs.,pennystocks,HPMM,17,0,17,-17,2,2,5,2,OTC
4642,12-02-2021 20:00,24 hrs.,pennystocks,HPTY,39,39,0,39,1,11,13,1,OTC
4642,12-02-2021 20:00,24 hrs.,pennystocks,HQGE,6,0,6,-6,1,1,0,1,OTC
4642,12-02-2021 20:00,24 hrs.,pennystocks,HRTH,129,0,129,-129,1,46,33,1,OTC
4642,12-02-2021 20:00,24 hrs.,pennystocks,HYII,7,0,7,-7,1,1,1,1,OTC
4642,12-02-2021 20:00,24 hrs.,pennystocks,HYSR,161,6,155,-149,4,52,41,4,OTC
4642,12-02-2021 20:00,24 hrs.,pennystocks,IBRC,10,0,10,-10,1,2,2,1,OTC
4642,12-02-2021 20:00,24 hrs.,pennystocks,ICBU,6,6,0,6,1,1,0,1,OTC
4642,12-02-2021 20:00,24 hrs.,pennystocks,ICLD,6,6,0,6,1,1,0,1,OTC
4642,12-02-2021 20:00,24 hrs.,pennystocks,ABEPF,73,0,73,-73,3,17,27,3,OTC
4642,12-02-2021 20:00,24 hrs.,wallstreetbets,SRACW,6,6,0,6,1,1,0,1,NASDAQ
4642,12-02-2021 20:00,24 hrs.,RobinHoodPennyStocks,AHFD,6,0,6,-6,1,1,0,1,OTC
4642,12-02-2021 20:00,24 hrs.,RobinHoodPennyStocks,AZFL,6,0,6,-6,1,0,2,1,OTC
4642,12-02-2021 20:00,24 hrs.,RobinHoodPennyStocks,BLXX,6,6,0,6,1,1,0,1,OTC
4642,12-02-2021 20:00,24 hrs.,RobinHoodPennyStocks,CAPS,6,0,6,-6,1,1,0,1,OTC
4642,12-02-2021 20:00,24 hrs.,RobinHoodPennyStocks,CBDD,6,6,0,6,1,1,0,1,OTC
4642,12-02-2021 20:00,24 hrs.,RobinHoodPennyStocks,DIGI,6,0,6,-6,1,1,0,1,OTC
4642,12-02-2021 20:00,24 hrs.,RobinHoodPennyStocks,GLEC,6,6,0,6,1,1,0,1,OTC
4642,12-02-2021 20:00,24 hrs.,RobinHoodPennyStocks,GPFT,28,28,0,28,4,4,4,2,OTC
4642,12-02-2021 20:00,24 hrs.,RobinHoodPennyStocks,GSPH,6,6,0,6,1,1,0,1,OTC
4642,12-02-2021 20:00,24 hrs.,RobinHoodPennyStocks,HCMC,12,6,6,0,2,2,0,2,OTC
4642,12-02-2021 20:00,24 hrs.,RobinHoodPennyStocks,INKW,6,6,0,6,1,1,0,1,OTC
4642,12-02-2021 20:00,24 hrs.,RobinHoodPennyStocks,LTUM,6,6,0,6,1,1,0,1,OTC
4642,12-02-2021 20:00,24 hrs.,RobinHoodPennyStocks,MJNA,6,6,0,6,1,1,0,1,OTC
4642,12-02-2021 20:00,24 hrs.,RobinHoodPennyStocks,OPTI,6,0,6,-6,1,1,0,1,OTC
4642,12-02-2021 20:00,24 hrs.,RobinHoodPennyStocks,PHIL,6,6,0,6,1,1,0,1,OTC
4642,12-02-2021 20:00,24 hrs.,RobinHoodPennyStocks,BDRBF,36,12,24,-12,6,6,0,6,OTC
4642,12-02-2021 20:00,24 hrs.,RobinHoodPennyStocks,HITIF,6,0,6,-6,1,1,0,1,OTC
4642,12-02-2021 20:00,24 hrs.,RobinHoodPennyStocks,NXTTF,6,6,0,6,1,1,0,1,OTC
4642,12-02-2021 20:00,24 hrs.,pennystocks,MJNA,97,25,72,-47,6,20,33,5,OTC
4642,12-02-2021 20:00,24 hrs.,pennystocks,MJTV,7,7,0,7,1,1,1,1,OTC
4642,12-02-2021 20:00,24 hrs.,pennystocks,MKTY,7,7,0,7,1,1,1,1,OTC
4642,12-02-2021 20:00,24 hrs.,pennystocks,MLFB,133,127,6,121,4,35,47,4,OTC
4642,12-02-2021 20:00,24 hrs.,pennystocks,MMEX,147,120,27,93,4,27,77,3,OTC
4642,12-02-2021 20:00,24 hrs.,pennystocks,MODC,6,0,6,-6,1,1,0,1,OTC
4642,12-02-2021 20:00,24 hrs.,pennystocks,MOJO,6,6,0,6,1,1,0,1,OTC
4642,12-02-2021 20:00,24 hrs.,pennystocks,MRMD,45,0,45,-45,1,18,5,1,OTC
4642,12-02-2021 20:00,24 hrs.,pennystocks,MRNJ,13,0,13,-13,2,2,1,1,OTC
4642,12-02-2021 20:00,24 hrs.,pennystocks,MTVX,6,6,0,6,1,1,0,1,OTC
4642,12-02-2021 20:00,24 hrs.,pennystocks,NBVG,7,7,0,7,1,1,1,1,OTC
4642,12-02-2021 20:00,24 hrs.,pennystocks,NOVC,54,54,0,54,2,17,12,2,OTC
4642,12-02-2021 20:00,24 hrs.,pennystocks,NPHC,36,0,36,-36,1,6,20,1,OTC
4642,12-02-2021 20:00,24 hrs.,pennystocks,NSAV,13,13,0,13,2,2,1,2,OTC
4642,12-02-2021 20:00,24 hrs.,pennystocks,NSEO,6,0,6,-6,1,1,0,1,OTC
4642,12-02-2021 20:00,24 hrs.,pennystocks,NSPT,6,6,0,6,1,1,0,1,OTC
4642,12-02-2021 20:00,24 hrs.,pennystocks,OZSC,200,0,200,-200,3,47,94,3,OTC
4642,12-02-2021 20:00,24 hrs.,pennystocks,PAOG,7,7,0,7,1,1,1,1,OTC
4642,12-02-2021 20:00,24 hrs.,pennystocks,PASO,76,0,76,-76,3,18,28,3,OTC
4642,12-02-2021 20:00,24 hrs.,pennystocks,PDXP,7,7,0,7,1,1,1,1,OTC
4642,12-02-2021 20:00,24 hrs.,pennystocks,PHIL,6,6,0,6,1,1,0,1,OTC
4642,12-02-2021 20:00,24 hrs.,pennystocks,PLSB,6,0,6,-6,1,1,0,1,OTC
4642,12-02-2021 20:00,24 hrs.,pennystocks,PMCB,6,6,0,6,1,1,0,1,OTC
4642,12-02-2021 20:00,24 hrs.,pennystocks,PPJE,14,6,8,-2,2,2,2,2,OTC
4642,12-02-2021 20:00,24 hrs.,pennystocks,PSYC,289,0,289,-289,5,107,55,3,OTC
4642,12-02-2021 20:00,24 hrs.,pennystocks,PUGE,38,32,6,26,2,11,8,2,OTC
4642,12-02-2021 20:00,24 hrs.,pennystocks,PURA,13,13,0,13,2,2,1,2,OTC
4642,12-02-2021 20:00,24 hrs.,pennystocks,PVDG,24,24,0,24,1,2,16,1,OTC
4642,12-02-2021 20:00,24 hrs.,pennystocks,PZOO,7,0,7,-7,1,1,1,1,OTC
4642,12-02-2021 20:00,24 hrs.,pennystocks,QOIL,7,7,0,7,1,1,1,1,OTC
4642,12-02-2021 20:00,24 hrs.,pennystocks,RDGL,6,6,0,6,1,1,0,1,OTC
4642,12-02-2021 20:00,24 hrs.,pennystocks,RELI,15,15,0,15,1,0,11,1,OTC
4642,12-02-2021 20:00,24 hrs.,pennystocks,RGBP,23,23,0,23,2,6,3,1,OTC
4642,12-02-2021 20:00,24 hrs.,pennystocks,RITE,39,0,39,-39,1,7,21,1,OTC
4642,12-02-2021 20:00,24 hrs.,pennystocks,RLBD,18,18,0,18,1,5,4,1,OTC
4642,12-02-2021 20:00,24 hrs.,pennystocks,RLTR,12,0,12,-12,2,2,0,2,OTC
4642,12-02-2021 20:00,24 hrs.,pennystocks,RMTD,6,6,0,6,1,1,0,1,OTC
4642,12-02-2021 20:00,24 hrs.,pennystocks,RNVA,129,0,129,-129,1,46,33,1,OTC
4642,12-02-2021 20:00,24 hrs.,pennystocks,RRTS,129,0,129,-129,1,46,33,1,OTC
4642,12-02-2021 20:00,24 hrs.,pennystocks,RSHN,15,15,0,15,1,0,11,1,OTC
4642,12-02-2021 20:00,24 hrs.,pennystocks,RSSV,240,234,6,228,3,83,62,3,OTC
4642,12-02-2021 20:00,24 hrs.,pennystocks,RTON,124,13,111,-98,5,34,36,5,OTC
4642,12-02-2021 20:00,24 hrs.,pennystocks,SCIE,355,6,349,-343,2,151,45,2,OTC
4642,12-02-2021 20:00,24 hrs.,pennystocks,SEEK,7,0,7,-7,1,1,1,1,OTC
4642,12-02-2021 20:00,24 hrs.,RobinHoodPennyStocks,GME,50,10,40,-30,2,10,22,2,NYSE
4642,12-02-2021 20:00,24 hrs.,RobinHoodPennyStocks,GSX,112,0,112,-112,1,41,26,1,NYSE
4642,12-02-2021 20:00,24 hrs.,RobinHoodPennyStocks,IRS,156,156,0,156,1,72,8,1,NYSE
4642,12-02-2021 20:00,24 hrs.,RobinHoodPennyStocks,IVR,6,0,6,-6,1,1,0,1,NYSE
4642,12-02-2021 20:00,24 hrs.,RobinHoodPennyStocks,LOW,6,0,6,-6,1,1,0,1,NYSE
4642,12-02-2021 20:00,24 hrs.,RobinHoodPennyStocks,LYG,6,0,6,-6,1,1,0,1,NYSE
4642,12-02-2021 20:00,24 hrs.,RobinHoodPennyStocks,MTL,13,13,0,13,1,1,7,1,NYSE
4642,12-02-2021 20:00,24 hrs.,RobinHoodPennyStocks,NAT,6,6,0,6,1,1,0,1,NYSE
4642,12-02-2021 20:00,24 hrs.,RobinHoodPennyStocks,NIO,112,0,112,-112,1,41,26,1,NYSE
4642,12-02-2021 20:00,24 hrs.,RobinHoodPennyStocks,PDT,58,0,58,-58,1,18,18,1,NYSE
4642,12-02-2021 20:00,24 hrs.,RobinHoodPennyStocks,PHI,6,6,0,6,1,1,0,1,NYSE
4642,12-02-2021 20:00,24 hrs.,RobinHoodPennyStocks,PSA,18,0,18,-18,1,5,4,1,NYSE
4642,12-02-2021 20:00,24 hrs.,RobinHoodPennyStocks,RFP,112,0,112,-112,1,41,26,1,NYSE
4642,12-02-2021 20:00,24 hrs.,RobinHoodPennyStocks,SOS,203,49,154,-105,10,61,41,8,NYSE
4642,12-02-2021 20:00,24 hrs.,RobinHoodPennyStocks,SUZ,112,0,112,-112,1,41,26,1,NYSE
4642,12-02-2021 20:00,24 hrs.,RobinHoodPennyStocks,TAL,112,0,112,-112,1,41,26,1,NYSE
4642,12-02-2021 20:00,24 hrs.,RobinHoodPennyStocks,WEI,112,0,112,-112,1,41,26,1,NYSE
4642,12-02-2021 20:00,24 hrs.,RobinHoodPennyStocks,BABA,112,0,112,-112,1,41,26,1,NYSE
4642,12-02-2021 20:00,24 hrs.,RobinHoodPennyStocks,CCIV,39,39,0,39,1,10,15,1,NYSE
4642,12-02-2021 20:00,24 hrs.,RobinHoodPennyStocks,CEIX,112,0,112,-112,1,41,26,1,NYSE
4642,12-02-2021 20:00,24 hrs.,pennystocks,SFOR,18,12,6,6,2,1,8,2,OTC
4642,12-02-2021 20:00,24 hrs.,pennystocks,SGMD,296,237,59,178,11,87,78,11,OTC
4642,12-02-2021 20:00,24 hrs.,pennystocks,SGSI,160,6,154,-148,5,52,36,4,OTC
4642,12-02-2021 20:00,24 hrs.,pennystocks,SHMP,29,6,23,-17,3,2,13,3,OTC
4642,12-02-2021 20:00,24 hrs.,pennystocks,SHWZ,7,7,0,7,1,1,1,1,OTC
4642,12-02-2021 20:00,24 hrs.,pennystocks,SILO,20,0,20,-20,1,5,6,1,OTC
4642,12-02-2021 20:00,24 hrs.,pennystocks,SIML,96,96,0,96,2,27,34,2,OTC
4642,12-02-2021 20:00,24 hrs.,pennystocks,SING,62,40,22,18,4,3,40,4,OTC
4642,12-02-2021 20:00,24 hrs.,pennystocks,SNPW,381,28,353,-325,5,140,81,5,OTC
4642,12-02-2021 20:00,24 hrs.,pennystocks,SNRS,14,14,0,14,2,2,2,2,OTC
4642,12-02-2021 20:00,24 hrs.,pennystocks,SNWV,12,12,0,12,2,2,0,1,OTC
4642,12-02-2021 20:00,24 hrs.,pennystocks,SNYR,6,6,0,6,1,1,0,1,OTC
4642,12-02-2021 20:00,24 hrs.,pennystocks,SRMX,239,54,185,-131,9,50,103,8,OTC
4642,12-02-2021 20:00,24 hrs.,pennystocks,SRNA,6,6,0,6,1,1,0,1,OTC
4642,12-02-2021 20:00,24 hrs.,pennystocks,SSFT,12,12,0,12,1,0,8,1,OTC
4642,12-02-2021 20:00,24 hrs.,pennystocks,SSOK,12,12,0,12,1,0,8,1,OTC
4642,12-02-2021 20:00,24 hrs.,pennystocks,STEV,40,10,30,-20,4,9,6,3,OTC
4642,12-02-2021 20:00,24 hrs.,pennystocks,SUIC,7,0,7,-7,1,1,1,1,OTC
4642,12-02-2021 20:00,24 hrs.,pennystocks,SURG,129,0,129,-129,1,46,33,1,OTC
4642,12-02-2021 20:00,24 hrs.,pennystocks,TCHH,7,7,0,7,1,1,1,1,OTC
4642,12-02-2021 20:00,24 hrs.,pennystocks,TFZI,6,0,6,-6,1,1,0,1,OTC
4642,12-02-2021 20:00,24 hrs.,pennystocks,TGHI,11,11,0,11,1,2,3,1,OTC
4642,12-02-2021 20:00,24 hrs.,pennystocks,TLGN,48,48,0,48,3,9,18,1,OTC
4642,12-02-2021 20:00,24 hrs.,pennystocks,TLSS,240,78,162,-84,3,59,110,3,OTC
4642,12-02-2021 20:00,24 hrs.,pennystocks,TPAC,118,112,6,106,2,46,18,2,OTC
4642,12-02-2021 20:00,24 hrs.,pennystocks,TREP,6,0,6,-6,1,1,0,1,OTC
4642,12-02-2021 20:00,24 hrs.,pennystocks,TSNP,22,16,6,10,3,2,6,3,OTC
4642,12-02-2021 20:00,24 hrs.,pennystocks,TSTS,12,0,12,-12,2,2,0,1,OTC
4642,12-02-2021 20:00,24 hrs.,pennystocks,UATG,12,0,12,-12,2,2,0,2,OTC
4642,12-02-2021 20:00,24 hrs.,pennystocks,USMJ,36,36,0,36,2,7,14,2,OTC
4642,12-02-2021 20:00,24 hrs.,pennystocks,USRM,6,6,0,6,1,1,0,1,OTC
4642,12-02-2021 20:00,24 hrs.,pennystocks,UVSE,7,0,7,-7,1,1,1,1,OTC
4642,12-02-2021 20:00,24 hrs.,pennystocks,VFRM,6,6,0,6,1,1,0,1,OTC
4642,12-02-2021 20:00,24 hrs.,pennystocks,VPLM,6,6,0,6,1,1,0,1,OTC
4642,12-02-2021 20:00,24 hrs.,pennystocks,VTLR,6,6,0,6,1,1,0,1,OTC
4642,12-02-2021 20:00,24 hrs.,pennystocks,WCVC,90,90,0,90,1,26,34,1,OTC
4642,12-02-2021 20:00,24 hrs.,pennystocks,WDLF,181,0,181,-181,4,38,89,4,OTC
4642,12-02-2021 20:00,24 hrs.,pennystocks,WHEN,7,0,7,-7,1,1,1,1,OTC
4642,12-02-2021 20:00,24 hrs.,pennystocks,WIZD,16,16,0,16,1,4,4,1,OTC
4642,12-02-2021 20:00,24 hrs.,pennystocks,WSTL,129,0,129,-129,1,46,33,1,OTC
4642,12-02-2021 20:00,24 hrs.,pennystocks,WTII,39,39,0,39,1,12,11,1,OTC
4642,12-02-2021 20:00,24 hrs.,pennystocks,XMET,8,0,8,-8,1,0,4,1,OTC
4642,12-02-2021 20:00,24 hrs.,pennystocks,XTRM,6,0,6,-6,1,1,0,1,OTC
4642,12-02-2021 20:00,24 hrs.,pennystocks,ZPAS,6,0,6,-6,1,1,0,1,OTC
4642,12-02-2021 20:00,24 hrs.,pennystocks,AGGHF,15,15,0,15,1,2,7,1,OTC
4642,12-02-2021 20:00,24 hrs.,pennystocks,ALLIF,114,114,0,114,1,31,48,1,OTC
4642,12-02-2021 20:00,24 hrs.,pennystocks,ARBKF,176,46,130,-84,3,40,84,3,OTC
4642,12-02-2021 20:00,24 hrs.,pennystocks,BDRBF,6,6,0,6,1,1,0,1,OTC
4642,12-02-2021 20:00,24 hrs.,pennystocks,BKLLF,72,72,0,72,1,23,22,1,OTC
4642,12-02-2021 20:00,24 hrs.,pennystocks,BNCHF,6,6,0,6,1,1,0,1,OTC
4642,12-02-2021 20:00,24 hrs.,pennystocks,BRPHF,40,40,0,40,1,6,24,1,OTC
4642,12-02-2021 20:00,24 hrs.,pennystocks,BVNNF,7,7,0,7,1,1,1,1,OTC
4642,12-02-2021 20:00,24 hrs.,pennystocks,CANSF,5,5,0,5,1,0,1,1,OTC
4642,12-02-2021 20:00,24 hrs.,pennystocks,CBULF,6,6,0,6,1,1,0,1,OTC
4642,12-02-2021 20:00,24 hrs.,pennystocks,CBWTF,19,13,6,7,3,3,1,3,OTC
4642,12-02-2021 20:00,24 hrs.,pennystocks,CIOXY,7,7,0,7,1,1,1,1,OTC
4642,12-02-2021 20:00,24 hrs.,pennystocks,COCSF,6,0,6,-6,1,1,0,1,OTC
4642,12-02-2021 20:00,24 hrs.,pennystocks,CPHRF,35,0,35,-35,1,10,11,1,OTC
4642,12-02-2021 20:00,24 hrs.,pennystocks,CRLBF,23,23,0,23,1,2,15,1,OTC
4642,12-02-2021 20:00,24 hrs.,pennystocks,CXXIF,6,0,6,-6,1,1,0,1,OTC
4642,12-02-2021 20:00,24 hrs.,pennystocks,DFLYF,48,0,48,-48,1,17,10,1,OTC
4642,12-02-2021 20:00,24 hrs.,pennystocks,DFODQ,19,19,0,19,1,3,9,1,OTC
4642,12-02-2021 20:00,24 hrs.,pennystocks,DMGGF,40,40,0,40,1,6,24,1,OTC
4642,12-02-2021 20:00,24 hrs.,pennystocks,EHVVF,226,12,214,-202,2,88,42,2,OTC
4642,12-02-2021 20:00,24 hrs.,pennystocks,ELRRF,12,12,0,12,2,2,0,2,OTC
4642,12-02-2021 20:00,24 hrs.,pennystocks,EMHTF,6,6,0,6,1,1,0,1,OTC
4642,12-02-2021 20:00,24 hrs.,pennystocks,ENTBF,214,0,214,-214,1,88,34,1,OTC
4642,12-02-2021 20:00,24 hrs.,pennystocks,EVKIF,29,29,0,29,1,8,9,1,OTC
4642,12-02-2021 20:00,24 hrs.,RobinHoodPennyStocks,PMEDF,6,6,0,6,1,1,0,1,OTC
4642,12-02-2021 20:00,24 hrs.,RobinHoodPennyStocks,RYCEY,18,18,0,18,3,3,0,3,OTC
4642,12-02-2021 20:00,24 hrs.,RobinHoodPennyStocks,SHCAY,16,16,0,16,1,6,0,1,OTC
4642,12-02-2021 20:00,24 hrs.,RobinHoodPennyStocks,TLOFF,6,0,6,-6,1,1,0,1,OTC
4642,12-02-2021 20:00,24 hrs.,RobinHoodPennyStocks,AAU,112,0,112,-112,1,41,26,1,AMEX
4642,12-02-2021 20:00,24 hrs.,RobinHoodPennyStocks,DNN,528,12,516,-504,8,178,140,7,AMEX
4642,12-02-2021 20:00,24 hrs.,RobinHoodPennyStocks,DPW,112,0,112,-112,1,41,26,1,AMEX
4642,12-02-2021 20:00,24 hrs.,RobinHoodPennyStocks,GSV,195,6,189,-183,3,58,67,3,AMEX
4642,12-02-2021 20:00,24 hrs.,RobinHoodPennyStocks,GTE,858,501,357,144,19,251,280,18,AMEX
4642,12-02-2021 20:00,24 hrs.,RobinHoodPennyStocks,ITP,6,6,0,6,1,1,0,1,AMEX
4642,12-02-2021 20:00,24 hrs.,RobinHoodPennyStocks,NAK,176,52,124,-72,9,55,30,9,AMEX
4642,12-02-2021 20:00,24 hrs.,RobinHoodPennyStocks,PLM,42,0,42,-42,1,16,6,1,AMEX
4642,12-02-2021 20:00,24 hrs.,RobinHoodPennyStocks,RHE,112,0,112,-112,1,41,26,1,AMEX
4642,12-02-2021 20:00,24 hrs.,RobinHoodPennyStocks,SYN,12,6,6,0,2,2,0,2,AMEX
4642,12-02-2021 20:00,24 hrs.,RobinHoodPennyStocks,TGB,107,0,107,-107,2,40,19,2,AMEX
4642,12-02-2021 20:00,24 hrs.,RobinHoodPennyStocks,TRT,112,0,112,-112,1,41,26,1,AMEX
4642,12-02-2021 20:00,24 hrs.,RobinHoodPennyStocks,TRX,245,36,209,-173,3,77,79,3,AMEX
4642,12-02-2021 20:00,24 hrs.,RobinHoodPennyStocks,XPL,112,0,112,-112,1,41,26,1,AMEX
4642,12-02-2021 20:00,24 hrs.,RobinHoodPennyStocks,ZOM,1375,862,513,349,16,452,407,16,AMEX
4642,12-02-2021 20:00,24 hrs.,RobinHoodPennyStocks,AMBO,112,0,112,-112,1,41,26,1,AMEX
4642,12-02-2021 20:00,24 hrs.,RobinHoodPennyStocks,AUMN,209,0,209,-209,2,69,63,2,AMEX
4642,12-02-2021 20:00,24 hrs.,RobinHoodPennyStocks,GSAT,26,0,26,-26,1,5,12,1,AMEX
4642,12-02-2021 20:00,24 hrs.,RobinHoodPennyStocks,IBIO,24,24,0,24,1,8,4,1,AMEX
4642,12-02-2021 20:00,24 hrs.,RobinHoodPennyStocks,NSPR,36,29,7,22,2,9,10,2,AMEX
4642,12-02-2021 20:00,24 hrs.,RobinHoodPennyStocks,OGEN,18,18,0,18,3,3,0,3,AMEX
4642,12-02-2021 20:00,24 hrs.,RobinHoodPennyStocks,PLAG,112,0,112,-112,1,41,26,1,AMEX
4642,12-02-2021 20:00,24 hrs.,RobinHoodPennyStocks,SENS,61,61,0,61,3,22,5,3,AMEX
4642,12-02-2021 20:00,24 hrs.,RobinHoodPennyStocks,SMTS,6,0,6,-6,1,1,0,1,AMEX
4642,12-02-2021 20:00,24 hrs.,RobinHoodPennyStocks,TKAT,112,0,112,-112,1,41,26,1,AMEX
4642,12-02-2021 20:00,24 hrs.,RobinHoodPennyStocks,TRXC,175,6,169,-163,3,66,31,3,AMEX
4642,12-02-2021 20:00,24 hrs.,RobinHoodPennyStocks,YCBD,6,0,6,-6,1,1,0,1,AMEX
4642,12-02-2021 20:00,24 hrs.,RobinHoodPennyStocks,AIV,6,6,0,6,1,1,0,1,NYSE
4642,12-02-2021 20:00,24 hrs.,RobinHoodPennyStocks,AMC,152,0,152,-152,2,50,44,2,NYSE
4642,12-02-2021 20:00,24 hrs.,RobinHoodPennyStocks,AUY,97,0,97,-97,1,28,37,1,NYSE
4642,12-02-2021 20:00,24 hrs.,RobinHoodPennyStocks,BBW,6,0,6,-6,1,1,0,1,NYSE
4642,12-02-2021 20:00,24 hrs.,RobinHoodPennyStocks,BTU,112,0,112,-112,1,41,26,1,NYSE
4642,12-02-2021 20:00,24 hrs.,RobinHoodPennyStocks,CCM,112,0,112,-112,1,41,26,1,NYSE
4642,12-02-2021 20:00,24 hrs.,RobinHoodPennyStocks,COO,97,0,97,-97,1,28,37,1,NYSE
4642,12-02-2021 20:00,24 hrs.,RobinHoodPennyStocks,CTK,112,0,112,-112,1,41,26,1,NYSE
4642,12-02-2021 20:00,24 hrs.,RobinHoodPennyStocks,FSR,118,6,112,-106,2,42,26,2,NYSE
4642,12-02-2021 20:00,24 hrs.,pennystocks,FIORF,8,0,8,-8,1,1,2,1,OTC
4642,12-02-2021 20:00,24 hrs.,pennystocks,FLWPF,22,22,0,22,1,4,10,1,OTC
4642,12-02-2021 20:00,24 hrs.,pennystocks,FTRPF,214,0,214,-214,1,88,34,1,OTC
4642,12-02-2021 20:00,24 hrs.,pennystocks,FUNFF,12,12,0,12,1,3,2,1,OTC
4642,12-02-2021 20:00,24 hrs.,pennystocks,GBOKF,214,0,214,-214,1,88,34,1,OTC
4642,12-02-2021 20:00,24 hrs.,pennystocks,GCPEF,25,0,25,-25,1,7,7,1,OTC
4642,12-02-2021 20:00,24 hrs.,pennystocks,GLDFF,12,6,6,0,2,2,0,2,OTC
4642,12-02-2021 20:00,24 hrs.,pennystocks,GUESF,7,0,7,-7,1,1,1,1,OTC
4642,12-02-2021 20:00,24 hrs.,pennystocks,HAVLF,214,0,214,-214,1,88,34,1,OTC
4642,12-02-2021 20:00,24 hrs.,pennystocks,HITIF,1142,1025,117,908,16,389,300,14,OTC
4642,12-02-2021 20:00,24 hrs.,pennystocks,HNLMF,214,0,214,-214,1,88,34,1,OTC
4642,12-02-2021 20:00,24 hrs.,pennystocks,HRVSF,6,6,0,6,1,1,0,1,OTC
4642,12-02-2021 20:00,24 hrs.,pennystocks,IDXAF,6,6,0,6,1,1,0,1,OTC
4642,12-02-2021 20:00,24 hrs.,pennystocks,INTEQ,6,6,0,6,1,1,0,1,OTC
4642,12-02-2021 20:00,24 hrs.,pennystocks,LIBFF,214,0,214,-214,1,88,34,1,OTC
4642,12-02-2021 20:00,24 hrs.,pennystocks,LKYSF,214,0,214,-214,1,88,34,1,OTC
4642,12-02-2021 20:00,24 hrs.,pennystocks,LLKKF,30,24,6,18,5,5,0,2,OTC
4642,12-02-2021 20:00,24 hrs.,pennystocks,LTMCF,50,0,50,-50,3,7,24,2,OTC
4642,12-02-2021 20:00,24 hrs.,pennystocks,LXXGF,74,74,0,74,1,13,44,1,OTC
4642,12-02-2021 20:00,24 hrs.,pennystocks,MCURF,214,0,214,-214,1,88,34,1,OTC
4642,12-02-2021 20:00,24 hrs.,pennystocks,MEDIF,6,6,0,6,1,1,0,1,OTC
4642,12-02-2021 20:00,24 hrs.,pennystocks,MMEDF,220,6,214,-208,2,89,34,2,OTC
4642,12-02-2021 20:00,24 hrs.,pennystocks,MMNFF,58,0,58,-58,2,23,4,2,OTC
4642,12-02-2021 20:00,24 hrs.,pennystocks,MNXXF,48,48,0,48,3,8,20,3,OTC
4642,12-02-2021 20:00,24 hrs.,pennystocks,MYCOF,214,0,214,-214,1,88,34,1,OTC
4642,12-02-2021 20:00,24 hrs.,pennystocks,NMGRF,122,6,116,-110,3,39,32,3,OTC
4642,12-02-2021 20:00,24 hrs.,pennystocks,NRGOF,14,0,14,-14,2,2,2,1,OTC
4642,12-02-2021 20:00,24 hrs.,pennystocks,NTSFF,6,0,6,-6,1,1,0,1,OTC
4642,12-02-2021 20:00,24 hrs.,pennystocks,NXTTF,24,18,6,12,4,4,0,4,OTC
4642,12-02-2021 20:00,24 hrs.,pennystocks,OILFF,6,6,0,6,1,1,0,1,OTC
4642,12-02-2021 20:00,24 hrs.,pennystocks,PFWIQ,189,90,99,-9,2,56,69,2,OTC
4642,12-02-2021 20:00,24 hrs.,pennystocks,PMNXF,6,6,0,6,1,1,0,1,OTC
4642,12-02-2021 20:00,24 hrs.,pennystocks,PYRNF,6,0,6,-6,1,1,0,1,OTC
4642,12-02-2021 20:00,24 hrs.,pennystocks,QYOUF,6,6,0,6,1,1,0,1,OTC
4642,12-02-2021 20:00,24 hrs.,pennystocks,RACMF,17,0,17,-17,1,5,3,1,OTC
4642,12-02-2021 20:00,24 hrs.,pennystocks,RHDGF,9,9,0,9,1,1,3,1,OTC
4642,12-02-2021 20:00,24 hrs.,pennystocks,RLFTF,6,6,0,6,1,1,0,1,OTC
4642,12-02-2021 20:00,24 hrs.,pennystocks,RLLCF,70,63,7,56,9,11,12,8,OTC
4642,12-02-2021 20:00,24 hrs.,pennystocks,RVVTF,269,7,262,-255,3,94,69,3,OTC
4642,12-02-2021 20:00,24 hrs.,pennystocks,RYCEY,6,0,6,-6,1,1,0,1,OTC
4642,12-02-2021 20:00,24 hrs.,pennystocks,SBSAA,5,0,5,-5,1,0,1,1,OTC
4642,12-02-2021 20:00,24 hrs.,pennystocks,SHRMF,214,0,214,-214,1,88,34,1,OTC
4642,12-02-2021 20:00,24 hrs.,pennystocks,SNNAF,9,9,0,9,1,2,1,1,OTC
4642,12-02-2021 20:00,24 hrs.,pennystocks,SPFYF,9,9,0,9,1,1,3,1,OTC
4642,12-02-2021 20:00,24 hrs.,pennystocks,SPMTF,18,18,0,18,1,2,10,1,OTC
4642,12-02-2021 20:00,24 hrs.,pennystocks,SPRWF,2216,155,2061,-1906,13,944,276,12,OTC
4642,12-02-2021 20:00,24 hrs.,pennystocks,TAKOF,359,0,359,-359,3,137,73,2,OTC
4642,12-02-2021 20:00,24 hrs.,pennystocks,TFECF,4,0,4,-4,1,0,0,1,OTC
4642,12-02-2021 20:00,24 hrs.,pennystocks,TFECY,4,0,4,-4,1,0,0,1,OTC
4642,12-02-2021 20:00,24 hrs.,pennystocks,TLOFF,12,0,12,-12,2,2,0,1,OTC
4642,12-02-2021 20:00,24 hrs.,pennystocks,TRUFF,214,0,214,-214,1,88,34,1,OTC
4642,12-02-2021 20:00,24 hrs.,pennystocks,TSCRF,94,69,25,44,4,25,28,4,OTC
4642,12-02-2021 20:00,24 hrs.,pennystocks,TSKFF,44,0,44,-44,1,15,10,1,OTC
4642,12-02-2021 20:00,24 hrs.,pennystocks,TTTSF,6,0,6,-6,1,1,0,1,OTC
4642,12-02-2021 20:00,24 hrs.,pennystocks,VRNDF,18,18,0,18,1,5,4,1,OTC
4642,12-02-2021 20:00,24 hrs.,pennystocks,XELAW,173,173,0,173,1,77,15,1,OTC
4642,12-02-2021 20:00,24 hrs.,pennystocks,ZBISF,40,40,0,40,1,14,8,1,OTC
4642,12-02-2021 20:00,24 hrs.,pennystocks,AIM,8,8,0,8,1,1,2,1,AMEX
4642,12-02-2021 20:00,24 hrs.,pennystocks,APT,12,0,12,-12,2,2,0,1,AMEX
4642,12-02-2021 20:00,24 hrs.,pennystocks,CTO,42,24,18,6,4,5,16,2,AMEX
4642,12-02-2021 20:00,24 hrs.,pennystocks,DNN,427,37,390,-353,9,134,123,9,AMEX
4642,12-02-2021 20:00,24 hrs.,pennystocks,DPW,6,0,6,-6,1,1,0,1,AMEX
4642,12-02-2021 20:00,24 hrs.,pennystocks,DSS,32,32,0,32,2,6,12,2,AMEX
4642,12-02-2021 20:00,24 hrs.,pennystocks,GPL,35,0,35,-35,1,13,5,1,AMEX
4642,12-02-2021 20:00,24 hrs.,pennystocks,AKBA,8,0,8,-8,1,2,0,1,NASDAQ
4642,12-02-2021 20:00,24 hrs.,pennystocks,ALRN,20,0,20,-20,1,3,10,1,NASDAQ
4642,12-02-2021 20:00,24 hrs.,pennystocks,AMTX,38,38,0,38,1,10,14,1,NASDAQ
4642,12-02-2021 20:00,24 hrs.,pennystocks,APHA,49,49,0,49,3,14,9,3,NASDAQ
4642,12-02-2021 20:00,24 hrs.,pennystocks,ARTL,48,48,0,48,5,11,6,3,NASDAQ
4642,12-02-2021 20:00,24 hrs.,pennystocks,ASRT,1548,1542,6,1536,15,593,302,9,NASDAQ
4642,12-02-2021 20:00,24 hrs.,pennystocks,ATOS,262,96,166,-70,5,97,48,5,NASDAQ
4642,12-02-2021 20:00,24 hrs.,pennystocks,AZRX,9,0,9,-9,1,1,3,1,NASDAQ
4642,12-02-2021 20:00,24 hrs.,pennystocks,BBIG,6,0,6,-6,1,1,0,1,NASDAQ
4642,12-02-2021 20:00,24 hrs.,pennystocks,BHTG,7,0,7,-7,1,1,1,1,NASDAQ
4642,12-02-2021 20:00,24 hrs.,pennystocks,GSV,18,0,18,-18,3,3,0,2,AMEX
4642,12-02-2021 20:00,24 hrs.,pennystocks,GTE,13,6,7,-1,2,2,1,2,AMEX
4642,12-02-2021 20:00,24 hrs.,pennystocks,ITP,29,12,17,-5,2,2,17,2,AMEX
4642,12-02-2021 20:00,24 hrs.,pennystocks,MCF,6,6,0,6,1,1,0,1,AMEX
4642,12-02-2021 20:00,24 hrs.,pennystocks,MXC,7,7,0,7,1,1,1,1,AMEX
4642,12-02-2021 20:00,24 hrs.,pennystocks,NAK,37,31,6,25,2,8,13,2,AMEX
4642,12-02-2021 20:00,24 hrs.,pennystocks,PTN,24,24,0,24,1,7,6,1,AMEX
4642,12-02-2021 20:00,24 hrs.,pennystocks,SIM,6,0,6,-6,1,1,0,1,AMEX
4642,12-02-2021 20:00,24 hrs.,pennystocks,TGB,28,28,0,28,1,10,4,1,AMEX
4642,12-02-2021 20:00,24 hrs.,pennystocks,TGC,52,0,52,-52,1,22,4,1,AMEX
4642,12-02-2021 20:00,24 hrs.,pennystocks,TRX,22,8,14,-6,3,3,4,3,AMEX
4642,12-02-2021 20:00,24 hrs.,pennystocks,ZOM,187,13,174,-161,6,65,33,6,AMEX
4642,12-02-2021 20:00,24 hrs.,pennystocks,INUV,65,65,0,65,1,23,15,1,AMEX
4642,12-02-2021 20:00,24 hrs.,pennystocks,NSPR,13,13,0,13,1,3,3,1,AMEX
4642,12-02-2021 20:00,24 hrs.,pennystocks,SDPI,6,6,0,6,1,1,0,1,AMEX
4642,12-02-2021 20:00,24 hrs.,pennystocks,SENS,71,36,35,1,4,20,15,4,AMEX
4642,12-02-2021 20:00,24 hrs.,pennystocks,TMBR,52,0,52,-52,1,22,4,1,AMEX
4642,12-02-2021 20:00,24 hrs.,pennystocks,TRXC,12,12,0,12,2,2,0,2,AMEX
4642,12-02-2021 20:00,24 hrs.,pennystocks,UAVS,98,98,0,98,1,32,30,1,AMEX
4642,12-02-2021 20:00,24 hrs.,pennystocks,XXII,6,6,0,6,1,0,2,1,AMEX
4642,12-02-2021 20:00,24 hrs.,pennystocks,AHT,6,6,0,6,1,1,0,1,NYSE
4642,12-02-2021 20:00,24 hrs.,pennystocks,AMC,92,80,12,68,7,16,32,6,NYSE
4642,12-02-2021 20:00,24 hrs.,pennystocks,ASX,24,24,0,24,4,4,0,2,NYSE
4642,12-02-2021 20:00,24 hrs.,pennystocks,ATH,10,10,0,10,1,2,2,1,NYSE
4642,12-02-2021 20:00,24 hrs.,pennystocks,BIO,307,0,307,-307,1,127,49,1,NYSE
4642,12-02-2021 20:00,24 hrs.,pennystocks,BTU,6,6,0,6,1,1,0,1,NYSE
4642,12-02-2021 20:00,24 hrs.,pennystocks,CBD,290,17,273,-256,5,109,52,5,NYSE
4642,12-02-2021 20:00,24 hrs.,pennystocks,CHS,29,29,0,29,1,8,9,1,NYSE
4642,12-02-2021 20:00,24 hrs.,pennystocks,CMO,33,0,33,-33,1,9,11,1,NYSE
4642,12-02-2021 20:00,24 hrs.,pennystocks,CRL,6,0,6,-6,1,1,0,1,NYSE
4642,12-02-2021 20:00,24 hrs.,pennystocks,CTK,52,0,52,-52,1,22,4,1,NYSE
4642,12-02-2021 20:00,24 hrs.,pennystocks,CVE,35,18,17,1,4,8,3,2,NYSE
4642,12-02-2021 20:00,24 hrs.,pennystocks,CVX,27,27,0,27,1,8,7,1,NYSE
4642,12-02-2021 20:00,24 hrs.,pennystocks,ETH,6,6,0,6,1,1,0,1,NYSE
4642,12-02-2021 20:00,24 hrs.,pennystocks,FLT,6,0,6,-6,1,1,0,1,NYSE
4642,12-02-2021 20:00,24 hrs.,pennystocks,GME,48,6,42,-36,8,8,0,7,NYSE
4642,12-02-2021 20:00,24 hrs.,pennystocks,LEE,102,0,102,-102,1,13,72,1,NYSE
4642,12-02-2021 20:00,24 hrs.,pennystocks,MDC,15,15,0,15,1,4,3,1,NYSE
4642,12-02-2021 20:00,24 hrs.,pennystocks,NAT,7,7,0,7,1,1,1,1,NYSE
4642,12-02-2021 20:00,24 hrs.,pennystocks,NOK,18,6,12,-6,3,3,0,2,NYSE
4642,12-02-2021 20:00,24 hrs.,pennystocks,PSA,14,0,14,-14,2,2,2,2,NYSE
4642,12-02-2021 20:00,24 hrs.,pennystocks,RKT,72,72,0,72,1,23,22,1,NYSE
4642,12-02-2021 20:00,24 hrs.,pennystocks,RSI,59,30,29,1,3,19,9,3,NYSE
4642,12-02-2021 20:00,24 hrs.,pennystocks,SAP,214,0,214,-214,1,88,34,1,NYSE
4642,12-02-2021 20:00,24 hrs.,pennystocks,SOS,44,38,6,32,4,4,20,4,NYSE
4642,12-02-2021 20:00,24 hrs.,pennystocks,SUM,30,30,0,30,1,11,4,1,NYSE
4642,12-02-2021 20:00,24 hrs.,pennystocks,THC,214,0,214,-214,1,88,34,1,NYSE
4642,12-02-2021 20:00,24 hrs.,pennystocks,TSM,27,27,0,27,1,9,5,1,NYSE
4642,12-02-2021 20:00,24 hrs.,pennystocks,TTI,12,0,12,-12,2,2,0,1,NYSE
4642,12-02-2021 20:00,24 hrs.,pennystocks,WEI,17,17,0,17,1,6,1,1,NYSE
4642,12-02-2021 20:00,24 hrs.,pennystocks,WLL,6,6,0,6,1,1,0,1,NYSE
4642,12-02-2021 20:00,24 hrs.,pennystocks,WWE,7,0,7,-7,1,1,1,1,NYSE
4642,12-02-2021 20:00,24 hrs.,pennystocks,AQUA,7,0,7,-7,1,1,1,1,NYSE
4642,12-02-2021 20:00,24 hrs.,pennystocks,ARGO,40,40,0,40,1,6,24,1,NYSE
4642,12-02-2021 20:00,24 hrs.,pennystocks,NAKD,44,38,6,32,3,9,14,3,NASDAQ
4642,12-02-2021 20:00,24 hrs.,pennystocks,NAOV,6,6,0,6,1,1,0,1,NASDAQ
4642,12-02-2021 20:00,24 hrs.,pennystocks,NCMI,15,15,0,15,1,4,3,1,NASDAQ
4642,12-02-2021 20:00,24 hrs.,pennystocks,NDAQ,17,17,0,17,1,6,1,1,NASDAQ
4642,12-02-2021 20:00,24 hrs.,pennystocks,NOVN,34,6,28,-22,3,7,8,3,NASDAQ
4642,12-02-2021 20:00,24 hrs.,pennystocks,NTEC,52,0,52,-52,1,22,4,1,NASDAQ
4642,12-02-2021 20:00,24 hrs.,pennystocks,NVCN,50,43,7,36,2,14,14,2,NASDAQ
4642,12-02-2021 20:00,24 hrs.,pennystocks,NXTD,60,0,60,-60,2,23,6,2,NASDAQ
4642,12-02-2021 20:00,24 hrs.,pennystocks,OCGN,51,51,0,51,3,12,15,3,NASDAQ
4642,12-02-2021 20:00,24 hrs.,pennystocks,ONTX,12,6,6,0,2,2,0,2,NASDAQ
4642,12-02-2021 20:00,24 hrs.,pennystocks,OPTT,20,20,0,20,1,6,4,1,NASDAQ
4642,12-02-2021 20:00,24 hrs.,pennystocks,OTIC,10,10,0,10,1,1,4,1,NASDAQ
4642,12-02-2021 20:00,24 hrs.,pennystocks,PHIO,52,0,52,-52,1,22,4,1,NASDAQ
4642,12-02-2021 20:00,24 hrs.,pennystocks,PHUN,13,0,13,-13,2,2,1,2,NASDAQ
4642,12-02-2021 20:00,24 hrs.,pennystocks,PLUG,111,17,94,-77,2,24,55,2,NASDAQ
4642,12-02-2021 20:00,24 hrs.,pennystocks,PPBT,10,0,10,-10,1,2,2,1,NASDAQ
4642,12-02-2021 20:00,24 hrs.,pennystocks,PSTV,76,6,70,-64,2,28,12,2,NASDAQ
4642,12-02-2021 20:00,24 hrs.,pennystocks,PULM,155,103,52,51,4,38,63,4,NASDAQ
4642,12-02-2021 20:00,24 hrs.,pennystocks,RAVE,41,0,41,-41,1,13,11,1,NASDAQ
4642,12-02-2021 20:00,24 hrs.,pennystocks,REAL,54,0,54,-54,2,6,34,2,NASDAQ
4642,12-02-2021 20:00,24 hrs.,pennystocks,BIOL,6,6,0,6,1,1,0,1,NASDAQ
4642,12-02-2021 20:00,24 hrs.,pennystocks,BKEP,12,0,12,-12,1,2,4,1,NASDAQ
4642,12-02-2021 20:00,24 hrs.,pennystocks,BLCM,52,0,52,-52,1,22,4,1,NASDAQ
4642,12-02-2021 20:00,24 hrs.,pennystocks,BNGO,35,35,0,35,3,10,3,3,NASDAQ
4642,12-02-2021 20:00,24 hrs.,pennystocks,BVXV,7,0,7,-7,1,1,1,1,NASDAQ
4642,12-02-2021 20:00,24 hrs.,pennystocks,CAPR,6,0,6,-6,1,1,0,1,NASDAQ
4642,12-02-2021 20:00,24 hrs.,pennystocks,CFMS,12,12,0,12,2,2,0,2,NASDAQ
4642,12-02-2021 20:00,24 hrs.,pennystocks,CIDM,74,74,0,74,1,13,44,1,NASDAQ
4642,12-02-2021 20:00,24 hrs.,pennystocks,CJJD,52,0,52,-52,1,22,4,1,NASDAQ
4642,12-02-2021 20:00,24 hrs.,pennystocks,CKPT,70,6,64,-58,4,25,4,3,NASDAQ
4642,12-02-2021 20:00,24 hrs.,pennystocks,CLBS,89,82,7,75,2,34,13,2,NASDAQ
4642,12-02-2021 20:00,24 hrs.,pennystocks,CLEU,7,7,0,7,1,1,1,1,NASDAQ
4642,12-02-2021 20:00,24 hrs.,pennystocks,CMPS,220,0,220,-220,2,89,34,2,NASDAQ
4642,12-02-2021 20:00,24 hrs.,pennystocks,COCP,33,33,0,33,2,11,3,2,NASDAQ
4642,12-02-2021 20:00,24 hrs.,pennystocks,CPLP,29,29,0,29,3,1,15,2,NASDAQ
4642,12-02-2021 20:00,24 hrs.,pennystocks,CRWS,6,6,0,6,1,1,0,1,NASDAQ
4642,12-02-2021 20:00,24 hrs.,pennystocks,CSCW,7,7,0,7,1,1,1,1,NASDAQ
4642,12-02-2021 20:00,24 hrs.,pennystocks,CSTR,6,6,0,6,1,1,0,1,NASDAQ
4642,12-02-2021 20:00,24 hrs.,pennystocks,CTHR,20,20,0,20,1,6,4,1,NASDAQ
4642,12-02-2021 20:00,24 hrs.,pennystocks,CTRM,153,54,99,-45,11,39,31,11,NASDAQ
4642,12-02-2021 20:00,24 hrs.,pennystocks,DSSI,9,9,0,9,1,0,5,1,NYSE
4642,12-02-2021 20:00,24 hrs.,pennystocks,FINV,7,7,0,7,1,1,1,1,NYSE
4642,12-02-2021 20:00,24 hrs.,pennystocks,HEXO,23,23,0,23,1,2,15,1,NYSE
4642,12-02-2021 20:00,24 hrs.,pennystocks,HYLN,19,0,19,-19,3,3,1,2,NYSE
4642,12-02-2021 20:00,24 hrs.,pennystocks,NOVA,214,0,214,-214,1,88,34,1,NYSE
4642,12-02-2021 20:00,24 hrs.,pennystocks,VIST,12,12,0,12,1,2,4,1,NYSE
4642,12-02-2021 20:00,24 hrs.,pennystocks,WELL,194,194,0,194,1,62,66,1,NYSE
4642,12-02-2021 20:00,24 hrs.,pennystocks,AQB,6,0,6,-6,1,1,0,1,NASDAQ
4642,12-02-2021 20:00,24 hrs.,pennystocks,AZN,32,0,32,-32,1,7,14,1,NASDAQ
4642,12-02-2021 20:00,24 hrs.,pennystocks,BBI,47,0,47,-47,1,17,9,1,NASDAQ
4642,12-02-2021 20:00,24 hrs.,pennystocks,CFO,33,0,33,-33,1,9,11,1,NASDAQ
4642,12-02-2021 20:00,24 hrs.,pennystocks,FWP,10,10,0,10,1,0,6,1,NASDAQ
4642,12-02-2021 20:00,24 hrs.,pennystocks,KOD,6,6,0,6,1,1,0,1,NASDAQ
4642,12-02-2021 20:00,24 hrs.,pennystocks,MFH,52,0,52,-52,1,22,4,1,NASDAQ
4642,12-02-2021 20:00,24 hrs.,pennystocks,MKD,27,27,0,27,1,8,7,1,NASDAQ
4642,12-02-2021 20:00,24 hrs.,pennystocks,MYT,11,11,0,11,1,1,5,1,NASDAQ
4642,12-02-2021 20:00,24 hrs.,pennystocks,NEO,214,0,214,-214,1,88,34,1,NASDAQ
4642,12-02-2021 20:00,24 hrs.,pennystocks,OGI,14,0,14,-14,2,2,2,2,NASDAQ
4642,12-02-2021 20:00,24 hrs.,pennystocks,UFO,6,0,6,-6,1,1,0,1,NASDAQ
4642,12-02-2021 20:00,24 hrs.,pennystocks,ABEO,7,7,0,7,1,1,1,1,NASDAQ
4642,12-02-2021 20:00,24 hrs.,pennystocks,ABIO,24,0,24,-24,1,8,4,1,NASDAQ
4642,12-02-2021 20:00,24 hrs.,pennystocks,ACST,13,6,7,-1,2,2,1,2,NASDAQ
4642,12-02-2021 20:00,24 hrs.,pennystocks,AGEN,8,8,0,8,1,2,0,1,NASDAQ
4642,12-02-2021 20:00,24 hrs.,pennystocks,AGTC,31,14,17,-3,3,5,9,3,NASDAQ
4642,12-02-2021 20:00,24 hrs.,RobinHoodPennyStocks,ATOS,571,514,57,457,16,200,107,16,NASDAQ
4642,12-02-2021 20:00,24 hrs.,RobinHoodPennyStocks,AVCO,112,0,112,-112,1,41,26,1,NASDAQ
4642,12-02-2021 20:00,24 hrs.,RobinHoodPennyStocks,BBIG,6,0,6,-6,1,1,0,1,NASDAQ
4642,12-02-2021 20:00,24 hrs.,RobinHoodPennyStocks,BCLI,6,0,6,-6,1,1,0,1,NASDAQ
4642,12-02-2021 20:00,24 hrs.,RobinHoodPennyStocks,BCRX,42,0,42,-42,1,8,22,1,NASDAQ
4642,12-02-2021 20:00,24 hrs.,RobinHoodPennyStocks,BFRA,112,0,112,-112,1,41,26,1,NASDAQ
4642,12-02-2021 20:00,24 hrs.,RobinHoodPennyStocks,BHAT,112,0,112,-112,1,41,26,1,NASDAQ
4642,12-02-2021 20:00,24 hrs.,RobinHoodPennyStocks,BHTG,31,31,0,31,2,9,5,2,NASDAQ
4642,12-02-2021 20:00,24 hrs.,RobinHoodPennyStocks,BIOL,6,6,0,6,1,1,0,1,NASDAQ
4642,12-02-2021 20:00,24 hrs.,RobinHoodPennyStocks,BNGO,38,38,0,38,3,9,8,3,NASDAQ
4642,12-02-2021 20:00,24 hrs.,RobinHoodPennyStocks,BRQS,139,27,112,-85,3,45,37,3,NASDAQ
4642,12-02-2021 20:00,24 hrs.,RobinHoodPennyStocks,BYFC,112,0,112,-112,1,41,26,1,NASDAQ
4642,12-02-2021 20:00,24 hrs.,RobinHoodPennyStocks,CAAS,112,0,112,-112,1,41,26,1,NASDAQ
4642,12-02-2021 20:00,24 hrs.,RobinHoodPennyStocks,CARV,112,0,112,-112,1,41,26,1,NASDAQ
4642,12-02-2021 20:00,24 hrs.,RobinHoodPennyStocks,CBAT,112,0,112,-112,1,41,26,1,NASDAQ
4642,12-02-2021 20:00,24 hrs.,RobinHoodPennyStocks,CCNC,112,0,112,-112,1,41,26,1,NASDAQ
4642,12-02-2021 20:00,24 hrs.,RobinHoodPennyStocks,CHNR,112,0,112,-112,1,41,26,1,NASDAQ
4642,12-02-2021 20:00,24 hrs.,RobinHoodPennyStocks,CIDM,6,0,6,-6,1,1,0,1,NASDAQ
4642,12-02-2021 20:00,24 hrs.,RobinHoodPennyStocks,CKPT,307,35,272,-237,2,66,167,2,NASDAQ
4642,12-02-2021 20:00,24 hrs.,RobinHoodPennyStocks,CLBS,6,6,0,6,1,1,0,1,NASDAQ
4642,12-02-2021 20:00,24 hrs.,pennystocks,CTXR,19,13,6,7,2,4,3,2,NASDAQ
4642,12-02-2021 20:00,24 hrs.,pennystocks,CYTH,7,7,0,7,1,1,1,1,NASDAQ
4642,12-02-2021 20:00,24 hrs.,pennystocks,DFFN,162,139,23,116,5,58,26,5,NASDAQ
4642,12-02-2021 20:00,24 hrs.,pennystocks,DGLY,35,0,35,-35,5,5,5,1,NASDAQ
4642,12-02-2021 20:00,24 hrs.,pennystocks,DYNT,52,0,52,-52,1,22,4,1,NASDAQ
4642,12-02-2021 20:00,24 hrs.,pennystocks,EBON,12,6,6,0,2,2,0,2,NASDAQ
4642,12-02-2021 20:00,24 hrs.,pennystocks,ENPH,94,0,94,-94,1,18,54,1,NASDAQ
4642,12-02-2021 20:00,24 hrs.,pennystocks,ENTX,24,24,0,24,1,8,4,1,NASDAQ
4642,12-02-2021 20:00,24 hrs.,pennystocks,ENVB,6,6,0,6,1,1,0,1,NASDAQ
4642,12-02-2021 20:00,24 hrs.,pennystocks,EPSN,12,12,0,12,2,2,0,2,NASDAQ
4642,12-02-2021 20:00,24 hrs.,pennystocks,EVFM,6,0,6,-6,1,1,0,1,NASDAQ
4642,12-02-2021 20:00,24 hrs.,pennystocks,FAMI,13,13,0,13,2,2,1,2,NASDAQ
4642,12-02-2021 20:00,24 hrs.,pennystocks,FATE,17,17,0,17,1,6,1,1,NASDAQ
4642,12-02-2021 20:00,24 hrs.,pennystocks,FCEL,94,0,94,-94,1,18,54,1,NASDAQ
4642,12-02-2021 20:00,24 hrs.,pennystocks,GAIN,7,7,0,7,1,1,1,1,NASDAQ
4642,12-02-2021 20:00,24 hrs.,pennystocks,GALT,7,7,0,7,1,1,1,1,NASDAQ
4642,12-02-2021 20:00,24 hrs.,pennystocks,GEVO,63,0,63,-63,3,16,19,2,NASDAQ
4642,12-02-2021 20:00,24 hrs.,pennystocks,GHSI,156,44,112,-68,3,60,24,3,NASDAQ
4642,12-02-2021 20:00,24 hrs.,pennystocks,GOEV,79,79,0,79,2,24,23,2,NASDAQ
4642,12-02-2021 20:00,24 hrs.,pennystocks,GOLD,6,0,6,-6,1,1,0,1,NASDAQ
4642,12-02-2021 20:00,24 hrs.,pennystocks,GRIL,47,0,47,-47,2,14,11,2,NASDAQ
4642,12-02-2021 20:00,24 hrs.,pennystocks,GRNQ,52,0,52,-52,1,22,4,1,NASDAQ
4642,12-02-2021 20:00,24 hrs.,pennystocks,HALO,6,0,6,-6,1,1,0,1,NASDAQ
4642,12-02-2021 20:00,24 hrs.,pennystocks,HRTX,14,14,0,14,1,2,6,1,NASDAQ
4642,12-02-2021 20:00,24 hrs.,pennystocks,HSTO,12,12,0,12,2,2,0,2,NASDAQ
4642,12-02-2021 20:00,24 hrs.,pennystocks,IFMK,93,0,93,-93,2,35,15,2,NASDAQ
4642,12-02-2021 20:00,24 hrs.,pennystocks,INFI,65,13,52,-39,2,23,11,2,NASDAQ
4642,12-02-2021 20:00,24 hrs.,pennystocks,INOD,47,47,0,47,1,10,23,1,NASDAQ
4642,12-02-2021 20:00,24 hrs.,pennystocks,INPX,65,0,65,-65,3,24,5,3,NASDAQ
4642,12-02-2021 20:00,24 hrs.,pennystocks,IRDM,17,17,0,17,1,6,1,1,NASDAQ
4642,12-02-2021 20:00,24 hrs.,pennystocks,IZEA,6,6,0,6,1,1,0,1,NASDAQ
4642,12-02-2021 20:00,24 hrs.,pennystocks,JAGX,6,0,6,-6,1,1,0,1,NASDAQ
4642,12-02-2021 20:00,24 hrs.,pennystocks,KTRA,146,100,46,54,5,42,42,5,NASDAQ
4642,12-02-2021 20:00,24 hrs.,pennystocks,KXIN,17,17,0,17,1,6,1,1,NASDAQ
4642,12-02-2021 20:00,24 hrs.,pennystocks,LKCO,73,9,64,-55,4,26,5,3,NASDAQ
4642,12-02-2021 20:00,24 hrs.,pennystocks,LPCN,52,0,52,-52,1,18,12,1,NASDAQ
4642,12-02-2021 20:00,24 hrs.,pennystocks,LPTH,57,57,0,57,1,22,9,1,NASDAQ
4642,12-02-2021 20:00,24 hrs.,pennystocks,MARK,94,0,94,-94,1,18,54,1,NASDAQ
4642,12-02-2021 20:00,24 hrs.,pennystocks,MDGS,6,0,6,-6,1,1,0,1,NASDAQ
4642,12-02-2021 20:00,24 hrs.,pennystocks,MOGO,16,0,16,-16,1,0,12,1,NASDAQ
4642,12-02-2021 20:00,24 hrs.,pennystocks,MOSY,52,0,52,-52,1,22,4,1,NASDAQ
4642,12-02-2021 20:00,24 hrs.,pennystocks,MOTS,7,0,7,-7,1,1,1,1,NASDAQ
4642,12-02-2021 20:00,24 hrs.,pennystocks,MTRX,17,0,17,-17,1,5,3,1,NASDAQ
4642,12-02-2021 20:00,24 hrs.,pennystocks,MVIS,58,0,58,-58,2,23,4,2,NASDAQ
4642,12-02-2021 20:00,24 hrs.,pennystocks,SHIP,20,20,0,20,3,3,2,2,NASDAQ
4642,12-02-2021 20:00,24 hrs.,pennystocks,SNDL,202,86,116,-30,25,46,10,22,NASDAQ
4642,12-02-2021 20:00,24 hrs.,pennystocks,SNGX,1290,1290,0,1290,7,507,248,5,NASDAQ
4642,12-02-2021 20:00,24 hrs.,pennystocks,SOLO,17,17,0,17,1,6,1,1,NASDAQ
4642,12-02-2021 20:00,24 hrs.,pennystocks,SRGA,6,6,0,6,1,1,0,1,NASDAQ
4642,12-02-2021 20:00,24 hrs.,pennystocks,STCN,6,6,0,6,1,1,0,1,NASDAQ
4642,12-02-2021 20:00,24 hrs.,RobinHoodPennyStocks,CLEU,112,0,112,-112,1,41,26,1,NASDAQ
4642,12-02-2021 20:00,24 hrs.,RobinHoodPennyStocks,CLSK,112,0,112,-112,1,41,26,1,NASDAQ
4642,12-02-2021 20:00,24 hrs.,RobinHoodPennyStocks,CMLF,112,0,112,-112,1,41,26,1,NASDAQ
4642,12-02-2021 20:00,24 hrs.,RobinHoodPennyStocks,CSCW,112,0,112,-112,1,41,26,1,NASDAQ
4642,12-02-2021 20:00,24 hrs.,RobinHoodPennyStocks,CTRM,1035,372,663,-291,17,300,367,17,NASDAQ
4642,12-02-2021 20:00,24 hrs.,RobinHoodPennyStocks,DFFN,509,503,6,497,8,180,117,7,NASDAQ
4642,12-02-2021 20:00,24 hrs.,RobinHoodPennyStocks,EAST,54,0,54,-54,1,17,16,1,NASDAQ
4642,12-02-2021 20:00,24 hrs.,RobinHoodPennyStocks,ENTX,57,57,0,57,1,23,7,1,NASDAQ
4642,12-02-2021 20:00,24 hrs.,RobinHoodPennyStocks,ENVB,6,0,6,-6,1,1,0,1,NASDAQ
4642,12-02-2021 20:00,24 hrs.,RobinHoodPennyStocks,EQOS,112,0,112,-112,1,41,26,1,NASDAQ
4642,12-02-2021 20:00,24 hrs.,RobinHoodPennyStocks,FCEL,157,45,112,-67,2,49,51,2,NASDAQ
4642,12-02-2021 20:00,24 hrs.,RobinHoodPennyStocks,GHSI,97,0,97,-97,1,40,13,1,NASDAQ
4642,12-02-2021 20:00,24 hrs.,RobinHoodPennyStocks,GLBS,6,6,0,6,1,1,0,1,NASDAQ
4642,12-02-2021 20:00,24 hrs.,RobinHoodPennyStocks,GLMD,272,0,272,-272,1,54,160,1,NASDAQ
4642,12-02-2021 20:00,24 hrs.,pennystocks,RIGL,12,0,12,-12,2,2,0,2,NASDAQ
4642,12-02-2021 20:00,24 hrs.,pennystocks,RMTI,6,0,6,-6,1,1,0,1,NASDAQ
4642,12-02-2021 20:00,24 hrs.,RobinHoodPennyStocks,CMCM,112,0,112,-112,1,41,26,1,NYSE
4642,12-02-2021 20:00,24 hrs.,RobinHoodPennyStocks,FUBO,118,0,118,-118,2,42,26,2,NYSE
4642,12-02-2021 20:00,24 hrs.,RobinHoodPennyStocks,LAIX,112,0,112,-112,1,41,26,1,NYSE
4642,12-02-2021 20:00,24 hrs.,RobinHoodPennyStocks,RLGY,112,0,112,-112,1,41,26,1,NYSE
4642,12-02-2021 20:00,24 hrs.,RobinHoodPennyStocks,XPEV,112,0,112,-112,1,41,26,1,NYSE
4642,12-02-2021 20:00,24 hrs.,RobinHoodPennyStocks,AIH,112,0,112,-112,1,41,26,1,NASDAQ
4642,12-02-2021 20:00,24 hrs.,RobinHoodPennyStocks,BBI,6,6,0,6,1,1,0,1,NASDAQ
4642,12-02-2021 20:00,24 hrs.,RobinHoodPennyStocks,ENG,112,0,112,-112,1,41,26,1,NASDAQ
4642,12-02-2021 20:00,24 hrs.,RobinHoodPennyStocks,EVK,112,0,112,-112,1,41,26,1,NASDAQ
4642,12-02-2021 20:00,24 hrs.,RobinHoodPennyStocks,JFU,6,0,6,-6,1,1,0,1,NASDAQ
4642,12-02-2021 20:00,24 hrs.,RobinHoodPennyStocks,MGI,112,0,112,-112,1,41,26,1,NASDAQ
4642,12-02-2021 20:00,24 hrs.,RobinHoodPennyStocks,OCG,112,0,112,-112,1,41,26,1,NASDAQ
4642,12-02-2021 20:00,24 hrs.,RobinHoodPennyStocks,OEG,112,0,112,-112,1,41,26,1,NASDAQ
4642,12-02-2021 20:00,24 hrs.,RobinHoodPennyStocks,OGI,6,6,0,6,1,1,0,1,NASDAQ
4642,12-02-2021 20:00,24 hrs.,RobinHoodPennyStocks,PTE,12,0,12,-12,2,2,0,1,NASDAQ
4642,12-02-2021 20:00,24 hrs.,RobinHoodPennyStocks,QTT,112,0,112,-112,1,41,26,1,NASDAQ
4642,12-02-2021 20:00,24 hrs.,RobinHoodPennyStocks,SND,18,18,0,18,3,3,0,1,NASDAQ
4642,12-02-2021 20:00,24 hrs.,RobinHoodPennyStocks,SPI,112,0,112,-112,1,41,26,1,NASDAQ
4642,12-02-2021 20:00,24 hrs.,RobinHoodPennyStocks,WNW,112,0,112,-112,1,41,26,1,NASDAQ
4642,12-02-2021 20:00,24 hrs.,RobinHoodPennyStocks,WWR,112,0,112,-112,1,41,26,1,NASDAQ
4642,12-02-2021 20:00,24 hrs.,RobinHoodPennyStocks,AAOI,112,0,112,-112,1,41,26,1,NASDAQ
4642,12-02-2021 20:00,24 hrs.,RobinHoodPennyStocks,ABEO,109,109,0,109,3,32,33,3,NASDAQ
4642,12-02-2021 20:00,24 hrs.,RobinHoodPennyStocks,ABIO,28,0,28,-28,1,4,16,1,NASDAQ
4642,12-02-2021 20:00,24 hrs.,RobinHoodPennyStocks,ACOR,112,0,112,-112,1,41,26,1,NASDAQ
4642,12-02-2021 20:00,24 hrs.,RobinHoodPennyStocks,ACRX,17,17,0,17,1,5,3,1,NASDAQ
4642,12-02-2021 20:00,24 hrs.,RobinHoodPennyStocks,ACST,6,6,0,6,1,1,0,1,NASDAQ
4642,12-02-2021 20:00,24 hrs.,RobinHoodPennyStocks,ADMA,47,0,47,-47,1,17,9,1,NASDAQ
4642,12-02-2021 20:00,24 hrs.,RobinHoodPennyStocks,ADXS,18,18,0,18,3,3,0,2,NASDAQ
4642,12-02-2021 20:00,24 hrs.,RobinHoodPennyStocks,AEHR,112,0,112,-112,1,41,26,1,NASDAQ
4642,12-02-2021 20:00,24 hrs.,RobinHoodPennyStocks,AESE,6,0,6,-6,1,1,0,1,NASDAQ
4642,12-02-2021 20:00,24 hrs.,RobinHoodPennyStocks,AEZS,17,0,17,-17,1,2,9,1,NASDAQ
4642,12-02-2021 20:00,24 hrs.,RobinHoodPennyStocks,AGTC,2153,976,1177,-201,24,793,471,24,NASDAQ
4642,12-02-2021 20:00,24 hrs.,RobinHoodPennyStocks,AIHS,112,0,112,-112,1,41,26,1,NASDAQ
4642,12-02-2021 20:00,24 hrs.,RobinHoodPennyStocks,ALAC,112,0,112,-112,1,41,26,1,NASDAQ
4642,12-02-2021 20:00,24 hrs.,RobinHoodPennyStocks,AMTX,112,0,112,-112,1,41,26,1,NASDAQ
4642,12-02-2021 20:00,24 hrs.,RobinHoodPennyStocks,APHA,18,12,6,6,3,3,0,2,NASDAQ
4642,12-02-2021 20:00,24 hrs.,RobinHoodPennyStocks,ARPO,6,6,0,6,1,1,0,1,NASDAQ
4642,12-02-2021 20:00,24 hrs.,RobinHoodPennyStocks,ARTL,18,18,0,18,3,3,0,3,NASDAQ
4642,12-02-2021 20:00,24 hrs.,RobinHoodPennyStocks,ASRT,18,12,6,6,3,3,0,2,NASDAQ
4642,12-02-2021 20:00,24 hrs.,RobinHoodPennyStocks,ASYS,112,0,112,-112,1,41,26,1,NASDAQ
4642,12-02-2021 20:00,24 hrs.,RobinHoodPennyStocks,ATIF,112,0,112,-112,1,41,26,1,NASDAQ
4642,12-02-2021 20:00,24 hrs.,RobinHoodPennyStocks,ATNI,112,0,112,-112,1,41,26,1,NASDAQ
4642,12-02-2021 20:00,24 hrs.,pennystocks,TNXP,470,69,401,-332,14,167,80,11,NASDAQ
4642,12-02-2021 20:00,24 hrs.,pennystocks,TRCH,6,0,6,-6,1,1,0,1,NASDAQ
4642,12-02-2021 20:00,24 hrs.,pennystocks,TRIP,214,0,214,-214,1,88,34,1,NASDAQ
4642,12-02-2021 20:00,24 hrs.,pennystocks,TRVG,19,19,0,19,3,3,1,2,NASDAQ
4642,12-02-2021 20:00,24 hrs.,pennystocks,TSLA,15,15,0,15,2,3,1,2,NASDAQ
4642,12-02-2021 20:00,24 hrs.,pennystocks,TTWO,6,0,6,-6,1,1,0,1,NASDAQ
4642,12-02-2021 20:00,24 hrs.,pennystocks,TXMD,7,7,0,7,1,1,1,1,NASDAQ
4642,12-02-2021 20:00,24 hrs.,pennystocks,TYME,13,13,0,13,1,3,3,1,NASDAQ
4642,12-02-2021 20:00,24 hrs.,pennystocks,USWS,12,0,12,-12,2,2,0,2,NASDAQ
4642,12-02-2021 20:00,24 hrs.,pennystocks,VEON,7,7,0,7,1,1,1,1,NASDAQ
4642,12-02-2021 20:00,24 hrs.,pennystocks,VETS,194,194,0,194,1,62,66,1,NASDAQ
4642,12-02-2021 20:00,24 hrs.,pennystocks,VRME,23,0,23,-23,1,7,5,1,NASDAQ
4642,12-02-2021 20:00,24 hrs.,pennystocks,WTRH,71,0,71,-71,2,22,19,2,NASDAQ
4642,12-02-2021 20:00,24 hrs.,pennystocks,XELA,173,173,0,173,1,77,15,1,NASDAQ
4642,12-02-2021 20:00,24 hrs.,pennystocks,XSPA,30,30,0,30,1,11,4,1,NASDAQ
4642,12-02-2021 20:00,24 hrs.,pennystocks,ZSAN,205,78,127,-49,6,62,57,6,NASDAQ
4642,12-02-2021 20:00,24 hrs.,pennystocks,ZYNE,52,0,52,-52,1,22,4,1,NASDAQ
4642,12-02-2021 20:00,24 hrs.,wallstreetbets,ABML,27,20,7,13,4,4,3,4,OTC
4642,12-02-2021 20:00,24 hrs.,wallstreetbets,ABQQ,7,7,0,7,1,1,1,1,OTC
4642,12-02-2021 20:00,24 hrs.,wallstreetbets,ABWN,6,0,6,-6,1,1,0,1,OTC
4642,12-02-2021 20:00,24 hrs.,wallstreetbets,ACRL,6,6,0,6,1,1,0,1,OTC
4642,12-02-2021 20:00,24 hrs.,wallstreetbets,AEGY,6,0,6,-6,1,1,0,1,OTC
4642,12-02-2021 20:00,24 hrs.,wallstreetbets,AHFD,7,0,7,-7,1,1,1,1,OTC
4642,12-02-2021 20:00,24 hrs.,wallstreetbets,AITX,26,0,26,-26,4,4,2,4,OTC
4642,12-02-2021 20:00,24 hrs.,wallstreetbets,ALPP,20,14,6,8,3,3,2,3,OTC
4642,12-02-2021 20:00,24 hrs.,wallstreetbets,ALYI,14,7,7,0,2,2,2,2,OTC
4642,12-02-2021 20:00,24 hrs.,wallstreetbets,AMNE,13,13,0,13,2,2,1,1,OTC
4642,12-02-2021 20:00,24 hrs.,wallstreetbets,ANTI,13,0,13,-13,2,2,1,2,OTC
4642,12-02-2021 20:00,24 hrs.,wallstreetbets,APCX,7,7,0,7,1,1,1,1,OTC
4642,12-02-2021 20:00,24 hrs.,wallstreetbets,ASTI,24,0,24,-24,4,4,0,2,OTC
4642,12-02-2021 20:00,24 hrs.,wallstreetbets,BANT,6,6,0,6,1,1,0,1,OTC
4642,12-02-2021 20:00,24 hrs.,wallstreetbets,BBRW,6,0,6,-6,1,1,0,1,OTC
4642,12-02-2021 20:00,24 hrs.,wallstreetbets,BCCI,14,0,14,-14,2,2,2,1,OTC
4642,12-02-2021 20:00,24 hrs.,wallstreetbets,BFCH,13,0,13,-13,2,2,1,2,OTC
4642,12-02-2021 20:00,24 hrs.,wallstreetbets,BIEL,37,12,25,-13,6,6,1,5,OTC
4642,12-02-2021 20:00,24 hrs.,wallstreetbets,BIGG,6,0,6,-6,1,1,0,1,OTC
4642,12-02-2021 20:00,24 hrs.,wallstreetbets,BLPG,7,0,7,-7,1,1,1,1,OTC
4642,12-02-2021 20:00,24 hrs.,wallstreetbets,BLSP,21,21,0,21,3,3,3,1,OTC
4642,12-02-2021 20:00,24 hrs.,wallstreetbets,BMIX,11,11,0,11,1,1,5,1,OTC
4642,12-02-2021 20:00,24 hrs.,wallstreetbets,BOTH,7,7,0,7,1,1,1,1,OTC
4642,12-02-2021 20:00,24 hrs.,wallstreetbets,BOTY,19,6,13,-7,3,3,1,3,OTC
4642,12-02-2021 20:00,24 hrs.,wallstreetbets,BRLL,13,7,6,1,2,2,1,2,OTC
4642,12-02-2021 20:00,24 hrs.,wallstreetbets,BTCS,21,21,0,21,3,3,3,1,OTC
4642,12-02-2021 20:00,24 hrs.,wallstreetbets,BTSC,7,7,0,7,1,1,1,1,OTC
4642,12-02-2021 20:00,24 hrs.,wallstreetbets,BTZI,13,13,0,13,2,2,1,2,OTC
4642,12-02-2021 20:00,24 hrs.,wallstreetbets,BUDZ,6,6,0,6,1,1,0,1,OTC
4642,12-02-2021 20:00,24 hrs.,wallstreetbets,CALI,6,0,6,-6,1,1,0,1,OTC
4642,12-02-2021 20:00,24 hrs.,wallstreetbets,CATV,6,0,6,-6,1,1,0,1,OTC
4642,12-02-2021 20:00,24 hrs.,wallstreetbets,CBDD,7,7,0,7,1,1,1,1,OTC
4642,12-02-2021 20:00,24 hrs.,wallstreetbets,CBDL,60,41,19,22,9,9,6,7,OTC
4642,12-02-2021 20:00,24 hrs.,wallstreetbets,CCTC,7,7,0,7,1,1,1,1,OTC
4642,12-02-2021 20:00,24 hrs.,wallstreetbets,CCTL,6,0,6,-6,1,1,0,1,OTC
4642,12-02-2021 20:00,24 hrs.,wallstreetbets,CGEI,7,0,7,-7,1,1,1,1,OTC
4642,12-02-2021 20:00,24 hrs.,wallstreetbets,CGLD,7,7,0,7,1,1,1,1,OTC
4642,12-02-2021 20:00,24 hrs.,wallstreetbets,CHUC,7,7,0,7,1,1,1,1,OTC
4642,12-02-2021 20:00,24 hrs.,wallstreetbets,CLSH,7,0,7,-7,1,1,1,1,OTC
4642,12-02-2021 20:00,24 hrs.,wallstreetbets,CLWD,7,7,0,7,1,1,1,1,OTC
4642,12-02-2021 20:00,24 hrs.,wallstreetbets,COMS,6,6,0,6,1,1,0,1,OTC
4642,12-02-2021 20:00,24 hrs.,wallstreetbets,CYDY,14,7,7,0,2,2,2,2,OTC
4642,12-02-2021 20:00,24 hrs.,wallstreetbets,CYLC,7,7,0,7,1,1,1,1,OTC
4642,12-02-2021 20:00,24 hrs.,pennystocks,SEAC,12,12,0,12,1,2,4,1,NASDAQ
4642,12-02-2021 20:00,24 hrs.,pennystocks,SEEL,214,0,214,-214,1,88,34,1,NASDAQ
4642,12-02-2021 20:00,24 hrs.,pennystocks,SELB,13,13,0,13,1,3,3,1,NASDAQ
4642,12-02-2021 20:00,24 hrs.,pennystocks,SFET,6,6,0,6,1,1,0,1,NASDAQ
4642,12-02-2021 20:00,24 hrs.,wallstreetbets,HIPH,14,7,7,0,2,2,2,2,OTC
4642,12-02-2021 20:00,24 hrs.,wallstreetbets,HMNY,61,28,33,-5,9,9,7,6,OTC
4642,12-02-2021 20:00,24 hrs.,wallstreetbets,HMPQ,13,7,6,1,2,2,1,2,OTC
4642,12-02-2021 20:00,24 hrs.,wallstreetbets,HQGE,28,28,0,28,4,4,4,2,OTC
4642,12-02-2021 20:00,24 hrs.,wallstreetbets,HRBR,6,6,0,6,1,1,0,1,OTC
4642,12-02-2021 20:00,24 hrs.,wallstreetbets,HYSR,13,7,6,1,2,2,1,2,OTC
4642,12-02-2021 20:00,24 hrs.,wallstreetbets,ICBU,7,7,0,7,1,1,1,1,OTC
4642,12-02-2021 20:00,24 hrs.,wallstreetbets,INCT,27,21,6,15,4,4,3,3,OTC
4642,12-02-2021 20:00,24 hrs.,wallstreetbets,INKW,7,7,0,7,1,1,1,1,OTC
4642,12-02-2021 20:00,24 hrs.,wallstreetbets,INND,27,14,13,1,4,4,3,3,OTC
4642,12-02-2021 20:00,24 hrs.,wallstreetbets,INTV,21,21,0,21,3,3,3,2,OTC
4642,12-02-2021 20:00,24 hrs.,wallstreetbets,IPIX,8,8,0,8,1,2,0,1,OTC
4642,12-02-2021 20:00,24 hrs.,wallstreetbets,IQST,25,13,12,1,4,4,1,3,OTC
4642,12-02-2021 20:00,24 hrs.,wallstreetbets,ITCJ,6,6,0,6,1,1,0,1,OTC
4642,12-02-2021 20:00,24 hrs.,wallstreetbets,KALY,7,7,0,7,1,1,1,1,OTC
4642,12-02-2021 20:00,24 hrs.,wallstreetbets,KGKG,7,0,7,-7,1,1,1,1,OTC
4642,12-02-2021 20:00,24 hrs.,wallstreetbets,KRFG,7,0,7,-7,1,1,1,1,OTC
4642,12-02-2021 20:00,24 hrs.,wallstreetbets,KWBT,7,7,0,7,1,1,1,1,OTC
4642,12-02-2021 20:00,24 hrs.,wallstreetbets,KYNC,14,7,7,0,2,2,2,2,OTC
4642,12-02-2021 20:00,24 hrs.,wallstreetbets,LBCC,7,7,0,7,1,1,1,1,OTC
4642,12-02-2021 20:00,24 hrs.,wallstreetbets,LINK,420,420,0,420,4,165,74,4,OTC
4642,12-02-2021 20:00,24 hrs.,wallstreetbets,LITH,7,7,0,7,1,1,1,1,OTC
4642,12-02-2021 20:00,24 hrs.,wallstreetbets,LOTE,7,0,7,-7,1,1,1,1,OTC
4642,12-02-2021 20:00,24 hrs.,wallstreetbets,LQMT,6,0,6,-6,1,1,0,1,OTC
4642,12-02-2021 20:00,24 hrs.,wallstreetbets,LQWC,6,0,6,-6,1,1,0,1,OTC
4642,12-02-2021 20:00,24 hrs.,wallstreetbets,LSCG,7,0,7,-7,1,1,1,1,OTC
4642,12-02-2021 20:00,24 hrs.,wallstreetbets,LTNC,14,14,0,14,2,2,2,2,OTC
4642,12-02-2021 20:00,24 hrs.,wallstreetbets,LTUM,12,6,6,0,2,2,0,2,OTC
4642,12-02-2021 20:00,24 hrs.,wallstreetbets,MAXD,15,15,0,15,2,2,3,2,OTC
4642,12-02-2021 20:00,24 hrs.,wallstreetbets,MCOA,20,20,0,20,3,3,2,3,OTC
4642,12-02-2021 20:00,24 hrs.,wallstreetbets,MEDH,7,7,0,7,1,1,1,1,OTC
4642,12-02-2021 20:00,24 hrs.,wallstreetbets,MGNT,7,7,0,7,1,1,1,1,OTC
4642,12-02-2021 20:00,24 hrs.,wallstreetbets,MGTI,7,7,0,7,1,1,1,1,OTC
4642,12-02-2021 20:00,24 hrs.,wallstreetbets,MINE,55,35,20,15,8,8,7,5,OTC
4642,12-02-2021 20:00,24 hrs.,wallstreetbets,DGWR,7,7,0,7,1,1,1,1,OTC
4642,12-02-2021 20:00,24 hrs.,wallstreetbets,DIGI,14,0,14,-14,2,2,2,1,OTC
4642,12-02-2021 20:00,24 hrs.,wallstreetbets,DPLS,13,13,0,13,2,2,1,2,OTC
4642,12-02-2021 20:00,24 hrs.,wallstreetbets,DPWW,7,7,0,7,1,1,1,1,OTC
4642,12-02-2021 20:00,24 hrs.,wallstreetbets,DROP,2605,0,2605,-2605,1,861,879,1,OTC
4642,12-02-2021 20:00,24 hrs.,wallstreetbets,DWOG,7,0,7,-7,1,1,1,1,OTC
4642,12-02-2021 20:00,24 hrs.,wallstreetbets,ECEZ,6,0,6,-6,1,1,0,1,OTC
4642,12-02-2021 20:00,24 hrs.,wallstreetbets,ELCR,28,28,0,28,4,4,4,2,OTC
4642,12-02-2021 20:00,24 hrs.,wallstreetbets,ELTP,24,24,0,24,3,3,6,3,OTC
4642,12-02-2021 20:00,24 hrs.,wallstreetbets,ENZN,7,7,0,7,1,1,1,1,OTC
4642,12-02-2021 20:00,24 hrs.,wallstreetbets,ETFM,6,0,6,-6,1,1,0,1,OTC
4642,12-02-2021 20:00,24 hrs.,wallstreetbets,EWKS,6,6,0,6,1,1,0,1,OTC
4642,12-02-2021 20:00,24 hrs.,wallstreetbets,EWLL,6,0,6,-6,1,1,0,1,OTC
4642,12-02-2021 20:00,24 hrs.,RobinHoodPennyStocks,TXMD,382,18,364,-346,7,78,198,6,NASDAQ
4642,12-02-2021 20:00,24 hrs.,RobinHoodPennyStocks,TYME,24,0,24,-24,1,3,14,1,NASDAQ
4642,12-02-2021 20:00,24 hrs.,RobinHoodPennyStocks,UONE,112,0,112,-112,1,41,26,1,NASDAQ
4642,12-02-2021 20:00,24 hrs.,RobinHoodPennyStocks,USEG,112,0,112,-112,1,41,26,1,NASDAQ
4642,12-02-2021 20:00,24 hrs.,RobinHoodPennyStocks,UXIN,112,0,112,-112,1,41,26,1,NASDAQ
4642,12-02-2021 20:00,24 hrs.,RobinHoodPennyStocks,WATT,112,0,112,-112,1,41,26,1,NASDAQ
4642,12-02-2021 20:00,24 hrs.,RobinHoodPennyStocks,WIMI,112,0,112,-112,1,41,26,1,NASDAQ
4642,12-02-2021 20:00,24 hrs.,RobinHoodPennyStocks,WKEY,112,0,112,-112,1,41,26,1,NASDAQ
4642,12-02-2021 20:00,24 hrs.,RobinHoodPennyStocks,WRAP,112,0,112,-112,1,41,26,1,NASDAQ
4642,12-02-2021 20:00,24 hrs.,RobinHoodPennyStocks,XSPA,23,23,0,23,1,9,1,1,NASDAQ
4642,12-02-2021 20:00,24 hrs.,RobinHoodPennyStocks,YGMZ,112,0,112,-112,1,41,26,1,NASDAQ
4642,12-02-2021 20:00,24 hrs.,RobinHoodPennyStocks,ZSAN,675,496,179,317,5,263,129,5,NASDAQ
4642,12-02-2021 20:00,24 hrs.,RobinHoodPennyStocks,UONEK,112,0,112,-112,1,41,26,1,NASDAQ
4642,12-02-2021 20:00,24 hrs.,pennystocks,SXTC,13,0,13,-13,2,2,1,1,NASDAQ
4642,12-02-2021 20:00,24 hrs.,pennystocks,TBLT,6,6,0,6,1,1,0,1,NASDAQ
4642,12-02-2021 20:00,24 hrs.,pennystocks,TLRY,79,7,72,-65,4,28,7,4,NASDAQ
4642,12-02-2021 20:00,24 hrs.,pennystocks,TMDI,6,0,6,-6,1,1,0,1,NASDAQ
4642,12-02-2021 20:00,24 hrs.,wallstreetbets,PDMI,7,0,7,-7,1,1,1,1,OTC
4642,12-02-2021 20:00,24 hrs.,wallstreetbets,PGIE,6,0,6,-6,1,1,0,1,OTC
4642,12-02-2021 20:00,24 hrs.,wallstreetbets,PHBI,14,14,0,14,2,2,2,1,OTC
4642,12-02-2021 20:00,24 hrs.,wallstreetbets,PNPL,13,0,13,-13,2,2,1,1,OTC
4642,12-02-2021 20:00,24 hrs.,wallstreetbets,PPJE,6,0,6,-6,1,1,0,1,OTC
4642,12-02-2021 20:00,24 hrs.,wallstreetbets,PRDL,6,0,6,-6,1,1,0,1,OTC
4642,12-02-2021 20:00,24 hrs.,wallstreetbets,PRED,7,0,7,-7,1,1,1,1,OTC
4642,12-02-2021 20:00,24 hrs.,wallstreetbets,PURA,6,0,6,-6,1,1,0,1,OTC
4642,12-02-2021 20:00,24 hrs.,wallstreetbets,PURE,7,0,7,-7,1,1,1,1,OTC
4642,12-02-2021 20:00,24 hrs.,wallstreetbets,QOIL,6,6,0,6,1,1,0,1,OTC
4642,12-02-2021 20:00,24 hrs.,wallstreetbets,QTMM,6,0,6,-6,1,1,0,1,OTC
4642,12-02-2021 20:00,24 hrs.,wallstreetbets,RBDC,7,7,0,7,1,1,1,1,OTC
4642,12-02-2021 20:00,24 hrs.,wallstreetbets,REGI,12,0,12,-12,2,2,0,2,NASDAQ
4642,12-02-2021 20:00,24 hrs.,wallstreetbets,REGN,21,21,0,21,3,3,3,2,NASDAQ
4642,12-02-2021 20:00,24 hrs.,wallstreetbets,RIDE,88,70,18,52,13,13,10,11,NASDAQ
4642,12-02-2021 20:00,24 hrs.,wallstreetbets,RIOT,2707,2688,19,2669,19,1201,229,14,NASDAQ
4642,12-02-2021 20:00,24 hrs.,wallstreetbets,RKDA,7,7,0,7,1,1,1,1,NASDAQ
4642,12-02-2021 20:00,24 hrs.,wallstreetbets,RMTI,20,0,20,-20,3,3,2,2,NASDAQ
4642,12-02-2021 20:00,24 hrs.,wallstreetbets,ROCK,6,0,6,-6,1,1,0,1,NASDAQ
4642,12-02-2021 20:00,24 hrs.,wallstreetbets,ROKU,6,6,0,6,1,1,0,1,NASDAQ
4642,12-02-2021 20:00,24 hrs.,wallstreetbets,ROOT,14,14,0,14,2,2,2,1,NASDAQ
4642,12-02-2021 20:00,24 hrs.,wallstreetbets,RWLK,21,21,0,21,3,3,3,3,NASDAQ
4642,12-02-2021 20:00,24 hrs.,wallstreetbets,SABR,7,0,7,-7,1,1,1,1,NASDAQ
4642,12-02-2021 20:00,24 hrs.,wallstreetbets,SAGE,6,0,6,-6,1,1,0,1,NASDAQ
4642,12-02-2021 20:00,24 hrs.,wallstreetbets,SAVA,13,7,6,1,2,2,1,2,NASDAQ
4642,12-02-2021 20:00,24 hrs.,wallstreetbets,SAVE,28,7,21,-14,4,4,4,2,NASDAQ
4642,12-02-2021 20:00,24 hrs.,wallstreetbets,SBUX,7,7,0,7,1,1,1,1,NASDAQ
4642,12-02-2021 20:00,24 hrs.,wallstreetbets,SEAC,7,7,0,7,1,1,1,1,NASDAQ
4642,12-02-2021 20:00,24 hrs.,wallstreetbets,SEEL,19,7,12,-5,3,3,1,3,NASDAQ
4642,12-02-2021 20:00,24 hrs.,wallstreetbets,SHIP,131,124,7,117,19,19,17,15,NASDAQ
4642,12-02-2021 20:00,24 hrs.,wallstreetbets,SINT,6,0,6,-6,1,1,0,1,NASDAQ
4642,12-02-2021 20:00,24 hrs.,wallstreetbets,SIRI,7,7,0,7,1,1,1,1,NASDAQ
4642,12-02-2021 20:00,24 hrs.,wallstreetbets,SLRX,7,7,0,7,1,1,1,1,NASDAQ
4642,12-02-2021 20:00,24 hrs.,wallstreetbets,SNCA,6,6,0,6,1,1,0,1,NASDAQ
4642,12-02-2021 20:00,24 hrs.,wallstreetbets,SNDL,8208,1369,6839,-5470,346,2669,1486,262,NASDAQ
4642,12-02-2021 20:00,24 hrs.,wallstreetbets,SNGX,15,8,7,1,2,2,3,2,NASDAQ
4642,12-02-2021 20:00,24 hrs.,wallstreetbets,SOHU,6,0,6,-6,1,1,0,1,NASDAQ
4642,12-02-2021 20:00,24 hrs.,wallstreetbets,SOLO,6,0,6,-6,1,1,0,1,NASDAQ
4642,12-02-2021 20:00,24 hrs.,wallstreetbets,SQQQ,14,7,7,0,2,2,2,2,NASDAQ
4642,12-02-2021 20:00,24 hrs.,wallstreetbets,SRAC,6,6,0,6,1,1,0,1,NASDAQ
4642,12-02-2021 20:00,24 hrs.,wallstreetbets,SRGA,13,7,6,1,2,2,1,2,NASDAQ
4642,12-02-2021 20:00,24 hrs.,wallstreetbets,SRNE,29,7,22,-15,3,6,5,3,NASDAQ
4642,12-02-2021 20:00,24 hrs.,wallstreetbets,SSPK,6,0,6,-6,1,1,0,1,NASDAQ
4642,12-02-2021 20:00,24 hrs.,wallstreetbets,STAF,14,7,7,0,2,2,2,2,NASDAQ
4642,12-02-2021 20:00,24 hrs.,wallstreetbets,FBSE,8,0,8,-8,1,1,2,1,OTC
4642,12-02-2021 20:00,24 hrs.,wallstreetbets,FORW,6,0,6,-6,1,1,0,1,OTC
4642,12-02-2021 20:00,24 hrs.,wallstreetbets,FTEG,7,7,0,7,1,1,1,1,OTC
4642,12-02-2021 20:00,24 hrs.,wallstreetbets,FTPM,7,7,0,7,1,1,1,1,OTC
4642,12-02-2021 20:00,24 hrs.,wallstreetbets,FUTL,6,0,6,-6,1,1,0,1,OTC
4642,12-02-2021 20:00,24 hrs.,wallstreetbets,GARB,7,7,0,7,1,1,1,1,OTC
4642,12-02-2021 20:00,24 hrs.,wallstreetbets,GBLX,6,0,6,-6,1,1,0,1,OTC
4642,12-02-2021 20:00,24 hrs.,wallstreetbets,GBTC,2595,2595,0,2595,3,1185,213,2,OTC
4642,12-02-2021 20:00,24 hrs.,wallstreetbets,GFCI,797,0,797,-797,1,309,175,1,OTC
4642,12-02-2021 20:00,24 hrs.,wallstreetbets,GMEV,14,14,0,14,2,2,2,2,OTC
4642,12-02-2021 20:00,24 hrs.,wallstreetbets,GMSC,14,14,0,14,2,2,2,1,OTC
4642,12-02-2021 20:00,24 hrs.,wallstreetbets,GPFT,27,20,7,13,4,4,3,4,OTC
4642,12-02-2021 20:00,24 hrs.,wallstreetbets,GRNH,6,0,6,-6,1,1,0,1,OTC
4642,12-02-2021 20:00,24 hrs.,wallstreetbets,GTEH,12,0,12,-12,1,3,2,1,OTC
4642,12-02-2021 20:00,24 hrs.,wallstreetbets,GTII,1250,0,1250,-1250,1,446,354,1,OTC
4642,12-02-2021 20:00,24 hrs.,wallstreetbets,GTLL,13,6,7,-1,2,2,1,2,OTC
4642,12-02-2021 20:00,24 hrs.,wallstreetbets,GTXO,14,14,0,14,2,2,2,1,OTC
4642,12-02-2021 20:00,24 hrs.,wallstreetbets,HCMC,399,217,182,35,60,60,39,55,OTC
4642,12-02-2021 20:00,24 hrs.,wallstreetbets,HEMP,26,14,12,2,4,4,2,2,OTC
4642,12-02-2021 20:00,24 hrs.,wallstreetbets,HIHI,7,7,0,7,1,1,1,1,OTC
4642,12-02-2021 20:00,24 hrs.,wallstreetbets,TEAM,12,0,12,-12,2,2,0,1,NASDAQ
4642,12-02-2021 20:00,24 hrs.,wallstreetbets,TELL,33159,13,33146,-33133,4,15843,1457,4,NASDAQ
4642,12-02-2021 20:00,24 hrs.,wallstreetbets,THBR,25,0,25,-25,4,4,1,3,NASDAQ
4642,12-02-2021 20:00,24 hrs.,wallstreetbets,THMO,13,13,0,13,2,2,1,1,NASDAQ
4642,12-02-2021 20:00,24 hrs.,wallstreetbets,TIGR,7,0,7,-7,1,1,1,1,NASDAQ
4642,12-02-2021 20:00,24 hrs.,wallstreetbets,TLRY,80628,350,80278,-79928,118,37653,4850,99,NASDAQ
4642,12-02-2021 20:00,24 hrs.,wallstreetbets,TNXP,138,56,82,-26,21,21,12,14,NASDAQ
4642,12-02-2021 20:00,24 hrs.,wallstreetbets,TOPS,87,80,7,73,12,13,13,9,NASDAQ
4642,12-02-2021 20:00,24 hrs.,wallstreetbets,TOWN,133,133,0,133,1,39,51,1,NASDAQ
4642,12-02-2021 20:00,24 hrs.,wallstreetbets,TRCH,51,14,37,-23,8,8,3,6,NASDAQ
4642,12-02-2021 20:00,24 hrs.,wallstreetbets,TRIT,72,39,33,6,11,11,6,8,NASDAQ
4642,12-02-2021 20:00,24 hrs.,wallstreetbets,TRVG,1650,1650,0,1650,26,562,422,18,NASDAQ
4642,12-02-2021 20:00,24 hrs.,wallstreetbets,TSLA,3903,3539,364,3175,37,1589,577,28,NASDAQ
4642,12-02-2021 20:00,24 hrs.,wallstreetbets,TTCF,14,7,7,0,2,2,2,2,NASDAQ
4642,12-02-2021 20:00,24 hrs.,wallstreetbets,TTWO,7,0,7,-7,1,1,1,1,NASDAQ
4642,12-02-2021 20:00,24 hrs.,wallstreetbets,TURN,20,0,20,-20,3,3,2,2,NASDAQ
4642,12-02-2021 20:00,24 hrs.,wallstreetbets,TXMD,75,43,32,11,11,11,9,9,NASDAQ
4642,12-02-2021 20:00,24 hrs.,wallstreetbets,UNFI,155,155,0,155,1,66,19,1,NASDAQ
4642,12-02-2021 20:00,24 hrs.,wallstreetbets,UPWK,6,0,6,-6,1,1,0,1,NASDAQ
4642,12-02-2021 20:00,24 hrs.,wallstreetbets,VEON,6,6,0,6,1,1,0,1,NASDAQ
4642,12-02-2021 20:00,24 hrs.,wallstreetbets,VERU,7,7,0,7,1,1,1,1,NASDAQ
4642,12-02-2021 20:00,24 hrs.,wallstreetbets,VISL,13,7,6,1,2,2,1,2,NASDAQ
4642,12-02-2021 20:00,24 hrs.,wallstreetbets,VLDR,7,7,0,7,1,1,1,1,NASDAQ
4642,12-02-2021 20:00,24 hrs.,wallstreetbets,VNDA,36,0,36,-36,5,5,6,1,NASDAQ
4642,12-02-2021 20:00,24 hrs.,wallstreetbets,VRSN,401,401,0,401,1,162,73,1,NASDAQ
4642,12-02-2021 20:00,24 hrs.,wallstreetbets,VSAT,14,14,0,14,2,2,2,1,NASDAQ
4642,12-02-2021 20:00,24 hrs.,wallstreetbets,VUZI,9,0,9,-9,1,1,3,1,NASDAQ
4642,12-02-2021 20:00,24 hrs.,wallstreetbets,VXRT,13,7,6,1,2,2,1,2,NASDAQ
4642,12-02-2021 20:00,24 hrs.,wallstreetbets,VYNE,7,0,7,-7,1,1,1,1,NASDAQ
4642,12-02-2021 20:00,24 hrs.,wallstreetbets,WATT,36,0,36,-36,4,5,10,4,NASDAQ
4642,12-02-2021 20:00,24 hrs.,wallstreetbets,WKHS,969,963,6,957,3,404,149,3,NASDAQ
4642,12-02-2021 20:00,24 hrs.,wallstreetbets,WRAP,7,7,0,7,1,1,1,1,NASDAQ
4642,12-02-2021 20:00,24 hrs.,wallstreetbets,WTER,7,0,7,-7,1,1,1,1,NASDAQ
4642,12-02-2021 20:00,24 hrs.,wallstreetbets,XENE,14,14,0,14,2,2,2,1,NASDAQ
4642,12-02-2021 20:00,24 hrs.,wallstreetbets,XERS,15,15,0,15,2,2,3,2,NASDAQ
4642,12-02-2021 20:00,24 hrs.,wallstreetbets,XNET,14,14,0,14,2,2,2,1,NASDAQ
4642,12-02-2021 20:00,24 hrs.,wallstreetbets,XSPA,72,34,38,-4,11,11,6,10,NASDAQ
4642,12-02-2021 20:00,24 hrs.,wallstreetbets,YNDX,490,0,490,-490,1,184,118,1,NASDAQ
4642,12-02-2021 20:00,24 hrs.,wallstreetbets,ZNGA,25,0,25,-25,4,4,1,3,NASDAQ
4642,12-02-2021 20:00,24 hrs.,wallstreetbets,ZSAN,6,0,6,-6,1,1,0,1,NASDAQ
4642,12-02-2021 20:00,24 hrs.,wallstreetbets,ZYNE,7,7,0,7,1,1,1,1,NASDAQ
4642,12-02-2021 20:00,24 hrs.,wallstreetbets,CMCSA,7,7,0,7,1,1,1,1,NASDAQ
4642,12-02-2021 20:00,24 hrs.,wallstreetbets,GOOGL,6,6,0,6,1,1,0,1,NASDAQ
4642,12-02-2021 20:00,24 hrs.,wallstreetbets,SRACU,6,6,0,6,1,1,0,1,NASDAQ
4642,12-02-2021 20:00,24 hrs.,wallstreetbets,MJNA,48,27,21,6,7,7,6,7,OTC
4642,12-02-2021 20:00,24 hrs.,wallstreetbets,MKTY,14,14,0,14,2,2,2,1,OTC
4642,12-02-2021 20:00,24 hrs.,wallstreetbets,MMEX,35,0,35,-35,5,5,5,3,OTC
4642,12-02-2021 20:00,24 hrs.,wallstreetbets,MOJO,7,7,0,7,1,1,1,1,OTC
4642,12-02-2021 20:00,24 hrs.,wallstreetbets,MOST,20,20,0,20,3,3,2,3,OTC
4642,12-02-2021 20:00,24 hrs.,wallstreetbets,MRMD,6,0,6,-6,1,1,0,1,OTC
4642,12-02-2021 20:00,24 hrs.,wallstreetbets,MTVX,15,0,15,-15,2,3,1,2,OTC
4642,12-02-2021 20:00,24 hrs.,wallstreetbets,NBVG,6,6,0,6,1,1,0,1,OTC
4642,12-02-2021 20:00,24 hrs.,wallstreetbets,NEOM,14,14,0,14,2,2,2,1,OTC
4642,12-02-2021 20:00,24 hrs.,wallstreetbets,NOVC,34,34,0,34,5,5,4,3,OTC
4642,12-02-2021 20:00,24 hrs.,wallstreetbets,NPHC,7,7,0,7,1,1,1,1,OTC
4642,12-02-2021 20:00,24 hrs.,wallstreetbets,NPTX,14,0,14,-14,2,2,2,1,OTC
4642,12-02-2021 20:00,24 hrs.,wallstreetbets,NWPN,6,6,0,6,1,1,0,1,OTC
4642,12-02-2021 20:00,24 hrs.,wallstreetbets,ONPH,6,6,0,6,1,1,0,1,OTC
4642,12-02-2021 20:00,24 hrs.,wallstreetbets,OTTV,14,14,0,14,2,2,2,1,OTC
4642,12-02-2021 20:00,24 hrs.,wallstreetbets,OWPC,6,6,0,6,1,1,0,1,OTC
4642,12-02-2021 20:00,24 hrs.,wallstreetbets,OZSC,13,7,6,1,2,2,1,2,OTC
4642,12-02-2021 20:00,24 hrs.,wallstreetbets,PAOG,13,7,6,1,2,2,1,2,OTC
4642,12-02-2021 20:00,24 hrs.,wallstreetbets,PAPA,6,0,6,-6,1,1,0,1,OTC
4642,12-02-2021 20:00,24 hrs.,wallstreetbets,PASO,6,0,6,-6,1,1,0,1,OTC
4642,12-02-2021 20:00,24 hrs.,wallstreetbets,MEDIF,6,0,6,-6,1,1,0,1,OTC
4642,12-02-2021 20:00,24 hrs.,wallstreetbets,MMEDF,2577,2571,6,2565,6,1073,407,5,OTC
4642,12-02-2021 20:00,24 hrs.,wallstreetbets,MMNFF,13,0,13,-13,2,2,1,2,OTC
4642,12-02-2021 20:00,24 hrs.,wallstreetbets,MNKKQ,14,0,14,-14,2,2,2,1,OTC
4642,12-02-2021 20:00,24 hrs.,wallstreetbets,NMGRF,6,0,6,-6,1,1,0,1,OTC
4642,12-02-2021 20:00,24 hrs.,wallstreetbets,NTDOY,15,15,0,15,2,2,3,2,OTC
4642,12-02-2021 20:00,24 hrs.,wallstreetbets,NTSFF,6,0,6,-6,1,1,0,1,OTC
4642,12-02-2021 20:00,24 hrs.,wallstreetbets,NXGWF,20,13,7,6,3,3,2,2,OTC
4642,12-02-2021 20:00,24 hrs.,wallstreetbets,NXTTF,14,14,0,14,2,2,2,1,OTC
4642,12-02-2021 20:00,24 hrs.,wallstreetbets,PDYPF,7,7,0,7,1,1,1,1,OTC
4642,12-02-2021 20:00,24 hrs.,wallstreetbets,PFFOF,6,0,6,-6,1,1,0,1,OTC
4642,12-02-2021 20:00,24 hrs.,wallstreetbets,PMNXF,6,6,0,6,1,1,0,1,OTC
4642,12-02-2021 20:00,24 hrs.,wallstreetbets,RAZFF,14,7,7,0,2,2,2,2,OTC
4642,12-02-2021 20:00,24 hrs.,wallstreetbets,RLLCF,57,57,0,57,8,8,9,8,OTC
4642,12-02-2021 20:00,24 hrs.,wallstreetbets,RYCEY,468,435,33,402,17,119,162,15,OTC
4642,12-02-2021 20:00,24 hrs.,wallstreetbets,SHERF,6,0,6,-6,1,1,0,1,OTC
4642,12-02-2021 20:00,24 hrs.,wallstreetbets,RBNW,13,6,7,-1,2,2,1,2,OTC
4642,12-02-2021 20:00,24 hrs.,wallstreetbets,REFG,7,7,0,7,1,1,1,1,OTC
4642,12-02-2021 20:00,24 hrs.,wallstreetbets,RELI,6,6,0,6,1,1,0,1,OTC
4642,12-02-2021 20:00,24 hrs.,wallstreetbets,RIGH,7,0,7,-7,1,1,1,1,OTC
4642,12-02-2021 20:00,24 hrs.,wallstreetbets,RSHN,7,0,7,-7,1,1,1,1,OTC
4642,12-02-2021 20:00,24 hrs.,wallstreetbets,RSSV,9,9,0,9,1,2,1,1,OTC
4642,12-02-2021 20:00,24 hrs.,wallstreetbets,RTON,20,7,13,-6,3,3,2,3,OTC
4642,12-02-2021 20:00,24 hrs.,wallstreetbets,SFOR,14,0,14,-14,2,2,2,1,OTC
4642,12-02-2021 20:00,24 hrs.,wallstreetbets,SGMD,31,6,25,-19,5,5,1,4,OTC
4642,12-02-2021 20:00,24 hrs.,wallstreetbets,SHMP,27,14,13,1,4,4,3,4,OTC
4642,12-02-2021 20:00,24 hrs.,wallstreetbets,SIGN,27,14,13,1,4,4,3,4,OTC
4642,12-02-2021 20:00,24 hrs.,wallstreetbets,SING,7,0,7,-7,1,1,1,1,OTC
4642,12-02-2021 20:00,24 hrs.,wallstreetbets,SIRR,7,7,0,7,1,1,1,1,OTC
4642,12-02-2021 20:00,24 hrs.,wallstreetbets,SNRY,6,0,6,-6,1,1,0,1,OTC
4642,12-02-2021 20:00,24 hrs.,wallstreetbets,SRMX,45,13,32,-19,7,7,3,7,OTC
4642,12-02-2021 20:00,24 hrs.,wallstreetbets,SUIC,6,6,0,6,1,1,0,1,OTC
4642,12-02-2021 20:00,24 hrs.,wallstreetbets,TCHH,6,6,0,6,1,1,0,1,OTC
4642,12-02-2021 20:00,24 hrs.,wallstreetbets,TGLO,7,7,0,7,1,1,1,1,OTC
4642,12-02-2021 20:00,24 hrs.,wallstreetbets,TRNX,7,0,7,-7,1,1,1,1,OTC
4642,12-02-2021 20:00,24 hrs.,wallstreetbets,TRTC,20,14,6,8,3,3,2,2,OTC
4642,12-02-2021 20:00,24 hrs.,wallstreetbets,TSNP,20,14,6,8,3,3,2,3,OTC
4642,12-02-2021 20:00,24 hrs.,wallstreetbets,UBQU,7,7,0,7,1,1,1,1,OTC
4642,12-02-2021 20:00,24 hrs.,wallstreetbets,UNVC,6,0,6,-6,1,1,0,1,OTC
4642,12-02-2021 20:00,24 hrs.,wallstreetbets,USDC,8,8,0,8,1,1,2,1,OTC
4642,12-02-2021 20:00,24 hrs.,wallstreetbets,USMJ,13,13,0,13,2,2,1,2,OTC
4642,12-02-2021 20:00,24 hrs.,wallstreetbets,UVSE,7,7,0,7,1,1,1,1,OTC
4642,12-02-2021 20:00,24 hrs.,wallstreetbets,VBIO,6,0,6,-6,1,1,0,1,OTC
4642,12-02-2021 20:00,24 hrs.,wallstreetbets,VTLR,7,7,0,7,1,1,1,1,OTC
4642,12-02-2021 20:00,24 hrs.,wallstreetbets,WDDD,7,7,0,7,1,1,1,1,OTC
4642,12-02-2021 20:00,24 hrs.,wallstreetbets,WDLF,7,7,0,7,1,1,1,1,OTC
4642,12-02-2021 20:00,24 hrs.,wallstreetbets,WHEN,19,19,0,19,3,3,1,3,OTC
4642,12-02-2021 20:00,24 hrs.,wallstreetbets,WNDW,6,0,6,-6,1,1,0,1,OTC
4642,12-02-2021 20:00,24 hrs.,wallstreetbets,WSSE,7,7,0,7,1,1,1,1,OTC
4642,12-02-2021 20:00,24 hrs.,wallstreetbets,YRIV,4,4,0,4,1,0,0,1,OTC
4642,12-02-2021 20:00,24 hrs.,wallstreetbets,ZMRK,7,7,0,7,1,1,1,1,OTC
4642,12-02-2021 20:00,24 hrs.,wallstreetbets,ZNOG,13,7,6,1,2,2,1,2,OTC
4642,12-02-2021 20:00,24 hrs.,wallstreetbets,ABEPF,6,0,6,-6,1,1,0,1,OTC
4642,12-02-2021 20:00,24 hrs.,wallstreetbets,AMYZF,23,23,0,23,3,3,5,2,OTC
4642,12-02-2021 20:00,24 hrs.,wallstreetbets,ARBKF,13,6,7,-1,2,2,1,2,OTC
4642,12-02-2021 20:00,24 hrs.,wallstreetbets,ATURF,7,7,0,7,1,1,1,1,OTC
4642,12-02-2021 20:00,24 hrs.,wallstreetbets,AZKLF,18,18,0,18,3,3,0,1,OTC
4642,12-02-2021 20:00,24 hrs.,wallstreetbets,BDRBF,33,14,19,-5,5,5,3,5,OTC
4642,12-02-2021 20:00,24 hrs.,wallstreetbets,STAY,12,6,6,0,2,2,0,2,NASDAQ
4642,12-02-2021 20:00,24 hrs.,wallstreetbets,STEP,15,15,0,15,1,0,11,1,NASDAQ
4642,12-02-2021 20:00,24 hrs.,wallstreetbets,STLD,7,7,0,7,1,1,1,1,NASDAQ
4642,12-02-2021 20:00,24 hrs.,wallstreetbets,SVMK,401,401,0,401,1,162,73,1,NASDAQ
4642,12-02-2021 20:00,24 hrs.,wallstreetbets,SWBI,7,7,0,7,1,1,1,1,NASDAQ
4642,12-02-2021 20:00,24 hrs.,wallstreetbets,SWKS,432,432,0,432,1,109,210,1,NASDAQ
4642,12-02-2021 20:00,24 hrs.,wallstreetbets,DPW,21,14,7,7,3,3,3,3,AMEX
4642,12-02-2021 20:00,24 hrs.,wallstreetbets,FEN,7,0,7,-7,1,1,1,1,AMEX
4642,12-02-2021 20:00,24 hrs.,wallstreetbets,GDP,148,148,0,148,2,39,62,2,AMEX
4642,12-02-2021 20:00,24 hrs.,wallstreetbets,GLU,7,7,0,7,1,1,1,1,AMEX
4642,12-02-2021 20:00,24 hrs.,SPACs,APEX,31,31,0,31,1,4,19,1,OTC
4642,12-02-2021 20:00,24 hrs.,SPACs,CAGR,113,0,113,-113,1,22,65,1,OTC
4642,12-02-2021 20:00,24 hrs.,SPACs,CIK,43,43,0,43,1,11,17,1,AMEX
4642,12-02-2021 20:00,24 hrs.,SPACs,CTO,129,0,129,-129,1,44,37,1,AMEX
4642,12-02-2021 20:00,24 hrs.,SPACs,NBA,249,249,0,249,1,69,107,1,AMEX
4642,12-02-2021 20:00,24 hrs.,SPACs,PTK,249,249,0,249,1,69,107,1,AMEX
4642,12-02-2021 20:00,24 hrs.,SPACs,CHAQ,249,249,0,249,1,69,107,1,AMEX
4642,12-02-2021 20:00,24 hrs.,SPACs,AIR,42,42,0,42,1,13,12,1,NYSE
4642,12-02-2021 20:00,24 hrs.,SPACs,BSN,2125,249,1876,-1627,2,116,1885,2,NYSE
4642,12-02-2021 20:00,24 hrs.,SPACs,CCX,256,249,7,242,2,70,108,2,NYSE
4642,12-02-2021 20:00,24 hrs.,SPACs,COO,32,32,0,32,1,5,18,1,NYSE
4642,12-02-2021 20:00,24 hrs.,SPACs,DEH,249,249,0,249,1,69,107,1,NYSE
4642,12-02-2021 20:00,24 hrs.,SPACs,DFS,42,42,0,42,1,13,12,1,NYSE
4642,12-02-2021 20:00,24 hrs.,SPACs,EQD,249,249,0,249,1,69,107,1,NYSE
4642,12-02-2021 20:00,24 hrs.,SPACs,FSR,6,6,0,6,1,1,0,1,NYSE
4642,12-02-2021 20:00,24 hrs.,SPACs,GIK,30,30,0,30,4,2,10,2,NYSE
4642,12-02-2021 20:00,24 hrs.,SPACs,GIX,249,249,0,249,1,69,107,1,NYSE
4642,12-02-2021 20:00,24 hrs.,SPACs,HPX,249,249,0,249,1,69,107,1,NYSE
4642,12-02-2021 20:00,24 hrs.,SPACs,ICE,33,33,0,33,1,10,9,1,NYSE
4642,12-02-2021 20:00,24 hrs.,SPACs,IRR,43,43,0,43,1,13,13,1,NYSE
4642,12-02-2021 20:00,24 hrs.,SPACs,NAV,566,174,392,-218,8,205,124,7,NYSE
4642,12-02-2021 20:00,24 hrs.,SPACs,NGA,67,67,0,67,4,12,27,3,NYSE
4642,12-02-2021 20:00,24 hrs.,SPACs,NSH,249,249,0,249,1,69,107,1,NYSE
4642,12-02-2021 20:00,24 hrs.,SPACs,RSI,132,7,125,-118,2,39,46,2,NYSE
4642,12-02-2021 20:00,24 hrs.,SPACs,RTP,2752,333,2419,-2086,14,331,2034,12,NYSE
4642,12-02-2021 20:00,24 hrs.,SPACs,SBE,83,6,77,-71,6,19,21,4,NYSE
4642,12-02-2021 20:00,24 hrs.,SPACs,SBG,249,249,0,249,1,69,107,1,NYSE
4642,12-02-2021 20:00,24 hrs.,SPACs,TDA,7,7,0,7,1,1,1,1,NYSE
4642,12-02-2021 20:00,24 hrs.,SPACs,WPF,255,249,6,243,2,70,107,2,NYSE
4642,12-02-2021 20:00,24 hrs.,SPACs,YAC,249,249,0,249,1,69,107,1,NYSE
4642,12-02-2021 20:00,24 hrs.,SPACs,ACIC,1876,0,1876,-1876,1,47,1778,1,NYSE
4642,12-02-2021 20:00,24 hrs.,SPACs,ACND,249,249,0,249,1,69,107,1,NYSE
4642,12-02-2021 20:00,24 hrs.,wallstreetbets,CBWTF,23,0,23,-23,3,2,7,3,OTC
4642,12-02-2021 20:00,24 hrs.,wallstreetbets,CLXPF,7,7,0,7,1,1,1,1,OTC
4642,12-02-2021 20:00,24 hrs.,wallstreetbets,CRLBF,12,12,0,12,2,2,0,2,OTC
4642,12-02-2021 20:00,24 hrs.,wallstreetbets,DFLYF,33,0,33,-33,3,2,17,2,OTC
4642,12-02-2021 20:00,24 hrs.,wallstreetbets,DIAAF,7,7,0,7,1,1,1,1,OTC
4642,12-02-2021 20:00,24 hrs.,wallstreetbets,EHVVF,6,0,6,-6,1,1,0,1,OTC
4642,12-02-2021 20:00,24 hrs.,wallstreetbets,EPWCF,12,0,12,-12,1,0,8,1,OTC
4642,12-02-2021 20:00,24 hrs.,wallstreetbets,FDVRF,6,6,0,6,1,1,0,1,OTC
4642,12-02-2021 20:00,24 hrs.,wallstreetbets,FGPHF,6,0,6,-6,1,1,0,1,OTC
4642,12-02-2021 20:00,24 hrs.,wallstreetbets,FLWPF,7,0,7,-7,1,1,1,1,OTC
4642,12-02-2021 20:00,24 hrs.,wallstreetbets,GAYMF,20,6,14,-8,3,3,2,3,OTC
4642,12-02-2021 20:00,24 hrs.,wallstreetbets,GGTTF,7,7,0,7,1,1,1,1,OTC
4642,12-02-2021 20:00,24 hrs.,wallstreetbets,GPORQ,6,0,6,-6,1,1,0,1,OTC
4642,12-02-2021 20:00,24 hrs.,wallstreetbets,HITIF,7,7,0,7,1,1,1,1,OTC
4642,12-02-2021 20:00,24 hrs.,wallstreetbets,HRSTW,11,11,0,11,2,1,1,1,OTC
4642,12-02-2021 20:00,24 hrs.,wallstreetbets,HUTMF,13,13,0,13,2,2,1,2,OTC
4642,12-02-2021 20:00,24 hrs.,wallstreetbets,HVBTF,22,22,0,22,3,3,4,3,OTC
4642,12-02-2021 20:00,24 hrs.,wallstreetbets,IGCIW,49,49,0,49,7,7,7,2,OTC
4642,12-02-2021 20:00,24 hrs.,wallstreetbets,ISCNF,14,14,0,14,2,2,2,2,OTC
4642,12-02-2021 20:00,24 hrs.,wallstreetbets,ITHUF,7,7,0,7,1,1,1,1,OTC
4642,12-02-2021 20:00,24 hrs.,wallstreetbets,KBEVF,7,7,0,7,1,1,1,1,OTC
4642,12-02-2021 20:00,24 hrs.,wallstreetbets,KPIFF,6,0,6,-6,1,1,0,1,OTC
4642,12-02-2021 20:00,24 hrs.,wallstreetbets,LHSIF,7,7,0,7,1,1,1,1,OTC
4642,12-02-2021 20:00,24 hrs.,wallstreetbets,LKNCY,6,6,0,6,1,1,0,1,OTC
4642,12-02-2021 20:00,24 hrs.,wallstreetbets,LLKKF,6,0,6,-6,1,1,0,1,OTC
4642,12-02-2021 20:00,24 hrs.,wallstreetbets,LMLLF,6,0,6,-6,1,1,0,1,OTC
4642,12-02-2021 20:00,24 hrs.,wallstreetbets,LTMCF,12,0,12,-12,2,2,0,2,OTC
4642,12-02-2021 20:00,24 hrs.,wallstreetbets,LXXGF,8,0,8,-8,1,1,2,1,OTC
4642,12-02-2021 20:00,24 hrs.,wallstreetbets,BTU,14,14,0,14,2,2,2,1,NYSE
4642,12-02-2021 20:00,24 hrs.,wallstreetbets,BUD,8,0,8,-8,1,1,2,1,NYSE
4642,12-02-2021 20:00,24 hrs.,wallstreetbets,CAT,7,7,0,7,1,1,1,1,NYSE
4642,12-02-2021 20:00,24 hrs.,wallstreetbets,CBD,40,7,33,-26,5,7,6,4,NYSE
4642,12-02-2021 20:00,24 hrs.,SPACs,ALUS,1906,30,1876,-1846,2,53,1792,2,NYSE
4642,12-02-2021 20:00,24 hrs.,SPACs,AONE,249,249,0,249,1,69,107,1,NYSE
4642,12-02-2021 20:00,24 hrs.,SPACs,APSG,249,249,0,249,1,69,107,1,NYSE
4642,12-02-2021 20:00,24 hrs.,SPACs,ASAQ,249,249,0,249,1,69,107,1,NYSE
4642,12-02-2021 20:00,24 hrs.,SPACs,ASPL,255,249,6,243,2,70,107,2,NYSE
4642,12-02-2021 20:00,24 hrs.,SPACs,ATAC,249,249,0,249,1,69,107,1,NYSE
4642,12-02-2021 20:00,24 hrs.,SPACs,AVAN,249,249,0,249,1,69,107,1,NYSE
4642,12-02-2021 20:00,24 hrs.,SPACs,BOAC,302,302,0,302,2,83,128,2,NYSE
4642,12-02-2021 20:00,24 hrs.,SPACs,CCIV,4153,597,3556,-2959,17,878,2329,16,NYSE
4642,12-02-2021 20:00,24 hrs.,SPACs,CLII,47,0,47,-47,3,12,11,3,NYSE
4642,12-02-2021 20:00,24 hrs.,SPACs,CPSR,249,249,0,249,1,69,107,1,NYSE
4642,12-02-2021 20:00,24 hrs.,SPACs,CTAC,249,249,0,249,1,69,107,1,NYSE
4642,12-02-2021 20:00,24 hrs.,SPACs,DFNS,290,290,0,290,2,86,110,2,NYSE
4642,12-02-2021 20:00,24 hrs.,SPACs,DGNR,312,312,0,312,1,133,42,1,NYSE
4642,12-02-2021 20:00,24 hrs.,SPACs,DMYD,402,402,0,402,2,146,102,2,NYSE
4642,12-02-2021 20:00,24 hrs.,SPACs,EMPW,2125,249,1876,-1627,2,116,1885,2,NYSE
4642,12-02-2021 20:00,24 hrs.,SPACs,FUSE,3654,1624,2030,-406,16,670,2250,13,NYSE
4642,12-02-2021 20:00,24 hrs.,SPACs,GLEO,249,249,0,249,1,69,107,1,NYSE
4642,12-02-2021 20:00,24 hrs.,SPACs,GOAC,249,249,0,249,1,69,107,1,NYSE
4642,12-02-2021 20:00,24 hrs.,SPACs,GSAH,402,402,0,402,2,146,102,2,NYSE
4642,12-02-2021 20:00,24 hrs.,SPACs,HIGA,249,249,0,249,1,69,107,1,NYSE
4642,12-02-2021 20:00,24 hrs.,SPACs,HZAC,249,249,0,249,1,69,107,1,NYSE
4642,12-02-2021 20:00,24 hrs.,SPACs,HZON,249,249,0,249,1,69,107,1,NYSE
4642,12-02-2021 20:00,24 hrs.,SPACs,IMPX,249,249,0,249,1,69,107,1,NYSE
4642,12-02-2021 20:00,24 hrs.,SPACs,IPOE,6,0,6,-6,1,1,0,1,NYSE
4642,12-02-2021 20:00,24 hrs.,SPACs,LGVW,398,312,86,226,4,157,68,3,NYSE
4642,12-02-2021 20:00,24 hrs.,SPACs,OACB,249,249,0,249,1,69,107,1,NYSE
4642,12-02-2021 20:00,24 hrs.,SPACs,PANA,249,249,0,249,1,69,107,1,NYSE
4642,12-02-2021 20:00,24 hrs.,SPACs,PCPL,249,249,0,249,1,69,107,1,NYSE
4642,12-02-2021 20:00,24 hrs.,SPACs,PIAI,249,249,0,249,1,69,107,1,NYSE
4642,12-02-2021 20:00,24 hrs.,SPACs,PRPB,249,249,0,249,1,69,107,1,NYSE
4642,12-02-2021 20:00,24 hrs.,SPACs,RBAC,249,249,0,249,1,69,107,1,NYSE
4642,12-02-2021 20:00,24 hrs.,SPACs,RPLA,249,249,0,249,1,69,107,1,NYSE
4642,12-02-2021 20:00,24 hrs.,SPACs,SCPE,249,249,0,249,1,69,107,1,NYSE
4642,12-02-2021 20:00,24 hrs.,SPACs,SCVX,378,249,129,120,2,113,144,2,NYSE
4642,12-02-2021 20:00,24 hrs.,SPACs,SEAH,249,249,0,249,1,69,107,1,NYSE
4642,12-02-2021 20:00,24 hrs.,SPACs,SFTW,249,249,0,249,1,69,107,1,NYSE
4642,12-02-2021 20:00,24 hrs.,SPACs,SKLZ,125,0,125,-125,1,39,43,1,NYSE
4642,12-02-2021 20:00,24 hrs.,SPACs,SNPR,1925,36,1889,-1853,7,54,1789,6,NYSE
4642,12-02-2021 20:00,24 hrs.,SPACs,SPCE,7,0,7,-7,1,1,1,1,NYSE
4642,12-02-2021 20:00,24 hrs.,SPACs,TWND,1916,33,1883,-1850,3,53,1798,3,NYSE
4642,12-02-2021 20:00,24 hrs.,SPACs,VGAC,1876,0,1876,-1876,1,47,1778,1,NYSE
4642,12-02-2021 20:00,24 hrs.,SPACs,VTOL,42,42,0,42,1,13,12,1,NYSE
4642,12-02-2021 20:00,24 hrs.,SPACs,VYGG,6,6,0,6,1,0,2,1,NYSE
4642,12-02-2021 20:00,24 hrs.,wallstreetbets,SPRWF,90,28,62,-34,13,15,8,10,OTC
4642,12-02-2021 20:00,24 hrs.,wallstreetbets,TAKOF,249,0,249,-249,1,96,53,1,OTC
4642,12-02-2021 20:00,24 hrs.,wallstreetbets,TCNNF,2609,2609,0,2609,5,1187,215,1,OTC
4642,12-02-2021 20:00,24 hrs.,wallstreetbets,TGODF,7,7,0,7,1,1,1,1,OTC
4642,12-02-2021 20:00,24 hrs.,wallstreetbets,TLOFF,7,0,7,-7,1,1,1,1,OTC
4642,12-02-2021 20:00,24 hrs.,wallstreetbets,TPPRF,14,14,0,14,2,2,2,1,OTC
4642,12-02-2021 20:00,24 hrs.,wallstreetbets,TSCRF,56,49,7,42,4,6,28,3,OTC
4642,12-02-2021 20:00,24 hrs.,wallstreetbets,TXLZF,7,7,0,7,1,1,1,1,OTC
4642,12-02-2021 20:00,24 hrs.,wallstreetbets,VALPQ,7,0,7,-7,1,1,1,1,OTC
4642,12-02-2021 20:00,24 hrs.,wallstreetbets,VVCIF,7,0,7,-7,1,1,1,1,OTC
4642,12-02-2021 20:00,24 hrs.,wallstreetbets,WDDMF,7,7,0,7,1,1,1,1,OTC
4642,12-02-2021 20:00,24 hrs.,wallstreetbets,WPMLF,8,0,8,-8,1,1,2,1,OTC
4642,12-02-2021 20:00,24 hrs.,wallstreetbets,AAU,14,14,0,14,2,2,2,2,AMEX
4642,12-02-2021 20:00,24 hrs.,wallstreetbets,BTN,15,15,0,15,2,2,3,1,AMEX
4642,12-02-2021 20:00,24 hrs.,wallstreetbets,DIT,6,6,0,6,1,1,0,1,AMEX
4642,12-02-2021 20:00,24 hrs.,wallstreetbets,DNN,222,117,105,12,33,34,22,28,AMEX
4642,12-02-2021 20:00,24 hrs.,SPACs,CELH,113,0,113,-113,1,22,65,1,NASDAQ
4642,12-02-2021 20:00,24 hrs.,SPACs,CFII,249,249,0,249,1,69,107,1,NASDAQ
4642,12-02-2021 20:00,24 hrs.,SPACs,CHPM,249,249,0,249,1,69,107,1,NASDAQ
4642,12-02-2021 20:00,24 hrs.,wallstreetbets,CHS,8,0,8,-8,1,1,2,1,NYSE
4642,12-02-2021 20:00,24 hrs.,wallstreetbets,GPL,6,0,6,-6,1,1,0,1,AMEX
4642,12-02-2021 20:00,24 hrs.,wallstreetbets,GSV,21,0,21,-21,3,3,3,3,AMEX
4642,12-02-2021 20:00,24 hrs.,wallstreetbets,GTE,66,20,46,-26,10,10,6,10,AMEX
4642,12-02-2021 20:00,24 hrs.,wallstreetbets,IGC,7,0,7,-7,1,1,1,1,AMEX
4642,12-02-2021 20:00,24 hrs.,wallstreetbets,ISR,6,0,6,-6,1,1,0,1,AMEX
4642,12-02-2021 20:00,24 hrs.,wallstreetbets,ITP,13,7,6,1,2,2,1,2,AMEX
4642,12-02-2021 20:00,24 hrs.,wallstreetbets,LSF,7,0,7,-7,1,1,1,1,AMEX
4642,12-02-2021 20:00,24 hrs.,wallstreetbets,MSN,7,7,0,7,1,1,1,1,AMEX
4642,12-02-2021 20:00,24 hrs.,wallstreetbets,MXC,21,14,7,7,3,3,3,3,AMEX
4642,12-02-2021 20:00,24 hrs.,wallstreetbets,MYO,7,7,0,7,1,1,1,1,AMEX
4642,12-02-2021 20:00,24 hrs.,wallstreetbets,NAK,116,44,72,-28,18,18,8,15,AMEX
4642,12-02-2021 20:00,24 hrs.,wallstreetbets,NGD,15,0,15,-15,2,2,3,1,AMEX
4642,12-02-2021 20:00,24 hrs.,wallstreetbets,PTN,7,7,0,7,1,1,1,1,AMEX
4642,12-02-2021 20:00,24 hrs.,wallstreetbets,REI,7,7,0,7,1,1,1,1,AMEX
4642,12-02-2021 20:00,24 hrs.,wallstreetbets,SYN,14,14,0,14,2,2,2,1,AMEX
4642,12-02-2021 20:00,24 hrs.,wallstreetbets,TGB,6,6,0,6,1,1,0,1,AMEX
4642,12-02-2021 20:00,24 hrs.,wallstreetbets,TMQ,8,0,8,-8,1,1,2,1,AMEX
4642,12-02-2021 20:00,24 hrs.,wallstreetbets,TRX,112,55,57,-2,17,17,10,11,AMEX
4642,12-02-2021 20:00,24 hrs.,wallstreetbets,URG,7,0,7,-7,1,1,1,1,AMEX
4642,12-02-2021 20:00,24 hrs.,wallstreetbets,UUU,6,6,0,6,1,1,0,1,AMEX
4642,12-02-2021 20:00,24 hrs.,wallstreetbets,ZOM,212,94,118,-24,32,32,20,29,AMEX
4642,12-02-2021 20:00,24 hrs.,wallstreetbets,AMPE,27,27,0,27,4,4,3,3,AMEX
4642,12-02-2021 20:00,24 hrs.,wallstreetbets,CRMD,7,7,0,7,1,1,1,1,AMEX
4642,12-02-2021 20:00,24 hrs.,wallstreetbets,EMAN,14,7,7,0,2,2,2,2,AMEX
4642,12-02-2021 20:00,24 hrs.,wallstreetbets,GSAT,122,14,108,-94,19,19,8,9,AMEX
4642,12-02-2021 20:00,24 hrs.,wallstreetbets,HUSA,7,7,0,7,1,1,1,1,AMEX
4642,12-02-2021 20:00,24 hrs.,wallstreetbets,IBIO,18,0,18,-18,3,3,0,1,AMEX
4642,12-02-2021 20:00,24 hrs.,wallstreetbets,LODE,13,13,0,13,2,2,1,2,AMEX
4642,12-02-2021 20:00,24 hrs.,wallstreetbets,NSPR,7,0,7,-7,1,1,1,1,AMEX
4642,12-02-2021 20:00,24 hrs.,wallstreetbets,OGEN,21,14,7,7,3,3,3,3,AMEX
4642,12-02-2021 20:00,24 hrs.,wallstreetbets,RLGT,21,0,21,-21,3,3,3,1,AMEX
4642,12-02-2021 20:00,24 hrs.,wallstreetbets,SENS,240,209,31,178,18,52,64,16,AMEX
4642,12-02-2021 20:00,24 hrs.,wallstreetbets,TMBR,20,14,6,8,3,3,2,3,AMEX
4642,12-02-2021 20:00,24 hrs.,wallstreetbets,TRXC,40,19,21,-2,6,6,4,5,AMEX
4642,12-02-2021 20:00,24 hrs.,wallstreetbets,UAVS,34,21,13,8,5,5,4,4,AMEX
4642,12-02-2021 20:00,24 hrs.,wallstreetbets,UUUU,21,7,14,-7,3,3,3,2,AMEX
4642,12-02-2021 20:00,24 hrs.,wallstreetbets,YCBD,14,7,7,0,2,2,2,2,AMEX
4642,12-02-2021 20:00,24 hrs.,wallstreetbets,ABT,13,13,0,13,2,2,1,2,NYSE
4642,12-02-2021 20:00,24 hrs.,wallstreetbets,ACB,152,103,49,54,23,23,14,20,NYSE
4642,12-02-2021 20:00,24 hrs.,wallstreetbets,ACI,7,7,0,7,1,1,1,1,NYSE
4642,12-02-2021 20:00,24 hrs.,wallstreetbets,ADX,12,0,12,-12,2,2,0,1,NYSE
4642,12-02-2021 20:00,24 hrs.,wallstreetbets,AEM,8,8,0,8,1,1,2,1,NYSE
4642,12-02-2021 20:00,24 hrs.,wallstreetbets,AHT,14,0,14,-14,2,2,2,2,NYSE
4642,12-02-2021 20:00,24 hrs.,wallstreetbets,AIR,13,6,7,-1,2,2,1,2,NYSE
4642,12-02-2021 20:00,24 hrs.,wallstreetbets,AIV,6,6,0,6,1,1,0,1,NYSE
4642,12-02-2021 20:00,24 hrs.,wallstreetbets,AMC,10321,4894,5427,-533,252,3987,1339,205,NYSE
4642,12-02-2021 20:00,24 hrs.,wallstreetbets,AMP,48,21,27,-6,7,7,6,7,NYSE
4642,12-02-2021 20:00,24 hrs.,wallstreetbets,ASX,21,7,14,-7,3,3,3,3,NYSE
4642,12-02-2021 20:00,24 hrs.,wallstreetbets,ATH,89,23,66,-43,4,25,23,4,NYSE
4642,12-02-2021 20:00,24 hrs.,wallstreetbets,AUY,103,103,0,103,8,16,39,4,NYSE
4642,12-02-2021 20:00,24 hrs.,wallstreetbets,AXP,2588,2588,0,2588,2,1184,212,1,NYSE
4642,12-02-2021 20:00,24 hrs.,wallstreetbets,AYX,6,0,6,-6,1,1,0,1,NYSE
4642,12-02-2021 20:00,24 hrs.,wallstreetbets,BBW,19,6,13,-7,3,3,1,3,NYSE
4642,12-02-2021 20:00,24 hrs.,wallstreetbets,BBY,14,0,14,-14,2,2,2,1,NYSE
4642,12-02-2021 20:00,24 hrs.,wallstreetbets,BCH,7,7,0,7,1,1,1,1,NYSE
4642,12-02-2021 20:00,24 hrs.,wallstreetbets,BFT,7,0,7,-7,1,1,1,1,NYSE
4642,12-02-2021 20:00,24 hrs.,wallstreetbets,BGS,14,8,6,2,2,2,2,2,NYSE
4642,12-02-2021 20:00,24 hrs.,wallstreetbets,BHC,429,408,21,387,5,166,77,3,NYSE
4642,12-02-2021 20:00,24 hrs.,wallstreetbets,BIT,7,0,7,-7,1,1,1,1,NYSE
4642,12-02-2021 20:00,24 hrs.,wallstreetbets,BTT,51,12,39,-27,8,8,3,8,NYSE
4642,12-02-2021 20:00,24 hrs.,SPACs,KERN,32,32,0,32,1,5,18,1,NASDAQ
4642,12-02-2021 20:00,24 hrs.,SPACs,KSMT,249,249,0,249,1,69,107,1,NASDAQ
4642,12-02-2021 20:00,24 hrs.,SPACs,LATN,249,249,0,249,1,69,107,1,NASDAQ
4642,12-02-2021 20:00,24 hrs.,SPACs,LCAP,249,249,0,249,1,69,107,1,NASDAQ
4642,12-02-2021 20:00,24 hrs.,SPACs,LFTR,249,249,0,249,1,69,107,1,NASDAQ
4642,12-02-2021 20:00,24 hrs.,SPACs,LIVK,249,249,0,249,1,69,107,1,NASDAQ
4642,12-02-2021 20:00,24 hrs.,SPACs,LUXA,1876,0,1876,-1876,1,47,1778,1,NASDAQ
4642,12-02-2021 20:00,24 hrs.,SPACs,MAAC,249,249,0,249,1,69,107,1,NASDAQ
4642,12-02-2021 20:00,24 hrs.,SPACs,MACU,249,249,0,249,1,69,107,1,NASDAQ
4642,12-02-2021 20:00,24 hrs.,SPACs,MCMJ,249,249,0,249,1,69,107,1,NASDAQ
4642,12-02-2021 20:00,24 hrs.,SPACs,MLAC,249,249,0,249,1,69,107,1,NASDAQ
4642,12-02-2021 20:00,24 hrs.,SPACs,MOTN,249,249,0,249,1,69,107,1,NASDAQ
4642,12-02-2021 20:00,24 hrs.,SPACs,NGAC,461,0,461,-461,2,203,47,2,NASDAQ
4642,12-02-2021 20:00,24 hrs.,SPACs,OTRA,249,249,0,249,1,69,107,1,NASDAQ
4642,12-02-2021 20:00,24 hrs.,SPACs,PAIC,249,249,0,249,1,69,107,1,NASDAQ
4642,12-02-2021 20:00,24 hrs.,SPACs,PLUG,6,6,0,6,1,1,0,1,NASDAQ
4642,12-02-2021 20:00,24 hrs.,SPACs,PRCH,23,23,0,23,1,8,3,1,NASDAQ
4642,12-02-2021 20:00,24 hrs.,SPACs,QELL,510,354,156,198,4,167,160,4,NASDAQ
4642,12-02-2021 20:00,24 hrs.,SPACs,RCHG,249,249,0,249,1,69,107,1,NASDAQ
4642,12-02-2021 20:00,24 hrs.,SPACs,RIDE,6,6,0,6,1,1,0,1,NASDAQ
4642,12-02-2021 20:00,24 hrs.,SPACs,ROCH,1876,0,1876,-1876,1,47,1778,1,NASDAQ
4642,12-02-2021 20:00,24 hrs.,SPACs,SGAM,249,249,0,249,1,69,107,1,NASDAQ
4642,12-02-2021 20:00,24 hrs.,SPACs,SRAC,71,71,0,71,1,24,19,1,NASDAQ
4642,12-02-2021 20:00,24 hrs.,SPACs,STWO,249,249,0,249,1,69,107,1,NASDAQ
4642,12-02-2021 20:00,24 hrs.,SPACs,SVAC,249,249,0,249,1,69,107,1,NASDAQ
4642,12-02-2021 20:00,24 hrs.,SPACs,TEKK,249,249,0,249,1,69,107,1,NASDAQ
4642,12-02-2021 20:00,24 hrs.,SPACs,THBR,1903,27,1876,-1849,2,51,1793,2,NASDAQ
4642,12-02-2021 20:00,24 hrs.,SPACs,THCA,249,249,0,249,1,69,107,1,NASDAQ
4642,12-02-2021 20:00,24 hrs.,SPACs,THCB,6,6,0,6,1,1,0,1,NASDAQ
4642,12-02-2021 20:00,24 hrs.,SPACs,TLRY,14,0,14,-14,1,0,10,1,NASDAQ
4642,12-02-2021 20:00,24 hrs.,SPACs,TMPM,249,249,0,249,1,69,107,1,NASDAQ
4642,12-02-2021 20:00,24 hrs.,SPACs,TMTS,249,249,0,249,1,69,107,1,NASDAQ
4642,12-02-2021 20:00,24 hrs.,SPACs,TTCF,113,0,113,-113,1,22,65,1,NASDAQ
4642,12-02-2021 20:00,24 hrs.,SPACs,TWCT,249,249,0,249,1,69,107,1,NASDAQ
4642,12-02-2021 20:00,24 hrs.,SPACs,VACQ,249,249,0,249,1,69,107,1,NASDAQ
4642,12-02-2021 20:00,24 hrs.,SPACs,VMAC,263,256,7,249,3,71,109,3,NASDAQ
4642,12-02-2021 20:00,24 hrs.,SPACs,VSPR,45,0,45,-45,1,12,17,1,NASDAQ
4642,12-02-2021 20:00,24 hrs.,wallstreetbets,CPG,7,7,0,7,1,1,1,1,NYSE
4642,12-02-2021 20:00,24 hrs.,wallstreetbets,CUB,24,0,24,-24,4,4,0,1,NYSE
4642,12-02-2021 20:00,24 hrs.,SPACs,ADV,2125,249,1876,-1627,2,116,1885,2,NASDAQ
4642,12-02-2021 20:00,24 hrs.,SPACs,CFO,61,61,0,61,2,17,19,2,NASDAQ
4642,12-02-2021 20:00,24 hrs.,SPACs,ESG,111,111,0,111,1,34,39,1,NASDAQ
4642,12-02-2021 20:00,24 hrs.,SPACs,HOL,1883,0,1883,-1883,2,48,1779,2,NASDAQ
4642,12-02-2021 20:00,24 hrs.,SPACs,LCY,249,249,0,249,1,69,107,1,NASDAQ
4642,12-02-2021 20:00,24 hrs.,SPACs,NPA,168,71,97,-26,3,60,36,3,NASDAQ
4642,12-02-2021 20:00,24 hrs.,SPACs,VIH,33,33,0,33,1,10,9,1,NASDAQ
4642,12-02-2021 20:00,24 hrs.,SPACs,ACAC,125,0,125,-125,1,39,43,1,NASDAQ
4642,12-02-2021 20:00,24 hrs.,SPACs,ACEV,216,39,177,-138,6,60,72,4,NASDAQ
4642,12-02-2021 20:00,24 hrs.,SPACs,ADOC,249,249,0,249,1,69,107,1,NASDAQ
4642,12-02-2021 20:00,24 hrs.,SPACs,AGBA,249,249,0,249,1,69,107,1,NASDAQ
4642,12-02-2021 20:00,24 hrs.,SPACs,AHAC,249,249,0,249,1,69,107,1,NASDAQ
4642,12-02-2021 20:00,24 hrs.,SPACs,AMHC,249,249,0,249,1,69,107,1,NASDAQ
4642,12-02-2021 20:00,24 hrs.,SPACs,ANDA,113,0,113,-113,1,22,65,1,NASDAQ
4642,12-02-2021 20:00,24 hrs.,SPACs,BHSE,249,249,0,249,1,69,107,1,NASDAQ
4642,12-02-2021 20:00,24 hrs.,SPACs,BLNK,32,32,0,32,1,5,18,1,NASDAQ
4642,12-02-2021 20:00,24 hrs.,SPACs,BLSA,1876,0,1876,-1876,1,47,1778,1,NASDAQ
4642,12-02-2021 20:00,24 hrs.,SPACs,BOWX,249,249,0,249,1,69,107,1,NASDAQ
4642,12-02-2021 20:00,24 hrs.,SPACs,BREZ,249,249,0,249,1,69,107,1,NASDAQ
4642,12-02-2021 20:00,24 hrs.,SPACs,BRLI,249,249,0,249,1,69,107,1,NASDAQ
4642,12-02-2021 20:00,24 hrs.,SPACs,BRPA,1876,0,1876,-1876,1,47,1778,1,NASDAQ
4642,12-02-2021 20:00,24 hrs.,SPACs,BTAQ,352,352,0,352,3,104,132,3,NASDAQ
4642,12-02-2021 20:00,24 hrs.,SPACs,BTWN,75,9,66,-57,3,13,37,3,NASDAQ
4642,12-02-2021 20:00,24 hrs.,SPACs,BWAC,249,249,0,249,1,69,107,1,NASDAQ
4642,12-02-2021 20:00,24 hrs.,SPACs,CAPA,249,249,0,249,1,69,107,1,NASDAQ
4642,12-02-2021 20:00,24 hrs.,wallstreetbets,FSD,14,14,0,14,2,2,2,2,NYSE
4642,12-02-2021 20:00,24 hrs.,wallstreetbets,FSR,706,216,490,-274,37,206,146,19,NYSE
4642,12-02-2021 20:00,24 hrs.,wallstreetbets,FTI,27,20,7,13,4,4,3,2,NYSE
4642,12-02-2021 20:00,24 hrs.,wallstreetbets,GAM,7,7,0,7,1,1,1,1,NYSE
4642,12-02-2021 20:00,24 hrs.,wallstreetbets,GEO,48,28,20,8,7,7,6,2,NYSE
4642,12-02-2021 20:00,24 hrs.,wallstreetbets,GLW,14,7,7,0,2,2,2,2,NYSE
4642,12-02-2021 20:00,24 hrs.,wallstreetbets,GME,87707,46245,41462,4783,486,38666,8431,382,NYSE
4642,12-02-2021 20:00,24 hrs.,wallstreetbets,HII,12,0,12,-12,2,2,0,1,NYSE
4642,12-02-2021 20:00,24 hrs.,wallstreetbets,HMI,7,7,0,7,1,1,1,1,NYSE
4642,12-02-2021 20:00,24 hrs.,wallstreetbets,HON,6,0,6,-6,1,1,0,1,NYSE
4642,12-02-2021 20:00,24 hrs.,wallstreetbets,IAG,14,14,0,14,2,2,2,2,NYSE
4642,12-02-2021 20:00,24 hrs.,wallstreetbets,IBM,570,570,0,570,5,226,98,5,NYSE
4642,12-02-2021 20:00,24 hrs.,wallstreetbets,IVC,6,0,6,-6,1,1,0,1,NYSE
4642,12-02-2021 20:00,24 hrs.,wallstreetbets,IVR,54,48,6,42,8,7,8,6,NYSE
4642,12-02-2021 20:00,24 hrs.,wallstreetbets,JNJ,13,7,6,1,2,2,1,2,NYSE
4642,12-02-2021 20:00,24 hrs.,wallstreetbets,KGC,6,0,6,-6,1,1,0,1,NYSE
4642,12-02-2021 20:00,24 hrs.,wallstreetbets,KMI,35,35,0,35,2,9,9,1,NYSE
4642,12-02-2021 20:00,24 hrs.,wallstreetbets,KMX,60,0,60,-60,1,18,20,1,NYSE
4642,12-02-2021 20:00,24 hrs.,wallstreetbets,KOS,12,12,0,12,2,2,0,1,NYSE
4642,12-02-2021 20:00,24 hrs.,wallstreetbets,LAC,19,0,19,-19,3,3,1,3,NYSE
4642,12-02-2021 20:00,24 hrs.,wallstreetbets,LEG,6,0,6,-6,1,1,0,1,NYSE
4642,12-02-2021 20:00,24 hrs.,wallstreetbets,LEN,6,0,6,-6,1,1,0,1,NYSE
4642,12-02-2021 20:00,24 hrs.,wallstreetbets,LMT,13,0,13,-13,2,2,1,2,NYSE
4642,12-02-2021 20:00,24 hrs.,wallstreetbets,LOW,28,22,6,16,4,4,4,3,NYSE
4642,12-02-2021 20:00,24 hrs.,wallstreetbets,LTC,7,0,7,-7,1,1,1,1,NYSE
4642,12-02-2021 20:00,24 hrs.,wallstreetbets,MAC,9,9,0,9,1,1,3,1,NYSE
4642,12-02-2021 20:00,24 hrs.,wallstreetbets,MBI,14,14,0,14,2,2,2,2,NYSE
4642,12-02-2021 20:00,24 hrs.,wallstreetbets,MCO,401,401,0,401,1,162,73,1,NYSE
4642,12-02-2021 20:00,24 hrs.,wallstreetbets,MEN,6,0,6,-6,1,1,0,1,NYSE
4642,12-02-2021 20:00,24 hrs.,wallstreetbets,MFA,7,7,0,7,1,1,1,1,NYSE
4642,12-02-2021 20:00,24 hrs.,wallstreetbets,MRO,413,407,6,401,3,164,73,3,NYSE
4642,12-02-2021 20:00,24 hrs.,wallstreetbets,MSM,7,7,0,7,1,1,1,1,NYSE
4642,12-02-2021 20:00,24 hrs.,wallstreetbets,MTL,6,0,6,-6,1,1,0,1,NYSE
4642,12-02-2021 20:00,24 hrs.,wallstreetbets,NAT,26,13,13,0,4,3,4,4,NYSE
4642,12-02-2021 20:00,24 hrs.,wallstreetbets,NAV,399,0,399,-399,1,122,151,1,NYSE
4642,12-02-2021 20:00,24 hrs.,wallstreetbets,NET,19,7,12,-5,3,3,1,3,NYSE
4642,12-02-2021 20:00,24 hrs.,wallstreetbets,NGA,12,6,6,0,2,2,0,2,NYSE
4642,12-02-2021 20:00,24 hrs.,wallstreetbets,NIO,880,428,452,-24,19,249,306,17,NYSE
4642,12-02-2021 20:00,24 hrs.,wallstreetbets,NLY,7,7,0,7,1,1,1,1,NYSE
4642,12-02-2021 20:00,24 hrs.,SPACs,CIIC,20,20,0,20,1,6,4,1,NASDAQ
4642,12-02-2021 20:00,24 hrs.,SPACs,CMLF,1876,0,1876,-1876,1,47,1778,1,NASDAQ
4642,12-02-2021 20:00,24 hrs.,SPACs,CONX,249,249,0,249,1,69,107,1,NASDAQ
4642,12-02-2021 20:00,24 hrs.,SPACs,CRSA,249,249,0,249,1,69,107,1,NASDAQ
4642,12-02-2021 20:00,24 hrs.,SPACs,DBDR,249,249,0,249,1,69,107,1,NASDAQ
4642,12-02-2021 20:00,24 hrs.,SPACs,DCRB,20,20,0,20,1,6,4,1,NASDAQ
4642,12-02-2021 20:00,24 hrs.,SPACs,DFPH,249,249,0,249,1,69,107,1,NASDAQ
4642,12-02-2021 20:00,24 hrs.,SPACs,DGNS,402,402,0,402,2,146,102,2,NASDAQ
4642,12-02-2021 20:00,24 hrs.,SPACs,DSAC,249,249,0,249,1,69,107,1,NASDAQ
4642,12-02-2021 20:00,24 hrs.,SPACs,ERES,249,249,0,249,1,69,107,1,NASDAQ
4642,12-02-2021 20:00,24 hrs.,SPACs,ESSC,249,249,0,249,1,69,107,1,NASDAQ
4642,12-02-2021 20:00,24 hrs.,SPACs,ETAC,249,249,0,249,1,69,107,1,NASDAQ
4642,12-02-2021 20:00,24 hrs.,SPACs,EUCR,249,249,0,249,1,69,107,1,NASDAQ
4642,12-02-2021 20:00,24 hrs.,SPACs,FCAC,2247,371,1876,-1505,3,201,1833,3,NASDAQ
4642,12-02-2021 20:00,24 hrs.,SPACs,FTOC,14,14,0,14,1,0,10,1,NASDAQ
4642,12-02-2021 20:00,24 hrs.,SPACs,FVAM,249,249,0,249,1,69,107,1,NASDAQ
4642,12-02-2021 20:00,24 hrs.,SPACs,GNRS,249,249,0,249,1,69,107,1,NASDAQ
4642,12-02-2021 20:00,24 hrs.,SPACs,GRCY,249,249,0,249,1,69,107,1,NASDAQ
4642,12-02-2021 20:00,24 hrs.,SPACs,GRNV,249,249,0,249,1,69,107,1,NASDAQ
4642,12-02-2021 20:00,24 hrs.,SPACs,GRSV,249,249,0,249,1,69,107,1,NASDAQ
4642,12-02-2021 20:00,24 hrs.,SPACs,GWAC,249,249,0,249,1,69,107,1,NASDAQ
4642,12-02-2021 20:00,24 hrs.,SPACs,GXGX,249,249,0,249,1,69,107,1,NASDAQ
4642,12-02-2021 20:00,24 hrs.,SPACs,IGAC,249,249,0,249,1,69,107,1,NASDAQ
4642,12-02-2021 20:00,24 hrs.,SPACs,ITAC,249,249,0,249,1,69,107,1,NASDAQ
4642,12-02-2021 20:00,24 hrs.,SPACs,JYAC,492,249,243,6,2,184,116,2,NASDAQ
4642,12-02-2021 20:00,24 hrs.,stocks,BTT,12,6,6,0,2,2,0,2,NYSE
4642,12-02-2021 20:00,24 hrs.,stocks,CBD,6,6,0,6,1,1,0,1,NYSE
4642,12-02-2021 20:00,24 hrs.,stocks,CIA,8427,0,8427,-8427,1,3947,529,1,NYSE
4642,12-02-2021 20:00,24 hrs.,stocks,CRM,6,6,0,6,1,1,0,1,NYSE
4642,12-02-2021 20:00,24 hrs.,stocks,CVE,6,6,0,6,1,1,0,1,NYSE
4642,12-02-2021 20:00,24 hrs.,stocks,CVS,11,11,0,11,1,1,5,1,NYSE
4642,12-02-2021 20:00,24 hrs.,stocks,DDD,42,0,42,-42,1,10,18,1,NYSE
4642,12-02-2021 20:00,24 hrs.,stocks,DIS,67,10,57,-47,2,21,17,2,NYSE
4642,12-02-2021 20:00,24 hrs.,SPACs,VTIQ,14,14,0,14,1,2,6,1,NASDAQ
4642,12-02-2021 20:00,24 hrs.,SPACs,YSAC,249,249,0,249,1,69,107,1,NASDAQ
4642,12-02-2021 20:00,24 hrs.,SPACs,ZGYH,249,249,0,249,1,69,107,1,NASDAQ
4642,12-02-2021 20:00,24 hrs.,SPACs,CMLFW,1876,0,1876,-1876,1,47,1778,1,NASDAQ
4642,12-02-2021 20:00,24 hrs.,SPACs,DSACW,1876,0,1876,-1876,1,47,1778,1,NASDAQ
4642,12-02-2021 20:00,24 hrs.,SPACs,EXPCW,1876,0,1876,-1876,1,47,1778,1,NASDAQ
4642,12-02-2021 20:00,24 hrs.,SPACs,FCACW,1876,0,1876,-1876,1,47,1778,1,NASDAQ
4642,12-02-2021 20:00,24 hrs.,SPACs,SAIIW,1876,0,1876,-1876,1,47,1778,1,NASDAQ
4642,12-02-2021 20:00,24 hrs.,stocks,ABML,6,6,0,6,1,1,0,1,OTC
4642,12-02-2021 20:00,24 hrs.,stocks,APTY,6,6,0,6,1,1,0,1,OTC
4642,12-02-2021 20:00,24 hrs.,stocks,BIEL,6,0,6,-6,1,1,0,1,OTC
4642,12-02-2021 20:00,24 hrs.,wallstreetbets,NOC,7,0,7,-7,1,1,1,1,NYSE
4642,12-02-2021 20:00,24 hrs.,wallstreetbets,NOK,1519,1421,98,1323,33,567,253,29,NYSE
4642,12-02-2021 20:00,24 hrs.,wallstreetbets,NRG,35,35,0,35,5,5,5,1,NYSE
4642,12-02-2021 20:00,24 hrs.,wallstreetbets,NUS,7,7,0,7,1,1,1,1,NYSE
4642,12-02-2021 20:00,24 hrs.,wallstreetbets,NVO,6,0,6,-6,1,1,0,1,NYSE
4642,12-02-2021 20:00,24 hrs.,wallstreetbets,NYC,14,7,7,0,2,2,2,2,NYSE
4642,12-02-2021 20:00,24 hrs.,wallstreetbets,OGE,7,7,0,7,1,1,1,1,NYSE
4642,12-02-2021 20:00,24 hrs.,wallstreetbets,OPP,7,0,7,-7,1,1,1,1,NYSE
4642,12-02-2021 20:00,24 hrs.,wallstreetbets,OPY,6,0,6,-6,1,1,0,1,NYSE
4642,12-02-2021 20:00,24 hrs.,wallstreetbets,OSK,64,64,0,64,1,16,28,1,NYSE
4642,12-02-2021 20:00,24 hrs.,wallstreetbets,OVV,5,5,0,5,1,0,1,1,NYSE
4642,12-02-2021 20:00,24 hrs.,wallstreetbets,OXY,13,0,13,-13,2,2,1,2,NYSE
4642,12-02-2021 20:00,24 hrs.,wallstreetbets,PCG,530,131,399,-268,2,157,208,2,NYSE
4642,12-02-2021 20:00,24 hrs.,wallstreetbets,PDT,13,0,13,-13,2,2,1,2,NYSE
4642,12-02-2021 20:00,24 hrs.,wallstreetbets,PEG,232,0,232,-232,1,81,66,1,NYSE
4642,12-02-2021 20:00,24 hrs.,wallstreetbets,PFE,19,13,6,7,3,3,1,3,NYSE
4642,12-02-2021 20:00,24 hrs.,wallstreetbets,PMO,7,7,0,7,1,1,1,1,NYSE
4642,12-02-2021 20:00,24 hrs.,wallstreetbets,PSA,1202,58,1144,-1086,8,482,206,6,NYSE
4642,12-02-2021 20:00,24 hrs.,wallstreetbets,PSX,7027,0,7027,-7027,1,3037,949,1,NYSE
4642,12-02-2021 20:00,24 hrs.,wallstreetbets,PVL,13,13,0,13,2,2,1,1,NYSE
4642,12-02-2021 20:00,24 hrs.,wallstreetbets,CVA,7,0,7,-7,1,1,1,1,NYSE
4642,12-02-2021 20:00,24 hrs.,wallstreetbets,DAC,20,20,0,20,3,3,2,2,NYSE
4642,12-02-2021 20:00,24 hrs.,wallstreetbets,DAL,13,13,0,13,2,2,1,2,NYSE
4642,12-02-2021 20:00,24 hrs.,wallstreetbets,DAO,12,12,0,12,2,2,0,1,NYSE
4642,12-02-2021 20:00,24 hrs.,wallstreetbets,DCF,232,0,232,-232,1,81,66,1,NYSE
4642,12-02-2021 20:00,24 hrs.,wallstreetbets,DHT,7,7,0,7,1,1,1,1,NYSE
4642,12-02-2021 20:00,24 hrs.,wallstreetbets,DIS,1651,428,1223,-795,15,674,243,15,NYSE
4642,12-02-2021 20:00,24 hrs.,wallstreetbets,DNB,7,0,7,-7,1,1,1,1,NYSE
4642,12-02-2021 20:00,24 hrs.,wallstreetbets,DOC,7,0,7,-7,1,1,1,1,NYSE
4642,12-02-2021 20:00,24 hrs.,wallstreetbets,DTE,133,133,0,133,1,39,51,1,NYSE
4642,12-02-2021 20:00,24 hrs.,wallstreetbets,DVN,7,7,0,7,1,1,1,1,NYSE
4642,12-02-2021 20:00,24 hrs.,wallstreetbets,EAT,28,14,14,0,4,4,4,4,NYSE
4642,12-02-2021 20:00,24 hrs.,wallstreetbets,EOS,13,0,13,-13,2,2,1,2,NYSE
4642,12-02-2021 20:00,24 hrs.,wallstreetbets,EPD,35,35,0,35,2,9,9,1,NYSE
4642,12-02-2021 20:00,24 hrs.,wallstreetbets,ETN,7,7,0,7,1,1,1,1,NYSE
4642,12-02-2021 20:00,24 hrs.,wallstreetbets,EXP,6,6,0,6,1,1,0,1,NYSE
4642,12-02-2021 20:00,24 hrs.,wallstreetbets,FAF,6,0,6,-6,1,1,0,1,NYSE
4642,12-02-2021 20:00,24 hrs.,wallstreetbets,FCF,232,0,232,-232,1,81,66,1,NYSE
4642,12-02-2021 20:00,24 hrs.,wallstreetbets,FCX,110,0,110,-110,6,26,34,3,NYSE
4642,12-02-2021 20:00,24 hrs.,wallstreetbets,FDX,7,7,0,7,1,1,1,1,NYSE
4642,12-02-2021 20:00,24 hrs.,wallstreetbets,FLT,13,7,6,1,2,2,1,2,NYSE
4642,12-02-2021 20:00,24 hrs.,wallstreetbets,FMC,13,13,0,13,2,2,1,1,NYSE
4642,12-02-2021 20:00,24 hrs.,wallstreetbets,FMS,13,0,13,-13,2,2,1,2,NYSE
4642,12-02-2021 20:00,24 hrs.,wallstreetbets,FOF,6,0,6,-6,1,1,0,1,NYSE
4642,12-02-2021 20:00,24 hrs.,wallstreetbets,FRO,6,6,0,6,1,1,0,1,NYSE
4642,12-02-2021 20:00,24 hrs.,wallstreetbets,UNP,7,7,0,7,1,1,1,1,NYSE
4642,12-02-2021 20:00,24 hrs.,wallstreetbets,USB,797,0,797,-797,1,309,175,1,NYSE
4642,12-02-2021 20:00,24 hrs.,wallstreetbets,UTZ,525,525,0,525,1,187,147,1,NYSE
4642,12-02-2021 20:00,24 hrs.,wallstreetbets,VET,20,0,20,-20,3,3,2,3,NYSE
4642,12-02-2021 20:00,24 hrs.,wallstreetbets,VGR,7,7,0,7,1,1,1,1,NYSE
4642,12-02-2021 20:00,24 hrs.,wallstreetbets,VHC,6,0,6,-6,1,1,0,1,NYSE
4642,12-02-2021 20:00,24 hrs.,wallstreetbets,VST,35,35,0,35,5,5,5,1,NYSE
4642,12-02-2021 20:00,24 hrs.,wallstreetbets,WFC,7,7,0,7,1,1,1,1,NYSE
4642,12-02-2021 20:00,24 hrs.,stocks,CAGR,25,0,25,-25,1,3,15,1,OTC
4642,12-02-2021 20:00,24 hrs.,stocks,CANN,6,6,0,6,1,1,0,1,OTC
4642,12-02-2021 20:00,24 hrs.,stocks,CAPC,6,6,0,6,1,1,0,1,OTC
4642,12-02-2021 20:00,24 hrs.,stocks,CORG,6,0,6,-6,1,1,0,1,OTC
4642,12-02-2021 20:00,24 hrs.,stocks,DIGI,6,0,6,-6,1,1,0,1,OTC
4642,12-02-2021 20:00,24 hrs.,stocks,FNMA,6,0,6,-6,1,1,0,1,OTC
4642,12-02-2021 20:00,24 hrs.,stocks,GRYN,6,6,0,6,1,1,0,1,OTC
4642,12-02-2021 20:00,24 hrs.,stocks,GTEH,6,6,0,6,1,1,0,1,OTC
4642,12-02-2021 20:00,24 hrs.,stocks,HCMC,31,6,25,-19,5,5,1,5,OTC
4642,12-02-2021 20:00,24 hrs.,stocks,HEMP,6,0,6,-6,1,1,0,1,OTC
4642,12-02-2021 20:00,24 hrs.,stocks,KGKG,6,0,6,-6,1,1,0,1,OTC
4642,12-02-2021 20:00,24 hrs.,stocks,KYNC,18,0,18,-18,3,3,0,1,OTC
4642,12-02-2021 20:00,24 hrs.,stocks,LINK,10,10,0,10,1,2,2,1,OTC
4642,12-02-2021 20:00,24 hrs.,stocks,MCAP,6,6,0,6,1,1,0,1,OTC
4642,12-02-2021 20:00,24 hrs.,stocks,MJNA,12,6,6,0,2,2,0,2,OTC
4642,12-02-2021 20:00,24 hrs.,stocks,MOJO,6,6,0,6,1,1,0,1,OTC
4642,12-02-2021 20:00,24 hrs.,stocks,NTRR,6,6,0,6,1,1,0,1,OTC
4642,12-02-2021 20:00,24 hrs.,stocks,OZSC,6,6,0,6,1,1,0,1,OTC
4642,12-02-2021 20:00,24 hrs.,stocks,PZOO,6,0,6,-6,1,1,0,1,OTC
4642,12-02-2021 20:00,24 hrs.,stocks,RSSV,15,15,0,15,1,4,3,1,OTC
4642,12-02-2021 20:00,24 hrs.,stocks,SNYR,6,6,0,6,1,1,0,1,OTC
4642,12-02-2021 20:00,24 hrs.,stocks,SUIC,6,0,6,-6,1,1,0,1,OTC
4642,12-02-2021 20:00,24 hrs.,stocks,TMRC,6,6,0,6,1,1,0,1,OTC
4642,12-02-2021 20:00,24 hrs.,stocks,ACRDF,6,6,0,6,1,1,0,1,OTC
4642,12-02-2021 20:00,24 hrs.,stocks,ACRHF,6,6,0,6,1,1,0,1,OTC
4642,12-02-2021 20:00,24 hrs.,stocks,BDRBF,6,6,0,6,1,1,0,1,OTC
4642,12-02-2021 20:00,24 hrs.,stocks,CBWTF,12,0,12,-12,2,2,0,2,OTC
4642,12-02-2021 20:00,24 hrs.,stocks,DGTHF,6,6,0,6,1,1,0,1,OTC
4642,12-02-2021 20:00,24 hrs.,stocks,EMHTF,6,6,0,6,1,1,0,1,OTC
4642,12-02-2021 20:00,24 hrs.,stocks,HITIF,6,0,6,-6,1,1,0,1,OTC
4642,12-02-2021 20:00,24 hrs.,stocks,MMEDF,6,6,0,6,1,1,0,1,OTC
4642,12-02-2021 20:00,24 hrs.,stocks,MMNFF,12,0,12,-12,2,2,0,1,OTC
4642,12-02-2021 20:00,24 hrs.,stocks,NXTTF,6,6,0,6,1,1,0,1,OTC
4642,12-02-2021 20:00,24 hrs.,stocks,OILFF,6,6,0,6,1,1,0,1,OTC
4642,12-02-2021 20:00,24 hrs.,stocks,RHDGF,6,6,0,6,1,1,0,1,OTC
4642,12-02-2021 20:00,24 hrs.,stocks,RHHBY,18,18,0,18,1,6,2,1,OTC
4642,12-02-2021 20:00,24 hrs.,stocks,RLLCF,12,6,6,0,2,2,0,2,OTC
4642,12-02-2021 20:00,24 hrs.,stocks,SFTBY,16,0,16,-16,1,4,4,1,OTC
4642,12-02-2021 20:00,24 hrs.,stocks,DNN,12,0,12,-12,2,2,0,2,AMEX
4642,12-02-2021 20:00,24 hrs.,stocks,DPW,12,0,12,-12,1,3,2,1,AMEX
4642,12-02-2021 20:00,24 hrs.,stocks,DSS,6,6,0,6,1,1,0,1,AMEX
4642,12-02-2021 20:00,24 hrs.,stocks,GDP,29,29,0,29,1,3,19,1,AMEX
4642,12-02-2021 20:00,24 hrs.,stocks,IGC,6,6,0,6,1,1,0,1,AMEX
4642,12-02-2021 20:00,24 hrs.,stocks,MXC,6,6,0,6,1,1,0,1,AMEX
4642,12-02-2021 20:00,24 hrs.,stocks,PLX,12,12,0,12,1,2,4,1,AMEX
4642,12-02-2021 20:00,24 hrs.,stocks,ZOM,31,12,19,-7,5,5,1,5,AMEX
4642,12-02-2021 20:00,24 hrs.,stocks,GSAT,6,6,0,6,1,1,0,1,AMEX
4642,12-02-2021 20:00,24 hrs.,stocks,TMBR,6,6,0,6,1,1,0,1,AMEX
4642,12-02-2021 20:00,24 hrs.,stocks,ACB,67,0,67,-67,2,15,29,2,NYSE
4642,12-02-2021 20:00,24 hrs.,stocks,ADT,6,6,0,6,1,1,0,1,NYSE
4642,12-02-2021 20:00,24 hrs.,stocks,AMC,244,85,159,-74,9,53,102,9,NYSE
4642,12-02-2021 20:00,24 hrs.,stocks,ASX,13,7,6,1,2,2,1,2,NYSE
4642,12-02-2021 20:00,24 hrs.,stocks,ATH,29,29,0,29,1,3,19,1,NYSE
4642,12-02-2021 20:00,24 hrs.,stocks,BBY,54,0,54,-54,1,14,22,1,NYSE
4642,12-02-2021 20:00,24 hrs.,stocks,BEP,113,113,0,113,5,17,59,5,NYSE
4642,12-02-2021 20:00,24 hrs.,stocks,BHC,10,10,0,10,1,2,2,1,NYSE
4642,12-02-2021 20:00,24 hrs.,wallstreetbets,HYLN,983,409,574,-165,58,241,269,48,NYSE
4642,12-02-2021 20:00,24 hrs.,wallstreetbets,IIPR,20,20,0,20,3,3,2,2,NYSE
4642,12-02-2021 20:00,24 hrs.,wallstreetbets,IPOE,13,7,6,1,2,2,1,2,NYSE
4642,12-02-2021 20:00,24 hrs.,wallstreetbets,JMIA,2623,2623,0,2623,7,1189,217,2,NYSE
4642,12-02-2021 20:00,24 hrs.,wallstreetbets,JNPR,6,6,0,6,1,1,0,1,NYSE
4642,12-02-2021 20:00,24 hrs.,wallstreetbets,KODK,13,13,0,13,2,2,1,1,NYSE
4642,12-02-2021 20:00,24 hrs.,wallstreetbets,LDOS,6,0,6,-6,1,1,0,1,NYSE
4642,12-02-2021 20:00,24 hrs.,wallstreetbets,LEAP,6,0,6,-6,1,1,0,1,NYSE
4642,12-02-2021 20:00,24 hrs.,stocks,EOS,12,0,12,-12,2,2,0,1,NYSE
4642,12-02-2021 20:00,24 hrs.,stocks,ETH,6,6,0,6,1,1,0,1,NYSE
4642,12-02-2021 20:00,24 hrs.,stocks,FCF,29,29,0,29,1,3,19,1,NYSE
4642,12-02-2021 20:00,24 hrs.,stocks,FCX,6,0,6,-6,1,1,0,1,NYSE
4642,12-02-2021 20:00,24 hrs.,stocks,FSR,32,6,26,-20,2,12,0,2,NYSE
4642,12-02-2021 20:00,24 hrs.,stocks,GME,5163,107,5056,-4949,19,2075,937,18,NYSE
4642,12-02-2021 20:00,24 hrs.,stocks,IBM,8525,98,8427,-8329,2,3987,543,2,NYSE
4642,12-02-2021 20:00,24 hrs.,stocks,ICE,29,29,0,29,1,3,19,1,NYSE
4642,12-02-2021 20:00,24 hrs.,stocks,IRS,63,63,0,63,1,24,11,1,NYSE
4642,12-02-2021 20:00,24 hrs.,stocks,KEY,88,0,88,-88,1,34,16,1,NYSE
4642,12-02-2021 20:00,24 hrs.,stocks,KNL,31,0,31,-31,1,10,7,1,NYSE
4642,12-02-2021 20:00,24 hrs.,stocks,LEN,6,0,6,-6,1,1,0,1,NYSE
4642,12-02-2021 20:00,24 hrs.,stocks,LMT,6,0,6,-6,1,1,0,1,NYSE
4642,12-02-2021 20:00,24 hrs.,stocks,LUV,57,57,0,57,1,13,27,1,NYSE
4642,12-02-2021 20:00,24 hrs.,stocks,MCO,10,10,0,10,1,2,2,1,NYSE
4642,12-02-2021 20:00,24 hrs.,stocks,MFA,8,8,0,8,1,1,2,1,NYSE
4642,12-02-2021 20:00,24 hrs.,stocks,MGM,28,11,17,-6,2,5,10,2,NYSE
4642,12-02-2021 20:00,24 hrs.,stocks,MRO,10,10,0,10,1,2,2,1,NYSE
4642,12-02-2021 20:00,24 hrs.,stocks,NAT,29,0,29,-29,1,7,11,1,NYSE
4642,12-02-2021 20:00,24 hrs.,stocks,NET,385,11,374,-363,2,143,91,2,NYSE
4642,12-02-2021 20:00,24 hrs.,stocks,NGL,6,6,0,6,1,1,0,1,NYSE
4642,12-02-2021 20:00,24 hrs.,wallstreetbets,RDY,6,6,0,6,1,1,0,1,NYSE
4642,12-02-2021 20:00,24 hrs.,wallstreetbets,RKT,887,47,840,-793,18,259,297,14,NYSE
4642,12-02-2021 20:00,24 hrs.,wallstreetbets,RMO,89,69,20,49,13,13,11,9,NYSE
4642,12-02-2021 20:00,24 hrs.,wallstreetbets,RPT,7,7,0,7,1,1,1,1,NYSE
4642,12-02-2021 20:00,24 hrs.,wallstreetbets,RSI,18,6,12,-6,3,3,0,3,NYSE
4642,12-02-2021 20:00,24 hrs.,wallstreetbets,RTX,7,0,7,-7,1,1,1,1,NYSE
4642,12-02-2021 20:00,24 hrs.,wallstreetbets,SBE,18,6,12,-6,3,3,0,3,NYSE
4642,12-02-2021 20:00,24 hrs.,wallstreetbets,SBI,7,0,7,-7,1,1,1,1,NYSE
4642,12-02-2021 20:00,24 hrs.,wallstreetbets,SCI,602,0,602,-602,3,225,140,2,NYSE
4642,12-02-2021 20:00,24 hrs.,wallstreetbets,SKM,30,30,0,30,1,0,26,1,NYSE
4642,12-02-2021 20:00,24 hrs.,wallstreetbets,SKT,14,0,14,-14,2,2,2,2,NYSE
4642,12-02-2021 20:00,24 hrs.,wallstreetbets,SNE,14,14,0,14,2,2,2,1,NYSE
4642,12-02-2021 20:00,24 hrs.,wallstreetbets,SNX,6,0,6,-6,1,1,0,1,NYSE
4642,12-02-2021 20:00,24 hrs.,wallstreetbets,SOL,14,0,14,-14,2,2,2,2,NYSE
4642,12-02-2021 20:00,24 hrs.,wallstreetbets,SOS,291,106,185,-79,44,42,31,31,NYSE
4642,12-02-2021 20:00,24 hrs.,wallstreetbets,SPG,59,0,59,-59,2,1,49,2,NYSE
4642,12-02-2021 20:00,24 hrs.,wallstreetbets,SPH,13,0,13,-13,2,2,1,2,NYSE
4642,12-02-2021 20:00,24 hrs.,wallstreetbets,STM,7,7,0,7,1,1,1,1,NYSE
4642,12-02-2021 20:00,24 hrs.,wallstreetbets,SUN,6,6,0,6,1,1,0,1,NYSE
4642,12-02-2021 20:00,24 hrs.,wallstreetbets,SUP,7,7,0,7,1,1,1,1,NYSE
4642,12-02-2021 20:00,24 hrs.,wallstreetbets,TAK,14,14,0,14,2,2,2,2,NYSE
4642,12-02-2021 20:00,24 hrs.,wallstreetbets,TAP,7,7,0,7,1,1,1,1,NYSE
4642,12-02-2021 20:00,24 hrs.,wallstreetbets,TDA,1328,0,1328,-1328,3,582,152,3,NYSE
4642,12-02-2021 20:00,24 hrs.,wallstreetbets,TDC,6,6,0,6,1,1,0,1,NYSE
4642,12-02-2021 20:00,24 hrs.,wallstreetbets,TFC,7,7,0,7,1,1,1,1,NYSE
4642,12-02-2021 20:00,24 hrs.,wallstreetbets,THR,8,0,8,-8,1,1,2,1,NYSE
4642,12-02-2021 20:00,24 hrs.,wallstreetbets,TPB,6,0,6,-6,1,1,0,1,NYSE
4642,12-02-2021 20:00,24 hrs.,wallstreetbets,TRQ,6,6,0,6,1,1,0,1,NYSE
4642,12-02-2021 20:00,24 hrs.,wallstreetbets,TRU,7,7,0,7,1,1,1,1,NYSE
4642,12-02-2021 20:00,24 hrs.,wallstreetbets,TSM,2436,438,1998,-1560,7,889,630,5,NYSE
4642,12-02-2021 20:00,24 hrs.,wallstreetbets,TSN,2588,2588,0,2588,2,1184,212,1,NYSE
4642,12-02-2021 20:00,24 hrs.,wallstreetbets,TTM,6,6,0,6,1,1,0,1,NYSE
4642,12-02-2021 20:00,24 hrs.,wallstreetbets,TWO,7,7,0,7,1,1,1,1,NYSE
4642,12-02-2021 20:00,24 hrs.,wallstreetbets,UBS,20,7,13,-6,3,3,2,2,NYSE
4642,12-02-2021 20:00,24 hrs.,wallstreetbets,UMC,6,0,6,-6,1,1,0,1,NYSE
4642,12-02-2021 20:00,24 hrs.,stocks,TMO,7,0,7,-7,1,1,1,1,NYSE
4642,12-02-2021 20:00,24 hrs.,stocks,TSM,44,44,0,44,1,7,26,1,NYSE
4642,12-02-2021 20:00,24 hrs.,stocks,UBS,1819,1819,0,1819,1,880,55,1,NYSE
4642,12-02-2021 20:00,24 hrs.,stocks,WLL,6,6,0,6,1,1,0,1,NYSE
4642,12-02-2021 20:00,24 hrs.,stocks,WMT,52,52,0,52,1,14,20,1,NYSE
4642,12-02-2021 20:00,24 hrs.,stocks,AJRD,52,52,0,52,1,14,20,1,NYSE
4642,12-02-2021 20:00,24 hrs.,stocks,ALSN,31,0,31,-31,1,10,7,1,NYSE
4642,12-02-2021 20:00,24 hrs.,stocks,APTV,52,52,0,52,1,14,20,1,NYSE
4642,12-02-2021 20:00,24 hrs.,stocks,BABA,7,0,7,-7,1,1,1,1,NYSE
4642,12-02-2021 20:00,24 hrs.,stocks,BEPC,26,26,0,26,2,1,16,2,NYSE
4642,12-02-2021 20:00,24 hrs.,stocks,BORR,44,44,0,44,3,10,12,3,NYSE
4642,12-02-2021 20:00,24 hrs.,stocks,CACI,8427,0,8427,-8427,1,3947,529,1,NYSE
4642,12-02-2021 20:00,24 hrs.,stocks,CCIV,12,0,12,-12,2,2,0,2,NYSE
4642,12-02-2021 20:00,24 hrs.,stocks,COTY,6,6,0,6,1,1,0,1,NYSE
4642,12-02-2021 20:00,24 hrs.,stocks,FTCH,29,0,29,-29,1,6,13,1,NYSE
4642,12-02-2021 20:00,24 hrs.,stocks,FUSE,6,6,0,6,1,1,0,1,NYSE
4642,12-02-2021 20:00,24 hrs.,stocks,FVRR,29,0,29,-29,1,6,13,1,NYSE
4642,12-02-2021 20:00,24 hrs.,stocks,HEXO,6,6,0,6,1,1,0,1,NYSE
4642,12-02-2021 20:00,24 hrs.,stocks,HUYA,77,77,0,77,1,27,19,1,NYSE
4642,12-02-2021 20:00,24 hrs.,stocks,HYLN,6,0,6,-6,1,1,0,1,NYSE
4642,12-02-2021 20:00,24 hrs.,stocks,JMIA,6,6,0,6,1,1,0,1,NYSE
4642,12-02-2021 20:00,24 hrs.,stocks,MDLY,6,0,6,-6,1,1,0,1,NYSE
4642,12-02-2021 20:00,24 hrs.,stocks,OTIS,31,0,31,-31,1,10,7,1,NYSE
4642,12-02-2021 20:00,24 hrs.,stocks,PLTR,222,216,6,210,3,60,90,3,NYSE
4642,12-02-2021 20:00,24 hrs.,stocks,SKLZ,47,0,47,-47,1,15,13,1,NYSE
4642,12-02-2021 20:00,24 hrs.,stocks,SPCE,65,52,13,39,3,16,21,3,NYSE
4642,12-02-2021 20:00,24 hrs.,stocks,SPOT,6,0,6,-6,1,1,0,1,NYSE
4642,12-02-2021 20:00,24 hrs.,stocks,VGAC,6,6,0,6,1,1,0,1,NYSE
4642,12-02-2021 20:00,24 hrs.,stocks,VOYA,31,0,31,-31,1,10,7,1,NYSE
4642,12-02-2021 20:00,24 hrs.,stocks,WORK,6,0,6,-6,1,1,0,1,NYSE
4642,12-02-2021 20:00,24 hrs.,wallstreetbets,WLL,6,6,0,6,1,1,0,1,NYSE
4642,12-02-2021 20:00,24 hrs.,wallstreetbets,WMC,8,8,0,8,1,1,2,1,NYSE
4642,12-02-2021 20:00,24 hrs.,wallstreetbets,WMT,20,13,7,6,3,3,2,3,NYSE
4642,12-02-2021 20:00,24 hrs.,wallstreetbets,WWE,7,0,7,-7,1,1,1,1,NYSE
4642,12-02-2021 20:00,24 hrs.,wallstreetbets,ABEV,7,7,0,7,1,1,1,1,NYSE
4642,12-02-2021 20:00,24 hrs.,wallstreetbets,ACIC,45,20,25,-5,7,7,3,6,NYSE
4642,12-02-2021 20:00,24 hrs.,wallstreetbets,APRN,6,6,0,6,1,1,0,1,NYSE
4642,12-02-2021 20:00,24 hrs.,wallstreetbets,ARGO,6,6,0,6,1,1,0,1,NYSE
4642,12-02-2021 20:00,24 hrs.,wallstreetbets,ATUS,14,14,0,14,2,2,2,1,NYSE
4642,12-02-2021 20:00,24 hrs.,wallstreetbets,BABA,153,147,6,141,4,42,53,4,NYSE
4642,12-02-2021 20:00,24 hrs.,wallstreetbets,BEKE,399,0,399,-399,1,122,151,1,NYSE
4642,12-02-2021 20:00,24 hrs.,wallstreetbets,BNED,6,6,0,6,1,1,0,1,NYSE
4642,12-02-2021 20:00,24 hrs.,wallstreetbets,CARS,6,6,0,6,1,1,0,1,NYSE
4642,12-02-2021 20:00,24 hrs.,wallstreetbets,CCIV,268,122,146,-24,39,39,34,33,NYSE
4642,12-02-2021 20:00,24 hrs.,wallstreetbets,CHWY,67,7,60,-53,2,19,21,2,NYSE
4642,12-02-2021 20:00,24 hrs.,wallstreetbets,CLDR,159,0,159,-159,1,49,57,1,NYSE
4642,12-02-2021 20:00,24 hrs.,wallstreetbets,CLII,7,7,0,7,1,1,1,1,NYSE
4642,12-02-2021 20:00,24 hrs.,wallstreetbets,COTY,6,0,6,-6,1,1,0,1,NYSE
4642,12-02-2021 20:00,24 hrs.,wallstreetbets,CVNA,60,0,60,-60,1,18,20,1,NYSE
4642,12-02-2021 20:00,24 hrs.,wallstreetbets,DASH,26,0,26,-26,3,2,10,2,NYSE
4642,12-02-2021 20:00,24 hrs.,wallstreetbets,DECK,7,0,7,-7,1,1,1,1,NYSE
4642,12-02-2021 20:00,24 hrs.,wallstreetbets,EXPR,7,7,0,7,1,1,1,1,NYSE
4642,12-02-2021 20:00,24 hrs.,wallstreetbets,FEDU,7,7,0,7,1,1,1,1,NYSE
4642,12-02-2021 20:00,24 hrs.,wallstreetbets,FENG,6,0,6,-6,1,1,0,1,NYSE
4642,12-02-2021 20:00,24 hrs.,wallstreetbets,FINV,14,0,14,-14,2,2,2,1,NYSE
4642,12-02-2021 20:00,24 hrs.,wallstreetbets,FLOW,7,7,0,7,1,1,1,1,NYSE
4642,12-02-2021 20:00,24 hrs.,wallstreetbets,FSLY,14,14,0,14,2,2,2,2,NYSE
4642,12-02-2021 20:00,24 hrs.,wallstreetbets,FUBO,552,532,20,512,5,191,150,5,NYSE
4642,12-02-2021 20:00,24 hrs.,wallstreetbets,FUSE,30,30,0,30,4,4,6,2,NYSE
4642,12-02-2021 20:00,24 hrs.,wallstreetbets,FVRR,15,7,8,-1,2,2,3,2,NYSE
4642,12-02-2021 20:00,24 hrs.,wallstreetbets,GPRK,7,7,0,7,1,1,1,1,NYSE
4642,12-02-2021 20:00,24 hrs.,wallstreetbets,GRUB,6,0,6,-6,1,1,0,1,NYSE
4642,12-02-2021 20:00,24 hrs.,wallstreetbets,HUBS,13,13,0,13,2,2,1,2,NYSE
4642,12-02-2021 20:00,24 hrs.,wallstreetbets,HUYA,36,21,15,6,5,5,6,4,NYSE
4642,12-02-2021 20:00,24 hrs.,stocks,XPEV,8433,6,8427,-8421,2,3948,529,2,NYSE
4642,12-02-2021 20:00,24 hrs.,stocks,YETI,57,57,0,57,1,13,27,1,NYSE
4642,12-02-2021 20:00,24 hrs.,stocks,AAL,57,0,57,-57,2,9,31,2,NASDAQ
4642,12-02-2021 20:00,24 hrs.,stocks,AMD,58,44,14,30,3,8,30,2,NASDAQ
4642,12-02-2021 20:00,24 hrs.,stocks,AZN,10,10,0,10,1,2,2,1,NASDAQ
4642,12-02-2021 20:00,24 hrs.,stocks,CDC,10,10,0,10,1,2,2,1,NASDAQ
4642,12-02-2021 20:00,24 hrs.,stocks,CGC,6,0,6,-6,1,1,0,1,NASDAQ
4642,12-02-2021 20:00,24 hrs.,stocks,FTC,31,31,0,31,1,9,9,1,NASDAQ
4642,12-02-2021 20:00,24 hrs.,stocks,IEA,14,14,0,14,1,2,6,1,NASDAQ
4642,12-02-2021 20:00,24 hrs.,stocks,JFU,6,0,6,-6,1,1,0,1,NASDAQ
4642,12-02-2021 20:00,24 hrs.,stocks,KHC,39,0,39,-39,2,10,11,2,NASDAQ
4642,12-02-2021 20:00,24 hrs.,stocks,LNT,31,0,31,-31,1,10,7,1,NASDAQ
4642,12-02-2021 20:00,24 hrs.,stocks,MIK,6,0,6,-6,1,1,0,1,NASDAQ
4642,12-02-2021 20:00,24 hrs.,stocks,NPA,6,0,6,-6,1,1,0,1,NASDAQ
4642,12-02-2021 20:00,24 hrs.,stocks,NWL,10,10,0,10,1,2,2,1,NASDAQ
4642,12-02-2021 20:00,24 hrs.,stocks,OGI,31,12,19,-7,5,5,1,5,NASDAQ
4642,12-02-2021 20:00,24 hrs.,stocks,OLB,6,0,6,-6,1,1,0,1,NASDAQ
4642,12-02-2021 20:00,24 hrs.,stocks,PEP,6,0,6,-6,1,0,2,1,NASDAQ
4642,12-02-2021 20:00,24 hrs.,stocks,UFO,20,0,20,-20,1,7,2,1,NASDAQ
4642,12-02-2021 20:00,24 hrs.,stocks,AAPL,64,0,64,-64,1,14,32,1,NASDAQ
4642,12-02-2021 20:00,24 hrs.,stocks,ABIO,6,0,6,-6,1,1,0,1,NASDAQ
4642,12-02-2021 20:00,24 hrs.,stocks,ABNB,38,0,38,-38,1,13,8,1,NASDAQ
4642,12-02-2021 20:00,24 hrs.,stocks,ABUS,6,6,0,6,1,1,0,1,NASDAQ
4642,12-02-2021 20:00,24 hrs.,stocks,AEZS,149,149,0,149,1,65,15,1,NASDAQ
4642,12-02-2021 20:00,24 hrs.,stocks,AGEN,8,8,0,8,1,2,0,1,NASDAQ
4642,12-02-2021 20:00,24 hrs.,stocks,AGTC,18,12,6,6,3,3,0,2,NASDAQ
4642,12-02-2021 20:00,24 hrs.,stocks,ALJJ,6,0,6,-6,1,1,0,1,NASDAQ
4642,12-02-2021 20:00,24 hrs.,stocks,ALOT,175,0,175,-175,1,44,83,1,NASDAQ
4642,12-02-2021 20:00,24 hrs.,stocks,AMCX,6,0,6,-6,1,1,0,1,NASDAQ
4642,12-02-2021 20:00,24 hrs.,stocks,AMZN,52,52,0,52,1,14,20,1,NASDAQ
4642,12-02-2021 20:00,24 hrs.,stocks,APHA,1123,657,466,191,12,313,449,12,NASDAQ
4642,12-02-2021 20:00,24 hrs.,stocks,APXT,6,0,6,-6,1,1,0,1,NASDAQ
4642,12-02-2021 20:00,24 hrs.,stocks,ARTL,18,18,0,18,3,3,0,2,NASDAQ
4642,12-02-2021 20:00,24 hrs.,stocks,ASYS,6,6,0,6,1,1,0,1,NASDAQ
4642,12-02-2021 20:00,24 hrs.,stocks,ATOM,6,0,6,-6,1,1,0,1,NASDAQ
4642,12-02-2021 20:00,24 hrs.,stocks,ATOS,149,149,0,149,1,65,15,1,NASDAQ
4642,12-02-2021 20:00,24 hrs.,stocks,AVGO,6,6,0,6,1,1,0,1,NASDAQ
4642,12-02-2021 20:00,24 hrs.,stocks,AZRX,12,0,12,-12,1,2,4,1,NASDAQ
4642,12-02-2021 20:00,24 hrs.,stocks,BNGO,6,6,0,6,1,1,0,1,NASDAQ
4642,12-02-2021 20:00,24 hrs.,stocks,BYND,6,6,0,6,1,1,0,1,NASDAQ
4642,12-02-2021 20:00,24 hrs.,stocks,CLEU,7,0,7,-7,1,1,1,1,NASDAQ
4642,12-02-2021 20:00,24 hrs.,stocks,CLSK,41,0,41,-41,2,10,13,2,NASDAQ
4642,12-02-2021 20:00,24 hrs.,stocks,CLVS,6,0,6,-6,1,1,0,1,NASDAQ
4642,12-02-2021 20:00,24 hrs.,stocks,CMPS,12,12,0,12,2,2,0,1,NASDAQ
4642,12-02-2021 20:00,24 hrs.,stocks,CNDT,16,0,16,-16,1,4,4,1,NASDAQ
4642,12-02-2021 20:00,24 hrs.,stocks,COHR,10,10,0,10,1,2,2,1,NASDAQ
4642,12-02-2021 20:00,24 hrs.,stocks,CPST,6,6,0,6,1,1,0,1,NASDAQ
4642,12-02-2021 20:00,24 hrs.,stocks,CREE,6,0,6,-6,1,1,0,1,NASDAQ
4642,12-02-2021 20:00,24 hrs.,stocks,CRSP,52,52,0,52,1,14,20,1,NASDAQ
4642,12-02-2021 20:00,24 hrs.,stocks,CRSR,47,0,47,-47,1,15,13,1,NASDAQ
4642,12-02-2021 20:00,24 hrs.,stocks,NIO,553,553,0,553,4,182,173,4,NYSE
4642,12-02-2021 20:00,24 hrs.,stocks,NOK,124,124,0,124,3,21,70,3,NYSE
4642,12-02-2021 20:00,24 hrs.,stocks,NOM,65,65,0,65,1,23,15,1,NYSE
4642,12-02-2021 20:00,24 hrs.,stocks,NSA,8427,0,8427,-8427,1,3947,529,1,NYSE
4642,12-02-2021 20:00,24 hrs.,stocks,NVS,18,0,18,-18,3,3,0,1,NYSE
4642,12-02-2021 20:00,24 hrs.,stocks,PDT,6,0,6,-6,1,1,0,1,NYSE
4642,12-02-2021 20:00,24 hrs.,stocks,PEG,166,166,0,166,1,9,144,1,NYSE
4642,12-02-2021 20:00,24 hrs.,stocks,PFE,7,7,0,7,1,1,1,1,NYSE
4642,12-02-2021 20:00,24 hrs.,stocks,RKT,95,0,95,-95,1,37,17,1,NYSE
4642,12-02-2021 20:00,24 hrs.,stocks,RSI,31,0,31,-31,1,10,7,1,NYSE
4642,12-02-2021 20:00,24 hrs.,stocks,SBE,64,0,64,-64,5,21,2,3,NYSE
4642,12-02-2021 20:00,24 hrs.,stocks,SOI,6,0,6,-6,1,1,0,1,NYSE
4642,12-02-2021 20:00,24 hrs.,stocks,SOS,30,12,18,-6,5,5,0,5,NYSE
4642,12-02-2021 20:00,24 hrs.,stocks,SUP,6,6,0,6,1,1,0,1,NYSE
4630,12-02-2021 18:00,24 hrs.,SPACs,EMPW,1686,203,1483,-1280,2,100,1478,2,NYSE
4630,12-02-2021 18:00,24 hrs.,SPACs,FGNA,1483,0,1483,-1483,1,44,1391,1,NYSE
4630,12-02-2021 18:00,24 hrs.,SPACs,FUSE,3055,1414,1641,-227,16,600,1791,13,NYSE
4630,12-02-2021 18:00,24 hrs.,SPACs,GLEO,203,203,0,203,1,56,87,1,NYSE
4630,12-02-2021 18:00,24 hrs.,SPACs,GOAC,203,203,0,203,1,56,87,1,NYSE
4630,12-02-2021 18:00,24 hrs.,SPACs,GSAH,327,327,0,327,2,116,87,2,NYSE
4630,12-02-2021 18:00,24 hrs.,SPACs,HIGA,203,203,0,203,1,56,87,1,NYSE
4630,12-02-2021 18:00,24 hrs.,SPACs,HYLN,6,0,6,-6,1,1,0,1,NYSE
4630,12-02-2021 18:00,24 hrs.,SPACs,HZAC,203,203,0,203,1,56,87,1,NYSE
4630,12-02-2021 18:00,24 hrs.,SPACs,HZON,203,203,0,203,1,56,87,1,NYSE
4630,12-02-2021 18:00,24 hrs.,SPACs,IMPX,203,203,0,203,1,56,87,1,NYSE
4630,12-02-2021 18:00,24 hrs.,SPACs,IPOE,13,6,7,-1,2,2,1,2,NYSE
4630,12-02-2021 18:00,24 hrs.,SPACs,LGVW,330,245,85,160,4,126,62,3,NYSE
4630,12-02-2021 18:00,24 hrs.,SPACs,OACB,203,203,0,203,1,56,87,1,NYSE
4630,12-02-2021 18:00,24 hrs.,SPACs,PACE,1483,0,1483,-1483,1,44,1391,1,NYSE
4630,12-02-2021 18:00,24 hrs.,SPACs,PANA,203,203,0,203,1,56,87,1,NYSE
4630,12-02-2021 18:00,24 hrs.,SPACs,PCPL,203,203,0,203,1,56,87,1,NYSE
4630,12-02-2021 18:00,24 hrs.,SPACs,PIAI,203,203,0,203,1,56,87,1,NYSE
4630,12-02-2021 18:00,24 hrs.,SPACs,PRPB,203,203,0,203,1,56,87,1,NYSE
4630,12-02-2021 18:00,24 hrs.,SPACs,RBAC,203,203,0,203,1,56,87,1,NYSE
4630,12-02-2021 18:00,24 hrs.,SPACs,RPLA,203,203,0,203,1,56,87,1,NYSE
4630,12-02-2021 18:00,24 hrs.,SPACs,SCPE,203,203,0,203,1,56,87,1,NYSE
4630,12-02-2021 18:00,24 hrs.,SPACs,SCVX,330,203,127,76,2,99,124,2,NYSE
4630,12-02-2021 18:00,24 hrs.,SPACs,SEAH,203,203,0,203,1,56,87,1,NYSE
4630,12-02-2021 18:00,24 hrs.,SPACs,SFTW,203,203,0,203,1,56,87,1,NYSE
4630,12-02-2021 18:00,24 hrs.,SPACs,SKLZ,119,0,119,-119,1,36,43,1,NYSE
4630,12-02-2021 18:00,24 hrs.,SPACs,SNPR,1511,15,1496,-1481,4,49,1397,4,NYSE
4630,12-02-2021 18:00,24 hrs.,SPACs,SPCE,7,0,7,-7,1,1,1,1,NYSE
4630,12-02-2021 18:00,24 hrs.,SPACs,SPNV,25,0,25,-25,1,7,7,1,NYSE
4630,12-02-2021 18:00,24 hrs.,SPACs,TWND,37,24,13,11,3,5,15,2,NYSE
4630,12-02-2021 18:00,24 hrs.,SPACs,ADOC,203,203,0,203,1,56,87,1,NASDAQ
4630,12-02-2021 18:00,24 hrs.,SPACs,AGBA,203,203,0,203,1,56,87,1,NASDAQ
4630,12-02-2021 18:00,24 hrs.,SPACs,AHAC,203,203,0,203,1,56,87,1,NASDAQ
4630,12-02-2021 18:00,24 hrs.,SPACs,AMHC,203,203,0,203,1,56,87,1,NASDAQ
4630,12-02-2021 18:00,24 hrs.,SPACs,ANDA,103,0,103,-103,1,20,59,1,NASDAQ
4630,12-02-2021 18:00,24 hrs.,SPACs,BHSE,203,203,0,203,1,56,87,1,NASDAQ
4630,12-02-2021 18:00,24 hrs.,SPACs,BLNK,23,23,0,23,1,2,15,1,NASDAQ
4630,12-02-2021 18:00,24 hrs.,SPACs,BOWX,203,203,0,203,1,56,87,1,NASDAQ
4630,12-02-2021 18:00,24 hrs.,SPACs,BREZ,203,203,0,203,1,56,87,1,NASDAQ
4630,12-02-2021 18:00,24 hrs.,SPACs,BRLI,203,203,0,203,1,56,87,1,NASDAQ
4630,12-02-2021 18:00,24 hrs.,SPACs,BTAQ,209,209,0,209,2,57,87,2,NASDAQ
4630,12-02-2021 18:00,24 hrs.,SPACs,BTWN,70,8,62,-54,3,11,36,3,NASDAQ
4630,12-02-2021 18:00,24 hrs.,SPACs,BWAC,203,203,0,203,1,56,87,1,NASDAQ
4630,12-02-2021 18:00,24 hrs.,SPACs,CAPA,203,203,0,203,1,56,87,1,NASDAQ
4630,12-02-2021 18:00,24 hrs.,SPACs,CELH,103,0,103,-103,1,20,59,1,NASDAQ
4630,12-02-2021 18:00,24 hrs.,SPACs,CFII,203,203,0,203,1,56,87,1,NASDAQ
4630,12-02-2021 18:00,24 hrs.,SPACs,CHPM,203,203,0,203,1,56,87,1,NASDAQ
4630,12-02-2021 18:00,24 hrs.,SPACs,CIIC,20,20,0,20,1,6,4,1,NASDAQ
4630,12-02-2021 18:00,24 hrs.,SPACs,CMLF,1483,0,1483,-1483,1,44,1391,1,NASDAQ
4630,12-02-2021 18:00,24 hrs.,SPACs,CONX,203,203,0,203,1,56,87,1,NASDAQ
4630,12-02-2021 18:00,24 hrs.,SPACs,CRSA,203,203,0,203,1,56,87,1,NASDAQ
4630,12-02-2021 18:00,24 hrs.,SPACs,DBDR,203,203,0,203,1,56,87,1,NASDAQ
4630,12-02-2021 18:00,24 hrs.,SPACs,DCRB,20,20,0,20,1,6,4,1,NASDAQ
4630,12-02-2021 18:00,24 hrs.,SPACs,DFPH,203,203,0,203,1,56,87,1,NASDAQ
4630,12-02-2021 18:00,24 hrs.,SPACs,DGNS,327,327,0,327,2,116,87,2,NASDAQ
4630,12-02-2021 18:00,24 hrs.,SPACs,DSAC,203,203,0,203,1,56,87,1,NASDAQ
4630,12-02-2021 18:00,24 hrs.,SPACs,ERES,203,203,0,203,1,56,87,1,NASDAQ
4630,12-02-2021 18:00,24 hrs.,SPACs,ESSC,203,203,0,203,1,56,87,1,NASDAQ
4630,12-02-2021 18:00,24 hrs.,SPACs,ETAC,203,203,0,203,1,56,87,1,NASDAQ
4630,12-02-2021 18:00,24 hrs.,SPACs,EUCR,203,203,0,203,1,56,87,1,NASDAQ
4630,12-02-2021 18:00,24 hrs.,SPACs,EXPC,1483,0,1483,-1483,1,44,1391,1,NASDAQ
4630,12-02-2021 18:00,24 hrs.,SPACs,FCAC,1780,297,1483,-1186,3,164,1440,3,NASDAQ
4630,12-02-2021 18:00,24 hrs.,SPACs,FTOC,7,0,7,-7,1,1,1,1,NASDAQ
4630,12-02-2021 18:00,24 hrs.,SPACs,FVAM,203,203,0,203,1,56,87,1,NASDAQ
4630,12-02-2021 18:00,24 hrs.,SPACs,GNRS,203,203,0,203,1,56,87,1,NASDAQ
4630,12-02-2021 18:00,24 hrs.,SPACs,GRCY,203,203,0,203,1,56,87,1,NASDAQ
4630,12-02-2021 18:00,24 hrs.,SPACs,GRNV,203,203,0,203,1,56,87,1,NASDAQ
4630,12-02-2021 18:00,24 hrs.,SPACs,GRSV,203,203,0,203,1,56,87,1,NASDAQ
4630,12-02-2021 18:00,24 hrs.,SPACs,GWAC,203,203,0,203,1,56,87,1,NASDAQ
4630,12-02-2021 18:00,24 hrs.,SPACs,GXGX,203,203,0,203,1,56,87,1,NASDAQ
4630,12-02-2021 18:00,24 hrs.,SPACs,IGAC,203,203,0,203,1,56,87,1,NASDAQ
4630,12-02-2021 18:00,24 hrs.,wallstreetbets,USMJ,13,13,0,13,2,2,1,2,OTC
4630,12-02-2021 18:00,24 hrs.,wallstreetbets,UVSE,7,7,0,7,1,1,1,1,OTC
4630,12-02-2021 18:00,24 hrs.,wallstreetbets,VBIO,6,0,6,-6,1,1,0,1,OTC
4630,12-02-2021 18:00,24 hrs.,wallstreetbets,VTLR,7,7,0,7,1,1,1,1,OTC
4630,12-02-2021 18:00,24 hrs.,wallstreetbets,WARM,18,0,18,-18,3,3,0,1,OTC
4630,12-02-2021 18:00,24 hrs.,wallstreetbets,WDDD,7,7,0,7,1,1,1,1,OTC
4630,12-02-2021 18:00,24 hrs.,wallstreetbets,WHEN,25,19,6,13,4,4,1,4,OTC
4630,12-02-2021 18:00,24 hrs.,wallstreetbets,WNDW,6,0,6,-6,1,1,0,1,OTC
4630,12-02-2021 18:00,24 hrs.,wallstreetbets,WSSE,7,7,0,7,1,1,1,1,OTC
4630,12-02-2021 18:00,24 hrs.,wallstreetbets,ZMRK,7,7,0,7,1,1,1,1,OTC
4630,12-02-2021 18:00,24 hrs.,wallstreetbets,ZNOG,13,7,6,1,2,2,1,2,OTC
4630,12-02-2021 18:00,24 hrs.,wallstreetbets,ABEPF,6,0,6,-6,1,1,0,1,OTC
4630,12-02-2021 18:00,24 hrs.,wallstreetbets,AMYZF,23,23,0,23,3,3,5,2,OTC
4630,12-02-2021 18:00,24 hrs.,SPACs,ATAC,203,203,0,203,1,56,87,1,NYSE
4630,12-02-2021 18:00,24 hrs.,SPACs,AVAN,203,203,0,203,1,56,87,1,NYSE
4630,12-02-2021 18:00,24 hrs.,SPACs,BOAC,251,251,0,251,2,69,105,2,NYSE
4630,12-02-2021 18:00,24 hrs.,SPACs,CCIV,3563,427,3136,-2709,18,799,1893,17,NYSE
4630,12-02-2021 18:00,24 hrs.,SPACs,CLII,49,0,49,-49,3,13,11,3,NYSE
4630,12-02-2021 18:00,24 hrs.,SPACs,CPSR,203,203,0,203,1,56,87,1,NYSE
4630,12-02-2021 18:00,24 hrs.,SPACs,CTAC,203,203,0,203,1,56,87,1,NYSE
4630,12-02-2021 18:00,24 hrs.,SPACs,DFNS,240,240,0,240,2,71,90,2,NYSE
4630,12-02-2021 18:00,24 hrs.,SPACs,DGNR,245,245,0,245,1,102,37,1,NYSE
4630,12-02-2021 18:00,24 hrs.,SPACs,DMYD,327,327,0,327,2,116,87,2,NYSE
4630,12-02-2021 18:00,24 hrs.,wallstreetbets,DFLYF,33,0,33,-33,3,2,17,2,OTC
4630,12-02-2021 18:00,24 hrs.,wallstreetbets,DIAAF,7,7,0,7,1,1,1,1,OTC
4630,12-02-2021 18:00,24 hrs.,wallstreetbets,EHVVF,6,0,6,-6,1,1,0,1,OTC
4630,12-02-2021 18:00,24 hrs.,wallstreetbets,EPWCF,12,0,12,-12,1,0,8,1,OTC
4630,12-02-2021 18:00,24 hrs.,wallstreetbets,FDVRF,12,6,6,0,2,2,0,2,OTC
4630,12-02-2021 18:00,24 hrs.,wallstreetbets,FGPHF,6,0,6,-6,1,1,0,1,OTC
4630,12-02-2021 18:00,24 hrs.,wallstreetbets,FLWPF,13,0,13,-13,2,2,1,2,OTC
4630,12-02-2021 18:00,24 hrs.,wallstreetbets,GAYMF,20,6,14,-8,3,3,2,3,OTC
4630,12-02-2021 18:00,24 hrs.,wallstreetbets,GGTTF,12,0,12,-12,2,2,0,1,OTC
4630,12-02-2021 18:00,24 hrs.,wallstreetbets,GPORQ,6,0,6,-6,1,1,0,1,OTC
4630,12-02-2021 18:00,24 hrs.,wallstreetbets,GTBIF,7,0,7,-7,1,1,1,1,OTC
4630,12-02-2021 18:00,24 hrs.,wallstreetbets,GUESF,6,0,6,-6,1,1,0,1,OTC
4630,12-02-2021 18:00,24 hrs.,wallstreetbets,HITIF,19,7,12,-5,3,3,1,3,OTC
4630,12-02-2021 18:00,24 hrs.,wallstreetbets,HRSTW,11,11,0,11,2,1,1,1,OTC
4630,12-02-2021 18:00,24 hrs.,wallstreetbets,HUTMF,13,13,0,13,2,2,1,2,OTC
4630,12-02-2021 18:00,24 hrs.,wallstreetbets,HVBTF,22,22,0,22,3,3,4,3,OTC
4630,12-02-2021 18:00,24 hrs.,wallstreetbets,IGCIW,49,49,0,49,7,7,7,2,OTC
4630,12-02-2021 18:00,24 hrs.,wallstreetbets,ISCNF,7,7,0,7,1,1,1,1,OTC
4630,12-02-2021 18:00,24 hrs.,wallstreetbets,ITHUF,7,7,0,7,1,1,1,1,OTC
4630,12-02-2021 18:00,24 hrs.,wallstreetbets,KBEVF,7,7,0,7,1,1,1,1,OTC
4630,12-02-2021 18:00,24 hrs.,wallstreetbets,KPIFF,6,0,6,-6,1,1,0,1,OTC
4630,12-02-2021 18:00,24 hrs.,wallstreetbets,LHSIF,7,7,0,7,1,1,1,1,OTC
4630,12-02-2021 18:00,24 hrs.,wallstreetbets,LITOF,6,0,6,-6,1,1,0,1,OTC
4630,12-02-2021 18:00,24 hrs.,wallstreetbets,LKNCY,6,6,0,6,1,1,0,1,OTC
4630,12-02-2021 18:00,24 hrs.,wallstreetbets,LLKKF,6,0,6,-6,1,1,0,1,OTC
4630,12-02-2021 18:00,24 hrs.,wallstreetbets,LMLLF,6,0,6,-6,1,1,0,1,OTC
4630,12-02-2021 18:00,24 hrs.,wallstreetbets,LTMCF,12,0,12,-12,2,2,0,2,OTC
4630,12-02-2021 18:00,24 hrs.,wallstreetbets,LXXGF,8,0,8,-8,1,1,2,1,OTC
4630,12-02-2021 18:00,24 hrs.,wallstreetbets,MEDIF,6,6,0,6,1,1,0,1,OTC
4630,12-02-2021 18:00,24 hrs.,wallstreetbets,MMEDF,1803,1791,12,1779,7,717,341,6,OTC
4630,12-02-2021 18:00,24 hrs.,wallstreetbets,MMNFF,19,0,19,-19,3,3,1,3,OTC
4630,12-02-2021 18:00,24 hrs.,wallstreetbets,MNKKQ,14,0,14,-14,2,2,2,1,OTC
4630,12-02-2021 18:00,24 hrs.,wallstreetbets,NMGRF,6,0,6,-6,1,1,0,1,OTC
4630,12-02-2021 18:00,24 hrs.,wallstreetbets,NSANY,6,0,6,-6,1,1,0,1,OTC
4630,12-02-2021 18:00,24 hrs.,wallstreetbets,NTDOY,15,15,0,15,2,2,3,2,OTC
4630,12-02-2021 18:00,24 hrs.,wallstreetbets,NTSFF,6,0,6,-6,1,1,0,1,OTC
4630,12-02-2021 18:00,24 hrs.,wallstreetbets,NXGWF,20,13,7,6,3,3,2,2,OTC
4630,12-02-2021 18:00,24 hrs.,wallstreetbets,NXTTF,14,14,0,14,2,2,2,1,OTC
4630,12-02-2021 18:00,24 hrs.,wallstreetbets,PDYPF,7,7,0,7,1,1,1,1,OTC
4630,12-02-2021 18:00,24 hrs.,wallstreetbets,PFFOF,6,0,6,-6,1,1,0,1,OTC
4630,12-02-2021 18:00,24 hrs.,wallstreetbets,PLNHF,6,0,6,-6,1,1,0,1,OTC
4630,12-02-2021 18:00,24 hrs.,wallstreetbets,RAZFF,14,7,7,0,2,2,2,2,OTC
4630,12-02-2021 18:00,24 hrs.,wallstreetbets,RLLCF,43,43,0,43,6,6,7,6,OTC
4630,12-02-2021 18:00,24 hrs.,wallstreetbets,RYCEY,442,396,46,350,16,112,154,14,OTC
4630,12-02-2021 18:00,24 hrs.,wallstreetbets,SHECY,87,0,87,-87,1,29,25,1,OTC
4630,12-02-2021 18:00,24 hrs.,wallstreetbets,SHERF,6,0,6,-6,1,1,0,1,OTC
4630,12-02-2021 18:00,24 hrs.,wallstreetbets,SPRWF,90,28,62,-34,13,15,8,10,OTC
4630,12-02-2021 18:00,24 hrs.,wallstreetbets,TAKOF,247,0,247,-247,1,95,53,1,OTC
4630,12-02-2021 18:00,24 hrs.,wallstreetbets,TCNNF,1397,1397,0,1397,5,619,139,1,OTC
4630,12-02-2021 18:00,24 hrs.,wallstreetbets,TGODF,12,0,12,-12,2,2,0,1,OTC
4630,12-02-2021 18:00,24 hrs.,wallstreetbets,TLOFF,7,0,7,-7,1,1,1,1,OTC
4630,12-02-2021 18:00,24 hrs.,wallstreetbets,TPPRF,14,14,0,14,2,2,2,1,OTC
4630,12-02-2021 18:00,24 hrs.,wallstreetbets,TSCRF,7,0,7,-7,1,1,1,1,OTC
4630,12-02-2021 18:00,24 hrs.,wallstreetbets,TXLZF,7,7,0,7,1,1,1,1,OTC
4630,12-02-2021 18:00,24 hrs.,SPACs,VGAC,1483,0,1483,-1483,1,44,1391,1,NYSE
4630,12-02-2021 18:00,24 hrs.,SPACs,VYGG,6,6,0,6,1,0,2,1,NYSE
4630,12-02-2021 18:00,24 hrs.,SPACs,ADV,1686,203,1483,-1280,2,100,1478,2,NASDAQ
4630,12-02-2021 18:00,24 hrs.,SPACs,ESG,110,110,0,110,1,35,36,1,NASDAQ
4630,12-02-2021 18:00,24 hrs.,SPACs,HOL,1490,0,1490,-1490,2,45,1392,2,NASDAQ
4630,12-02-2021 18:00,24 hrs.,SPACs,LCY,203,203,0,203,1,56,87,1,NASDAQ
4630,12-02-2021 18:00,24 hrs.,SPACs,NPA,1617,31,1586,-1555,4,94,1413,4,NASDAQ
4630,12-02-2021 18:00,24 hrs.,SPACs,VIH,29,29,0,29,1,9,7,1,NASDAQ
4630,12-02-2021 18:00,24 hrs.,SPACs,ACAC,119,0,119,-119,1,36,43,1,NASDAQ
4630,12-02-2021 18:00,24 hrs.,SPACs,ACEV,231,40,191,-151,7,60,83,4,NASDAQ
4630,12-02-2021 18:00,24 hrs.,SPACs,DSACW,1483,0,1483,-1483,1,44,1391,1,NASDAQ
4630,12-02-2021 18:00,24 hrs.,SPACs,EXPCW,1483,0,1483,-1483,1,44,1391,1,NASDAQ
4630,12-02-2021 18:00,24 hrs.,SPACs,FCACW,1483,0,1483,-1483,1,44,1391,1,NASDAQ
4630,12-02-2021 18:00,24 hrs.,SPACs,SAIIW,1483,0,1483,-1483,1,44,1391,1,NASDAQ
4630,12-02-2021 18:00,24 hrs.,SPACs,THCAW,1483,0,1483,-1483,1,44,1391,1,NASDAQ
4630,12-02-2021 18:00,24 hrs.,stocks,ABML,6,6,0,6,1,1,0,1,OTC
4630,12-02-2021 18:00,24 hrs.,stocks,AITX,6,0,6,-6,1,1,0,1,OTC
4630,12-02-2021 18:00,24 hrs.,stocks,ALPP,6,0,6,-6,1,1,0,1,OTC
4630,12-02-2021 18:00,24 hrs.,stocks,APTY,6,6,0,6,1,1,0,1,OTC
4630,12-02-2021 18:00,24 hrs.,stocks,BIEL,6,0,6,-6,1,1,0,1,OTC
4630,12-02-2021 18:00,24 hrs.,stocks,CAGR,24,0,24,-24,1,3,14,1,OTC
4630,12-02-2021 18:00,24 hrs.,stocks,CANN,6,6,0,6,1,1,0,1,OTC
4630,12-02-2021 18:00,24 hrs.,stocks,CORG,6,0,6,-6,1,1,0,1,OTC
4630,12-02-2021 18:00,24 hrs.,stocks,DIGI,6,6,0,6,1,1,0,1,OTC
4630,12-02-2021 18:00,24 hrs.,stocks,FNMA,6,0,6,-6,1,1,0,1,OTC
4630,12-02-2021 18:00,24 hrs.,stocks,GTEH,6,6,0,6,1,1,0,1,OTC
4630,12-02-2021 18:00,24 hrs.,stocks,HCMC,31,6,25,-19,5,5,1,5,OTC
4630,12-02-2021 18:00,24 hrs.,stocks,HEMP,6,0,6,-6,1,1,0,1,OTC
4630,12-02-2021 18:00,24 hrs.,stocks,KGKG,6,0,6,-6,1,1,0,1,OTC
4630,12-02-2021 18:00,24 hrs.,stocks,KYNC,18,0,18,-18,3,3,0,1,OTC
4630,12-02-2021 18:00,24 hrs.,stocks,LINK,8,8,0,8,1,1,2,1,OTC
4630,12-02-2021 18:00,24 hrs.,stocks,MCAP,6,6,0,6,1,1,0,1,OTC
4630,12-02-2021 18:00,24 hrs.,stocks,MJNA,12,6,6,0,2,2,0,2,OTC
4630,12-02-2021 18:00,24 hrs.,stocks,MOJO,6,6,0,6,1,1,0,1,OTC
4630,12-02-2021 18:00,24 hrs.,stocks,NTRR,6,6,0,6,1,1,0,1,OTC
4630,12-02-2021 18:00,24 hrs.,stocks,OZSC,6,6,0,6,1,1,0,1,OTC
4630,12-02-2021 18:00,24 hrs.,stocks,PURA,6,0,6,-6,1,1,0,1,OTC
4630,12-02-2021 18:00,24 hrs.,stocks,PZOO,6,0,6,-6,1,1,0,1,OTC
4630,12-02-2021 18:00,24 hrs.,stocks,RSSV,15,15,0,15,1,4,3,1,OTC
4630,12-02-2021 18:00,24 hrs.,stocks,SGMD,36,0,36,-36,6,6,0,2,OTC
4630,12-02-2021 18:00,24 hrs.,stocks,SUIC,6,0,6,-6,1,1,0,1,OTC
4630,12-02-2021 18:00,24 hrs.,stocks,TMRC,6,6,0,6,1,1,0,1,OTC
4630,12-02-2021 18:00,24 hrs.,stocks,TSTS,6,0,6,-6,1,1,0,1,OTC
4630,12-02-2021 18:00,24 hrs.,stocks,USPS,67,0,67,-67,1,25,13,1,OTC
4630,12-02-2021 18:00,24 hrs.,SPACs,ITAC,203,203,0,203,1,56,87,1,NASDAQ
4630,12-02-2021 18:00,24 hrs.,SPACs,JYAC,446,203,243,-40,2,171,96,2,NASDAQ
4630,12-02-2021 18:00,24 hrs.,SPACs,KERN,23,23,0,23,1,2,15,1,NASDAQ
4630,12-02-2021 18:00,24 hrs.,SPACs,KSMT,203,203,0,203,1,56,87,1,NASDAQ
4630,12-02-2021 18:00,24 hrs.,SPACs,LATN,203,203,0,203,1,56,87,1,NASDAQ
4630,12-02-2021 18:00,24 hrs.,SPACs,LCAP,203,203,0,203,1,56,87,1,NASDAQ
4630,12-02-2021 18:00,24 hrs.,SPACs,LFTR,203,203,0,203,1,56,87,1,NASDAQ
4630,12-02-2021 18:00,24 hrs.,SPACs,LIVK,203,203,0,203,1,56,87,1,NASDAQ
4630,12-02-2021 18:00,24 hrs.,SPACs,MAAC,203,203,0,203,1,56,87,1,NASDAQ
4630,12-02-2021 18:00,24 hrs.,SPACs,MACU,203,203,0,203,1,56,87,1,NASDAQ
4630,12-02-2021 18:00,24 hrs.,SPACs,MCMJ,203,203,0,203,1,56,87,1,NASDAQ
4630,12-02-2021 18:00,24 hrs.,SPACs,MLAC,203,203,0,203,1,56,87,1,NASDAQ
4630,12-02-2021 18:00,24 hrs.,wallstreetbets,VALPQ,7,0,7,-7,1,1,1,1,OTC
4630,12-02-2021 18:00,24 hrs.,wallstreetbets,VEGGF,6,0,6,-6,1,1,0,1,OTC
4630,12-02-2021 18:00,24 hrs.,wallstreetbets,VLNCF,6,0,6,-6,1,1,0,1,OTC
4630,12-02-2021 18:00,24 hrs.,wallstreetbets,VVCIF,7,0,7,-7,1,1,1,1,OTC
4630,12-02-2021 18:00,24 hrs.,wallstreetbets,VYGVF,12,0,12,-12,1,2,4,1,OTC
4630,12-02-2021 18:00,24 hrs.,wallstreetbets,WDDMF,7,7,0,7,1,1,1,1,OTC
4630,12-02-2021 18:00,24 hrs.,wallstreetbets,WPMLF,8,0,8,-8,1,1,2,1,OTC
4630,12-02-2021 18:00,24 hrs.,wallstreetbets,AAU,14,14,0,14,2,2,2,2,AMEX
4630,12-02-2021 18:00,24 hrs.,wallstreetbets,ARBKF,7,0,7,-7,1,1,1,1,OTC
4630,12-02-2021 18:00,24 hrs.,wallstreetbets,ATURF,7,7,0,7,1,1,1,1,OTC
4630,12-02-2021 18:00,24 hrs.,wallstreetbets,AYRWF,6,0,6,-6,1,1,0,1,OTC
4630,12-02-2021 18:00,24 hrs.,wallstreetbets,BDRBF,57,20,37,-17,9,9,3,9,OTC
4630,12-02-2021 18:00,24 hrs.,wallstreetbets,BLOZF,6,0,6,-6,1,1,0,1,OTC
4630,12-02-2021 18:00,24 hrs.,wallstreetbets,BUSXF,6,0,6,-6,1,1,0,1,OTC
4630,12-02-2021 18:00,24 hrs.,wallstreetbets,CBWTF,23,0,23,-23,3,2,7,3,OTC
4630,12-02-2021 18:00,24 hrs.,wallstreetbets,CLXPF,7,7,0,7,1,1,1,1,OTC
4630,12-02-2021 18:00,24 hrs.,wallstreetbets,CNTTQ,6,0,6,-6,1,1,0,1,OTC
4630,12-02-2021 18:00,24 hrs.,wallstreetbets,CRLBF,19,12,7,5,3,3,1,3,OTC
4630,12-02-2021 18:00,24 hrs.,wallstreetbets,ISR,6,0,6,-6,1,1,0,1,AMEX
4630,12-02-2021 18:00,24 hrs.,wallstreetbets,ITP,13,7,6,1,2,2,1,2,AMEX
4630,12-02-2021 18:00,24 hrs.,wallstreetbets,KIQ,12,0,12,-12,2,2,0,1,AMEX
4630,12-02-2021 18:00,24 hrs.,wallstreetbets,LSF,7,0,7,-7,1,1,1,1,AMEX
4630,12-02-2021 18:00,24 hrs.,wallstreetbets,MXC,21,14,7,7,3,3,3,3,AMEX
4630,12-02-2021 18:00,24 hrs.,wallstreetbets,NAK,121,44,77,-33,19,19,7,16,AMEX
4630,12-02-2021 18:00,24 hrs.,wallstreetbets,NGD,15,0,15,-15,2,2,3,1,AMEX
4630,12-02-2021 18:00,24 hrs.,wallstreetbets,NXE,6,0,6,-6,1,1,0,1,AMEX
4630,12-02-2021 18:00,24 hrs.,wallstreetbets,PTN,7,7,0,7,1,1,1,1,AMEX
4630,12-02-2021 18:00,24 hrs.,wallstreetbets,REI,7,7,0,7,1,1,1,1,AMEX
4630,12-02-2021 18:00,24 hrs.,wallstreetbets,SYN,26,14,12,2,4,4,2,3,AMEX
4630,12-02-2021 18:00,24 hrs.,wallstreetbets,TMQ,8,8,0,8,1,1,2,1,AMEX
4630,12-02-2021 18:00,24 hrs.,wallstreetbets,TRX,112,55,57,-2,17,17,10,11,AMEX
4630,12-02-2021 18:00,24 hrs.,wallstreetbets,URG,7,0,7,-7,1,1,1,1,AMEX
4630,12-02-2021 18:00,24 hrs.,wallstreetbets,ZOM,218,88,130,-42,33,33,20,29,AMEX
4630,12-02-2021 18:00,24 hrs.,wallstreetbets,AMPE,21,21,0,21,3,3,3,2,AMEX
4630,12-02-2021 18:00,24 hrs.,wallstreetbets,EMAN,7,0,7,-7,1,1,1,1,AMEX
4630,12-02-2021 18:00,24 hrs.,wallstreetbets,GSAT,134,35,99,-64,21,21,8,10,AMEX
4630,12-02-2021 18:00,24 hrs.,wallstreetbets,HUSA,7,7,0,7,1,1,1,1,AMEX
4630,12-02-2021 18:00,24 hrs.,wallstreetbets,IBIO,18,0,18,-18,3,3,0,1,AMEX
4630,12-02-2021 18:00,24 hrs.,wallstreetbets,LODE,12,6,6,0,2,2,0,2,AMEX
4630,12-02-2021 18:00,24 hrs.,wallstreetbets,NSPR,7,0,7,-7,1,1,1,1,AMEX
4630,12-02-2021 18:00,24 hrs.,wallstreetbets,OGEN,27,14,13,1,4,4,3,4,AMEX
4630,12-02-2021 18:00,24 hrs.,wallstreetbets,RLGT,21,14,7,7,3,3,3,2,AMEX
4630,12-02-2021 18:00,24 hrs.,wallstreetbets,SENS,225,166,59,107,18,46,61,16,AMEX
4630,12-02-2021 18:00,24 hrs.,wallstreetbets,TMBR,26,14,12,2,4,4,2,4,AMEX
4630,12-02-2021 18:00,24 hrs.,wallstreetbets,TRXC,40,19,21,-2,6,6,4,5,AMEX
4630,12-02-2021 18:00,24 hrs.,wallstreetbets,UAVS,27,14,13,1,4,4,3,3,AMEX
4630,12-02-2021 18:00,24 hrs.,wallstreetbets,UUUU,21,7,14,-7,3,3,3,2,AMEX
4630,12-02-2021 18:00,24 hrs.,wallstreetbets,YCBD,14,7,7,0,2,2,2,2,AMEX
4630,12-02-2021 18:00,24 hrs.,wallstreetbets,ABT,13,13,0,13,2,2,1,2,NYSE
4630,12-02-2021 18:00,24 hrs.,wallstreetbets,ACB,175,83,92,-9,27,27,13,22,NYSE
4630,12-02-2021 18:00,24 hrs.,wallstreetbets,ACI,6,0,6,-6,1,1,0,1,NYSE
4630,12-02-2021 18:00,24 hrs.,wallstreetbets,ADT,6,0,6,-6,1,1,0,1,NYSE
4630,12-02-2021 18:00,24 hrs.,SPACs,MOTN,203,203,0,203,1,56,87,1,NASDAQ
4630,12-02-2021 18:00,24 hrs.,SPACs,NGAC,467,0,467,-467,2,206,47,2,NASDAQ
4630,12-02-2021 18:00,24 hrs.,SPACs,OTRA,203,203,0,203,1,56,87,1,NASDAQ
4630,12-02-2021 18:00,24 hrs.,SPACs,PAIC,203,203,0,203,1,56,87,1,NASDAQ
4630,12-02-2021 18:00,24 hrs.,SPACs,PLUG,6,6,0,6,1,1,0,1,NASDAQ
4630,12-02-2021 18:00,24 hrs.,SPACs,QELL,394,245,149,96,3,122,138,3,NASDAQ
4630,12-02-2021 18:00,24 hrs.,SPACs,RCHG,203,203,0,203,1,56,87,1,NASDAQ
4630,12-02-2021 18:00,24 hrs.,SPACs,RIDE,6,6,0,6,1,1,0,1,NASDAQ
4630,12-02-2021 18:00,24 hrs.,SPACs,ROCH,1483,0,1483,-1483,1,44,1391,1,NASDAQ
4630,12-02-2021 18:00,24 hrs.,SPACs,SGAM,203,203,0,203,1,56,87,1,NASDAQ
4630,12-02-2021 18:00,24 hrs.,SPACs,SRAC,31,31,0,31,1,11,5,1,NASDAQ
4630,12-02-2021 18:00,24 hrs.,SPACs,STWO,203,203,0,203,1,56,87,1,NASDAQ
4630,12-02-2021 18:00,24 hrs.,SPACs,SVAC,203,203,0,203,1,56,87,1,NASDAQ
4630,12-02-2021 18:00,24 hrs.,SPACs,TEKK,203,203,0,203,1,56,87,1,NASDAQ
4630,12-02-2021 18:00,24 hrs.,SPACs,THBR,1504,21,1483,-1462,2,45,1406,2,NASDAQ
4630,12-02-2021 18:00,24 hrs.,SPACs,THCA,203,203,0,203,1,56,87,1,NASDAQ
4630,12-02-2021 18:00,24 hrs.,SPACs,THCB,13,6,7,-1,2,2,1,2,NASDAQ
4630,12-02-2021 18:00,24 hrs.,SPACs,TLRY,14,0,14,-14,1,0,10,1,NASDAQ
4630,12-02-2021 18:00,24 hrs.,SPACs,TMPM,203,203,0,203,1,56,87,1,NASDAQ
4630,12-02-2021 18:00,24 hrs.,SPACs,TMTS,203,203,0,203,1,56,87,1,NASDAQ
4630,12-02-2021 18:00,24 hrs.,SPACs,TTCF,103,0,103,-103,1,20,59,1,NASDAQ
4630,12-02-2021 18:00,24 hrs.,SPACs,TWCT,203,203,0,203,1,56,87,1,NASDAQ
4630,12-02-2021 18:00,24 hrs.,SPACs,UNIT,21,0,21,-21,1,2,13,1,NASDAQ
4630,12-02-2021 18:00,24 hrs.,SPACs,VACQ,203,203,0,203,1,56,87,1,NASDAQ
4630,12-02-2021 18:00,24 hrs.,SPACs,VMAC,1700,210,1490,-1280,4,102,1480,4,NASDAQ
4630,12-02-2021 18:00,24 hrs.,SPACs,VSPR,49,0,49,-49,1,14,17,1,NASDAQ
4630,12-02-2021 18:00,24 hrs.,SPACs,VTIQ,15,15,0,15,1,3,5,1,NASDAQ
4630,12-02-2021 18:00,24 hrs.,SPACs,YSAC,203,203,0,203,1,56,87,1,NASDAQ
4630,12-02-2021 18:00,24 hrs.,SPACs,ZGYH,203,203,0,203,1,56,87,1,NASDAQ
4630,12-02-2021 18:00,24 hrs.,SPACs,CMLFW,1483,0,1483,-1483,1,44,1391,1,NASDAQ
4630,12-02-2021 18:00,24 hrs.,wallstreetbets,AIR,13,13,0,13,2,2,1,2,NYSE
4630,12-02-2021 18:00,24 hrs.,wallstreetbets,AIV,6,6,0,6,1,1,0,1,NYSE
4630,12-02-2021 18:00,24 hrs.,wallstreetbets,AMC,9997,4679,5318,-639,264,3856,1229,224,NYSE
4630,12-02-2021 18:00,24 hrs.,wallstreetbets,AMP,48,21,27,-6,7,7,6,7,NYSE
4630,12-02-2021 18:00,24 hrs.,wallstreetbets,ASX,21,7,14,-7,3,3,3,3,NYSE
4630,12-02-2021 18:00,24 hrs.,wallstreetbets,ATH,27,21,6,15,3,6,3,3,NYSE
4630,12-02-2021 18:00,24 hrs.,wallstreetbets,AUY,54,42,12,30,8,8,6,4,NYSE
4630,12-02-2021 18:00,24 hrs.,wallstreetbets,AXP,1374,1374,0,1374,2,615,136,1,NYSE
4630,12-02-2021 18:00,24 hrs.,wallstreetbets,AYX,6,0,6,-6,1,1,0,1,NYSE
4630,12-02-2021 18:00,24 hrs.,wallstreetbets,BBW,19,6,13,-7,3,3,1,3,NYSE
4630,12-02-2021 18:00,24 hrs.,wallstreetbets,BBY,14,0,14,-14,2,2,2,1,NYSE
4630,12-02-2021 18:00,24 hrs.,wallstreetbets,BFT,7,0,7,-7,1,1,1,1,NYSE
4630,12-02-2021 18:00,24 hrs.,wallstreetbets,BGS,6,0,6,-6,1,1,0,1,NYSE
4630,12-02-2021 18:00,24 hrs.,wallstreetbets,BHC,409,388,21,367,5,156,77,3,NYSE
4630,12-02-2021 18:00,24 hrs.,wallstreetbets,BIO,6,0,6,-6,1,1,0,1,NYSE
4630,12-02-2021 18:00,24 hrs.,wallstreetbets,BIT,7,0,7,-7,1,1,1,1,NYSE
4630,12-02-2021 18:00,24 hrs.,wallstreetbets,BTT,51,19,32,-13,8,8,3,8,NYSE
4630,12-02-2021 18:00,24 hrs.,wallstreetbets,BUD,8,0,8,-8,1,1,2,1,NYSE
4630,12-02-2021 18:00,24 hrs.,wallstreetbets,CAT,7,7,0,7,1,1,1,1,NYSE
4630,12-02-2021 18:00,24 hrs.,wallstreetbets,CBD,40,7,33,-26,5,7,6,4,NYSE
4630,12-02-2021 18:00,24 hrs.,wallstreetbets,CHS,8,0,8,-8,1,1,2,1,NYSE
4630,12-02-2021 18:00,24 hrs.,wallstreetbets,COO,6,0,6,-6,1,1,0,1,NYSE
4630,12-02-2021 18:00,24 hrs.,wallstreetbets,CPG,7,7,0,7,1,1,1,1,NYSE
4630,12-02-2021 18:00,24 hrs.,wallstreetbets,CRL,6,0,6,-6,1,1,0,1,NYSE
4630,12-02-2021 18:00,24 hrs.,wallstreetbets,CUB,37,0,37,-37,6,6,1,1,NYSE
4630,12-02-2021 18:00,24 hrs.,wallstreetbets,CVA,7,0,7,-7,1,1,1,1,NYSE
4630,12-02-2021 18:00,24 hrs.,wallstreetbets,CVS,13,0,13,-13,2,2,1,2,NYSE
4630,12-02-2021 18:00,24 hrs.,wallstreetbets,DAC,7,7,0,7,1,1,1,1,NYSE
4630,12-02-2021 18:00,24 hrs.,wallstreetbets,DAL,239,13,226,-213,3,82,63,3,NYSE
4630,12-02-2021 18:00,24 hrs.,wallstreetbets,DAO,12,12,0,12,2,2,0,1,NYSE
4630,12-02-2021 18:00,24 hrs.,wallstreetbets,DCF,243,0,243,-243,1,87,65,1,NYSE
4630,12-02-2021 18:00,24 hrs.,wallstreetbets,DDD,6,0,6,-6,1,1,0,1,NYSE
4630,12-02-2021 18:00,24 hrs.,wallstreetbets,DIS,2570,402,2168,-1766,15,1065,380,15,NYSE
4630,12-02-2021 18:00,24 hrs.,wallstreetbets,DNB,7,0,7,-7,1,1,1,1,NYSE
4630,12-02-2021 18:00,24 hrs.,stocks,ACRDF,6,6,0,6,1,1,0,1,OTC
4630,12-02-2021 18:00,24 hrs.,stocks,ACRHF,6,6,0,6,1,1,0,1,OTC
4630,12-02-2021 18:00,24 hrs.,stocks,BDRBF,6,6,0,6,1,1,0,1,OTC
4630,12-02-2021 18:00,24 hrs.,stocks,CBWTF,12,0,12,-12,2,2,0,2,OTC
4630,12-02-2021 18:00,24 hrs.,stocks,DGTHF,6,6,0,6,1,1,0,1,OTC
4630,12-02-2021 18:00,24 hrs.,stocks,FLWPF,6,0,6,-6,1,1,0,1,OTC
4630,12-02-2021 18:00,24 hrs.,stocks,GGTTF,6,0,6,-6,1,1,0,1,OTC
4630,12-02-2021 18:00,24 hrs.,stocks,HITIF,6,0,6,-6,1,1,0,1,OTC
4630,12-02-2021 18:00,24 hrs.,stocks,MMNFF,12,0,12,-12,2,2,0,1,OTC
4630,12-02-2021 18:00,24 hrs.,stocks,RHDGF,6,6,0,6,1,1,0,1,OTC
4630,12-02-2021 18:00,24 hrs.,stocks,RLLCF,12,12,0,12,2,2,0,1,OTC
4630,12-02-2021 18:00,24 hrs.,stocks,SFTBY,22,0,22,-22,1,7,4,1,OTC
4630,12-02-2021 18:00,24 hrs.,stocks,VLNCF,6,0,6,-6,1,1,0,1,OTC
4630,12-02-2021 18:00,24 hrs.,stocks,DNN,35,0,35,-35,3,4,15,3,AMEX
4630,12-02-2021 18:00,24 hrs.,stocks,DPW,12,0,12,-12,1,3,2,1,AMEX
4630,12-02-2021 18:00,24 hrs.,stocks,DSS,6,6,0,6,1,1,0,1,AMEX
4630,12-02-2021 18:00,24 hrs.,stocks,GDP,31,31,0,31,1,4,19,1,AMEX
4630,12-02-2021 18:00,24 hrs.,wallstreetbets,AGE,6,0,6,-6,1,1,0,1,AMEX
4630,12-02-2021 18:00,24 hrs.,wallstreetbets,BTN,8,8,0,8,1,1,2,1,AMEX
4630,12-02-2021 18:00,24 hrs.,wallstreetbets,CEI,12,0,12,-12,2,2,0,1,AMEX
4630,12-02-2021 18:00,24 hrs.,wallstreetbets,DIT,6,6,0,6,1,1,0,1,AMEX
4630,12-02-2021 18:00,24 hrs.,wallstreetbets,DNN,245,110,135,-25,37,38,21,31,AMEX
4630,12-02-2021 18:00,24 hrs.,wallstreetbets,DPW,13,0,13,-13,2,2,1,2,AMEX
4630,12-02-2021 18:00,24 hrs.,wallstreetbets,FEN,7,0,7,-7,1,1,1,1,AMEX
4630,12-02-2021 18:00,24 hrs.,wallstreetbets,GDP,146,146,0,146,2,40,58,2,AMEX
4630,12-02-2021 18:00,24 hrs.,wallstreetbets,GLU,7,7,0,7,1,1,1,1,AMEX
4630,12-02-2021 18:00,24 hrs.,wallstreetbets,GPL,6,0,6,-6,1,1,0,1,AMEX
4630,12-02-2021 18:00,24 hrs.,wallstreetbets,GSV,33,0,33,-33,5,5,3,5,AMEX
4630,12-02-2021 18:00,24 hrs.,wallstreetbets,GTE,96,20,76,-56,15,15,6,14,AMEX
4630,12-02-2021 18:00,24 hrs.,wallstreetbets,IGC,7,0,7,-7,1,1,1,1,AMEX
4630,12-02-2021 18:00,24 hrs.,wallstreetbets,DTE,1096,133,963,-830,2,451,186,2,NYSE
4630,12-02-2021 18:00,24 hrs.,wallstreetbets,EAT,21,7,14,-7,3,3,3,3,NYSE
4630,12-02-2021 18:00,24 hrs.,wallstreetbets,EMO,6,0,6,-6,1,1,0,1,NYSE
4630,12-02-2021 18:00,24 hrs.,wallstreetbets,ENJ,6,0,6,-6,1,1,0,1,NYSE
4630,12-02-2021 18:00,24 hrs.,wallstreetbets,EOS,13,0,13,-13,2,2,1,2,NYSE
4630,12-02-2021 18:00,24 hrs.,wallstreetbets,EXP,6,6,0,6,1,1,0,1,NYSE
4630,12-02-2021 18:00,24 hrs.,wallstreetbets,FAF,6,0,6,-6,1,1,0,1,NYSE
4630,12-02-2021 18:00,24 hrs.,wallstreetbets,FCF,243,0,243,-243,1,87,65,1,NYSE
4630,12-02-2021 18:00,24 hrs.,wallstreetbets,FCX,106,28,78,-50,6,25,32,3,NYSE
4630,12-02-2021 18:00,24 hrs.,wallstreetbets,FLT,25,7,18,-11,4,4,1,3,NYSE
4630,12-02-2021 18:00,24 hrs.,wallstreetbets,FMC,13,13,0,13,2,2,1,1,NYSE
4630,12-02-2021 18:00,24 hrs.,wallstreetbets,FMS,13,0,13,-13,2,2,1,2,NYSE
4630,12-02-2021 18:00,24 hrs.,wallstreetbets,FOF,6,0,6,-6,1,1,0,1,NYSE
4630,12-02-2021 18:00,24 hrs.,wallstreetbets,FRO,6,6,0,6,1,1,0,1,NYSE
4630,12-02-2021 18:00,24 hrs.,stocks,MXC,6,6,0,6,1,1,0,1,AMEX
4630,12-02-2021 18:00,24 hrs.,stocks,PLX,13,13,0,13,1,2,5,1,AMEX
4630,12-02-2021 18:00,24 hrs.,stocks,TRX,43,0,43,-43,2,15,5,2,AMEX
4630,12-02-2021 18:00,24 hrs.,stocks,WYY,6,0,6,-6,1,1,0,1,AMEX
4630,12-02-2021 18:00,24 hrs.,stocks,ZOM,37,12,25,-13,6,6,1,6,AMEX
4630,12-02-2021 18:00,24 hrs.,stocks,GSAT,6,6,0,6,1,1,0,1,AMEX
4630,12-02-2021 18:00,24 hrs.,stocks,TMBR,6,6,0,6,1,1,0,1,AMEX
4630,12-02-2021 18:00,24 hrs.,stocks,UAVS,6,0,6,-6,1,1,0,1,AMEX
4630,12-02-2021 18:00,24 hrs.,stocks,ACB,72,0,72,-72,2,19,26,2,NYSE
4630,12-02-2021 18:00,24 hrs.,stocks,AHT,7,0,7,-7,1,1,1,1,NYSE
4630,12-02-2021 18:00,24 hrs.,stocks,AMC,224,133,91,42,10,46,92,9,NYSE
4630,12-02-2021 18:00,24 hrs.,stocks,ASX,13,7,6,1,2,2,1,2,NYSE
4630,12-02-2021 18:00,24 hrs.,stocks,ATH,47,31,16,15,2,7,25,2,NYSE
4630,12-02-2021 18:00,24 hrs.,stocks,AUY,6,0,6,-6,1,1,0,1,NYSE
4630,12-02-2021 18:00,24 hrs.,stocks,BBY,54,0,54,-54,1,14,22,1,NYSE
4630,12-02-2021 18:00,24 hrs.,stocks,BEP,59,59,0,59,4,2,39,4,NYSE
4630,12-02-2021 18:00,24 hrs.,stocks,BHC,8,8,0,8,1,1,2,1,NYSE
4630,12-02-2021 18:00,24 hrs.,stocks,BLK,8,0,8,-8,1,1,2,1,NYSE
4630,12-02-2021 18:00,24 hrs.,stocks,BNY,8,0,8,-8,1,1,2,1,NYSE
4630,12-02-2021 18:00,24 hrs.,stocks,BTT,12,6,6,0,2,2,0,2,NYSE
4630,12-02-2021 18:00,24 hrs.,stocks,CBD,6,6,0,6,1,1,0,1,NYSE
4630,12-02-2021 18:00,24 hrs.,stocks,CIA,7684,0,7684,-7684,1,3627,426,1,NYSE
4630,12-02-2021 18:00,24 hrs.,stocks,CRM,6,6,0,6,1,1,0,1,NYSE
4630,12-02-2021 18:00,24 hrs.,stocks,CVE,6,6,0,6,1,1,0,1,NYSE
4630,12-02-2021 18:00,24 hrs.,stocks,CVS,11,11,0,11,1,1,5,1,NYSE
4630,12-02-2021 18:00,24 hrs.,stocks,DDD,40,0,40,-40,1,9,18,1,NYSE
4630,12-02-2021 18:00,24 hrs.,stocks,DIS,25391,8,25383,-25375,3,11821,1737,3,NYSE
4630,12-02-2021 18:00,24 hrs.,stocks,DTE,23,0,23,-23,1,2,15,1,NYSE
4630,12-02-2021 18:00,24 hrs.,stocks,EOS,12,0,12,-12,2,2,0,1,NYSE
4630,12-02-2021 18:00,24 hrs.,stocks,ETH,6,6,0,6,1,1,0,1,NYSE
4630,12-02-2021 18:00,24 hrs.,stocks,FCF,31,31,0,31,1,4,19,1,NYSE
4630,12-02-2021 18:00,24 hrs.,stocks,FCX,6,0,6,-6,1,1,0,1,NYSE
4630,12-02-2021 18:00,24 hrs.,stocks,FSR,32,6,26,-20,2,12,0,2,NYSE
4630,12-02-2021 18:00,24 hrs.,stocks,GME,30420,222,30198,-29976,22,13850,2632,21,NYSE
4630,12-02-2021 18:00,24 hrs.,stocks,IBM,7684,0,7684,-7684,1,3627,426,1,NYSE
4630,12-02-2021 18:00,24 hrs.,stocks,ICE,31,31,0,31,1,4,19,1,NYSE
4630,12-02-2021 18:00,24 hrs.,stocks,IRS,53,53,0,53,1,19,11,1,NYSE
4630,12-02-2021 18:00,24 hrs.,stocks,IVR,6,0,6,-6,1,1,0,1,NYSE
4630,12-02-2021 18:00,24 hrs.,stocks,JNJ,25365,0,25365,-25365,2,11806,1745,2,NYSE
4630,12-02-2021 18:00,24 hrs.,stocks,JPM,8,0,8,-8,1,1,2,1,NYSE
4630,12-02-2021 18:00,24 hrs.,stocks,KEY,89,0,89,-89,1,35,15,1,NYSE
4630,12-02-2021 18:00,24 hrs.,stocks,KNL,27,0,27,-27,1,8,7,1,NYSE
4630,12-02-2021 18:00,24 hrs.,stocks,LEN,6,0,6,-6,1,1,0,1,NYSE
4630,12-02-2021 18:00,24 hrs.,stocks,LMT,6,6,0,6,1,1,0,1,NYSE
4630,12-02-2021 18:00,24 hrs.,stocks,LUV,51,51,0,51,1,12,23,1,NYSE
4630,12-02-2021 18:00,24 hrs.,stocks,MCO,8,8,0,8,1,1,2,1,NYSE
4630,12-02-2021 18:00,24 hrs.,wallstreetbets,ADX,12,0,12,-12,2,2,0,1,NYSE
4630,12-02-2021 18:00,24 hrs.,wallstreetbets,AEM,8,8,0,8,1,1,2,1,NYSE
4630,12-02-2021 18:00,24 hrs.,wallstreetbets,AFC,12,0,12,-12,2,2,0,1,NYSE
4630,12-02-2021 18:00,24 hrs.,wallstreetbets,AHT,14,0,14,-14,2,2,2,2,NYSE
4630,12-02-2021 18:00,24 hrs.,wallstreetbets,PCG,496,120,376,-256,2,142,204,2,NYSE
4630,12-02-2021 18:00,24 hrs.,wallstreetbets,PDT,13,13,0,13,2,2,1,2,NYSE
4630,12-02-2021 18:00,24 hrs.,wallstreetbets,PEG,243,0,243,-243,1,87,65,1,NYSE
4630,12-02-2021 18:00,24 hrs.,wallstreetbets,PFE,19,13,6,7,3,3,1,3,NYSE
4630,12-02-2021 18:00,24 hrs.,wallstreetbets,PMO,7,7,0,7,1,1,1,1,NYSE
4630,12-02-2021 18:00,24 hrs.,wallstreetbets,PSA,1450,51,1399,-1348,8,571,276,6,NYSE
4630,12-02-2021 18:00,24 hrs.,wallstreetbets,PSX,6497,6497,0,6497,1,2803,887,1,NYSE
4630,12-02-2021 18:00,24 hrs.,wallstreetbets,RCL,226,0,226,-226,1,80,62,1,NYSE
4630,12-02-2021 18:00,24 hrs.,wallstreetbets,RDY,6,6,0,6,1,1,0,1,NYSE
4630,12-02-2021 18:00,24 hrs.,wallstreetbets,RKT,868,33,835,-802,20,248,292,15,NYSE
4630,12-02-2021 18:00,24 hrs.,wallstreetbets,RMO,82,62,20,42,12,12,10,8,NYSE
4630,12-02-2021 18:00,24 hrs.,wallstreetbets,RSI,24,6,18,-12,4,4,0,4,NYSE
4630,12-02-2021 18:00,24 hrs.,wallstreetbets,RTX,7,0,7,-7,1,1,1,1,NYSE
4630,12-02-2021 18:00,24 hrs.,wallstreetbets,SBE,12,0,12,-12,2,2,0,2,NYSE
4630,12-02-2021 18:00,24 hrs.,stocks,MFA,8,8,0,8,1,1,2,1,NYSE
4630,12-02-2021 18:00,24 hrs.,stocks,MGM,19,0,19,-19,1,4,7,1,NYSE
4630,12-02-2021 18:00,24 hrs.,stocks,MRO,8,8,0,8,1,1,2,1,NYSE
4630,12-02-2021 18:00,24 hrs.,stocks,NAT,31,0,31,-31,1,8,11,1,NYSE
4630,12-02-2021 18:00,24 hrs.,stocks,NET,381,11,370,-359,2,141,91,2,NYSE
4630,12-02-2021 18:00,24 hrs.,stocks,NGL,6,6,0,6,1,1,0,1,NYSE
4630,12-02-2021 18:00,24 hrs.,stocks,NIO,367,330,37,293,3,104,147,3,NYSE
4630,12-02-2021 18:00,24 hrs.,stocks,NKE,25328,0,25328,-25328,1,11802,1720,1,NYSE
4630,12-02-2021 18:00,24 hrs.,stocks,NOK,89,89,0,89,2,12,57,2,NYSE
4630,12-02-2021 18:00,24 hrs.,stocks,NOM,53,53,0,53,1,19,11,1,NYSE
4630,12-02-2021 18:00,24 hrs.,stocks,NSA,7684,0,7684,-7684,1,3627,426,1,NYSE
4630,12-02-2021 18:00,24 hrs.,stocks,NVS,18,0,18,-18,3,3,0,1,NYSE
4630,12-02-2021 18:00,24 hrs.,stocks,PDT,6,6,0,6,1,1,0,1,NYSE
4630,12-02-2021 18:00,24 hrs.,stocks,PFE,7,7,0,7,1,1,1,1,NYSE
4630,12-02-2021 18:00,24 hrs.,stocks,RKT,81,0,81,-81,1,30,17,1,NYSE
4630,12-02-2021 18:00,24 hrs.,stocks,RSI,27,0,27,-27,1,8,7,1,NYSE
4630,12-02-2021 18:00,24 hrs.,stocks,SBE,64,0,64,-64,5,21,2,3,NYSE
4630,12-02-2021 18:00,24 hrs.,stocks,SOI,6,0,6,-6,1,1,0,1,NYSE
4630,12-02-2021 18:00,24 hrs.,stocks,SOS,24,6,18,-12,4,4,0,4,NYSE
4630,12-02-2021 18:00,24 hrs.,stocks,TDA,7,0,7,-7,1,1,1,1,NYSE
4630,12-02-2021 18:00,24 hrs.,stocks,TMO,7,0,7,-7,1,1,1,1,NYSE
4630,12-02-2021 18:00,24 hrs.,stocks,TSM,80,39,41,-2,2,12,48,2,NYSE
4630,12-02-2021 18:00,24 hrs.,stocks,UBS,27,27,0,27,1,11,1,1,NYSE
4630,12-02-2021 18:00,24 hrs.,stocks,UPS,67,0,67,-67,1,25,13,1,NYSE
4630,12-02-2021 18:00,24 hrs.,stocks,WLL,6,6,0,6,1,1,0,1,NYSE
4630,12-02-2021 18:00,24 hrs.,stocks,WMT,25372,0,25372,-25372,3,11807,1746,3,NYSE
4630,12-02-2021 18:00,24 hrs.,stocks,ALSN,27,0,27,-27,1,8,7,1,NYSE
4630,12-02-2021 18:00,24 hrs.,stocks,AQUA,7,0,7,-7,1,1,1,1,NYSE
4630,12-02-2021 18:00,24 hrs.,stocks,BABA,48,0,48,-48,2,7,26,2,NYSE
4630,12-02-2021 18:00,24 hrs.,stocks,BEPC,26,26,0,26,2,1,16,2,NYSE
4630,12-02-2021 18:00,24 hrs.,stocks,BORR,38,38,0,38,3,7,12,3,NYSE
4630,12-02-2021 18:00,24 hrs.,stocks,CACI,7684,0,7684,-7684,1,3627,426,1,NYSE
4630,12-02-2021 18:00,24 hrs.,stocks,CCIV,12,0,12,-12,2,2,0,2,NYSE
4630,12-02-2021 18:00,24 hrs.,stocks,COTY,6,6,0,6,1,1,0,1,NYSE
4630,12-02-2021 18:00,24 hrs.,stocks,FTCH,25,25,0,25,1,4,13,1,NYSE
4630,12-02-2021 18:00,24 hrs.,stocks,FUSE,6,6,0,6,1,1,0,1,NYSE
4630,12-02-2021 18:00,24 hrs.,stocks,FVRR,25,25,0,25,1,4,13,1,NYSE
4630,12-02-2021 18:00,24 hrs.,stocks,HEXO,6,6,0,6,1,1,0,1,NYSE
4630,12-02-2021 18:00,24 hrs.,stocks,HUYA,72,72,0,72,1,25,18,1,NYSE
4630,12-02-2021 18:00,24 hrs.,stocks,HYLN,12,0,12,-12,2,2,0,2,NYSE
4630,12-02-2021 18:00,24 hrs.,stocks,JMIA,6,6,0,6,1,1,0,1,NYSE
4630,12-02-2021 18:00,24 hrs.,stocks,MDLY,6,0,6,-6,1,1,0,1,NYSE
4630,12-02-2021 18:00,24 hrs.,stocks,OTIS,27,0,27,-27,1,8,7,1,NYSE
4630,12-02-2021 18:00,24 hrs.,stocks,PINS,41,0,41,-41,1,6,25,1,NYSE
4630,12-02-2021 18:00,24 hrs.,stocks,PLTR,25416,88,25328,-25240,3,11814,1776,3,NYSE
4630,12-02-2021 18:00,24 hrs.,stocks,SKLZ,45,0,45,-45,1,14,13,1,NYSE
4630,12-02-2021 18:00,24 hrs.,stocks,SPCE,13,7,6,1,2,2,1,2,NYSE
4630,12-02-2021 18:00,24 hrs.,stocks,SPOT,6,0,6,-6,1,1,0,1,NYSE
4630,12-02-2021 18:00,24 hrs.,stocks,VOYA,27,0,27,-27,1,8,7,1,NYSE
4630,12-02-2021 18:00,24 hrs.,wallstreetbets,DOC,7,0,7,-7,1,1,1,1,NYSE
4630,12-02-2021 18:00,24 hrs.,stocks,CGC,6,0,6,-6,1,1,0,1,NASDAQ
4630,12-02-2021 18:00,24 hrs.,stocks,FTC,24,24,0,24,1,7,6,1,NASDAQ
4630,12-02-2021 18:00,24 hrs.,stocks,IEA,12,12,0,12,1,1,6,1,NASDAQ
4630,12-02-2021 18:00,24 hrs.,stocks,JFU,6,0,6,-6,1,1,0,1,NASDAQ
4630,12-02-2021 18:00,24 hrs.,stocks,KHC,34,0,34,-34,2,8,10,2,NASDAQ
4630,12-02-2021 18:00,24 hrs.,stocks,LNT,27,0,27,-27,1,8,7,1,NASDAQ
4630,12-02-2021 18:00,24 hrs.,stocks,MIK,6,0,6,-6,1,1,0,1,NASDAQ
4630,12-02-2021 18:00,24 hrs.,stocks,NPA,6,0,6,-6,1,1,0,1,NASDAQ
4630,12-02-2021 18:00,24 hrs.,wallstreetbets,SBI,7,0,7,-7,1,1,1,1,NYSE
4630,12-02-2021 18:00,24 hrs.,wallstreetbets,SCI,600,0,600,-600,3,224,140,2,NYSE
4630,12-02-2021 18:00,24 hrs.,wallstreetbets,SKM,30,30,0,30,1,0,26,1,NYSE
4630,12-02-2021 18:00,24 hrs.,wallstreetbets,SKT,14,7,7,0,2,2,2,2,NYSE
4630,12-02-2021 18:00,24 hrs.,wallstreetbets,SNE,14,14,0,14,2,2,2,1,NYSE
4630,12-02-2021 18:00,24 hrs.,wallstreetbets,SNP,6,0,6,-6,1,1,0,1,NYSE
4630,12-02-2021 18:00,24 hrs.,wallstreetbets,FSD,20,14,6,8,3,3,2,3,NYSE
4630,12-02-2021 18:00,24 hrs.,wallstreetbets,FSR,684,199,485,-286,35,202,140,17,NYSE
4630,12-02-2021 18:00,24 hrs.,wallstreetbets,FTI,27,20,7,13,4,4,3,2,NYSE
4630,12-02-2021 18:00,24 hrs.,wallstreetbets,GAM,7,7,0,7,1,1,1,1,NYSE
4630,12-02-2021 18:00,24 hrs.,wallstreetbets,GEO,34,28,6,22,5,5,4,2,NYSE
4630,12-02-2021 18:00,24 hrs.,wallstreetbets,GLW,14,14,0,14,2,2,2,2,NYSE
4630,12-02-2021 18:00,24 hrs.,wallstreetbets,GME,66213,20716,45497,-24781,509,28653,6871,406,NYSE
4630,12-02-2021 18:00,24 hrs.,wallstreetbets,GUT,6,0,6,-6,1,1,0,1,NYSE
4630,12-02-2021 18:00,24 hrs.,wallstreetbets,HAL,6,0,6,-6,1,1,0,1,NYSE
4630,12-02-2021 18:00,24 hrs.,wallstreetbets,HII,12,0,12,-12,2,2,0,1,NYSE
4630,12-02-2021 18:00,24 hrs.,wallstreetbets,HMI,7,7,0,7,1,1,1,1,NYSE
4630,12-02-2021 18:00,24 hrs.,wallstreetbets,HON,6,0,6,-6,1,1,0,1,NYSE
4630,12-02-2021 18:00,24 hrs.,wallstreetbets,HVT,7,0,7,-7,1,1,1,1,NYSE
4630,12-02-2021 18:00,24 hrs.,wallstreetbets,IAG,14,14,0,14,2,2,2,2,NYSE
4630,12-02-2021 18:00,24 hrs.,wallstreetbets,IBM,209,209,0,209,2,77,47,2,NYSE
4630,12-02-2021 18:00,24 hrs.,wallstreetbets,IVC,6,0,6,-6,1,1,0,1,NYSE
4630,12-02-2021 18:00,24 hrs.,wallstreetbets,IVR,40,40,0,40,6,5,6,4,NYSE
4630,12-02-2021 18:00,24 hrs.,wallstreetbets,JNJ,13,13,0,13,2,2,1,2,NYSE
4630,12-02-2021 18:00,24 hrs.,wallstreetbets,KGC,6,0,6,-6,1,1,0,1,NYSE
4630,12-02-2021 18:00,24 hrs.,wallstreetbets,KOS,12,12,0,12,2,2,0,1,NYSE
4630,12-02-2021 18:00,24 hrs.,wallstreetbets,LAC,19,6,13,-7,3,3,1,3,NYSE
4630,12-02-2021 18:00,24 hrs.,wallstreetbets,LEG,6,0,6,-6,1,1,0,1,NYSE
4630,12-02-2021 18:00,24 hrs.,wallstreetbets,LEN,6,0,6,-6,1,1,0,1,NYSE
4630,12-02-2021 18:00,24 hrs.,wallstreetbets,LMT,13,0,13,-13,2,2,1,2,NYSE
4630,12-02-2021 18:00,24 hrs.,wallstreetbets,LOW,1003,22,981,-959,7,417,141,6,NYSE
4630,12-02-2021 18:00,24 hrs.,wallstreetbets,LTC,7,0,7,-7,1,1,1,1,NYSE
4630,12-02-2021 18:00,24 hrs.,wallstreetbets,MAC,9,9,0,9,1,1,3,1,NYSE
4630,12-02-2021 18:00,24 hrs.,wallstreetbets,MBI,14,14,0,14,2,2,2,2,NYSE
4630,12-02-2021 18:00,24 hrs.,wallstreetbets,MCO,381,381,0,381,1,152,73,1,NYSE
4630,12-02-2021 18:00,24 hrs.,wallstreetbets,MEN,6,0,6,-6,1,1,0,1,NYSE
4630,12-02-2021 18:00,24 hrs.,wallstreetbets,MFA,7,7,0,7,1,1,1,1,NYSE
4630,12-02-2021 18:00,24 hrs.,wallstreetbets,MRO,387,381,6,375,2,153,73,2,NYSE
4630,12-02-2021 18:00,24 hrs.,wallstreetbets,MSM,7,7,0,7,1,1,1,1,NYSE
4630,12-02-2021 18:00,24 hrs.,wallstreetbets,MTL,6,0,6,-6,1,1,0,1,NYSE
4630,12-02-2021 18:00,24 hrs.,wallstreetbets,NAT,32,13,19,-6,5,4,4,4,NYSE
4630,12-02-2021 18:00,24 hrs.,wallstreetbets,NAV,376,0,376,-376,1,112,148,1,NYSE
4630,12-02-2021 18:00,24 hrs.,wallstreetbets,NET,18,0,18,-18,3,3,0,2,NYSE
4630,12-02-2021 18:00,24 hrs.,wallstreetbets,NGA,12,6,6,0,2,2,0,2,NYSE
4630,12-02-2021 18:00,24 hrs.,wallstreetbets,NIO,716,261,455,-194,22,172,284,19,NYSE
4630,12-02-2021 18:00,24 hrs.,wallstreetbets,NOC,7,0,7,-7,1,1,1,1,NYSE
4630,12-02-2021 18:00,24 hrs.,wallstreetbets,NOK,1052,893,159,734,38,371,158,32,NYSE
4630,12-02-2021 18:00,24 hrs.,wallstreetbets,NRG,28,28,0,28,4,4,4,1,NYSE
4630,12-02-2021 18:00,24 hrs.,wallstreetbets,NUS,7,7,0,7,1,1,1,1,NYSE
4630,12-02-2021 18:00,24 hrs.,wallstreetbets,NVO,12,6,6,0,2,2,0,2,NYSE
4630,12-02-2021 18:00,24 hrs.,wallstreetbets,NYC,14,7,7,0,2,2,2,2,NYSE
4630,12-02-2021 18:00,24 hrs.,wallstreetbets,OGE,7,7,0,7,1,1,1,1,NYSE
4630,12-02-2021 18:00,24 hrs.,wallstreetbets,OPP,7,0,7,-7,1,1,1,1,NYSE
4630,12-02-2021 18:00,24 hrs.,wallstreetbets,OPY,6,0,6,-6,1,1,0,1,NYSE
4630,12-02-2021 18:00,24 hrs.,wallstreetbets,OVV,5,5,0,5,1,0,1,1,NYSE
4630,12-02-2021 18:00,24 hrs.,wallstreetbets,OXY,13,0,13,-13,2,2,1,2,NYSE
4630,12-02-2021 18:00,24 hrs.,stocks,AAPL,25388,0,25388,-25388,2,11814,1752,2,NASDAQ
4630,12-02-2021 18:00,24 hrs.,stocks,ABIO,6,0,6,-6,1,1,0,1,NASDAQ
4630,12-02-2021 18:00,24 hrs.,stocks,ABNB,36,0,36,-36,1,12,8,1,NASDAQ
4630,12-02-2021 18:00,24 hrs.,stocks,ABUS,6,6,0,6,1,1,0,1,NASDAQ
4630,12-02-2021 18:00,24 hrs.,stocks,AEZS,78,78,0,78,1,33,8,1,NASDAQ
4630,12-02-2021 18:00,24 hrs.,stocks,AGTC,18,12,6,6,3,3,0,2,NASDAQ
4630,12-02-2021 18:00,24 hrs.,stocks,ALJJ,6,0,6,-6,1,1,0,1,NASDAQ
4630,12-02-2021 18:00,24 hrs.,stocks,ALOT,174,0,174,-174,1,45,80,1,NASDAQ
4630,12-02-2021 18:00,24 hrs.,stocks,AMCX,6,0,6,-6,1,1,0,1,NASDAQ
4630,12-02-2021 18:00,24 hrs.,stocks,AMZN,25328,0,25328,-25328,1,11802,1720,1,NASDAQ
4630,12-02-2021 18:00,24 hrs.,stocks,APHA,26301,496,25805,-25309,14,12067,2111,14,NASDAQ
4630,12-02-2021 18:00,24 hrs.,stocks,APXT,6,0,6,-6,1,1,0,1,NASDAQ
4630,12-02-2021 18:00,24 hrs.,stocks,ARTL,18,18,0,18,3,3,0,2,NASDAQ
4630,12-02-2021 18:00,24 hrs.,stocks,ASYS,6,6,0,6,1,1,0,1,NASDAQ
4630,12-02-2021 18:00,24 hrs.,stocks,ATOM,6,0,6,-6,1,1,0,1,NASDAQ
4630,12-02-2021 18:00,24 hrs.,stocks,ATOS,78,78,0,78,1,33,8,1,NASDAQ
4630,12-02-2021 18:00,24 hrs.,stocks,AVGO,6,6,0,6,1,1,0,1,NASDAQ
4630,12-02-2021 18:00,24 hrs.,stocks,AVXL,6,0,6,-6,1,1,0,1,NASDAQ
4630,12-02-2021 18:00,24 hrs.,stocks,AZRX,12,0,12,-12,1,2,4,1,NASDAQ
4630,12-02-2021 18:00,24 hrs.,stocks,BLDP,6,0,6,-6,1,1,0,1,NASDAQ
4630,12-02-2021 18:00,24 hrs.,stocks,BLNK,37,0,37,-37,1,4,25,1,NASDAQ
4630,12-02-2021 18:00,24 hrs.,stocks,BNGO,6,6,0,6,1,1,0,1,NASDAQ
4630,12-02-2021 18:00,24 hrs.,stocks,CLEU,7,0,7,-7,1,1,1,1,NASDAQ
4630,12-02-2021 18:00,24 hrs.,stocks,CLSK,45,0,45,-45,2,12,13,2,NASDAQ
4630,12-02-2021 18:00,24 hrs.,stocks,CLVS,6,0,6,-6,1,1,0,1,NASDAQ
4630,12-02-2021 18:00,24 hrs.,stocks,CMPS,12,12,0,12,2,2,0,1,NASDAQ
4630,12-02-2021 18:00,24 hrs.,stocks,CNDT,14,0,14,-14,1,3,4,1,NASDAQ
4630,12-02-2021 18:00,24 hrs.,stocks,COHR,8,8,0,8,1,1,2,1,NASDAQ
4630,12-02-2021 18:00,24 hrs.,stocks,COST,25328,0,25328,-25328,1,11802,1720,1,NASDAQ
4630,12-02-2021 18:00,24 hrs.,stocks,CPST,6,6,0,6,1,1,0,1,NASDAQ
4630,12-02-2021 18:00,24 hrs.,stocks,CREE,6,0,6,-6,1,1,0,1,NASDAQ
4630,12-02-2021 18:00,24 hrs.,stocks,CRSR,45,0,45,-45,1,14,13,1,NASDAQ
4630,12-02-2021 18:00,24 hrs.,stocks,CTRM,57,13,44,-31,9,9,3,8,NASDAQ
4630,12-02-2021 18:00,24 hrs.,stocks,CVLB,6,6,0,6,1,1,0,1,NASDAQ
4630,12-02-2021 18:00,24 hrs.,stocks,CXDC,6,0,6,-6,1,1,0,1,NASDAQ
4630,12-02-2021 18:00,24 hrs.,stocks,DDOG,8,8,0,8,1,1,2,1,NASDAQ
4630,12-02-2021 18:00,24 hrs.,stocks,DFFN,15,15,0,15,2,3,1,2,NASDAQ
4630,12-02-2021 18:00,24 hrs.,stocks,DMTK,24,0,24,-24,1,3,14,1,NASDAQ
4630,12-02-2021 18:00,24 hrs.,stocks,DOCU,6,6,0,6,1,1,0,1,NASDAQ
4630,12-02-2021 18:00,24 hrs.,stocks,EDIT,78,78,0,78,1,33,8,1,NASDAQ
4630,12-02-2021 18:00,24 hrs.,stocks,ENTX,7,7,0,7,1,1,1,1,NASDAQ
4630,12-02-2021 18:00,24 hrs.,stocks,ETSY,25,25,0,25,1,4,13,1,NASDAQ
4630,12-02-2021 18:00,24 hrs.,stocks,EVFM,18,0,18,-18,2,5,0,2,NASDAQ
4630,12-02-2021 18:00,24 hrs.,stocks,EXAS,24,0,24,-24,1,3,14,1,NASDAQ
4630,12-02-2021 18:00,24 hrs.,stocks,EXPE,8,8,0,8,1,1,2,1,NASDAQ
4630,12-02-2021 18:00,24 hrs.,stocks,FLXN,27,0,27,-27,1,8,7,1,NASDAQ
4630,12-02-2021 18:00,24 hrs.,stocks,FROG,6,0,6,-6,1,1,0,1,NASDAQ
4630,12-02-2021 18:00,24 hrs.,stocks,FSRV,6,0,6,-6,1,1,0,1,NASDAQ
4630,12-02-2021 18:00,24 hrs.,stocks,GILT,51,6,45,-39,2,15,13,2,NASDAQ
4630,12-02-2021 18:00,24 hrs.,stocks,GLBS,6,0,6,-6,1,1,0,1,NASDAQ
4630,12-02-2021 18:00,24 hrs.,stocks,GLUU,5,5,0,5,1,0,1,1,NASDAQ
4630,12-02-2021 18:00,24 hrs.,stocks,GNUS,6,6,0,6,1,1,0,1,NASDAQ
4630,12-02-2021 18:00,24 hrs.,stocks,GOEV,82,82,0,82,1,11,56,1,NASDAQ
4630,12-02-2021 18:00,24 hrs.,stocks,GTEC,6,0,6,-6,1,1,0,1,NASDAQ
4630,12-02-2021 18:00,24 hrs.,stocks,GTHX,6,0,6,-6,1,1,0,1,NASDAQ
4630,12-02-2021 18:00,24 hrs.,stocks,HTBX,6,0,6,-6,1,1,0,1,NASDAQ
4630,12-02-2021 18:00,24 hrs.,stocks,ICLN,48,48,0,48,1,13,18,1,NASDAQ
4630,12-02-2021 18:00,24 hrs.,stocks,WORK,6,0,6,-6,1,1,0,1,NYSE
4630,12-02-2021 18:00,24 hrs.,stocks,XPEV,7684,0,7684,-7684,1,3627,426,1,NYSE
4630,12-02-2021 18:00,24 hrs.,stocks,YETI,51,51,0,51,1,12,23,1,NYSE
4630,12-02-2021 18:00,24 hrs.,stocks,AAL,59,0,59,-59,2,10,31,2,NASDAQ
4630,12-02-2021 18:00,24 hrs.,stocks,AMD,94,39,55,-16,4,13,52,3,NASDAQ
4630,12-02-2021 18:00,24 hrs.,stocks,AZN,8,8,0,8,1,1,2,1,NASDAQ
4630,12-02-2021 18:00,24 hrs.,stocks,CDC,8,8,0,8,1,1,2,1,NASDAQ
4630,12-02-2021 18:00,24 hrs.,stocks,LITE,8,8,0,8,1,1,2,1,NASDAQ
4630,12-02-2021 18:00,24 hrs.,stocks,LIVE,8,8,0,8,1,1,2,1,NASDAQ
4630,12-02-2021 18:00,24 hrs.,stocks,LKCO,12,12,0,12,2,2,0,1,NASDAQ
4630,12-02-2021 18:00,24 hrs.,stocks,LRCX,39,39,0,39,1,6,23,1,NASDAQ
4630,12-02-2021 18:00,24 hrs.,stocks,MBRX,6,0,6,-6,1,1,0,1,NASDAQ
4630,12-02-2021 18:00,24 hrs.,stocks,MELI,41,0,41,-41,1,6,25,1,NASDAQ
4630,12-02-2021 18:00,24 hrs.,wallstreetbets,SNX,6,0,6,-6,1,1,0,1,NYSE
4630,12-02-2021 18:00,24 hrs.,wallstreetbets,SOL,14,7,7,0,2,2,2,2,NYSE
4630,12-02-2021 18:00,24 hrs.,wallstreetbets,SOS,262,78,184,-106,40,38,26,28,NYSE
4630,12-02-2021 18:00,24 hrs.,wallstreetbets,SPG,59,0,59,-59,2,1,49,2,NYSE
4630,12-02-2021 18:00,24 hrs.,wallstreetbets,SPH,13,0,13,-13,2,2,1,2,NYSE
4630,12-02-2021 18:00,24 hrs.,wallstreetbets,STM,402,0,402,-402,1,145,108,1,NYSE
4630,12-02-2021 18:00,24 hrs.,wallstreetbets,SUN,12,6,6,0,2,2,0,2,NYSE
4630,12-02-2021 18:00,24 hrs.,wallstreetbets,TAK,14,14,0,14,2,2,2,2,NYSE
4630,12-02-2021 18:00,24 hrs.,wallstreetbets,TAP,13,7,6,1,2,2,1,2,NYSE
4630,12-02-2021 18:00,24 hrs.,wallstreetbets,TDA,1310,0,1310,-1310,3,577,144,3,NYSE
4630,12-02-2021 18:00,24 hrs.,wallstreetbets,TDC,6,6,0,6,1,1,0,1,NYSE
4630,12-02-2021 18:00,24 hrs.,wallstreetbets,TGT,7,0,7,-7,1,1,1,1,NYSE
4630,12-02-2021 18:00,24 hrs.,wallstreetbets,THR,14,0,14,-14,2,2,2,2,NYSE
4630,12-02-2021 18:00,24 hrs.,wallstreetbets,TPB,6,0,6,-6,1,1,0,1,NYSE
4630,12-02-2021 18:00,24 hrs.,wallstreetbets,TRQ,6,6,0,6,1,1,0,1,NYSE
4630,12-02-2021 18:00,24 hrs.,wallstreetbets,TRU,7,7,0,7,1,1,1,1,NYSE
4630,12-02-2021 18:00,24 hrs.,wallstreetbets,TSM,2821,362,2459,-2097,10,1027,727,8,NYSE
4630,12-02-2021 18:00,24 hrs.,wallstreetbets,TSN,1374,1374,0,1374,2,615,136,1,NYSE
4630,12-02-2021 18:00,24 hrs.,wallstreetbets,TTM,6,6,0,6,1,1,0,1,NYSE
4630,12-02-2021 18:00,24 hrs.,wallstreetbets,UBS,26,7,19,-12,4,4,2,3,NYSE
4630,12-02-2021 18:00,24 hrs.,wallstreetbets,UMC,6,0,6,-6,1,1,0,1,NYSE
4630,12-02-2021 18:00,24 hrs.,wallstreetbets,UNP,7,7,0,7,1,1,1,1,NYSE
4630,12-02-2021 18:00,24 hrs.,wallstreetbets,USB,786,0,786,-786,1,307,168,1,NYSE
4630,12-02-2021 18:00,24 hrs.,wallstreetbets,UTZ,231,231,0,231,1,79,69,1,NYSE
4630,12-02-2021 18:00,24 hrs.,wallstreetbets,VET,20,0,20,-20,3,3,2,3,NYSE
4630,12-02-2021 18:00,24 hrs.,wallstreetbets,VGR,7,7,0,7,1,1,1,1,NYSE
4630,12-02-2021 18:00,24 hrs.,wallstreetbets,VHC,6,0,6,-6,1,1,0,1,NYSE
4630,12-02-2021 18:00,24 hrs.,wallstreetbets,VST,34,28,6,22,5,5,4,2,NYSE
4630,12-02-2021 18:00,24 hrs.,wallstreetbets,WFC,13,7,6,1,2,2,1,2,NYSE
4630,12-02-2021 18:00,24 hrs.,wallstreetbets,WLL,6,6,0,6,1,1,0,1,NYSE
4630,12-02-2021 18:00,24 hrs.,wallstreetbets,WMC,8,8,0,8,1,1,2,1,NYSE
4630,12-02-2021 18:00,24 hrs.,wallstreetbets,WMT,13,6,7,-1,2,2,1,2,NYSE
4630,12-02-2021 18:00,24 hrs.,wallstreetbets,WWE,7,0,7,-7,1,1,1,1,NYSE
4630,12-02-2021 18:00,24 hrs.,wallstreetbets,ABEV,7,7,0,7,1,1,1,1,NYSE
4630,12-02-2021 18:00,24 hrs.,wallstreetbets,ACIC,38,7,31,-24,6,6,2,5,NYSE
4630,12-02-2021 18:00,24 hrs.,wallstreetbets,APRN,6,6,0,6,1,1,0,1,NYSE
4630,12-02-2021 18:00,24 hrs.,wallstreetbets,ATUS,14,14,0,14,2,2,2,1,NYSE
4630,12-02-2021 18:00,24 hrs.,wallstreetbets,BABA,153,147,6,141,4,43,51,4,NYSE
4630,12-02-2021 18:00,24 hrs.,wallstreetbets,BEKE,376,0,376,-376,1,112,148,1,NYSE
4630,12-02-2021 18:00,24 hrs.,wallstreetbets,BNED,6,6,0,6,1,1,0,1,NYSE
4630,12-02-2021 18:00,24 hrs.,wallstreetbets,CARS,6,6,0,6,1,1,0,1,NYSE
4630,12-02-2021 18:00,24 hrs.,wallstreetbets,CCIV,242,110,132,-22,35,35,32,29,NYSE
4630,12-02-2021 18:00,24 hrs.,wallstreetbets,CHWY,7,7,0,7,1,1,1,1,NYSE
4630,12-02-2021 18:00,24 hrs.,wallstreetbets,CLDR,146,0,146,-146,1,43,56,1,NYSE
4630,12-02-2021 18:00,24 hrs.,wallstreetbets,CLII,13,7,6,1,2,2,1,2,NYSE
4630,12-02-2021 18:00,24 hrs.,wallstreetbets,CORR,6,0,6,-6,1,1,0,1,NYSE
4630,12-02-2021 18:00,24 hrs.,wallstreetbets,COTY,6,0,6,-6,1,1,0,1,NYSE
4630,12-02-2021 18:00,24 hrs.,wallstreetbets,CSPR,6,0,6,-6,1,1,0,1,NYSE
4630,12-02-2021 18:00,24 hrs.,wallstreetbets,DASH,26,14,12,2,3,2,10,2,NYSE
4630,12-02-2021 18:00,24 hrs.,wallstreetbets,DECK,7,0,7,-7,1,1,1,1,NYSE
4630,12-02-2021 18:00,24 hrs.,wallstreetbets,EXPR,7,7,0,7,1,1,1,1,NYSE
4630,12-02-2021 18:00,24 hrs.,stocks,NWL,8,8,0,8,1,1,2,1,NASDAQ
4630,12-02-2021 18:00,24 hrs.,stocks,OGI,31,18,13,5,5,5,1,5,NASDAQ
4630,12-02-2021 18:00,24 hrs.,stocks,OLB,6,0,6,-6,1,1,0,1,NASDAQ
4630,12-02-2021 18:00,24 hrs.,stocks,PEP,6,0,6,-6,1,0,2,1,NASDAQ
4630,12-02-2021 18:00,24 hrs.,stocks,QQQ,48,0,48,-48,2,7,26,2,NASDAQ
4630,12-02-2021 18:00,24 hrs.,stocks,SMH,41,0,41,-41,1,6,25,1,NASDAQ
4630,12-02-2021 18:00,24 hrs.,stocks,UFO,35,0,35,-35,3,9,5,1,NASDAQ
4630,12-02-2021 18:00,24 hrs.,stocks,SQQQ,7,0,7,-7,1,1,1,1,NASDAQ
4630,12-02-2021 18:00,24 hrs.,stocks,SRAC,8,0,8,-8,1,2,0,1,NASDAQ
4630,12-02-2021 18:00,24 hrs.,stocks,SSPK,49,0,49,-49,1,15,15,1,NASDAQ
4630,12-02-2021 18:00,24 hrs.,stocks,SSYS,40,0,40,-40,1,9,18,1,NASDAQ
4630,12-02-2021 18:00,24 hrs.,stocks,SVMK,8,8,0,8,1,1,2,1,NASDAQ
4630,12-02-2021 18:00,24 hrs.,stocks,SWAV,24,0,24,-24,1,3,14,1,NASDAQ
4630,12-02-2021 18:00,24 hrs.,stocks,SWBI,7,0,7,-7,1,1,1,1,NASDAQ
4630,12-02-2021 18:00,24 hrs.,stocks,SWKS,39,39,0,39,1,6,23,1,NASDAQ
4630,12-02-2021 18:00,24 hrs.,stocks,TLRY,833,425,408,17,9,254,289,9,NASDAQ
4630,12-02-2021 18:00,24 hrs.,stocks,TMDX,24,0,24,-24,1,3,14,1,NASDAQ
4630,12-02-2021 18:00,24 hrs.,stocks,TNXP,12,0,12,-12,2,2,0,2,NASDAQ
4630,12-02-2021 18:00,24 hrs.,stocks,TSLA,144,31,113,-82,4,16,96,4,NASDAQ
4630,12-02-2021 18:00,24 hrs.,stocks,TTWO,6,0,6,-6,1,1,0,1,NASDAQ
4630,12-02-2021 18:00,24 hrs.,stocks,TWOU,23,0,23,-23,2,5,5,1,NASDAQ
4630,12-02-2021 18:00,24 hrs.,stocks,TXMD,6,0,6,-6,1,1,0,1,NASDAQ
4630,12-02-2021 18:00,24 hrs.,stocks,VCEL,24,0,24,-24,1,3,14,1,NASDAQ
4630,12-02-2021 18:00,24 hrs.,stocks,VECO,6,0,6,-6,1,1,0,1,NASDAQ
4630,12-02-2021 18:00,24 hrs.,stocks,VRSN,8,8,0,8,1,1,2,1,NASDAQ
4630,12-02-2021 18:00,24 hrs.,stocks,VXRT,12,0,12,-12,2,2,0,2,NASDAQ
4630,12-02-2021 18:00,24 hrs.,stocks,VXUS,24,0,24,-24,1,5,10,1,NASDAQ
4630,12-02-2021 18:00,24 hrs.,stocks,WISH,6,6,0,6,1,1,0,1,NASDAQ
4630,12-02-2021 18:00,24 hrs.,stocks,XCUR,6,0,6,-6,1,1,0,1,NASDAQ
4630,12-02-2021 18:00,24 hrs.,stocks,XERS,6,6,0,6,1,1,0,1,NASDAQ
4630,12-02-2021 18:00,24 hrs.,wallstreetbets,FEDU,7,7,0,7,1,1,1,1,NYSE
4630,12-02-2021 18:00,24 hrs.,wallstreetbets,FENG,6,0,6,-6,1,1,0,1,NYSE
4630,12-02-2021 18:00,24 hrs.,wallstreetbets,FINV,14,0,14,-14,2,2,2,1,NYSE
4630,12-02-2021 18:00,24 hrs.,wallstreetbets,FLOW,7,7,0,7,1,1,1,1,NYSE
4630,12-02-2021 18:00,24 hrs.,wallstreetbets,FSLY,14,14,0,14,2,2,2,2,NYSE
4630,12-02-2021 18:00,24 hrs.,wallstreetbets,FUBO,258,238,20,218,5,83,72,5,NYSE
4630,12-02-2021 18:00,24 hrs.,wallstreetbets,FUSE,30,30,0,30,4,4,6,2,NYSE
4630,12-02-2021 18:00,24 hrs.,wallstreetbets,FVRR,15,7,8,-1,2,2,3,2,NYSE
4630,12-02-2021 18:00,24 hrs.,wallstreetbets,GPRK,7,7,0,7,1,1,1,1,NYSE
4630,12-02-2021 18:00,24 hrs.,wallstreetbets,GRUB,6,0,6,-6,1,1,0,1,NYSE
4630,12-02-2021 18:00,24 hrs.,wallstreetbets,HUYA,36,21,15,6,5,5,6,4,NYSE
4630,12-02-2021 18:00,24 hrs.,wallstreetbets,HYLN,2740,370,2370,-2000,74,951,542,61,NYSE
4630,12-02-2021 18:00,24 hrs.,wallstreetbets,IIPR,16,12,4,8,3,2,0,2,NYSE
4630,12-02-2021 18:00,24 hrs.,wallstreetbets,IPOE,13,13,0,13,2,2,1,2,NYSE
4630,12-02-2021 18:00,24 hrs.,wallstreetbets,JMIA,1397,1397,0,1397,5,619,139,1,NYSE
4630,12-02-2021 18:00,24 hrs.,wallstreetbets,JNPR,6,6,0,6,1,1,0,1,NYSE
4630,12-02-2021 18:00,24 hrs.,wallstreetbets,KODK,19,13,6,7,3,3,1,2,NYSE
4630,12-02-2021 18:00,24 hrs.,wallstreetbets,LDOS,6,0,6,-6,1,1,0,1,NYSE
4630,12-02-2021 18:00,24 hrs.,wallstreetbets,LEAP,6,0,6,-6,1,1,0,1,NYSE
4630,12-02-2021 18:00,24 hrs.,wallstreetbets,LGVW,41,7,34,-27,6,6,5,5,NYSE
4630,12-02-2021 18:00,24 hrs.,wallstreetbets,LMND,12,0,12,-12,2,2,0,1,NYSE
4630,12-02-2021 18:00,24 hrs.,wallstreetbets,LSPD,13,6,7,-1,2,2,1,2,NYSE
4630,12-02-2021 18:00,24 hrs.,wallstreetbets,LUMN,13,0,13,-13,2,2,1,2,NYSE
4630,12-02-2021 18:00,24 hrs.,wallstreetbets,MAIN,14,0,14,-14,2,2,2,2,NYSE
4630,12-02-2021 18:00,24 hrs.,wallstreetbets,MANU,12,12,0,12,2,2,0,2,NYSE
4630,12-02-2021 18:00,24 hrs.,wallstreetbets,MDLY,19,0,19,-19,3,3,1,1,NYSE
4630,12-02-2021 18:00,24 hrs.,wallstreetbets,NVTA,12,0,12,-12,2,2,0,1,NYSE
4630,12-02-2021 18:00,24 hrs.,wallstreetbets,PACK,15,15,0,15,2,2,3,1,NYSE
4630,12-02-2021 18:00,24 hrs.,wallstreetbets,PGRE,6,0,6,-6,1,1,0,1,NYSE
4630,12-02-2021 18:00,24 hrs.,wallstreetbets,PINS,14,0,14,-14,2,2,2,2,NYSE
4630,12-02-2021 18:00,24 hrs.,wallstreetbets,PLNT,6,0,6,-6,1,1,0,1,NYSE
4630,12-02-2021 18:00,24 hrs.,wallstreetbets,PLTR,1615,248,1367,-1119,51,518,375,35,NYSE
4630,12-02-2021 18:00,24 hrs.,wallstreetbets,PRTY,8,8,0,8,1,1,2,1,NYSE
4630,12-02-2021 18:00,24 hrs.,wallstreetbets,PSXP,6,0,6,-6,1,1,0,1,NYSE
4630,12-02-2021 18:00,24 hrs.,stocks,ICPT,19,0,19,-19,1,5,5,1,NASDAQ
4630,12-02-2021 18:00,24 hrs.,stocks,IIVI,8,8,0,8,1,1,2,1,NASDAQ
4630,12-02-2021 18:00,24 hrs.,stocks,ILMN,7,7,0,7,1,1,1,1,NASDAQ
4630,12-02-2021 18:00,24 hrs.,stocks,INPX,18,18,0,18,3,3,0,1,NASDAQ
4630,12-02-2021 18:00,24 hrs.,stocks,INTC,111,70,41,29,2,32,39,2,NASDAQ
4630,12-02-2021 18:00,24 hrs.,stocks,INVE,7,7,0,7,1,1,1,1,NASDAQ
4630,12-02-2021 18:00,24 hrs.,stocks,KPTI,27,0,27,-27,1,8,7,1,NASDAQ
4630,12-02-2021 18:00,24 hrs.,wallstreetbets,SAFE,62,62,0,62,1,14,30,1,NYSE
4630,12-02-2021 18:00,24 hrs.,wallstreetbets,SCVX,6,0,6,-6,1,1,0,1,NYSE
4630,12-02-2021 18:00,24 hrs.,wallstreetbets,SHOP,970,0,970,-970,2,412,138,2,NYSE
4630,12-02-2021 18:00,24 hrs.,wallstreetbets,SLCA,6,0,6,-6,1,1,0,1,NYSE
4630,12-02-2021 18:00,24 hrs.,wallstreetbets,SNPR,6,0,6,-6,1,1,0,1,NYSE
4630,12-02-2021 18:00,24 hrs.,wallstreetbets,SPCE,1420,717,703,14,35,524,232,27,NYSE
4630,12-02-2021 18:00,24 hrs.,wallstreetbets,SPOT,7,0,7,-7,1,1,1,1,NYSE
4630,12-02-2021 18:00,24 hrs.,wallstreetbets,STNG,6,0,6,-6,1,1,0,1,NYSE
4630,12-02-2021 18:00,24 hrs.,wallstreetbets,STPK,6,0,6,-6,1,1,0,1,NYSE
4630,12-02-2021 18:00,24 hrs.,wallstreetbets,STWD,120,120,0,120,1,30,56,1,NYSE
4630,12-02-2021 18:00,24 hrs.,wallstreetbets,TDOC,6,0,6,-6,1,1,0,1,NYSE
4630,12-02-2021 18:00,24 hrs.,wallstreetbets,TEVA,6,0,6,-6,1,1,0,1,NYSE
4630,12-02-2021 18:00,24 hrs.,wallstreetbets,TWTR,7,7,0,7,1,1,1,1,NYSE
4630,12-02-2021 18:00,24 hrs.,wallstreetbets,UBER,40,7,33,-26,6,6,4,3,NYSE
4630,12-02-2021 18:00,24 hrs.,wallstreetbets,VGAC,7,7,0,7,1,1,1,1,NYSE
4630,12-02-2021 18:00,24 hrs.,wallstreetbets,VSTO,8,0,8,-8,1,1,2,1,NYSE
4630,12-02-2021 18:00,24 hrs.,wallstreetbets,WELL,335,0,335,-335,1,128,75,1,NYSE
4630,12-02-2021 18:00,24 hrs.,wallstreetbets,WORK,1743,1729,14,1715,3,700,331,3,NYSE
4630,12-02-2021 18:00,24 hrs.,wallstreetbets,XPEV,20,14,6,8,3,3,2,2,NYSE
4630,12-02-2021 18:00,24 hrs.,wallstreetbets,AAL,46,19,27,-8,7,7,4,6,NASDAQ
4630,12-02-2021 18:00,24 hrs.,wallstreetbets,ADI,402,0,402,-402,1,145,108,1,NASDAQ
4630,12-02-2021 18:00,24 hrs.,wallstreetbets,AMD,3741,1235,2506,-1271,33,1337,935,31,NASDAQ
4630,12-02-2021 18:00,24 hrs.,wallstreetbets,AQB,6,0,6,-6,1,1,0,1,NASDAQ
4630,12-02-2021 18:00,24 hrs.,wallstreetbets,ASO,12,6,6,0,2,2,0,2,NASDAQ
4630,12-02-2021 18:00,24 hrs.,wallstreetbets,AWH,13,0,13,-13,2,2,1,1,NASDAQ
4630,12-02-2021 18:00,24 hrs.,wallstreetbets,AZN,394,388,6,382,3,154,74,3,NASDAQ
4630,12-02-2021 18:00,24 hrs.,wallstreetbets,BFI,23,16,7,9,3,4,3,2,NASDAQ
4630,12-02-2021 18:00,24 hrs.,wallstreetbets,BLU,14,14,0,14,2,2,2,1,NASDAQ
4630,12-02-2021 18:00,24 hrs.,wallstreetbets,CDC,381,381,0,381,1,152,73,1,NASDAQ
4630,12-02-2021 18:00,24 hrs.,stocks,MGNI,60,0,60,-60,1,12,32,1,NASDAQ
4630,12-02-2021 18:00,24 hrs.,stocks,MKSI,8,8,0,8,1,1,2,1,NASDAQ
4630,12-02-2021 18:00,24 hrs.,stocks,MNPR,6,6,0,6,1,1,0,1,NASDAQ
4630,12-02-2021 18:00,24 hrs.,stocks,MSFT,25413,25,25388,-25363,3,11818,1765,3,NASDAQ
4630,12-02-2021 18:00,24 hrs.,stocks,MSTR,6,0,6,-6,1,1,0,1,NASDAQ
4630,12-02-2021 18:00,24 hrs.,stocks,MVIS,6,0,6,-6,1,1,0,1,NASDAQ
4630,12-02-2021 18:00,24 hrs.,stocks,NAKD,25,6,19,-13,3,3,7,3,NASDAQ
4630,12-02-2021 18:00,24 hrs.,stocks,NCMI,51,51,0,51,2,18,7,1,NASDAQ
4630,12-02-2021 18:00,24 hrs.,stocks,NTLA,16,0,16,-16,1,3,6,1,NASDAQ
4630,12-02-2021 18:00,24 hrs.,stocks,NTRS,8,0,8,-8,1,1,2,1,NASDAQ
4630,12-02-2021 18:00,24 hrs.,stocks,NVDA,25489,64,25425,-25361,5,11828,1813,5,NASDAQ
4630,12-02-2021 18:00,24 hrs.,stocks,NXTD,12,12,0,12,2,2,0,1,NASDAQ
4630,12-02-2021 18:00,24 hrs.,stocks,NYMT,8,8,0,8,1,1,2,1,NASDAQ
4630,12-02-2021 18:00,24 hrs.,stocks,OLED,85,85,0,85,1,39,3,1,NASDAQ
4630,12-02-2021 18:00,24 hrs.,stocks,ONTX,6,6,0,6,1,1,0,1,NASDAQ
4630,12-02-2021 18:00,24 hrs.,stocks,ONVO,6,6,0,6,1,1,0,1,NASDAQ
4630,12-02-2021 18:00,24 hrs.,stocks,OPRX,24,0,24,-24,1,3,14,1,NASDAQ
4630,12-02-2021 18:00,24 hrs.,stocks,PAAS,6,6,0,6,1,1,0,1,NASDAQ
4630,12-02-2021 18:00,24 hrs.,stocks,PENN,7,0,7,-7,1,1,1,1,NASDAQ
4630,12-02-2021 18:00,24 hrs.,stocks,PGNY,24,0,24,-24,1,3,14,1,NASDAQ
4630,12-02-2021 18:00,24 hrs.,stocks,PHUN,6,6,0,6,1,1,0,1,NASDAQ
4630,12-02-2021 18:00,24 hrs.,stocks,PLUG,82,82,0,82,1,11,56,1,NASDAQ
4630,12-02-2021 18:00,24 hrs.,stocks,POWW,212,0,212,-212,1,78,52,1,NASDAQ
4630,12-02-2021 18:00,24 hrs.,stocks,PSTV,6,6,0,6,1,1,0,1,NASDAQ
4630,12-02-2021 18:00,24 hrs.,stocks,PYPL,640,0,640,-640,2,260,112,2,NASDAQ
4630,12-02-2021 18:00,24 hrs.,stocks,QCLN,48,48,0,48,1,13,18,1,NASDAQ
4630,12-02-2021 18:00,24 hrs.,stocks,QCOM,14,0,14,-14,2,2,2,1,NASDAQ
4630,12-02-2021 18:00,24 hrs.,stocks,QQQM,67,26,41,-15,2,12,35,2,NASDAQ
4630,12-02-2021 18:00,24 hrs.,stocks,RGEN,24,0,24,-24,1,3,14,1,NASDAQ
4630,12-02-2021 18:00,24 hrs.,stocks,RIOT,6,0,6,-6,1,1,0,1,NASDAQ
4630,12-02-2021 18:00,24 hrs.,stocks,SABR,51,51,0,51,1,12,23,1,NASDAQ
4630,12-02-2021 18:00,24 hrs.,stocks,SEEL,18,12,6,6,3,3,0,2,NASDAQ
4630,12-02-2021 18:00,24 hrs.,stocks,SNDL,68,19,49,-30,11,11,2,10,NASDAQ
4630,12-02-2021 18:00,24 hrs.,stocks,SNGX,11,11,0,11,1,3,1,1,NASDAQ
4630,12-02-2021 18:00,24 hrs.,stocks,SPRO,24,0,24,-24,1,3,14,1,NASDAQ
4630,12-02-2021 18:00,24 hrs.,wallstreetbets,QQQ,969,0,969,-969,2,412,137,2,NASDAQ
4630,12-02-2021 18:00,24 hrs.,wallstreetbets,RCM,6,0,6,-6,1,1,0,1,NASDAQ
4630,12-02-2021 18:00,24 hrs.,wallstreetbets,RUN,7,0,7,-7,1,1,1,1,NASDAQ
4630,12-02-2021 18:00,24 hrs.,wallstreetbets,SFT,7,7,0,7,1,1,1,1,NASDAQ
4630,12-02-2021 18:00,24 hrs.,wallstreetbets,SLS,6,0,6,-6,1,1,0,1,NASDAQ
4630,12-02-2021 18:00,24 hrs.,wallstreetbets,SND,34,34,0,34,5,5,4,5,NASDAQ
4630,12-02-2021 18:00,24 hrs.,wallstreetbets,SPI,7,7,0,7,1,1,1,1,NASDAQ
4630,12-02-2021 18:00,24 hrs.,wallstreetbets,TXN,402,0,402,-402,1,145,108,1,NASDAQ
4630,12-02-2021 18:00,24 hrs.,wallstreetbets,UAL,7,0,7,-7,1,1,1,1,NASDAQ
4630,12-02-2021 18:00,24 hrs.,wallstreetbets,UFO,6,6,0,6,1,1,0,1,NASDAQ
4630,12-02-2021 18:00,24 hrs.,wallstreetbets,VFF,22,14,8,6,3,3,4,3,NASDAQ
4630,12-02-2021 18:00,24 hrs.,wallstreetbets,WDC,38,0,38,-38,2,12,6,1,NASDAQ
4630,12-02-2021 18:00,24 hrs.,wallstreetbets,WNW,21,15,6,9,3,3,3,3,NASDAQ
4630,12-02-2021 18:00,24 hrs.,wallstreetbets,WVE,6,0,6,-6,1,1,0,1,NASDAQ
4630,12-02-2021 18:00,24 hrs.,wallstreetbets,AACG,7,7,0,7,1,1,1,1,NASDAQ
4630,12-02-2021 18:00,24 hrs.,wallstreetbets,AAPL,263,13,250,-237,6,74,91,6,NASDAQ
4630,12-02-2021 18:00,24 hrs.,wallstreetbets,AAWW,6,6,0,6,1,1,0,1,NASDAQ
4630,12-02-2021 18:00,24 hrs.,wallstreetbets,ABEO,13,7,6,1,2,2,1,2,NASDAQ
4630,12-02-2021 18:00,24 hrs.,wallstreetbets,ABIO,7,0,7,-7,1,1,1,1,NASDAQ
4630,12-02-2021 18:00,24 hrs.,wallstreetbets,ABNB,29,22,7,15,4,4,5,3,NASDAQ
4630,12-02-2021 18:00,24 hrs.,wallstreetbets,ACIU,19,7,12,-5,3,3,1,3,NASDAQ
4630,12-02-2021 18:00,24 hrs.,wallstreetbets,ACRX,6,0,6,-6,1,1,0,1,NASDAQ
4630,12-02-2021 18:00,24 hrs.,wallstreetbets,ACST,19,13,6,7,3,3,1,3,NASDAQ
4630,12-02-2021 18:00,24 hrs.,wallstreetbets,ADXS,6,6,0,6,1,1,0,1,NASDAQ
4630,12-02-2021 18:00,24 hrs.,wallstreetbets,AESE,30,0,30,-30,5,5,0,2,NASDAQ
4630,12-02-2021 18:00,24 hrs.,wallstreetbets,AEZS,14,14,0,14,2,2,2,1,NASDAQ
4630,12-02-2021 18:00,24 hrs.,wallstreetbets,AGEN,7,7,0,7,1,1,1,1,NASDAQ
4630,12-02-2021 18:00,24 hrs.,wallstreetbets,AGRX,6,0,6,-6,1,1,0,1,NASDAQ
4630,12-02-2021 18:00,24 hrs.,wallstreetbets,AGTC,61,29,32,-3,9,9,7,8,NASDAQ
4630,12-02-2021 18:00,24 hrs.,stocks,XSPA,6,0,6,-6,1,1,0,1,NASDAQ
4630,12-02-2021 18:00,24 hrs.,stocks,ZSAN,12,0,12,-12,2,2,0,2,NASDAQ
4630,12-02-2021 18:00,24 hrs.,stocks,ZYXI,24,0,24,-24,1,3,14,1,NASDAQ
4630,12-02-2021 18:00,24 hrs.,stocks,DISCA,12,12,0,12,2,2,0,2,NASDAQ
4630,12-02-2021 18:00,24 hrs.,Daytrading,AABB,29,0,29,-29,1,9,7,1,OTC
4630,12-02-2021 18:00,24 hrs.,Daytrading,HCMC,29,0,29,-29,1,9,7,1,OTC
4630,12-02-2021 18:00,24 hrs.,Daytrading,HMPQ,16,0,16,-16,1,3,6,1,OTC
4630,12-02-2021 18:00,24 hrs.,Daytrading,IDEA,6,0,6,-6,1,1,0,1,OTC
4630,12-02-2021 18:00,24 hrs.,Daytrading,INKW,8,0,8,-8,1,2,0,1,OTC
4630,12-02-2021 18:00,24 hrs.,Daytrading,LVVV,29,0,29,-29,1,9,7,1,OTC
4630,12-02-2021 18:00,24 hrs.,Daytrading,RLTR,6,6,0,6,1,1,0,1,OTC
4630,12-02-2021 18:00,24 hrs.,Daytrading,TSTS,35,0,35,-35,2,10,7,2,OTC
4630,12-02-2021 18:00,24 hrs.,Daytrading,MNKKQ,6,0,6,-6,1,1,0,1,OTC
4630,12-02-2021 18:00,24 hrs.,Daytrading,DNN,364,364,0,364,2,148,60,2,AMEX
4630,12-02-2021 18:00,24 hrs.,Daytrading,DSS,358,358,0,358,1,147,60,1,AMEX
4630,12-02-2021 18:00,24 hrs.,Daytrading,MXC,6,6,0,6,1,1,0,1,AMEX
4630,12-02-2021 18:00,24 hrs.,Daytrading,TRX,6,0,6,-6,1,1,0,1,AMEX
4630,12-02-2021 18:00,24 hrs.,Daytrading,TRXC,6,0,6,-6,1,1,0,1,AMEX
4630,12-02-2021 18:00,24 hrs.,Daytrading,ACB,364,364,0,364,2,148,60,2,NYSE
4630,12-02-2021 18:00,24 hrs.,Daytrading,ADX,9,9,0,9,1,2,1,1,NYSE
4630,12-02-2021 18:00,24 hrs.,Daytrading,AMC,6,0,6,-6,1,1,0,1,NYSE
4630,12-02-2021 18:00,24 hrs.,Daytrading,BDX,7,7,0,7,1,1,1,1,NYSE
4630,12-02-2021 18:00,24 hrs.,Daytrading,BFT,14,0,14,-14,1,4,2,1,NYSE
4630,12-02-2021 18:00,24 hrs.,Daytrading,FSR,358,358,0,358,1,147,60,1,NYSE
4630,12-02-2021 18:00,24 hrs.,Daytrading,GME,6,6,0,6,1,1,0,1,NYSE
4630,12-02-2021 18:00,24 hrs.,Daytrading,NOK,18,18,0,18,1,0,14,1,NYSE
4630,12-02-2021 18:00,24 hrs.,Daytrading,PDT,14,14,0,14,1,2,6,1,NYSE
4630,12-02-2021 18:00,24 hrs.,Daytrading,RTP,358,358,0,358,1,147,60,1,NYSE
4630,12-02-2021 18:00,24 hrs.,Daytrading,SCI,6,0,6,-6,1,1,0,1,NYSE
4630,12-02-2021 18:00,24 hrs.,Daytrading,WLL,6,6,0,6,1,1,0,1,NYSE
4630,12-02-2021 18:00,24 hrs.,Daytrading,CCIV,358,358,0,358,1,147,60,1,NYSE
4630,12-02-2021 18:00,24 hrs.,Daytrading,CHWY,6,6,0,6,1,1,0,1,NYSE
4630,12-02-2021 18:00,24 hrs.,Daytrading,SPCE,365,365,0,365,2,148,61,2,NYSE
4630,12-02-2021 18:00,24 hrs.,wallstreetbets,PUMP,55,49,6,43,8,8,7,3,NYSE
4630,12-02-2021 18:00,24 hrs.,wallstreetbets,QUAD,8,0,8,-8,1,1,2,1,NYSE
4630,12-02-2021 18:00,24 hrs.,trakstocks,AESE,12,0,12,-12,1,2,4,1,NASDAQ
4630,12-02-2021 18:00,24 hrs.,trakstocks,APPS,6,6,0,6,1,1,0,1,NASDAQ
4630,12-02-2021 18:00,24 hrs.,trakstocks,AYRO,154,0,154,-154,1,57,36,1,NASDAQ
4630,12-02-2021 18:00,24 hrs.,trakstocks,BTBT,13,0,13,-13,1,3,3,1,NASDAQ
4630,12-02-2021 18:00,24 hrs.,trakstocks,CHEF,28,0,28,-28,1,9,6,1,NASDAQ
4630,12-02-2021 18:00,24 hrs.,trakstocks,CPSH,100,7,93,-86,3,40,8,3,NASDAQ
4630,12-02-2021 18:00,24 hrs.,trakstocks,CTRM,59,0,59,-59,2,23,5,1,NASDAQ
4630,12-02-2021 18:00,24 hrs.,trakstocks,EXPC,23,0,23,-23,1,9,1,1,NASDAQ
4630,12-02-2021 18:00,24 hrs.,trakstocks,FUTU,45,0,45,-45,1,13,15,1,NASDAQ
4630,12-02-2021 18:00,24 hrs.,trakstocks,GEVO,77,0,77,-77,1,32,9,1,NASDAQ
4630,12-02-2021 18:00,24 hrs.,trakstocks,GHIV,45,0,45,-45,1,13,15,1,NASDAQ
4630,12-02-2021 18:00,24 hrs.,trakstocks,GMBL,12,0,12,-12,1,2,4,1,NASDAQ
4630,12-02-2021 18:00,24 hrs.,trakstocks,GMDA,12,0,12,-12,1,1,6,1,NASDAQ
4630,12-02-2021 18:00,24 hrs.,trakstocks,GTHX,6,6,0,6,1,1,0,1,NASDAQ
4630,12-02-2021 18:00,24 hrs.,trakstocks,IBKR,45,0,45,-45,1,13,15,1,NASDAQ
4630,12-02-2021 18:00,24 hrs.,trakstocks,IRBT,25,0,25,-25,1,7,7,1,NASDAQ
4630,12-02-2021 18:00,24 hrs.,trakstocks,LKCO,23,0,23,-23,1,7,5,1,NASDAQ
4630,12-02-2021 18:00,24 hrs.,Daytrading,AMD,10,10,0,10,1,0,6,1,NASDAQ
4630,12-02-2021 18:00,24 hrs.,Daytrading,API,50,50,0,50,1,20,6,1,NASDAQ
4630,12-02-2021 18:00,24 hrs.,Daytrading,INO,358,358,0,358,1,147,60,1,NASDAQ
4630,12-02-2021 18:00,24 hrs.,Daytrading,OGI,15,15,0,15,1,2,7,1,NASDAQ
4630,12-02-2021 18:00,24 hrs.,Daytrading,ACST,6,6,0,6,1,1,0,1,NASDAQ
4630,12-02-2021 18:00,24 hrs.,Daytrading,APDN,358,358,0,358,1,147,60,1,NASDAQ
4630,12-02-2021 18:00,24 hrs.,Daytrading,APHA,383,358,25,333,3,152,67,2,NASDAQ
4630,12-02-2021 18:00,24 hrs.,Daytrading,ARTL,439,439,0,439,5,174,71,5,NASDAQ
4630,12-02-2021 18:00,24 hrs.,Daytrading,AZRX,7,0,7,-7,1,1,1,1,NASDAQ
4630,12-02-2021 18:00,24 hrs.,Daytrading,BYND,6,0,6,-6,1,1,0,1,NASDAQ
4630,12-02-2021 18:00,24 hrs.,Daytrading,CLEU,407,407,0,407,2,166,67,2,NASDAQ
4630,12-02-2021 18:00,24 hrs.,Daytrading,CLGN,358,358,0,358,1,147,60,1,NASDAQ
4630,12-02-2021 18:00,24 hrs.,Daytrading,CLSN,358,358,0,358,1,147,60,1,NASDAQ
4630,12-02-2021 18:00,24 hrs.,Daytrading,CMLF,358,358,0,358,1,147,60,1,NASDAQ
4630,12-02-2021 18:00,24 hrs.,Daytrading,CRSR,358,358,0,358,1,147,60,1,NASDAQ
4630,12-02-2021 18:00,24 hrs.,Daytrading,EXPE,4,4,0,4,1,0,0,1,NASDAQ
4630,12-02-2021 18:00,24 hrs.,Daytrading,FOLD,364,364,0,364,2,148,60,2,NASDAQ
4630,12-02-2021 18:00,24 hrs.,Daytrading,FTFT,358,358,0,358,1,147,60,1,NASDAQ
4630,12-02-2021 18:00,24 hrs.,Daytrading,IBKR,14,0,14,-14,1,2,6,1,NASDAQ
4630,12-02-2021 18:00,24 hrs.,Daytrading,LIVE,38,38,0,38,2,14,2,1,NASDAQ
4630,12-02-2021 18:00,24 hrs.,Daytrading,MARA,358,358,0,358,1,147,60,1,NASDAQ
4630,12-02-2021 18:00,24 hrs.,Daytrading,NOVN,358,358,0,358,1,147,60,1,NASDAQ
4630,12-02-2021 18:00,24 hrs.,Daytrading,OCGN,23,23,0,23,1,3,13,1,NASDAQ
4630,12-02-2021 18:00,24 hrs.,wallstreetbets,CGC,1359,89,1270,-1181,11,467,381,10,NASDAQ
4630,12-02-2021 18:00,24 hrs.,wallstreetbets,CTG,7,7,0,7,1,1,1,1,NASDAQ
4630,12-02-2021 18:00,24 hrs.,wallstreetbets,DYN,6,0,6,-6,1,1,0,1,NASDAQ
4630,12-02-2021 18:00,24 hrs.,wallstreetbets,ESG,8,0,8,-8,1,1,2,1,NASDAQ
4630,12-02-2021 18:00,24 hrs.,wallstreetbets,FAT,133,133,0,133,1,40,49,1,NASDAQ
4630,12-02-2021 18:00,24 hrs.,wallstreetbets,FUV,7,7,0,7,1,1,1,1,NASDAQ
4630,12-02-2021 18:00,24 hrs.,wallstreetbets,FWP,14,14,0,14,2,2,2,1,NASDAQ
4630,12-02-2021 18:00,24 hrs.,wallstreetbets,GBT,6,0,6,-6,1,1,0,1,NASDAQ
4630,12-02-2021 18:00,24 hrs.,wallstreetbets,GSM,12,6,6,0,2,2,0,2,NASDAQ
4630,12-02-2021 18:00,24 hrs.,wallstreetbets,HAS,52,7,45,-38,8,8,4,8,NASDAQ
4630,12-02-2021 18:00,24 hrs.,wallstreetbets,HPK,6,6,0,6,1,1,0,1,NASDAQ
4630,12-02-2021 18:00,24 hrs.,wallstreetbets,III,6,0,6,-6,1,1,0,1,NASDAQ
4630,12-02-2021 18:00,24 hrs.,wallstreetbets,INO,751,682,69,613,21,256,155,19,NASDAQ
4630,12-02-2021 18:00,24 hrs.,wallstreetbets,IPA,7,0,7,-7,1,1,1,1,NASDAQ
4630,12-02-2021 18:00,24 hrs.,wallstreetbets,JFU,6,0,6,-6,1,1,0,1,NASDAQ
4630,12-02-2021 18:00,24 hrs.,wallstreetbets,KHC,12,0,12,-12,2,2,0,2,NASDAQ
4630,12-02-2021 18:00,24 hrs.,wallstreetbets,KOD,6,6,0,6,1,1,0,1,NASDAQ
4630,12-02-2021 18:00,24 hrs.,wallstreetbets,MGI,9,9,0,9,1,1,3,1,NASDAQ
4630,12-02-2021 18:00,24 hrs.,wallstreetbets,NPA,13,6,7,-1,2,2,1,2,NASDAQ
4630,12-02-2021 18:00,24 hrs.,wallstreetbets,NWL,381,381,0,381,1,152,73,1,NASDAQ
4630,12-02-2021 18:00,24 hrs.,wallstreetbets,OGI,133,47,86,-39,20,20,13,18,NASDAQ
4630,12-02-2021 18:00,24 hrs.,wallstreetbets,OPK,7,7,0,7,1,1,1,1,NASDAQ
4630,12-02-2021 18:00,24 hrs.,wallstreetbets,OPT,7,0,7,-7,1,1,1,1,NASDAQ
4630,12-02-2021 18:00,24 hrs.,wallstreetbets,PTE,35,35,0,35,5,5,5,1,NASDAQ
4630,12-02-2021 18:00,24 hrs.,wallstreetbets,CATM,7,7,0,7,1,1,1,1,NASDAQ
4630,12-02-2021 18:00,24 hrs.,wallstreetbets,CBAT,7,7,0,7,1,1,1,1,NASDAQ
4630,12-02-2021 18:00,24 hrs.,wallstreetbets,CCNC,6,0,6,-6,1,1,0,1,NASDAQ
4630,12-02-2021 18:00,24 hrs.,wallstreetbets,CCRC,12,12,0,12,2,2,0,1,NASDAQ
4630,12-02-2021 18:00,24 hrs.,wallstreetbets,CGIX,14,0,14,-14,2,2,2,1,NASDAQ
4630,12-02-2021 18:00,24 hrs.,wallstreetbets,CGRO,6,0,6,-6,1,1,0,1,NASDAQ
4630,12-02-2021 18:00,24 hrs.,wallstreetbets,CHKP,6,0,6,-6,1,1,0,1,NASDAQ
4630,12-02-2021 18:00,24 hrs.,wallstreetbets,CIDM,14,14,0,14,2,2,2,2,NASDAQ
4630,12-02-2021 18:00,24 hrs.,wallstreetbets,CKPT,26,14,12,2,4,4,2,3,NASDAQ
4630,12-02-2021 18:00,24 hrs.,wallstreetbets,CLBS,26,14,12,2,4,4,2,3,NASDAQ
4630,12-02-2021 18:00,24 hrs.,wallstreetbets,CLCT,6,0,6,-6,1,1,0,1,NASDAQ
4630,12-02-2021 18:00,24 hrs.,wallstreetbets,CLEU,7,7,0,7,1,1,1,1,NASDAQ
4630,12-02-2021 18:00,24 hrs.,wallstreetbets,CLNE,133,0,133,-133,2,40,45,2,NASDAQ
4630,12-02-2021 18:00,24 hrs.,wallstreetbets,CLSN,7,7,0,7,1,1,1,1,NASDAQ
4630,12-02-2021 18:00,24 hrs.,wallstreetbets,CLVS,34,0,34,-34,5,5,4,4,NASDAQ
4630,12-02-2021 18:00,24 hrs.,wallstreetbets,CMLF,7,0,7,-7,1,1,1,1,NASDAQ
4630,12-02-2021 18:00,24 hrs.,wallstreetbets,CMPS,1764,1749,15,1734,6,703,334,5,NASDAQ
4630,12-02-2021 18:00,24 hrs.,Daytrading,PLAY,10,10,0,10,1,0,6,1,NASDAQ
4630,12-02-2021 18:00,24 hrs.,Daytrading,PLUS,11,0,11,-11,1,2,3,1,NASDAQ
4630,12-02-2021 18:00,24 hrs.,Daytrading,PYPL,358,358,0,358,1,147,60,1,NASDAQ
4630,12-02-2021 18:00,24 hrs.,Daytrading,RIDE,358,358,0,358,1,147,60,1,NASDAQ
4630,12-02-2021 18:00,24 hrs.,Daytrading,RIOT,358,358,0,358,1,147,60,1,NASDAQ
4630,12-02-2021 18:00,24 hrs.,Daytrading,SNDL,15,15,0,15,1,2,7,1,NASDAQ
4630,12-02-2021 18:00,24 hrs.,Daytrading,STAY,33,33,0,33,1,14,1,1,NASDAQ
4630,12-02-2021 18:00,24 hrs.,Daytrading,TLRY,398,373,25,348,3,156,74,3,NASDAQ
4630,12-02-2021 18:00,24 hrs.,Daytrading,WAFU,49,49,0,49,1,19,7,1,NASDAQ
4630,12-02-2021 18:00,24 hrs.,Daytrading,XERS,358,358,0,358,1,147,60,1,NASDAQ
4630,12-02-2021 18:00,24 hrs.,trakstocks,BRGO,6,0,6,-6,1,1,0,1,OTC
4630,12-02-2021 18:00,24 hrs.,trakstocks,BRTX,6,6,0,6,1,1,0,1,OTC
4630,12-02-2021 18:00,24 hrs.,trakstocks,MMEX,15,15,0,15,2,3,1,2,OTC
4630,12-02-2021 18:00,24 hrs.,trakstocks,MOST,6,6,0,6,1,1,0,1,OTC
4630,12-02-2021 18:00,24 hrs.,trakstocks,SGSI,16,0,16,-16,1,6,0,1,OTC
4630,12-02-2021 18:00,24 hrs.,trakstocks,SMVI,6,0,6,-6,1,1,0,1,OTC
4630,12-02-2021 18:00,24 hrs.,trakstocks,SUIC,6,0,6,-6,1,1,0,1,OTC
4630,12-02-2021 18:00,24 hrs.,trakstocks,ARBKF,6,6,0,6,1,1,0,1,OTC
4630,12-02-2021 18:00,24 hrs.,trakstocks,BBXIA,6,6,0,6,1,1,0,1,OTC
4630,12-02-2021 18:00,24 hrs.,trakstocks,HUTMF,12,0,12,-12,1,1,6,1,OTC
4630,12-02-2021 18:00,24 hrs.,trakstocks,PYRNF,6,6,0,6,1,1,0,1,OTC
4630,12-02-2021 18:00,24 hrs.,trakstocks,TRXC,116,47,69,-22,2,41,26,2,AMEX
4630,12-02-2021 18:00,24 hrs.,trakstocks,UUUU,47,0,47,-47,1,12,19,1,AMEX
4630,12-02-2021 18:00,24 hrs.,trakstocks,AMC,71,26,45,-19,2,16,31,2,NYSE
4630,12-02-2021 18:00,24 hrs.,trakstocks,BFT,49,0,49,-49,1,13,19,1,NYSE
4630,12-02-2021 18:00,24 hrs.,trakstocks,CPS,77,0,77,-77,1,34,5,1,NYSE
4630,12-02-2021 18:00,24 hrs.,trakstocks,GME,71,26,45,-19,2,16,31,2,NYSE
4630,12-02-2021 18:00,24 hrs.,trakstocks,LEN,11,11,0,11,1,3,1,1,NYSE
4630,12-02-2021 18:00,24 hrs.,trakstocks,NAV,45,0,45,-45,1,13,15,1,NYSE
4630,12-02-2021 18:00,24 hrs.,trakstocks,PCG,45,0,45,-45,1,13,15,1,NYSE
4630,12-02-2021 18:00,24 hrs.,trakstocks,RKT,45,0,45,-45,1,13,15,1,NYSE
4630,12-02-2021 18:00,24 hrs.,trakstocks,SOL,6,6,0,6,1,1,0,1,NYSE
4630,12-02-2021 18:00,24 hrs.,trakstocks,SOS,58,0,58,-58,1,26,2,1,NYSE
4630,12-02-2021 18:00,24 hrs.,trakstocks,SPH,12,0,12,-12,1,4,0,1,NYSE
4630,12-02-2021 18:00,24 hrs.,trakstocks,WPF,6,0,6,-6,1,1,0,1,NYSE
4630,12-02-2021 18:00,24 hrs.,trakstocks,ARGO,6,6,0,6,1,1,0,1,NYSE
4630,12-02-2021 18:00,24 hrs.,trakstocks,BEKE,45,0,45,-45,1,13,15,1,NYSE
4630,12-02-2021 18:00,24 hrs.,trakstocks,CCIV,39,0,39,-39,4,8,7,3,NYSE
4630,12-02-2021 18:00,24 hrs.,trakstocks,FUSE,6,0,6,-6,1,1,0,1,NYSE
4630,12-02-2021 18:00,24 hrs.,trakstocks,IIPR,17,0,17,-17,1,5,3,1,NYSE
4630,12-02-2021 18:00,24 hrs.,trakstocks,MDLY,6,0,6,-6,1,1,0,1,NYSE
4630,12-02-2021 18:00,24 hrs.,trakstocks,SKLZ,6,0,6,-6,1,1,0,1,NYSE
4630,12-02-2021 18:00,24 hrs.,trakstocks,STIC,23,0,23,-23,1,7,5,1,NYSE
4630,12-02-2021 18:00,24 hrs.,trakstocks,STPK,91,0,91,-91,3,30,19,3,NYSE
4630,12-02-2021 18:00,24 hrs.,trakstocks,CFO,352,0,352,-352,1,153,42,1,NASDAQ
4630,12-02-2021 18:00,24 hrs.,trakstocks,HOL,49,0,49,-49,1,13,19,1,NASDAQ
4630,12-02-2021 18:00,24 hrs.,trakstocks,ABEO,31,8,23,-15,2,10,3,2,NASDAQ
4630,12-02-2021 18:00,24 hrs.,wallstreetbets,COHR,381,381,0,381,1,152,73,1,NASDAQ
4630,12-02-2021 18:00,24 hrs.,wallstreetbets,CPST,12,0,12,-12,2,2,0,1,NASDAQ
4630,12-02-2021 18:00,24 hrs.,wallstreetbets,CRBP,21,21,0,21,3,3,3,3,NASDAQ
4630,12-02-2021 18:00,24 hrs.,wallstreetbets,CRNT,13,13,0,13,2,2,1,2,NASDAQ
4630,12-02-2021 18:00,24 hrs.,wallstreetbets,CRON,30,6,24,-18,5,5,0,3,NASDAQ
4630,12-02-2021 18:00,24 hrs.,wallstreetbets,CRSR,5863,41,5822,-5781,9,2523,781,7,NASDAQ
4630,12-02-2021 18:00,24 hrs.,wallstreetbets,CSCW,12,0,12,-12,2,2,0,2,NASDAQ
4630,12-02-2021 18:00,24 hrs.,wallstreetbets,CTHR,7,7,0,7,1,1,1,1,NASDAQ
4630,12-02-2021 18:00,24 hrs.,wallstreetbets,CTRM,538,203,335,-132,84,84,34,71,NASDAQ
4630,12-02-2021 18:00,24 hrs.,wallstreetbets,CTRN,6,0,6,-6,1,1,0,1,NASDAQ
4630,12-02-2021 18:00,24 hrs.,wallstreetbets,DBVT,14,8,6,2,2,2,2,2,NASDAQ
4630,12-02-2021 18:00,24 hrs.,wallstreetbets,DDOG,394,381,13,368,3,154,74,3,NASDAQ
4630,12-02-2021 18:00,24 hrs.,wallstreetbets,DFFN,14,14,0,14,2,2,2,1,NASDAQ
4630,12-02-2021 18:00,24 hrs.,wallstreetbets,DKNG,983,14,969,-955,4,414,139,4,NASDAQ
4630,12-02-2021 18:00,24 hrs.,wallstreetbets,DLPN,12,0,12,-12,2,2,0,1,NASDAQ
4630,12-02-2021 18:00,24 hrs.,wallstreetbets,DOYU,7,7,0,7,1,1,1,1,NASDAQ
4630,12-02-2021 18:00,24 hrs.,wallstreetbets,DRRX,7,7,0,7,1,1,1,1,NASDAQ
4630,12-02-2021 18:00,24 hrs.,trakstocks,MARA,25,0,25,-25,2,4,9,2,NASDAQ
4630,12-02-2021 18:00,24 hrs.,wallstreetbets,AIKI,7,7,0,7,1,1,1,1,NASDAQ
4630,12-02-2021 18:00,24 hrs.,wallstreetbets,AKER,6,0,6,-6,1,1,0,1,NASDAQ
4630,12-02-2021 18:00,24 hrs.,wallstreetbets,ALGM,6,0,6,-6,1,1,0,1,NASDAQ
4630,12-02-2021 18:00,24 hrs.,wallstreetbets,ALJJ,7,0,7,-7,1,1,1,1,NASDAQ
4630,12-02-2021 18:00,24 hrs.,wallstreetbets,AMAT,26,14,12,2,4,4,2,3,NASDAQ
4630,12-02-2021 18:00,24 hrs.,wallstreetbets,AMBC,8,8,0,8,1,1,2,1,NASDAQ
4630,12-02-2021 18:00,24 hrs.,wallstreetbets,AMKR,554,14,540,-526,7,187,152,5,NASDAQ
4630,12-02-2021 18:00,24 hrs.,wallstreetbets,AMRN,6,0,6,-6,1,1,0,1,NASDAQ
4630,12-02-2021 18:00,24 hrs.,wallstreetbets,AMZN,816,796,20,776,5,334,128,5,NASDAQ
4630,12-02-2021 18:00,24 hrs.,wallstreetbets,ANCN,7,7,0,7,1,1,1,1,NASDAQ
4630,12-02-2021 18:00,24 hrs.,wallstreetbets,ANTE,6,0,6,-6,1,1,0,1,NASDAQ
4630,12-02-2021 18:00,24 hrs.,wallstreetbets,APHA,77875,295,77580,-77285,98,36450,4583,84,NASDAQ
4630,12-02-2021 18:00,24 hrs.,wallstreetbets,APRE,7,7,0,7,1,1,1,1,NASDAQ
4630,12-02-2021 18:00,24 hrs.,wallstreetbets,APXT,35,15,20,-5,5,5,5,4,NASDAQ
4630,12-02-2021 18:00,24 hrs.,wallstreetbets,AQMS,7,0,7,-7,1,1,1,1,NASDAQ
4630,12-02-2021 18:00,24 hrs.,wallstreetbets,AQST,13,13,0,13,2,2,1,2,NASDAQ
4630,12-02-2021 18:00,24 hrs.,wallstreetbets,ARTL,89,89,0,89,13,13,11,11,NASDAQ
4630,12-02-2021 18:00,24 hrs.,wallstreetbets,ASML,21,0,21,-21,3,3,3,2,NASDAQ
4630,12-02-2021 18:00,24 hrs.,wallstreetbets,ASRT,25,13,12,1,4,4,1,4,NASDAQ
4630,12-02-2021 18:00,24 hrs.,wallstreetbets,ASYS,6,6,0,6,1,1,0,1,NASDAQ
4630,12-02-2021 18:00,24 hrs.,wallstreetbets,ATHE,6,6,0,6,1,1,0,1,NASDAQ
4630,12-02-2021 18:00,24 hrs.,wallstreetbets,ATHX,13,0,13,-13,2,2,1,2,NASDAQ
4630,12-02-2021 18:00,24 hrs.,wallstreetbets,ATNF,7,0,7,-7,1,1,1,1,NASDAQ
4630,12-02-2021 18:00,24 hrs.,wallstreetbets,ATOS,14,7,7,0,2,2,2,2,NASDAQ
4630,12-02-2021 18:00,24 hrs.,wallstreetbets,AUPH,6,6,0,6,1,1,0,1,NASDAQ
4630,12-02-2021 18:00,24 hrs.,wallstreetbets,AUTL,14,14,0,14,2,2,2,1,NASDAQ
4630,12-02-2021 18:00,24 hrs.,wallstreetbets,AVAV,6,0,6,-6,1,1,0,1,NASDAQ
4630,12-02-2021 18:00,24 hrs.,wallstreetbets,AWRE,7,7,0,7,1,1,1,1,NASDAQ
4630,12-02-2021 18:00,24 hrs.,wallstreetbets,AXDX,21,0,21,-21,3,3,3,1,NASDAQ
4630,12-02-2021 18:00,24 hrs.,wallstreetbets,AYRO,7,7,0,7,1,1,1,1,NASDAQ
4630,12-02-2021 18:00,24 hrs.,wallstreetbets,BBBY,12,0,12,-12,2,2,0,2,NASDAQ
4630,12-02-2021 18:00,24 hrs.,wallstreetbets,BEAT,14,8,6,2,2,3,0,2,NASDAQ
4630,12-02-2021 18:00,24 hrs.,wallstreetbets,BHAT,6,0,6,-6,1,1,0,1,NASDAQ
4630,12-02-2021 18:00,24 hrs.,wallstreetbets,BIGC,35,0,35,-35,5,5,5,2,NASDAQ
4630,12-02-2021 18:00,24 hrs.,wallstreetbets,BIOC,14,7,7,0,2,2,2,2,NASDAQ
4630,12-02-2021 18:00,24 hrs.,wallstreetbets,BLNK,7,7,0,7,1,1,1,1,NASDAQ
4630,12-02-2021 18:00,24 hrs.,wallstreetbets,BLUE,6,0,6,-6,1,1,0,1,NASDAQ
4630,12-02-2021 18:00,24 hrs.,wallstreetbets,BNGO,26,14,12,2,4,4,2,3,NASDAQ
4630,12-02-2021 18:00,24 hrs.,wallstreetbets,BNTX,13,13,0,13,2,2,1,1,NASDAQ
4630,12-02-2021 18:00,24 hrs.,wallstreetbets,BOXL,7,7,0,7,1,1,1,1,NASDAQ
4630,12-02-2021 18:00,24 hrs.,wallstreetbets,BPTH,13,7,6,1,2,2,1,2,NASDAQ
4630,12-02-2021 18:00,24 hrs.,wallstreetbets,BRQS,31,6,25,-19,5,5,1,4,NASDAQ
4630,12-02-2021 18:00,24 hrs.,wallstreetbets,BSGM,6,0,6,-6,1,1,0,1,NASDAQ
4630,12-02-2021 18:00,24 hrs.,wallstreetbets,CARE,49,49,0,49,7,7,7,2,NASDAQ
4630,12-02-2021 18:00,24 hrs.,wallstreetbets,CARV,20,7,13,-6,3,3,2,3,NASDAQ
4630,12-02-2021 18:00,24 hrs.,wallstreetbets,CASH,14,14,0,14,2,2,2,2,NASDAQ
4630,12-02-2021 18:00,24 hrs.,StockMarket,BOTY,36,4,32,-28,3,2,20,2,OTC
4630,12-02-2021 18:00,24 hrs.,StockMarket,DIGI,6,6,0,6,1,1,0,1,OTC
4630,12-02-2021 18:00,24 hrs.,StockMarket,FMCC,92,0,92,-92,1,26,36,1,OTC
4630,12-02-2021 18:00,24 hrs.,StockMarket,FNMA,92,0,92,-92,1,26,36,1,OTC
4630,12-02-2021 18:00,24 hrs.,StockMarket,GAXY,20,0,20,-20,1,8,0,1,OTC
4630,12-02-2021 18:00,24 hrs.,StockMarket,GTSO,11,0,11,-11,1,3,1,1,OTC
4630,12-02-2021 18:00,24 hrs.,StockMarket,GTVH,6,6,0,6,1,1,0,1,OTC
4630,12-02-2021 18:00,24 hrs.,StockMarket,HCMC,50,50,0,50,2,17,8,2,OTC
4630,12-02-2021 18:00,24 hrs.,StockMarket,HEMP,6,6,0,6,1,1,0,1,OTC
4630,12-02-2021 18:00,24 hrs.,StockMarket,KWBT,6,6,0,6,1,1,0,1,OTC
4630,12-02-2021 18:00,24 hrs.,StockMarket,LINK,13,13,0,13,1,3,3,1,OTC
4630,12-02-2021 18:00,24 hrs.,StockMarket,MOST,13,13,0,13,1,3,3,1,OTC
4630,12-02-2021 18:00,24 hrs.,StockMarket,PCTL,6,6,0,6,1,1,0,1,OTC
4630,12-02-2021 18:00,24 hrs.,StockMarket,RLTR,6,6,0,6,1,1,0,1,OTC
4630,12-02-2021 18:00,24 hrs.,StockMarket,RSSV,14,14,0,14,1,4,2,1,OTC
4630,12-02-2021 18:00,24 hrs.,StockMarket,RTON,6,0,6,-6,1,1,0,1,OTC
4630,12-02-2021 18:00,24 hrs.,StockMarket,SGMD,70,70,0,70,3,11,36,2,OTC
4630,12-02-2021 18:00,24 hrs.,StockMarket,SUIC,6,0,6,-6,1,1,0,1,OTC
4630,12-02-2021 18:00,24 hrs.,StockMarket,CLUBQ,9,0,9,-9,1,2,1,1,OTC
4630,12-02-2021 18:00,24 hrs.,StockMarket,HITIF,83,0,83,-83,1,19,41,1,OTC
4630,12-02-2021 18:00,24 hrs.,StockMarket,HTZGQ,6,6,0,6,1,1,0,1,OTC
4630,12-02-2021 18:00,24 hrs.,StockMarket,NMGRF,6,6,0,6,1,1,0,1,OTC
4630,12-02-2021 18:00,24 hrs.,StockMarket,NXGWF,21,0,21,-21,1,8,1,1,OTC
4630,12-02-2021 18:00,24 hrs.,StockMarket,RHDGF,6,6,0,6,1,1,0,1,OTC
4630,12-02-2021 18:00,24 hrs.,StockMarket,RYCEY,12,6,6,0,2,2,0,2,OTC
4630,12-02-2021 18:00,24 hrs.,StockMarket,DNN,31,6,25,-19,2,7,9,2,AMEX
4630,12-02-2021 18:00,24 hrs.,StockMarket,GSV,33,0,33,-33,1,7,15,1,AMEX
4630,12-02-2021 18:00,24 hrs.,StockMarket,IGC,16,0,16,-16,1,5,2,1,AMEX
4630,12-02-2021 18:00,24 hrs.,StockMarket,ITP,8,0,8,-8,1,1,2,1,AMEX
4630,12-02-2021 18:00,24 hrs.,StockMarket,REI,10,0,10,-10,1,3,0,1,AMEX
4630,12-02-2021 18:00,24 hrs.,StockMarket,URG,25,0,25,-25,1,6,9,1,AMEX
4630,12-02-2021 18:00,24 hrs.,StockMarket,ZOM,52,0,52,-52,3,9,22,3,AMEX
4630,12-02-2021 18:00,24 hrs.,StockMarket,GSAT,38,38,0,38,1,7,20,1,AMEX
4630,12-02-2021 18:00,24 hrs.,StockMarket,NSPR,39,6,33,-27,2,12,7,2,AMEX
4630,12-02-2021 18:00,24 hrs.,StockMarket,RLGT,6,6,0,6,1,1,0,1,AMEX
4630,12-02-2021 18:00,24 hrs.,StockMarket,UUUU,25,0,25,-25,1,6,9,1,AMEX
4630,12-02-2021 18:00,24 hrs.,StockMarket,ACI,6,0,6,-6,1,1,0,1,NYSE
4630,12-02-2021 18:00,24 hrs.,StockMarket,AFC,6,6,0,6,1,1,0,1,NYSE
4630,12-02-2021 18:00,24 hrs.,StockMarket,AHC,13,0,13,-13,1,2,5,1,NYSE
4630,12-02-2021 18:00,24 hrs.,StockMarket,ALV,20,20,0,20,1,3,10,1,NYSE
4630,12-02-2021 18:00,24 hrs.,StockMarket,AMC,388,372,16,356,5,161,46,5,NYSE
4630,12-02-2021 18:00,24 hrs.,StockMarket,BHC,13,13,0,13,1,3,3,1,NYSE
4630,12-02-2021 18:00,24 hrs.,StockMarket,CHL,6,0,6,-6,1,1,0,1,NYSE
4630,12-02-2021 18:00,24 hrs.,StockMarket,CIA,397,0,397,-397,1,180,33,1,NYSE
4630,12-02-2021 18:00,24 hrs.,StockMarket,CMI,56,0,56,-56,1,18,16,1,NYSE
4630,12-02-2021 18:00,24 hrs.,StockMarket,DIS,13,13,0,13,1,3,3,1,NYSE
4630,12-02-2021 18:00,24 hrs.,StockMarket,FAF,6,0,6,-6,1,1,0,1,NYSE
4630,12-02-2021 18:00,24 hrs.,StockMarket,FSR,13,13,0,13,1,3,3,1,NYSE
4630,12-02-2021 18:00,24 hrs.,StockMarket,GME,517,398,119,279,10,194,89,10,NYSE
4630,12-02-2021 18:00,24 hrs.,StockMarket,IBM,397,0,397,-397,1,180,33,1,NYSE
4630,12-02-2021 18:00,24 hrs.,StockMarket,LAC,4,4,0,4,1,0,0,1,NYSE
4630,12-02-2021 18:00,24 hrs.,StockMarket,LMT,23,23,0,23,1,4,11,1,NYSE
4630,12-02-2021 18:00,24 hrs.,StockMarket,MCO,13,13,0,13,1,3,3,1,NYSE
4630,12-02-2021 18:00,24 hrs.,StockMarket,MRO,13,13,0,13,1,3,3,1,NYSE
4630,12-02-2021 18:00,24 hrs.,StockMarket,NSA,397,0,397,-397,1,180,33,1,NYSE
4630,12-02-2021 18:00,24 hrs.,StockMarket,PDT,10,10,0,10,1,2,2,1,NYSE
4630,12-02-2021 18:00,24 hrs.,StockMarket,RSI,6,0,6,-6,1,1,0,1,NYSE
4630,12-02-2021 18:00,24 hrs.,trakstocks,MSTR,4,0,4,-4,1,0,0,1,NASDAQ
4630,12-02-2021 18:00,24 hrs.,trakstocks,OPRX,6,6,0,6,1,1,0,1,NASDAQ
4630,12-02-2021 18:00,24 hrs.,trakstocks,RIOT,31,0,31,-31,3,5,9,3,NASDAQ
4630,12-02-2021 18:00,24 hrs.,trakstocks,SNGX,32,0,32,-32,1,12,4,1,NASDAQ
4630,12-02-2021 18:00,24 hrs.,wallstreetbets,CNDT,13,6,7,-1,2,2,1,2,NASDAQ
4630,12-02-2021 18:00,24 hrs.,wallstreetbets,CNSP,7,7,0,7,1,1,1,1,NASDAQ
4630,12-02-2021 18:00,24 hrs.,wallstreetbets,CODX,7,7,0,7,1,1,1,1,NASDAQ
4630,12-02-2021 18:00,24 hrs.,StockMarket,CACI,397,0,397,-397,1,180,33,1,NYSE
4630,12-02-2021 18:00,24 hrs.,StockMarket,CCIV,54,15,39,-24,2,17,12,2,NYSE
4630,12-02-2021 18:00,24 hrs.,StockMarket,CHGG,7,7,0,7,1,1,1,1,NYSE
4630,12-02-2021 18:00,24 hrs.,StockMarket,COTY,8,8,0,8,1,2,0,1,NYSE
4630,12-02-2021 18:00,24 hrs.,StockMarket,FUSE,12,12,0,12,2,2,0,2,NYSE
4630,12-02-2021 18:00,24 hrs.,StockMarket,HYLN,13,13,0,13,1,3,3,1,NYSE
4630,12-02-2021 18:00,24 hrs.,StockMarket,LAIX,12,12,0,12,1,0,8,1,NYSE
4630,12-02-2021 18:00,24 hrs.,StockMarket,MDLY,6,0,6,-6,1,0,2,1,NYSE
4630,12-02-2021 18:00,24 hrs.,StockMarket,PAYC,56,0,56,-56,1,18,16,1,NYSE
4630,12-02-2021 18:00,24 hrs.,StockMarket,SPCE,6,0,6,-6,1,1,0,1,NYSE
4630,12-02-2021 18:00,24 hrs.,StockMarket,TEVA,6,0,6,-6,1,1,0,1,NYSE
4630,12-02-2021 18:00,24 hrs.,StockMarket,UBER,56,0,56,-56,1,18,16,1,NYSE
4630,12-02-2021 18:00,24 hrs.,StockMarket,XPEV,397,0,397,-397,1,180,33,1,NYSE
4630,12-02-2021 18:00,24 hrs.,StockMarket,YETI,4,4,0,4,1,0,0,1,NYSE
4630,12-02-2021 18:00,24 hrs.,wallstreetbets,DSKE,7,7,0,7,1,1,1,1,NASDAQ
4630,12-02-2021 18:00,24 hrs.,wallstreetbets,DTIL,6,0,6,-6,1,1,0,1,NASDAQ
4630,12-02-2021 18:00,24 hrs.,wallstreetbets,EBON,7,7,0,7,1,1,1,1,NASDAQ
4630,12-02-2021 18:00,24 hrs.,wallstreetbets,EDIT,13031,0,13031,-13031,3,5965,1089,3,NASDAQ
4630,12-02-2021 18:00,24 hrs.,wallstreetbets,EDSA,6,6,0,6,1,1,0,1,NASDAQ
4630,12-02-2021 18:00,24 hrs.,wallstreetbets,EHTH,7,7,0,7,1,1,1,1,NASDAQ
4630,12-02-2021 18:00,24 hrs.,wallstreetbets,ELSE,7,7,0,7,1,1,1,1,NASDAQ
4630,12-02-2021 18:00,24 hrs.,wallstreetbets,ENLV,6,0,6,-6,1,1,0,1,NASDAQ
4630,12-02-2021 18:00,24 hrs.,wallstreetbets,ENVB,7,7,0,7,1,1,1,1,NASDAQ
4630,12-02-2021 18:00,24 hrs.,wallstreetbets,ERIC,7,0,7,-7,1,1,1,1,NASDAQ
4630,12-02-2021 18:00,24 hrs.,wallstreetbets,ESPR,13,7,6,1,2,2,1,2,NASDAQ
4630,12-02-2021 18:00,24 hrs.,wallstreetbets,ETSY,6,0,6,-6,1,1,0,1,NASDAQ
4630,12-02-2021 18:00,24 hrs.,wallstreetbets,EVER,738,7,731,-724,3,294,138,3,NASDAQ
4630,12-02-2021 18:00,24 hrs.,wallstreetbets,EVFM,6,0,6,-6,1,1,0,1,NASDAQ
4630,12-02-2021 18:00,24 hrs.,wallstreetbets,EXPE,381,381,0,381,1,152,73,1,NASDAQ
4630,12-02-2021 18:00,24 hrs.,wallstreetbets,EYES,26,26,0,26,4,4,2,1,NASDAQ
4630,12-02-2021 18:00,24 hrs.,wallstreetbets,FAMI,6,6,0,6,1,1,0,1,NASDAQ
4630,12-02-2021 18:00,24 hrs.,wallstreetbets,FANG,7,0,7,-7,1,1,1,1,NASDAQ
4630,12-02-2021 18:00,24 hrs.,wallstreetbets,FARM,7,7,0,7,1,1,1,1,NASDAQ
4630,12-02-2021 18:00,24 hrs.,wallstreetbets,FCAC,8,8,0,8,1,1,2,1,NASDAQ
4630,12-02-2021 18:00,24 hrs.,wallstreetbets,FCEL,13,6,7,-1,2,2,1,2,NASDAQ
4630,12-02-2021 18:00,24 hrs.,wallstreetbets,FLDM,7,7,0,7,1,1,1,1,NASDAQ
4630,12-02-2021 18:00,24 hrs.,wallstreetbets,FLGT,7,7,0,7,1,1,1,1,NASDAQ
4630,12-02-2021 18:00,24 hrs.,wallstreetbets,FNKO,12,0,12,-12,2,2,0,2,NASDAQ
4630,12-02-2021 18:00,24 hrs.,wallstreetbets,FOLD,26,20,6,14,4,4,2,4,NASDAQ
4630,12-02-2021 18:00,24 hrs.,wallstreetbets,FORD,21,7,14,-7,3,3,3,2,NASDAQ
4630,12-02-2021 18:00,24 hrs.,wallstreetbets,FROG,6,0,6,-6,1,1,0,1,NASDAQ
4630,12-02-2021 18:00,24 hrs.,wallstreetbets,FTFT,7,7,0,7,1,1,1,1,NASDAQ
4630,12-02-2021 18:00,24 hrs.,wallstreetbets,FUTU,607,231,376,-145,2,191,217,2,NASDAQ
4630,12-02-2021 18:00,24 hrs.,wallstreetbets,GAIN,42,15,27,-12,6,6,6,6,NASDAQ
4630,12-02-2021 18:00,24 hrs.,wallstreetbets,GDRX,7,0,7,-7,1,1,1,1,NASDAQ
4630,12-02-2021 18:00,24 hrs.,wallstreetbets,GERN,7,0,7,-7,1,1,1,1,NASDAQ
4630,12-02-2021 18:00,24 hrs.,wallstreetbets,GEVO,86,79,7,72,7,15,28,5,NASDAQ
4630,12-02-2021 18:00,24 hrs.,wallstreetbets,GHIV,376,0,376,-376,1,112,148,1,NASDAQ
4630,12-02-2021 18:00,24 hrs.,wallstreetbets,GHSI,20,0,20,-20,3,3,2,2,NASDAQ
4630,12-02-2021 18:00,24 hrs.,wallstreetbets,GILT,7,7,0,7,1,1,1,1,NASDAQ
4630,12-02-2021 18:00,24 hrs.,wallstreetbets,GLMD,21,21,0,21,3,3,3,1,NASDAQ
4630,12-02-2021 18:00,24 hrs.,wallstreetbets,GLPG,7,7,0,7,1,1,1,1,NASDAQ
4630,12-02-2021 18:00,24 hrs.,wallstreetbets,GLSI,8,0,8,-8,1,1,2,1,NASDAQ
4630,12-02-2021 18:00,24 hrs.,wallstreetbets,GLUU,31,31,0,31,2,1,21,1,NASDAQ
4630,12-02-2021 18:00,24 hrs.,wallstreetbets,GMBL,7,7,0,7,1,1,1,1,NASDAQ
4630,12-02-2021 18:00,24 hrs.,wallstreetbets,GNLN,6,0,6,-6,1,1,0,1,NASDAQ
4630,12-02-2021 18:00,24 hrs.,wallstreetbets,GNMK,6,0,6,-6,1,1,0,1,NASDAQ
4630,12-02-2021 18:00,24 hrs.,trakstocks,STCN,14,14,0,14,1,4,2,1,NASDAQ
4630,12-02-2021 18:00,24 hrs.,trakstocks,TTCF,28,0,28,-28,1,9,6,1,NASDAQ
4630,12-02-2021 18:00,24 hrs.,trakstocks,USWS,242,0,242,-242,2,92,50,2,NASDAQ
4630,12-02-2021 18:00,24 hrs.,trakstocks,VNDA,10,0,10,-10,1,3,0,1,NASDAQ
4630,12-02-2021 18:00,24 hrs.,trakstocks,VRME,8,0,8,-8,1,2,0,1,NASDAQ
4630,12-02-2021 18:00,24 hrs.,trakstocks,VTRS,7,0,7,-7,1,1,1,1,NASDAQ
4630,12-02-2021 18:00,24 hrs.,trakstocks,XSPA,21,21,0,21,1,6,5,1,NASDAQ
4630,12-02-2021 18:00,24 hrs.,StockMarket,AAPL,56,0,56,-56,1,18,16,1,NASDAQ
4630,12-02-2021 18:00,24 hrs.,StockMarket,AEZS,4,4,0,4,1,0,0,1,NASDAQ
4630,12-02-2021 18:00,24 hrs.,StockMarket,APHA,715,6,709,-703,5,229,237,4,NASDAQ
4630,12-02-2021 18:00,24 hrs.,StockMarket,ARTL,56,56,0,56,1,12,28,1,NASDAQ
4630,12-02-2021 18:00,24 hrs.,StockMarket,ASYS,4,0,4,-4,1,0,0,1,NASDAQ
4630,12-02-2021 18:00,24 hrs.,StockMarket,ATOM,23,0,23,-23,1,8,3,1,NASDAQ
4630,12-02-2021 18:00,24 hrs.,StockMarket,ATOS,7,7,0,7,1,1,1,1,NASDAQ
4630,12-02-2021 18:00,24 hrs.,StockMarket,AVGO,6,6,0,6,1,1,0,1,NASDAQ
4630,12-02-2021 18:00,24 hrs.,StockMarket,AVXL,6,0,6,-6,1,1,0,1,NASDAQ
4630,12-02-2021 18:00,24 hrs.,StockMarket,BPTH,6,6,0,6,1,1,0,1,NASDAQ
4630,12-02-2021 18:00,24 hrs.,StockMarket,BSQR,16,0,16,-16,1,0,12,1,NASDAQ
4630,12-02-2021 18:00,24 hrs.,StockMarket,BYND,6,6,0,6,1,1,0,1,NASDAQ
4630,12-02-2021 18:00,24 hrs.,StockMarket,CECE,12,0,12,-12,1,4,0,1,NASDAQ
4630,12-02-2021 18:00,24 hrs.,StockMarket,CLEU,68,68,0,68,2,12,36,2,NASDAQ
4630,12-02-2021 18:00,24 hrs.,StockMarket,CLNE,56,0,56,-56,1,18,16,1,NASDAQ
4630,12-02-2021 18:00,24 hrs.,StockMarket,CLSK,8,0,8,-8,1,1,2,1,NASDAQ
4630,12-02-2021 18:00,24 hrs.,StockMarket,COHR,13,13,0,13,1,3,3,1,NASDAQ
4630,12-02-2021 18:00,24 hrs.,wallstreetbets,GNOG,13,0,13,-13,2,2,1,2,NASDAQ
4630,12-02-2021 18:00,24 hrs.,wallstreetbets,GNRS,14,14,0,14,2,2,2,1,NASDAQ
4630,12-02-2021 18:00,24 hrs.,wallstreetbets,GOEV,13,0,13,-13,2,2,1,2,NASDAQ
4630,12-02-2021 18:00,24 hrs.,wallstreetbets,GOGO,32,13,19,-6,5,5,2,4,NASDAQ
4630,12-02-2021 18:00,24 hrs.,wallstreetbets,GOLD,278,20,258,-238,6,92,70,6,NASDAQ
4630,12-02-2021 18:00,24 hrs.,wallstreetbets,GPRO,6,0,6,-6,1,1,0,1,NASDAQ
4630,12-02-2021 18:00,24 hrs.,wallstreetbets,GRID,12,0,12,-12,2,2,0,1,NASDAQ
4630,12-02-2021 18:00,24 hrs.,wallstreetbets,GRIL,25,0,25,-25,4,4,1,3,NASDAQ
4630,12-02-2021 18:00,24 hrs.,wallstreetbets,GRMN,6,0,6,-6,1,1,0,1,NASDAQ
4630,12-02-2021 18:00,24 hrs.,wallstreetbets,GRTS,12,6,6,0,2,2,0,2,NASDAQ
4630,12-02-2021 18:00,24 hrs.,wallstreetbets,GRWG,13,0,13,-13,2,2,1,2,NASDAQ
4630,12-02-2021 18:00,24 hrs.,wallstreetbets,GTEC,12,0,12,-12,2,2,0,1,NASDAQ
4630,12-02-2021 18:00,24 hrs.,wallstreetbets,GTHX,25,18,7,11,4,4,1,3,NASDAQ
4630,12-02-2021 18:00,24 hrs.,wallstreetbets,GWPH,13,13,0,13,1,0,9,1,NASDAQ
4630,12-02-2021 18:00,24 hrs.,wallstreetbets,HALO,14,14,0,14,2,2,2,2,NASDAQ
4630,12-02-2021 18:00,24 hrs.,wallstreetbets,HDSN,7,7,0,7,1,1,1,1,NASDAQ
4630,12-02-2021 18:00,24 hrs.,wallstreetbets,HEPA,9,0,9,-9,1,1,3,1,NASDAQ
4630,12-02-2021 18:00,24 hrs.,wallstreetbets,HIMX,7,0,7,-7,1,1,1,1,NASDAQ
4630,12-02-2021 18:00,24 hrs.,wallstreetbets,HJLI,14,14,0,14,2,2,2,1,NASDAQ
4630,12-02-2021 18:00,24 hrs.,wallstreetbets,HSTO,26,26,0,26,4,4,2,3,NASDAQ
4630,12-02-2021 18:00,24 hrs.,wallstreetbets,HTBX,14,8,6,2,2,2,2,2,NASDAQ
4630,12-02-2021 18:00,24 hrs.,wallstreetbets,IBKR,550,0,550,-550,3,177,184,3,NASDAQ
4630,12-02-2021 18:00,24 hrs.,wallstreetbets,ICLN,12,6,6,0,2,2,0,2,NASDAQ
4630,12-02-2021 18:00,24 hrs.,wallstreetbets,ICON,7,7,0,7,1,1,1,1,NASDAQ
4630,12-02-2021 18:00,24 hrs.,wallstreetbets,ICPT,13,7,6,1,2,2,1,2,NASDAQ
4630,12-02-2021 18:00,24 hrs.,wallstreetbets,IDEX,180,133,47,86,10,39,62,8,NASDAQ
4630,12-02-2021 18:00,24 hrs.,wallstreetbets,IFMK,20,0,20,-20,3,3,2,2,NASDAQ
4630,12-02-2021 18:00,24 hrs.,wallstreetbets,IIVI,381,381,0,381,1,152,73,1,NASDAQ
4630,12-02-2021 18:00,24 hrs.,wallstreetbets,ILMN,7,7,0,7,1,1,1,1,NASDAQ
4630,12-02-2021 18:00,24 hrs.,wallstreetbets,IMGN,102,14,88,-74,3,29,32,3,NASDAQ
4630,12-02-2021 18:00,24 hrs.,wallstreetbets,IMMR,8,0,8,-8,1,1,2,1,NASDAQ
4630,12-02-2021 18:00,24 hrs.,wallstreetbets,INFI,21,21,0,21,3,3,3,1,NASDAQ
4630,12-02-2021 18:00,24 hrs.,wallstreetbets,INFO,8,8,0,8,1,1,2,1,NASDAQ
4630,12-02-2021 18:00,24 hrs.,wallstreetbets,INPX,19,19,0,19,3,3,1,2,NASDAQ
4630,12-02-2021 18:00,24 hrs.,wallstreetbets,INTC,64,31,33,-2,6,6,28,4,NASDAQ
4630,12-02-2021 18:00,24 hrs.,wallstreetbets,IPWR,6,6,0,6,1,1,0,1,NASDAQ
4630,12-02-2021 18:00,24 hrs.,wallstreetbets,IRBT,14,0,14,-14,2,2,2,2,NASDAQ
4630,12-02-2021 18:00,24 hrs.,wallstreetbets,IRDM,6,0,6,-6,1,1,0,1,NASDAQ
4630,12-02-2021 18:00,24 hrs.,wallstreetbets,ITRM,21,21,0,21,3,3,3,2,NASDAQ
4630,12-02-2021 18:00,24 hrs.,wallstreetbets,JAGX,12,0,12,-12,2,2,0,1,NASDAQ
4630,12-02-2021 18:00,24 hrs.,StockMarket,SBE,6,6,0,6,1,1,0,1,NYSE
4630,12-02-2021 18:00,24 hrs.,StockMarket,SOS,43,31,12,19,6,8,3,5,NYSE
4630,12-02-2021 18:00,24 hrs.,StockMarket,TDA,8,8,0,8,1,1,2,1,NYSE
4630,12-02-2021 18:00,24 hrs.,StockMarket,TSE,35,0,35,-35,2,9,9,2,NYSE
4630,12-02-2021 18:00,24 hrs.,StockMarket,TTM,19,19,0,19,1,3,9,1,NYSE
4630,12-02-2021 18:00,24 hrs.,StockMarket,UBS,56,0,56,-56,1,18,16,1,NYSE
4630,12-02-2021 18:00,24 hrs.,StockMarket,AVLR,56,0,56,-56,1,18,16,1,NYSE
4630,12-02-2021 18:00,24 hrs.,StockMarket,LGND,6,0,6,-6,1,1,0,1,NASDAQ
4630,12-02-2021 18:00,24 hrs.,StockMarket,LIFE,3936,0,3936,-3936,1,1922,88,1,NASDAQ
4630,12-02-2021 18:00,24 hrs.,StockMarket,LITE,13,13,0,13,1,3,3,1,NASDAQ
4630,12-02-2021 18:00,24 hrs.,StockMarket,LIVE,13,13,0,13,1,3,3,1,NASDAQ
4630,12-02-2021 18:00,24 hrs.,StockMarket,LLNW,25,25,0,25,4,4,1,1,NASDAQ
4630,12-02-2021 18:00,24 hrs.,StockMarket,LYFT,56,0,56,-56,1,18,16,1,NASDAQ
4630,12-02-2021 18:00,24 hrs.,StockMarket,MKSI,13,13,0,13,1,3,3,1,NASDAQ
4630,12-02-2021 18:00,24 hrs.,StockMarket,MSTR,12,12,0,12,2,2,0,1,NASDAQ
4630,12-02-2021 18:00,24 hrs.,StockMarket,MTCH,7,7,0,7,1,0,3,1,NASDAQ
4630,12-02-2021 18:00,24 hrs.,StockMarket,OCGN,18,18,0,18,2,1,8,2,NASDAQ
4630,12-02-2021 18:00,24 hrs.,StockMarket,OPTT,28,0,28,-28,1,8,8,1,NASDAQ
4630,12-02-2021 18:00,24 hrs.,StockMarket,PACB,4,4,0,4,1,0,0,1,NASDAQ
4630,12-02-2021 18:00,24 hrs.,StockMarket,PTGX,6,0,6,-6,1,1,0,1,NASDAQ
4630,12-02-2021 18:00,24 hrs.,StockMarket,PYPL,14,14,0,14,1,3,4,1,NASDAQ
4630,12-02-2021 18:00,24 hrs.,StockMarket,RBBN,6,6,0,6,1,1,0,1,NASDAQ
4630,12-02-2021 18:00,24 hrs.,StockMarket,RCMT,4,4,0,4,1,0,0,1,NASDAQ
4630,12-02-2021 18:00,24 hrs.,StockMarket,REAL,27,27,0,27,1,0,23,1,NASDAQ
4630,12-02-2021 18:00,24 hrs.,StockMarket,RIDE,19,19,0,19,2,4,3,2,NASDAQ
4630,12-02-2021 18:00,24 hrs.,StockMarket,RIGL,6,0,6,-6,1,1,0,1,NASDAQ
4630,12-02-2021 18:00,24 hrs.,StockMarket,SNDL,1092,49,1043,-994,16,343,342,15,NASDAQ
4630,12-02-2021 18:00,24 hrs.,StockMarket,SONO,56,0,56,-56,1,18,16,1,NASDAQ
4630,12-02-2021 18:00,24 hrs.,StockMarket,SRNE,6,0,6,-6,1,1,0,1,NASDAQ
4630,12-02-2021 18:00,24 hrs.,StockMarket,SVMK,13,13,0,13,1,3,3,1,NASDAQ
4630,12-02-2021 18:00,24 hrs.,StockMarket,TLRY,830,76,754,-678,11,260,266,10,NASDAQ
4630,12-02-2021 18:00,24 hrs.,StockMarket,TLSA,4,4,0,4,1,0,0,1,NASDAQ
4630,12-02-2021 18:00,24 hrs.,StockMarket,TNXP,6,6,0,6,1,1,0,1,NASDAQ
4630,12-02-2021 18:00,24 hrs.,StockMarket,TSLA,12,6,6,0,2,2,0,2,NASDAQ
4630,12-02-2021 18:00,24 hrs.,StockMarket,TXMD,6,0,6,-6,1,1,0,1,NASDAQ
4630,12-02-2021 18:00,24 hrs.,StockMarket,VITL,6,6,0,6,1,1,0,1,NASDAQ
4630,12-02-2021 18:00,24 hrs.,StockMarket,VRAY,14,0,14,-14,2,2,2,2,NASDAQ
4630,12-02-2021 18:00,24 hrs.,StockMarket,VRSN,13,13,0,13,1,3,3,1,NASDAQ
4630,12-02-2021 18:00,24 hrs.,StockMarket,VXRT,25,0,25,-25,1,8,5,1,NASDAQ
4630,12-02-2021 18:00,24 hrs.,StockMarket,WAFU,56,56,0,56,1,12,28,1,NASDAQ
4630,12-02-2021 18:00,24 hrs.,StockMarket,ZNGA,34,0,34,-34,2,9,8,2,NASDAQ
4630,12-02-2021 18:00,24 hrs.,StockMarket,UONEK,6,0,6,-6,1,1,0,1,NASDAQ
4630,12-02-2021 18:00,24 hrs.,pennystocks,AABB,18,0,18,-18,3,3,0,2,OTC
4630,12-02-2021 18:00,24 hrs.,pennystocks,ABML,145,63,82,-19,2,50,37,2,OTC
4630,12-02-2021 18:00,24 hrs.,pennystocks,ABQQ,6,0,6,-6,1,1,0,1,OTC
4630,12-02-2021 18:00,24 hrs.,pennystocks,ACRL,50,0,50,-50,2,16,10,2,OTC
4630,12-02-2021 18:00,24 hrs.,pennystocks,ADGO,14,0,14,-14,1,2,6,1,OTC
4630,12-02-2021 18:00,24 hrs.,wallstreetbets,JBLU,12,6,6,0,2,2,0,2,NASDAQ
4630,12-02-2021 18:00,24 hrs.,wallstreetbets,JNCE,12,6,6,0,2,2,0,2,NASDAQ
4630,12-02-2021 18:00,24 hrs.,wallstreetbets,KERN,13,0,13,-13,2,2,1,2,NASDAQ
4630,12-02-2021 18:00,24 hrs.,wallstreetbets,KOSS,43,43,0,43,1,14,11,1,NASDAQ
4630,12-02-2021 18:00,24 hrs.,wallstreetbets,LAKE,6,0,6,-6,1,1,0,1,NASDAQ
4630,12-02-2021 18:00,24 hrs.,wallstreetbets,LAZR,7,7,0,7,1,1,1,1,NASDAQ
4630,12-02-2021 18:00,24 hrs.,wallstreetbets,LEGN,7,7,0,7,1,1,1,1,NASDAQ
4630,12-02-2021 18:00,24 hrs.,wallstreetbets,LGHL,6,0,6,-6,1,1,0,1,NASDAQ
4630,12-02-2021 18:00,24 hrs.,wallstreetbets,LGND,13,13,0,13,2,2,1,2,NASDAQ
4630,12-02-2021 18:00,24 hrs.,StockMarket,AMD,24,18,6,12,3,2,8,3,NASDAQ
4630,12-02-2021 18:00,24 hrs.,StockMarket,AZN,13,13,0,13,1,3,3,1,NASDAQ
4630,12-02-2021 18:00,24 hrs.,StockMarket,CDC,13,13,0,13,1,3,3,1,NASDAQ
4630,12-02-2021 18:00,24 hrs.,StockMarket,HAS,6,0,6,-6,1,1,0,1,NASDAQ
4630,12-02-2021 18:00,24 hrs.,StockMarket,INO,13,13,0,13,1,3,3,1,NASDAQ
4630,12-02-2021 18:00,24 hrs.,StockMarket,JFU,38,38,0,38,1,7,20,1,NASDAQ
4630,12-02-2021 18:00,24 hrs.,StockMarket,MGI,9,9,0,9,1,2,1,1,NASDAQ
4630,12-02-2021 18:00,24 hrs.,StockMarket,NWL,13,13,0,13,1,3,3,1,NASDAQ
4630,12-02-2021 18:00,24 hrs.,StockMarket,OGI,37,37,0,37,3,9,7,3,NASDAQ
4630,12-02-2021 18:00,24 hrs.,StockMarket,OPK,6,6,0,6,1,1,0,1,NASDAQ
4630,12-02-2021 18:00,24 hrs.,StockMarket,RCM,6,0,6,-6,1,1,0,1,NASDAQ
4630,12-02-2021 18:00,24 hrs.,StockMarket,SDC,15,0,15,-15,1,3,5,1,NASDAQ
4630,12-02-2021 18:00,24 hrs.,StockMarket,SFT,6,6,0,6,1,1,0,1,NASDAQ
4630,12-02-2021 18:00,24 hrs.,StockMarket,SND,10,0,10,-10,1,3,0,1,NASDAQ
4630,12-02-2021 18:00,24 hrs.,StockMarket,VFF,18,0,18,-18,3,3,0,1,NASDAQ
4630,12-02-2021 18:00,24 hrs.,wallstreetbets,MKSI,381,381,0,381,1,152,73,1,NASDAQ
4630,12-02-2021 18:00,24 hrs.,wallstreetbets,MNPR,6,6,0,6,1,1,0,1,NASDAQ
4630,12-02-2021 18:00,24 hrs.,wallstreetbets,MOGO,7,0,7,-7,1,1,1,1,NASDAQ
4630,12-02-2021 18:00,24 hrs.,wallstreetbets,MOSY,7,0,7,-7,1,1,1,1,NASDAQ
4630,12-02-2021 18:00,24 hrs.,wallstreetbets,MOTS,12,0,12,-12,2,2,0,1,NASDAQ
4630,12-02-2021 18:00,24 hrs.,wallstreetbets,MRAM,6,0,6,-6,1,1,0,1,NASDAQ
4630,12-02-2021 18:00,24 hrs.,wallstreetbets,MRNA,6,6,0,6,1,1,0,1,NASDAQ
4630,12-02-2021 18:00,24 hrs.,wallstreetbets,MSFT,970,7,963,-956,2,412,138,2,NASDAQ
4630,12-02-2021 18:00,24 hrs.,wallstreetbets,MSTR,39,27,12,15,6,6,3,4,NASDAQ
4630,12-02-2021 18:00,24 hrs.,wallstreetbets,MTCH,7,7,0,7,1,1,1,1,NASDAQ
4630,12-02-2021 18:00,24 hrs.,wallstreetbets,MVIS,273,224,49,175,13,77,67,11,NASDAQ
4630,12-02-2021 18:00,24 hrs.,wallstreetbets,NAKD,226,83,143,-60,34,35,20,28,NASDAQ
4630,12-02-2021 18:00,24 hrs.,wallstreetbets,NBEV,8,0,8,-8,1,2,0,1,NASDAQ
4630,12-02-2021 18:00,24 hrs.,wallstreetbets,NCLH,7,0,7,-7,1,1,1,1,NASDAQ
4630,12-02-2021 18:00,24 hrs.,wallstreetbets,NDRA,13,0,13,-13,2,2,1,2,NASDAQ
4630,12-02-2021 18:00,24 hrs.,wallstreetbets,NEOS,7,7,0,7,1,1,1,1,NASDAQ
4630,12-02-2021 18:00,24 hrs.,wallstreetbets,NEPT,19,0,19,-19,3,3,1,3,NASDAQ
4630,12-02-2021 18:00,24 hrs.,wallstreetbets,NFLX,7,7,0,7,1,1,1,1,NASDAQ
4630,12-02-2021 18:00,24 hrs.,wallstreetbets,NKLA,20,0,20,-20,3,3,2,3,NASDAQ
4630,12-02-2021 18:00,24 hrs.,wallstreetbets,NLOK,13,0,13,-13,2,2,1,1,NASDAQ
4630,12-02-2021 18:00,24 hrs.,wallstreetbets,NMRK,6,6,0,6,1,1,0,1,NASDAQ
4630,12-02-2021 18:00,24 hrs.,wallstreetbets,NNDM,14,14,0,14,2,2,2,1,NASDAQ
4630,12-02-2021 18:00,24 hrs.,wallstreetbets,NNOX,6,0,6,-6,1,1,0,1,NASDAQ
4630,12-02-2021 18:00,24 hrs.,wallstreetbets,NOVN,7,0,7,-7,1,1,1,1,NASDAQ
4630,12-02-2021 18:00,24 hrs.,wallstreetbets,NUAN,208,202,6,196,2,77,46,2,NASDAQ
4630,12-02-2021 18:00,24 hrs.,wallstreetbets,NVAX,6,0,6,-6,1,1,0,1,NASDAQ
4630,12-02-2021 18:00,24 hrs.,wallstreetbets,NVCN,26,0,26,-26,4,4,2,4,NASDAQ
4630,12-02-2021 18:00,24 hrs.,wallstreetbets,NVDA,561,394,167,227,4,145,255,4,NASDAQ
4630,12-02-2021 18:00,24 hrs.,wallstreetbets,NXPI,402,0,402,-402,1,145,108,1,NASDAQ
4630,12-02-2021 18:00,24 hrs.,wallstreetbets,NXTD,12,0,12,-12,2,2,0,1,NASDAQ
4630,12-02-2021 18:00,24 hrs.,wallstreetbets,OCGN,62,19,43,-24,10,10,2,7,NASDAQ
4630,12-02-2021 18:00,24 hrs.,wallstreetbets,ONTX,6,0,6,-6,1,1,0,1,NASDAQ
4630,12-02-2021 18:00,24 hrs.,wallstreetbets,ONVO,7,7,0,7,1,1,1,1,NASDAQ
4630,12-02-2021 18:00,24 hrs.,wallstreetbets,OPGN,14,14,0,14,2,2,2,1,NASDAQ
4630,12-02-2021 18:00,24 hrs.,wallstreetbets,OPTT,6,6,0,6,1,1,0,1,NASDAQ
4630,12-02-2021 18:00,24 hrs.,wallstreetbets,OSTK,9,0,9,-9,1,1,3,1,NASDAQ
4630,12-02-2021 18:00,24 hrs.,wallstreetbets,PACB,14,0,14,-14,2,2,2,1,NASDAQ
4630,12-02-2021 18:00,24 hrs.,wallstreetbets,PDSB,12,0,12,-12,2,2,0,1,NASDAQ
4630,12-02-2021 18:00,24 hrs.,wallstreetbets,PENN,1404,1404,0,1404,6,620,140,2,NASDAQ
4630,12-02-2021 18:00,24 hrs.,wallstreetbets,PHIO,7,0,7,-7,1,1,1,1,NASDAQ
4630,12-02-2021 18:00,24 hrs.,wallstreetbets,PHUN,7,7,0,7,1,1,1,1,NASDAQ
4630,12-02-2021 18:00,24 hrs.,wallstreetbets,PLAY,52,7,45,-38,8,8,4,6,NASDAQ
4630,12-02-2021 18:00,24 hrs.,wallstreetbets,PLUG,13,7,6,1,2,2,1,2,NASDAQ
4630,12-02-2021 18:00,24 hrs.,wallstreetbets,PLYA,7,7,0,7,1,1,1,1,NASDAQ
4630,12-02-2021 18:00,24 hrs.,wallstreetbets,POTX,7,7,0,7,1,1,1,1,NASDAQ
4630,12-02-2021 18:00,24 hrs.,wallstreetbets,POWW,120,20,100,-80,19,19,6,15,NASDAQ
4630,12-02-2021 18:00,24 hrs.,wallstreetbets,PRCH,30,6,24,-18,5,5,0,3,NASDAQ
4630,12-02-2021 18:00,24 hrs.,wallstreetbets,PRPL,1194,231,963,-732,2,490,206,2,NASDAQ
4630,12-02-2021 18:00,24 hrs.,wallstreetbets,PRTS,15,15,0,15,2,2,3,1,NASDAQ
4630,12-02-2021 18:00,24 hrs.,StockMarket,CRSP,4,4,0,4,1,0,0,1,NASDAQ
4630,12-02-2021 18:00,24 hrs.,StockMarket,CTHR,21,0,21,-21,1,5,7,1,NASDAQ
4630,12-02-2021 18:00,24 hrs.,StockMarket,CTRM,55,0,55,-55,4,14,11,4,NASDAQ
4630,12-02-2021 18:00,24 hrs.,StockMarket,DDOG,13,13,0,13,1,3,3,1,NASDAQ
4630,12-02-2021 18:00,24 hrs.,StockMarket,ENTX,8,8,0,8,1,2,0,1,NASDAQ
4630,12-02-2021 18:00,24 hrs.,StockMarket,EXPE,13,13,0,13,1,3,3,1,NASDAQ
4630,12-02-2021 18:00,24 hrs.,StockMarket,FNKO,19,0,19,-19,1,5,5,1,NASDAQ
4630,12-02-2021 18:00,24 hrs.,StockMarket,GBIO,7,7,0,7,1,1,1,1,NASDAQ
4630,12-02-2021 18:00,24 hrs.,StockMarket,HTBX,50,44,6,38,3,9,20,3,NASDAQ
4630,12-02-2021 18:00,24 hrs.,StockMarket,IBKR,6,0,6,-6,1,1,0,1,NASDAQ
4630,12-02-2021 18:00,24 hrs.,StockMarket,IIVI,13,13,0,13,1,3,3,1,NASDAQ
4630,12-02-2021 18:00,24 hrs.,StockMarket,INMD,56,0,56,-56,1,18,16,1,NASDAQ
4630,12-02-2021 18:00,24 hrs.,StockMarket,INTZ,4,4,0,4,1,0,0,1,NASDAQ
4630,12-02-2021 18:00,24 hrs.,StockMarket,INVE,24,24,0,24,2,6,4,1,NASDAQ
4630,12-02-2021 18:00,24 hrs.,StockMarket,LAZR,6,6,0,6,1,1,0,1,NASDAQ
4630,12-02-2021 18:00,24 hrs.,pennystocks,BONZ,6,6,0,6,1,0,2,1,OTC
4630,12-02-2021 18:00,24 hrs.,pennystocks,BOTY,124,0,124,-124,5,34,36,4,OTC
4630,12-02-2021 18:00,24 hrs.,pennystocks,BRGO,14,0,14,-14,1,4,2,1,OTC
4630,12-02-2021 18:00,24 hrs.,pennystocks,BRLL,48,42,6,36,3,3,30,3,OTC
4630,12-02-2021 18:00,24 hrs.,pennystocks,BRTX,6,6,0,6,1,1,0,1,OTC
4630,12-02-2021 18:00,24 hrs.,pennystocks,BTCS,7,0,7,-7,1,1,1,1,OTC
4630,12-02-2021 18:00,24 hrs.,pennystocks,BUDZ,24,24,0,24,3,4,4,3,OTC
4630,12-02-2021 18:00,24 hrs.,pennystocks,BWMG,58,48,10,38,3,12,22,3,OTC
4630,12-02-2021 18:00,24 hrs.,pennystocks,BXNG,23,0,23,-23,1,3,13,1,OTC
4630,12-02-2021 18:00,24 hrs.,pennystocks,CANN,6,6,0,6,1,1,0,1,OTC
4630,12-02-2021 18:00,24 hrs.,pennystocks,CAPC,7,7,0,7,1,1,1,1,OTC
4630,12-02-2021 18:00,24 hrs.,pennystocks,CBBT,677,332,345,-13,15,224,169,14,OTC
4630,12-02-2021 18:00,24 hrs.,pennystocks,CBDD,67,5,62,-57,4,18,15,4,OTC
4630,12-02-2021 18:00,24 hrs.,pennystocks,CBDL,300,123,177,-54,6,78,120,6,OTC
4630,12-02-2021 18:00,24 hrs.,pennystocks,CBDS,6,0,6,-6,1,1,0,1,OTC
4630,12-02-2021 18:00,24 hrs.,pennystocks,CBTC,7,0,7,-7,1,1,1,1,OTC
4630,12-02-2021 18:00,24 hrs.,pennystocks,CCTL,6,0,6,-6,1,1,0,1,OTC
4630,12-02-2021 18:00,24 hrs.,pennystocks,CELZ,7,7,0,7,1,1,1,1,OTC
4630,12-02-2021 18:00,24 hrs.,pennystocks,CETY,6,0,6,-6,1,1,0,1,OTC
4630,12-02-2021 18:00,24 hrs.,pennystocks,CLIS,6,0,6,-6,1,1,0,1,OTC
4630,12-02-2021 18:00,24 hrs.,pennystocks,CLWD,26,6,20,-14,3,7,0,3,OTC
4630,12-02-2021 18:00,24 hrs.,pennystocks,CNNA,25,0,25,-25,2,3,11,2,OTC
4630,12-02-2021 18:00,24 hrs.,pennystocks,CNXS,6,0,6,-6,1,1,0,1,OTC
4630,12-02-2021 18:00,24 hrs.,pennystocks,COMS,24,0,24,-24,1,3,14,1,OTC
4630,12-02-2021 18:00,24 hrs.,pennystocks,CORG,47,35,12,23,5,5,17,5,OTC
4630,12-02-2021 18:00,24 hrs.,pennystocks,CRTG,19,19,0,19,1,5,5,1,OTC
4630,12-02-2021 18:00,24 hrs.,pennystocks,CRWG,6,6,0,6,1,1,0,1,OTC
4630,12-02-2021 18:00,24 hrs.,pennystocks,CTLE,12,12,0,12,2,2,0,1,OTC
4630,12-02-2021 18:00,24 hrs.,pennystocks,CVAT,6,0,6,-6,1,1,0,1,OTC
4630,12-02-2021 18:00,24 hrs.,pennystocks,CYDY,7,7,0,7,1,1,1,1,OTC
4630,12-02-2021 18:00,24 hrs.,pennystocks,CYPW,6,0,6,-6,1,1,0,1,OTC
4630,12-02-2021 18:00,24 hrs.,pennystocks,DGMA,6,0,6,-6,1,1,0,1,OTC
4630,12-02-2021 18:00,24 hrs.,pennystocks,DIGI,13,13,0,13,2,2,1,1,OTC
4630,12-02-2021 18:00,24 hrs.,pennystocks,DMAN,19,19,0,19,1,5,5,1,OTC
4630,12-02-2021 18:00,24 hrs.,pennystocks,DPLS,344,83,261,-178,11,92,116,8,OTC
4630,12-02-2021 18:00,24 hrs.,pennystocks,DTST,39,0,39,-39,1,12,11,1,OTC
4630,12-02-2021 18:00,24 hrs.,pennystocks,ECCI,6,0,6,-6,1,1,0,1,OTC
4630,12-02-2021 18:00,24 hrs.,pennystocks,ECEZ,196,0,196,-196,4,65,50,3,OTC
4630,12-02-2021 18:00,24 hrs.,pennystocks,ELTP,15,15,0,15,1,4,3,1,OTC
4630,12-02-2021 18:00,24 hrs.,wallstreetbets,PSAC,7,7,0,7,1,1,1,1,NASDAQ
4630,12-02-2021 18:00,24 hrs.,wallstreetbets,PSEC,31,0,31,-31,3,2,15,2,NASDAQ
4630,12-02-2021 18:00,24 hrs.,wallstreetbets,PSTV,13,7,6,1,2,2,1,2,NASDAQ
4630,12-02-2021 18:00,24 hrs.,wallstreetbets,PTCT,7,7,0,7,1,1,1,1,NASDAQ
4630,12-02-2021 18:00,24 hrs.,wallstreetbets,PTON,1397,1397,0,1397,5,619,139,1,NASDAQ
4630,12-02-2021 18:00,24 hrs.,wallstreetbets,PUBM,6,0,6,-6,1,1,0,1,NASDAQ
4630,12-02-2021 18:00,24 hrs.,wallstreetbets,PYPL,7,0,7,-7,1,1,1,1,NASDAQ
4630,12-02-2021 18:00,24 hrs.,wallstreetbets,PZZA,7,0,7,-7,1,1,1,1,NASDAQ
4630,12-02-2021 18:00,24 hrs.,wallstreetbets,QRVO,38,0,38,-38,2,12,6,1,NASDAQ
4630,12-02-2021 18:00,24 hrs.,wallstreetbets,QUIK,26,13,13,0,4,4,2,3,NASDAQ
4630,12-02-2021 18:00,24 hrs.,wallstreetbets,LIFE,20,20,0,20,3,3,2,3,NASDAQ
4630,12-02-2021 18:00,24 hrs.,wallstreetbets,LITE,381,381,0,381,1,152,73,1,NASDAQ
4630,12-02-2021 18:00,24 hrs.,wallstreetbets,LIVE,723,388,335,53,3,281,149,3,NASDAQ
4630,12-02-2021 18:00,24 hrs.,wallstreetbets,LIVX,15,15,0,15,2,2,3,1,NASDAQ
4630,12-02-2021 18:00,24 hrs.,wallstreetbets,LKCO,73,42,31,11,11,11,7,7,NASDAQ
4630,12-02-2021 18:00,24 hrs.,wallstreetbets,LLIT,6,0,6,-6,1,1,0,1,NASDAQ
4630,12-02-2021 18:00,24 hrs.,wallstreetbets,LLNW,49,21,28,-7,7,7,7,7,NASDAQ
4630,12-02-2021 18:00,24 hrs.,wallstreetbets,LPCN,7,7,0,7,1,1,1,1,NASDAQ
4630,12-02-2021 18:00,24 hrs.,wallstreetbets,LRCX,356,356,0,356,1,83,186,1,NASDAQ
4630,12-02-2021 18:00,24 hrs.,wallstreetbets,MARA,52,14,38,-24,8,8,4,7,NASDAQ
4630,12-02-2021 18:00,24 hrs.,wallstreetbets,MARK,13,7,6,1,2,2,1,2,NASDAQ
4630,12-02-2021 18:00,24 hrs.,wallstreetbets,MBRX,38,19,19,0,6,6,2,5,NASDAQ
4630,12-02-2021 18:00,24 hrs.,wallstreetbets,MCHP,402,0,402,-402,1,145,108,1,NASDAQ
4630,12-02-2021 18:00,24 hrs.,wallstreetbets,MGNI,21,14,7,7,3,3,3,3,NASDAQ
4630,12-02-2021 18:00,24 hrs.,wallstreetbets,MITO,6,0,6,-6,1,1,0,1,NASDAQ
4630,12-02-2021 18:00,24 hrs.,wallstreetbets,RBBN,12,0,12,-12,2,2,0,1,NASDAQ
4630,12-02-2021 18:00,24 hrs.,wallstreetbets,RCMT,20,0,20,-20,3,3,2,3,NASDAQ
4630,12-02-2021 18:00,24 hrs.,wallstreetbets,RDHL,13,13,0,13,2,2,1,2,NASDAQ
4630,12-02-2021 18:00,24 hrs.,wallstreetbets,REAL,47,8,39,-31,7,7,5,7,NASDAQ
4630,12-02-2021 18:00,24 hrs.,wallstreetbets,REGI,12,0,12,-12,2,2,0,2,NASDAQ
4630,12-02-2021 18:00,24 hrs.,wallstreetbets,REGN,21,21,0,21,3,3,3,2,NASDAQ
4630,12-02-2021 18:00,24 hrs.,wallstreetbets,RIDE,38,20,18,2,6,6,2,6,NASDAQ
4630,12-02-2021 18:00,24 hrs.,wallstreetbets,RIOT,1467,1448,19,1429,15,629,149,12,NASDAQ
4630,12-02-2021 18:00,24 hrs.,wallstreetbets,RKDA,7,7,0,7,1,1,1,1,NASDAQ
4630,12-02-2021 18:00,24 hrs.,wallstreetbets,RMTI,20,6,14,-8,3,3,2,2,NASDAQ
4630,12-02-2021 18:00,24 hrs.,wallstreetbets,ROCK,6,0,6,-6,1,1,0,1,NASDAQ
4630,12-02-2021 18:00,24 hrs.,wallstreetbets,ROOT,20,14,6,8,3,3,2,2,NASDAQ
4630,12-02-2021 18:00,24 hrs.,wallstreetbets,RWLK,21,21,0,21,3,3,3,3,NASDAQ
4630,12-02-2021 18:00,24 hrs.,wallstreetbets,SABR,7,7,0,7,1,1,1,1,NASDAQ
4630,12-02-2021 18:00,24 hrs.,wallstreetbets,SAGE,6,0,6,-6,1,1,0,1,NASDAQ
4630,12-02-2021 18:00,24 hrs.,wallstreetbets,SAVA,19,7,12,-5,3,3,1,3,NASDAQ
4630,12-02-2021 18:00,24 hrs.,wallstreetbets,SAVE,34,7,27,-20,5,5,4,3,NASDAQ
4630,12-02-2021 18:00,24 hrs.,wallstreetbets,SBUX,7,7,0,7,1,1,1,1,NASDAQ
4630,12-02-2021 18:00,24 hrs.,wallstreetbets,SEEL,19,7,12,-5,3,3,1,3,NASDAQ
4630,12-02-2021 18:00,24 hrs.,wallstreetbets,SHIP,109,96,13,83,16,16,13,13,NASDAQ
4630,12-02-2021 18:00,24 hrs.,wallstreetbets,SIEB,6,0,6,-6,1,1,0,1,NASDAQ
4630,12-02-2021 18:00,24 hrs.,wallstreetbets,SINT,18,0,18,-18,3,3,0,1,NASDAQ
4630,12-02-2021 18:00,24 hrs.,wallstreetbets,SIRI,7,7,0,7,1,1,1,1,NASDAQ
4630,12-02-2021 18:00,24 hrs.,wallstreetbets,SLRX,7,7,0,7,1,1,1,1,NASDAQ
4630,12-02-2021 18:00,24 hrs.,wallstreetbets,SNDL,12693,1076,11617,-10541,396,4425,2259,308,NASDAQ
4630,12-02-2021 18:00,24 hrs.,wallstreetbets,SNGX,7,7,0,7,1,1,1,1,NASDAQ
4630,12-02-2021 18:00,24 hrs.,wallstreetbets,SOHU,6,0,6,-6,1,1,0,1,NASDAQ
4630,12-02-2021 18:00,24 hrs.,wallstreetbets,SOLO,6,0,6,-6,1,1,0,1,NASDAQ
4630,12-02-2021 18:00,24 hrs.,wallstreetbets,SPWR,6,0,6,-6,1,1,0,1,NASDAQ
4630,12-02-2021 18:00,24 hrs.,wallstreetbets,SQQQ,14,7,7,0,2,2,2,2,NASDAQ
4630,12-02-2021 18:00,24 hrs.,wallstreetbets,SRGA,13,7,6,1,2,2,1,2,NASDAQ
4630,12-02-2021 18:00,24 hrs.,wallstreetbets,SRNE,22,0,22,-22,2,5,4,2,NASDAQ
4630,12-02-2021 18:00,24 hrs.,wallstreetbets,SSPK,6,0,6,-6,1,1,0,1,NASDAQ
4630,12-02-2021 18:00,24 hrs.,wallstreetbets,STAF,14,7,7,0,2,2,2,2,NASDAQ
4630,12-02-2021 18:00,24 hrs.,wallstreetbets,STAY,12,6,6,0,2,2,0,2,NASDAQ
4630,12-02-2021 18:00,24 hrs.,wallstreetbets,STEP,13,13,0,13,1,0,9,1,NASDAQ
4630,12-02-2021 18:00,24 hrs.,wallstreetbets,STLD,7,7,0,7,1,1,1,1,NASDAQ
4630,12-02-2021 18:00,24 hrs.,wallstreetbets,SVMK,381,381,0,381,1,152,73,1,NASDAQ
4630,12-02-2021 18:00,24 hrs.,wallstreetbets,SWBI,6,0,6,-6,1,1,0,1,NASDAQ
4630,12-02-2021 18:00,24 hrs.,pennystocks,ADTM,111,0,111,-111,3,32,35,3,OTC
4630,12-02-2021 18:00,24 hrs.,pennystocks,AEPT,6,6,0,6,1,1,0,1,OTC
4630,12-02-2021 18:00,24 hrs.,pennystocks,AFPW,6,6,0,6,1,1,0,1,OTC
4630,12-02-2021 18:00,24 hrs.,pennystocks,AHFD,6,0,6,-6,1,1,0,1,OTC
4630,12-02-2021 18:00,24 hrs.,pennystocks,AITX,363,181,182,-1,7,101,133,7,OTC
4630,12-02-2021 18:00,24 hrs.,pennystocks,ALKM,26,7,19,-12,4,4,2,2,OTC
4630,12-02-2021 18:00,24 hrs.,pennystocks,ALPP,184,168,16,152,7,56,44,6,OTC
4630,12-02-2021 18:00,24 hrs.,pennystocks,ALYI,181,38,143,-105,4,59,47,3,OTC
4630,12-02-2021 18:00,24 hrs.,pennystocks,ANDI,7,7,0,7,1,1,1,1,OTC
4630,12-02-2021 18:00,24 hrs.,pennystocks,APEX,119,0,119,-119,1,41,33,1,OTC
4630,12-02-2021 18:00,24 hrs.,pennystocks,APPZ,7,7,0,7,1,1,1,1,OTC
4630,12-02-2021 18:00,24 hrs.,pennystocks,ASTI,36,18,18,0,5,6,4,5,OTC
4630,12-02-2021 18:00,24 hrs.,pennystocks,ATDS,6,6,0,6,1,1,0,1,OTC
4630,12-02-2021 18:00,24 hrs.,pennystocks,AZFL,95,40,55,-15,4,9,61,3,OTC
4630,12-02-2021 18:00,24 hrs.,pennystocks,BANT,25,6,19,-13,2,4,9,2,OTC
4630,12-02-2021 18:00,24 hrs.,pennystocks,BBRW,50,50,0,50,1,14,18,1,OTC
4630,12-02-2021 18:00,24 hrs.,pennystocks,BCCI,7,0,7,-7,1,1,1,1,OTC
4630,12-02-2021 18:00,24 hrs.,pennystocks,BDGR,6,6,0,6,1,1,0,1,OTC
4630,12-02-2021 18:00,24 hrs.,pennystocks,BIEL,101,101,0,101,4,28,29,3,OTC
4630,12-02-2021 18:00,24 hrs.,pennystocks,BKMP,6,0,6,-6,1,1,0,1,OTC
4630,12-02-2021 18:00,24 hrs.,pennystocks,BLDV,104,0,104,-104,2,31,34,2,OTC
4630,12-02-2021 18:00,24 hrs.,pennystocks,BLLB,6,0,6,-6,1,1,0,1,OTC
4630,12-02-2021 18:00,24 hrs.,pennystocks,BLSP,104,13,91,-78,5,24,36,5,OTC
4630,12-02-2021 18:00,24 hrs.,pennystocks,BMCS,10,10,0,10,1,2,2,1,OTC
4630,12-02-2021 18:00,24 hrs.,pennystocks,BMIX,47,6,41,-35,2,9,21,2,OTC
4630,12-02-2021 18:00,24 hrs.,wallstreetbets,TIGR,7,0,7,-7,1,1,1,1,NASDAQ
4630,12-02-2021 18:00,24 hrs.,wallstreetbets,TLRY,79557,357,79200,-78843,134,37141,4739,114,NASDAQ
4630,12-02-2021 18:00,24 hrs.,wallstreetbets,TNXP,114,20,94,-74,18,18,6,16,NASDAQ
4630,12-02-2021 18:00,24 hrs.,wallstreetbets,TOPS,73,66,7,59,10,11,11,8,NASDAQ
4630,12-02-2021 18:00,24 hrs.,wallstreetbets,TOWN,133,133,0,133,1,40,49,1,NASDAQ
4630,12-02-2021 18:00,24 hrs.,wallstreetbets,TPCO,6,0,6,-6,1,1,0,1,NASDAQ
4630,12-02-2021 18:00,24 hrs.,wallstreetbets,TRCH,44,7,37,-30,7,7,2,5,NASDAQ
4630,12-02-2021 18:00,24 hrs.,wallstreetbets,TRIT,77,26,51,-25,12,12,5,7,NASDAQ
4630,12-02-2021 18:00,24 hrs.,wallstreetbets,TRVG,480,480,0,480,6,166,124,6,NASDAQ
4630,12-02-2021 18:00,24 hrs.,wallstreetbets,TRVN,7,0,7,-7,1,1,1,1,NASDAQ
4630,12-02-2021 18:00,24 hrs.,wallstreetbets,TSLA,3237,1681,1556,125,42,1259,551,31,NASDAQ
4630,12-02-2021 18:00,24 hrs.,wallstreetbets,TTCF,7,0,7,-7,1,1,1,1,NASDAQ
4630,12-02-2021 18:00,24 hrs.,wallstreetbets,TTWO,7,0,7,-7,1,1,1,1,NASDAQ
4630,12-02-2021 18:00,24 hrs.,wallstreetbets,TURN,20,0,20,-20,3,3,2,2,NASDAQ
4630,12-02-2021 18:00,24 hrs.,wallstreetbets,TWOU,12,0,12,-12,2,2,0,1,NASDAQ
4630,12-02-2021 18:00,24 hrs.,wallstreetbets,TXMD,87,43,44,-1,13,13,9,11,NASDAQ
4630,12-02-2021 18:00,24 hrs.,wallstreetbets,TYME,12,0,12,-12,2,2,0,2,NASDAQ
4630,12-02-2021 18:00,24 hrs.,wallstreetbets,UNFI,50,50,0,50,1,20,6,1,NASDAQ
4630,12-02-2021 18:00,24 hrs.,wallstreetbets,UPWK,6,0,6,-6,1,1,0,1,NASDAQ
4630,12-02-2021 18:00,24 hrs.,wallstreetbets,VEON,6,6,0,6,1,1,0,1,NASDAQ
4630,12-02-2021 18:00,24 hrs.,wallstreetbets,VERU,7,7,0,7,1,1,1,1,NASDAQ
4630,12-02-2021 18:00,24 hrs.,wallstreetbets,VISL,13,7,6,1,2,2,1,2,NASDAQ
4630,12-02-2021 18:00,24 hrs.,wallstreetbets,VIVE,6,0,6,-6,1,1,0,1,NASDAQ
4630,12-02-2021 18:00,24 hrs.,wallstreetbets,VLDR,9,9,0,9,1,2,1,1,NASDAQ
4630,12-02-2021 18:00,24 hrs.,wallstreetbets,VNDA,36,0,36,-36,5,5,6,1,NASDAQ
4630,12-02-2021 18:00,24 hrs.,wallstreetbets,VRSN,381,381,0,381,1,152,73,1,NASDAQ
4630,12-02-2021 18:00,24 hrs.,wallstreetbets,VSAT,7,7,0,7,1,1,1,1,NASDAQ
4630,12-02-2021 18:00,24 hrs.,wallstreetbets,VUZI,9,0,9,-9,1,1,3,1,NASDAQ
4630,12-02-2021 18:00,24 hrs.,wallstreetbets,VXRT,13,7,6,1,2,2,1,2,NASDAQ
4630,12-02-2021 18:00,24 hrs.,wallstreetbets,VYNE,7,0,7,-7,1,1,1,1,NASDAQ
4630,12-02-2021 18:00,24 hrs.,wallstreetbets,WATT,54,0,54,-54,7,8,10,4,NASDAQ
4630,12-02-2021 18:00,24 hrs.,wallstreetbets,WKHS,221,215,6,209,2,76,61,2,NASDAQ
4630,12-02-2021 18:00,24 hrs.,wallstreetbets,WTER,7,0,7,-7,1,1,1,1,NASDAQ
4630,12-02-2021 18:00,24 hrs.,wallstreetbets,XERS,15,15,0,15,2,2,3,2,NASDAQ
4630,12-02-2021 18:00,24 hrs.,wallstreetbets,XNET,14,14,0,14,2,2,2,1,NASDAQ
4630,12-02-2021 18:00,24 hrs.,wallstreetbets,XSPA,65,34,31,3,10,10,5,9,NASDAQ
4630,12-02-2021 18:00,24 hrs.,wallstreetbets,YNDX,477,0,477,-477,1,179,115,1,NASDAQ
4630,12-02-2021 18:00,24 hrs.,wallstreetbets,ZNGA,31,0,31,-31,5,5,1,4,NASDAQ
4630,12-02-2021 18:00,24 hrs.,wallstreetbets,ZSAN,6,0,6,-6,1,1,0,1,NASDAQ
4630,12-02-2021 18:00,24 hrs.,pennystocks,ENCS,6,0,6,-6,1,1,0,1,OTC
4630,12-02-2021 18:00,24 hrs.,pennystocks,ENDV,6,0,6,-6,1,1,0,1,OTC
4630,12-02-2021 18:00,24 hrs.,pennystocks,ENRT,6,6,0,6,1,1,0,1,OTC
4630,12-02-2021 18:00,24 hrs.,pennystocks,ENTI,13,0,13,-13,2,2,1,1,OTC
4630,12-02-2021 18:00,24 hrs.,pennystocks,ENZC,25,12,13,-1,4,4,1,3,OTC
4630,12-02-2021 18:00,24 hrs.,pennystocks,EPAZ,119,0,119,-119,1,48,19,1,OTC
4630,12-02-2021 18:00,24 hrs.,pennystocks,ERBB,12,12,0,12,1,0,8,1,OTC
4630,12-02-2021 18:00,24 hrs.,pennystocks,ETFM,104,0,104,-104,2,31,34,2,OTC
4630,12-02-2021 18:00,24 hrs.,pennystocks,ETHE,34,34,0,34,1,4,22,1,OTC
4630,12-02-2021 18:00,24 hrs.,pennystocks,EVSV,6,0,6,-6,1,1,0,1,OTC
4630,12-02-2021 18:00,24 hrs.,pennystocks,EWKS,7,7,0,7,1,1,1,1,OTC
4630,12-02-2021 18:00,24 hrs.,pennystocks,FBEC,6,6,0,6,1,1,0,1,OTC
4630,12-02-2021 18:00,24 hrs.,pennystocks,FDBH,7,7,0,7,1,1,1,1,OTC
4630,12-02-2021 18:00,24 hrs.,pennystocks,FMCC,119,0,119,-119,1,41,33,1,OTC
4630,12-02-2021 18:00,24 hrs.,pennystocks,FNMA,119,0,119,-119,1,41,33,1,OTC
4630,12-02-2021 18:00,24 hrs.,pennystocks,FPVD,9,0,9,-9,1,2,1,1,OTC
4630,12-02-2021 18:00,24 hrs.,pennystocks,FTFY,6,0,6,-6,1,1,0,1,OTC
4630,12-02-2021 18:00,24 hrs.,pennystocks,FUST,7,7,0,7,1,1,1,1,OTC
4630,12-02-2021 18:00,24 hrs.,pennystocks,FUTL,7,0,7,-7,1,1,1,1,OTC
4630,12-02-2021 18:00,24 hrs.,pennystocks,GAXY,79,0,79,-79,1,20,35,1,OTC
4630,12-02-2021 18:00,24 hrs.,pennystocks,GBTC,34,34,0,34,1,4,22,1,OTC
4630,12-02-2021 18:00,24 hrs.,pennystocks,GDET,13,0,13,-13,2,2,1,2,OTC
4630,12-02-2021 18:00,24 hrs.,pennystocks,GHMP,46,46,0,46,3,10,14,2,OTC
4630,12-02-2021 18:00,24 hrs.,pennystocks,GLEC,6,6,0,6,1,1,0,1,OTC
4630,12-02-2021 18:00,24 hrs.,pennystocks,GLGI,119,0,119,-119,1,41,33,1,OTC
4630,12-02-2021 18:00,24 hrs.,RobinHoodPennyStocks,ABEPF,8,0,8,-8,1,0,4,1,OTC
4630,12-02-2021 18:00,24 hrs.,RobinHoodPennyStocks,BDRBF,209,30,179,-149,11,50,65,11,OTC
4630,12-02-2021 18:00,24 hrs.,RobinHoodPennyStocks,HITIF,6,0,6,-6,1,1,0,1,OTC
4630,12-02-2021 18:00,24 hrs.,RobinHoodPennyStocks,MZDAY,24,0,24,-24,1,5,10,1,OTC
4630,12-02-2021 18:00,24 hrs.,RobinHoodPennyStocks,PMEDF,6,6,0,6,1,1,0,1,OTC
4630,12-02-2021 18:00,24 hrs.,RobinHoodPennyStocks,RYCEY,12,12,0,12,2,2,0,2,OTC
4630,12-02-2021 18:00,24 hrs.,RobinHoodPennyStocks,SHCAY,14,14,0,14,1,5,0,1,OTC
4630,12-02-2021 18:00,24 hrs.,RobinHoodPennyStocks,TLOFF,6,0,6,-6,1,1,0,1,OTC
4630,12-02-2021 18:00,24 hrs.,RobinHoodPennyStocks,VRYYF,6,0,6,-6,1,1,0,1,OTC
4630,12-02-2021 18:00,24 hrs.,pennystocks,GMEV,656,0,656,-656,1,256,140,1,OTC
4630,12-02-2021 18:00,24 hrs.,pennystocks,GNCP,10,0,10,-10,1,1,4,1,OTC
4630,12-02-2021 18:00,24 hrs.,pennystocks,GPFT,48,35,13,22,3,9,18,3,OTC
4630,12-02-2021 18:00,24 hrs.,pennystocks,GRCU,15,9,6,3,2,2,3,2,OTC
4630,12-02-2021 18:00,24 hrs.,pennystocks,GTCH,38,20,18,2,4,3,16,2,OTC
4630,12-02-2021 18:00,24 hrs.,pennystocks,GTEH,161,0,161,-161,3,62,25,3,OTC
4630,12-02-2021 18:00,24 hrs.,pennystocks,GTLL,90,48,42,6,3,31,16,3,OTC
4630,12-02-2021 18:00,24 hrs.,pennystocks,HALB,11,11,0,11,1,3,1,1,OTC
4630,12-02-2021 18:00,24 hrs.,pennystocks,HCMC,173,77,96,-19,25,31,11,23,OTC
4630,12-02-2021 18:00,24 hrs.,pennystocks,HEMP,13,0,13,-13,2,2,1,2,OTC
4630,12-02-2021 18:00,24 hrs.,pennystocks,HIPH,1345,12,1333,-1321,7,593,131,4,OTC
4630,12-02-2021 18:00,24 hrs.,pennystocks,HMNY,14,0,14,-14,2,2,2,2,OTC
4630,12-02-2021 18:00,24 hrs.,pennystocks,HPMM,17,0,17,-17,2,2,5,2,OTC
4630,12-02-2021 18:00,24 hrs.,pennystocks,HPTY,32,32,0,32,1,10,8,1,OTC
4630,12-02-2021 18:00,24 hrs.,pennystocks,HQGE,6,0,6,-6,1,1,0,1,OTC
4630,12-02-2021 18:00,24 hrs.,pennystocks,HRTH,119,0,119,-119,1,41,33,1,OTC
4630,12-02-2021 18:00,24 hrs.,pennystocks,HYII,7,0,7,-7,1,1,1,1,OTC
4630,12-02-2021 18:00,24 hrs.,pennystocks,HYSR,167,6,161,-155,5,53,41,5,OTC
4630,12-02-2021 18:00,24 hrs.,pennystocks,IBRC,10,0,10,-10,1,2,2,1,OTC
4630,12-02-2021 18:00,24 hrs.,pennystocks,ICBU,6,6,0,6,1,1,0,1,OTC
4630,12-02-2021 18:00,24 hrs.,pennystocks,ICNM,15,15,0,15,1,4,3,1,OTC
4630,12-02-2021 18:00,24 hrs.,pennystocks,ILUS,6,0,6,-6,1,1,0,1,OTC
4630,12-02-2021 18:00,24 hrs.,pennystocks,IMJX,88,82,6,76,2,26,28,2,OTC
4630,12-02-2021 18:00,24 hrs.,pennystocks,IMTL,6,6,0,6,1,1,0,1,OTC
4630,12-02-2021 18:00,24 hrs.,pennystocks,INCT,7,0,7,-7,1,1,1,1,OTC
4630,12-02-2021 18:00,24 hrs.,pennystocks,INKW,74,50,24,26,12,12,2,10,OTC
4630,12-02-2021 18:00,24 hrs.,pennystocks,INND,167,96,71,25,10,28,71,10,OTC
4630,12-02-2021 18:00,24 hrs.,pennystocks,INTV,6,6,0,6,1,1,0,1,OTC
4630,12-02-2021 18:00,24 hrs.,pennystocks,INVU,6,0,6,-6,1,1,0,1,OTC
4630,12-02-2021 18:00,24 hrs.,pennystocks,IPIX,67,6,61,-55,2,13,33,2,OTC
4630,12-02-2021 18:00,24 hrs.,pennystocks,IPSI,6,0,6,-6,1,1,0,1,OTC
4630,12-02-2021 18:00,24 hrs.,pennystocks,IQST,18,18,0,18,3,3,0,2,OTC
4630,12-02-2021 18:00,24 hrs.,pennystocks,ITCJ,7,7,0,7,1,1,1,1,OTC
4630,12-02-2021 18:00,24 hrs.,pennystocks,JETR,6,0,6,-6,1,1,0,1,OTC
4630,12-02-2021 18:00,24 hrs.,pennystocks,JSDA,6,6,0,6,1,1,0,1,OTC
4630,12-02-2021 18:00,24 hrs.,pennystocks,KGKG,25,0,25,-25,4,4,1,2,OTC
4630,12-02-2021 18:00,24 hrs.,pennystocks,KWBT,126,7,119,-112,2,42,34,2,OTC
4630,12-02-2021 18:00,24 hrs.,pennystocks,KYNC,38,0,38,-38,6,6,2,2,OTC
4630,12-02-2021 18:00,24 hrs.,pennystocks,LBSR,7,0,7,-7,1,1,1,1,OTC
4630,12-02-2021 18:00,24 hrs.,pennystocks,LQMT,99,6,93,-87,2,30,31,2,OTC
4630,12-02-2021 18:00,24 hrs.,pennystocks,LTNC,6,0,6,-6,1,1,0,1,OTC
4630,12-02-2021 18:00,24 hrs.,pennystocks,LTUM,6,0,6,-6,1,1,0,1,OTC
4630,12-02-2021 18:00,24 hrs.,pennystocks,LUVU,153,14,139,-125,6,48,33,5,OTC
4630,12-02-2021 18:00,24 hrs.,pennystocks,LVVV,24,0,24,-24,4,4,0,2,OTC
4630,12-02-2021 18:00,24 hrs.,pennystocks,MAXD,12,12,0,12,2,2,0,2,OTC
4630,12-02-2021 18:00,24 hrs.,pennystocks,MCOA,14,7,7,0,2,2,2,2,OTC
4630,12-02-2021 18:00,24 hrs.,pennystocks,MDCN,13,13,0,13,2,2,1,2,OTC
4630,12-02-2021 18:00,24 hrs.,pennystocks,MEDH,53,53,0,53,1,12,25,1,OTC
4630,12-02-2021 18:00,24 hrs.,pennystocks,MGLG,6,0,6,-6,1,1,0,1,OTC
4630,12-02-2021 18:00,24 hrs.,pennystocks,MIKP,6,0,6,-6,1,1,0,1,OTC
4630,12-02-2021 18:00,24 hrs.,wallstreetbets,SWKS,356,356,0,356,1,83,186,1,NASDAQ
4630,12-02-2021 18:00,24 hrs.,wallstreetbets,TEAM,12,0,12,-12,2,2,0,1,NASDAQ
4630,12-02-2021 18:00,24 hrs.,wallstreetbets,TELL,31339,13,31326,-31313,4,14973,1377,4,NASDAQ
4630,12-02-2021 18:00,24 hrs.,wallstreetbets,THBR,25,0,25,-25,4,4,1,3,NASDAQ
4630,12-02-2021 18:00,24 hrs.,wallstreetbets,THMO,13,13,0,13,2,2,1,1,NASDAQ
4630,12-02-2021 18:00,24 hrs.,RobinHoodPennyStocks,PSA,18,0,18,-18,1,5,4,1,NYSE
4630,12-02-2021 18:00,24 hrs.,RobinHoodPennyStocks,RFP,109,0,109,-109,1,40,25,1,NYSE
4630,12-02-2021 18:00,24 hrs.,RobinHoodPennyStocks,SOS,201,50,151,-101,10,61,39,8,NYSE
4630,12-02-2021 18:00,24 hrs.,RobinHoodPennyStocks,SUZ,109,0,109,-109,1,40,25,1,NYSE
4630,12-02-2021 18:00,24 hrs.,RobinHoodPennyStocks,TAL,109,0,109,-109,1,40,25,1,NYSE
4630,12-02-2021 18:00,24 hrs.,RobinHoodPennyStocks,WEI,109,0,109,-109,1,40,25,1,NYSE
4630,12-02-2021 18:00,24 hrs.,RobinHoodPennyStocks,BABA,109,0,109,-109,1,40,25,1,NYSE
4630,12-02-2021 18:00,24 hrs.,RobinHoodPennyStocks,CCIV,38,38,0,38,1,10,14,1,NYSE
4630,12-02-2021 18:00,24 hrs.,RobinHoodPennyStocks,CEIX,109,0,109,-109,1,40,25,1,NYSE
4630,12-02-2021 18:00,24 hrs.,pennystocks,MINE,692,40,652,-612,5,275,122,5,OTC
4630,12-02-2021 18:00,24 hrs.,pennystocks,MJNA,150,25,125,-100,7,42,38,6,OTC
4630,12-02-2021 18:00,24 hrs.,pennystocks,MJTV,7,7,0,7,1,1,1,1,OTC
4630,12-02-2021 18:00,24 hrs.,pennystocks,MKTY,7,7,0,7,1,1,1,1,OTC
4630,12-02-2021 18:00,24 hrs.,pennystocks,MLFB,93,87,6,81,3,25,31,3,OTC
4630,12-02-2021 18:00,24 hrs.,pennystocks,MMEX,66,31,35,-4,4,12,26,3,OTC
4630,12-02-2021 18:00,24 hrs.,pennystocks,MODC,6,0,6,-6,1,1,0,1,OTC
4630,12-02-2021 18:00,24 hrs.,pennystocks,MOJO,6,6,0,6,1,1,0,1,OTC
4630,12-02-2021 18:00,24 hrs.,pennystocks,MRMD,45,0,45,-45,1,18,5,1,OTC
4630,12-02-2021 18:00,24 hrs.,pennystocks,MRNJ,13,0,13,-13,2,2,1,1,OTC
4630,12-02-2021 18:00,24 hrs.,pennystocks,MTVX,6,6,0,6,1,1,0,1,OTC
4630,12-02-2021 18:00,24 hrs.,pennystocks,NBVG,7,7,0,7,1,1,1,1,OTC
4630,12-02-2021 18:00,24 hrs.,pennystocks,NOVC,44,44,0,44,2,13,10,2,OTC
4630,12-02-2021 18:00,24 hrs.,pennystocks,NPHC,48,0,48,-48,2,10,20,2,OTC
4630,12-02-2021 18:00,24 hrs.,pennystocks,NSAV,47,6,41,-35,3,8,19,3,OTC
4630,12-02-2021 18:00,24 hrs.,pennystocks,NSEO,6,0,6,-6,1,1,0,1,OTC
4630,12-02-2021 18:00,24 hrs.,pennystocks,NSPT,6,6,0,6,1,1,0,1,OTC
4630,12-02-2021 18:00,24 hrs.,pennystocks,OZSC,200,0,200,-200,3,47,94,3,OTC
4630,12-02-2021 18:00,24 hrs.,pennystocks,PAOG,7,7,0,7,1,1,1,1,OTC
4630,12-02-2021 18:00,24 hrs.,pennystocks,PASO,199,0,199,-199,4,68,47,4,OTC
4630,12-02-2021 18:00,24 hrs.,pennystocks,PDXP,7,7,0,7,1,1,1,1,OTC
4630,12-02-2021 18:00,24 hrs.,pennystocks,PHIL,12,6,6,0,2,2,0,2,OTC
4630,12-02-2021 18:00,24 hrs.,pennystocks,PLSB,6,0,6,-6,1,1,0,1,OTC
4630,12-02-2021 18:00,24 hrs.,pennystocks,PMCB,6,6,0,6,1,1,0,1,OTC
4630,12-02-2021 18:00,24 hrs.,pennystocks,PMDP,6,0,6,-6,1,1,0,1,OTC
4630,12-02-2021 18:00,24 hrs.,pennystocks,PRPM,6,0,6,-6,1,1,0,1,OTC
4630,12-02-2021 18:00,24 hrs.,pennystocks,PSYC,290,0,290,-290,5,109,52,3,OTC
4630,12-02-2021 18:00,24 hrs.,pennystocks,PUGE,22,16,6,10,2,4,6,2,OTC
4630,12-02-2021 18:00,24 hrs.,pennystocks,PURA,7,7,0,7,1,1,1,1,OTC
4630,12-02-2021 18:00,24 hrs.,pennystocks,PVDG,21,21,0,21,1,1,15,1,OTC
4630,12-02-2021 18:00,24 hrs.,pennystocks,PZOO,7,0,7,-7,1,1,1,1,OTC
4630,12-02-2021 18:00,24 hrs.,pennystocks,QOIL,7,7,0,7,1,1,1,1,OTC
4630,12-02-2021 18:00,24 hrs.,pennystocks,RELI,40,13,27,-14,2,6,20,2,OTC
4630,12-02-2021 18:00,24 hrs.,pennystocks,RITE,41,0,41,-41,1,8,21,1,OTC
4630,12-02-2021 18:00,24 hrs.,pennystocks,RLBD,16,16,0,16,1,4,4,1,OTC
4630,12-02-2021 18:00,24 hrs.,pennystocks,RLTR,12,0,12,-12,2,2,0,2,OTC
4630,12-02-2021 18:00,24 hrs.,pennystocks,RMTD,6,6,0,6,1,1,0,1,OTC
4630,12-02-2021 18:00,24 hrs.,pennystocks,RNVA,119,0,119,-119,1,41,33,1,OTC
4630,12-02-2021 18:00,24 hrs.,pennystocks,RRTS,119,0,119,-119,1,41,33,1,OTC
4630,12-02-2021 18:00,24 hrs.,wallstreetbets,ZYNE,7,7,0,7,1,1,1,1,NASDAQ
4630,12-02-2021 18:00,24 hrs.,RobinHoodPennyStocks,AHFD,6,0,6,-6,1,1,0,1,OTC
4630,12-02-2021 18:00,24 hrs.,RobinHoodPennyStocks,AZFL,6,0,6,-6,1,0,2,1,OTC
4630,12-02-2021 18:00,24 hrs.,RobinHoodPennyStocks,BLXX,6,6,0,6,1,1,0,1,OTC
4630,12-02-2021 18:00,24 hrs.,RobinHoodPennyStocks,CAPS,6,6,0,6,1,1,0,1,OTC
4630,12-02-2021 18:00,24 hrs.,RobinHoodPennyStocks,CBDD,6,6,0,6,1,1,0,1,OTC
4630,12-02-2021 18:00,24 hrs.,RobinHoodPennyStocks,COMS,6,0,6,-6,1,1,0,1,OTC
4630,12-02-2021 18:00,24 hrs.,RobinHoodPennyStocks,CYTR,6,0,6,-6,1,1,0,1,OTC
4630,12-02-2021 18:00,24 hrs.,RobinHoodPennyStocks,DIGI,6,6,0,6,1,1,0,1,OTC
4630,12-02-2021 18:00,24 hrs.,RobinHoodPennyStocks,GLEC,6,6,0,6,1,1,0,1,OTC
4630,12-02-2021 18:00,24 hrs.,RobinHoodPennyStocks,GPFT,28,28,0,28,4,4,4,2,OTC
4630,12-02-2021 18:00,24 hrs.,RobinHoodPennyStocks,HCMC,24,6,18,-12,4,4,0,3,OTC
4630,12-02-2021 18:00,24 hrs.,RobinHoodPennyStocks,LTUM,6,6,0,6,1,1,0,1,OTC
4630,12-02-2021 18:00,24 hrs.,RobinHoodPennyStocks,MJNA,6,6,0,6,1,1,0,1,OTC
4630,12-02-2021 18:00,24 hrs.,RobinHoodPennyStocks,NUGS,6,0,6,-6,1,1,0,1,OTC
4630,12-02-2021 18:00,24 hrs.,RobinHoodPennyStocks,OPTI,6,0,6,-6,1,1,0,1,OTC
4630,12-02-2021 18:00,24 hrs.,pennystocks,SGLN,86,0,86,-86,1,15,52,1,OTC
4630,12-02-2021 18:00,24 hrs.,pennystocks,SGMD,208,149,59,90,10,55,58,10,OTC
4630,12-02-2021 18:00,24 hrs.,pennystocks,SGSI,150,6,144,-138,5,47,36,4,OTC
4630,12-02-2021 18:00,24 hrs.,pennystocks,SHMP,29,6,23,-17,3,2,13,3,OTC
4630,12-02-2021 18:00,24 hrs.,pennystocks,SHRG,7,0,7,-7,1,1,1,1,OTC
4630,12-02-2021 18:00,24 hrs.,pennystocks,SHWZ,7,7,0,7,1,1,1,1,OTC
4630,12-02-2021 18:00,24 hrs.,pennystocks,SILO,16,0,16,-16,1,3,6,1,OTC
4630,12-02-2021 18:00,24 hrs.,pennystocks,SIML,82,82,0,82,1,25,28,1,OTC
4630,12-02-2021 18:00,24 hrs.,pennystocks,SING,44,22,22,0,3,4,24,3,OTC
4630,12-02-2021 18:00,24 hrs.,pennystocks,SNPW,453,27,426,-399,6,161,107,6,OTC
4630,12-02-2021 18:00,24 hrs.,pennystocks,SNRS,14,14,0,14,2,2,2,2,OTC
4630,12-02-2021 18:00,24 hrs.,pennystocks,SNWV,12,12,0,12,2,2,0,1,OTC
4630,12-02-2021 18:00,24 hrs.,pennystocks,SRMX,248,183,65,118,13,47,102,12,OTC
4630,12-02-2021 18:00,24 hrs.,pennystocks,SRNA,6,6,0,6,1,1,0,1,OTC
4630,12-02-2021 18:00,24 hrs.,pennystocks,SSFT,18,0,18,-18,3,3,0,1,OTC
4630,12-02-2021 18:00,24 hrs.,pennystocks,STEV,40,10,30,-20,4,9,6,3,OTC
4630,12-02-2021 18:00,24 hrs.,pennystocks,SUGR,6,0,6,-6,1,1,0,1,OTC
4630,12-02-2021 18:00,24 hrs.,pennystocks,SUIC,7,0,7,-7,1,1,1,1,OTC
4630,12-02-2021 18:00,24 hrs.,pennystocks,SURG,119,0,119,-119,1,41,33,1,OTC
4630,12-02-2021 18:00,24 hrs.,RobinHoodPennyStocks,AAU,109,0,109,-109,1,40,25,1,AMEX
4630,12-02-2021 18:00,24 hrs.,RobinHoodPennyStocks,CEI,6,0,6,-6,1,1,0,1,AMEX
4630,12-02-2021 18:00,24 hrs.,RobinHoodPennyStocks,DNN,522,6,516,-510,8,176,138,7,AMEX
4630,12-02-2021 18:00,24 hrs.,RobinHoodPennyStocks,DPW,109,0,109,-109,1,40,25,1,AMEX
4630,12-02-2021 18:00,24 hrs.,RobinHoodPennyStocks,GSV,183,6,177,-171,3,54,63,3,AMEX
4630,12-02-2021 18:00,24 hrs.,RobinHoodPennyStocks,GTE,874,361,513,-152,21,264,262,19,AMEX
4630,12-02-2021 18:00,24 hrs.,RobinHoodPennyStocks,ITP,6,6,0,6,1,1,0,1,AMEX
4630,12-02-2021 18:00,24 hrs.,RobinHoodPennyStocks,NAK,172,24,148,-124,8,54,32,8,AMEX
4630,12-02-2021 18:00,24 hrs.,RobinHoodPennyStocks,PLM,42,0,42,-42,1,16,6,1,AMEX
4630,12-02-2021 18:00,24 hrs.,RobinHoodPennyStocks,RHE,109,0,109,-109,1,40,25,1,AMEX
4630,12-02-2021 18:00,24 hrs.,RobinHoodPennyStocks,SYN,6,0,6,-6,1,1,0,1,AMEX
4630,12-02-2021 18:00,24 hrs.,RobinHoodPennyStocks,TGB,118,6,112,-106,3,43,20,2,AMEX
4630,12-02-2021 18:00,24 hrs.,RobinHoodPennyStocks,TRT,109,0,109,-109,1,40,25,1,AMEX
4630,12-02-2021 18:00,24 hrs.,RobinHoodPennyStocks,TRX,243,35,208,-173,3,77,77,3,AMEX
4630,12-02-2021 18:00,24 hrs.,RobinHoodPennyStocks,XPL,109,0,109,-109,1,40,25,1,AMEX
4630,12-02-2021 18:00,24 hrs.,RobinHoodPennyStocks,ZOM,1189,676,513,163,15,375,379,15,AMEX
4630,12-02-2021 18:00,24 hrs.,RobinHoodPennyStocks,AMBO,109,0,109,-109,1,40,25,1,AMEX
4630,12-02-2021 18:00,24 hrs.,RobinHoodPennyStocks,AUMN,208,0,208,-208,2,69,62,2,AMEX
4630,12-02-2021 18:00,24 hrs.,RobinHoodPennyStocks,GSAT,24,0,24,-24,1,4,12,1,AMEX
4630,12-02-2021 18:00,24 hrs.,RobinHoodPennyStocks,NSPR,28,21,7,14,2,5,10,2,AMEX
4630,12-02-2021 18:00,24 hrs.,RobinHoodPennyStocks,OGEN,18,18,0,18,3,3,0,3,AMEX
4630,12-02-2021 18:00,24 hrs.,RobinHoodPennyStocks,PLAG,109,0,109,-109,1,40,25,1,AMEX
4630,12-02-2021 18:00,24 hrs.,RobinHoodPennyStocks,SENS,53,53,0,53,2,21,3,2,AMEX
4630,12-02-2021 18:00,24 hrs.,RobinHoodPennyStocks,SMTS,6,0,6,-6,1,1,0,1,AMEX
4630,12-02-2021 18:00,24 hrs.,RobinHoodPennyStocks,TKAT,109,0,109,-109,1,40,25,1,AMEX
4630,12-02-2021 18:00,24 hrs.,RobinHoodPennyStocks,TRXC,169,12,157,-145,3,63,31,3,AMEX
4630,12-02-2021 18:00,24 hrs.,RobinHoodPennyStocks,YCBD,6,0,6,-6,1,1,0,1,AMEX
4630,12-02-2021 18:00,24 hrs.,RobinHoodPennyStocks,AIV,6,6,0,6,1,1,0,1,NYSE
4630,12-02-2021 18:00,24 hrs.,RobinHoodPennyStocks,AMC,155,0,155,-155,3,50,43,3,NYSE
4630,12-02-2021 18:00,24 hrs.,RobinHoodPennyStocks,ASX,6,0,6,-6,1,1,0,1,NYSE
4630,12-02-2021 18:00,24 hrs.,RobinHoodPennyStocks,AUY,99,0,99,-99,1,29,37,1,NYSE
4630,12-02-2021 18:00,24 hrs.,RobinHoodPennyStocks,BBW,6,0,6,-6,1,1,0,1,NYSE
4630,12-02-2021 18:00,24 hrs.,RobinHoodPennyStocks,BTU,109,0,109,-109,1,40,25,1,NYSE
4630,12-02-2021 18:00,24 hrs.,RobinHoodPennyStocks,CCM,109,0,109,-109,1,40,25,1,NYSE
4630,12-02-2021 18:00,24 hrs.,RobinHoodPennyStocks,COO,99,0,99,-99,1,29,37,1,NYSE
4630,12-02-2021 18:00,24 hrs.,RobinHoodPennyStocks,CTK,109,0,109,-109,1,40,25,1,NYSE
4630,12-02-2021 18:00,24 hrs.,RobinHoodPennyStocks,FSR,115,6,109,-103,2,41,25,2,NYSE
4630,12-02-2021 18:00,24 hrs.,RobinHoodPennyStocks,GME,54,0,54,-54,2,9,28,2,NYSE
4630,12-02-2021 18:00,24 hrs.,RobinHoodPennyStocks,GSX,109,0,109,-109,1,40,25,1,NYSE
4630,12-02-2021 18:00,24 hrs.,RobinHoodPennyStocks,IRS,53,53,0,53,1,23,3,1,NYSE
4630,12-02-2021 18:00,24 hrs.,RobinHoodPennyStocks,IVR,6,0,6,-6,1,1,0,1,NYSE
4630,12-02-2021 18:00,24 hrs.,RobinHoodPennyStocks,LOW,6,6,0,6,1,1,0,1,NYSE
4630,12-02-2021 18:00,24 hrs.,RobinHoodPennyStocks,LYG,6,0,6,-6,1,1,0,1,NYSE
4630,12-02-2021 18:00,24 hrs.,RobinHoodPennyStocks,NIO,109,0,109,-109,1,40,25,1,NYSE
4630,12-02-2021 18:00,24 hrs.,RobinHoodPennyStocks,PDT,119,0,119,-119,2,39,33,2,NYSE
4630,12-02-2021 18:00,24 hrs.,pennystocks,TREP,6,0,6,-6,1,1,0,1,OTC
4630,12-02-2021 18:00,24 hrs.,pennystocks,TRTC,15,0,15,-15,1,0,11,1,OTC
4630,12-02-2021 18:00,24 hrs.,pennystocks,TSNP,12,6,6,0,2,2,0,2,OTC
4630,12-02-2021 18:00,24 hrs.,pennystocks,TSTS,12,0,12,-12,2,2,0,1,OTC
4630,12-02-2021 18:00,24 hrs.,pennystocks,UATG,12,0,12,-12,2,2,0,2,OTC
4630,12-02-2021 18:00,24 hrs.,pennystocks,USMJ,31,31,0,31,2,6,11,2,OTC
4630,12-02-2021 18:00,24 hrs.,pennystocks,USRM,6,6,0,6,1,1,0,1,OTC
4630,12-02-2021 18:00,24 hrs.,pennystocks,UVSE,7,0,7,-7,1,1,1,1,OTC
4630,12-02-2021 18:00,24 hrs.,pennystocks,VPER,6,0,6,-6,1,1,0,1,OTC
4630,12-02-2021 18:00,24 hrs.,pennystocks,VPLM,6,6,0,6,1,1,0,1,OTC
4630,12-02-2021 18:00,24 hrs.,pennystocks,VTLR,6,6,0,6,1,1,0,1,OTC
4630,12-02-2021 18:00,24 hrs.,pennystocks,WARM,39,0,39,-39,1,13,9,1,OTC
4630,12-02-2021 18:00,24 hrs.,pennystocks,WCVC,82,82,0,82,1,25,28,1,OTC
4630,12-02-2021 18:00,24 hrs.,pennystocks,WDLF,183,0,183,-183,4,39,89,4,OTC
4630,12-02-2021 18:00,24 hrs.,pennystocks,WHEN,7,0,7,-7,1,1,1,1,OTC
4630,12-02-2021 18:00,24 hrs.,pennystocks,WIZD,15,15,0,15,1,5,1,1,OTC
4630,12-02-2021 18:00,24 hrs.,pennystocks,WSTL,119,0,119,-119,1,41,33,1,OTC
4630,12-02-2021 18:00,24 hrs.,pennystocks,WTII,39,39,0,39,1,12,11,1,OTC
4630,12-02-2021 18:00,24 hrs.,pennystocks,XMET,8,0,8,-8,1,0,4,1,OTC
4630,12-02-2021 18:00,24 hrs.,pennystocks,XTRM,6,0,6,-6,1,1,0,1,OTC
4630,12-02-2021 18:00,24 hrs.,pennystocks,ZPAS,6,6,0,6,1,1,0,1,OTC
4630,12-02-2021 18:00,24 hrs.,pennystocks,ABEPF,76,0,76,-76,3,19,26,3,OTC
4630,12-02-2021 18:00,24 hrs.,pennystocks,AGGHF,16,16,0,16,1,4,4,1,OTC
4630,12-02-2021 18:00,24 hrs.,pennystocks,ALLIF,113,113,0,113,1,32,45,1,OTC
4630,12-02-2021 18:00,24 hrs.,pennystocks,AQSZF,35,0,35,-35,1,12,7,1,OTC
4630,12-02-2021 18:00,24 hrs.,pennystocks,ARBKF,167,40,127,-87,3,37,81,3,OTC
4630,12-02-2021 18:00,24 hrs.,pennystocks,BDRBF,50,0,50,-50,1,15,16,1,OTC
4630,12-02-2021 18:00,24 hrs.,pennystocks,BKLLF,63,63,0,63,1,19,21,1,OTC
4630,12-02-2021 18:00,24 hrs.,pennystocks,BRPHF,34,34,0,34,1,4,22,1,OTC
4630,12-02-2021 18:00,24 hrs.,pennystocks,BVNNF,7,7,0,7,1,1,1,1,OTC
4630,12-02-2021 18:00,24 hrs.,pennystocks,CANSF,5,5,0,5,1,0,1,1,OTC
4630,12-02-2021 18:00,24 hrs.,pennystocks,CBULF,6,6,0,6,1,1,0,1,OTC
4630,12-02-2021 18:00,24 hrs.,pennystocks,CBWTF,12,6,6,0,2,2,0,2,OTC
4630,12-02-2021 18:00,24 hrs.,pennystocks,CCIHY,119,0,119,-119,1,48,19,1,OTC
4630,12-02-2021 18:00,24 hrs.,pennystocks,CNIKF,61,0,61,-61,1,15,27,1,OTC
4630,12-02-2021 18:00,24 hrs.,pennystocks,COCSF,6,0,6,-6,1,1,0,1,OTC
4630,12-02-2021 18:00,24 hrs.,pennystocks,CPHRF,35,0,35,-35,1,10,11,1,OTC
4630,12-02-2021 18:00,24 hrs.,pennystocks,CRLBF,22,22,0,22,1,2,14,1,OTC
4630,12-02-2021 18:00,24 hrs.,pennystocks,CXXIF,6,0,6,-6,1,1,0,1,OTC
4630,12-02-2021 18:00,24 hrs.,pennystocks,DFLYF,46,0,46,-46,1,16,10,1,OTC
4630,12-02-2021 18:00,24 hrs.,pennystocks,DFODQ,19,19,0,19,1,3,9,1,OTC
4630,12-02-2021 18:00,24 hrs.,pennystocks,DMGGF,34,34,0,34,1,4,22,1,OTC
4630,12-02-2021 18:00,24 hrs.,pennystocks,EHVVF,215,0,215,-215,1,90,31,1,OTC
4630,12-02-2021 18:00,24 hrs.,pennystocks,ELRRF,6,6,0,6,1,1,0,1,OTC
4630,12-02-2021 18:00,24 hrs.,pennystocks,EMHTF,6,6,0,6,1,1,0,1,OTC
4630,12-02-2021 18:00,24 hrs.,pennystocks,ENTBF,215,0,215,-215,1,90,31,1,OTC
4630,12-02-2021 18:00,24 hrs.,pennystocks,EVKIF,19,19,0,19,1,5,5,1,OTC
4630,12-02-2021 18:00,24 hrs.,pennystocks,FIORF,8,0,8,-8,1,1,2,1,OTC
4630,12-02-2021 18:00,24 hrs.,pennystocks,FLWPF,29,22,7,15,2,5,11,2,OTC
4630,12-02-2021 18:00,24 hrs.,pennystocks,FTRPF,215,0,215,-215,1,90,31,1,OTC
4630,12-02-2021 18:00,24 hrs.,pennystocks,FUNFF,45,12,33,-21,2,10,17,2,OTC
4630,12-02-2021 18:00,24 hrs.,pennystocks,GBOKF,215,0,215,-215,1,90,31,1,OTC
4630,12-02-2021 18:00,24 hrs.,pennystocks,GCPEF,23,0,23,-23,1,6,7,1,OTC
4630,12-02-2021 18:00,24 hrs.,pennystocks,GLDFF,12,6,6,0,2,2,0,2,OTC
4630,12-02-2021 18:00,24 hrs.,pennystocks,GUESF,7,0,7,-7,1,1,1,1,OTC
4630,12-02-2021 18:00,24 hrs.,pennystocks,HAVLF,215,0,215,-215,1,90,31,1,OTC
4630,12-02-2021 18:00,24 hrs.,pennystocks,HITIF,1001,816,185,631,17,331,271,14,OTC
4630,12-02-2021 18:00,24 hrs.,RobinHoodPennyStocks,CMCM,109,0,109,-109,1,40,25,1,NYSE
4630,12-02-2021 18:00,24 hrs.,pennystocks,RSHN,6,6,0,6,1,0,2,1,OTC
4630,12-02-2021 18:00,24 hrs.,pennystocks,RSSV,185,179,6,173,2,64,49,2,OTC
4630,12-02-2021 18:00,24 hrs.,pennystocks,RTON,191,6,185,-179,6,53,61,5,OTC
4630,12-02-2021 18:00,24 hrs.,pennystocks,SCIE,357,6,351,-345,2,152,45,2,OTC
4630,12-02-2021 18:00,24 hrs.,pennystocks,SEEK,7,0,7,-7,1,1,1,1,OTC
4630,12-02-2021 18:00,24 hrs.,pennystocks,SFOR,6,0,6,-6,1,1,0,1,OTC
4630,12-02-2021 18:00,24 hrs.,RobinHoodPennyStocks,ENG,109,0,109,-109,1,40,25,1,NASDAQ
4630,12-02-2021 18:00,24 hrs.,RobinHoodPennyStocks,EVK,109,0,109,-109,1,40,25,1,NASDAQ
4630,12-02-2021 18:00,24 hrs.,RobinHoodPennyStocks,JFU,6,0,6,-6,1,1,0,1,NASDAQ
4630,12-02-2021 18:00,24 hrs.,RobinHoodPennyStocks,MGI,109,0,109,-109,1,40,25,1,NASDAQ
4630,12-02-2021 18:00,24 hrs.,RobinHoodPennyStocks,OCG,109,0,109,-109,1,40,25,1,NASDAQ
4630,12-02-2021 18:00,24 hrs.,RobinHoodPennyStocks,OEG,109,0,109,-109,1,40,25,1,NASDAQ
4630,12-02-2021 18:00,24 hrs.,RobinHoodPennyStocks,OGI,6,6,0,6,1,1,0,1,NASDAQ
4630,12-02-2021 18:00,24 hrs.,RobinHoodPennyStocks,PTE,12,0,12,-12,2,2,0,1,NASDAQ
4630,12-02-2021 18:00,24 hrs.,RobinHoodPennyStocks,QTT,109,0,109,-109,1,40,25,1,NASDAQ
4630,12-02-2021 18:00,24 hrs.,RobinHoodPennyStocks,SND,12,12,0,12,2,2,0,1,NASDAQ
4630,12-02-2021 18:00,24 hrs.,RobinHoodPennyStocks,SPI,109,0,109,-109,1,40,25,1,NASDAQ
4630,12-02-2021 18:00,24 hrs.,RobinHoodPennyStocks,WNW,109,0,109,-109,1,40,25,1,NASDAQ
4630,12-02-2021 18:00,24 hrs.,RobinHoodPennyStocks,WWR,109,0,109,-109,1,40,25,1,NASDAQ
4630,12-02-2021 18:00,24 hrs.,RobinHoodPennyStocks,AAOI,109,0,109,-109,1,40,25,1,NASDAQ
4630,12-02-2021 18:00,24 hrs.,RobinHoodPennyStocks,ABEO,42,42,0,42,2,10,14,2,NASDAQ
4630,12-02-2021 18:00,24 hrs.,RobinHoodPennyStocks,ABIO,26,0,26,-26,1,3,16,1,NASDAQ
4630,12-02-2021 18:00,24 hrs.,RobinHoodPennyStocks,ACOR,109,0,109,-109,1,40,25,1,NASDAQ
4630,12-02-2021 18:00,24 hrs.,RobinHoodPennyStocks,ACRX,12,12,0,12,1,3,2,1,NASDAQ
4630,12-02-2021 18:00,24 hrs.,RobinHoodPennyStocks,ACST,6,6,0,6,1,1,0,1,NASDAQ
4630,12-02-2021 18:00,24 hrs.,RobinHoodPennyStocks,ADMA,45,0,45,-45,1,16,9,1,NASDAQ
4630,12-02-2021 18:00,24 hrs.,RobinHoodPennyStocks,ADMP,18,18,0,18,1,4,6,1,NASDAQ
4630,12-02-2021 18:00,24 hrs.,RobinHoodPennyStocks,ADXS,18,18,0,18,3,3,0,2,NASDAQ
4630,12-02-2021 18:00,24 hrs.,RobinHoodPennyStocks,AEHR,109,0,109,-109,1,40,25,1,NASDAQ
4630,12-02-2021 18:00,24 hrs.,RobinHoodPennyStocks,AESE,6,0,6,-6,1,1,0,1,NASDAQ
4630,12-02-2021 18:00,24 hrs.,RobinHoodPennyStocks,AEZS,17,0,17,-17,1,2,9,1,NASDAQ
4630,12-02-2021 18:00,24 hrs.,RobinHoodPennyStocks,AGTC,2035,784,1251,-467,26,741,449,26,NASDAQ
4630,12-02-2021 18:00,24 hrs.,RobinHoodPennyStocks,AIHS,109,0,109,-109,1,40,25,1,NASDAQ
4630,12-02-2021 18:00,24 hrs.,RobinHoodPennyStocks,ALAC,109,0,109,-109,1,40,25,1,NASDAQ
4630,12-02-2021 18:00,24 hrs.,RobinHoodPennyStocks,AMTX,109,0,109,-109,1,40,25,1,NASDAQ
4630,12-02-2021 18:00,24 hrs.,RobinHoodPennyStocks,APHA,18,12,6,6,3,3,0,2,NASDAQ
4630,12-02-2021 18:00,24 hrs.,RobinHoodPennyStocks,ARPO,6,6,0,6,1,1,0,1,NASDAQ
4630,12-02-2021 18:00,24 hrs.,RobinHoodPennyStocks,ARTL,12,12,0,12,2,2,0,2,NASDAQ
4630,12-02-2021 18:00,24 hrs.,RobinHoodPennyStocks,ASRT,58,12,46,-34,4,12,18,3,NASDAQ
4630,12-02-2021 18:00,24 hrs.,RobinHoodPennyStocks,ASYS,109,0,109,-109,1,40,25,1,NASDAQ
4630,12-02-2021 18:00,24 hrs.,RobinHoodPennyStocks,ATIF,109,0,109,-109,1,40,25,1,NASDAQ
4630,12-02-2021 18:00,24 hrs.,RobinHoodPennyStocks,ATNI,109,0,109,-109,1,40,25,1,NASDAQ
4630,12-02-2021 18:00,24 hrs.,RobinHoodPennyStocks,ATOS,555,504,51,453,16,194,103,16,NASDAQ
4630,12-02-2021 18:00,24 hrs.,RobinHoodPennyStocks,AVCO,109,0,109,-109,1,40,25,1,NASDAQ
4630,12-02-2021 18:00,24 hrs.,RobinHoodPennyStocks,BBIG,6,0,6,-6,1,1,0,1,NASDAQ
4630,12-02-2021 18:00,24 hrs.,RobinHoodPennyStocks,BCLI,6,0,6,-6,1,1,0,1,NASDAQ
4630,12-02-2021 18:00,24 hrs.,RobinHoodPennyStocks,BCRX,42,0,42,-42,1,8,22,1,NASDAQ
4630,12-02-2021 18:00,24 hrs.,RobinHoodPennyStocks,BFRA,109,0,109,-109,1,40,25,1,NASDAQ
4630,12-02-2021 18:00,24 hrs.,RobinHoodPennyStocks,BHAT,109,0,109,-109,1,40,25,1,NASDAQ
4630,12-02-2021 18:00,24 hrs.,RobinHoodPennyStocks,BNGO,6,6,0,6,1,1,0,1,NASDAQ
4630,12-02-2021 18:00,24 hrs.,RobinHoodPennyStocks,BRQS,137,28,109,-81,3,45,35,3,NASDAQ
4630,12-02-2021 18:00,24 hrs.,RobinHoodPennyStocks,BYFC,109,0,109,-109,1,40,25,1,NASDAQ
4630,12-02-2021 18:00,24 hrs.,RobinHoodPennyStocks,CAAS,109,0,109,-109,1,40,25,1,NASDAQ
4630,12-02-2021 18:00,24 hrs.,RobinHoodPennyStocks,CARV,109,0,109,-109,1,40,25,1,NASDAQ
4630,12-02-2021 18:00,24 hrs.,RobinHoodPennyStocks,CBAT,109,0,109,-109,1,40,25,1,NASDAQ
4630,12-02-2021 18:00,24 hrs.,RobinHoodPennyStocks,CCNC,109,0,109,-109,1,40,25,1,NASDAQ
4630,12-02-2021 18:00,24 hrs.,RobinHoodPennyStocks,CHNR,109,0,109,-109,1,40,25,1,NASDAQ
4630,12-02-2021 18:00,24 hrs.,RobinHoodPennyStocks,CIDM,6,0,6,-6,1,1,0,1,NASDAQ
4630,12-02-2021 18:00,24 hrs.,RobinHoodPennyStocks,CKPT,309,31,278,-247,2,67,167,2,NASDAQ
4630,12-02-2021 18:00,24 hrs.,RobinHoodPennyStocks,CLEU,109,0,109,-109,1,40,25,1,NASDAQ
4630,12-02-2021 18:00,24 hrs.,RobinHoodPennyStocks,CLSK,109,0,109,-109,1,40,25,1,NASDAQ
4630,12-02-2021 18:00,24 hrs.,RobinHoodPennyStocks,CMLF,109,0,109,-109,1,40,25,1,NASDAQ
4630,12-02-2021 18:00,24 hrs.,RobinHoodPennyStocks,CSCW,109,0,109,-109,1,40,25,1,NASDAQ
4630,12-02-2021 18:00,24 hrs.,RobinHoodPennyStocks,CTRM,1029,300,729,-429,19,302,349,18,NASDAQ
4630,12-02-2021 18:00,24 hrs.,pennystocks,TBEV,6,0,6,-6,1,1,0,1,OTC
4630,12-02-2021 18:00,24 hrs.,pennystocks,TCHH,7,7,0,7,1,1,1,1,OTC
4630,12-02-2021 18:00,24 hrs.,pennystocks,TFZI,6,0,6,-6,1,1,0,1,OTC
4630,12-02-2021 18:00,24 hrs.,pennystocks,TGHI,11,11,0,11,1,2,3,1,OTC
4630,12-02-2021 18:00,24 hrs.,pennystocks,TLSS,293,69,224,-155,5,75,123,5,OTC
4630,12-02-2021 18:00,24 hrs.,pennystocks,TPAC,6,0,6,-6,1,1,0,1,OTC
4630,12-02-2021 18:00,24 hrs.,pennystocks,TSCRF,72,43,29,14,3,19,22,3,OTC
4630,12-02-2021 18:00,24 hrs.,pennystocks,TSKFF,44,0,44,-44,1,15,10,1,OTC
4630,12-02-2021 18:00,24 hrs.,pennystocks,TTTSF,12,0,12,-12,2,2,0,2,OTC
4630,12-02-2021 18:00,24 hrs.,pennystocks,VRNDF,16,16,0,16,1,4,4,1,OTC
4630,12-02-2021 18:00,24 hrs.,pennystocks,XELAW,159,159,0,159,1,71,13,1,OTC
4630,12-02-2021 18:00,24 hrs.,pennystocks,ZBISF,33,33,0,33,1,11,7,1,OTC
4630,12-02-2021 18:00,24 hrs.,pennystocks,AIM,8,8,0,8,1,1,2,1,AMEX
4630,12-02-2021 18:00,24 hrs.,pennystocks,APT,12,0,12,-12,2,2,0,1,AMEX
4630,12-02-2021 18:00,24 hrs.,pennystocks,CTO,38,20,18,2,4,3,16,2,AMEX
4630,12-02-2021 18:00,24 hrs.,pennystocks,DNN,415,25,390,-365,10,127,121,7,AMEX
4630,12-02-2021 18:00,24 hrs.,pennystocks,DPW,6,0,6,-6,1,1,0,1,AMEX
4630,12-02-2021 18:00,24 hrs.,pennystocks,DSS,11,0,11,-11,1,0,7,1,AMEX
4630,12-02-2021 18:00,24 hrs.,pennystocks,GPL,35,0,35,-35,1,13,5,1,AMEX
4630,12-02-2021 18:00,24 hrs.,pennystocks,GSV,18,0,18,-18,3,3,0,2,AMEX
4630,12-02-2021 18:00,24 hrs.,pennystocks,GTE,14,0,14,-14,2,2,2,2,AMEX
4630,12-02-2021 18:00,24 hrs.,pennystocks,ITP,33,12,21,-9,2,4,17,2,AMEX
4630,12-02-2021 18:00,24 hrs.,pennystocks,LNG,15,0,15,-15,1,5,1,1,AMEX
4630,12-02-2021 18:00,24 hrs.,pennystocks,MXC,7,7,0,7,1,1,1,1,AMEX
4630,12-02-2021 18:00,24 hrs.,pennystocks,NAK,39,27,12,15,3,8,11,3,AMEX
4630,12-02-2021 18:00,24 hrs.,pennystocks,NHS,17,0,17,-17,1,0,13,1,AMEX
4630,12-02-2021 18:00,24 hrs.,pennystocks,PTN,22,22,0,22,1,6,6,1,AMEX
4630,12-02-2021 18:00,24 hrs.,pennystocks,SIM,6,0,6,-6,1,1,0,1,AMEX
4630,12-02-2021 18:00,24 hrs.,pennystocks,TGB,18,18,0,18,1,5,4,1,AMEX
4630,12-02-2021 18:00,24 hrs.,pennystocks,TGC,52,0,52,-52,1,22,4,1,AMEX
4630,12-02-2021 18:00,24 hrs.,pennystocks,TRX,28,15,13,2,4,4,4,4,AMEX
4630,12-02-2021 18:00,24 hrs.,pennystocks,WRN,6,0,6,-6,1,1,0,1,AMEX
4630,12-02-2021 18:00,24 hrs.,pennystocks,ZOM,175,13,162,-149,6,59,33,6,AMEX
4630,12-02-2021 18:00,24 hrs.,pennystocks,INUV,63,63,0,63,1,22,15,1,AMEX
4630,12-02-2021 18:00,24 hrs.,pennystocks,SDPI,6,6,0,6,1,1,0,1,AMEX
4630,12-02-2021 18:00,24 hrs.,pennystocks,SENS,66,25,41,-16,3,23,8,3,AMEX
4630,12-02-2021 18:00,24 hrs.,pennystocks,TMBR,52,0,52,-52,1,22,4,1,AMEX
4630,12-02-2021 18:00,24 hrs.,pennystocks,TRXC,12,12,0,12,2,2,0,2,AMEX
4630,12-02-2021 18:00,24 hrs.,pennystocks,UAVS,74,74,0,74,1,27,16,1,AMEX
4630,12-02-2021 18:00,24 hrs.,pennystocks,XXII,6,6,0,6,1,0,2,1,AMEX
4630,12-02-2021 18:00,24 hrs.,pennystocks,HNLMF,215,0,215,-215,1,90,31,1,OTC
4630,12-02-2021 18:00,24 hrs.,pennystocks,IDXAF,6,6,0,6,1,1,0,1,OTC
4630,12-02-2021 18:00,24 hrs.,pennystocks,ISCNF,12,0,12,-12,2,2,0,1,OTC
4630,12-02-2021 18:00,24 hrs.,pennystocks,LIBFF,215,0,215,-215,1,90,31,1,OTC
4630,12-02-2021 18:00,24 hrs.,pennystocks,LKYSF,215,0,215,-215,1,90,31,1,OTC
4630,12-02-2021 18:00,24 hrs.,pennystocks,LLKKF,6,0,6,-6,1,1,0,1,OTC
4630,12-02-2021 18:00,24 hrs.,pennystocks,LTMCF,50,0,50,-50,3,7,24,2,OTC
4630,12-02-2021 18:00,24 hrs.,pennystocks,LXXGF,64,64,0,64,1,13,34,1,OTC
4630,12-02-2021 18:00,24 hrs.,pennystocks,MCURF,215,0,215,-215,1,90,31,1,OTC
4630,12-02-2021 18:00,24 hrs.,pennystocks,MEDIF,6,6,0,6,1,1,0,1,OTC
4630,12-02-2021 18:00,24 hrs.,pennystocks,MMEDF,215,0,215,-215,1,90,31,1,OTC
4630,12-02-2021 18:00,24 hrs.,pennystocks,MMNFF,58,0,58,-58,2,23,4,2,OTC
4630,12-02-2021 18:00,24 hrs.,pennystocks,MNXXF,46,46,0,46,3,7,20,3,OTC
4630,12-02-2021 18:00,24 hrs.,pennystocks,MYCOF,215,0,215,-215,1,90,31,1,OTC
4630,12-02-2021 18:00,24 hrs.,RobinHoodPennyStocks,DFFN,367,339,28,311,9,122,87,8,NASDAQ
4630,12-02-2021 18:00,24 hrs.,RobinHoodPennyStocks,EAST,86,18,68,-50,4,24,22,4,NASDAQ
4630,12-02-2021 18:00,24 hrs.,RobinHoodPennyStocks,ENTX,50,50,0,50,1,20,6,1,NASDAQ
4630,12-02-2021 18:00,24 hrs.,RobinHoodPennyStocks,ENVB,6,0,6,-6,1,1,0,1,NASDAQ
4630,12-02-2021 18:00,24 hrs.,RobinHoodPennyStocks,EQOS,109,0,109,-109,1,40,25,1,NASDAQ
4630,12-02-2021 18:00,24 hrs.,RobinHoodPennyStocks,FCEL,154,45,109,-64,2,49,48,2,NASDAQ
4630,12-02-2021 18:00,24 hrs.,RobinHoodPennyStocks,GHSI,95,0,95,-95,1,39,13,1,NASDAQ
4630,12-02-2021 18:00,24 hrs.,RobinHoodPennyStocks,GLBS,6,6,0,6,1,1,0,1,NASDAQ
4630,12-02-2021 18:00,24 hrs.,RobinHoodPennyStocks,GLMD,278,0,278,-278,1,57,160,1,NASDAQ
4630,12-02-2021 18:00,24 hrs.,RobinHoodPennyStocks,GMDA,6,0,6,-6,1,1,0,1,NASDAQ
4630,12-02-2021 18:00,24 hrs.,RobinHoodPennyStocks,FUBO,115,0,115,-115,2,41,25,2,NYSE
4630,12-02-2021 18:00,24 hrs.,RobinHoodPennyStocks,LAIX,109,0,109,-109,1,40,25,1,NYSE
4630,12-02-2021 18:00,24 hrs.,RobinHoodPennyStocks,RLGY,109,0,109,-109,1,40,25,1,NYSE
4630,12-02-2021 18:00,24 hrs.,RobinHoodPennyStocks,XPEV,109,0,109,-109,1,40,25,1,NYSE
4630,12-02-2021 18:00,24 hrs.,RobinHoodPennyStocks,AIH,109,0,109,-109,1,40,25,1,NASDAQ
4630,12-02-2021 18:00,24 hrs.,RobinHoodPennyStocks,BBI,6,6,0,6,1,1,0,1,NASDAQ
4630,12-02-2021 18:00,24 hrs.,RobinHoodPennyStocks,METX,109,0,109,-109,1,40,25,1,NASDAQ
4630,12-02-2021 18:00,24 hrs.,RobinHoodPennyStocks,MMLP,6,6,0,6,1,1,0,1,NASDAQ
4630,12-02-2021 18:00,24 hrs.,RobinHoodPennyStocks,MOGO,109,0,109,-109,1,40,25,1,NASDAQ
4630,12-02-2021 18:00,24 hrs.,RobinHoodPennyStocks,MOMO,109,0,109,-109,1,40,25,1,NASDAQ
4630,12-02-2021 18:00,24 hrs.,RobinHoodPennyStocks,MOSY,109,0,109,-109,1,40,25,1,NASDAQ
4630,12-02-2021 18:00,24 hrs.,RobinHoodPennyStocks,MOXC,109,0,109,-109,1,40,25,1,NASDAQ
4630,12-02-2021 18:00,24 hrs.,RobinHoodPennyStocks,MVIS,109,0,109,-109,1,40,25,1,NASDAQ
4630,12-02-2021 18:00,24 hrs.,RobinHoodPennyStocks,NAKD,212,18,194,-176,6,54,80,6,NASDAQ
4630,12-02-2021 18:00,24 hrs.,RobinHoodPennyStocks,NCTY,109,0,109,-109,1,40,25,1,NASDAQ
4630,12-02-2021 18:00,24 hrs.,RobinHoodPennyStocks,NOVN,257,48,209,-161,7,83,63,5,NASDAQ
4630,12-02-2021 18:00,24 hrs.,RobinHoodPennyStocks,NVCN,52,0,52,-52,2,13,18,2,NASDAQ
4630,12-02-2021 18:00,24 hrs.,RobinHoodPennyStocks,NVIV,12,0,12,-12,1,2,4,1,NASDAQ
4630,12-02-2021 18:00,24 hrs.,RobinHoodPennyStocks,NXTD,109,0,109,-109,1,40,25,1,NASDAQ
4630,12-02-2021 18:00,24 hrs.,RobinHoodPennyStocks,OCGN,44,38,6,32,2,11,14,2,NASDAQ
4630,12-02-2021 18:00,24 hrs.,RobinHoodPennyStocks,ONTX,28,0,28,-28,2,8,4,2,NASDAQ
4630,12-02-2021 18:00,24 hrs.,RobinHoodPennyStocks,OPGN,30,24,6,18,5,5,0,2,NASDAQ
4630,12-02-2021 18:00,24 hrs.,RobinHoodPennyStocks,OPTT,115,6,109,-103,2,41,25,2,NASDAQ
4630,12-02-2021 18:00,24 hrs.,RobinHoodPennyStocks,OVID,6,6,0,6,1,1,0,1,NASDAQ
4630,12-02-2021 18:00,24 hrs.,RobinHoodPennyStocks,PECK,109,0,109,-109,1,40,25,1,NASDAQ
4630,12-02-2021 18:00,24 hrs.,RobinHoodPennyStocks,PEIX,109,0,109,-109,1,40,25,1,NASDAQ
4630,12-02-2021 18:00,24 hrs.,RobinHoodPennyStocks,PETZ,109,0,109,-109,1,40,25,1,NASDAQ
4630,12-02-2021 18:00,24 hrs.,RobinHoodPennyStocks,PHUN,109,0,109,-109,1,40,25,1,NASDAQ
4630,12-02-2021 18:00,24 hrs.,RobinHoodPennyStocks,PIXY,109,0,109,-109,1,40,25,1,NASDAQ
4630,12-02-2021 18:00,24 hrs.,RobinHoodPennyStocks,PLIN,109,0,109,-109,1,40,25,1,NASDAQ
4630,12-02-2021 18:00,24 hrs.,RobinHoodPennyStocks,PLUG,109,0,109,-109,1,40,25,1,NASDAQ
4630,12-02-2021 18:00,24 hrs.,RobinHoodPennyStocks,PSEC,51,51,0,51,3,11,17,2,NASDAQ
4630,12-02-2021 18:00,24 hrs.,RobinHoodPennyStocks,PSTV,144,144,0,144,1,58,24,1,NASDAQ
4630,12-02-2021 18:00,24 hrs.,RobinHoodPennyStocks,PXLW,6,0,6,-6,1,1,0,1,NASDAQ
4630,12-02-2021 18:00,24 hrs.,RobinHoodPennyStocks,QUIK,109,0,109,-109,1,40,25,1,NASDAQ
4630,12-02-2021 18:00,24 hrs.,RobinHoodPennyStocks,RAVE,109,0,109,-109,1,40,25,1,NASDAQ
4630,12-02-2021 18:00,24 hrs.,RobinHoodPennyStocks,RCMT,109,0,109,-109,1,40,25,1,NASDAQ
4630,12-02-2021 18:00,24 hrs.,RobinHoodPennyStocks,REAL,81,0,81,-81,1,28,21,1,NASDAQ
4630,12-02-2021 18:00,24 hrs.,RobinHoodPennyStocks,RIOT,116,7,109,-102,2,40,28,2,NASDAQ
4630,12-02-2021 18:00,24 hrs.,RobinHoodPennyStocks,SALM,109,0,109,-109,1,40,25,1,NASDAQ
4630,12-02-2021 18:00,24 hrs.,pennystocks,NMGRF,129,6,123,-117,4,39,35,4,OTC
4630,12-02-2021 18:00,24 hrs.,pennystocks,NMHLY,6,0,6,-6,1,1,0,1,OTC
4630,12-02-2021 18:00,24 hrs.,pennystocks,NRGOF,14,0,14,-14,2,2,2,1,OTC
4630,12-02-2021 18:00,24 hrs.,pennystocks,NTDOY,13,0,13,-13,2,2,1,2,OTC
4630,12-02-2021 18:00,24 hrs.,pennystocks,NTSFF,6,0,6,-6,1,1,0,1,OTC
4630,12-02-2021 18:00,24 hrs.,pennystocks,NXTTF,18,12,6,6,3,3,0,3,OTC
4630,12-02-2021 18:00,24 hrs.,pennystocks,OILFF,6,6,0,6,1,1,0,1,OTC
4630,12-02-2021 18:00,24 hrs.,pennystocks,PFWIQ,180,82,98,-16,2,55,62,2,OTC
4630,12-02-2021 18:00,24 hrs.,pennystocks,PLNHF,29,0,29,-29,1,7,11,1,OTC
4630,12-02-2021 18:00,24 hrs.,pennystocks,PYRNF,6,6,0,6,1,1,0,1,OTC
4630,12-02-2021 18:00,24 hrs.,pennystocks,QYOUF,6,6,0,6,1,1,0,1,OTC
4630,12-02-2021 18:00,24 hrs.,pennystocks,RACMF,13,0,13,-13,1,3,3,1,OTC
4630,12-02-2021 18:00,24 hrs.,pennystocks,RHDGF,8,8,0,8,1,1,2,1,OTC
4630,12-02-2021 18:00,24 hrs.,pennystocks,RLFTF,6,6,0,6,1,1,0,1,OTC
4630,12-02-2021 18:00,24 hrs.,pennystocks,RLLCF,70,63,7,56,9,12,10,8,OTC
4630,12-02-2021 18:00,24 hrs.,pennystocks,RVVTF,266,7,259,-252,3,96,62,3,OTC
4630,12-02-2021 18:00,24 hrs.,pennystocks,RYCEY,6,0,6,-6,1,1,0,1,OTC
4630,12-02-2021 18:00,24 hrs.,pennystocks,SBSAA,5,0,5,-5,1,0,1,1,OTC
4630,12-02-2021 18:00,24 hrs.,pennystocks,SHRMF,215,0,215,-215,1,90,31,1,OTC
4630,12-02-2021 18:00,24 hrs.,pennystocks,SNNAF,11,11,0,11,1,3,1,1,OTC
4630,12-02-2021 18:00,24 hrs.,pennystocks,SORHF,8,0,8,-8,1,1,2,1,OTC
4630,12-02-2021 18:00,24 hrs.,pennystocks,SPFYF,9,9,0,9,1,1,3,1,OTC
4630,12-02-2021 18:00,24 hrs.,pennystocks,SPLIF,18,0,18,-18,3,3,0,2,OTC
4630,12-02-2021 18:00,24 hrs.,pennystocks,SPMTF,20,20,0,20,1,3,10,1,OTC
4630,12-02-2021 18:00,24 hrs.,pennystocks,SPRWF,2149,153,1996,-1843,12,917,267,11,OTC
4630,12-02-2021 18:00,24 hrs.,pennystocks,TAKOF,367,0,367,-367,4,139,73,2,OTC
4630,12-02-2021 18:00,24 hrs.,pennystocks,TFECF,4,0,4,-4,1,0,0,1,OTC
4630,12-02-2021 18:00,24 hrs.,pennystocks,TFECY,4,0,4,-4,1,0,0,1,OTC
4630,12-02-2021 18:00,24 hrs.,pennystocks,TLOFF,73,0,73,-73,3,17,27,2,OTC
4630,12-02-2021 18:00,24 hrs.,pennystocks,TRUFF,215,0,215,-215,1,90,31,1,OTC
4630,12-02-2021 18:00,24 hrs.,pennystocks,BVXV,7,0,7,-7,1,1,1,1,NASDAQ
4630,12-02-2021 18:00,24 hrs.,pennystocks,CAPR,6,0,6,-6,1,1,0,1,NASDAQ
4630,12-02-2021 18:00,24 hrs.,pennystocks,CFMS,6,6,0,6,1,1,0,1,NASDAQ
4630,12-02-2021 18:00,24 hrs.,pennystocks,CIDM,71,64,7,57,2,14,35,2,NASDAQ
4630,12-02-2021 18:00,24 hrs.,pennystocks,CJJD,52,0,52,-52,1,22,4,1,NASDAQ
4630,12-02-2021 18:00,24 hrs.,pennystocks,CKPT,70,6,64,-58,4,25,4,3,NASDAQ
4630,12-02-2021 18:00,24 hrs.,pennystocks,CLBS,26,19,7,12,2,7,4,2,NASDAQ
4630,12-02-2021 18:00,24 hrs.,pennystocks,CLEU,7,7,0,7,1,1,1,1,NASDAQ
4630,12-02-2021 18:00,24 hrs.,pennystocks,CVE,31,18,13,5,4,6,3,2,NYSE
4630,12-02-2021 18:00,24 hrs.,pennystocks,CVX,31,31,0,31,1,10,7,1,NYSE
4630,12-02-2021 18:00,24 hrs.,pennystocks,ETH,6,6,0,6,1,1,0,1,NYSE
4630,12-02-2021 18:00,24 hrs.,pennystocks,FLT,13,0,13,-13,2,2,1,2,NYSE
4630,12-02-2021 18:00,24 hrs.,RobinHoodPennyStocks,SAVA,109,0,109,-109,1,40,25,1,NASDAQ
4630,12-02-2021 18:00,24 hrs.,RobinHoodPennyStocks,SEED,109,0,109,-109,1,40,25,1,NASDAQ
4630,12-02-2021 18:00,24 hrs.,RobinHoodPennyStocks,SGOC,109,0,109,-109,1,40,25,1,NASDAQ
4630,12-02-2021 18:00,24 hrs.,RobinHoodPennyStocks,SHIP,36,30,6,24,6,6,0,5,NASDAQ
4630,12-02-2021 18:00,24 hrs.,RobinHoodPennyStocks,SNDL,1373,915,458,457,43,416,369,36,NASDAQ
4630,12-02-2021 18:00,24 hrs.,RobinHoodPennyStocks,SNGX,185,179,6,173,4,70,29,3,NASDAQ
4630,12-02-2021 18:00,24 hrs.,RobinHoodPennyStocks,SONM,55,0,55,-55,1,21,9,1,NASDAQ
4630,12-02-2021 18:00,24 hrs.,RobinHoodPennyStocks,SRGA,6,6,0,6,1,1,0,1,NASDAQ
4630,12-02-2021 18:00,24 hrs.,RobinHoodPennyStocks,SUNW,109,0,109,-109,1,40,25,1,NASDAQ
4630,12-02-2021 18:00,24 hrs.,RobinHoodPennyStocks,SXTC,109,0,109,-109,1,40,25,1,NASDAQ
4630,12-02-2021 18:00,24 hrs.,RobinHoodPennyStocks,SYPR,109,0,109,-109,1,40,25,1,NASDAQ
4630,12-02-2021 18:00,24 hrs.,RobinHoodPennyStocks,TAIT,109,0,109,-109,1,40,25,1,NASDAQ
4630,12-02-2021 18:00,24 hrs.,RobinHoodPennyStocks,TANH,109,0,109,-109,1,40,25,1,NASDAQ
4630,12-02-2021 18:00,24 hrs.,RobinHoodPennyStocks,TAOP,109,0,109,-109,1,40,25,1,NASDAQ
4630,12-02-2021 18:00,24 hrs.,RobinHoodPennyStocks,TBLT,61,61,0,61,1,18,21,1,NASDAQ
4630,12-02-2021 18:00,24 hrs.,RobinHoodPennyStocks,TEDU,109,0,109,-109,1,40,25,1,NASDAQ
4630,12-02-2021 18:00,24 hrs.,RobinHoodPennyStocks,TIGR,109,0,109,-109,1,40,25,1,NASDAQ
4630,12-02-2021 18:00,24 hrs.,RobinHoodPennyStocks,TLRY,23,0,23,-23,2,6,3,2,NASDAQ
4630,12-02-2021 18:00,24 hrs.,RobinHoodPennyStocks,TNXP,304,54,250,-196,5,103,78,5,NASDAQ
4630,12-02-2021 18:00,24 hrs.,RobinHoodPennyStocks,TRCH,298,20,278,-258,5,97,84,5,NASDAQ
4630,12-02-2021 18:00,24 hrs.,RobinHoodPennyStocks,TTOO,61,36,25,11,2,21,11,2,NASDAQ
4630,12-02-2021 18:00,24 hrs.,RobinHoodPennyStocks,TXMD,442,18,424,-406,8,105,200,7,NASDAQ
4630,12-02-2021 18:00,24 hrs.,pennystocks,AHT,6,6,0,6,1,1,0,1,NYSE
4630,12-02-2021 18:00,24 hrs.,pennystocks,AMC,97,78,19,59,8,16,33,7,NYSE
4630,12-02-2021 18:00,24 hrs.,pennystocks,ASX,30,24,6,18,5,5,0,3,NYSE
4630,12-02-2021 18:00,24 hrs.,pennystocks,ATH,10,10,0,10,1,2,2,1,NYSE
4630,12-02-2021 18:00,24 hrs.,pennystocks,BIO,300,0,300,-300,1,125,46,1,NYSE
4630,12-02-2021 18:00,24 hrs.,pennystocks,BTU,6,6,0,6,1,1,0,1,NYSE
4630,12-02-2021 18:00,24 hrs.,pennystocks,CBD,286,16,270,-254,5,109,48,5,NYSE
4630,12-02-2021 18:00,24 hrs.,pennystocks,CHS,19,19,0,19,1,5,5,1,NYSE
4630,12-02-2021 18:00,24 hrs.,pennystocks,CMO,31,0,31,-31,1,8,11,1,NYSE
4630,12-02-2021 18:00,24 hrs.,pennystocks,CRL,6,0,6,-6,1,1,0,1,NYSE
4630,12-02-2021 18:00,24 hrs.,pennystocks,CTK,52,0,52,-52,1,22,4,1,NYSE
4630,12-02-2021 18:00,24 hrs.,RobinHoodPennyStocks,GRIL,109,0,109,-109,1,40,25,1,NASDAQ
4630,12-02-2021 18:00,24 hrs.,RobinHoodPennyStocks,HCDI,109,0,109,-109,1,40,25,1,NASDAQ
4630,12-02-2021 18:00,24 hrs.,RobinHoodPennyStocks,HGSH,109,0,109,-109,1,40,25,1,NASDAQ
4630,12-02-2021 18:00,24 hrs.,RobinHoodPennyStocks,IDEX,118,9,109,-100,2,42,26,2,NASDAQ
4630,12-02-2021 18:00,24 hrs.,RobinHoodPennyStocks,IFMK,109,0,109,-109,1,40,25,1,NASDAQ
4630,12-02-2021 18:00,24 hrs.,RobinHoodPennyStocks,IMTE,109,0,109,-109,1,40,25,1,NASDAQ
4630,12-02-2021 18:00,24 hrs.,RobinHoodPennyStocks,INPX,6,0,6,-6,1,1,0,1,NASDAQ
4630,12-02-2021 18:00,24 hrs.,RobinHoodPennyStocks,IZEA,109,0,109,-109,1,40,25,1,NASDAQ
4630,12-02-2021 18:00,24 hrs.,RobinHoodPennyStocks,JFIN,109,0,109,-109,1,40,25,1,NASDAQ
4630,12-02-2021 18:00,24 hrs.,RobinHoodPennyStocks,JRJC,109,0,109,-109,1,40,25,1,NASDAQ
4630,12-02-2021 18:00,24 hrs.,RobinHoodPennyStocks,KNDI,109,0,109,-109,1,40,25,1,NASDAQ
4630,12-02-2021 18:00,24 hrs.,RobinHoodPennyStocks,KTRA,53,47,6,41,2,19,7,2,NASDAQ
4630,12-02-2021 18:00,24 hrs.,RobinHoodPennyStocks,KXIN,109,0,109,-109,1,40,25,1,NASDAQ
4630,12-02-2021 18:00,24 hrs.,RobinHoodPennyStocks,LEDS,109,0,109,-109,1,40,25,1,NASDAQ
4630,12-02-2021 18:00,24 hrs.,RobinHoodPennyStocks,LKCO,68,50,18,32,8,16,4,7,NASDAQ
4630,12-02-2021 18:00,24 hrs.,RobinHoodPennyStocks,LLNW,45,0,45,-45,1,13,15,1,NASDAQ
4630,12-02-2021 18:00,24 hrs.,RobinHoodPennyStocks,LMFA,109,0,109,-109,1,40,25,1,NASDAQ
4630,12-02-2021 18:00,24 hrs.,RobinHoodPennyStocks,LXEH,109,0,109,-109,1,40,25,1,NASDAQ
4630,12-02-2021 18:00,24 hrs.,RobinHoodPennyStocks,MARA,109,0,109,-109,1,40,25,1,NASDAQ
4630,12-02-2021 18:00,24 hrs.,RobinHoodPennyStocks,WATT,109,0,109,-109,1,40,25,1,NASDAQ
4630,12-02-2021 18:00,24 hrs.,RobinHoodPennyStocks,WIMI,109,0,109,-109,1,40,25,1,NASDAQ
4630,12-02-2021 18:00,24 hrs.,RobinHoodPennyStocks,WKEY,109,0,109,-109,1,40,25,1,NASDAQ
4630,12-02-2021 18:00,24 hrs.,RobinHoodPennyStocks,WRAP,109,0,109,-109,1,40,25,1,NASDAQ
4630,12-02-2021 18:00,24 hrs.,RobinHoodPennyStocks,XSPA,15,15,0,15,1,5,1,1,NASDAQ
4630,12-02-2021 18:00,24 hrs.,RobinHoodPennyStocks,YGMZ,109,0,109,-109,1,40,25,1,NASDAQ
4630,12-02-2021 18:00,24 hrs.,RobinHoodPennyStocks,ZSAN,595,414,181,233,5,228,119,5,NASDAQ
4630,12-02-2021 18:00,24 hrs.,RobinHoodPennyStocks,UONEK,109,0,109,-109,1,40,25,1,NASDAQ
4630,12-02-2021 18:00,24 hrs.,pennystocks,GME,55,6,49,-43,9,9,1,8,NYSE
4630,12-02-2021 18:00,24 hrs.,pennystocks,LEE,117,0,117,-117,2,17,75,2,NYSE
4630,12-02-2021 18:00,24 hrs.,pennystocks,MDC,14,14,0,14,1,4,2,1,NYSE
4630,12-02-2021 18:00,24 hrs.,pennystocks,NAT,7,7,0,7,1,1,1,1,NYSE
4630,12-02-2021 18:00,24 hrs.,pennystocks,NOK,12,0,12,-12,2,2,0,1,NYSE
4630,12-02-2021 18:00,24 hrs.,pennystocks,PHI,6,0,6,-6,1,1,0,1,NYSE
4630,12-02-2021 18:00,24 hrs.,pennystocks,PSA,610,0,610,-610,3,276,46,3,NYSE
4630,12-02-2021 18:00,24 hrs.,pennystocks,RKT,63,63,0,63,1,19,21,1,NYSE
4630,12-02-2021 18:00,24 hrs.,pennystocks,RSI,35,0,35,-35,3,9,5,3,NYSE
4630,12-02-2021 18:00,24 hrs.,pennystocks,SAP,215,0,215,-215,1,90,31,1,NYSE
4630,12-02-2021 18:00,24 hrs.,pennystocks,SOS,12,6,6,0,2,1,2,2,NYSE
4630,12-02-2021 18:00,24 hrs.,pennystocks,TDA,26,0,26,-26,1,4,14,1,NYSE
4630,12-02-2021 18:00,24 hrs.,pennystocks,THC,302,0,302,-302,2,122,50,2,NYSE
4630,12-02-2021 18:00,24 hrs.,pennystocks,TKR,16,0,16,-16,1,4,4,1,NYSE
4630,12-02-2021 18:00,24 hrs.,pennystocks,TTI,12,0,12,-12,2,2,0,1,NYSE
4630,12-02-2021 18:00,24 hrs.,pennystocks,VET,9,0,9,-9,1,2,1,1,NYSE
4630,12-02-2021 18:00,24 hrs.,pennystocks,WEI,17,17,0,17,1,6,1,1,NYSE
4630,12-02-2021 18:00,24 hrs.,pennystocks,WLL,6,6,0,6,1,1,0,1,NYSE
4630,12-02-2021 18:00,24 hrs.,pennystocks,WWE,7,0,7,-7,1,1,1,1,NYSE
4630,12-02-2021 18:00,24 hrs.,pennystocks,AQUA,7,0,7,-7,1,1,1,1,NYSE
4630,12-02-2021 18:00,24 hrs.,pennystocks,ARGO,34,34,0,34,1,4,22,1,NYSE
4630,12-02-2021 18:00,24 hrs.,pennystocks,HEXO,22,22,0,22,1,2,14,1,NYSE
4630,12-02-2021 18:00,24 hrs.,pennystocks,HYLN,19,0,19,-19,3,3,1,2,NYSE
4630,12-02-2021 18:00,24 hrs.,pennystocks,NOVA,215,0,215,-215,1,90,31,1,NYSE
4630,12-02-2021 18:00,24 hrs.,pennystocks,VIST,12,12,0,12,1,2,4,1,NYSE
4630,12-02-2021 18:00,24 hrs.,pennystocks,AQB,6,0,6,-6,1,1,0,1,NASDAQ
4630,12-02-2021 18:00,24 hrs.,pennystocks,AZN,28,0,28,-28,1,5,14,1,NASDAQ
4630,12-02-2021 18:00,24 hrs.,pennystocks,BBI,47,0,47,-47,1,17,9,1,NASDAQ
4630,12-02-2021 18:00,24 hrs.,pennystocks,CFO,31,0,31,-31,1,8,11,1,NASDAQ
4630,12-02-2021 18:00,24 hrs.,pennystocks,FWP,8,8,0,8,1,0,4,1,NASDAQ
4630,12-02-2021 18:00,24 hrs.,pennystocks,KOD,6,6,0,6,1,1,0,1,NASDAQ
4630,12-02-2021 18:00,24 hrs.,pennystocks,MFH,52,0,52,-52,1,22,4,1,NASDAQ
4630,12-02-2021 18:00,24 hrs.,pennystocks,MKD,25,25,0,25,1,7,7,1,NASDAQ
4630,12-02-2021 18:00,24 hrs.,pennystocks,MYT,11,11,0,11,1,1,5,1,NASDAQ
4630,12-02-2021 18:00,24 hrs.,pennystocks,NEO,215,0,215,-215,1,90,31,1,NASDAQ
4630,12-02-2021 18:00,24 hrs.,pennystocks,OGI,14,7,7,0,2,2,2,2,NASDAQ
4630,12-02-2021 18:00,24 hrs.,pennystocks,UFO,6,6,0,6,1,1,0,1,NASDAQ
4630,12-02-2021 18:00,24 hrs.,pennystocks,ABEO,13,7,6,1,2,2,1,2,NASDAQ
4630,12-02-2021 18:00,24 hrs.,pennystocks,ABIO,22,0,22,-22,1,7,4,1,NASDAQ
4630,12-02-2021 18:00,24 hrs.,pennystocks,ACST,13,6,7,-1,2,2,1,2,NASDAQ
4630,12-02-2021 18:00,24 hrs.,pennystocks,ADTX,25,0,25,-25,1,4,13,1,NASDAQ
4630,12-02-2021 18:00,24 hrs.,pennystocks,AGTC,29,14,15,-1,3,4,9,3,NASDAQ
4630,12-02-2021 18:00,24 hrs.,pennystocks,AKBA,14,0,14,-14,2,3,0,1,NASDAQ
4630,12-02-2021 18:00,24 hrs.,pennystocks,ALRN,16,0,16,-16,1,1,10,1,NASDAQ
4630,12-02-2021 18:00,24 hrs.,pennystocks,ANDA,17,0,17,-17,1,0,13,1,NASDAQ
4630,12-02-2021 18:00,24 hrs.,pennystocks,APHA,15,15,0,15,2,3,1,2,NASDAQ
4630,12-02-2021 18:00,24 hrs.,pennystocks,ARTL,50,50,0,50,5,12,6,3,NASDAQ
4630,12-02-2021 18:00,24 hrs.,pennystocks,ASRT,1267,1261,6,1255,14,482,247,8,NASDAQ
4630,12-02-2021 18:00,24 hrs.,pennystocks,ATOS,222,64,158,-94,4,79,48,4,NASDAQ
4630,12-02-2021 18:00,24 hrs.,pennystocks,AVXL,7,0,7,-7,1,1,1,1,NASDAQ
4630,12-02-2021 18:00,24 hrs.,pennystocks,AZRX,9,0,9,-9,1,1,3,1,NASDAQ
4630,12-02-2021 18:00,24 hrs.,pennystocks,BBIG,6,0,6,-6,1,1,0,1,NASDAQ
4630,12-02-2021 18:00,24 hrs.,pennystocks,BHTG,7,0,7,-7,1,1,1,1,NASDAQ
4630,12-02-2021 18:00,24 hrs.,pennystocks,BKEP,12,0,12,-12,1,2,4,1,NASDAQ
4630,12-02-2021 18:00,24 hrs.,pennystocks,BLCM,52,0,52,-52,1,22,4,1,NASDAQ
4630,12-02-2021 18:00,24 hrs.,pennystocks,BNGO,35,35,0,35,3,10,3,3,NASDAQ
4630,12-02-2021 18:00,24 hrs.,pennystocks,GRNQ,52,0,52,-52,1,22,4,1,NASDAQ
4630,12-02-2021 18:00,24 hrs.,pennystocks,HALO,6,0,6,-6,1,1,0,1,NASDAQ
4630,12-02-2021 18:00,24 hrs.,pennystocks,HRTX,14,14,0,14,1,2,6,1,NASDAQ
4630,12-02-2021 18:00,24 hrs.,pennystocks,HSTO,12,12,0,12,2,2,0,2,NASDAQ
4630,12-02-2021 18:00,24 hrs.,pennystocks,IFMK,97,0,97,-97,2,37,15,2,NASDAQ
4630,12-02-2021 18:00,24 hrs.,pennystocks,INFI,62,10,52,-42,2,23,8,2,NASDAQ
4630,12-02-2021 18:00,24 hrs.,pennystocks,INFO,6,0,6,-6,1,0,2,1,NASDAQ
4630,12-02-2021 18:00,24 hrs.,pennystocks,INPX,78,0,78,-78,5,26,6,5,NASDAQ
4630,12-02-2021 18:00,24 hrs.,pennystocks,IRDM,17,17,0,17,1,6,1,1,NASDAQ
4630,12-02-2021 18:00,24 hrs.,pennystocks,JAGX,6,0,6,-6,1,1,0,1,NASDAQ
4630,12-02-2021 18:00,24 hrs.,pennystocks,KTRA,111,111,0,111,3,37,25,3,NASDAQ
4630,12-02-2021 18:00,24 hrs.,pennystocks,KXIN,17,17,0,17,1,6,1,1,NASDAQ
4630,12-02-2021 18:00,24 hrs.,pennystocks,LKCO,80,9,71,-62,5,27,6,4,NASDAQ
4630,12-02-2021 18:00,24 hrs.,pennystocks,LPCN,46,46,0,46,1,15,12,1,NASDAQ
4630,12-02-2021 18:00,24 hrs.,pennystocks,LPTH,49,49,0,49,1,18,9,1,NASDAQ
4630,12-02-2021 18:00,24 hrs.,pennystocks,MARK,94,0,94,-94,1,18,54,1,NASDAQ
4630,12-02-2021 18:00,24 hrs.,pennystocks,MDGS,6,6,0,6,1,1,0,1,NASDAQ
4630,12-02-2021 18:00,24 hrs.,pennystocks,MOGO,28,0,28,-28,3,2,12,1,NASDAQ
4630,12-02-2021 18:00,24 hrs.,pennystocks,MOSY,52,0,52,-52,1,22,4,1,NASDAQ
4630,12-02-2021 18:00,24 hrs.,pennystocks,MOTS,7,0,7,-7,1,1,1,1,NASDAQ
4630,12-02-2021 18:00,24 hrs.,pennystocks,MTRX,13,0,13,-13,1,3,3,1,NASDAQ
4630,12-02-2021 18:00,24 hrs.,pennystocks,MVIS,58,0,58,-58,2,23,4,2,NASDAQ
4630,12-02-2021 18:00,24 hrs.,pennystocks,NAKD,40,34,6,28,3,8,12,3,NASDAQ
4630,12-02-2021 18:00,24 hrs.,pennystocks,NAOV,6,6,0,6,1,1,0,1,NASDAQ
4630,12-02-2021 18:00,24 hrs.,pennystocks,NCMI,15,15,0,15,1,4,3,1,NASDAQ
4630,12-02-2021 18:00,24 hrs.,pennystocks,NDAQ,17,17,0,17,1,6,1,1,NASDAQ
4630,12-02-2021 18:00,24 hrs.,pennystocks,NOVN,36,6,30,-24,3,8,8,3,NASDAQ
4630,12-02-2021 18:00,24 hrs.,pennystocks,NTEC,52,0,52,-52,1,22,4,1,NASDAQ
4630,12-02-2021 18:00,24 hrs.,pennystocks,NVCN,40,33,7,26,2,10,12,2,NASDAQ
4630,12-02-2021 18:00,24 hrs.,pennystocks,NXTD,60,0,60,-60,2,23,6,2,NASDAQ
4630,12-02-2021 18:00,24 hrs.,pennystocks,OCGN,34,34,0,34,2,7,12,2,NASDAQ
4630,12-02-2021 18:00,24 hrs.,pennystocks,ONTX,12,6,6,0,2,2,0,2,NASDAQ
4630,12-02-2021 18:00,24 hrs.,pennystocks,OPTT,18,18,0,18,1,5,4,1,NASDAQ
4630,12-02-2021 18:00,24 hrs.,pennystocks,PHIO,52,0,52,-52,1,22,4,1,NASDAQ
4630,12-02-2021 18:00,24 hrs.,pennystocks,PHUN,13,0,13,-13,2,2,1,2,NASDAQ
4630,12-02-2021 18:00,24 hrs.,pennystocks,PLUG,111,17,94,-77,2,24,55,2,NASDAQ
4630,12-02-2021 18:00,24 hrs.,pennystocks,PPBT,10,0,10,-10,1,2,2,1,NASDAQ
4630,12-02-2021 18:00,24 hrs.,pennystocks,PSTV,72,6,66,-60,2,26,12,2,NASDAQ
4630,12-02-2021 18:00,24 hrs.,pennystocks,PULM,122,70,52,18,3,36,38,3,NASDAQ
4630,12-02-2021 18:00,24 hrs.,pennystocks,RAVE,45,0,45,-45,1,15,11,1,NASDAQ
4630,12-02-2021 18:00,24 hrs.,pennystocks,CMPS,221,0,221,-221,2,91,31,2,NASDAQ
4630,12-02-2021 18:00,24 hrs.,pennystocks,COCP,22,22,0,22,1,8,2,1,NASDAQ
4630,12-02-2021 18:00,24 hrs.,pennystocks,CPLP,20,20,0,20,2,1,10,1,NASDAQ
4630,12-02-2021 18:00,24 hrs.,pennystocks,CRBP,119,0,119,-119,1,48,19,1,NASDAQ
4630,12-02-2021 18:00,24 hrs.,pennystocks,CRWS,6,6,0,6,1,1,0,1,NASDAQ
4630,12-02-2021 18:00,24 hrs.,pennystocks,CSTR,6,6,0,6,1,1,0,1,NASDAQ
4630,12-02-2021 18:00,24 hrs.,pennystocks,CTHR,16,16,0,16,1,4,4,1,NASDAQ
4630,12-02-2021 18:00,24 hrs.,pennystocks,CTRM,186,50,136,-86,16,45,32,13,NASDAQ
4630,12-02-2021 18:00,24 hrs.,pennystocks,CTXR,6,0,6,-6,1,1,0,1,NASDAQ
4630,12-02-2021 18:00,24 hrs.,pennystocks,DFFN,112,93,19,74,4,39,18,4,NASDAQ
4630,12-02-2021 18:00,24 hrs.,pennystocks,DGLY,35,0,35,-35,5,5,5,1,NASDAQ
4630,12-02-2021 18:00,24 hrs.,pennystocks,DYNT,52,0,52,-52,1,22,4,1,NASDAQ
4630,12-02-2021 18:00,24 hrs.,pennystocks,EBON,12,6,6,0,2,2,0,2,NASDAQ
4630,12-02-2021 18:00,24 hrs.,pennystocks,EDIT,143,0,143,-143,2,54,27,2,NASDAQ
4630,12-02-2021 18:00,24 hrs.,pennystocks,ENPH,94,0,94,-94,1,18,54,1,NASDAQ
4630,12-02-2021 18:00,24 hrs.,pennystocks,ENTX,26,26,0,26,1,9,4,1,NASDAQ
4630,12-02-2021 18:00,24 hrs.,pennystocks,ENVB,6,6,0,6,1,1,0,1,NASDAQ
4630,12-02-2021 18:00,24 hrs.,pennystocks,EVFM,6,0,6,-6,1,1,0,1,NASDAQ
4630,12-02-2021 18:00,24 hrs.,pennystocks,FAMI,13,13,0,13,2,2,1,2,NASDAQ
4630,12-02-2021 18:00,24 hrs.,RobinHoodPennyStocks,TYME,24,0,24,-24,1,3,14,1,NASDAQ
4630,12-02-2021 18:00,24 hrs.,RobinHoodPennyStocks,UONE,109,0,109,-109,1,40,25,1,NASDAQ
4630,12-02-2021 18:00,24 hrs.,RobinHoodPennyStocks,USEG,109,0,109,-109,1,40,25,1,NASDAQ
4630,12-02-2021 18:00,24 hrs.,RobinHoodPennyStocks,USWS,6,0,6,-6,1,1,0,1,NASDAQ
4630,12-02-2021 18:00,24 hrs.,RobinHoodPennyStocks,UXIN,109,0,109,-109,1,40,25,1,NASDAQ
4630,12-02-2021 18:00,24 hrs.,wallstreetbets,BFCH,13,0,13,-13,2,2,1,2,OTC
4630,12-02-2021 18:00,24 hrs.,wallstreetbets,BIEL,43,19,24,-5,7,7,1,6,OTC
4630,12-02-2021 18:00,24 hrs.,wallstreetbets,BIGG,6,0,6,-6,1,1,0,1,OTC
4630,12-02-2021 18:00,24 hrs.,wallstreetbets,BLPG,7,0,7,-7,1,1,1,1,OTC
4630,12-02-2021 18:00,24 hrs.,wallstreetbets,BMIX,11,11,0,11,1,1,5,1,OTC
4630,12-02-2021 18:00,24 hrs.,wallstreetbets,BOTY,43,6,37,-31,7,7,1,6,OTC
4630,12-02-2021 18:00,24 hrs.,wallstreetbets,BRLL,12,0,12,-12,2,2,0,2,OTC
4630,12-02-2021 18:00,24 hrs.,wallstreetbets,BTCS,21,21,0,21,3,3,3,1,OTC
4630,12-02-2021 18:00,24 hrs.,wallstreetbets,BTSC,7,7,0,7,1,1,1,1,OTC
4630,12-02-2021 18:00,24 hrs.,wallstreetbets,BTZI,13,13,0,13,2,2,1,2,OTC
4630,12-02-2021 18:00,24 hrs.,wallstreetbets,BUDZ,12,6,6,0,2,2,0,2,OTC
4630,12-02-2021 18:00,24 hrs.,wallstreetbets,CALI,6,0,6,-6,1,1,0,1,OTC
4630,12-02-2021 18:00,24 hrs.,wallstreetbets,CATV,6,0,6,-6,1,1,0,1,OTC
4630,12-02-2021 18:00,24 hrs.,wallstreetbets,CBDD,7,7,0,7,1,1,1,1,OTC
4630,12-02-2021 18:00,24 hrs.,wallstreetbets,CBDL,46,21,25,-4,7,7,4,5,OTC
4630,12-02-2021 18:00,24 hrs.,wallstreetbets,CBTC,6,0,6,-6,1,1,0,1,OTC
4630,12-02-2021 18:00,24 hrs.,wallstreetbets,CCTC,7,7,0,7,1,1,1,1,OTC
4630,12-02-2021 18:00,24 hrs.,wallstreetbets,CCTL,12,0,12,-12,2,2,0,2,OTC
4630,12-02-2021 18:00,24 hrs.,pennystocks,REAL,124,0,124,-124,3,25,62,3,NASDAQ
4630,12-02-2021 18:00,24 hrs.,pennystocks,RIGL,12,0,12,-12,2,2,0,2,NASDAQ
4630,12-02-2021 18:00,24 hrs.,pennystocks,RMTI,6,0,6,-6,1,1,0,1,NASDAQ
4630,12-02-2021 18:00,24 hrs.,pennystocks,SEAC,12,12,0,12,1,2,4,1,NASDAQ
4630,12-02-2021 18:00,24 hrs.,pennystocks,SEEL,215,0,215,-215,1,90,31,1,NASDAQ
4630,12-02-2021 18:00,24 hrs.,pennystocks,SFET,6,6,0,6,1,1,0,1,NASDAQ
4630,12-02-2021 18:00,24 hrs.,pennystocks,SHIP,20,20,0,20,3,3,2,2,NASDAQ
4630,12-02-2021 18:00,24 hrs.,pennystocks,SNCA,6,0,6,-6,1,1,0,1,NASDAQ
4630,12-02-2021 18:00,24 hrs.,pennystocks,SNDL,230,93,137,-44,29,50,14,25,NASDAQ
4630,12-02-2021 18:00,24 hrs.,pennystocks,SNGX,1082,963,119,844,7,418,218,6,NASDAQ
4630,12-02-2021 18:00,24 hrs.,pennystocks,SOLO,17,17,0,17,1,6,1,1,NASDAQ
4630,12-02-2021 18:00,24 hrs.,pennystocks,SRGA,6,6,0,6,1,1,0,1,NASDAQ
4630,12-02-2021 18:00,24 hrs.,pennystocks,SXTC,13,0,13,-13,2,2,1,1,NASDAQ
4630,12-02-2021 18:00,24 hrs.,pennystocks,TBLT,6,6,0,6,1,1,0,1,NASDAQ
4630,12-02-2021 18:00,24 hrs.,pennystocks,TLRY,81,14,67,-53,4,29,7,4,NASDAQ
4630,12-02-2021 18:00,24 hrs.,pennystocks,TMDI,6,6,0,6,1,1,0,1,NASDAQ
4630,12-02-2021 18:00,24 hrs.,pennystocks,TNXP,800,40,760,-720,14,312,120,11,NASDAQ
4630,12-02-2021 18:00,24 hrs.,pennystocks,TRCH,24,0,24,-24,4,4,0,2,NASDAQ
4630,12-02-2021 18:00,24 hrs.,pennystocks,TRIP,215,0,215,-215,1,90,31,1,NASDAQ
4630,12-02-2021 18:00,24 hrs.,pennystocks,TRVG,12,12,0,12,2,2,0,1,NASDAQ
4630,12-02-2021 18:00,24 hrs.,pennystocks,TSLA,6,6,0,6,1,1,0,1,NASDAQ
4630,12-02-2021 18:00,24 hrs.,pennystocks,TTWO,6,0,6,-6,1,1,0,1,NASDAQ
4630,12-02-2021 18:00,24 hrs.,pennystocks,TXMD,7,7,0,7,1,1,1,1,NASDAQ
4630,12-02-2021 18:00,24 hrs.,pennystocks,USWS,12,0,12,-12,2,2,0,2,NASDAQ
4630,12-02-2021 18:00,24 hrs.,pennystocks,VEON,7,7,0,7,1,1,1,1,NASDAQ
4630,12-02-2021 18:00,24 hrs.,pennystocks,VRME,23,0,23,-23,1,7,5,1,NASDAQ
4630,12-02-2021 18:00,24 hrs.,pennystocks,WTER,26,0,26,-26,1,3,16,1,NASDAQ
4630,12-02-2021 18:00,24 hrs.,pennystocks,WTRH,79,0,79,-79,2,26,19,2,NASDAQ
4630,12-02-2021 18:00,24 hrs.,pennystocks,XELA,159,159,0,159,1,71,13,1,NASDAQ
4630,12-02-2021 18:00,24 hrs.,pennystocks,XSPA,30,30,0,30,1,11,4,1,NASDAQ
4630,12-02-2021 18:00,24 hrs.,pennystocks,ZSAN,206,69,137,-68,7,61,56,7,NASDAQ
4630,12-02-2021 18:00,24 hrs.,pennystocks,ZYNE,52,0,52,-52,1,22,4,1,NASDAQ
4630,12-02-2021 18:00,24 hrs.,pennystocks,SGAMW,45,0,45,-45,1,16,9,1,NASDAQ
4630,12-02-2021 18:00,24 hrs.,wallstreetbets,ABML,27,20,7,13,4,4,3,4,OTC
4630,12-02-2021 18:00,24 hrs.,wallstreetbets,ABQQ,7,7,0,7,1,1,1,1,OTC
4630,12-02-2021 18:00,24 hrs.,wallstreetbets,ABWN,6,0,6,-6,1,1,0,1,OTC
4630,12-02-2021 18:00,24 hrs.,pennystocks,FATE,17,17,0,17,1,6,1,1,NASDAQ
4630,12-02-2021 18:00,24 hrs.,pennystocks,FCEL,94,0,94,-94,1,18,54,1,NASDAQ
4630,12-02-2021 18:00,24 hrs.,pennystocks,GAIN,7,7,0,7,1,1,1,1,NASDAQ
4630,12-02-2021 18:00,24 hrs.,pennystocks,GALT,7,7,0,7,1,1,1,1,NASDAQ
4630,12-02-2021 18:00,24 hrs.,pennystocks,GEVO,63,0,63,-63,3,16,19,2,NASDAQ
4630,12-02-2021 18:00,24 hrs.,pennystocks,GHSI,142,28,114,-86,3,53,24,3,NASDAQ
4630,12-02-2021 18:00,24 hrs.,pennystocks,GLBS,18,0,18,-18,1,0,14,1,NASDAQ
4630,12-02-2021 18:00,24 hrs.,pennystocks,GOEV,70,70,0,70,2,20,22,2,NASDAQ
4630,12-02-2021 18:00,24 hrs.,pennystocks,GOLD,6,0,6,-6,1,1,0,1,NASDAQ
4630,12-02-2021 18:00,24 hrs.,pennystocks,GRIL,51,0,51,-51,2,16,11,2,NASDAQ
4630,12-02-2021 18:00,24 hrs.,wallstreetbets,CLWD,7,7,0,7,1,1,1,1,OTC
4630,12-02-2021 18:00,24 hrs.,wallstreetbets,CVSI,6,0,6,-6,1,1,0,1,OTC
4630,12-02-2021 18:00,24 hrs.,wallstreetbets,CYDY,14,7,7,0,2,2,2,2,OTC
4630,12-02-2021 18:00,24 hrs.,wallstreetbets,CYLC,7,7,0,7,1,1,1,1,OTC
4630,12-02-2021 18:00,24 hrs.,wallstreetbets,DGWR,7,7,0,7,1,1,1,1,OTC
4630,12-02-2021 18:00,24 hrs.,wallstreetbets,DIGI,14,14,0,14,2,2,2,1,OTC
4630,12-02-2021 18:00,24 hrs.,wallstreetbets,DPLS,13,13,0,13,2,2,1,2,OTC
4630,12-02-2021 18:00,24 hrs.,wallstreetbets,DPWW,7,7,0,7,1,1,1,1,OTC
4630,12-02-2021 18:00,24 hrs.,wallstreetbets,DROP,2582,0,2582,-2582,1,850,878,1,OTC
4630,12-02-2021 18:00,24 hrs.,wallstreetbets,DWOG,7,0,7,-7,1,1,1,1,OTC
4630,12-02-2021 18:00,24 hrs.,wallstreetbets,ECEZ,6,0,6,-6,1,1,0,1,OTC
4630,12-02-2021 18:00,24 hrs.,wallstreetbets,EFLN,6,0,6,-6,1,1,0,1,OTC
4630,12-02-2021 18:00,24 hrs.,wallstreetbets,ELCR,34,28,6,22,5,5,4,3,OTC
4630,12-02-2021 18:00,24 hrs.,wallstreetbets,ELTP,24,24,0,24,3,3,6,3,OTC
4630,12-02-2021 18:00,24 hrs.,wallstreetbets,ENZN,7,7,0,7,1,1,1,1,OTC
4630,12-02-2021 18:00,24 hrs.,wallstreetbets,ETFM,6,0,6,-6,1,1,0,1,OTC
4630,12-02-2021 18:00,24 hrs.,wallstreetbets,EWKS,6,6,0,6,1,1,0,1,OTC
4630,12-02-2021 18:00,24 hrs.,wallstreetbets,EWLL,6,0,6,-6,1,1,0,1,OTC
4630,12-02-2021 18:00,24 hrs.,wallstreetbets,FBSE,8,0,8,-8,1,1,2,1,OTC
4630,12-02-2021 18:00,24 hrs.,wallstreetbets,FORW,6,0,6,-6,1,1,0,1,OTC
4630,12-02-2021 18:00,24 hrs.,wallstreetbets,FTEG,7,7,0,7,1,1,1,1,OTC
4630,12-02-2021 18:00,24 hrs.,wallstreetbets,FTPM,7,7,0,7,1,1,1,1,OTC
4630,12-02-2021 18:00,24 hrs.,wallstreetbets,FUTL,6,0,6,-6,1,1,0,1,OTC
4630,12-02-2021 18:00,24 hrs.,wallstreetbets,GAXY,6,0,6,-6,1,1,0,1,OTC
4630,12-02-2021 18:00,24 hrs.,wallstreetbets,GBLX,6,0,6,-6,1,1,0,1,OTC
4630,12-02-2021 18:00,24 hrs.,wallstreetbets,GBTC,1381,1381,0,1381,3,616,137,2,OTC
4630,12-02-2021 18:00,24 hrs.,wallstreetbets,GFCI,786,0,786,-786,1,307,168,1,OTC
4630,12-02-2021 18:00,24 hrs.,wallstreetbets,GMEV,7,7,0,7,1,1,1,1,OTC
4630,12-02-2021 18:00,24 hrs.,wallstreetbets,GMSC,14,14,0,14,2,2,2,1,OTC
4630,12-02-2021 18:00,24 hrs.,wallstreetbets,GPFT,20,20,0,20,3,3,2,3,OTC
4630,12-02-2021 18:00,24 hrs.,wallstreetbets,GRNH,12,0,12,-12,2,2,0,2,OTC
4630,12-02-2021 18:00,24 hrs.,wallstreetbets,GTEH,18,0,18,-18,2,4,2,2,OTC
4630,12-02-2021 18:00,24 hrs.,wallstreetbets,GTII,1231,0,1231,-1231,1,440,347,1,OTC
4630,12-02-2021 18:00,24 hrs.,wallstreetbets,GTLL,13,6,7,-1,2,2,1,2,OTC
4630,12-02-2021 18:00,24 hrs.,wallstreetbets,GTXO,6,0,6,-6,1,1,0,1,OTC
4630,12-02-2021 18:00,24 hrs.,wallstreetbets,HCMC,437,203,234,-31,67,67,35,61,OTC
4630,12-02-2021 18:00,24 hrs.,wallstreetbets,HEMP,26,14,12,2,4,4,2,2,OTC
4630,12-02-2021 18:00,24 hrs.,wallstreetbets,HIHI,7,7,0,7,1,1,1,1,OTC
4630,12-02-2021 18:00,24 hrs.,wallstreetbets,HIPH,14,14,0,14,2,2,2,2,OTC
4630,12-02-2021 18:00,24 hrs.,wallstreetbets,HMNY,47,27,20,7,7,7,5,5,OTC
4630,12-02-2021 18:00,24 hrs.,wallstreetbets,HMPQ,19,7,12,-5,3,3,1,3,OTC
4630,12-02-2021 18:00,24 hrs.,wallstreetbets,HQGE,28,21,7,14,4,4,4,3,OTC
4630,12-02-2021 18:00,24 hrs.,wallstreetbets,HRBR,6,6,0,6,1,1,0,1,OTC
4630,12-02-2021 18:00,24 hrs.,wallstreetbets,HYSR,6,0,6,-6,1,1,0,1,OTC
4630,12-02-2021 18:00,24 hrs.,wallstreetbets,ICBU,7,7,0,7,1,1,1,1,OTC
4630,12-02-2021 18:00,24 hrs.,wallstreetbets,IINX,12,0,12,-12,2,2,0,1,OTC
4630,12-02-2021 18:00,24 hrs.,wallstreetbets,INCT,20,7,13,-6,3,3,2,3,OTC
4630,12-02-2021 18:00,24 hrs.,wallstreetbets,INKW,6,0,6,-6,1,1,0,1,OTC
4630,12-02-2021 18:00,24 hrs.,wallstreetbets,INND,13,6,7,-1,2,2,1,2,OTC
4630,12-02-2021 18:00,24 hrs.,wallstreetbets,ACRL,6,6,0,6,1,1,0,1,OTC
4630,12-02-2021 18:00,24 hrs.,wallstreetbets,ADTM,6,0,6,-6,1,1,0,1,OTC
4630,12-02-2021 18:00,24 hrs.,wallstreetbets,AEGY,6,0,6,-6,1,1,0,1,OTC
4630,12-02-2021 18:00,24 hrs.,wallstreetbets,AFTM,12,0,12,-12,2,2,0,1,OTC
4630,12-02-2021 18:00,24 hrs.,wallstreetbets,AHFD,7,0,7,-7,1,1,1,1,OTC
4630,12-02-2021 18:00,24 hrs.,wallstreetbets,AITX,38,14,24,-10,6,6,2,6,OTC
4630,12-02-2021 18:00,24 hrs.,wallstreetbets,ALPP,20,14,6,8,3,3,2,3,OTC
4630,12-02-2021 18:00,24 hrs.,wallstreetbets,ALYI,13,0,13,-13,2,2,1,2,OTC
4630,12-02-2021 18:00,24 hrs.,wallstreetbets,AMNE,13,13,0,13,2,2,1,1,OTC
4630,12-02-2021 18:00,24 hrs.,wallstreetbets,ANDD,6,0,6,-6,1,1,0,1,OTC
4630,12-02-2021 18:00,24 hrs.,wallstreetbets,ANTI,13,0,13,-13,2,2,1,2,OTC
4630,12-02-2021 18:00,24 hrs.,wallstreetbets,ASTI,30,0,30,-30,5,5,0,3,OTC
4630,12-02-2021 18:00,24 hrs.,wallstreetbets,BANT,6,6,0,6,1,1,0,1,OTC
4630,12-02-2021 18:00,24 hrs.,wallstreetbets,BBRW,6,0,6,-6,1,1,0,1,OTC
4630,12-02-2021 18:00,24 hrs.,wallstreetbets,BCCI,14,0,14,-14,2,2,2,1,OTC
4630,12-02-2021 18:00,24 hrs.,wallstreetbets,PDMI,7,0,7,-7,1,1,1,1,OTC
4630,12-02-2021 18:00,24 hrs.,wallstreetbets,PFNO,6,0,6,-6,1,1,0,1,OTC
4630,12-02-2021 18:00,24 hrs.,wallstreetbets,PGIE,6,0,6,-6,1,1,0,1,OTC
4630,12-02-2021 18:00,24 hrs.,wallstreetbets,PNPL,13,0,13,-13,2,2,1,1,OTC
4630,12-02-2021 18:00,24 hrs.,wallstreetbets,PPJE,6,0,6,-6,1,1,0,1,OTC
4630,12-02-2021 18:00,24 hrs.,wallstreetbets,PRDL,6,0,6,-6,1,1,0,1,OTC
4630,12-02-2021 18:00,24 hrs.,wallstreetbets,PRED,7,0,7,-7,1,1,1,1,OTC
4630,12-02-2021 18:00,24 hrs.,wallstreetbets,PTOI,12,0,12,-12,2,2,0,1,OTC
4630,12-02-2021 18:00,24 hrs.,wallstreetbets,PURA,6,0,6,-6,1,1,0,1,OTC
4630,12-02-2021 18:00,24 hrs.,wallstreetbets,PURE,7,0,7,-7,1,1,1,1,OTC
4630,12-02-2021 18:00,24 hrs.,wallstreetbets,QOIL,6,6,0,6,1,1,0,1,OTC
4630,12-02-2021 18:00,24 hrs.,wallstreetbets,QTMM,6,0,6,-6,1,1,0,1,OTC
4630,12-02-2021 18:00,24 hrs.,wallstreetbets,RBDC,7,7,0,7,1,1,1,1,OTC
4630,12-02-2021 18:00,24 hrs.,wallstreetbets,RBNW,13,13,0,13,2,2,1,2,OTC
4630,12-02-2021 18:00,24 hrs.,wallstreetbets,REFG,7,7,0,7,1,1,1,1,OTC
4630,12-02-2021 18:00,24 hrs.,wallstreetbets,RELI,6,6,0,6,1,1,0,1,OTC
4630,12-02-2021 18:00,24 hrs.,wallstreetbets,RIGH,7,0,7,-7,1,1,1,1,OTC
4630,12-02-2021 18:00,24 hrs.,wallstreetbets,RLTR,12,0,12,-12,2,2,0,2,OTC
4630,12-02-2021 18:00,24 hrs.,wallstreetbets,RSHN,7,0,7,-7,1,1,1,1,OTC
4630,12-02-2021 18:00,24 hrs.,wallstreetbets,RSSV,9,9,0,9,1,2,1,1,OTC
4630,12-02-2021 18:00,24 hrs.,SPACs,APEX,30,30,0,30,1,5,16,1,OTC
4630,12-02-2021 18:00,24 hrs.,SPACs,CAGR,103,0,103,-103,1,20,59,1,OTC
4630,12-02-2021 18:00,24 hrs.,SPACs,BGI,29,0,29,-29,1,5,15,1,AMEX
4630,12-02-2021 18:00,24 hrs.,SPACs,CIK,52,31,21,10,2,8,28,2,AMEX
4630,12-02-2021 18:00,24 hrs.,SPACs,CTO,127,0,127,-127,1,43,37,1,AMEX
4630,12-02-2021 18:00,24 hrs.,SPACs,NBA,203,203,0,203,1,56,87,1,AMEX
4630,12-02-2021 18:00,24 hrs.,SPACs,PTK,203,203,0,203,1,56,87,1,AMEX
4630,12-02-2021 18:00,24 hrs.,SPACs,CHAQ,203,203,0,203,1,56,87,1,AMEX
4630,12-02-2021 18:00,24 hrs.,SPACs,BSN,203,203,0,203,1,56,87,1,NYSE
4630,12-02-2021 18:00,24 hrs.,SPACs,CCX,210,203,7,196,2,57,88,2,NYSE
4630,12-02-2021 18:00,24 hrs.,SPACs,COO,23,23,0,23,1,2,15,1,NYSE
4630,12-02-2021 18:00,24 hrs.,SPACs,DEH,203,203,0,203,1,56,87,1,NYSE
4630,12-02-2021 18:00,24 hrs.,SPACs,EQD,203,203,0,203,1,56,87,1,NYSE
4630,12-02-2021 18:00,24 hrs.,SPACs,FSR,6,6,0,6,1,1,0,1,NYSE
4630,12-02-2021 18:00,24 hrs.,SPACs,GIK,29,29,0,29,4,2,9,2,NYSE
4630,12-02-2021 18:00,24 hrs.,SPACs,GIX,203,203,0,203,1,56,87,1,NYSE
4630,12-02-2021 18:00,24 hrs.,SPACs,HPX,203,203,0,203,1,56,87,1,NYSE
4630,12-02-2021 18:00,24 hrs.,SPACs,ICE,29,29,0,29,1,9,7,1,NYSE
4630,12-02-2021 18:00,24 hrs.,SPACs,IRR,24,24,0,24,1,5,10,1,NYSE
4630,12-02-2021 18:00,24 hrs.,SPACs,NAV,533,157,376,-219,8,195,111,7,NYSE
4630,12-02-2021 18:00,24 hrs.,SPACs,NGA,54,54,0,54,4,7,24,3,NYSE
4630,12-02-2021 18:00,24 hrs.,SPACs,NSH,203,203,0,203,1,56,87,1,NYSE
4630,12-02-2021 18:00,24 hrs.,SPACs,RMO,7,0,7,-7,1,1,1,1,NYSE
4630,12-02-2021 18:00,24 hrs.,SPACs,RSI,124,5,119,-114,2,36,44,2,NYSE
4630,12-02-2021 18:00,24 hrs.,SPACs,RTP,2275,266,2009,-1743,14,290,1639,12,NYSE
4630,12-02-2021 18:00,24 hrs.,SPACs,SBE,126,6,120,-114,8,31,32,5,NYSE
4630,12-02-2021 18:00,24 hrs.,SPACs,SBG,203,203,0,203,1,56,87,1,NYSE
4630,12-02-2021 18:00,24 hrs.,SPACs,TDA,7,7,0,7,1,1,1,1,NYSE
4630,12-02-2021 18:00,24 hrs.,SPACs,WPF,209,203,6,197,2,57,87,2,NYSE
4630,12-02-2021 18:00,24 hrs.,SPACs,YAC,203,203,0,203,1,56,87,1,NYSE
4630,12-02-2021 18:00,24 hrs.,SPACs,ACIC,1483,0,1483,-1483,1,44,1391,1,NYSE
4630,12-02-2021 18:00,24 hrs.,SPACs,ACND,203,203,0,203,1,56,87,1,NYSE
4630,12-02-2021 18:00,24 hrs.,SPACs,ALUS,22,22,0,22,1,6,6,1,NYSE
4630,12-02-2021 18:00,24 hrs.,SPACs,AONE,203,203,0,203,1,56,87,1,NYSE
4630,12-02-2021 18:00,24 hrs.,SPACs,APSG,203,203,0,203,1,56,87,1,NYSE
4630,12-02-2021 18:00,24 hrs.,SPACs,ASAQ,203,203,0,203,1,56,87,1,NYSE
4630,12-02-2021 18:00,24 hrs.,SPACs,ASPL,209,209,0,209,2,57,87,2,NYSE
4630,12-02-2021 18:00,24 hrs.,wallstreetbets,INTV,14,14,0,14,2,2,2,1,OTC
4630,12-02-2021 18:00,24 hrs.,wallstreetbets,IPIX,10,10,0,10,1,3,0,1,OTC
4630,12-02-2021 18:00,24 hrs.,wallstreetbets,IQST,18,0,18,-18,3,3,0,3,OTC
4630,12-02-2021 18:00,24 hrs.,wallstreetbets,CGEI,7,0,7,-7,1,1,1,1,OTC
4630,12-02-2021 18:00,24 hrs.,wallstreetbets,CHUC,7,7,0,7,1,1,1,1,OTC
4630,12-02-2021 18:00,24 hrs.,wallstreetbets,CLIS,6,0,6,-6,1,1,0,1,OTC
4630,12-02-2021 18:00,24 hrs.,wallstreetbets,CLSH,7,0,7,-7,1,1,1,1,OTC
4630,12-02-2021 18:00,24 hrs.,wallstreetbets,RTON,27,7,20,-13,4,4,3,4,OTC
4630,12-02-2021 18:00,24 hrs.,wallstreetbets,SCNA,14,0,14,-14,2,3,0,2,OTC
4630,12-02-2021 18:00,24 hrs.,wallstreetbets,SFOR,14,0,14,-14,2,2,2,1,OTC
4630,12-02-2021 18:00,24 hrs.,wallstreetbets,SGLN,6,0,6,-6,1,1,0,1,OTC
4630,12-02-2021 18:00,24 hrs.,wallstreetbets,SGMD,31,6,25,-19,5,5,1,4,OTC
4630,12-02-2021 18:00,24 hrs.,wallstreetbets,SHMP,20,14,6,8,3,3,2,3,OTC
4630,12-02-2021 18:00,24 hrs.,wallstreetbets,SHWZ,6,0,6,-6,1,1,0,1,OTC
4630,12-02-2021 18:00,24 hrs.,wallstreetbets,SIGN,26,7,19,-12,4,4,2,4,OTC
4630,12-02-2021 18:00,24 hrs.,wallstreetbets,SING,7,0,7,-7,1,1,1,1,OTC
4630,12-02-2021 18:00,24 hrs.,wallstreetbets,SNPW,6,0,6,-6,1,1,0,1,OTC
4630,12-02-2021 18:00,24 hrs.,wallstreetbets,SNRY,6,0,6,-6,1,1,0,1,OTC
4630,12-02-2021 18:00,24 hrs.,wallstreetbets,SRMX,57,7,50,-43,9,9,3,9,OTC
4630,12-02-2021 18:00,24 hrs.,wallstreetbets,SUIC,6,6,0,6,1,1,0,1,OTC
4630,12-02-2021 18:00,24 hrs.,wallstreetbets,SUND,6,0,6,-6,1,1,0,1,OTC
4630,12-02-2021 18:00,24 hrs.,wallstreetbets,SVTE,6,0,6,-6,1,1,0,1,OTC
4630,12-02-2021 18:00,24 hrs.,wallstreetbets,TCHH,6,6,0,6,1,1,0,1,OTC
4630,12-02-2021 18:00,24 hrs.,wallstreetbets,TRNX,13,0,13,-13,2,2,1,2,OTC
4630,12-02-2021 18:00,24 hrs.,wallstreetbets,TRTC,20,14,6,8,3,3,2,2,OTC
4630,12-02-2021 18:00,24 hrs.,wallstreetbets,TSNP,20,14,6,8,3,3,2,3,OTC
4630,12-02-2021 18:00,24 hrs.,wallstreetbets,UNVC,6,0,6,-6,1,1,0,1,OTC
4630,12-02-2021 18:00,24 hrs.,wallstreetbets,ITCJ,6,6,0,6,1,1,0,1,OTC
4630,12-02-2021 18:00,24 hrs.,wallstreetbets,KALY,7,7,0,7,1,1,1,1,OTC
4630,12-02-2021 18:00,24 hrs.,wallstreetbets,KBLB,12,0,12,-12,2,2,0,2,OTC
4630,12-02-2021 18:00,24 hrs.,wallstreetbets,KGKG,7,0,7,-7,1,1,1,1,OTC
4630,12-02-2021 18:00,24 hrs.,wallstreetbets,KRFG,7,0,7,-7,1,1,1,1,OTC
4630,12-02-2021 18:00,24 hrs.,wallstreetbets,KWBT,7,7,0,7,1,1,1,1,OTC
4630,12-02-2021 18:00,24 hrs.,wallstreetbets,KYNC,14,7,7,0,2,2,2,2,OTC
4630,12-02-2021 18:00,24 hrs.,wallstreetbets,LBCC,7,7,0,7,1,1,1,1,OTC
4630,12-02-2021 18:00,24 hrs.,wallstreetbets,LGIQ,6,0,6,-6,1,1,0,1,OTC
4630,12-02-2021 18:00,24 hrs.,wallstreetbets,LINK,394,394,0,394,3,154,74,3,OTC
4630,12-02-2021 18:00,24 hrs.,wallstreetbets,LITH,7,7,0,7,1,1,1,1,OTC
4630,12-02-2021 18:00,24 hrs.,wallstreetbets,LOTE,7,7,0,7,1,1,1,1,OTC
4630,12-02-2021 18:00,24 hrs.,wallstreetbets,LQMT,12,0,12,-12,2,2,0,2,OTC
4630,12-02-2021 18:00,24 hrs.,wallstreetbets,LQWC,6,0,6,-6,1,1,0,1,OTC
4630,12-02-2021 18:00,24 hrs.,wallstreetbets,LSCG,7,0,7,-7,1,1,1,1,OTC
4630,12-02-2021 18:00,24 hrs.,wallstreetbets,LTNC,14,14,0,14,2,2,2,2,OTC
4630,12-02-2021 18:00,24 hrs.,wallstreetbets,LTUM,6,0,6,-6,1,1,0,1,OTC
4630,12-02-2021 18:00,24 hrs.,wallstreetbets,LUVU,6,0,6,-6,1,1,0,1,OTC
4630,12-02-2021 18:00,24 hrs.,wallstreetbets,MATN,6,0,6,-6,1,1,0,1,OTC
4630,12-02-2021 18:00,24 hrs.,wallstreetbets,MCOA,20,20,0,20,3,3,2,3,OTC
4630,12-02-2021 18:00,24 hrs.,wallstreetbets,MEDH,7,7,0,7,1,1,1,1,OTC
4630,12-02-2021 18:00,24 hrs.,wallstreetbets,MGTI,7,7,0,7,1,1,1,1,OTC
4630,12-02-2021 18:00,24 hrs.,wallstreetbets,MINE,60,28,32,-4,9,9,6,6,OTC
4630,12-02-2021 18:00,24 hrs.,wallstreetbets,MITI,6,0,6,-6,1,1,0,1,OTC
4630,12-02-2021 18:00,24 hrs.,wallstreetbets,MJNA,47,27,20,7,7,7,5,7,OTC
4630,12-02-2021 18:00,24 hrs.,wallstreetbets,MKTY,14,14,0,14,2,2,2,1,OTC
4630,12-02-2021 18:00,24 hrs.,wallstreetbets,MMEX,41,0,41,-41,6,6,5,4,OTC
4630,12-02-2021 18:00,24 hrs.,wallstreetbets,MMMM,6,0,6,-6,1,1,0,1,OTC
4630,12-02-2021 18:00,24 hrs.,wallstreetbets,MOJO,7,7,0,7,1,1,1,1,OTC
4630,12-02-2021 18:00,24 hrs.,wallstreetbets,MRMD,6,0,6,-6,1,1,0,1,OTC
4630,12-02-2021 18:00,24 hrs.,wallstreetbets,MTVX,15,6,9,-3,2,3,1,2,OTC
4630,12-02-2021 18:00,24 hrs.,wallstreetbets,NBVG,6,6,0,6,1,1,0,1,OTC
4630,12-02-2021 18:00,24 hrs.,wallstreetbets,NEOM,14,14,0,14,2,2,2,1,OTC
4630,12-02-2021 18:00,24 hrs.,wallstreetbets,NOVC,34,34,0,34,5,5,4,3,OTC
4630,12-02-2021 18:00,24 hrs.,wallstreetbets,NPHC,6,0,6,-6,1,1,0,1,OTC
4630,12-02-2021 18:00,24 hrs.,wallstreetbets,NPTX,14,0,14,-14,2,2,2,1,OTC
4630,12-02-2021 18:00,24 hrs.,wallstreetbets,NUKK,6,0,6,-6,1,1,0,1,OTC
4630,12-02-2021 18:00,24 hrs.,wallstreetbets,NWPN,6,6,0,6,1,1,0,1,OTC
4630,12-02-2021 18:00,24 hrs.,wallstreetbets,ONPH,6,6,0,6,1,1,0,1,OTC
4630,12-02-2021 18:00,24 hrs.,wallstreetbets,OTTV,14,14,0,14,2,2,2,1,OTC
4630,12-02-2021 18:00,24 hrs.,wallstreetbets,OZSC,6,0,6,-6,1,1,0,1,OTC
4630,12-02-2021 18:00,24 hrs.,wallstreetbets,PAOG,13,7,6,1,2,2,1,2,OTC
4630,12-02-2021 18:00,24 hrs.,wallstreetbets,PAPA,6,0,6,-6,1,1,0,1,OTC
4630,12-02-2021 18:00,24 hrs.,wallstreetbets,PASO,6,0,6,-6,1,1,0,1,OTC
4618,12-02-2021 16:00,24 hrs.,RobinHoodPennyStocks,TAOP,107,0,107,-107,1,39,25,1,NASDAQ
4618,12-02-2021 16:00,24 hrs.,RobinHoodPennyStocks,TBLT,42,42,0,42,1,10,18,1,NASDAQ
4618,12-02-2021 16:00,24 hrs.,RobinHoodPennyStocks,TEDU,107,0,107,-107,1,39,25,1,NASDAQ
4618,12-02-2021 16:00,24 hrs.,RobinHoodPennyStocks,TIGR,107,0,107,-107,1,39,25,1,NASDAQ
4618,12-02-2021 16:00,24 hrs.,RobinHoodPennyStocks,TLRY,21,0,21,-21,2,5,3,2,NASDAQ
4618,12-02-2021 16:00,24 hrs.,RobinHoodPennyStocks,TNXP,598,53,545,-492,10,216,126,9,NASDAQ
4618,12-02-2021 16:00,24 hrs.,RobinHoodPennyStocks,TRCH,344,16,328,-312,7,109,98,6,NASDAQ
4618,12-02-2021 16:00,24 hrs.,RobinHoodPennyStocks,TRIL,6,0,6,-6,1,1,0,1,NASDAQ
4618,12-02-2021 16:00,24 hrs.,RobinHoodPennyStocks,TTOO,59,34,25,9,2,20,11,2,NASDAQ
4618,12-02-2021 16:00,24 hrs.,RobinHoodPennyStocks,TXMD,427,6,421,-415,8,98,199,8,NASDAQ
4618,12-02-2021 16:00,24 hrs.,RobinHoodPennyStocks,TYME,22,22,0,22,1,2,14,1,NASDAQ
4618,12-02-2021 16:00,24 hrs.,RobinHoodPennyStocks,UONE,107,0,107,-107,1,39,25,1,NASDAQ
4618,12-02-2021 16:00,24 hrs.,RobinHoodPennyStocks,USEG,107,0,107,-107,1,39,25,1,NASDAQ
4618,12-02-2021 16:00,24 hrs.,RobinHoodPennyStocks,USWS,12,0,12,-12,2,2,0,2,NASDAQ
4618,12-02-2021 16:00,24 hrs.,RobinHoodPennyStocks,UXIN,107,0,107,-107,1,39,25,1,NASDAQ
4618,12-02-2021 16:00,24 hrs.,RobinHoodPennyStocks,VYNE,6,0,6,-6,1,1,0,1,NASDAQ
4618,12-02-2021 16:00,24 hrs.,RobinHoodPennyStocks,WATT,107,0,107,-107,1,39,25,1,NASDAQ
4618,12-02-2021 16:00,24 hrs.,RobinHoodPennyStocks,WIMI,107,0,107,-107,1,39,25,1,NASDAQ
4618,12-02-2021 16:00,24 hrs.,RobinHoodPennyStocks,WKEY,107,0,107,-107,1,39,25,1,NASDAQ
4618,12-02-2021 16:00,24 hrs.,RobinHoodPennyStocks,WRAP,107,0,107,-107,1,39,25,1,NASDAQ
4618,12-02-2021 16:00,24 hrs.,RobinHoodPennyStocks,YGMZ,107,0,107,-107,1,39,25,1,NASDAQ
4618,12-02-2021 16:00,24 hrs.,RobinHoodPennyStocks,ZSAN,487,321,166,155,7,173,113,7,NASDAQ
4618,12-02-2021 16:00,24 hrs.,RobinHoodPennyStocks,ZYNE,63,0,63,-63,1,13,33,1,NASDAQ
4618,12-02-2021 16:00,24 hrs.,RobinHoodPennyStocks,UONEK,107,0,107,-107,1,39,25,1,NASDAQ
4618,12-02-2021 16:00,24 hrs.,RobinHoodPennyStocks,PULM,199,0,199,-199,2,75,41,2,NASDAQ
4618,12-02-2021 16:00,24 hrs.,RobinHoodPennyStocks,PXLW,6,0,6,-6,1,1,0,1,NASDAQ
4618,12-02-2021 16:00,24 hrs.,RobinHoodPennyStocks,QUIK,107,0,107,-107,1,39,25,1,NASDAQ
4618,12-02-2021 16:00,24 hrs.,RobinHoodPennyStocks,RAVE,107,0,107,-107,1,39,25,1,NASDAQ
4618,12-02-2021 16:00,24 hrs.,RobinHoodPennyStocks,RCMT,107,0,107,-107,1,39,25,1,NASDAQ
4618,12-02-2021 16:00,24 hrs.,RobinHoodPennyStocks,REAL,75,75,0,75,1,25,21,1,NASDAQ
4618,12-02-2021 16:00,24 hrs.,RobinHoodPennyStocks,RIOT,114,7,107,-100,2,39,28,2,NASDAQ
4618,12-02-2021 16:00,24 hrs.,RobinHoodPennyStocks,RWLK,6,0,6,-6,1,1,0,1,NASDAQ
4618,12-02-2021 16:00,24 hrs.,RobinHoodPennyStocks,SALM,107,0,107,-107,1,39,25,1,NASDAQ
4618,12-02-2021 16:00,24 hrs.,RobinHoodPennyStocks,SAVA,107,0,107,-107,1,39,25,1,NASDAQ
4618,12-02-2021 16:00,24 hrs.,RobinHoodPennyStocks,SEED,107,0,107,-107,1,39,25,1,NASDAQ
4618,12-02-2021 16:00,24 hrs.,RobinHoodPennyStocks,SGOC,107,0,107,-107,1,39,25,1,NASDAQ
4618,12-02-2021 16:00,24 hrs.,RobinHoodPennyStocks,SHIP,12,6,6,0,2,2,0,2,NASDAQ
4618,12-02-2021 16:00,24 hrs.,RobinHoodPennyStocks,SNDL,1711,609,1102,-493,52,475,553,44,NASDAQ
4618,12-02-2021 16:00,24 hrs.,RobinHoodPennyStocks,SNGX,240,159,81,78,5,96,28,4,NASDAQ
4618,12-02-2021 16:00,24 hrs.,RobinHoodPennyStocks,SONM,59,0,59,-59,1,23,9,1,NASDAQ
4618,12-02-2021 16:00,24 hrs.,RobinHoodPennyStocks,SRGA,21,0,21,-21,1,7,3,1,NASDAQ
4618,12-02-2021 16:00,24 hrs.,RobinHoodPennyStocks,SUNW,107,0,107,-107,1,39,25,1,NASDAQ
4618,12-02-2021 16:00,24 hrs.,RobinHoodPennyStocks,SXTC,107,0,107,-107,1,39,25,1,NASDAQ
4618,12-02-2021 16:00,24 hrs.,RobinHoodPennyStocks,SYPR,107,0,107,-107,1,39,25,1,NASDAQ
4618,12-02-2021 16:00,24 hrs.,RobinHoodPennyStocks,TAIT,107,0,107,-107,1,39,25,1,NASDAQ
4618,12-02-2021 16:00,24 hrs.,RobinHoodPennyStocks,TANH,107,0,107,-107,1,39,25,1,NASDAQ
4618,12-02-2021 16:00,24 hrs.,RobinHoodPennyStocks,LIVE,10,0,10,-10,1,0,6,1,NASDAQ
4618,12-02-2021 16:00,24 hrs.,RobinHoodPennyStocks,LKCO,42,12,30,-18,7,7,0,4,NASDAQ
4618,12-02-2021 16:00,24 hrs.,RobinHoodPennyStocks,LLNW,42,0,42,-42,1,12,14,1,NASDAQ
4618,12-02-2021 16:00,24 hrs.,RobinHoodPennyStocks,LMFA,107,0,107,-107,1,39,25,1,NASDAQ
4618,12-02-2021 16:00,24 hrs.,RobinHoodPennyStocks,LXEH,107,0,107,-107,1,39,25,1,NASDAQ
4618,12-02-2021 16:00,24 hrs.,RobinHoodPennyStocks,MARA,107,0,107,-107,1,39,25,1,NASDAQ
4618,12-02-2021 16:00,24 hrs.,RobinHoodPennyStocks,METX,107,0,107,-107,1,39,25,1,NASDAQ
4618,12-02-2021 16:00,24 hrs.,RobinHoodPennyStocks,MOGO,107,0,107,-107,1,39,25,1,NASDAQ
4618,12-02-2021 16:00,24 hrs.,RobinHoodPennyStocks,MOMO,107,0,107,-107,1,39,25,1,NASDAQ
4618,12-02-2021 16:00,24 hrs.,RobinHoodPennyStocks,MOSY,107,0,107,-107,1,39,25,1,NASDAQ
4618,12-02-2021 16:00,24 hrs.,RobinHoodPennyStocks,MOXC,107,0,107,-107,1,39,25,1,NASDAQ
4618,12-02-2021 16:00,24 hrs.,RobinHoodPennyStocks,MVIS,107,0,107,-107,1,39,25,1,NASDAQ
4618,12-02-2021 16:00,24 hrs.,RobinHoodPennyStocks,NAKD,206,12,194,-182,5,53,80,5,NASDAQ
4618,12-02-2021 16:00,24 hrs.,RobinHoodPennyStocks,NCTY,107,0,107,-107,1,39,25,1,NASDAQ
4618,12-02-2021 16:00,24 hrs.,RobinHoodPennyStocks,NOVN,248,39,209,-170,7,79,62,5,NASDAQ
4618,12-02-2021 16:00,24 hrs.,RobinHoodPennyStocks,NVCN,60,0,60,-60,4,13,18,4,NASDAQ
4618,12-02-2021 16:00,24 hrs.,RobinHoodPennyStocks,NVIV,12,0,12,-12,1,2,4,1,NASDAQ
4618,12-02-2021 16:00,24 hrs.,RobinHoodPennyStocks,NXTD,107,0,107,-107,1,39,25,1,NASDAQ
4618,12-02-2021 16:00,24 hrs.,RobinHoodPennyStocks,OCGN,54,36,18,18,4,12,14,4,NASDAQ
4618,12-02-2021 16:00,24 hrs.,RobinHoodPennyStocks,ONTX,28,0,28,-28,2,8,4,2,NASDAQ
4618,12-02-2021 16:00,24 hrs.,RobinHoodPennyStocks,OPGN,30,18,12,6,5,5,0,2,NASDAQ
4618,12-02-2021 16:00,24 hrs.,RobinHoodPennyStocks,OPTT,107,0,107,-107,1,39,25,1,NASDAQ
4618,12-02-2021 16:00,24 hrs.,RobinHoodPennyStocks,PECK,107,0,107,-107,1,39,25,1,NASDAQ
4618,12-02-2021 16:00,24 hrs.,RobinHoodPennyStocks,PEIX,107,0,107,-107,1,39,25,1,NASDAQ
4618,12-02-2021 16:00,24 hrs.,RobinHoodPennyStocks,PETZ,107,0,107,-107,1,39,25,1,NASDAQ
4618,12-02-2021 16:00,24 hrs.,RobinHoodPennyStocks,PHUN,107,0,107,-107,1,39,25,1,NASDAQ
4618,12-02-2021 16:00,24 hrs.,RobinHoodPennyStocks,PIXY,107,0,107,-107,1,39,25,1,NASDAQ
4618,12-02-2021 16:00,24 hrs.,RobinHoodPennyStocks,PLIN,107,0,107,-107,1,39,25,1,NASDAQ
4618,12-02-2021 16:00,24 hrs.,RobinHoodPennyStocks,PLUG,107,0,107,-107,1,39,25,1,NASDAQ
4618,12-02-2021 16:00,24 hrs.,RobinHoodPennyStocks,PSEC,61,42,19,23,6,10,17,3,NASDAQ
4618,12-02-2021 16:00,24 hrs.,RobinHoodPennyStocks,PSTV,125,125,0,125,1,51,19,1,NASDAQ
4618,12-02-2021 16:00,24 hrs.,RobinHoodPennyStocks,BCRX,44,0,44,-44,1,9,22,1,NASDAQ
4618,12-02-2021 16:00,24 hrs.,RobinHoodPennyStocks,BFRA,107,0,107,-107,1,39,25,1,NASDAQ
4618,12-02-2021 16:00,24 hrs.,RobinHoodPennyStocks,BHAT,107,0,107,-107,1,39,25,1,NASDAQ
4618,12-02-2021 16:00,24 hrs.,RobinHoodPennyStocks,BNGO,6,6,0,6,1,1,0,1,NASDAQ
4618,12-02-2021 16:00,24 hrs.,RobinHoodPennyStocks,BRQS,132,19,113,-94,3,43,34,3,NASDAQ
4618,12-02-2021 16:00,24 hrs.,RobinHoodPennyStocks,BYFC,107,0,107,-107,1,39,25,1,NASDAQ
4618,12-02-2021 16:00,24 hrs.,RobinHoodPennyStocks,CAAS,107,0,107,-107,1,39,25,1,NASDAQ
4618,12-02-2021 16:00,24 hrs.,RobinHoodPennyStocks,CARV,107,0,107,-107,1,39,25,1,NASDAQ
4618,12-02-2021 16:00,24 hrs.,RobinHoodPennyStocks,CBAT,107,0,107,-107,1,39,25,1,NASDAQ
4618,12-02-2021 16:00,24 hrs.,RobinHoodPennyStocks,CCNC,107,0,107,-107,1,39,25,1,NASDAQ
4618,12-02-2021 16:00,24 hrs.,RobinHoodPennyStocks,CHNR,107,0,107,-107,1,39,25,1,NASDAQ
4618,12-02-2021 16:00,24 hrs.,RobinHoodPennyStocks,CIDM,6,0,6,-6,1,1,0,1,NASDAQ
4618,12-02-2021 16:00,24 hrs.,RobinHoodPennyStocks,CKPT,294,29,265,-236,2,60,166,2,NASDAQ
4618,12-02-2021 16:00,24 hrs.,RobinHoodPennyStocks,CLEU,107,0,107,-107,1,39,25,1,NASDAQ
4618,12-02-2021 16:00,24 hrs.,RobinHoodPennyStocks,CLRB,19,0,19,-19,1,7,1,1,NASDAQ
4618,12-02-2021 16:00,24 hrs.,RobinHoodPennyStocks,CLSK,107,0,107,-107,1,39,25,1,NASDAQ
4618,12-02-2021 16:00,24 hrs.,RobinHoodPennyStocks,CLSN,6,0,6,-6,1,1,0,1,NASDAQ
4618,12-02-2021 16:00,24 hrs.,RobinHoodPennyStocks,CMLF,107,0,107,-107,1,39,25,1,NASDAQ
4618,12-02-2021 16:00,24 hrs.,RobinHoodPennyStocks,CSCW,107,0,107,-107,1,39,25,1,NASDAQ
4618,12-02-2021 16:00,24 hrs.,RobinHoodPennyStocks,CTRM,1130,217,913,-696,27,323,376,24,NASDAQ
4618,12-02-2021 16:00,24 hrs.,RobinHoodPennyStocks,DFFN,167,151,16,135,5,50,47,5,NASDAQ
4618,12-02-2021 16:00,24 hrs.,RobinHoodPennyStocks,EAST,66,54,12,42,3,19,16,3,NASDAQ
4618,12-02-2021 16:00,24 hrs.,RobinHoodPennyStocks,ENTX,29,29,0,29,1,11,3,1,NASDAQ
4618,12-02-2021 16:00,24 hrs.,RobinHoodPennyStocks,ENVB,6,0,6,-6,1,1,0,1,NASDAQ
4618,12-02-2021 16:00,24 hrs.,RobinHoodPennyStocks,EQOS,107,0,107,-107,1,39,25,1,NASDAQ
4618,12-02-2021 16:00,24 hrs.,RobinHoodPennyStocks,FCEL,130,23,107,-84,2,45,32,2,NASDAQ
4618,12-02-2021 16:00,24 hrs.,RobinHoodPennyStocks,GHSI,91,0,91,-91,1,37,13,1,NASDAQ
4618,12-02-2021 16:00,24 hrs.,RobinHoodPennyStocks,GLMD,265,0,265,-265,1,51,159,1,NASDAQ
4618,12-02-2021 16:00,24 hrs.,RobinHoodPennyStocks,GMDA,6,6,0,6,1,1,0,1,NASDAQ
4618,12-02-2021 16:00,24 hrs.,RobinHoodPennyStocks,GRIL,107,0,107,-107,1,39,25,1,NASDAQ
4618,12-02-2021 16:00,24 hrs.,RobinHoodPennyStocks,HCDI,107,0,107,-107,1,39,25,1,NASDAQ
4618,12-02-2021 16:00,24 hrs.,RobinHoodPennyStocks,HGSH,107,0,107,-107,1,39,25,1,NASDAQ
4618,12-02-2021 16:00,24 hrs.,RobinHoodPennyStocks,IDEX,114,7,107,-100,2,40,26,2,NASDAQ
4618,12-02-2021 16:00,24 hrs.,RobinHoodPennyStocks,IFMK,107,0,107,-107,1,39,25,1,NASDAQ
4618,12-02-2021 16:00,24 hrs.,RobinHoodPennyStocks,IMTE,107,0,107,-107,1,39,25,1,NASDAQ
4618,12-02-2021 16:00,24 hrs.,RobinHoodPennyStocks,INPX,6,0,6,-6,1,1,0,1,NASDAQ
4618,12-02-2021 16:00,24 hrs.,RobinHoodPennyStocks,ITRM,6,0,6,-6,1,1,0,1,NASDAQ
4618,12-02-2021 16:00,24 hrs.,RobinHoodPennyStocks,IZEA,107,0,107,-107,1,39,25,1,NASDAQ
4618,12-02-2021 16:00,24 hrs.,RobinHoodPennyStocks,JFIN,107,0,107,-107,1,39,25,1,NASDAQ
4618,12-02-2021 16:00,24 hrs.,RobinHoodPennyStocks,JRJC,107,0,107,-107,1,39,25,1,NASDAQ
4618,12-02-2021 16:00,24 hrs.,RobinHoodPennyStocks,KNDI,107,0,107,-107,1,39,25,1,NASDAQ
4618,12-02-2021 16:00,24 hrs.,RobinHoodPennyStocks,KTRA,48,42,6,36,2,17,6,2,NASDAQ
4618,12-02-2021 16:00,24 hrs.,RobinHoodPennyStocks,KXIN,107,0,107,-107,1,39,25,1,NASDAQ
4618,12-02-2021 16:00,24 hrs.,RobinHoodPennyStocks,LEDS,107,0,107,-107,1,39,25,1,NASDAQ
4618,12-02-2021 16:00,24 hrs.,RobinHoodPennyStocks,AIHS,107,0,107,-107,1,39,25,1,NASDAQ
4618,12-02-2021 16:00,24 hrs.,RobinHoodPennyStocks,ALAC,107,0,107,-107,1,39,25,1,NASDAQ
4618,12-02-2021 16:00,24 hrs.,RobinHoodPennyStocks,AMTX,107,0,107,-107,1,39,25,1,NASDAQ
4618,12-02-2021 16:00,24 hrs.,RobinHoodPennyStocks,APHA,18,12,6,6,3,3,0,2,NASDAQ
4618,12-02-2021 16:00,24 hrs.,RobinHoodPennyStocks,ARPO,6,6,0,6,1,1,0,1,NASDAQ
4618,12-02-2021 16:00,24 hrs.,RobinHoodPennyStocks,ARTL,12,6,6,0,2,2,0,2,NASDAQ
4618,12-02-2021 16:00,24 hrs.,RobinHoodPennyStocks,ASRT,56,6,50,-44,3,13,18,3,NASDAQ
4618,12-02-2021 16:00,24 hrs.,RobinHoodPennyStocks,ASYS,107,0,107,-107,1,39,25,1,NASDAQ
4618,12-02-2021 16:00,24 hrs.,RobinHoodPennyStocks,ATIF,107,0,107,-107,1,39,25,1,NASDAQ
4618,12-02-2021 16:00,24 hrs.,RobinHoodPennyStocks,ATNI,107,0,107,-107,1,39,25,1,NASDAQ
4618,12-02-2021 16:00,24 hrs.,RobinHoodPennyStocks,ATOS,296,243,53,190,15,84,68,15,NASDAQ
4618,12-02-2021 16:00,24 hrs.,RobinHoodPennyStocks,AVCO,107,0,107,-107,1,39,25,1,NASDAQ
4618,12-02-2021 16:00,24 hrs.,RobinHoodPennyStocks,BBIG,6,0,6,-6,1,1,0,1,NASDAQ
4618,12-02-2021 16:00,24 hrs.,RobinHoodPennyStocks,BCLI,6,0,6,-6,1,1,0,1,NASDAQ
4618,12-02-2021 16:00,24 hrs.,RobinHoodPennyStocks,TKAT,107,0,107,-107,1,39,25,1,AMEX
4618,12-02-2021 16:00,24 hrs.,RobinHoodPennyStocks,TRXC,178,12,166,-154,3,68,30,3,AMEX
4618,12-02-2021 16:00,24 hrs.,RobinHoodPennyStocks,UUUU,36,0,36,-36,1,11,10,1,AMEX
4618,12-02-2021 16:00,24 hrs.,RobinHoodPennyStocks,YCBD,6,0,6,-6,1,1,0,1,AMEX
4618,12-02-2021 16:00,24 hrs.,RobinHoodPennyStocks,AIV,6,6,0,6,1,1,0,1,NYSE
4618,12-02-2021 16:00,24 hrs.,RobinHoodPennyStocks,AMC,151,0,151,-151,3,48,43,3,NYSE
4618,12-02-2021 16:00,24 hrs.,RobinHoodPennyStocks,ASX,6,0,6,-6,1,1,0,1,NYSE
4618,12-02-2021 16:00,24 hrs.,RobinHoodPennyStocks,AUY,98,0,98,-98,1,29,36,1,NYSE
4618,12-02-2021 16:00,24 hrs.,RobinHoodPennyStocks,BBW,6,0,6,-6,1,1,0,1,NYSE
4618,12-02-2021 16:00,24 hrs.,RobinHoodPennyStocks,BTU,107,0,107,-107,1,39,25,1,NYSE
4618,12-02-2021 16:00,24 hrs.,RobinHoodPennyStocks,CCM,107,0,107,-107,1,39,25,1,NYSE
4618,12-02-2021 16:00,24 hrs.,RobinHoodPennyStocks,COO,98,0,98,-98,1,29,36,1,NYSE
4618,12-02-2021 16:00,24 hrs.,RobinHoodPennyStocks,CTK,107,0,107,-107,1,39,25,1,NYSE
4618,12-02-2021 16:00,24 hrs.,RobinHoodPennyStocks,DNK,6,0,6,-6,1,1,0,1,NYSE
4618,12-02-2021 16:00,24 hrs.,RobinHoodPennyStocks,FSR,107,0,107,-107,1,39,25,1,NYSE
4618,12-02-2021 16:00,24 hrs.,RobinHoodPennyStocks,GME,52,0,52,-52,2,8,28,2,NYSE
4618,12-02-2021 16:00,24 hrs.,RobinHoodPennyStocks,GSX,107,0,107,-107,1,39,25,1,NYSE
4618,12-02-2021 16:00,24 hrs.,RobinHoodPennyStocks,IRL,313,0,313,-313,1,148,13,1,NYSE
4618,12-02-2021 16:00,24 hrs.,RobinHoodPennyStocks,IVR,6,0,6,-6,1,1,0,1,NYSE
4618,12-02-2021 16:00,24 hrs.,RobinHoodPennyStocks,LOW,6,6,0,6,1,1,0,1,NYSE
4618,12-02-2021 16:00,24 hrs.,RobinHoodPennyStocks,LYG,6,0,6,-6,1,1,0,1,NYSE
4618,12-02-2021 16:00,24 hrs.,RobinHoodPennyStocks,NIO,107,0,107,-107,1,39,25,1,NYSE
4618,12-02-2021 16:00,24 hrs.,RobinHoodPennyStocks,PDT,119,0,119,-119,2,39,33,2,NYSE
4618,12-02-2021 16:00,24 hrs.,RobinHoodPennyStocks,PSA,54,0,54,-54,2,15,16,2,NYSE
4618,12-02-2021 16:00,24 hrs.,RobinHoodPennyStocks,RFP,107,0,107,-107,1,39,25,1,NYSE
4618,12-02-2021 16:00,24 hrs.,RobinHoodPennyStocks,SOS,204,43,161,-118,12,59,38,10,NYSE
4618,12-02-2021 16:00,24 hrs.,RobinHoodPennyStocks,SUZ,107,0,107,-107,1,39,25,1,NYSE
4618,12-02-2021 16:00,24 hrs.,RobinHoodPennyStocks,TAL,107,0,107,-107,1,39,25,1,NYSE
4618,12-02-2021 16:00,24 hrs.,RobinHoodPennyStocks,WEI,107,0,107,-107,1,39,25,1,NYSE
4618,12-02-2021 16:00,24 hrs.,RobinHoodPennyStocks,BABA,107,0,107,-107,1,39,25,1,NYSE
4618,12-02-2021 16:00,24 hrs.,RobinHoodPennyStocks,CCIV,36,36,0,36,1,9,14,1,NYSE
4618,12-02-2021 16:00,24 hrs.,RobinHoodPennyStocks,CEIX,107,0,107,-107,1,39,25,1,NYSE
4618,12-02-2021 16:00,24 hrs.,RobinHoodPennyStocks,CMCM,107,0,107,-107,1,39,25,1,NYSE
4618,12-02-2021 16:00,24 hrs.,RobinHoodPennyStocks,FUBO,113,0,113,-113,2,40,25,2,NYSE
4618,12-02-2021 16:00,24 hrs.,RobinHoodPennyStocks,LAIX,107,0,107,-107,1,39,25,1,NYSE
4618,12-02-2021 16:00,24 hrs.,RobinHoodPennyStocks,RLGY,107,0,107,-107,1,39,25,1,NYSE
4618,12-02-2021 16:00,24 hrs.,RobinHoodPennyStocks,XPEV,107,0,107,-107,1,39,25,1,NYSE
4618,12-02-2021 16:00,24 hrs.,RobinHoodPennyStocks,AIH,107,0,107,-107,1,39,25,1,NASDAQ
4618,12-02-2021 16:00,24 hrs.,RobinHoodPennyStocks,ENG,107,0,107,-107,1,39,25,1,NASDAQ
4618,12-02-2021 16:00,24 hrs.,RobinHoodPennyStocks,EVK,107,0,107,-107,1,39,25,1,NASDAQ
4618,12-02-2021 16:00,24 hrs.,RobinHoodPennyStocks,JFU,6,0,6,-6,1,1,0,1,NASDAQ
4618,12-02-2021 16:00,24 hrs.,RobinHoodPennyStocks,MGI,107,0,107,-107,1,39,25,1,NASDAQ
4618,12-02-2021 16:00,24 hrs.,RobinHoodPennyStocks,OCG,107,0,107,-107,1,39,25,1,NASDAQ
4618,12-02-2021 16:00,24 hrs.,RobinHoodPennyStocks,OEG,107,0,107,-107,1,39,25,1,NASDAQ
4618,12-02-2021 16:00,24 hrs.,RobinHoodPennyStocks,OGI,6,6,0,6,1,1,0,1,NASDAQ
4618,12-02-2021 16:00,24 hrs.,RobinHoodPennyStocks,PTE,39,0,39,-39,4,8,7,3,NASDAQ
4618,12-02-2021 16:00,24 hrs.,RobinHoodPennyStocks,QTT,107,0,107,-107,1,39,25,1,NASDAQ
4618,12-02-2021 16:00,24 hrs.,RobinHoodPennyStocks,SND,6,6,0,6,1,1,0,1,NASDAQ
4618,12-02-2021 16:00,24 hrs.,RobinHoodPennyStocks,SPI,107,0,107,-107,1,39,25,1,NASDAQ
4618,12-02-2021 16:00,24 hrs.,RobinHoodPennyStocks,WNW,107,0,107,-107,1,39,25,1,NASDAQ
4618,12-02-2021 16:00,24 hrs.,RobinHoodPennyStocks,WWR,107,0,107,-107,1,39,25,1,NASDAQ
4618,12-02-2021 16:00,24 hrs.,RobinHoodPennyStocks,AAOI,107,0,107,-107,1,39,25,1,NASDAQ
4618,12-02-2021 16:00,24 hrs.,RobinHoodPennyStocks,ABEO,136,0,136,-136,1,55,22,1,NASDAQ
4618,12-02-2021 16:00,24 hrs.,RobinHoodPennyStocks,ABIO,26,0,26,-26,1,3,16,1,NASDAQ
4618,12-02-2021 16:00,24 hrs.,RobinHoodPennyStocks,ACOR,107,0,107,-107,1,39,25,1,NASDAQ
4618,12-02-2021 16:00,24 hrs.,RobinHoodPennyStocks,ACRX,10,10,0,10,1,2,2,1,NASDAQ
4618,12-02-2021 16:00,24 hrs.,RobinHoodPennyStocks,ACST,6,6,0,6,1,1,0,1,NASDAQ
4618,12-02-2021 16:00,24 hrs.,RobinHoodPennyStocks,ADMA,41,0,41,-41,1,14,9,1,NASDAQ
4618,12-02-2021 16:00,24 hrs.,RobinHoodPennyStocks,ADXS,6,0,6,-6,1,1,0,1,NASDAQ
4618,12-02-2021 16:00,24 hrs.,RobinHoodPennyStocks,AEHR,107,0,107,-107,1,39,25,1,NASDAQ
4618,12-02-2021 16:00,24 hrs.,RobinHoodPennyStocks,AESE,6,0,6,-6,1,1,0,1,NASDAQ
4618,12-02-2021 16:00,24 hrs.,RobinHoodPennyStocks,AEZS,17,0,17,-17,1,2,9,1,NASDAQ
4618,12-02-2021 16:00,24 hrs.,RobinHoodPennyStocks,AGTC,2230,440,1790,-1350,31,788,530,30,NASDAQ
4618,12-02-2021 16:00,24 hrs.,RobinHoodPennyStocks,CBDL,6,0,6,-6,1,1,0,1,OTC
4618,12-02-2021 16:00,24 hrs.,RobinHoodPennyStocks,COMS,6,0,6,-6,1,1,0,1,OTC
4618,12-02-2021 16:00,24 hrs.,RobinHoodPennyStocks,CYTR,6,0,6,-6,1,1,0,1,OTC
4618,12-02-2021 16:00,24 hrs.,RobinHoodPennyStocks,DIGI,6,6,0,6,1,1,0,1,OTC
4618,12-02-2021 16:00,24 hrs.,RobinHoodPennyStocks,ETEK,6,0,6,-6,1,1,0,1,OTC
4618,12-02-2021 16:00,24 hrs.,RobinHoodPennyStocks,GLEC,6,6,0,6,1,1,0,1,OTC
4618,12-02-2021 16:00,24 hrs.,RobinHoodPennyStocks,GPFT,28,28,0,28,4,4,4,2,OTC
4618,12-02-2021 16:00,24 hrs.,RobinHoodPennyStocks,GTBP,21,0,21,-21,1,4,9,1,OTC
4618,12-02-2021 16:00,24 hrs.,RobinHoodPennyStocks,HCMC,54,6,48,-42,9,9,0,8,OTC
4618,12-02-2021 16:00,24 hrs.,RobinHoodPennyStocks,HQGE,6,0,6,-6,1,1,0,1,OTC
4618,12-02-2021 16:00,24 hrs.,RobinHoodPennyStocks,INOH,6,0,6,-6,1,1,0,1,OTC
4618,12-02-2021 16:00,24 hrs.,RobinHoodPennyStocks,LTUM,6,6,0,6,1,1,0,1,OTC
4618,12-02-2021 16:00,24 hrs.,RobinHoodPennyStocks,MCOA,6,0,6,-6,1,1,0,1,OTC
4618,12-02-2021 16:00,24 hrs.,RobinHoodPennyStocks,MJNA,6,6,0,6,1,1,0,1,OTC
4618,12-02-2021 16:00,24 hrs.,RobinHoodPennyStocks,NUGS,6,0,6,-6,1,1,0,1,OTC
4618,12-02-2021 16:00,24 hrs.,RobinHoodPennyStocks,NWPN,8,0,8,-8,1,0,4,1,OTC
4618,12-02-2021 16:00,24 hrs.,RobinHoodPennyStocks,OPTI,6,0,6,-6,1,1,0,1,OTC
4618,12-02-2021 16:00,24 hrs.,RobinHoodPennyStocks,PHIL,6,0,6,-6,1,1,0,1,OTC
4618,12-02-2021 16:00,24 hrs.,RobinHoodPennyStocks,QTMM,6,0,6,-6,1,1,0,1,OTC
4618,12-02-2021 16:00,24 hrs.,RobinHoodPennyStocks,SGMD,20,0,20,-20,1,4,8,1,OTC
4618,12-02-2021 16:00,24 hrs.,RobinHoodPennyStocks,SRMX,6,0,6,-6,1,1,0,1,OTC
4618,12-02-2021 16:00,24 hrs.,RobinHoodPennyStocks,SUIC,6,0,6,-6,1,1,0,1,OTC
4618,12-02-2021 16:00,24 hrs.,RobinHoodPennyStocks,TLSS,6,0,6,-6,1,1,0,1,OTC
4618,12-02-2021 16:00,24 hrs.,RobinHoodPennyStocks,VPRB,6,0,6,-6,1,1,0,1,OTC
4618,12-02-2021 16:00,24 hrs.,RobinHoodPennyStocks,ABEPF,8,0,8,-8,1,0,4,1,OTC
4618,12-02-2021 16:00,24 hrs.,RobinHoodPennyStocks,BDRBF,209,12,197,-185,13,49,59,13,OTC
4618,12-02-2021 16:00,24 hrs.,RobinHoodPennyStocks,HITIF,12,0,12,-12,2,2,0,2,OTC
4618,12-02-2021 16:00,24 hrs.,RobinHoodPennyStocks,MZDAY,24,0,24,-24,1,5,10,1,OTC
4618,12-02-2021 16:00,24 hrs.,RobinHoodPennyStocks,PLNHF,6,0,6,-6,1,1,0,1,OTC
4618,12-02-2021 16:00,24 hrs.,RobinHoodPennyStocks,PMEDF,6,6,0,6,1,1,0,1,OTC
4618,12-02-2021 16:00,24 hrs.,RobinHoodPennyStocks,RYCEY,6,6,0,6,1,1,0,1,OTC
4618,12-02-2021 16:00,24 hrs.,RobinHoodPennyStocks,SHCAY,12,12,0,12,1,4,0,1,OTC
4618,12-02-2021 16:00,24 hrs.,RobinHoodPennyStocks,TLOFF,6,0,6,-6,1,1,0,1,OTC
4618,12-02-2021 16:00,24 hrs.,RobinHoodPennyStocks,VRYYF,6,0,6,-6,1,1,0,1,OTC
4618,12-02-2021 16:00,24 hrs.,RobinHoodPennyStocks,AAU,107,0,107,-107,1,39,25,1,AMEX
4618,12-02-2021 16:00,24 hrs.,RobinHoodPennyStocks,CEI,6,0,6,-6,1,1,0,1,AMEX
4618,12-02-2021 16:00,24 hrs.,RobinHoodPennyStocks,DNN,587,0,587,-587,10,196,155,9,AMEX
4618,12-02-2021 16:00,24 hrs.,RobinHoodPennyStocks,DPW,107,0,107,-107,1,39,25,1,AMEX
4618,12-02-2021 16:00,24 hrs.,RobinHoodPennyStocks,GSV,176,6,170,-164,3,51,62,3,AMEX
4618,12-02-2021 16:00,24 hrs.,RobinHoodPennyStocks,GTE,875,459,416,43,25,267,241,23,AMEX
4618,12-02-2021 16:00,24 hrs.,RobinHoodPennyStocks,ITP,7,0,7,-7,1,1,1,1,AMEX
4618,12-02-2021 16:00,24 hrs.,RobinHoodPennyStocks,KIQ,17,0,17,-17,1,0,13,1,AMEX
4618,12-02-2021 16:00,24 hrs.,RobinHoodPennyStocks,NAK,158,12,146,-134,6,51,32,6,AMEX
4618,12-02-2021 16:00,24 hrs.,RobinHoodPennyStocks,PLM,42,0,42,-42,1,16,6,1,AMEX
4618,12-02-2021 16:00,24 hrs.,RobinHoodPennyStocks,PTN,18,0,18,-18,1,4,6,1,AMEX
4618,12-02-2021 16:00,24 hrs.,RobinHoodPennyStocks,RHE,107,0,107,-107,1,39,25,1,AMEX
4618,12-02-2021 16:00,24 hrs.,RobinHoodPennyStocks,SSY,6,0,6,-6,1,1,0,1,AMEX
4618,12-02-2021 16:00,24 hrs.,RobinHoodPennyStocks,SYN,6,0,6,-6,1,1,0,1,AMEX
4618,12-02-2021 16:00,24 hrs.,RobinHoodPennyStocks,TGB,105,92,13,79,3,38,17,3,AMEX
4618,12-02-2021 16:00,24 hrs.,RobinHoodPennyStocks,TRT,107,0,107,-107,1,39,25,1,AMEX
4618,12-02-2021 16:00,24 hrs.,RobinHoodPennyStocks,TRX,236,31,205,-174,3,74,76,3,AMEX
4618,12-02-2021 16:00,24 hrs.,RobinHoodPennyStocks,XPL,107,0,107,-107,1,39,25,1,AMEX
4618,12-02-2021 16:00,24 hrs.,RobinHoodPennyStocks,ZOM,1099,394,705,-311,16,306,423,16,AMEX
4618,12-02-2021 16:00,24 hrs.,RobinHoodPennyStocks,AMBO,107,0,107,-107,1,39,25,1,AMEX
4618,12-02-2021 16:00,24 hrs.,RobinHoodPennyStocks,AUMN,211,0,211,-211,3,69,61,3,AMEX
4618,12-02-2021 16:00,24 hrs.,RobinHoodPennyStocks,GSAT,25,0,25,-25,1,5,11,1,AMEX
4618,12-02-2021 16:00,24 hrs.,RobinHoodPennyStocks,NSPR,22,15,7,8,2,3,8,2,AMEX
4618,12-02-2021 16:00,24 hrs.,RobinHoodPennyStocks,OGEN,18,18,0,18,3,3,0,3,AMEX
4618,12-02-2021 16:00,24 hrs.,RobinHoodPennyStocks,PLAG,107,0,107,-107,1,39,25,1,AMEX
4618,12-02-2021 16:00,24 hrs.,RobinHoodPennyStocks,SMTS,6,6,0,6,1,1,0,1,AMEX
4618,12-02-2021 16:00,24 hrs.,wallstreetbets,VRAY,6,0,6,-6,1,1,0,1,NASDAQ
4618,12-02-2021 16:00,24 hrs.,wallstreetbets,VRSN,322,322,0,322,1,123,72,1,NASDAQ
4618,12-02-2021 16:00,24 hrs.,wallstreetbets,VUZI,15,0,15,-15,2,2,3,2,NASDAQ
4618,12-02-2021 16:00,24 hrs.,wallstreetbets,VXRT,13,13,0,13,2,2,1,2,NASDAQ
4618,12-02-2021 16:00,24 hrs.,wallstreetbets,VYNE,7,0,7,-7,1,1,1,1,NASDAQ
4618,12-02-2021 16:00,24 hrs.,wallstreetbets,WATT,68,0,68,-68,9,11,10,4,NASDAQ
4618,12-02-2021 16:00,24 hrs.,wallstreetbets,WKHS,90,0,90,-90,3,23,32,2,NASDAQ
4618,12-02-2021 16:00,24 hrs.,wallstreetbets,WTER,7,0,7,-7,1,1,1,1,NASDAQ
4618,12-02-2021 16:00,24 hrs.,wallstreetbets,XERS,15,15,0,15,2,2,3,2,NASDAQ
4618,12-02-2021 16:00,24 hrs.,wallstreetbets,XSPA,77,34,43,-9,12,12,5,11,NASDAQ
4618,12-02-2021 16:00,24 hrs.,wallstreetbets,YNDX,451,0,451,-451,1,170,107,1,NASDAQ
4618,12-02-2021 16:00,24 hrs.,wallstreetbets,ZNGA,31,7,24,-17,5,5,1,4,NASDAQ
4618,12-02-2021 16:00,24 hrs.,wallstreetbets,ZSAN,6,0,6,-6,1,1,0,1,NASDAQ
4618,12-02-2021 16:00,24 hrs.,wallstreetbets,ZYNE,19,7,12,-5,3,3,1,3,NASDAQ
4618,12-02-2021 16:00,24 hrs.,RobinHoodPennyStocks,AHFD,6,0,6,-6,1,1,0,1,OTC
4618,12-02-2021 16:00,24 hrs.,RobinHoodPennyStocks,AITX,13,0,13,-13,1,1,7,1,OTC
4618,12-02-2021 16:00,24 hrs.,RobinHoodPennyStocks,AZFL,6,6,0,6,1,0,2,1,OTC
4618,12-02-2021 16:00,24 hrs.,RobinHoodPennyStocks,BNGI,12,0,12,-12,2,2,0,2,OTC
4618,12-02-2021 16:00,24 hrs.,RobinHoodPennyStocks,CAPS,6,6,0,6,1,1,0,1,OTC
4618,12-02-2021 16:00,24 hrs.,RobinHoodPennyStocks,CBDD,6,6,0,6,1,1,0,1,OTC
4618,12-02-2021 16:00,24 hrs.,pennystocks,CKPT,70,6,64,-58,4,25,4,3,NASDAQ
4618,12-02-2021 16:00,24 hrs.,pennystocks,CLBS,7,0,7,-7,1,1,1,1,NASDAQ
4618,12-02-2021 16:00,24 hrs.,pennystocks,CLEU,7,7,0,7,1,1,1,1,NASDAQ
4618,12-02-2021 16:00,24 hrs.,pennystocks,CMPS,209,0,209,-209,2,85,31,2,NASDAQ
4618,12-02-2021 16:00,24 hrs.,pennystocks,CPLP,7,7,0,7,1,1,1,1,NASDAQ
4618,12-02-2021 16:00,24 hrs.,pennystocks,CRBP,117,0,117,-117,1,47,19,1,NASDAQ
4618,12-02-2021 16:00,24 hrs.,pennystocks,CRSR,52,0,52,-52,1,14,20,1,NASDAQ
4618,12-02-2021 16:00,24 hrs.,pennystocks,CTRM,386,37,349,-312,24,105,80,18,NASDAQ
4618,12-02-2021 16:00,24 hrs.,pennystocks,CTXR,6,0,6,-6,1,1,0,1,NASDAQ
4618,12-02-2021 16:00,24 hrs.,pennystocks,DFFN,80,80,0,80,2,29,14,2,NASDAQ
4618,12-02-2021 16:00,24 hrs.,pennystocks,DGLY,35,0,35,-35,5,5,5,1,NASDAQ
4618,12-02-2021 16:00,24 hrs.,pennystocks,DYNT,52,0,52,-52,1,22,4,1,NASDAQ
4618,12-02-2021 16:00,24 hrs.,pennystocks,EBON,6,0,6,-6,1,1,0,1,NASDAQ
4618,12-02-2021 16:00,24 hrs.,pennystocks,EDIT,137,0,137,-137,2,51,27,2,NASDAQ
4618,12-02-2021 16:00,24 hrs.,pennystocks,ENPH,90,0,90,-90,1,16,54,1,NASDAQ
4618,12-02-2021 16:00,24 hrs.,pennystocks,ENTX,19,19,0,19,1,6,3,1,NASDAQ
4618,12-02-2021 16:00,24 hrs.,pennystocks,ENVB,6,6,0,6,1,1,0,1,NASDAQ
4618,12-02-2021 16:00,24 hrs.,pennystocks,EVFM,6,0,6,-6,1,1,0,1,NASDAQ
4618,12-02-2021 16:00,24 hrs.,pennystocks,FAMI,7,7,0,7,1,1,1,1,NASDAQ
4618,12-02-2021 16:00,24 hrs.,pennystocks,FATE,17,17,0,17,1,6,1,1,NASDAQ
4618,12-02-2021 16:00,24 hrs.,pennystocks,FCEL,90,0,90,-90,1,16,54,1,NASDAQ
4618,12-02-2021 16:00,24 hrs.,pennystocks,GEVO,57,0,57,-57,3,13,19,2,NASDAQ
4618,12-02-2021 16:00,24 hrs.,pennystocks,GHSI,114,6,108,-102,2,42,22,2,NASDAQ
4618,12-02-2021 16:00,24 hrs.,pennystocks,GLBS,18,0,18,-18,1,0,14,1,NASDAQ
4618,12-02-2021 16:00,24 hrs.,pennystocks,GOEV,27,27,0,27,1,8,7,1,NASDAQ
4618,12-02-2021 16:00,24 hrs.,pennystocks,GOLD,12,0,12,-12,2,2,0,2,NASDAQ
4618,12-02-2021 16:00,24 hrs.,pennystocks,GRIL,49,0,49,-49,2,15,11,2,NASDAQ
4618,12-02-2021 16:00,24 hrs.,pennystocks,GRNQ,52,0,52,-52,1,22,4,1,NASDAQ
4618,12-02-2021 16:00,24 hrs.,pennystocks,HALO,6,0,6,-6,1,1,0,1,NASDAQ
4618,12-02-2021 16:00,24 hrs.,pennystocks,HRTX,13,13,0,13,1,2,5,1,NASDAQ
4618,12-02-2021 16:00,24 hrs.,pennystocks,HSTO,12,12,0,12,2,2,0,2,NASDAQ
4618,12-02-2021 16:00,24 hrs.,pennystocks,IFMK,95,0,95,-95,2,36,15,2,NASDAQ
4618,12-02-2021 16:00,24 hrs.,pennystocks,INFI,52,0,52,-52,1,22,4,1,NASDAQ
4618,12-02-2021 16:00,24 hrs.,pennystocks,INFO,6,0,6,-6,1,0,2,1,NASDAQ
4618,12-02-2021 16:00,24 hrs.,pennystocks,INPX,92,0,92,-92,7,28,8,6,NASDAQ
4618,12-02-2021 16:00,24 hrs.,pennystocks,IRDM,17,17,0,17,1,6,1,1,NASDAQ
4618,12-02-2021 16:00,24 hrs.,pennystocks,JAGX,6,0,6,-6,1,1,0,1,NASDAQ
4618,12-02-2021 16:00,24 hrs.,pennystocks,KTRA,106,106,0,106,3,35,24,3,NASDAQ
4618,12-02-2021 16:00,24 hrs.,pennystocks,KXIN,17,17,0,17,1,6,1,1,NASDAQ
4618,12-02-2021 16:00,24 hrs.,pennystocks,LKCO,80,9,71,-62,5,27,6,4,NASDAQ
4618,12-02-2021 16:00,24 hrs.,pennystocks,LPCN,45,45,0,45,1,15,11,1,NASDAQ
4618,12-02-2021 16:00,24 hrs.,pennystocks,MARK,90,0,90,-90,1,16,54,1,NASDAQ
4618,12-02-2021 16:00,24 hrs.,pennystocks,MDGS,6,6,0,6,1,1,0,1,NASDAQ
4618,12-02-2021 16:00,24 hrs.,pennystocks,MOGO,28,0,28,-28,3,2,12,1,NASDAQ
4618,12-02-2021 16:00,24 hrs.,pennystocks,MOSY,52,0,52,-52,1,22,4,1,NASDAQ
4618,12-02-2021 16:00,24 hrs.,pennystocks,BORR,6,0,6,-6,1,1,0,1,NYSE
4618,12-02-2021 16:00,24 hrs.,pennystocks,HEXO,24,24,0,24,1,3,14,1,NYSE
4618,12-02-2021 16:00,24 hrs.,pennystocks,HYLN,19,0,19,-19,3,3,1,2,NYSE
4618,12-02-2021 16:00,24 hrs.,pennystocks,NOVA,203,0,203,-203,1,84,31,1,NYSE
4618,12-02-2021 16:00,24 hrs.,pennystocks,VIST,12,12,0,12,1,2,4,1,NYSE
4618,12-02-2021 16:00,24 hrs.,pennystocks,AQB,6,0,6,-6,1,1,0,1,NASDAQ
4618,12-02-2021 16:00,24 hrs.,pennystocks,AZN,28,0,28,-28,1,5,14,1,NASDAQ
4618,12-02-2021 16:00,24 hrs.,pennystocks,BBI,49,49,0,49,1,18,9,1,NASDAQ
4618,12-02-2021 16:00,24 hrs.,pennystocks,CFO,35,0,35,-35,1,10,11,1,NASDAQ
4618,12-02-2021 16:00,24 hrs.,pennystocks,KOD,6,6,0,6,1,1,0,1,NASDAQ
4618,12-02-2021 16:00,24 hrs.,pennystocks,MFH,52,0,52,-52,1,22,4,1,NASDAQ
4618,12-02-2021 16:00,24 hrs.,pennystocks,MKD,22,22,0,22,1,6,6,1,NASDAQ
4618,12-02-2021 16:00,24 hrs.,pennystocks,MYT,12,12,0,12,1,1,6,1,NASDAQ
4618,12-02-2021 16:00,24 hrs.,pennystocks,NEO,203,0,203,-203,1,84,31,1,NASDAQ
4618,12-02-2021 16:00,24 hrs.,pennystocks,OGI,14,7,7,0,2,2,2,2,NASDAQ
4618,12-02-2021 16:00,24 hrs.,pennystocks,UFO,6,6,0,6,1,1,0,1,NASDAQ
4618,12-02-2021 16:00,24 hrs.,pennystocks,ABEO,12,0,12,-12,2,2,0,2,NASDAQ
4618,12-02-2021 16:00,24 hrs.,pennystocks,ABIO,28,0,28,-28,2,8,4,2,NASDAQ
4618,12-02-2021 16:00,24 hrs.,pennystocks,ACST,13,13,0,13,2,2,1,2,NASDAQ
4618,12-02-2021 16:00,24 hrs.,pennystocks,ADTX,25,0,25,-25,1,4,13,1,NASDAQ
4618,12-02-2021 16:00,24 hrs.,pennystocks,ADXS,13,0,13,-13,2,2,1,2,NASDAQ
4618,12-02-2021 16:00,24 hrs.,pennystocks,AGTC,603,14,589,-575,7,247,81,7,NASDAQ
4618,12-02-2021 16:00,24 hrs.,pennystocks,AKBA,14,0,14,-14,2,3,0,1,NASDAQ
4618,12-02-2021 16:00,24 hrs.,pennystocks,ALRN,20,0,20,-20,1,3,10,1,NASDAQ
4618,12-02-2021 16:00,24 hrs.,pennystocks,ANDA,17,0,17,-17,1,0,13,1,NASDAQ
4618,12-02-2021 16:00,24 hrs.,pennystocks,APHA,6,6,0,6,1,1,0,1,NASDAQ
4618,12-02-2021 16:00,24 hrs.,pennystocks,ARTL,24,24,0,24,4,4,0,2,NASDAQ
4618,12-02-2021 16:00,24 hrs.,pennystocks,ASRT,953,947,6,941,13,362,177,7,NASDAQ
4618,12-02-2021 16:00,24 hrs.,pennystocks,ATOS,292,40,252,-212,5,97,78,5,NASDAQ
4618,12-02-2021 16:00,24 hrs.,pennystocks,AVXL,7,0,7,-7,1,1,1,1,NASDAQ
4618,12-02-2021 16:00,24 hrs.,pennystocks,AZRX,9,0,9,-9,1,1,3,1,NASDAQ
4618,12-02-2021 16:00,24 hrs.,pennystocks,BBIG,6,0,6,-6,1,1,0,1,NASDAQ
4618,12-02-2021 16:00,24 hrs.,pennystocks,BHTG,7,0,7,-7,1,1,1,1,NASDAQ
4618,12-02-2021 16:00,24 hrs.,pennystocks,BKEP,12,0,12,-12,1,2,4,1,NASDAQ
4618,12-02-2021 16:00,24 hrs.,pennystocks,BLCM,52,0,52,-52,1,22,4,1,NASDAQ
4618,12-02-2021 16:00,24 hrs.,pennystocks,BNGO,17,17,0,17,1,6,1,1,NASDAQ
4618,12-02-2021 16:00,24 hrs.,pennystocks,BRQS,66,0,66,-66,1,21,20,1,NASDAQ
4618,12-02-2021 16:00,24 hrs.,pennystocks,BVXV,7,0,7,-7,1,1,1,1,NASDAQ
4618,12-02-2021 16:00,24 hrs.,pennystocks,CAPR,6,0,6,-6,1,1,0,1,NASDAQ
4618,12-02-2021 16:00,24 hrs.,pennystocks,CIDM,50,43,7,36,2,9,24,2,NASDAQ
4618,12-02-2021 16:00,24 hrs.,pennystocks,CJJD,52,0,52,-52,1,22,4,1,NASDAQ
4618,12-02-2021 16:00,24 hrs.,pennystocks,CTK,52,0,52,-52,1,22,4,1,NYSE
4618,12-02-2021 16:00,24 hrs.,pennystocks,CVE,38,18,20,-2,5,8,2,3,NYSE
4618,12-02-2021 16:00,24 hrs.,pennystocks,CVX,23,23,0,23,1,6,7,1,NYSE
4618,12-02-2021 16:00,24 hrs.,pennystocks,FLT,13,0,13,-13,2,2,1,2,NYSE
4618,12-02-2021 16:00,24 hrs.,pennystocks,GME,55,6,49,-43,9,9,1,8,NYSE
4618,12-02-2021 16:00,24 hrs.,pennystocks,LEE,117,0,117,-117,2,17,75,2,NYSE
4618,12-02-2021 16:00,24 hrs.,pennystocks,MUX,6,0,6,-6,1,1,0,1,NYSE
4618,12-02-2021 16:00,24 hrs.,pennystocks,NAT,7,7,0,7,1,1,1,1,NYSE
4618,12-02-2021 16:00,24 hrs.,pennystocks,NOK,64,0,64,-64,3,16,20,2,NYSE
4618,12-02-2021 16:00,24 hrs.,pennystocks,PHI,6,0,6,-6,1,1,0,1,NYSE
4618,12-02-2021 16:00,24 hrs.,pennystocks,PSA,625,0,625,-625,4,281,47,4,NYSE
4618,12-02-2021 16:00,24 hrs.,pennystocks,RKT,27,27,0,27,1,8,7,1,NYSE
4618,12-02-2021 16:00,24 hrs.,pennystocks,RSI,33,0,33,-33,3,8,5,3,NYSE
4618,12-02-2021 16:00,24 hrs.,pennystocks,SAP,203,0,203,-203,1,84,31,1,NYSE
4618,12-02-2021 16:00,24 hrs.,pennystocks,SOS,18,6,12,-6,3,2,2,3,NYSE
4618,12-02-2021 16:00,24 hrs.,pennystocks,TDA,26,0,26,-26,1,4,14,1,NYSE
4618,12-02-2021 16:00,24 hrs.,pennystocks,THC,294,0,294,-294,2,118,50,2,NYSE
4618,12-02-2021 16:00,24 hrs.,pennystocks,TKR,15,0,15,-15,1,4,3,1,NYSE
4618,12-02-2021 16:00,24 hrs.,pennystocks,TTI,12,0,12,-12,2,2,0,1,NYSE
4618,12-02-2021 16:00,24 hrs.,pennystocks,VET,9,0,9,-9,1,2,1,1,NYSE
4618,12-02-2021 16:00,24 hrs.,pennystocks,WEI,17,17,0,17,1,6,1,1,NYSE
4618,12-02-2021 16:00,24 hrs.,pennystocks,WLL,6,6,0,6,1,1,0,1,NYSE
4618,12-02-2021 16:00,24 hrs.,pennystocks,WWE,7,7,0,7,1,1,1,1,NYSE
4618,12-02-2021 16:00,24 hrs.,pennystocks,AQUA,7,0,7,-7,1,1,1,1,NYSE
4618,12-02-2021 16:00,24 hrs.,pennystocks,ARGO,24,24,0,24,1,4,12,1,NYSE
4618,12-02-2021 16:00,24 hrs.,pennystocks,RACMF,14,0,14,-14,1,4,2,1,OTC
4618,12-02-2021 16:00,24 hrs.,pennystocks,RLFTF,12,6,6,0,2,2,0,2,OTC
4618,12-02-2021 16:00,24 hrs.,pennystocks,RLLCF,32,25,7,18,5,5,2,5,OTC
4618,12-02-2021 16:00,24 hrs.,pennystocks,RVVTF,247,0,247,-247,2,90,59,2,OTC
4618,12-02-2021 16:00,24 hrs.,pennystocks,RWBYF,7,0,7,-7,1,1,1,1,OTC
4618,12-02-2021 16:00,24 hrs.,pennystocks,RYCEY,6,0,6,-6,1,1,0,1,OTC
4618,12-02-2021 16:00,24 hrs.,pennystocks,RYMDF,28,0,28,-28,1,9,6,1,OTC
4618,12-02-2021 16:00,24 hrs.,pennystocks,SBSAA,5,0,5,-5,1,0,1,1,OTC
4618,12-02-2021 16:00,24 hrs.,pennystocks,SHRMF,203,0,203,-203,1,84,31,1,OTC
4618,12-02-2021 16:00,24 hrs.,pennystocks,SNNAF,9,9,0,9,1,2,1,1,OTC
4618,12-02-2021 16:00,24 hrs.,pennystocks,SORHF,8,0,8,-8,1,1,2,1,OTC
4618,12-02-2021 16:00,24 hrs.,pennystocks,SPFYF,9,9,0,9,1,1,3,1,OTC
4618,12-02-2021 16:00,24 hrs.,pennystocks,SPLIF,24,0,24,-24,4,4,0,3,OTC
4618,12-02-2021 16:00,24 hrs.,pennystocks,SPMTF,14,14,0,14,1,1,8,1,OTC
4618,12-02-2021 16:00,24 hrs.,pennystocks,SPRWF,2093,276,1817,-1541,11,899,251,10,OTC
4618,12-02-2021 16:00,24 hrs.,pennystocks,TAKOF,357,0,357,-357,4,134,73,2,OTC
4618,12-02-2021 16:00,24 hrs.,pennystocks,TFECF,4,0,4,-4,1,0,0,1,OTC
4618,12-02-2021 16:00,24 hrs.,pennystocks,TFECY,4,0,4,-4,1,0,0,1,OTC
4618,12-02-2021 16:00,24 hrs.,pennystocks,TLOFF,75,0,75,-75,3,18,27,2,OTC
4618,12-02-2021 16:00,24 hrs.,pennystocks,TRUFF,203,0,203,-203,1,84,31,1,OTC
4618,12-02-2021 16:00,24 hrs.,pennystocks,TSCRF,27,0,27,-27,1,8,7,1,OTC
4618,12-02-2021 16:00,24 hrs.,pennystocks,TSKFF,39,0,39,-39,1,13,9,1,OTC
4618,12-02-2021 16:00,24 hrs.,pennystocks,TTTSF,12,0,12,-12,2,2,0,2,OTC
4618,12-02-2021 16:00,24 hrs.,pennystocks,VRNDF,14,14,0,14,1,3,4,1,OTC
4618,12-02-2021 16:00,24 hrs.,pennystocks,XELAW,129,129,0,129,1,56,13,1,OTC
4618,12-02-2021 16:00,24 hrs.,pennystocks,ZBISF,31,25,6,19,2,9,5,2,OTC
4618,12-02-2021 16:00,24 hrs.,pennystocks,AIM,8,8,0,8,1,1,2,1,AMEX
4618,12-02-2021 16:00,24 hrs.,pennystocks,APT,12,0,12,-12,2,2,0,1,AMEX
4618,12-02-2021 16:00,24 hrs.,pennystocks,CTO,40,22,18,4,4,4,16,2,AMEX
4618,12-02-2021 16:00,24 hrs.,pennystocks,DNN,392,19,373,-354,9,119,118,6,AMEX
4618,12-02-2021 16:00,24 hrs.,pennystocks,DPW,6,0,6,-6,1,1,0,1,AMEX
4618,12-02-2021 16:00,24 hrs.,pennystocks,DSS,11,0,11,-11,1,0,7,1,AMEX
4618,12-02-2021 16:00,24 hrs.,pennystocks,GPL,35,0,35,-35,1,13,5,1,AMEX
4618,12-02-2021 16:00,24 hrs.,pennystocks,GSV,24,0,24,-24,4,4,0,3,AMEX
4618,12-02-2021 16:00,24 hrs.,pennystocks,GTE,14,7,7,0,2,2,2,2,AMEX
4618,12-02-2021 16:00,24 hrs.,pennystocks,ITP,31,31,0,31,2,3,17,2,AMEX
4618,12-02-2021 16:00,24 hrs.,pennystocks,LNG,11,0,11,-11,1,3,1,1,AMEX
4618,12-02-2021 16:00,24 hrs.,pennystocks,MXC,7,7,0,7,1,1,1,1,AMEX
4618,12-02-2021 16:00,24 hrs.,pennystocks,NAK,12,0,12,-12,2,2,0,2,AMEX
4618,12-02-2021 16:00,24 hrs.,pennystocks,NBY,21,0,21,-21,1,5,7,1,AMEX
4618,12-02-2021 16:00,24 hrs.,pennystocks,NHS,17,0,17,-17,1,0,13,1,AMEX
4618,12-02-2021 16:00,24 hrs.,pennystocks,PTN,22,22,0,22,1,6,6,1,AMEX
4618,12-02-2021 16:00,24 hrs.,pennystocks,SIM,6,0,6,-6,1,1,0,1,AMEX
4618,12-02-2021 16:00,24 hrs.,pennystocks,TGC,52,0,52,-52,1,22,4,1,AMEX
4618,12-02-2021 16:00,24 hrs.,pennystocks,TRX,28,15,13,2,4,4,4,4,AMEX
4618,12-02-2021 16:00,24 hrs.,pennystocks,WRN,6,0,6,-6,1,1,0,1,AMEX
4618,12-02-2021 16:00,24 hrs.,pennystocks,ZOM,175,136,39,97,6,59,33,6,AMEX
4618,12-02-2021 16:00,24 hrs.,pennystocks,GSAT,6,0,6,-6,1,1,0,1,AMEX
4618,12-02-2021 16:00,24 hrs.,pennystocks,INUV,56,56,0,56,1,19,14,1,AMEX
4618,12-02-2021 16:00,24 hrs.,pennystocks,SENS,35,0,35,-35,1,14,3,1,AMEX
4618,12-02-2021 16:00,24 hrs.,pennystocks,TMBR,52,0,52,-52,1,22,4,1,AMEX
4618,12-02-2021 16:00,24 hrs.,pennystocks,TRXC,12,12,0,12,2,2,0,2,AMEX
4618,12-02-2021 16:00,24 hrs.,pennystocks,UAVS,49,49,0,49,1,17,11,1,AMEX
4618,12-02-2021 16:00,24 hrs.,pennystocks,UUUU,6,0,6,-6,1,1,0,1,AMEX
4618,12-02-2021 16:00,24 hrs.,pennystocks,AHT,6,6,0,6,1,1,0,1,NYSE
4618,12-02-2021 16:00,24 hrs.,pennystocks,AMC,91,65,26,39,8,15,29,7,NYSE
4618,12-02-2021 16:00,24 hrs.,pennystocks,ASX,30,24,6,18,5,5,0,3,NYSE
4618,12-02-2021 16:00,24 hrs.,pennystocks,ATH,10,10,0,10,1,2,2,1,NYSE
4618,12-02-2021 16:00,24 hrs.,pennystocks,AUY,6,0,6,-6,1,1,0,1,NYSE
4618,12-02-2021 16:00,24 hrs.,pennystocks,BIO,275,275,0,275,1,118,35,1,NYSE
4618,12-02-2021 16:00,24 hrs.,pennystocks,BTU,6,6,0,6,1,1,0,1,NYSE
4618,12-02-2021 16:00,24 hrs.,pennystocks,CBD,307,15,292,-277,10,108,51,8,NYSE
4618,12-02-2021 16:00,24 hrs.,pennystocks,CMO,35,0,35,-35,1,10,11,1,NYSE
4618,12-02-2021 16:00,24 hrs.,pennystocks,CRL,6,0,6,-6,1,1,0,1,NYSE
4618,12-02-2021 16:00,24 hrs.,pennystocks,QYOUF,6,6,0,6,1,1,0,1,OTC
4618,12-02-2021 16:00,24 hrs.,pennystocks,WTII,41,41,0,41,1,13,11,1,OTC
4618,12-02-2021 16:00,24 hrs.,pennystocks,XMET,8,8,0,8,1,0,4,1,OTC
4618,12-02-2021 16:00,24 hrs.,pennystocks,XTRM,6,0,6,-6,1,1,0,1,OTC
4618,12-02-2021 16:00,24 hrs.,pennystocks,ZAAG,6,0,6,-6,1,1,0,1,OTC
4618,12-02-2021 16:00,24 hrs.,pennystocks,ZPAS,12,6,6,0,2,2,0,2,OTC
4618,12-02-2021 16:00,24 hrs.,pennystocks,ABEPF,74,0,74,-74,3,18,26,3,OTC
4618,12-02-2021 16:00,24 hrs.,pennystocks,ALLIF,103,103,0,103,1,30,39,1,OTC
4618,12-02-2021 16:00,24 hrs.,pennystocks,AQSZF,35,0,35,-35,1,12,7,1,OTC
4618,12-02-2021 16:00,24 hrs.,pennystocks,ARBKF,154,30,124,-94,3,37,68,3,OTC
4618,12-02-2021 16:00,24 hrs.,pennystocks,BDRBF,48,0,48,-48,1,14,16,1,OTC
4618,12-02-2021 16:00,24 hrs.,pennystocks,BKLLF,27,27,0,27,1,8,7,1,OTC
4618,12-02-2021 16:00,24 hrs.,pennystocks,BRPHF,24,24,0,24,1,4,12,1,OTC
4618,12-02-2021 16:00,24 hrs.,pennystocks,CANSF,5,5,0,5,1,0,1,1,OTC
4618,12-02-2021 16:00,24 hrs.,pennystocks,CBULF,6,6,0,6,1,1,0,1,OTC
4618,12-02-2021 16:00,24 hrs.,pennystocks,CBWTF,6,0,6,-6,1,1,0,1,OTC
4618,12-02-2021 16:00,24 hrs.,pennystocks,CCIHY,117,0,117,-117,1,47,19,1,OTC
4618,12-02-2021 16:00,24 hrs.,pennystocks,CNIKF,63,0,63,-63,1,16,27,1,OTC
4618,12-02-2021 16:00,24 hrs.,pennystocks,COCSF,6,0,6,-6,1,1,0,1,OTC
4618,12-02-2021 16:00,24 hrs.,pennystocks,CPHRF,35,0,35,-35,1,10,11,1,OTC
4618,12-02-2021 16:00,24 hrs.,pennystocks,CRLBF,24,24,0,24,1,3,14,1,OTC
4618,12-02-2021 16:00,24 hrs.,pennystocks,CXXIF,6,0,6,-6,1,1,0,1,OTC
4618,12-02-2021 16:00,24 hrs.,pennystocks,DFLYF,46,0,46,-46,1,16,10,1,OTC
4618,12-02-2021 16:00,24 hrs.,pennystocks,DFODQ,21,21,0,21,1,4,9,1,OTC
4618,12-02-2021 16:00,24 hrs.,pennystocks,DMGGF,24,24,0,24,1,4,12,1,OTC
4618,12-02-2021 16:00,24 hrs.,pennystocks,EHVVF,203,0,203,-203,1,84,31,1,OTC
4618,12-02-2021 16:00,24 hrs.,pennystocks,ELRRF,6,6,0,6,1,1,0,1,OTC
4618,12-02-2021 16:00,24 hrs.,pennystocks,ENTBF,203,0,203,-203,1,84,31,1,OTC
4618,12-02-2021 16:00,24 hrs.,pennystocks,FIORF,8,8,0,8,1,1,2,1,OTC
4618,12-02-2021 16:00,24 hrs.,pennystocks,FLWPF,24,17,7,10,2,3,10,2,OTC
4618,12-02-2021 16:00,24 hrs.,pennystocks,FTRPF,203,0,203,-203,1,84,31,1,OTC
4618,12-02-2021 16:00,24 hrs.,pennystocks,FUNFF,33,0,33,-33,1,7,15,1,OTC
4618,12-02-2021 16:00,24 hrs.,pennystocks,GBOKF,203,0,203,-203,1,84,31,1,OTC
4618,12-02-2021 16:00,24 hrs.,pennystocks,GCPEF,25,0,25,-25,1,7,7,1,OTC
4618,12-02-2021 16:00,24 hrs.,pennystocks,GLDFF,12,6,6,0,2,2,0,2,OTC
4618,12-02-2021 16:00,24 hrs.,pennystocks,GUESF,7,0,7,-7,1,1,1,1,OTC
4618,12-02-2021 16:00,24 hrs.,pennystocks,HAVLF,203,0,203,-203,1,84,31,1,OTC
4618,12-02-2021 16:00,24 hrs.,pennystocks,HITIF,853,486,367,119,21,254,261,18,OTC
4618,12-02-2021 16:00,24 hrs.,pennystocks,HNLMF,203,0,203,-203,1,84,31,1,OTC
4618,12-02-2021 16:00,24 hrs.,pennystocks,IDXAF,6,6,0,6,1,1,0,1,OTC
4618,12-02-2021 16:00,24 hrs.,pennystocks,ISCNF,12,0,12,-12,2,2,0,1,OTC
4618,12-02-2021 16:00,24 hrs.,pennystocks,KWHIY,6,0,6,-6,1,0,2,1,OTC
4618,12-02-2021 16:00,24 hrs.,pennystocks,LIACF,34,0,34,-34,1,12,6,1,OTC
4618,12-02-2021 16:00,24 hrs.,pennystocks,LIBFF,203,0,203,-203,1,84,31,1,OTC
4618,12-02-2021 16:00,24 hrs.,pennystocks,LKYSF,203,0,203,-203,1,84,31,1,OTC
4618,12-02-2021 16:00,24 hrs.,pennystocks,LLKKF,6,0,6,-6,1,1,0,1,OTC
4618,12-02-2021 16:00,24 hrs.,pennystocks,LTMCF,161,0,161,-161,4,47,51,3,OTC
4618,12-02-2021 16:00,24 hrs.,pennystocks,LXXGF,43,43,0,43,1,8,23,1,OTC
4618,12-02-2021 16:00,24 hrs.,pennystocks,MCURF,203,0,203,-203,1,84,31,1,OTC
4618,12-02-2021 16:00,24 hrs.,pennystocks,MEDIF,6,6,0,6,1,1,0,1,OTC
4618,12-02-2021 16:00,24 hrs.,pennystocks,MMEDF,203,0,203,-203,1,84,31,1,OTC
4618,12-02-2021 16:00,24 hrs.,pennystocks,MMNFF,58,0,58,-58,2,23,4,2,OTC
4618,12-02-2021 16:00,24 hrs.,pennystocks,MNXXF,46,46,0,46,3,7,20,3,OTC
4618,12-02-2021 16:00,24 hrs.,pennystocks,MYCOF,203,0,203,-203,1,84,31,1,OTC
4618,12-02-2021 16:00,24 hrs.,pennystocks,NEBLQ,6,0,6,-6,1,1,0,1,OTC
4618,12-02-2021 16:00,24 hrs.,pennystocks,NMGRF,122,6,116,-110,4,36,34,4,OTC
4618,12-02-2021 16:00,24 hrs.,pennystocks,NMHLY,6,0,6,-6,1,1,0,1,OTC
4618,12-02-2021 16:00,24 hrs.,pennystocks,NRGOF,14,0,14,-14,2,2,2,1,OTC
4618,12-02-2021 16:00,24 hrs.,pennystocks,NTDOY,13,0,13,-13,2,2,1,2,OTC
4618,12-02-2021 16:00,24 hrs.,pennystocks,NTSFF,6,0,6,-6,1,1,0,1,OTC
4618,12-02-2021 16:00,24 hrs.,pennystocks,NXTTF,12,6,6,0,2,2,0,2,OTC
4618,12-02-2021 16:00,24 hrs.,pennystocks,PFWIQ,155,64,91,-27,2,45,57,2,OTC
4618,12-02-2021 16:00,24 hrs.,pennystocks,PLNHF,29,0,29,-29,1,7,11,1,OTC
4618,12-02-2021 16:00,24 hrs.,pennystocks,PLUUF,34,0,34,-34,1,12,6,1,OTC
4618,12-02-2021 16:00,24 hrs.,pennystocks,PYRNF,6,6,0,6,1,1,0,1,OTC
4618,12-02-2021 16:00,24 hrs.,pennystocks,TBEV,6,0,6,-6,1,1,0,1,OTC
4618,12-02-2021 16:00,24 hrs.,pennystocks,TCHH,7,7,0,7,1,1,1,1,OTC
4618,12-02-2021 16:00,24 hrs.,pennystocks,TFZI,6,6,0,6,1,1,0,1,OTC
4618,12-02-2021 16:00,24 hrs.,pennystocks,TGHI,11,11,0,11,1,2,3,1,OTC
4618,12-02-2021 16:00,24 hrs.,pennystocks,TLSS,246,27,219,-192,4,61,108,4,OTC
4618,12-02-2021 16:00,24 hrs.,pennystocks,TPAC,6,6,0,6,1,1,0,1,OTC
4618,12-02-2021 16:00,24 hrs.,pennystocks,TREP,6,0,6,-6,1,1,0,1,OTC
4618,12-02-2021 16:00,24 hrs.,pennystocks,TRTC,15,0,15,-15,1,0,11,1,OTC
4618,12-02-2021 16:00,24 hrs.,pennystocks,TSNP,24,6,18,-12,4,4,0,4,OTC
4618,12-02-2021 16:00,24 hrs.,pennystocks,TSTS,12,12,0,12,2,2,0,1,OTC
4618,12-02-2021 16:00,24 hrs.,pennystocks,UATG,12,0,12,-12,2,2,0,2,OTC
4618,12-02-2021 16:00,24 hrs.,pennystocks,USMJ,20,6,14,-8,3,3,2,3,OTC
4618,12-02-2021 16:00,24 hrs.,pennystocks,USRM,6,6,0,6,1,1,0,1,OTC
4618,12-02-2021 16:00,24 hrs.,pennystocks,UVSE,7,0,7,-7,1,1,1,1,OTC
4618,12-02-2021 16:00,24 hrs.,pennystocks,VPER,6,0,6,-6,1,1,0,1,OTC
4618,12-02-2021 16:00,24 hrs.,pennystocks,VPLM,6,6,0,6,1,1,0,1,OTC
4618,12-02-2021 16:00,24 hrs.,pennystocks,VTLR,6,6,0,6,1,1,0,1,OTC
4618,12-02-2021 16:00,24 hrs.,pennystocks,WARM,146,0,146,-146,2,51,36,2,OTC
4618,12-02-2021 16:00,24 hrs.,pennystocks,WCVC,64,64,0,64,1,18,24,1,OTC
4618,12-02-2021 16:00,24 hrs.,pennystocks,WDHR,14,0,14,-14,2,2,2,1,OTC
4618,12-02-2021 16:00,24 hrs.,pennystocks,WDLF,185,0,185,-185,5,38,89,5,OTC
4618,12-02-2021 16:00,24 hrs.,pennystocks,WHEN,7,0,7,-7,1,1,1,1,OTC
4618,12-02-2021 16:00,24 hrs.,pennystocks,WSTL,123,0,123,-123,1,43,33,1,OTC
4618,12-02-2021 16:00,24 hrs.,pennystocks,PMCB,12,6,6,0,2,2,0,2,OTC
4618,12-02-2021 16:00,24 hrs.,pennystocks,PMDP,6,0,6,-6,1,1,0,1,OTC
4618,12-02-2021 16:00,24 hrs.,pennystocks,PPJE,14,0,14,-14,2,2,2,2,OTC
4618,12-02-2021 16:00,24 hrs.,pennystocks,PRPM,6,0,6,-6,1,1,0,1,OTC
4618,12-02-2021 16:00,24 hrs.,pennystocks,PSYC,276,0,276,-276,5,102,52,3,OTC
4618,12-02-2021 16:00,24 hrs.,pennystocks,PUGE,6,0,6,-6,1,1,0,1,OTC
4618,12-02-2021 16:00,24 hrs.,pennystocks,PURA,7,7,0,7,1,1,1,1,OTC
4618,12-02-2021 16:00,24 hrs.,pennystocks,PVDG,17,17,0,17,1,1,11,1,OTC
4618,12-02-2021 16:00,24 hrs.,pennystocks,PZOO,7,7,0,7,1,1,1,1,OTC
4618,12-02-2021 16:00,24 hrs.,pennystocks,QOIL,7,7,0,7,1,1,1,1,OTC
4618,12-02-2021 16:00,24 hrs.,pennystocks,QPRC,13,0,13,-13,2,2,1,1,OTC
4618,12-02-2021 16:00,24 hrs.,pennystocks,RELI,27,0,27,-27,1,6,11,1,OTC
4618,12-02-2021 16:00,24 hrs.,pennystocks,RITE,43,43,0,43,1,9,21,1,OTC
4618,12-02-2021 16:00,24 hrs.,pennystocks,RLBD,17,17,0,17,1,5,3,1,OTC
4618,12-02-2021 16:00,24 hrs.,pennystocks,RLTR,12,0,12,-12,2,2,0,2,OTC
4618,12-02-2021 16:00,24 hrs.,pennystocks,RMTD,6,6,0,6,1,1,0,1,OTC
4618,12-02-2021 16:00,24 hrs.,pennystocks,RNVA,123,0,123,-123,1,43,33,1,OTC
4618,12-02-2021 16:00,24 hrs.,pennystocks,RRTS,123,0,123,-123,1,43,33,1,OTC
4618,12-02-2021 16:00,24 hrs.,pennystocks,RSSV,89,83,6,77,2,30,21,2,OTC
4618,12-02-2021 16:00,24 hrs.,pennystocks,RTON,185,0,185,-185,6,51,59,5,OTC
4618,12-02-2021 16:00,24 hrs.,pennystocks,SCIE,353,6,347,-341,2,150,45,2,OTC
4618,12-02-2021 16:00,24 hrs.,pennystocks,SEEK,7,0,7,-7,1,1,1,1,OTC
4618,12-02-2021 16:00,24 hrs.,pennystocks,SFOR,6,0,6,-6,1,1,0,1,OTC
4618,12-02-2021 16:00,24 hrs.,pennystocks,SGLN,88,0,88,-88,1,16,52,1,OTC
4618,12-02-2021 16:00,24 hrs.,pennystocks,SGMD,228,6,222,-216,5,72,64,5,OTC
4618,12-02-2021 16:00,24 hrs.,pennystocks,SGSI,154,6,148,-142,5,49,36,4,OTC
4618,12-02-2021 16:00,24 hrs.,pennystocks,SHMP,29,6,23,-17,3,2,13,3,OTC
4618,12-02-2021 16:00,24 hrs.,pennystocks,SHRG,7,0,7,-7,1,1,1,1,OTC
4618,12-02-2021 16:00,24 hrs.,pennystocks,SHWZ,7,7,0,7,1,1,1,1,OTC
4618,12-02-2021 16:00,24 hrs.,pennystocks,SILO,16,0,16,-16,1,3,6,1,OTC
4618,12-02-2021 16:00,24 hrs.,pennystocks,SIML,64,64,0,64,1,18,24,1,OTC
4618,12-02-2021 16:00,24 hrs.,pennystocks,SING,28,0,28,-28,2,1,18,2,OTC
4618,12-02-2021 16:00,24 hrs.,pennystocks,SNPW,522,145,377,-232,6,186,126,6,OTC
4618,12-02-2021 16:00,24 hrs.,pennystocks,SNRS,14,14,0,14,2,2,2,2,OTC
4618,12-02-2021 16:00,24 hrs.,pennystocks,SNWV,12,12,0,12,2,2,0,1,OTC
4618,12-02-2021 16:00,24 hrs.,pennystocks,SPRN,6,0,6,-6,1,1,0,1,OTC
4618,12-02-2021 16:00,24 hrs.,pennystocks,SRMX,243,161,82,79,14,45,97,12,OTC
4618,12-02-2021 16:00,24 hrs.,pennystocks,SSFT,18,0,18,-18,3,3,0,1,OTC
4618,12-02-2021 16:00,24 hrs.,pennystocks,STEV,40,10,30,-20,4,9,6,3,OTC
4618,12-02-2021 16:00,24 hrs.,pennystocks,SUGR,6,0,6,-6,1,1,0,1,OTC
4618,12-02-2021 16:00,24 hrs.,pennystocks,SUIC,6,0,6,-6,1,1,0,1,OTC
4618,12-02-2021 16:00,24 hrs.,pennystocks,SURG,123,0,123,-123,1,43,33,1,OTC
4618,12-02-2021 16:00,24 hrs.,pennystocks,IQST,24,18,6,12,4,4,0,3,OTC
4618,12-02-2021 16:00,24 hrs.,pennystocks,ITCJ,7,7,0,7,1,1,1,1,OTC
4618,12-02-2021 16:00,24 hrs.,pennystocks,JETR,6,0,6,-6,1,1,0,1,OTC
4618,12-02-2021 16:00,24 hrs.,pennystocks,JKSM,6,0,6,-6,1,1,0,1,OTC
4618,12-02-2021 16:00,24 hrs.,pennystocks,KAVL,6,0,6,-6,1,1,0,1,OTC
4618,12-02-2021 16:00,24 hrs.,pennystocks,KGKG,25,6,19,-13,4,4,1,2,OTC
4618,12-02-2021 16:00,24 hrs.,pennystocks,KWBT,130,7,123,-116,2,44,34,2,OTC
4618,12-02-2021 16:00,24 hrs.,pennystocks,KYNC,38,0,38,-38,6,6,2,2,OTC
4618,12-02-2021 16:00,24 hrs.,pennystocks,LBSR,7,0,7,-7,1,1,1,1,OTC
4618,12-02-2021 16:00,24 hrs.,pennystocks,LOGQ,6,0,6,-6,1,1,0,1,OTC
4618,12-02-2021 16:00,24 hrs.,pennystocks,LQMT,95,6,89,-83,2,29,29,2,OTC
4618,12-02-2021 16:00,24 hrs.,pennystocks,LTNC,6,0,6,-6,1,1,0,1,OTC
4618,12-02-2021 16:00,24 hrs.,pennystocks,LTUM,6,0,6,-6,1,1,0,1,OTC
4618,12-02-2021 16:00,24 hrs.,pennystocks,LUVU,149,6,143,-137,5,48,33,4,OTC
4618,12-02-2021 16:00,24 hrs.,pennystocks,LVVV,24,12,12,0,4,4,0,2,OTC
4618,12-02-2021 16:00,24 hrs.,pennystocks,MAXD,6,6,0,6,1,1,0,1,OTC
4618,12-02-2021 16:00,24 hrs.,pennystocks,MCOA,20,7,13,-6,3,3,2,3,OTC
4618,12-02-2021 16:00,24 hrs.,pennystocks,MDCN,13,13,0,13,2,2,1,2,OTC
4618,12-02-2021 16:00,24 hrs.,pennystocks,MEDH,34,34,0,34,1,6,18,1,OTC
4618,12-02-2021 16:00,24 hrs.,pennystocks,MGLG,6,6,0,6,1,1,0,1,OTC
4618,12-02-2021 16:00,24 hrs.,pennystocks,MIKP,6,6,0,6,1,1,0,1,OTC
4618,12-02-2021 16:00,24 hrs.,pennystocks,MINE,674,89,585,-496,5,267,120,5,OTC
4618,12-02-2021 16:00,24 hrs.,pennystocks,MJNA,160,12,148,-136,9,43,38,7,OTC
4618,12-02-2021 16:00,24 hrs.,pennystocks,MLFB,73,67,6,61,2,20,25,2,OTC
4618,12-02-2021 16:00,24 hrs.,pennystocks,MMEX,36,0,36,-36,3,9,6,3,OTC
4618,12-02-2021 16:00,24 hrs.,pennystocks,MODC,6,6,0,6,1,1,0,1,OTC
4618,12-02-2021 16:00,24 hrs.,pennystocks,MOJO,6,6,0,6,1,1,0,1,OTC
4618,12-02-2021 16:00,24 hrs.,pennystocks,MOPN,7,0,7,-7,1,1,1,1,OTC
4618,12-02-2021 16:00,24 hrs.,pennystocks,MRMD,47,0,47,-47,1,19,5,1,OTC
4618,12-02-2021 16:00,24 hrs.,pennystocks,MRNJ,13,0,13,-13,2,2,1,1,OTC
4618,12-02-2021 16:00,24 hrs.,pennystocks,MRPI,7,0,7,-7,1,1,1,1,OTC
4618,12-02-2021 16:00,24 hrs.,pennystocks,NBVG,7,7,0,7,1,1,1,1,OTC
4618,12-02-2021 16:00,24 hrs.,pennystocks,NOVC,34,34,0,34,2,10,6,2,OTC
4618,12-02-2021 16:00,24 hrs.,pennystocks,NPHC,54,0,54,-54,3,11,20,2,OTC
4618,12-02-2021 16:00,24 hrs.,pennystocks,NSAV,45,6,39,-33,3,7,19,3,OTC
4618,12-02-2021 16:00,24 hrs.,pennystocks,NSEO,6,6,0,6,1,1,0,1,OTC
4618,12-02-2021 16:00,24 hrs.,pennystocks,NSPT,6,6,0,6,1,1,0,1,OTC
4618,12-02-2021 16:00,24 hrs.,pennystocks,NSPX,7,0,7,-7,1,1,1,1,OTC
4618,12-02-2021 16:00,24 hrs.,pennystocks,NWPN,6,0,6,-6,1,1,0,1,OTC
4618,12-02-2021 16:00,24 hrs.,pennystocks,OPTI,12,0,12,-12,2,2,0,2,OTC
4618,12-02-2021 16:00,24 hrs.,pennystocks,OPVS,6,0,6,-6,1,1,0,1,OTC
4618,12-02-2021 16:00,24 hrs.,pennystocks,OZSC,193,0,193,-193,3,44,93,3,OTC
4618,12-02-2021 16:00,24 hrs.,pennystocks,PAOG,7,7,0,7,1,1,1,1,OTC
4618,12-02-2021 16:00,24 hrs.,pennystocks,PASO,244,0,244,-244,5,76,72,5,OTC
4618,12-02-2021 16:00,24 hrs.,pennystocks,PDXP,7,7,0,7,1,1,1,1,OTC
4618,12-02-2021 16:00,24 hrs.,pennystocks,PHIL,12,6,6,0,2,2,0,2,OTC
4618,12-02-2021 16:00,24 hrs.,pennystocks,PLSB,6,6,0,6,1,1,0,1,OTC
4618,12-02-2021 16:00,24 hrs.,wallstreetbets,AYX,6,0,6,-6,1,1,0,1,NYSE
4618,12-02-2021 16:00,24 hrs.,wallstreetbets,BBW,19,0,19,-19,3,3,1,3,NYSE
4618,12-02-2021 16:00,24 hrs.,wallstreetbets,BBY,14,14,0,14,2,2,2,1,NYSE
4618,12-02-2021 16:00,24 hrs.,wallstreetbets,BEP,6,0,6,-6,1,1,0,1,NYSE
4618,12-02-2021 16:00,24 hrs.,wallstreetbets,BFT,14,0,14,-14,2,2,2,2,NYSE
4618,12-02-2021 16:00,24 hrs.,wallstreetbets,BGS,12,0,12,-12,2,2,0,1,NYSE
4618,12-02-2021 16:00,24 hrs.,wallstreetbets,BHC,350,329,21,308,5,127,76,3,NYSE
4618,12-02-2021 16:00,24 hrs.,wallstreetbets,BIO,12,0,12,-12,2,2,0,2,NYSE
4618,12-02-2021 16:00,24 hrs.,wallstreetbets,BIT,7,0,7,-7,1,1,1,1,NYSE
4618,12-02-2021 16:00,24 hrs.,wallstreetbets,BTT,45,7,38,-31,7,7,3,7,NYSE
4618,12-02-2021 16:00,24 hrs.,wallstreetbets,BUD,8,0,8,-8,1,1,2,1,NYSE
4618,12-02-2021 16:00,24 hrs.,wallstreetbets,CBD,52,14,38,-24,7,9,6,6,NYSE
4618,12-02-2021 16:00,24 hrs.,wallstreetbets,CCJ,6,0,6,-6,1,1,0,1,NYSE
4618,12-02-2021 16:00,24 hrs.,wallstreetbets,CCL,18,0,18,-18,3,3,0,3,NYSE
4618,12-02-2021 16:00,24 hrs.,wallstreetbets,CHS,8,8,0,8,1,1,2,1,NYSE
4618,12-02-2021 16:00,24 hrs.,wallstreetbets,CMO,6,0,6,-6,1,1,0,1,NYSE
4618,12-02-2021 16:00,24 hrs.,wallstreetbets,COO,6,0,6,-6,1,1,0,1,NYSE
4618,12-02-2021 16:00,24 hrs.,wallstreetbets,COP,6,0,6,-6,1,1,0,1,NYSE
4618,12-02-2021 16:00,24 hrs.,wallstreetbets,CPG,7,7,0,7,1,1,1,1,NYSE
4618,12-02-2021 16:00,24 hrs.,wallstreetbets,CRL,6,0,6,-6,1,1,0,1,NYSE
4618,12-02-2021 16:00,24 hrs.,wallstreetbets,CUB,37,0,37,-37,6,6,1,1,NYSE
4618,12-02-2021 16:00,24 hrs.,wallstreetbets,CVA,13,0,13,-13,2,2,1,2,NYSE
4618,12-02-2021 16:00,24 hrs.,wallstreetbets,CVS,13,0,13,-13,2,2,1,2,NYSE
4618,12-02-2021 16:00,24 hrs.,wallstreetbets,DAC,7,7,0,7,1,1,1,1,NYSE
4618,12-02-2021 16:00,24 hrs.,wallstreetbets,DAL,217,0,217,-217,1,76,61,1,NYSE
4618,12-02-2021 16:00,24 hrs.,wallstreetbets,DCF,226,0,226,-226,1,79,64,1,NYSE
4618,12-02-2021 16:00,24 hrs.,wallstreetbets,DDD,6,0,6,-6,1,1,0,1,NYSE
4618,12-02-2021 16:00,24 hrs.,wallstreetbets,DIS,2625,336,2289,-1953,17,1048,461,15,NYSE
4618,12-02-2021 16:00,24 hrs.,wallstreetbets,DNB,7,0,7,-7,1,1,1,1,NYSE
4618,12-02-2021 16:00,24 hrs.,wallstreetbets,DOC,7,7,0,7,1,1,1,1,NYSE
4618,12-02-2021 16:00,24 hrs.,wallstreetbets,DTE,989,33,956,-923,2,418,145,2,NYSE
4618,12-02-2021 16:00,24 hrs.,wallstreetbets,EAT,27,7,20,-13,4,4,3,4,NYSE
4618,12-02-2021 16:00,24 hrs.,wallstreetbets,ELY,6,0,6,-6,1,1,0,1,NYSE
4618,12-02-2021 16:00,24 hrs.,wallstreetbets,EMO,6,0,6,-6,1,1,0,1,NYSE
4618,12-02-2021 16:00,24 hrs.,wallstreetbets,ENJ,6,0,6,-6,1,1,0,1,NYSE
4618,12-02-2021 16:00,24 hrs.,wallstreetbets,EOS,13,0,13,-13,2,2,1,2,NYSE
4618,12-02-2021 16:00,24 hrs.,wallstreetbets,EXP,6,6,0,6,1,1,0,1,NYSE
4618,12-02-2021 16:00,24 hrs.,wallstreetbets,FAF,6,0,6,-6,1,1,0,1,NYSE
4618,12-02-2021 16:00,24 hrs.,wallstreetbets,FCF,226,0,226,-226,1,79,64,1,NYSE
4618,12-02-2021 16:00,24 hrs.,pennystocks,HRTH,123,0,123,-123,1,43,33,1,OTC
4618,12-02-2021 16:00,24 hrs.,pennystocks,HYII,7,0,7,-7,1,1,1,1,OTC
4618,12-02-2021 16:00,24 hrs.,pennystocks,HYSR,157,139,18,121,4,50,41,4,OTC
4618,12-02-2021 16:00,24 hrs.,pennystocks,IBRC,10,0,10,-10,1,2,2,1,OTC
4618,12-02-2021 16:00,24 hrs.,pennystocks,ICBU,13,6,7,-1,2,2,1,2,OTC
4618,12-02-2021 16:00,24 hrs.,pennystocks,ICLD,12,0,12,-12,2,2,0,1,OTC
4618,12-02-2021 16:00,24 hrs.,pennystocks,IDCN,6,0,6,-6,1,1,0,1,OTC
4618,12-02-2021 16:00,24 hrs.,pennystocks,IDGC,8,0,8,-8,1,1,2,1,OTC
4618,12-02-2021 16:00,24 hrs.,pennystocks,ILUS,6,0,6,-6,1,1,0,1,OTC
4618,12-02-2021 16:00,24 hrs.,pennystocks,IMJX,70,70,0,70,2,19,24,2,OTC
4618,12-02-2021 16:00,24 hrs.,pennystocks,INCT,7,0,7,-7,1,1,1,1,OTC
4618,12-02-2021 16:00,24 hrs.,pennystocks,INKW,37,12,25,-13,6,6,1,5,OTC
4618,12-02-2021 16:00,24 hrs.,pennystocks,INND,113,42,71,-29,8,17,47,8,OTC
4618,12-02-2021 16:00,24 hrs.,pennystocks,INTV,6,6,0,6,1,1,0,1,OTC
4618,12-02-2021 16:00,24 hrs.,pennystocks,INVU,6,0,6,-6,1,1,0,1,OTC
4618,12-02-2021 16:00,24 hrs.,pennystocks,IPIX,67,6,61,-55,2,13,33,2,OTC
4618,12-02-2021 16:00,24 hrs.,pennystocks,IPSI,6,0,6,-6,1,1,0,1,OTC
4618,12-02-2021 16:00,24 hrs.,wallstreetbets,IGC,13,0,13,-13,2,2,1,2,AMEX
4618,12-02-2021 16:00,24 hrs.,wallstreetbets,ISR,6,0,6,-6,1,1,0,1,AMEX
4618,12-02-2021 16:00,24 hrs.,wallstreetbets,ITP,6,0,6,-6,1,1,0,1,AMEX
4618,12-02-2021 16:00,24 hrs.,wallstreetbets,KIQ,12,0,12,-12,2,2,0,1,AMEX
4618,12-02-2021 16:00,24 hrs.,wallstreetbets,LSF,7,7,0,7,1,1,1,1,AMEX
4618,12-02-2021 16:00,24 hrs.,wallstreetbets,MXC,21,14,7,7,3,3,3,3,AMEX
4618,12-02-2021 16:00,24 hrs.,wallstreetbets,NAK,157,45,112,-67,25,25,7,22,AMEX
4618,12-02-2021 16:00,24 hrs.,wallstreetbets,NGD,15,0,15,-15,2,2,3,1,AMEX
4618,12-02-2021 16:00,24 hrs.,wallstreetbets,NXE,6,0,6,-6,1,1,0,1,AMEX
4618,12-02-2021 16:00,24 hrs.,wallstreetbets,PTN,7,7,0,7,1,1,1,1,AMEX
4618,12-02-2021 16:00,24 hrs.,wallstreetbets,SYN,26,14,12,2,4,4,2,3,AMEX
4618,12-02-2021 16:00,24 hrs.,wallstreetbets,TMQ,8,8,0,8,1,1,2,1,AMEX
4618,12-02-2021 16:00,24 hrs.,wallstreetbets,TRX,105,62,43,19,16,16,9,10,AMEX
4618,12-02-2021 16:00,24 hrs.,wallstreetbets,URG,7,0,7,-7,1,1,1,1,AMEX
4618,12-02-2021 16:00,24 hrs.,wallstreetbets,XPL,12,0,12,-12,2,2,0,1,AMEX
4618,12-02-2021 16:00,24 hrs.,wallstreetbets,ZOM,270,91,179,-88,42,42,18,34,AMEX
4618,12-02-2021 16:00,24 hrs.,wallstreetbets,AMPE,7,7,0,7,1,1,1,1,AMEX
4618,12-02-2021 16:00,24 hrs.,wallstreetbets,CRMD,12,0,12,-12,2,2,0,2,AMEX
4618,12-02-2021 16:00,24 hrs.,wallstreetbets,EMAN,7,7,0,7,1,1,1,1,AMEX
4618,12-02-2021 16:00,24 hrs.,wallstreetbets,GSAT,163,42,121,-79,26,26,7,15,AMEX
4618,12-02-2021 16:00,24 hrs.,wallstreetbets,HUSA,7,7,0,7,1,1,1,1,AMEX
4618,12-02-2021 16:00,24 hrs.,wallstreetbets,IBIO,18,0,18,-18,3,3,0,1,AMEX
4618,12-02-2021 16:00,24 hrs.,wallstreetbets,LODE,6,0,6,-6,1,1,0,1,AMEX
4618,12-02-2021 16:00,24 hrs.,wallstreetbets,NSPR,19,0,19,-19,3,3,1,2,AMEX
4618,12-02-2021 16:00,24 hrs.,wallstreetbets,OGEN,25,13,12,1,4,4,1,4,AMEX
4618,12-02-2021 16:00,24 hrs.,wallstreetbets,RLGT,21,21,0,21,3,3,3,1,AMEX
4618,12-02-2021 16:00,24 hrs.,wallstreetbets,SENS,219,129,90,39,21,40,55,18,AMEX
4618,12-02-2021 16:00,24 hrs.,wallstreetbets,TMBR,26,14,12,2,4,4,2,4,AMEX
4618,12-02-2021 16:00,24 hrs.,wallstreetbets,TRXC,40,33,7,26,6,6,4,5,AMEX
4618,12-02-2021 16:00,24 hrs.,wallstreetbets,UAVS,33,14,19,-5,5,5,3,4,AMEX
4618,12-02-2021 16:00,24 hrs.,wallstreetbets,UUUU,33,7,26,-19,5,5,3,4,AMEX
4618,12-02-2021 16:00,24 hrs.,wallstreetbets,YCBD,7,0,7,-7,1,1,1,1,AMEX
4618,12-02-2021 16:00,24 hrs.,wallstreetbets,ABT,7,7,0,7,1,1,1,1,NYSE
4618,12-02-2021 16:00,24 hrs.,wallstreetbets,ACB,196,69,127,-58,31,31,10,25,NYSE
4618,12-02-2021 16:00,24 hrs.,wallstreetbets,ACI,6,0,6,-6,1,1,0,1,NYSE
4618,12-02-2021 16:00,24 hrs.,wallstreetbets,ADT,18,0,18,-18,3,3,0,2,NYSE
4618,12-02-2021 16:00,24 hrs.,wallstreetbets,ADX,12,0,12,-12,2,2,0,1,NYSE
4618,12-02-2021 16:00,24 hrs.,wallstreetbets,AFC,12,0,12,-12,2,2,0,1,NYSE
4618,12-02-2021 16:00,24 hrs.,wallstreetbets,AHT,14,0,14,-14,2,2,2,2,NYSE
4618,12-02-2021 16:00,24 hrs.,wallstreetbets,AIR,13,13,0,13,2,2,1,2,NYSE
4618,12-02-2021 16:00,24 hrs.,wallstreetbets,AIV,6,6,0,6,1,1,0,1,NYSE
4618,12-02-2021 16:00,24 hrs.,wallstreetbets,AMC,73780,4453,69327,-64874,274,33754,5176,232,NYSE
4618,12-02-2021 16:00,24 hrs.,wallstreetbets,AMP,27,0,27,-27,4,4,3,4,NYSE
4618,12-02-2021 16:00,24 hrs.,wallstreetbets,ASX,21,7,14,-7,3,3,3,3,NYSE
4618,12-02-2021 16:00,24 hrs.,wallstreetbets,ATH,27,21,6,15,3,6,3,3,NYSE
4618,12-02-2021 16:00,24 hrs.,wallstreetbets,AUY,19,7,12,-5,3,3,1,3,NYSE
4618,12-02-2021 16:00,24 hrs.,wallstreetbets,AXP,429,429,0,429,2,176,69,1,NYSE
4618,12-02-2021 16:00,24 hrs.,pennystocks,CBTC,7,0,7,-7,1,1,1,1,OTC
4618,12-02-2021 16:00,24 hrs.,pennystocks,CCTL,6,0,6,-6,1,1,0,1,OTC
4618,12-02-2021 16:00,24 hrs.,pennystocks,CETY,6,0,6,-6,1,1,0,1,OTC
4618,12-02-2021 16:00,24 hrs.,pennystocks,CLIS,6,0,6,-6,1,1,0,1,OTC
4618,12-02-2021 16:00,24 hrs.,pennystocks,CLWD,26,6,20,-14,3,7,0,3,OTC
4618,12-02-2021 16:00,24 hrs.,pennystocks,CNNA,25,25,0,25,2,3,11,2,OTC
4618,12-02-2021 16:00,24 hrs.,pennystocks,CNXS,6,0,6,-6,1,1,0,1,OTC
4618,12-02-2021 16:00,24 hrs.,pennystocks,COMS,32,0,32,-32,1,7,14,1,OTC
4618,12-02-2021 16:00,24 hrs.,pennystocks,CORG,53,32,21,11,6,5,19,6,OTC
4618,12-02-2021 16:00,24 hrs.,pennystocks,CRWG,6,6,0,6,1,1,0,1,OTC
4618,12-02-2021 16:00,24 hrs.,pennystocks,CTLE,12,12,0,12,2,2,0,2,OTC
4618,12-02-2021 16:00,24 hrs.,pennystocks,CVAT,6,0,6,-6,1,1,0,1,OTC
4618,12-02-2021 16:00,24 hrs.,pennystocks,CYDY,7,7,0,7,1,1,1,1,OTC
4618,12-02-2021 16:00,24 hrs.,pennystocks,CYPW,6,6,0,6,1,1,0,1,OTC
4618,12-02-2021 16:00,24 hrs.,pennystocks,DGMA,6,6,0,6,1,1,0,1,OTC
4618,12-02-2021 16:00,24 hrs.,pennystocks,DIGI,13,13,0,13,2,2,1,1,OTC
4618,12-02-2021 16:00,24 hrs.,pennystocks,DMAN,17,17,0,17,1,4,5,1,OTC
4618,12-02-2021 16:00,24 hrs.,pennystocks,DPLS,304,58,246,-188,9,80,108,7,OTC
4618,12-02-2021 16:00,24 hrs.,pennystocks,DTST,39,0,39,-39,1,12,11,1,OTC
4618,12-02-2021 16:00,24 hrs.,pennystocks,ECCI,6,6,0,6,1,1,0,1,OTC
4618,12-02-2021 16:00,24 hrs.,pennystocks,ECEZ,192,0,192,-192,4,63,50,3,OTC
4618,12-02-2021 16:00,24 hrs.,pennystocks,EDXC,7,0,7,-7,1,1,1,1,OTC
4618,12-02-2021 16:00,24 hrs.,pennystocks,ENCS,6,6,0,6,1,1,0,1,OTC
4618,12-02-2021 16:00,24 hrs.,pennystocks,ENDV,6,0,6,-6,1,1,0,1,OTC
4618,12-02-2021 16:00,24 hrs.,pennystocks,ENRT,6,6,0,6,1,1,0,1,OTC
4618,12-02-2021 16:00,24 hrs.,pennystocks,ENTI,13,0,13,-13,2,2,1,1,OTC
4618,12-02-2021 16:00,24 hrs.,pennystocks,ENZC,13,0,13,-13,2,2,1,1,OTC
4618,12-02-2021 16:00,24 hrs.,pennystocks,EPAZ,117,0,117,-117,1,47,19,1,OTC
4618,12-02-2021 16:00,24 hrs.,pennystocks,ERBB,12,12,0,12,1,0,8,1,OTC
4618,12-02-2021 16:00,24 hrs.,pennystocks,ETFM,121,6,115,-109,4,29,47,4,OTC
4618,12-02-2021 16:00,24 hrs.,pennystocks,ETHE,24,24,0,24,1,4,12,1,OTC
4618,12-02-2021 16:00,24 hrs.,pennystocks,EUOT,7,0,7,-7,1,1,1,1,OTC
4618,12-02-2021 16:00,24 hrs.,pennystocks,EVSV,6,0,6,-6,1,1,0,1,OTC
4618,12-02-2021 16:00,24 hrs.,pennystocks,EWKS,7,7,0,7,1,1,1,1,OTC
4618,12-02-2021 16:00,24 hrs.,pennystocks,FBEC,6,6,0,6,1,1,0,1,OTC
4618,12-02-2021 16:00,24 hrs.,pennystocks,FDBH,7,7,0,7,1,1,1,1,OTC
4618,12-02-2021 16:00,24 hrs.,pennystocks,FMCC,123,0,123,-123,1,43,33,1,OTC
4618,12-02-2021 16:00,24 hrs.,pennystocks,FNMA,123,0,123,-123,1,43,33,1,OTC
4618,12-02-2021 16:00,24 hrs.,pennystocks,FPVD,15,0,15,-15,2,3,1,2,OTC
4618,12-02-2021 16:00,24 hrs.,pennystocks,FTFY,6,0,6,-6,1,1,0,1,OTC
4618,12-02-2021 16:00,24 hrs.,pennystocks,FUTL,7,0,7,-7,1,1,1,1,OTC
4618,12-02-2021 16:00,24 hrs.,pennystocks,GAXY,114,0,114,-114,2,31,44,2,OTC
4618,12-02-2021 16:00,24 hrs.,pennystocks,GBTC,24,24,0,24,1,4,12,1,OTC
4618,12-02-2021 16:00,24 hrs.,pennystocks,GDET,13,0,13,-13,2,2,1,2,OTC
4618,12-02-2021 16:00,24 hrs.,pennystocks,GHMP,21,21,0,21,2,4,5,2,OTC
4618,12-02-2021 16:00,24 hrs.,pennystocks,GLEC,6,6,0,6,1,1,0,1,OTC
4618,12-02-2021 16:00,24 hrs.,pennystocks,GLGI,123,0,123,-123,1,43,33,1,OTC
4618,12-02-2021 16:00,24 hrs.,pennystocks,GMER,6,0,6,-6,1,1,0,1,OTC
4618,12-02-2021 16:00,24 hrs.,pennystocks,GMEV,633,0,633,-633,1,247,135,1,OTC
4618,12-02-2021 16:00,24 hrs.,pennystocks,GNCP,10,0,10,-10,1,1,4,1,OTC
4618,12-02-2021 16:00,24 hrs.,pennystocks,GPFT,47,34,13,21,3,9,17,3,OTC
4618,12-02-2021 16:00,24 hrs.,pennystocks,GRCU,14,8,6,2,2,2,2,2,OTC
4618,12-02-2021 16:00,24 hrs.,pennystocks,GRCV,6,0,6,-6,1,1,0,1,OTC
4618,12-02-2021 16:00,24 hrs.,pennystocks,GTCH,40,22,18,4,4,4,16,2,OTC
4618,12-02-2021 16:00,24 hrs.,pennystocks,GTEH,161,0,161,-161,4,60,25,4,OTC
4618,12-02-2021 16:00,24 hrs.,pennystocks,GTLL,81,81,0,81,2,29,15,2,OTC
4618,12-02-2021 16:00,24 hrs.,pennystocks,HALB,11,11,0,11,1,3,1,1,OTC
4618,12-02-2021 16:00,24 hrs.,pennystocks,HCMC,247,83,164,-81,37,42,15,32,OTC
4618,12-02-2021 16:00,24 hrs.,pennystocks,HEMP,13,7,6,1,2,2,1,2,OTC
4618,12-02-2021 16:00,24 hrs.,pennystocks,HIPH,1333,6,1327,-1321,6,590,129,4,OTC
4618,12-02-2021 16:00,24 hrs.,pennystocks,HMNY,14,0,14,-14,2,2,2,2,OTC
4618,12-02-2021 16:00,24 hrs.,pennystocks,HPMM,17,0,17,-17,2,2,5,2,OTC
4618,12-02-2021 16:00,24 hrs.,pennystocks,HPTY,197,0,197,-197,2,67,55,2,OTC
4618,12-02-2021 16:00,24 hrs.,pennystocks,HQGE,13,0,13,-13,2,2,1,2,OTC
4618,12-02-2021 16:00,24 hrs.,pennystocks,BXNG,23,0,23,-23,1,3,13,1,OTC
4618,12-02-2021 16:00,24 hrs.,pennystocks,CAPC,7,7,0,7,1,1,1,1,OTC
4618,12-02-2021 16:00,24 hrs.,pennystocks,CATV,6,0,6,-6,1,1,0,1,OTC
4618,12-02-2021 16:00,24 hrs.,pennystocks,CBBT,600,249,351,-102,16,192,152,14,OTC
4618,12-02-2021 16:00,24 hrs.,pennystocks,CBDD,113,5,108,-103,5,35,23,5,OTC
4618,12-02-2021 16:00,24 hrs.,pennystocks,CBDL,178,6,172,-166,4,37,88,4,OTC
4618,12-02-2021 16:00,24 hrs.,pennystocks,CBDS,6,0,6,-6,1,1,0,1,OTC
4618,12-02-2021 16:00,24 hrs.,pennystocks,CBGI,6,0,6,-6,1,1,0,1,OTC
4618,12-02-2021 16:00,24 hrs.,wallstreetbets,CLVS,40,0,40,-40,6,6,4,5,NASDAQ
4618,12-02-2021 16:00,24 hrs.,wallstreetbets,CMLF,7,0,7,-7,1,1,1,1,NASDAQ
4618,12-02-2021 16:00,24 hrs.,wallstreetbets,CMPS,926,871,55,816,12,320,238,8,NASDAQ
4618,12-02-2021 16:00,24 hrs.,wallstreetbets,CNDT,19,6,13,-7,3,3,1,3,NASDAQ
4618,12-02-2021 16:00,24 hrs.,wallstreetbets,CNSP,7,7,0,7,1,1,1,1,NASDAQ
4618,12-02-2021 16:00,24 hrs.,wallstreetbets,CODX,13,7,6,1,2,2,1,2,NASDAQ
4618,12-02-2021 16:00,24 hrs.,wallstreetbets,COHR,322,322,0,322,1,123,72,1,NASDAQ
4618,12-02-2021 16:00,24 hrs.,wallstreetbets,COST,12,0,12,-12,2,2,0,2,NASDAQ
4618,12-02-2021 16:00,24 hrs.,wallstreetbets,CPST,12,0,12,-12,2,2,0,1,NASDAQ
4618,12-02-2021 16:00,24 hrs.,wallstreetbets,CRBP,21,21,0,21,3,3,3,3,NASDAQ
4618,12-02-2021 16:00,24 hrs.,wallstreetbets,CRNT,19,13,6,7,3,3,1,3,NASDAQ
4618,12-02-2021 16:00,24 hrs.,wallstreetbets,CRON,42,0,42,-42,7,7,0,4,NASDAQ
4618,12-02-2021 16:00,24 hrs.,wallstreetbets,AMAT,19,19,0,19,3,3,1,2,NASDAQ
4618,12-02-2021 16:00,24 hrs.,wallstreetbets,AMBC,8,8,0,8,1,1,2,1,NASDAQ
4618,12-02-2021 16:00,24 hrs.,wallstreetbets,AMKR,507,0,507,-507,5,176,135,3,NASDAQ
4618,12-02-2021 16:00,24 hrs.,wallstreetbets,AMRK,6,0,6,-6,1,1,0,1,NASDAQ
4618,12-02-2021 16:00,24 hrs.,wallstreetbets,AMRN,6,0,6,-6,1,1,0,1,NASDAQ
4618,12-02-2021 16:00,24 hrs.,wallstreetbets,AMZN,3014,639,2375,-1736,6,1306,378,6,NASDAQ
4618,12-02-2021 16:00,24 hrs.,wallstreetbets,ANCN,7,7,0,7,1,1,1,1,NASDAQ
4618,12-02-2021 16:00,24 hrs.,wallstreetbets,ANTE,6,0,6,-6,1,1,0,1,NASDAQ
4618,12-02-2021 16:00,24 hrs.,wallstreetbets,APHA,137997,242,137755,-137513,129,64559,8363,105,NASDAQ
4618,12-02-2021 16:00,24 hrs.,wallstreetbets,APOP,6,0,6,-6,1,1,0,1,NASDAQ
4618,12-02-2021 16:00,24 hrs.,wallstreetbets,APRE,7,7,0,7,1,1,1,1,NASDAQ
4618,12-02-2021 16:00,24 hrs.,wallstreetbets,APXT,35,15,20,-5,5,5,5,4,NASDAQ
4618,12-02-2021 16:00,24 hrs.,wallstreetbets,AQMS,7,0,7,-7,1,1,1,1,NASDAQ
4618,12-02-2021 16:00,24 hrs.,wallstreetbets,AQST,6,6,0,6,1,1,0,1,NASDAQ
4618,12-02-2021 16:00,24 hrs.,wallstreetbets,ARCT,18,0,18,-18,3,3,0,1,NASDAQ
4618,12-02-2021 16:00,24 hrs.,wallstreetbets,ARTL,75,75,0,75,11,11,9,9,NASDAQ
4618,12-02-2021 16:00,24 hrs.,wallstreetbets,ASML,21,12,9,3,3,3,3,2,NASDAQ
4618,12-02-2021 16:00,24 hrs.,wallstreetbets,ASRT,37,13,24,-11,6,6,1,6,NASDAQ
4618,12-02-2021 16:00,24 hrs.,wallstreetbets,ASYS,6,6,0,6,1,1,0,1,NASDAQ
4618,12-02-2021 16:00,24 hrs.,wallstreetbets,ATEC,6,0,6,-6,1,1,0,1,NASDAQ
4618,12-02-2021 16:00,24 hrs.,wallstreetbets,ATHX,37,0,37,-37,6,6,1,3,NASDAQ
4618,12-02-2021 16:00,24 hrs.,wallstreetbets,ATNF,13,0,13,-13,2,2,1,2,NASDAQ
4618,12-02-2021 16:00,24 hrs.,wallstreetbets,ATOS,14,7,7,0,2,2,2,2,NASDAQ
4618,12-02-2021 16:00,24 hrs.,wallstreetbets,AUTL,14,14,0,14,2,2,2,1,NASDAQ
4618,12-02-2021 16:00,24 hrs.,wallstreetbets,AUVI,6,0,6,-6,1,1,0,1,NASDAQ
4618,12-02-2021 16:00,24 hrs.,wallstreetbets,AVAV,6,0,6,-6,1,1,0,1,NASDAQ
4618,12-02-2021 16:00,24 hrs.,wallstreetbets,AVGR,18,0,18,-18,3,3,0,2,NASDAQ
4618,12-02-2021 16:00,24 hrs.,wallstreetbets,AVXL,6,0,6,-6,1,1,0,1,NASDAQ
4618,12-02-2021 16:00,24 hrs.,wallstreetbets,AWRE,7,7,0,7,1,1,1,1,NASDAQ
4618,12-02-2021 16:00,24 hrs.,wallstreetbets,AXDX,27,0,27,-27,4,4,3,2,NASDAQ
4618,12-02-2021 16:00,24 hrs.,wallstreetbets,AYRO,7,7,0,7,1,1,1,1,NASDAQ
4618,12-02-2021 16:00,24 hrs.,wallstreetbets,BBBY,12,0,12,-12,2,2,0,2,NASDAQ
4618,12-02-2021 16:00,24 hrs.,wallstreetbets,BCRX,6,0,6,-6,1,1,0,1,NASDAQ
4618,12-02-2021 16:00,24 hrs.,wallstreetbets,BEAT,6,0,6,-6,1,1,0,1,NASDAQ
4618,12-02-2021 16:00,24 hrs.,wallstreetbets,BHAT,6,0,6,-6,1,1,0,1,NASDAQ
4618,12-02-2021 16:00,24 hrs.,wallstreetbets,BIGC,47,0,47,-47,7,7,5,4,NASDAQ
4618,12-02-2021 16:00,24 hrs.,wallstreetbets,BIOC,14,7,7,0,2,2,2,2,NASDAQ
4618,12-02-2021 16:00,24 hrs.,wallstreetbets,BLCT,6,0,6,-6,1,1,0,1,NASDAQ
4618,12-02-2021 16:00,24 hrs.,wallstreetbets,BLNK,7,7,0,7,1,1,1,1,NASDAQ
4618,12-02-2021 16:00,24 hrs.,wallstreetbets,BLUE,12,0,12,-12,2,2,0,2,NASDAQ
4618,12-02-2021 16:00,24 hrs.,wallstreetbets,BNGO,19,7,12,-5,3,3,1,3,NASDAQ
4618,12-02-2021 16:00,24 hrs.,wallstreetbets,BNTX,13,13,0,13,2,2,1,1,NASDAQ
4618,12-02-2021 16:00,24 hrs.,wallstreetbets,BOXL,7,7,0,7,1,1,1,1,NASDAQ
4618,12-02-2021 16:00,24 hrs.,wallstreetbets,BPTH,13,7,6,1,2,2,1,2,NASDAQ
4618,12-02-2021 16:00,24 hrs.,wallstreetbets,BRQS,37,6,31,-25,6,6,1,5,NASDAQ
4618,12-02-2021 16:00,24 hrs.,wallstreetbets,BSGM,6,0,6,-6,1,1,0,1,NASDAQ
4618,12-02-2021 16:00,24 hrs.,wallstreetbets,CALM,6,0,6,-6,1,1,0,1,NASDAQ
4618,12-02-2021 16:00,24 hrs.,wallstreetbets,CARV,20,14,6,8,3,3,2,2,NASDAQ
4618,12-02-2021 16:00,24 hrs.,wallstreetbets,CASA,6,0,6,-6,1,1,0,1,NASDAQ
4618,12-02-2021 16:00,24 hrs.,wallstreetbets,CASH,6,0,6,-6,1,1,0,1,NASDAQ
4618,12-02-2021 16:00,24 hrs.,wallstreetbets,CATM,7,7,0,7,1,1,1,1,NASDAQ
4618,12-02-2021 16:00,24 hrs.,wallstreetbets,CCNC,6,0,6,-6,1,1,0,1,NASDAQ
4618,12-02-2021 16:00,24 hrs.,wallstreetbets,CFII,6,0,6,-6,1,1,0,1,NASDAQ
4618,12-02-2021 16:00,24 hrs.,wallstreetbets,CGIX,20,0,20,-20,3,3,2,2,NASDAQ
4618,12-02-2021 16:00,24 hrs.,wallstreetbets,CGRO,6,0,6,-6,1,1,0,1,NASDAQ
4618,12-02-2021 16:00,24 hrs.,wallstreetbets,CHKP,6,0,6,-6,1,1,0,1,NASDAQ
4618,12-02-2021 16:00,24 hrs.,wallstreetbets,CIDM,13,7,6,1,2,2,1,2,NASDAQ
4618,12-02-2021 16:00,24 hrs.,wallstreetbets,CKPT,25,7,18,-11,4,4,1,3,NASDAQ
4618,12-02-2021 16:00,24 hrs.,wallstreetbets,CLBS,12,0,12,-12,2,2,0,2,NASDAQ
4618,12-02-2021 16:00,24 hrs.,wallstreetbets,CLCT,6,0,6,-6,1,1,0,1,NASDAQ
4618,12-02-2021 16:00,24 hrs.,wallstreetbets,CLEU,7,7,0,7,1,1,1,1,NASDAQ
4618,12-02-2021 16:00,24 hrs.,wallstreetbets,CLNE,133,0,133,-133,2,41,43,2,NASDAQ
4618,12-02-2021 16:00,24 hrs.,wallstreetbets,CLSN,13,7,6,1,2,2,1,2,NASDAQ
4618,12-02-2021 16:00,24 hrs.,wallstreetbets,CLVR,6,0,6,-6,1,1,0,1,NASDAQ
4618,12-02-2021 16:00,24 hrs.,StockMarket,RIGL,6,0,6,-6,1,1,0,1,NASDAQ
4618,12-02-2021 16:00,24 hrs.,StockMarket,SNDL,1109,47,1062,-1015,17,350,341,16,NASDAQ
4618,12-02-2021 16:00,24 hrs.,StockMarket,SONO,60,0,60,-60,1,20,16,1,NASDAQ
4618,12-02-2021 16:00,24 hrs.,StockMarket,SRNE,12,0,12,-12,2,2,0,2,NASDAQ
4618,12-02-2021 16:00,24 hrs.,StockMarket,SVMK,11,11,0,11,1,2,3,1,NASDAQ
4618,12-02-2021 16:00,24 hrs.,StockMarket,TELL,6,0,6,-6,1,1,0,1,NASDAQ
4618,12-02-2021 16:00,24 hrs.,StockMarket,TLRY,827,67,760,-693,12,259,261,11,NASDAQ
4618,12-02-2021 16:00,24 hrs.,StockMarket,TLSA,4,4,0,4,1,0,0,1,NASDAQ
4618,12-02-2021 16:00,24 hrs.,StockMarket,TNXP,6,6,0,6,1,1,0,1,NASDAQ
4618,12-02-2021 16:00,24 hrs.,StockMarket,TSLA,12,6,6,0,2,2,0,2,NASDAQ
4618,12-02-2021 16:00,24 hrs.,StockMarket,TXMD,6,0,6,-6,1,1,0,1,NASDAQ
4618,12-02-2021 16:00,24 hrs.,StockMarket,VITL,6,6,0,6,1,1,0,1,NASDAQ
4618,12-02-2021 16:00,24 hrs.,StockMarket,VRAY,20,0,20,-20,3,3,2,2,NASDAQ
4618,12-02-2021 16:00,24 hrs.,StockMarket,VRSN,11,11,0,11,1,2,3,1,NASDAQ
4618,12-02-2021 16:00,24 hrs.,StockMarket,VXRT,23,0,23,-23,1,7,5,1,NASDAQ
4618,12-02-2021 16:00,24 hrs.,StockMarket,WAFU,44,44,0,44,1,9,22,1,NASDAQ
4618,12-02-2021 16:00,24 hrs.,StockMarket,ZNGA,39,0,39,-39,3,10,7,2,NASDAQ
4618,12-02-2021 16:00,24 hrs.,StockMarket,UONEK,6,0,6,-6,1,1,0,1,NASDAQ
4618,12-02-2021 16:00,24 hrs.,pennystocks,AABB,18,12,6,6,3,3,0,2,OTC
4618,12-02-2021 16:00,24 hrs.,pennystocks,ABML,111,27,84,-57,2,40,23,2,OTC
4618,12-02-2021 16:00,24 hrs.,pennystocks,ABQQ,6,0,6,-6,1,1,0,1,OTC
4618,12-02-2021 16:00,24 hrs.,pennystocks,ACRL,46,0,46,-46,2,14,10,2,OTC
4618,12-02-2021 16:00,24 hrs.,pennystocks,ADGO,14,0,14,-14,1,2,6,1,OTC
4618,12-02-2021 16:00,24 hrs.,pennystocks,ADTM,110,0,110,-110,4,30,34,4,OTC
4618,12-02-2021 16:00,24 hrs.,pennystocks,AEPT,6,6,0,6,1,1,0,1,OTC
4618,12-02-2021 16:00,24 hrs.,pennystocks,AHFD,6,0,6,-6,1,1,0,1,OTC
4618,12-02-2021 16:00,24 hrs.,pennystocks,AITX,274,97,177,-80,7,71,104,7,OTC
4618,12-02-2021 16:00,24 hrs.,pennystocks,ALKM,26,7,19,-12,4,4,2,2,OTC
4618,12-02-2021 16:00,24 hrs.,pennystocks,ALPP,118,95,23,72,7,32,26,6,OTC
4618,12-02-2021 16:00,24 hrs.,pennystocks,ALYI,175,175,0,175,4,56,47,3,OTC
4618,12-02-2021 16:00,24 hrs.,pennystocks,ANDI,7,7,0,7,1,1,1,1,OTC
4618,12-02-2021 16:00,24 hrs.,pennystocks,APEX,123,0,123,-123,1,43,33,1,OTC
4618,12-02-2021 16:00,24 hrs.,pennystocks,APPZ,7,7,0,7,1,1,1,1,OTC
4618,12-02-2021 16:00,24 hrs.,pennystocks,ASTI,30,12,18,-6,4,5,4,4,OTC
4618,12-02-2021 16:00,24 hrs.,pennystocks,ATDS,6,6,0,6,1,1,0,1,OTC
4618,12-02-2021 16:00,24 hrs.,pennystocks,AXXA,12,0,12,-12,2,2,0,2,OTC
4618,12-02-2021 16:00,24 hrs.,pennystocks,AZFL,91,91,0,91,4,7,61,3,OTC
4618,12-02-2021 16:00,24 hrs.,pennystocks,BANT,25,6,19,-13,2,4,9,2,OTC
4618,12-02-2021 16:00,24 hrs.,pennystocks,BBDA,7,0,7,-7,1,1,1,1,OTC
4618,12-02-2021 16:00,24 hrs.,pennystocks,BBRW,6,0,6,-6,1,1,0,1,OTC
4618,12-02-2021 16:00,24 hrs.,pennystocks,BCCI,7,0,7,-7,1,1,1,1,OTC
4618,12-02-2021 16:00,24 hrs.,pennystocks,BDGR,13,6,7,-1,2,2,1,2,OTC
4618,12-02-2021 16:00,24 hrs.,pennystocks,BIEL,83,83,0,83,4,21,25,3,OTC
4618,12-02-2021 16:00,24 hrs.,pennystocks,BKMP,6,6,0,6,1,1,0,1,OTC
4618,12-02-2021 16:00,24 hrs.,pennystocks,BLDV,103,0,103,-103,3,29,33,3,OTC
4618,12-02-2021 16:00,24 hrs.,pennystocks,BLLB,6,0,6,-6,1,1,0,1,OTC
4618,12-02-2021 16:00,24 hrs.,pennystocks,BLSP,100,13,87,-74,5,22,36,5,OTC
4618,12-02-2021 16:00,24 hrs.,pennystocks,BMCS,12,12,0,12,1,3,2,1,OTC
4618,12-02-2021 16:00,24 hrs.,pennystocks,BMIX,56,49,7,42,3,11,22,3,OTC
4618,12-02-2021 16:00,24 hrs.,pennystocks,BNGI,12,0,12,-12,2,2,0,1,OTC
4618,12-02-2021 16:00,24 hrs.,pennystocks,BOTY,123,14,109,-95,6,32,35,5,OTC
4618,12-02-2021 16:00,24 hrs.,pennystocks,BRGO,14,14,0,14,1,4,2,1,OTC
4618,12-02-2021 16:00,24 hrs.,pennystocks,BRLL,24,12,12,0,3,2,8,3,OTC
4618,12-02-2021 16:00,24 hrs.,pennystocks,BTCS,7,0,7,-7,1,1,1,1,OTC
4618,12-02-2021 16:00,24 hrs.,pennystocks,BTSC,13,0,13,-13,2,2,1,1,OTC
4618,12-02-2021 16:00,24 hrs.,pennystocks,BUDZ,11,11,0,11,1,2,3,1,OTC
4618,12-02-2021 16:00,24 hrs.,pennystocks,BWMG,37,27,10,17,2,8,13,2,OTC
4618,12-02-2021 16:00,24 hrs.,wallstreetbets,AGTC,59,21,38,-17,9,9,5,8,NASDAQ
4618,12-02-2021 16:00,24 hrs.,wallstreetbets,AIKI,20,7,13,-6,3,3,2,2,NASDAQ
4618,12-02-2021 16:00,24 hrs.,wallstreetbets,AKAM,6,0,6,-6,1,1,0,1,NASDAQ
4618,12-02-2021 16:00,24 hrs.,wallstreetbets,AKER,6,0,6,-6,1,1,0,1,NASDAQ
4618,12-02-2021 16:00,24 hrs.,wallstreetbets,ALGM,6,0,6,-6,1,1,0,1,NASDAQ
4618,12-02-2021 16:00,24 hrs.,wallstreetbets,ALJJ,7,0,7,-7,1,1,1,1,NASDAQ
4618,12-02-2021 16:00,24 hrs.,wallstreetbets,ALOT,6,0,6,-6,1,1,0,1,NASDAQ
4618,12-02-2021 16:00,24 hrs.,StockMarket,CRSP,4,4,0,4,1,0,0,1,NASDAQ
4618,12-02-2021 16:00,24 hrs.,StockMarket,CTHR,15,0,15,-15,1,4,3,1,NASDAQ
4618,12-02-2021 16:00,24 hrs.,StockMarket,CTRM,61,0,61,-61,5,15,11,5,NASDAQ
4618,12-02-2021 16:00,24 hrs.,StockMarket,DDOG,11,11,0,11,1,2,3,1,NASDAQ
4618,12-02-2021 16:00,24 hrs.,StockMarket,ENTX,8,8,0,8,1,2,0,1,NASDAQ
4618,12-02-2021 16:00,24 hrs.,StockMarket,EXPE,11,11,0,11,1,2,3,1,NASDAQ
4618,12-02-2021 16:00,24 hrs.,StockMarket,FNKO,27,0,27,-27,1,9,5,1,NASDAQ
4618,12-02-2021 16:00,24 hrs.,StockMarket,HTBX,6,6,0,6,1,1,0,1,NASDAQ
4618,12-02-2021 16:00,24 hrs.,StockMarket,IBKR,6,0,6,-6,1,1,0,1,NASDAQ
4618,12-02-2021 16:00,24 hrs.,StockMarket,IIVI,11,11,0,11,1,2,3,1,NASDAQ
4618,12-02-2021 16:00,24 hrs.,StockMarket,INMD,60,0,60,-60,1,20,16,1,NASDAQ
4618,12-02-2021 16:00,24 hrs.,StockMarket,INTZ,4,4,0,4,1,0,0,1,NASDAQ
4618,12-02-2021 16:00,24 hrs.,StockMarket,INVE,21,21,0,21,2,5,3,1,NASDAQ
4618,12-02-2021 16:00,24 hrs.,StockMarket,LAZR,6,6,0,6,1,1,0,1,NASDAQ
4618,12-02-2021 16:00,24 hrs.,StockMarket,LGND,6,6,0,6,1,1,0,1,NASDAQ
4618,12-02-2021 16:00,24 hrs.,StockMarket,LIFE,3926,3926,0,3926,1,1917,88,1,NASDAQ
4618,12-02-2021 16:00,24 hrs.,StockMarket,LITE,11,11,0,11,1,2,3,1,NASDAQ
4618,12-02-2021 16:00,24 hrs.,StockMarket,LIVE,11,11,0,11,1,2,3,1,NASDAQ
4618,12-02-2021 16:00,24 hrs.,StockMarket,LLNW,25,25,0,25,4,4,1,1,NASDAQ
4618,12-02-2021 16:00,24 hrs.,StockMarket,LYFT,60,0,60,-60,1,20,16,1,NASDAQ
4618,12-02-2021 16:00,24 hrs.,StockMarket,MKSI,11,11,0,11,1,2,3,1,NASDAQ
4618,12-02-2021 16:00,24 hrs.,StockMarket,MSTR,12,12,0,12,2,2,0,1,NASDAQ
4618,12-02-2021 16:00,24 hrs.,StockMarket,MTCH,6,6,0,6,1,1,0,1,NASDAQ
4618,12-02-2021 16:00,24 hrs.,StockMarket,OCGN,12,12,0,12,1,1,6,1,NASDAQ
4618,12-02-2021 16:00,24 hrs.,StockMarket,OPTT,30,0,30,-30,1,9,8,1,NASDAQ
4618,12-02-2021 16:00,24 hrs.,StockMarket,PACB,4,4,0,4,1,0,0,1,NASDAQ
4618,12-02-2021 16:00,24 hrs.,StockMarket,PTGX,6,0,6,-6,1,1,0,1,NASDAQ
4618,12-02-2021 16:00,24 hrs.,StockMarket,PYPL,14,14,0,14,1,3,4,1,NASDAQ
4618,12-02-2021 16:00,24 hrs.,StockMarket,RCMT,4,4,0,4,1,0,0,1,NASDAQ
4618,12-02-2021 16:00,24 hrs.,StockMarket,REAL,6,6,0,6,1,0,2,1,NASDAQ
4618,12-02-2021 16:00,24 hrs.,StockMarket,RIDE,17,17,0,17,2,3,3,2,NASDAQ
4618,12-02-2021 16:00,24 hrs.,wallstreetbets,BNED,6,6,0,6,1,1,0,1,NYSE
4618,12-02-2021 16:00,24 hrs.,wallstreetbets,CCIV,241,111,130,-19,35,35,31,29,NYSE
4618,12-02-2021 16:00,24 hrs.,wallstreetbets,CHWY,7,7,0,7,1,1,1,1,NYSE
4618,12-02-2021 16:00,24 hrs.,wallstreetbets,CLDR,155,155,0,155,1,48,55,1,NYSE
4618,12-02-2021 16:00,24 hrs.,wallstreetbets,CLII,12,0,12,-12,2,2,0,2,NYSE
4618,12-02-2021 16:00,24 hrs.,wallstreetbets,CORR,6,0,6,-6,1,1,0,1,NYSE
4618,12-02-2021 16:00,24 hrs.,wallstreetbets,COTY,6,0,6,-6,1,1,0,1,NYSE
4618,12-02-2021 16:00,24 hrs.,wallstreetbets,CSPR,6,0,6,-6,1,1,0,1,NYSE
4618,12-02-2021 16:00,24 hrs.,wallstreetbets,CURO,6,0,6,-6,1,1,0,1,NYSE
4618,12-02-2021 16:00,24 hrs.,wallstreetbets,DASH,525,26,499,-473,4,172,165,3,NYSE
4618,12-02-2021 16:00,24 hrs.,wallstreetbets,DECK,7,0,7,-7,1,1,1,1,NYSE
4618,12-02-2021 16:00,24 hrs.,wallstreetbets,DMYD,6,0,6,-6,1,1,0,1,NYSE
4618,12-02-2021 16:00,24 hrs.,wallstreetbets,DNMR,7,0,7,-7,1,1,1,1,NYSE
4618,12-02-2021 16:00,24 hrs.,wallstreetbets,DOOR,6,0,6,-6,1,1,0,1,NYSE
4618,12-02-2021 16:00,24 hrs.,wallstreetbets,ENLC,6,0,6,-6,1,1,0,1,NYSE
4618,12-02-2021 16:00,24 hrs.,wallstreetbets,EXPR,7,7,0,7,1,1,1,1,NYSE
4618,12-02-2021 16:00,24 hrs.,wallstreetbets,FEDU,7,7,0,7,1,1,1,1,NYSE
4618,12-02-2021 16:00,24 hrs.,wallstreetbets,FENG,6,0,6,-6,1,1,0,1,NYSE
4618,12-02-2021 16:00,24 hrs.,wallstreetbets,FINV,14,0,14,-14,2,2,2,1,NYSE
4618,12-02-2021 16:00,24 hrs.,wallstreetbets,FLOW,7,7,0,7,1,1,1,1,NYSE
4618,12-02-2021 16:00,24 hrs.,wallstreetbets,FSLY,7,7,0,7,1,1,1,1,NYSE
4618,12-02-2021 16:00,24 hrs.,wallstreetbets,FUBO,20,0,20,-20,3,3,2,3,NYSE
4618,12-02-2021 16:00,24 hrs.,wallstreetbets,FUSE,30,30,0,30,4,4,6,2,NYSE
4618,12-02-2021 16:00,24 hrs.,wallstreetbets,FVRR,21,7,14,-7,3,3,3,3,NYSE
4618,12-02-2021 16:00,24 hrs.,wallstreetbets,GPRK,7,7,0,7,1,1,1,1,NYSE
4618,12-02-2021 16:00,24 hrs.,wallstreetbets,GRUB,6,0,6,-6,1,1,0,1,NYSE
4618,12-02-2021 16:00,24 hrs.,wallstreetbets,HEXO,12,0,12,-12,2,2,0,2,NYSE
4618,12-02-2021 16:00,24 hrs.,wallstreetbets,HUYA,189,21,168,-147,8,66,25,7,NYSE
4618,12-02-2021 16:00,24 hrs.,wallstreetbets,HYLN,2583,244,2339,-2095,71,904,491,60,NYSE
4618,12-02-2021 16:00,24 hrs.,wallstreetbets,IIPR,16,12,4,8,3,2,0,2,NYSE
4618,12-02-2021 16:00,24 hrs.,wallstreetbets,IPOE,18,6,12,-6,3,3,0,3,NYSE
4618,12-02-2021 16:00,24 hrs.,wallstreetbets,JMIA,450,450,0,450,5,179,72,1,NYSE
4618,12-02-2021 16:00,24 hrs.,wallstreetbets,KODK,19,13,6,7,3,3,1,2,NYSE
4618,12-02-2021 16:00,24 hrs.,wallstreetbets,LDOS,6,0,6,-6,1,1,0,1,NYSE
4618,12-02-2021 16:00,24 hrs.,wallstreetbets,LEAP,6,0,6,-6,1,1,0,1,NYSE
4618,12-02-2021 16:00,24 hrs.,wallstreetbets,LGVW,34,0,34,-34,5,5,4,4,NYSE
4618,12-02-2021 16:00,24 hrs.,wallstreetbets,LMND,12,0,12,-12,2,2,0,1,NYSE
4618,12-02-2021 16:00,24 hrs.,wallstreetbets,LSPD,13,6,7,-1,2,2,1,2,NYSE
4618,12-02-2021 16:00,24 hrs.,wallstreetbets,LUMN,47,0,47,-47,4,3,25,4,NYSE
4618,12-02-2021 16:00,24 hrs.,wallstreetbets,MAIN,14,0,14,-14,2,2,2,2,NYSE
4618,12-02-2021 16:00,24 hrs.,wallstreetbets,MANU,12,12,0,12,2,2,0,2,NYSE
4618,12-02-2021 16:00,24 hrs.,wallstreetbets,MAXR,6,0,6,-6,1,1,0,1,NYSE
4618,12-02-2021 16:00,24 hrs.,wallstreetbets,MDLY,19,0,19,-19,3,3,1,1,NYSE
4618,12-02-2021 16:00,24 hrs.,wallstreetbets,NVTA,12,0,12,-12,2,2,0,1,NYSE
4618,12-02-2021 16:00,24 hrs.,wallstreetbets,PACK,15,15,0,15,2,2,3,1,NYSE
4618,12-02-2021 16:00,24 hrs.,wallstreetbets,PGRE,6,0,6,-6,1,1,0,1,NYSE
4618,12-02-2021 16:00,24 hrs.,wallstreetbets,PINS,20,0,20,-20,3,3,2,3,NYSE
4618,12-02-2021 16:00,24 hrs.,wallstreetbets,PLNT,6,0,6,-6,1,1,0,1,NYSE
4618,12-02-2021 16:00,24 hrs.,wallstreetbets,PLTR,1418,88,1330,-1242,50,449,320,34,NYSE
4618,12-02-2021 16:00,24 hrs.,wallstreetbets,PSXP,12,0,12,-12,2,2,0,2,NYSE
4618,12-02-2021 16:00,24 hrs.,wallstreetbets,PUMP,6,0,6,-6,1,1,0,1,NYSE
4618,12-02-2021 16:00,24 hrs.,wallstreetbets,QUAD,8,0,8,-8,1,1,2,1,NYSE
4618,12-02-2021 16:00,24 hrs.,wallstreetbets,SCVX,6,0,6,-6,1,1,0,1,NYSE
4618,12-02-2021 16:00,24 hrs.,wallstreetbets,SHAK,18,0,18,-18,3,3,0,1,NYSE
4618,12-02-2021 16:00,24 hrs.,StockMarket,AMD,18,12,6,6,2,1,8,2,NASDAQ
4618,12-02-2021 16:00,24 hrs.,StockMarket,AZN,11,11,0,11,1,2,3,1,NASDAQ
4618,12-02-2021 16:00,24 hrs.,StockMarket,CDC,11,11,0,11,1,2,3,1,NASDAQ
4618,12-02-2021 16:00,24 hrs.,StockMarket,HAS,6,6,0,6,1,1,0,1,NASDAQ
4618,12-02-2021 16:00,24 hrs.,StockMarket,INO,11,11,0,11,1,2,3,1,NASDAQ
4618,12-02-2021 16:00,24 hrs.,StockMarket,MGI,9,9,0,9,1,2,1,1,NASDAQ
4618,12-02-2021 16:00,24 hrs.,StockMarket,NWL,11,11,0,11,1,2,3,1,NASDAQ
4618,12-02-2021 16:00,24 hrs.,StockMarket,OGI,41,41,0,41,3,11,7,3,NASDAQ
4618,12-02-2021 16:00,24 hrs.,StockMarket,RCM,6,0,6,-6,1,1,0,1,NASDAQ
4618,12-02-2021 16:00,24 hrs.,StockMarket,SDC,17,0,17,-17,1,4,5,1,NASDAQ
4618,12-02-2021 16:00,24 hrs.,StockMarket,SFT,6,6,0,6,1,1,0,1,NASDAQ
4618,12-02-2021 16:00,24 hrs.,StockMarket,SND,10,0,10,-10,1,3,0,1,NASDAQ
4618,12-02-2021 16:00,24 hrs.,StockMarket,VFF,18,0,18,-18,3,3,0,1,NASDAQ
4618,12-02-2021 16:00,24 hrs.,StockMarket,AAPL,60,0,60,-60,1,20,16,1,NASDAQ
4618,12-02-2021 16:00,24 hrs.,StockMarket,ABIO,6,0,6,-6,1,1,0,1,NASDAQ
4618,12-02-2021 16:00,24 hrs.,StockMarket,AEZS,4,4,0,4,1,0,0,1,NASDAQ
4618,12-02-2021 16:00,24 hrs.,StockMarket,AGTC,57,0,57,-57,1,15,23,1,NASDAQ
4618,12-02-2021 16:00,24 hrs.,StockMarket,APHA,735,0,735,-735,6,229,253,5,NASDAQ
4618,12-02-2021 16:00,24 hrs.,StockMarket,ARTL,44,44,0,44,1,9,22,1,NASDAQ
4618,12-02-2021 16:00,24 hrs.,StockMarket,ASYS,4,0,4,-4,1,0,0,1,NASDAQ
4618,12-02-2021 16:00,24 hrs.,StockMarket,ATOM,22,0,22,-22,1,8,2,1,NASDAQ
4618,12-02-2021 16:00,24 hrs.,StockMarket,ATOS,7,7,0,7,1,1,1,1,NASDAQ
4618,12-02-2021 16:00,24 hrs.,StockMarket,AVXL,6,0,6,-6,1,1,0,1,NASDAQ
4618,12-02-2021 16:00,24 hrs.,StockMarket,BPTH,6,6,0,6,1,1,0,1,NASDAQ
4618,12-02-2021 16:00,24 hrs.,StockMarket,BSQR,16,0,16,-16,1,0,12,1,NASDAQ
4618,12-02-2021 16:00,24 hrs.,StockMarket,BYND,6,6,0,6,1,1,0,1,NASDAQ
4618,12-02-2021 16:00,24 hrs.,StockMarket,CECE,12,0,12,-12,1,4,0,1,NASDAQ
4618,12-02-2021 16:00,24 hrs.,StockMarket,CLEU,56,56,0,56,2,10,28,2,NASDAQ
4618,12-02-2021 16:00,24 hrs.,StockMarket,CLNE,60,0,60,-60,1,20,16,1,NASDAQ
4618,12-02-2021 16:00,24 hrs.,StockMarket,CLSK,8,8,0,8,1,1,2,1,NASDAQ
4618,12-02-2021 16:00,24 hrs.,StockMarket,CLSN,6,0,6,-6,1,1,0,1,NASDAQ
4618,12-02-2021 16:00,24 hrs.,StockMarket,COHR,11,11,0,11,1,2,3,1,NASDAQ
4618,12-02-2021 16:00,24 hrs.,StockMarket,CPLP,8,8,0,8,1,2,0,1,NASDAQ
4618,12-02-2021 16:00,24 hrs.,wallstreetbets,TDA,1265,0,1265,-1265,3,556,141,3,NYSE
4618,12-02-2021 16:00,24 hrs.,wallstreetbets,TDC,12,6,6,0,2,2,0,2,NYSE
4618,12-02-2021 16:00,24 hrs.,wallstreetbets,TGT,7,0,7,-7,1,1,1,1,NYSE
4618,12-02-2021 16:00,24 hrs.,wallstreetbets,THC,80,0,80,-80,1,22,32,1,NYSE
4618,12-02-2021 16:00,24 hrs.,wallstreetbets,THR,14,0,14,-14,2,2,2,2,NYSE
4618,12-02-2021 16:00,24 hrs.,wallstreetbets,TPB,6,0,6,-6,1,1,0,1,NYSE
4618,12-02-2021 16:00,24 hrs.,wallstreetbets,TRQ,6,6,0,6,1,1,0,1,NYSE
4618,12-02-2021 16:00,24 hrs.,wallstreetbets,TRU,7,7,0,7,1,1,1,1,NYSE
4618,12-02-2021 16:00,24 hrs.,wallstreetbets,TSE,12,0,12,-12,2,2,0,2,NYSE
4618,12-02-2021 16:00,24 hrs.,wallstreetbets,TSM,2599,218,2381,-2163,12,959,633,9,NYSE
4618,12-02-2021 16:00,24 hrs.,wallstreetbets,TSN,429,429,0,429,2,176,69,1,NYSE
4618,12-02-2021 16:00,24 hrs.,wallstreetbets,UBS,202,7,195,-188,7,59,56,5,NYSE
4618,12-02-2021 16:00,24 hrs.,wallstreetbets,UMC,18,0,18,-18,3,3,0,3,NYSE
4618,12-02-2021 16:00,24 hrs.,wallstreetbets,UNP,7,7,0,7,1,1,1,1,NYSE
4618,12-02-2021 16:00,24 hrs.,wallstreetbets,USB,749,0,749,-749,1,291,163,1,NYSE
4618,12-02-2021 16:00,24 hrs.,wallstreetbets,VET,20,7,13,-6,3,3,2,3,NYSE
4618,12-02-2021 16:00,24 hrs.,wallstreetbets,VHC,6,0,6,-6,1,1,0,1,NYSE
4618,12-02-2021 16:00,24 hrs.,wallstreetbets,VST,6,0,6,-6,1,1,0,1,NYSE
4618,12-02-2021 16:00,24 hrs.,wallstreetbets,WFC,6,0,6,-6,1,1,0,1,NYSE
4618,12-02-2021 16:00,24 hrs.,wallstreetbets,WLL,6,6,0,6,1,1,0,1,NYSE
4618,12-02-2021 16:00,24 hrs.,wallstreetbets,WMT,19,7,12,-5,3,3,1,3,NYSE
4618,12-02-2021 16:00,24 hrs.,wallstreetbets,WWE,7,7,0,7,1,1,1,1,NYSE
4618,12-02-2021 16:00,24 hrs.,wallstreetbets,XOM,6,0,6,-6,1,1,0,1,NYSE
4618,12-02-2021 16:00,24 hrs.,wallstreetbets,ABBV,6,0,6,-6,1,1,0,1,NYSE
4618,12-02-2021 16:00,24 hrs.,wallstreetbets,ABEV,7,7,0,7,1,1,1,1,NYSE
4618,12-02-2021 16:00,24 hrs.,wallstreetbets,ACIC,44,14,30,-16,7,7,2,5,NYSE
4618,12-02-2021 16:00,24 hrs.,wallstreetbets,APRN,6,6,0,6,1,1,0,1,NYSE
4618,12-02-2021 16:00,24 hrs.,wallstreetbets,AQUA,6,0,6,-6,1,1,0,1,NYSE
4618,12-02-2021 16:00,24 hrs.,wallstreetbets,ATUS,14,14,0,14,2,2,2,1,NYSE
4618,12-02-2021 16:00,24 hrs.,wallstreetbets,BABA,59,53,6,47,5,14,11,5,NYSE
4618,12-02-2021 16:00,24 hrs.,wallstreetbets,BEKE,382,0,382,-382,1,116,146,1,NYSE
4618,12-02-2021 16:00,24 hrs.,StockMarket,NXGWF,19,19,0,19,1,7,1,1,OTC
4618,12-02-2021 16:00,24 hrs.,StockMarket,RYCEY,6,0,6,-6,1,1,0,1,OTC
4618,12-02-2021 16:00,24 hrs.,StockMarket,DNN,21,0,21,-21,1,4,9,1,AMEX
4618,12-02-2021 16:00,24 hrs.,StockMarket,DSS,8,8,0,8,1,2,0,1,AMEX
4618,12-02-2021 16:00,24 hrs.,StockMarket,GSV,33,0,33,-33,1,7,15,1,AMEX
4618,12-02-2021 16:00,24 hrs.,StockMarket,IGC,18,0,18,-18,1,6,2,1,AMEX
4618,12-02-2021 16:00,24 hrs.,StockMarket,ITP,8,0,8,-8,1,1,2,1,AMEX
4618,12-02-2021 16:00,24 hrs.,StockMarket,REI,10,0,10,-10,1,3,0,1,AMEX
4618,12-02-2021 16:00,24 hrs.,StockMarket,URG,21,0,21,-21,1,4,9,1,AMEX
4618,12-02-2021 16:00,24 hrs.,StockMarket,ZOM,54,0,54,-54,4,8,22,4,AMEX
4618,12-02-2021 16:00,24 hrs.,StockMarket,NSPR,37,6,31,-25,2,11,7,2,AMEX
4618,12-02-2021 16:00,24 hrs.,StockMarket,RLGT,6,6,0,6,1,1,0,1,AMEX
4618,12-02-2021 16:00,24 hrs.,StockMarket,UUUU,21,0,21,-21,1,4,9,1,AMEX
4618,12-02-2021 16:00,24 hrs.,StockMarket,ACI,6,0,6,-6,1,1,0,1,NYSE
4618,12-02-2021 16:00,24 hrs.,StockMarket,AHC,17,0,17,-17,1,4,5,1,NYSE
4618,12-02-2021 16:00,24 hrs.,StockMarket,ALV,20,20,0,20,1,3,10,1,NYSE
4618,12-02-2021 16:00,24 hrs.,StockMarket,AMC,322,300,22,278,6,132,34,5,NYSE
4618,12-02-2021 16:00,24 hrs.,StockMarket,BHC,11,11,0,11,1,2,3,1,NYSE
4618,12-02-2021 16:00,24 hrs.,StockMarket,CHL,6,0,6,-6,1,1,0,1,NYSE
4618,12-02-2021 16:00,24 hrs.,StockMarket,CIA,388,0,388,-388,1,176,32,1,NYSE
4618,12-02-2021 16:00,24 hrs.,StockMarket,CMI,60,0,60,-60,1,20,16,1,NYSE
4618,12-02-2021 16:00,24 hrs.,StockMarket,DIS,11,11,0,11,1,2,3,1,NYSE
4618,12-02-2021 16:00,24 hrs.,StockMarket,FAF,6,0,6,-6,1,1,0,1,NYSE
4618,12-02-2021 16:00,24 hrs.,StockMarket,FSR,11,11,0,11,1,2,3,1,NYSE
4618,12-02-2021 16:00,24 hrs.,StockMarket,GME,450,333,117,216,11,163,80,11,NYSE
4618,12-02-2021 16:00,24 hrs.,StockMarket,IBM,388,0,388,-388,1,176,32,1,NYSE
4618,12-02-2021 16:00,24 hrs.,StockMarket,KGC,6,0,6,-6,1,1,0,1,NYSE
4618,12-02-2021 16:00,24 hrs.,StockMarket,LAC,4,4,0,4,1,0,0,1,NYSE
4618,12-02-2021 16:00,24 hrs.,StockMarket,LMT,24,24,0,24,1,5,10,1,NYSE
4618,12-02-2021 16:00,24 hrs.,StockMarket,MCO,11,11,0,11,1,2,3,1,NYSE
4618,12-02-2021 16:00,24 hrs.,StockMarket,MRO,11,11,0,11,1,2,3,1,NYSE
4618,12-02-2021 16:00,24 hrs.,StockMarket,NSA,388,0,388,-388,1,176,32,1,NYSE
4618,12-02-2021 16:00,24 hrs.,StockMarket,PDT,10,10,0,10,1,2,2,1,NYSE
4618,12-02-2021 16:00,24 hrs.,StockMarket,RSI,6,0,6,-6,1,1,0,1,NYSE
4618,12-02-2021 16:00,24 hrs.,StockMarket,SKY,26,0,26,-26,1,6,10,1,NYSE
4618,12-02-2021 16:00,24 hrs.,StockMarket,SOS,41,29,12,17,6,7,3,5,NYSE
4618,12-02-2021 16:00,24 hrs.,StockMarket,TSE,29,0,29,-29,2,9,3,2,NYSE
4618,12-02-2021 16:00,24 hrs.,StockMarket,TTM,19,19,0,19,1,3,9,1,NYSE
4618,12-02-2021 16:00,24 hrs.,StockMarket,UBS,60,0,60,-60,1,20,16,1,NYSE
4618,12-02-2021 16:00,24 hrs.,StockMarket,ACIC,4,0,4,-4,1,0,0,1,NYSE
4618,12-02-2021 16:00,24 hrs.,StockMarket,AVLR,60,0,60,-60,1,20,16,1,NYSE
4618,12-02-2021 16:00,24 hrs.,StockMarket,CACI,388,0,388,-388,1,176,32,1,NYSE
4618,12-02-2021 16:00,24 hrs.,StockMarket,CCIV,51,8,43,-35,2,16,11,2,NYSE
4618,12-02-2021 16:00,24 hrs.,StockMarket,CHGG,7,7,0,7,1,1,1,1,NYSE
4618,12-02-2021 16:00,24 hrs.,StockMarket,DSSI,8,8,0,8,1,2,0,1,NYSE
4618,12-02-2021 16:00,24 hrs.,StockMarket,FUSE,6,6,0,6,1,1,0,1,NYSE
4618,12-02-2021 16:00,24 hrs.,StockMarket,HYLN,11,11,0,11,1,2,3,1,NYSE
4618,12-02-2021 16:00,24 hrs.,StockMarket,LAIX,12,12,0,12,1,1,6,1,NYSE
4618,12-02-2021 16:00,24 hrs.,StockMarket,MDLY,6,0,6,-6,1,0,2,1,NYSE
4618,12-02-2021 16:00,24 hrs.,StockMarket,PAYC,60,0,60,-60,1,20,16,1,NYSE
4618,12-02-2021 16:00,24 hrs.,StockMarket,RLGY,6,0,6,-6,1,1,0,1,NYSE
4618,12-02-2021 16:00,24 hrs.,StockMarket,SPCE,6,0,6,-6,1,1,0,1,NYSE
4618,12-02-2021 16:00,24 hrs.,StockMarket,TEVA,6,0,6,-6,1,1,0,1,NYSE
4618,12-02-2021 16:00,24 hrs.,StockMarket,UBER,60,0,60,-60,1,20,16,1,NYSE
4618,12-02-2021 16:00,24 hrs.,StockMarket,XPEV,388,0,388,-388,1,176,32,1,NYSE
4618,12-02-2021 16:00,24 hrs.,StockMarket,YETI,4,4,0,4,1,0,0,1,NYSE
4618,12-02-2021 16:00,24 hrs.,wallstreetbets,TLRY,139834,395,139439,-139044,185,65278,8538,157,NASDAQ
4618,12-02-2021 16:00,24 hrs.,wallstreetbets,TNXP,162,6,156,-150,25,26,10,20,NASDAQ
4618,12-02-2021 16:00,24 hrs.,wallstreetbets,TOPS,24,24,0,24,3,4,4,3,NASDAQ
4618,12-02-2021 16:00,24 hrs.,wallstreetbets,TOWN,33,33,0,33,1,10,9,1,NASDAQ
4618,12-02-2021 16:00,24 hrs.,wallstreetbets,TPCO,6,0,6,-6,1,1,0,1,NASDAQ
4618,12-02-2021 16:00,24 hrs.,wallstreetbets,TRCH,50,7,43,-36,8,8,2,6,NASDAQ
4618,12-02-2021 16:00,24 hrs.,wallstreetbets,TRIT,64,14,50,-36,10,10,4,7,NASDAQ
4618,12-02-2021 16:00,24 hrs.,wallstreetbets,TRVN,7,0,7,-7,1,1,1,1,NASDAQ
4618,12-02-2021 16:00,24 hrs.,wallstreetbets,TSLA,66389,617,65772,-65155,43,30868,4481,32,NASDAQ
4618,12-02-2021 16:00,24 hrs.,wallstreetbets,TTCF,7,7,0,7,1,1,1,1,NASDAQ
4618,12-02-2021 16:00,24 hrs.,wallstreetbets,TTWO,7,0,7,-7,1,1,1,1,NASDAQ
4618,12-02-2021 16:00,24 hrs.,wallstreetbets,TURN,20,0,20,-20,3,3,2,2,NASDAQ
4618,12-02-2021 16:00,24 hrs.,wallstreetbets,TWOU,12,0,12,-12,2,2,0,1,NASDAQ
4618,12-02-2021 16:00,24 hrs.,wallstreetbets,TXMD,112,43,69,-26,17,17,10,14,NASDAQ
4618,12-02-2021 16:00,24 hrs.,wallstreetbets,TYME,12,0,12,-12,2,2,0,2,NASDAQ
4618,12-02-2021 16:00,24 hrs.,wallstreetbets,UPST,6,0,6,-6,1,1,0,1,NASDAQ
4618,12-02-2021 16:00,24 hrs.,wallstreetbets,UPWK,12,0,12,-12,2,2,0,2,NASDAQ
4618,12-02-2021 16:00,24 hrs.,wallstreetbets,VEON,6,6,0,6,1,1,0,1,NASDAQ
4618,12-02-2021 16:00,24 hrs.,wallstreetbets,VERU,7,7,0,7,1,1,1,1,NASDAQ
4618,12-02-2021 16:00,24 hrs.,wallstreetbets,VIAC,66,0,66,-66,1,21,20,1,NASDAQ
4618,12-02-2021 16:00,24 hrs.,wallstreetbets,VISL,13,7,6,1,2,2,1,2,NASDAQ
4618,12-02-2021 16:00,24 hrs.,wallstreetbets,VIVE,6,0,6,-6,1,1,0,1,NASDAQ
4618,12-02-2021 16:00,24 hrs.,wallstreetbets,VKTX,6,0,6,-6,1,1,0,1,NASDAQ
4618,12-02-2021 16:00,24 hrs.,wallstreetbets,VNDA,36,0,36,-36,5,5,6,1,NASDAQ
4618,12-02-2021 16:00,24 hrs.,StockMarket,SGMD,41,29,12,17,3,7,15,3,OTC
4618,12-02-2021 16:00,24 hrs.,StockMarket,SUIC,6,0,6,-6,1,1,0,1,OTC
4618,12-02-2021 16:00,24 hrs.,StockMarket,CLUBQ,9,0,9,-9,1,2,1,1,OTC
4618,12-02-2021 16:00,24 hrs.,StockMarket,HITIF,76,0,76,-76,1,18,36,1,OTC
4618,12-02-2021 16:00,24 hrs.,StockMarket,MNKKQ,12,0,12,-12,2,2,0,1,OTC
4618,12-02-2021 16:00,24 hrs.,StockMarket,NMGRF,6,6,0,6,1,1,0,1,OTC
4618,12-02-2021 16:00,24 hrs.,wallstreetbets,PRPL,956,0,956,-956,1,408,136,1,NASDAQ
4618,12-02-2021 16:00,24 hrs.,wallstreetbets,PRTS,22,15,7,8,3,3,4,2,NASDAQ
4618,12-02-2021 16:00,24 hrs.,wallstreetbets,PSAC,7,7,0,7,1,1,1,1,NASDAQ
4618,12-02-2021 16:00,24 hrs.,wallstreetbets,PSEC,31,0,31,-31,3,2,15,2,NASDAQ
4618,12-02-2021 16:00,24 hrs.,wallstreetbets,PSTV,13,7,6,1,2,2,1,2,NASDAQ
4618,12-02-2021 16:00,24 hrs.,wallstreetbets,PTON,450,450,0,450,5,179,72,1,NASDAQ
4618,12-02-2021 16:00,24 hrs.,wallstreetbets,PUBM,6,0,6,-6,1,1,0,1,NASDAQ
4618,12-02-2021 16:00,24 hrs.,wallstreetbets,PYPL,7,0,7,-7,1,1,1,1,NASDAQ
4618,12-02-2021 16:00,24 hrs.,wallstreetbets,PZZA,7,0,7,-7,1,1,1,1,NASDAQ
4618,12-02-2021 16:00,24 hrs.,wallstreetbets,QRVO,34,0,34,-34,2,10,6,1,NASDAQ
4618,12-02-2021 16:00,24 hrs.,wallstreetbets,QUIK,26,13,13,0,4,4,2,3,NASDAQ
4618,12-02-2021 16:00,24 hrs.,wallstreetbets,RBBN,12,0,12,-12,2,2,0,1,NASDAQ
4618,12-02-2021 16:00,24 hrs.,wallstreetbets,RCMT,26,0,26,-26,4,4,2,4,NASDAQ
4618,12-02-2021 16:00,24 hrs.,wallstreetbets,RDHL,7,7,0,7,1,1,1,1,NASDAQ
4618,12-02-2021 16:00,24 hrs.,wallstreetbets,REAL,47,15,32,-17,7,7,5,7,NASDAQ
4618,12-02-2021 16:00,24 hrs.,wallstreetbets,REGI,12,6,6,0,2,2,0,2,NASDAQ
4618,12-02-2021 16:00,24 hrs.,wallstreetbets,REGN,21,21,0,21,3,3,3,2,NASDAQ
4618,12-02-2021 16:00,24 hrs.,wallstreetbets,RIDE,44,20,24,-4,7,7,2,7,NASDAQ
4618,12-02-2021 16:00,24 hrs.,wallstreetbets,RIOT,502,465,37,428,13,187,76,11,NASDAQ
4618,12-02-2021 16:00,24 hrs.,wallstreetbets,RKDA,7,7,0,7,1,1,1,1,NASDAQ
4618,12-02-2021 16:00,24 hrs.,wallstreetbets,RMTI,26,6,20,-14,4,4,2,3,NASDAQ
4618,12-02-2021 16:00,24 hrs.,wallstreetbets,ROCK,6,0,6,-6,1,1,0,1,NASDAQ
4618,12-02-2021 16:00,24 hrs.,wallstreetbets,ROOT,20,14,6,8,3,3,2,2,NASDAQ
4618,12-02-2021 16:00,24 hrs.,wallstreetbets,SABR,7,7,0,7,1,1,1,1,NASDAQ
4618,12-02-2021 16:00,24 hrs.,wallstreetbets,SAGE,6,0,6,-6,1,1,0,1,NASDAQ
4618,12-02-2021 16:00,24 hrs.,wallstreetbets,SAVA,25,7,18,-11,4,4,1,4,NASDAQ
4618,12-02-2021 16:00,24 hrs.,wallstreetbets,SAVE,27,0,27,-27,4,4,3,2,NASDAQ
4618,12-02-2021 16:00,24 hrs.,wallstreetbets,SBUX,7,7,0,7,1,1,1,1,NASDAQ
4618,12-02-2021 16:00,24 hrs.,wallstreetbets,SEEL,19,7,12,-5,3,3,1,3,NASDAQ
4618,12-02-2021 16:00,24 hrs.,wallstreetbets,SFET,6,0,6,-6,1,1,0,1,NASDAQ
4618,12-02-2021 16:00,24 hrs.,wallstreetbets,SHIP,68,55,13,42,10,10,8,8,NASDAQ
4618,12-02-2021 16:00,24 hrs.,wallstreetbets,SIEB,6,0,6,-6,1,1,0,1,NASDAQ
4618,12-02-2021 16:00,24 hrs.,wallstreetbets,SINT,18,0,18,-18,3,3,0,1,NASDAQ
4618,12-02-2021 16:00,24 hrs.,wallstreetbets,SNCR,7,0,7,-7,1,1,1,1,NASDAQ
4618,12-02-2021 16:00,24 hrs.,wallstreetbets,SNDL,58327,1015,57312,-56297,544,25730,4691,427,NASDAQ
4618,12-02-2021 16:00,24 hrs.,wallstreetbets,SNGX,7,7,0,7,1,1,1,1,NASDAQ
4618,12-02-2021 16:00,24 hrs.,wallstreetbets,SOHU,6,0,6,-6,1,1,0,1,NASDAQ
4618,12-02-2021 16:00,24 hrs.,wallstreetbets,SOLO,6,0,6,-6,1,1,0,1,NASDAQ
4618,12-02-2021 16:00,24 hrs.,wallstreetbets,SONO,141,0,141,-141,1,40,57,1,NASDAQ
4618,12-02-2021 16:00,24 hrs.,wallstreetbets,SPWR,6,0,6,-6,1,1,0,1,NASDAQ
4618,12-02-2021 16:00,24 hrs.,wallstreetbets,SQQQ,14,7,7,0,2,2,2,2,NASDAQ
4618,12-02-2021 16:00,24 hrs.,wallstreetbets,SRGA,6,0,6,-6,1,1,0,1,NASDAQ
4618,12-02-2021 16:00,24 hrs.,wallstreetbets,SRNE,22,8,14,-6,2,5,4,2,NASDAQ
4618,12-02-2021 16:00,24 hrs.,wallstreetbets,SSPK,6,0,6,-6,1,1,0,1,NASDAQ
4618,12-02-2021 16:00,24 hrs.,wallstreetbets,STAF,14,7,7,0,2,2,2,2,NASDAQ
4618,12-02-2021 16:00,24 hrs.,wallstreetbets,STAY,24,6,18,-12,4,4,0,4,NASDAQ
4618,12-02-2021 16:00,24 hrs.,wallstreetbets,STCN,6,0,6,-6,1,1,0,1,NASDAQ
4618,12-02-2021 16:00,24 hrs.,wallstreetbets,STEP,9,9,0,9,1,0,5,1,NASDAQ
4618,12-02-2021 16:00,24 hrs.,wallstreetbets,STLD,7,7,0,7,1,1,1,1,NASDAQ
4618,12-02-2021 16:00,24 hrs.,wallstreetbets,SVMK,322,322,0,322,1,123,72,1,NASDAQ
4618,12-02-2021 16:00,24 hrs.,wallstreetbets,SWBI,6,0,6,-6,1,1,0,1,NASDAQ
4618,12-02-2021 16:00,24 hrs.,wallstreetbets,SWKS,200,200,0,200,1,48,100,1,NASDAQ
4618,12-02-2021 16:00,24 hrs.,wallstreetbets,TEAM,12,0,12,-12,2,2,0,1,NASDAQ
4618,12-02-2021 16:00,24 hrs.,wallstreetbets,TELL,28409,28396,13,28383,4,13571,1251,4,NASDAQ
4618,12-02-2021 16:00,24 hrs.,wallstreetbets,THBR,25,7,18,-11,4,4,1,3,NASDAQ
4618,12-02-2021 16:00,24 hrs.,wallstreetbets,THCB,4,0,4,-4,1,0,0,1,NASDAQ
4618,12-02-2021 16:00,24 hrs.,wallstreetbets,THMO,25,13,12,1,4,4,1,2,NASDAQ
4618,12-02-2021 16:00,24 hrs.,wallstreetbets,TIGR,7,0,7,-7,1,1,1,1,NASDAQ
4618,12-02-2021 16:00,24 hrs.,trakstocks,GME,68,21,47,-26,2,17,26,2,NYSE
4618,12-02-2021 16:00,24 hrs.,trakstocks,LEN,11,11,0,11,1,3,1,1,NYSE
4618,12-02-2021 16:00,24 hrs.,trakstocks,NAV,47,0,47,-47,1,14,15,1,NYSE
4618,12-02-2021 16:00,24 hrs.,trakstocks,PCG,47,0,47,-47,1,14,15,1,NYSE
4618,12-02-2021 16:00,24 hrs.,trakstocks,RKT,47,0,47,-47,1,14,15,1,NYSE
4618,12-02-2021 16:00,24 hrs.,trakstocks,SOS,55,0,55,-55,1,25,1,1,NYSE
4618,12-02-2021 16:00,24 hrs.,trakstocks,SPH,12,0,12,-12,1,4,0,1,NYSE
4618,12-02-2021 16:00,24 hrs.,trakstocks,WPF,6,0,6,-6,1,1,0,1,NYSE
4618,12-02-2021 16:00,24 hrs.,trakstocks,ARGO,6,6,0,6,1,1,0,1,NYSE
4618,12-02-2021 16:00,24 hrs.,trakstocks,BEKE,47,0,47,-47,1,14,15,1,NYSE
4618,12-02-2021 16:00,24 hrs.,trakstocks,CCIV,39,12,27,-15,4,8,7,4,NYSE
4618,12-02-2021 16:00,24 hrs.,trakstocks,FUSE,6,0,6,-6,1,1,0,1,NYSE
4618,12-02-2021 16:00,24 hrs.,trakstocks,IIPR,12,0,12,-12,1,4,0,1,NYSE
4618,12-02-2021 16:00,24 hrs.,trakstocks,MDLY,6,0,6,-6,1,1,0,1,NYSE
4618,12-02-2021 16:00,24 hrs.,trakstocks,SKLZ,6,6,0,6,1,1,0,1,NYSE
4618,12-02-2021 16:00,24 hrs.,trakstocks,STIC,22,0,22,-22,1,8,2,1,NYSE
4618,12-02-2021 16:00,24 hrs.,trakstocks,STPK,87,0,87,-87,3,28,19,3,NYSE
4618,12-02-2021 16:00,24 hrs.,trakstocks,CFO,266,0,266,-266,1,111,40,1,NASDAQ
4618,12-02-2021 16:00,24 hrs.,trakstocks,HOL,45,0,45,-45,1,11,19,1,NASDAQ
4618,12-02-2021 16:00,24 hrs.,trakstocks,ABEO,29,8,21,-13,2,9,3,2,NASDAQ
4618,12-02-2021 16:00,24 hrs.,trakstocks,AESE,12,0,12,-12,1,2,4,1,NASDAQ
4618,12-02-2021 16:00,24 hrs.,trakstocks,AYRO,302,0,302,-302,2,118,58,2,NASDAQ
4618,12-02-2021 16:00,24 hrs.,trakstocks,BTBT,13,0,13,-13,1,3,3,1,NASDAQ
4618,12-02-2021 16:00,24 hrs.,trakstocks,CHEF,28,0,28,-28,1,9,6,1,NASDAQ
4618,12-02-2021 16:00,24 hrs.,trakstocks,CPSH,89,75,14,61,2,37,7,2,NASDAQ
4618,12-02-2021 16:00,24 hrs.,trakstocks,CTRM,127,0,127,-127,3,49,17,2,NASDAQ
4618,12-02-2021 16:00,24 hrs.,trakstocks,DARE,6,0,6,-6,1,1,0,1,NASDAQ
4618,12-02-2021 16:00,24 hrs.,trakstocks,EXPC,23,0,23,-23,1,9,1,1,NASDAQ
4618,12-02-2021 16:00,24 hrs.,trakstocks,FUTU,47,0,47,-47,1,14,15,1,NASDAQ
4618,12-02-2021 16:00,24 hrs.,trakstocks,GEVO,77,0,77,-77,1,32,9,1,NASDAQ
4618,12-02-2021 16:00,24 hrs.,trakstocks,GHIV,47,0,47,-47,1,14,15,1,NASDAQ
4618,12-02-2021 16:00,24 hrs.,trakstocks,GMBL,12,0,12,-12,1,2,4,1,NASDAQ
4618,12-02-2021 16:00,24 hrs.,trakstocks,GMDA,12,0,12,-12,1,1,6,1,NASDAQ
4618,12-02-2021 16:00,24 hrs.,trakstocks,GTHX,6,6,0,6,1,1,0,1,NASDAQ
4618,12-02-2021 16:00,24 hrs.,trakstocks,IBKR,47,0,47,-47,1,14,15,1,NASDAQ
4618,12-02-2021 16:00,24 hrs.,trakstocks,INMD,8,0,8,-8,1,2,0,1,NASDAQ
4618,12-02-2021 16:00,24 hrs.,trakstocks,INPX,22,0,22,-22,1,9,0,1,NASDAQ
4618,12-02-2021 16:00,24 hrs.,trakstocks,IRBT,25,0,25,-25,1,7,7,1,NASDAQ
4618,12-02-2021 16:00,24 hrs.,trakstocks,LKCO,21,0,21,-21,1,7,3,1,NASDAQ
4618,12-02-2021 16:00,24 hrs.,trakstocks,MARA,31,0,31,-31,2,7,9,2,NASDAQ
4618,12-02-2021 16:00,24 hrs.,trakstocks,MSTR,4,0,4,-4,1,0,0,1,NASDAQ
4618,12-02-2021 16:00,24 hrs.,trakstocks,RIOT,37,0,37,-37,3,8,9,3,NASDAQ
4618,12-02-2021 16:00,24 hrs.,trakstocks,SNGX,30,0,30,-30,1,11,4,1,NASDAQ
4618,12-02-2021 16:00,24 hrs.,trakstocks,TTCF,28,0,28,-28,1,9,6,1,NASDAQ
4618,12-02-2021 16:00,24 hrs.,trakstocks,USWS,218,0,218,-218,2,82,46,2,NASDAQ
4618,12-02-2021 16:00,24 hrs.,trakstocks,VNDA,10,10,0,10,1,3,0,1,NASDAQ
4618,12-02-2021 16:00,24 hrs.,trakstocks,VRME,8,0,8,-8,1,2,0,1,NASDAQ
4618,12-02-2021 16:00,24 hrs.,trakstocks,VTRS,7,0,7,-7,1,1,1,1,NASDAQ
4618,12-02-2021 16:00,24 hrs.,trakstocks,XSPA,19,19,0,19,1,5,5,1,NASDAQ
4618,12-02-2021 16:00,24 hrs.,StockMarket,BOTY,36,0,36,-36,2,4,20,1,OTC
4618,12-02-2021 16:00,24 hrs.,StockMarket,DIGI,6,6,0,6,1,1,0,1,OTC
4618,12-02-2021 16:00,24 hrs.,StockMarket,FMCC,84,0,84,-84,1,25,30,1,OTC
4618,12-02-2021 16:00,24 hrs.,StockMarket,FNMA,84,0,84,-84,1,25,30,1,OTC
4618,12-02-2021 16:00,24 hrs.,StockMarket,GAXY,22,0,22,-22,1,9,0,1,OTC
4618,12-02-2021 16:00,24 hrs.,StockMarket,GTSO,11,0,11,-11,1,3,1,1,OTC
4618,12-02-2021 16:00,24 hrs.,StockMarket,GTVH,6,6,0,6,1,1,0,1,OTC
4618,12-02-2021 16:00,24 hrs.,StockMarket,HCMC,49,49,0,49,2,17,7,2,OTC
4618,12-02-2021 16:00,24 hrs.,StockMarket,KWBT,6,6,0,6,1,1,0,1,OTC
4618,12-02-2021 16:00,24 hrs.,StockMarket,LINK,11,11,0,11,1,2,3,1,OTC
4618,12-02-2021 16:00,24 hrs.,StockMarket,MOST,11,11,0,11,1,2,3,1,OTC
4618,12-02-2021 16:00,24 hrs.,StockMarket,PCTL,6,6,0,6,1,1,0,1,OTC
4618,12-02-2021 16:00,24 hrs.,StockMarket,RLTR,6,6,0,6,1,1,0,1,OTC
4618,12-02-2021 16:00,24 hrs.,StockMarket,RSSV,13,13,0,13,1,4,1,1,OTC
4618,12-02-2021 16:00,24 hrs.,StockMarket,RTON,6,0,6,-6,1,1,0,1,OTC
4618,12-02-2021 16:00,24 hrs.,Daytrading,WAFU,44,44,0,44,1,17,6,1,NASDAQ
4618,12-02-2021 16:00,24 hrs.,Daytrading,XERS,282,282,0,282,1,115,48,1,NASDAQ
4618,12-02-2021 16:00,24 hrs.,trakstocks,BRGO,6,0,6,-6,1,1,0,1,OTC
4618,12-02-2021 16:00,24 hrs.,trakstocks,BRLL,13,0,13,-13,1,4,1,1,OTC
4618,12-02-2021 16:00,24 hrs.,trakstocks,MMEX,8,8,0,8,1,2,0,1,OTC
4618,12-02-2021 16:00,24 hrs.,trakstocks,MOST,6,6,0,6,1,1,0,1,OTC
4618,12-02-2021 16:00,24 hrs.,trakstocks,SGSI,12,0,12,-12,1,4,0,1,OTC
4618,12-02-2021 16:00,24 hrs.,trakstocks,SMVI,6,0,6,-6,1,1,0,1,OTC
4618,12-02-2021 16:00,24 hrs.,trakstocks,SUIC,6,6,0,6,1,1,0,1,OTC
4618,12-02-2021 16:00,24 hrs.,trakstocks,ARBKF,6,6,0,6,1,1,0,1,OTC
4618,12-02-2021 16:00,24 hrs.,trakstocks,HUTMF,18,0,18,-18,1,4,6,1,OTC
4618,12-02-2021 16:00,24 hrs.,trakstocks,PYRNF,6,6,0,6,1,1,0,1,OTC
4618,12-02-2021 16:00,24 hrs.,trakstocks,VVCIF,12,0,12,-12,1,2,4,1,OTC
4618,12-02-2021 16:00,24 hrs.,trakstocks,ZOM,64,0,64,-64,1,25,10,1,AMEX
4618,12-02-2021 16:00,24 hrs.,trakstocks,TRXC,98,29,69,-40,2,35,20,2,AMEX
4618,12-02-2021 16:00,24 hrs.,trakstocks,UUUU,47,0,47,-47,1,12,19,1,AMEX
4618,12-02-2021 16:00,24 hrs.,trakstocks,AMC,68,21,47,-26,2,17,26,2,NYSE
4618,12-02-2021 16:00,24 hrs.,trakstocks,BFT,45,0,45,-45,1,11,19,1,NYSE
4618,12-02-2021 16:00,24 hrs.,trakstocks,CPS,75,75,0,75,1,33,5,1,NYSE
4618,12-02-2021 16:00,24 hrs.,wallstreetbets,LIVE,793,329,464,-135,4,306,165,4,NASDAQ
4618,12-02-2021 16:00,24 hrs.,wallstreetbets,LIVX,15,15,0,15,2,2,3,1,NASDAQ
4618,12-02-2021 16:00,24 hrs.,wallstreetbets,LKCO,57,14,43,-29,9,9,3,4,NASDAQ
4618,12-02-2021 16:00,24 hrs.,wallstreetbets,LLIT,6,0,6,-6,1,1,0,1,NASDAQ
4618,12-02-2021 16:00,24 hrs.,wallstreetbets,LLNW,42,21,21,0,6,6,6,5,NASDAQ
4618,12-02-2021 16:00,24 hrs.,wallstreetbets,LPCN,7,7,0,7,1,1,1,1,NASDAQ
4618,12-02-2021 16:00,24 hrs.,wallstreetbets,LRCX,206,200,6,194,2,49,100,2,NASDAQ
4618,12-02-2021 16:00,24 hrs.,wallstreetbets,MARA,57,7,50,-43,9,9,3,8,NASDAQ
4618,12-02-2021 16:00,24 hrs.,wallstreetbets,MARK,13,7,6,1,2,2,1,2,NASDAQ
4618,12-02-2021 16:00,24 hrs.,wallstreetbets,MBRX,32,13,19,-6,5,5,2,4,NASDAQ
4618,12-02-2021 16:00,24 hrs.,wallstreetbets,MCHP,405,0,405,-405,1,146,109,1,NASDAQ
4618,12-02-2021 16:00,24 hrs.,wallstreetbets,METX,6,0,6,-6,1,1,0,1,NASDAQ
4618,12-02-2021 16:00,24 hrs.,wallstreetbets,MGNI,27,7,20,-13,4,4,3,4,NASDAQ
4618,12-02-2021 16:00,24 hrs.,wallstreetbets,MITO,6,0,6,-6,1,1,0,1,NASDAQ
4618,12-02-2021 16:00,24 hrs.,wallstreetbets,MKSI,322,322,0,322,1,123,72,1,NASDAQ
4618,12-02-2021 16:00,24 hrs.,wallstreetbets,MNPR,6,6,0,6,1,1,0,1,NASDAQ
4618,12-02-2021 16:00,24 hrs.,wallstreetbets,MOGO,7,0,7,-7,1,1,1,1,NASDAQ
4618,12-02-2021 16:00,24 hrs.,wallstreetbets,MOSY,7,0,7,-7,1,1,1,1,NASDAQ
4618,12-02-2021 16:00,24 hrs.,wallstreetbets,MOTS,12,0,12,-12,2,2,0,1,NASDAQ
4618,12-02-2021 16:00,24 hrs.,wallstreetbets,MRAM,6,0,6,-6,1,1,0,1,NASDAQ
4618,12-02-2021 16:00,24 hrs.,wallstreetbets,MSFT,963,7,956,-949,2,409,137,2,NASDAQ
4618,12-02-2021 16:00,24 hrs.,wallstreetbets,MSTR,33,21,12,9,5,5,3,3,NASDAQ
4618,12-02-2021 16:00,24 hrs.,wallstreetbets,MVIS,105,46,59,-13,11,20,21,10,NASDAQ
4618,12-02-2021 16:00,24 hrs.,wallstreetbets,NAKD,294,76,218,-142,46,46,18,40,NASDAQ
4618,12-02-2021 16:00,24 hrs.,wallstreetbets,NAOV,6,0,6,-6,1,1,0,1,NASDAQ
4618,12-02-2021 16:00,24 hrs.,wallstreetbets,NBEV,8,0,8,-8,1,2,0,1,NASDAQ
4618,12-02-2021 16:00,24 hrs.,wallstreetbets,NCLH,7,0,7,-7,1,1,1,1,NASDAQ
4618,12-02-2021 16:00,24 hrs.,wallstreetbets,NDRA,13,0,13,-13,2,2,1,2,NASDAQ
4618,12-02-2021 16:00,24 hrs.,wallstreetbets,NEOS,7,7,0,7,1,1,1,1,NASDAQ
4618,12-02-2021 16:00,24 hrs.,wallstreetbets,NEPT,25,0,25,-25,4,4,1,3,NASDAQ
4618,12-02-2021 16:00,24 hrs.,wallstreetbets,NKLA,20,0,20,-20,3,3,2,3,NASDAQ
4618,12-02-2021 16:00,24 hrs.,wallstreetbets,NLOK,13,0,13,-13,2,2,1,1,NASDAQ
4618,12-02-2021 16:00,24 hrs.,wallstreetbets,NNDM,27,7,20,-13,4,5,1,3,NASDAQ
4618,12-02-2021 16:00,24 hrs.,wallstreetbets,NNOX,6,0,6,-6,1,1,0,1,NASDAQ
4618,12-02-2021 16:00,24 hrs.,wallstreetbets,NOVN,7,0,7,-7,1,1,1,1,NASDAQ
4618,12-02-2021 16:00,24 hrs.,wallstreetbets,NUAN,6,0,6,-6,1,1,0,1,NASDAQ
4618,12-02-2021 16:00,24 hrs.,wallstreetbets,NVAX,6,0,6,-6,1,1,0,1,NASDAQ
4618,12-02-2021 16:00,24 hrs.,wallstreetbets,NVCN,32,0,32,-32,5,5,2,5,NASDAQ
4618,12-02-2021 16:00,24 hrs.,wallstreetbets,NVDA,371,200,171,29,4,107,141,3,NASDAQ
4618,12-02-2021 16:00,24 hrs.,wallstreetbets,NXPI,405,0,405,-405,1,146,109,1,NASDAQ
4618,12-02-2021 16:00,24 hrs.,wallstreetbets,NXTD,18,0,18,-18,3,3,0,2,NASDAQ
4618,12-02-2021 16:00,24 hrs.,wallstreetbets,OCGN,85,6,79,-73,14,14,1,11,NASDAQ
4618,12-02-2021 16:00,24 hrs.,wallstreetbets,ONTX,6,0,6,-6,1,1,0,1,NASDAQ
4618,12-02-2021 16:00,24 hrs.,wallstreetbets,ONVO,13,7,6,1,2,2,1,2,NASDAQ
4618,12-02-2021 16:00,24 hrs.,wallstreetbets,OPGN,7,7,0,7,1,1,1,1,NASDAQ
4618,12-02-2021 16:00,24 hrs.,wallstreetbets,OPTT,12,0,12,-12,2,2,0,2,NASDAQ
4618,12-02-2021 16:00,24 hrs.,wallstreetbets,OSTK,9,0,9,-9,1,1,3,1,NASDAQ
4618,12-02-2021 16:00,24 hrs.,wallstreetbets,OTLK,6,0,6,-6,1,1,0,1,NASDAQ
4618,12-02-2021 16:00,24 hrs.,wallstreetbets,PACB,14,0,14,-14,2,2,2,1,NASDAQ
4618,12-02-2021 16:00,24 hrs.,wallstreetbets,PDSB,12,0,12,-12,2,2,0,1,NASDAQ
4618,12-02-2021 16:00,24 hrs.,wallstreetbets,PENN,457,457,0,457,6,180,73,2,NASDAQ
4618,12-02-2021 16:00,24 hrs.,wallstreetbets,PHIO,7,0,7,-7,1,1,1,1,NASDAQ
4618,12-02-2021 16:00,24 hrs.,wallstreetbets,PHUN,7,7,0,7,1,1,1,1,NASDAQ
4618,12-02-2021 16:00,24 hrs.,wallstreetbets,PLAY,408,7,401,-394,12,111,138,8,NASDAQ
4618,12-02-2021 16:00,24 hrs.,wallstreetbets,PLUG,19,7,12,-5,3,3,1,3,NASDAQ
4618,12-02-2021 16:00,24 hrs.,wallstreetbets,PLYA,7,7,0,7,1,1,1,1,NASDAQ
4618,12-02-2021 16:00,24 hrs.,wallstreetbets,POTX,7,7,0,7,1,1,1,1,NASDAQ
4618,12-02-2021 16:00,24 hrs.,wallstreetbets,POWW,132,20,112,-92,21,21,6,17,NASDAQ
4618,12-02-2021 16:00,24 hrs.,wallstreetbets,PRCH,30,6,24,-18,5,5,0,3,NASDAQ
4618,12-02-2021 16:00,24 hrs.,Daytrading,MSM,17,0,17,-17,1,4,5,1,NYSE
4618,12-02-2021 16:00,24 hrs.,Daytrading,NOK,17,17,0,17,1,0,13,1,NYSE
4618,12-02-2021 16:00,24 hrs.,Daytrading,PDT,16,16,0,16,1,4,4,1,NYSE
4618,12-02-2021 16:00,24 hrs.,Daytrading,RTP,282,282,0,282,1,115,48,1,NYSE
4618,12-02-2021 16:00,24 hrs.,Daytrading,SCI,6,0,6,-6,1,1,0,1,NYSE
4618,12-02-2021 16:00,24 hrs.,Daytrading,TDA,11,0,11,-11,1,3,1,1,NYSE
4618,12-02-2021 16:00,24 hrs.,Daytrading,WLL,6,6,0,6,1,1,0,1,NYSE
4618,12-02-2021 16:00,24 hrs.,Daytrading,CCIV,282,282,0,282,1,115,48,1,NYSE
4618,12-02-2021 16:00,24 hrs.,Daytrading,CHWY,6,6,0,6,1,1,0,1,NYSE
4618,12-02-2021 16:00,24 hrs.,Daytrading,SPCE,289,289,0,289,2,116,49,2,NYSE
4618,12-02-2021 16:00,24 hrs.,Daytrading,AMD,10,10,0,10,1,0,6,1,NASDAQ
4618,12-02-2021 16:00,24 hrs.,Daytrading,INO,282,282,0,282,1,115,48,1,NASDAQ
4618,12-02-2021 16:00,24 hrs.,Daytrading,OGI,11,11,0,11,1,0,7,1,NASDAQ
4618,12-02-2021 16:00,24 hrs.,Daytrading,ACST,6,6,0,6,1,1,0,1,NASDAQ
4618,12-02-2021 16:00,24 hrs.,Daytrading,AMGN,8,0,8,-8,1,1,2,1,NASDAQ
4618,12-02-2021 16:00,24 hrs.,Daytrading,APDN,282,282,0,282,1,115,48,1,NASDAQ
4618,12-02-2021 16:00,24 hrs.,Daytrading,APHA,324,282,42,240,4,124,60,3,NASDAQ
4618,12-02-2021 16:00,24 hrs.,Daytrading,ARTL,347,347,0,347,4,137,57,4,NASDAQ
4618,12-02-2021 16:00,24 hrs.,Daytrading,AZRX,7,0,7,-7,1,1,1,1,NASDAQ
4618,12-02-2021 16:00,24 hrs.,Daytrading,BYND,6,6,0,6,1,1,0,1,NASDAQ
4618,12-02-2021 16:00,24 hrs.,Daytrading,CLEU,326,326,0,326,2,132,54,2,NASDAQ
4618,12-02-2021 16:00,24 hrs.,Daytrading,CLGN,282,282,0,282,1,115,48,1,NASDAQ
4618,12-02-2021 16:00,24 hrs.,Daytrading,CLSN,282,282,0,282,1,115,48,1,NASDAQ
4618,12-02-2021 16:00,24 hrs.,Daytrading,CMLF,282,282,0,282,1,115,48,1,NASDAQ
4618,12-02-2021 16:00,24 hrs.,Daytrading,CRSR,282,282,0,282,1,115,48,1,NASDAQ
4618,12-02-2021 16:00,24 hrs.,Daytrading,EXPE,4,4,0,4,1,0,0,1,NASDAQ
4618,12-02-2021 16:00,24 hrs.,Daytrading,FOLD,282,282,0,282,1,115,48,1,NASDAQ
4618,12-02-2021 16:00,24 hrs.,Daytrading,FTFT,282,282,0,282,1,115,48,1,NASDAQ
4618,12-02-2021 16:00,24 hrs.,Daytrading,IBKR,16,0,16,-16,1,3,6,1,NASDAQ
4618,12-02-2021 16:00,24 hrs.,Daytrading,ITRM,6,0,6,-6,1,1,0,1,NASDAQ
4618,12-02-2021 16:00,24 hrs.,Daytrading,MARA,282,282,0,282,1,115,48,1,NASDAQ
4618,12-02-2021 16:00,24 hrs.,Daytrading,NOVN,282,282,0,282,1,115,48,1,NASDAQ
4618,12-02-2021 16:00,24 hrs.,Daytrading,OCGN,27,21,6,15,2,5,9,2,NASDAQ
4618,12-02-2021 16:00,24 hrs.,Daytrading,PLAY,10,10,0,10,1,0,6,1,NASDAQ
4618,12-02-2021 16:00,24 hrs.,Daytrading,PLUS,10,0,10,-10,1,2,2,1,NASDAQ
4618,12-02-2021 16:00,24 hrs.,Daytrading,PYPL,282,282,0,282,1,115,48,1,NASDAQ
4618,12-02-2021 16:00,24 hrs.,Daytrading,RIDE,282,282,0,282,1,115,48,1,NASDAQ
4618,12-02-2021 16:00,24 hrs.,Daytrading,RIOT,282,282,0,282,1,115,48,1,NASDAQ
4618,12-02-2021 16:00,24 hrs.,Daytrading,SNDL,28,11,17,-6,2,4,12,2,NASDAQ
4618,12-02-2021 16:00,24 hrs.,Daytrading,STAY,31,31,0,31,1,13,1,1,NASDAQ
4618,12-02-2021 16:00,24 hrs.,Daytrading,TLRY,331,293,38,255,4,124,67,4,NASDAQ
4618,12-02-2021 16:00,24 hrs.,wallstreetbets,IFMK,26,0,26,-26,4,4,2,3,NASDAQ
4618,12-02-2021 16:00,24 hrs.,wallstreetbets,IIVI,322,322,0,322,1,123,72,1,NASDAQ
4618,12-02-2021 16:00,24 hrs.,wallstreetbets,IMGN,89,0,89,-89,1,29,27,1,NASDAQ
4618,12-02-2021 16:00,24 hrs.,wallstreetbets,IMMR,8,0,8,-8,1,1,2,1,NASDAQ
4618,12-02-2021 16:00,24 hrs.,wallstreetbets,INFI,21,21,0,21,3,3,3,1,NASDAQ
4618,12-02-2021 16:00,24 hrs.,wallstreetbets,INFO,8,8,0,8,1,1,2,1,NASDAQ
4618,12-02-2021 16:00,24 hrs.,wallstreetbets,INPX,49,19,30,-11,8,8,1,7,NASDAQ
4618,12-02-2021 16:00,24 hrs.,wallstreetbets,INTC,33,0,33,-33,5,6,1,3,NASDAQ
4618,12-02-2021 16:00,24 hrs.,wallstreetbets,IRBT,14,0,14,-14,2,2,2,2,NASDAQ
4618,12-02-2021 16:00,24 hrs.,wallstreetbets,IRDM,6,0,6,-6,1,1,0,1,NASDAQ
4618,12-02-2021 16:00,24 hrs.,wallstreetbets,ITRM,27,21,6,15,4,4,3,3,NASDAQ
4618,12-02-2021 16:00,24 hrs.,wallstreetbets,JAGX,12,0,12,-12,2,2,0,1,NASDAQ
4618,12-02-2021 16:00,24 hrs.,wallstreetbets,JBLU,12,6,6,0,2,2,0,2,NASDAQ
4618,12-02-2021 16:00,24 hrs.,wallstreetbets,JNCE,6,0,6,-6,1,1,0,1,NASDAQ
4618,12-02-2021 16:00,24 hrs.,wallstreetbets,KERN,13,0,13,-13,2,2,1,2,NASDAQ
4618,12-02-2021 16:00,24 hrs.,wallstreetbets,KTRA,6,0,6,-6,1,1,0,1,NASDAQ
4618,12-02-2021 16:00,24 hrs.,wallstreetbets,LAKE,6,0,6,-6,1,1,0,1,NASDAQ
4618,12-02-2021 16:00,24 hrs.,wallstreetbets,LAZR,7,7,0,7,1,1,1,1,NASDAQ
4618,12-02-2021 16:00,24 hrs.,wallstreetbets,LEGN,7,7,0,7,1,1,1,1,NASDAQ
4618,12-02-2021 16:00,24 hrs.,wallstreetbets,LGHL,6,0,6,-6,1,1,0,1,NASDAQ
4618,12-02-2021 16:00,24 hrs.,wallstreetbets,LGND,13,13,0,13,2,2,1,2,NASDAQ
4618,12-02-2021 16:00,24 hrs.,wallstreetbets,LIFE,13,13,0,13,2,2,1,2,NASDAQ
4618,12-02-2021 16:00,24 hrs.,wallstreetbets,LITE,322,322,0,322,1,123,72,1,NASDAQ
4618,12-02-2021 16:00,24 hrs.,stocks,SRAC,8,0,8,-8,1,2,0,1,NASDAQ
4618,12-02-2021 16:00,24 hrs.,stocks,SSPK,46,0,46,-46,1,14,14,1,NASDAQ
4618,12-02-2021 16:00,24 hrs.,stocks,SSYS,36,0,36,-36,1,7,18,1,NASDAQ
4618,12-02-2021 16:00,24 hrs.,stocks,SVMK,12,12,0,12,1,3,2,1,NASDAQ
4618,12-02-2021 16:00,24 hrs.,stocks,SWAV,23,0,23,-23,1,3,13,1,NASDAQ
4618,12-02-2021 16:00,24 hrs.,stocks,SWBI,7,0,7,-7,1,1,1,1,NASDAQ
4618,12-02-2021 16:00,24 hrs.,stocks,SWKS,20,20,0,20,1,3,10,1,NASDAQ
4618,12-02-2021 16:00,24 hrs.,stocks,TLRY,624,208,416,-208,11,190,200,11,NASDAQ
4618,12-02-2021 16:00,24 hrs.,stocks,TMDX,23,0,23,-23,1,3,13,1,NASDAQ
4618,12-02-2021 16:00,24 hrs.,stocks,TNXP,18,0,18,-18,3,3,0,2,NASDAQ
4618,12-02-2021 16:00,24 hrs.,stocks,TOPS,7,0,7,-7,1,1,1,1,NASDAQ
4618,12-02-2021 16:00,24 hrs.,stocks,TSLA,131,25,106,-81,4,11,93,4,NASDAQ
4618,12-02-2021 16:00,24 hrs.,stocks,TTWO,6,0,6,-6,1,1,0,1,NASDAQ
4618,12-02-2021 16:00,24 hrs.,stocks,TWOU,25,0,25,-25,2,6,5,1,NASDAQ
4618,12-02-2021 16:00,24 hrs.,stocks,TXMD,12,0,12,-12,2,2,0,2,NASDAQ
4618,12-02-2021 16:00,24 hrs.,stocks,VCEL,23,0,23,-23,1,3,13,1,NASDAQ
4618,12-02-2021 16:00,24 hrs.,stocks,VECO,6,0,6,-6,1,1,0,1,NASDAQ
4618,12-02-2021 16:00,24 hrs.,stocks,VRSN,12,12,0,12,1,3,2,1,NASDAQ
4618,12-02-2021 16:00,24 hrs.,stocks,VUZI,41,0,41,-41,1,9,19,1,NASDAQ
4618,12-02-2021 16:00,24 hrs.,stocks,VXRT,12,0,12,-12,2,2,0,2,NASDAQ
4618,12-02-2021 16:00,24 hrs.,stocks,VXUS,28,0,28,-28,1,7,10,1,NASDAQ
4618,12-02-2021 16:00,24 hrs.,stocks,XCUR,6,0,6,-6,1,1,0,1,NASDAQ
4618,12-02-2021 16:00,24 hrs.,stocks,XERS,6,6,0,6,1,1,0,1,NASDAQ
4618,12-02-2021 16:00,24 hrs.,stocks,XSPA,6,0,6,-6,1,1,0,1,NASDAQ
4618,12-02-2021 16:00,24 hrs.,stocks,ZSAN,12,0,12,-12,2,2,0,2,NASDAQ
4618,12-02-2021 16:00,24 hrs.,stocks,ZYXI,23,0,23,-23,1,3,13,1,NASDAQ
4618,12-02-2021 16:00,24 hrs.,stocks,DISCA,12,12,0,12,2,2,0,2,NASDAQ
4618,12-02-2021 16:00,24 hrs.,Daytrading,AABB,24,24,0,24,1,7,6,1,OTC
4618,12-02-2021 16:00,24 hrs.,Daytrading,HCMC,24,24,0,24,1,7,6,1,OTC
4618,12-02-2021 16:00,24 hrs.,Daytrading,HMPQ,13,0,13,-13,1,2,5,1,OTC
4618,12-02-2021 16:00,24 hrs.,Daytrading,IDEA,6,6,0,6,1,1,0,1,OTC
4618,12-02-2021 16:00,24 hrs.,Daytrading,INKW,17,8,9,-1,2,4,1,2,OTC
4618,12-02-2021 16:00,24 hrs.,Daytrading,LVVV,24,24,0,24,1,7,6,1,OTC
4618,12-02-2021 16:00,24 hrs.,Daytrading,RLTR,6,6,0,6,1,1,0,1,OTC
4618,12-02-2021 16:00,24 hrs.,Daytrading,TSTS,30,24,6,18,2,8,6,2,OTC
4618,12-02-2021 16:00,24 hrs.,Daytrading,MNKKQ,6,0,6,-6,1,1,0,1,OTC
4618,12-02-2021 16:00,24 hrs.,Daytrading,DNN,288,288,0,288,2,116,48,2,AMEX
4618,12-02-2021 16:00,24 hrs.,Daytrading,DSS,282,282,0,282,1,115,48,1,AMEX
4618,12-02-2021 16:00,24 hrs.,Daytrading,MXC,6,6,0,6,1,1,0,1,AMEX
4618,12-02-2021 16:00,24 hrs.,Daytrading,TRX,6,6,0,6,1,1,0,1,AMEX
4618,12-02-2021 16:00,24 hrs.,Daytrading,TRXC,6,0,6,-6,1,1,0,1,AMEX
4618,12-02-2021 16:00,24 hrs.,Daytrading,ACB,288,288,0,288,2,116,48,2,NYSE
4618,12-02-2021 16:00,24 hrs.,Daytrading,ADX,6,6,0,6,1,1,0,1,NYSE
4618,12-02-2021 16:00,24 hrs.,Daytrading,AMC,6,0,6,-6,1,1,0,1,NYSE
4618,12-02-2021 16:00,24 hrs.,Daytrading,BDX,7,7,0,7,1,1,1,1,NYSE
4618,12-02-2021 16:00,24 hrs.,Daytrading,BFT,10,0,10,-10,1,2,2,1,NYSE
4618,12-02-2021 16:00,24 hrs.,Daytrading,FSR,282,282,0,282,1,115,48,1,NYSE
4618,12-02-2021 16:00,24 hrs.,Daytrading,GME,6,6,0,6,1,1,0,1,NYSE
4618,12-02-2021 16:00,24 hrs.,wallstreetbets,PFE,19,7,12,-5,3,3,1,3,NYSE
4618,12-02-2021 16:00,24 hrs.,wallstreetbets,PMO,7,7,0,7,1,1,1,1,NYSE
4618,12-02-2021 16:00,24 hrs.,wallstreetbets,PSA,1394,29,1365,-1336,6,551,268,6,NYSE
4618,12-02-2021 16:00,24 hrs.,wallstreetbets,PSX,5473,5473,0,5473,1,2354,761,1,NYSE
4618,12-02-2021 16:00,24 hrs.,wallstreetbets,RAD,80,0,80,-80,1,27,22,1,NYSE
4618,12-02-2021 16:00,24 hrs.,wallstreetbets,RCL,217,0,217,-217,1,76,61,1,NYSE
4618,12-02-2021 16:00,24 hrs.,wallstreetbets,RDY,6,6,0,6,1,1,0,1,NYSE
4618,12-02-2021 16:00,24 hrs.,wallstreetbets,RIG,6,0,6,-6,1,1,0,1,NYSE
4618,12-02-2021 16:00,24 hrs.,wallstreetbets,RKT,879,27,852,-825,22,251,289,18,NYSE
4618,12-02-2021 16:00,24 hrs.,wallstreetbets,RMO,82,69,13,56,12,12,10,8,NYSE
4618,12-02-2021 16:00,24 hrs.,wallstreetbets,RSI,30,6,24,-18,5,5,0,4,NYSE
4618,12-02-2021 16:00,24 hrs.,wallstreetbets,RTX,7,0,7,-7,1,1,1,1,NYSE
4618,12-02-2021 16:00,24 hrs.,wallstreetbets,SBE,12,0,12,-12,2,2,0,2,NYSE
4618,12-02-2021 16:00,24 hrs.,wallstreetbets,SBI,7,0,7,-7,1,1,1,1,NYSE
4618,12-02-2021 16:00,24 hrs.,wallstreetbets,SCI,563,0,563,-563,3,210,131,2,NYSE
4618,12-02-2021 16:00,24 hrs.,wallstreetbets,SKM,29,29,0,29,1,0,25,1,NYSE
4618,12-02-2021 16:00,24 hrs.,wallstreetbets,SKT,26,7,19,-12,4,4,2,3,NYSE
4618,12-02-2021 16:00,24 hrs.,wallstreetbets,SKY,6,0,6,-6,1,1,0,1,NYSE
4618,12-02-2021 16:00,24 hrs.,wallstreetbets,SNE,7,7,0,7,1,1,1,1,NYSE
4618,12-02-2021 16:00,24 hrs.,wallstreetbets,SNP,6,0,6,-6,1,1,0,1,NYSE
4618,12-02-2021 16:00,24 hrs.,wallstreetbets,SNX,6,6,0,6,1,1,0,1,NYSE
4618,12-02-2021 16:00,24 hrs.,wallstreetbets,SOL,14,14,0,14,2,2,2,2,NYSE
4618,12-02-2021 16:00,24 hrs.,wallstreetbets,SOS,261,40,221,-181,41,40,17,28,NYSE
4618,12-02-2021 16:00,24 hrs.,wallstreetbets,SPG,59,0,59,-59,2,1,49,2,NYSE
4618,12-02-2021 16:00,24 hrs.,wallstreetbets,SPH,13,13,0,13,2,2,1,2,NYSE
4618,12-02-2021 16:00,24 hrs.,wallstreetbets,STM,405,0,405,-405,1,146,109,1,NYSE
4618,12-02-2021 16:00,24 hrs.,wallstreetbets,SUN,12,6,6,0,2,2,0,2,NYSE
4618,12-02-2021 16:00,24 hrs.,wallstreetbets,TAK,14,14,0,14,2,2,2,2,NYSE
4618,12-02-2021 16:00,24 hrs.,wallstreetbets,TAP,12,0,12,-12,2,2,0,2,NYSE
4618,12-02-2021 16:00,24 hrs.,stocks,RIOT,6,0,6,-6,1,1,0,1,NASDAQ
4618,12-02-2021 16:00,24 hrs.,stocks,SABR,45,45,0,45,1,10,21,1,NASDAQ
4618,12-02-2021 16:00,24 hrs.,stocks,SEEL,18,12,6,6,3,3,0,2,NASDAQ
4618,12-02-2021 16:00,24 hrs.,stocks,SNDL,94,25,69,-44,15,15,4,13,NASDAQ
4618,12-02-2021 16:00,24 hrs.,stocks,SNGX,11,11,0,11,1,3,1,1,NASDAQ
4618,12-02-2021 16:00,24 hrs.,stocks,SPRO,23,0,23,-23,1,3,13,1,NASDAQ
4618,12-02-2021 16:00,24 hrs.,stocks,SQQQ,7,0,7,-7,1,1,1,1,NASDAQ
4618,12-02-2021 16:00,24 hrs.,wallstreetbets,FCX,101,28,73,-45,6,24,29,3,NYSE
4618,12-02-2021 16:00,24 hrs.,wallstreetbets,FLT,31,7,24,-17,5,5,1,4,NYSE
4618,12-02-2021 16:00,24 hrs.,wallstreetbets,FMS,13,0,13,-13,2,2,1,2,NYSE
4618,12-02-2021 16:00,24 hrs.,wallstreetbets,FOF,6,0,6,-6,1,1,0,1,NYSE
4618,12-02-2021 16:00,24 hrs.,wallstreetbets,FRO,6,6,0,6,1,1,0,1,NYSE
4618,12-02-2021 16:00,24 hrs.,wallstreetbets,FSD,12,0,12,-12,2,2,0,1,NYSE
4618,12-02-2021 16:00,24 hrs.,wallstreetbets,FSR,642,189,453,-264,34,189,128,16,NYSE
4618,12-02-2021 16:00,24 hrs.,wallstreetbets,FTI,7,0,7,-7,1,1,1,1,NYSE
4618,12-02-2021 16:00,24 hrs.,wallstreetbets,GAM,7,7,0,7,1,1,1,1,NYSE
4618,12-02-2021 16:00,24 hrs.,wallstreetbets,GEO,33,21,12,9,5,5,3,2,NYSE
4618,12-02-2021 16:00,24 hrs.,wallstreetbets,GLW,14,14,0,14,2,2,2,2,NYSE
4618,12-02-2021 16:00,24 hrs.,wallstreetbets,GME,126227,4017,122210,-118193,506,56653,10897,409,NYSE
4618,12-02-2021 16:00,24 hrs.,wallstreetbets,GTT,6,0,6,-6,1,1,0,1,NYSE
4618,12-02-2021 16:00,24 hrs.,wallstreetbets,GUT,6,0,6,-6,1,1,0,1,NYSE
4618,12-02-2021 16:00,24 hrs.,wallstreetbets,HAL,6,0,6,-6,1,1,0,1,NYSE
4618,12-02-2021 16:00,24 hrs.,wallstreetbets,HII,12,0,12,-12,2,2,0,1,NYSE
4618,12-02-2021 16:00,24 hrs.,wallstreetbets,HON,6,0,6,-6,1,1,0,1,NYSE
4618,12-02-2021 16:00,24 hrs.,wallstreetbets,HRB,96,0,96,-96,1,21,50,1,NYSE
4618,12-02-2021 16:00,24 hrs.,wallstreetbets,HVT,55,0,55,-55,9,9,1,2,NYSE
4618,12-02-2021 16:00,24 hrs.,wallstreetbets,IAG,14,14,0,14,2,2,2,2,NYSE
4618,12-02-2021 16:00,24 hrs.,wallstreetbets,IBM,12,0,12,-12,2,2,0,2,NYSE
4618,12-02-2021 16:00,24 hrs.,wallstreetbets,INN,6,0,6,-6,1,1,0,1,NYSE
4618,12-02-2021 16:00,24 hrs.,wallstreetbets,IVC,6,0,6,-6,1,1,0,1,NYSE
4618,12-02-2021 16:00,24 hrs.,wallstreetbets,IVR,196,20,176,-156,4,63,54,4,NYSE
4618,12-02-2021 16:00,24 hrs.,wallstreetbets,JNJ,13,13,0,13,2,2,1,2,NYSE
4618,12-02-2021 16:00,24 hrs.,wallstreetbets,JOE,6,0,6,-6,1,1,0,1,NYSE
4618,12-02-2021 16:00,24 hrs.,wallstreetbets,KGC,18,0,18,-18,3,3,0,2,NYSE
4618,12-02-2021 16:00,24 hrs.,wallstreetbets,LAC,19,12,7,5,3,3,1,3,NYSE
4618,12-02-2021 16:00,24 hrs.,wallstreetbets,LEG,6,0,6,-6,1,1,0,1,NYSE
4618,12-02-2021 16:00,24 hrs.,wallstreetbets,LEN,6,6,0,6,1,1,0,1,NYSE
4618,12-02-2021 16:00,24 hrs.,wallstreetbets,LMT,13,0,13,-13,2,2,1,2,NYSE
4618,12-02-2021 16:00,24 hrs.,wallstreetbets,LOW,1008,22,986,-964,9,416,140,8,NYSE
4618,12-02-2021 16:00,24 hrs.,wallstreetbets,LTC,7,0,7,-7,1,1,1,1,NYSE
4618,12-02-2021 16:00,24 hrs.,wallstreetbets,MAC,9,9,0,9,1,1,3,1,NYSE
4618,12-02-2021 16:00,24 hrs.,wallstreetbets,MBI,14,14,0,14,2,2,2,2,NYSE
4618,12-02-2021 16:00,24 hrs.,wallstreetbets,MCO,322,322,0,322,1,123,72,1,NYSE
4618,12-02-2021 16:00,24 hrs.,wallstreetbets,MEN,6,0,6,-6,1,1,0,1,NYSE
4618,12-02-2021 16:00,24 hrs.,wallstreetbets,MFA,7,7,0,7,1,1,1,1,NYSE
4618,12-02-2021 16:00,24 hrs.,wallstreetbets,MRO,334,322,12,310,3,125,72,3,NYSE
4618,12-02-2021 16:00,24 hrs.,wallstreetbets,MSM,7,7,0,7,1,1,1,1,NYSE
4618,12-02-2021 16:00,24 hrs.,wallstreetbets,MTL,6,6,0,6,1,1,0,1,NYSE
4618,12-02-2021 16:00,24 hrs.,wallstreetbets,NAT,38,13,25,-12,6,5,4,4,NYSE
4618,12-02-2021 16:00,24 hrs.,wallstreetbets,NAV,382,0,382,-382,1,116,146,1,NYSE
4618,12-02-2021 16:00,24 hrs.,wallstreetbets,NET,18,0,18,-18,3,3,0,2,NYSE
4618,12-02-2021 16:00,24 hrs.,wallstreetbets,NGA,6,6,0,6,1,1,0,1,NYSE
4618,12-02-2021 16:00,24 hrs.,wallstreetbets,NIO,474,405,69,336,18,86,230,14,NYSE
4618,12-02-2021 16:00,24 hrs.,wallstreetbets,NOC,7,0,7,-7,1,1,1,1,NYSE
4618,12-02-2021 16:00,24 hrs.,wallstreetbets,NOK,721,499,222,277,50,211,99,41,NYSE
4618,12-02-2021 16:00,24 hrs.,wallstreetbets,NVO,36,6,30,-24,6,6,0,3,NYSE
4618,12-02-2021 16:00,24 hrs.,wallstreetbets,NYC,14,14,0,14,2,2,2,2,NYSE
4618,12-02-2021 16:00,24 hrs.,wallstreetbets,OGE,7,7,0,7,1,1,1,1,NYSE
4618,12-02-2021 16:00,24 hrs.,wallstreetbets,OPP,7,7,0,7,1,1,1,1,NYSE
4618,12-02-2021 16:00,24 hrs.,wallstreetbets,OPY,6,0,6,-6,1,1,0,1,NYSE
4618,12-02-2021 16:00,24 hrs.,wallstreetbets,OXY,13,0,13,-13,2,2,1,2,NYSE
4618,12-02-2021 16:00,24 hrs.,wallstreetbets,PCG,478,96,382,-286,2,137,196,2,NYSE
4618,12-02-2021 16:00,24 hrs.,wallstreetbets,PDT,13,13,0,13,2,2,1,2,NYSE
4618,12-02-2021 16:00,24 hrs.,wallstreetbets,PEG,226,0,226,-226,1,79,64,1,NYSE
4618,12-02-2021 16:00,24 hrs.,stocks,DOCU,6,6,0,6,1,1,0,1,NASDAQ
4618,12-02-2021 16:00,24 hrs.,stocks,DOYU,7,0,7,-7,1,1,1,1,NASDAQ
4618,12-02-2021 16:00,24 hrs.,stocks,ENTX,7,7,0,7,1,1,1,1,NASDAQ
4618,12-02-2021 16:00,24 hrs.,stocks,ETSY,26,26,0,26,1,5,12,1,NASDAQ
4618,12-02-2021 16:00,24 hrs.,stocks,EVFM,18,0,18,-18,2,5,0,2,NASDAQ
4618,12-02-2021 16:00,24 hrs.,stocks,EXAS,23,0,23,-23,1,3,13,1,NASDAQ
4618,12-02-2021 16:00,24 hrs.,stocks,EXPE,12,12,0,12,1,3,2,1,NASDAQ
4618,12-02-2021 16:00,24 hrs.,stocks,EXPI,6,0,6,-6,1,1,0,1,NASDAQ
4618,12-02-2021 16:00,24 hrs.,stocks,FLXN,29,0,29,-29,1,9,7,1,NASDAQ
4618,12-02-2021 16:00,24 hrs.,stocks,FROG,6,0,6,-6,1,1,0,1,NASDAQ
4618,12-02-2021 16:00,24 hrs.,stocks,FSRV,6,0,6,-6,1,1,0,1,NASDAQ
4618,12-02-2021 16:00,24 hrs.,stocks,GILT,45,0,45,-45,1,14,13,1,NASDAQ
4618,12-02-2021 16:00,24 hrs.,stocks,GLBS,6,0,6,-6,1,1,0,1,NASDAQ
4618,12-02-2021 16:00,24 hrs.,stocks,GNUS,6,6,0,6,1,1,0,1,NASDAQ
4618,12-02-2021 16:00,24 hrs.,stocks,GOEV,6,0,6,-6,1,1,0,1,NASDAQ
4618,12-02-2021 16:00,24 hrs.,stocks,GTEC,6,0,6,-6,1,1,0,1,NASDAQ
4618,12-02-2021 16:00,24 hrs.,stocks,GTHX,6,0,6,-6,1,1,0,1,NASDAQ
4618,12-02-2021 16:00,24 hrs.,stocks,HTBX,6,6,0,6,1,1,0,1,NASDAQ
4618,12-02-2021 16:00,24 hrs.,stocks,ICLN,24,24,0,24,1,5,10,1,NASDAQ
4618,12-02-2021 16:00,24 hrs.,stocks,ICPT,19,0,19,-19,1,5,5,1,NASDAQ
4618,12-02-2021 16:00,24 hrs.,stocks,IFMK,6,0,6,-6,1,1,0,1,NASDAQ
4618,12-02-2021 16:00,24 hrs.,stocks,IIVI,12,12,0,12,1,3,2,1,NASDAQ
4618,12-02-2021 16:00,24 hrs.,stocks,INPX,18,18,0,18,3,3,0,1,NASDAQ
4618,12-02-2021 16:00,24 hrs.,stocks,INTC,78,37,41,-4,2,20,30,2,NASDAQ
4618,12-02-2021 16:00,24 hrs.,stocks,INVE,7,7,0,7,1,1,1,1,NASDAQ
4618,12-02-2021 16:00,24 hrs.,stocks,KLIC,6,0,6,-6,1,1,0,1,NASDAQ
4618,12-02-2021 16:00,24 hrs.,stocks,KPTI,29,0,29,-29,1,9,7,1,NASDAQ
4618,12-02-2021 16:00,24 hrs.,stocks,LITE,12,12,0,12,1,3,2,1,NASDAQ
4618,12-02-2021 16:00,24 hrs.,stocks,LIVE,12,12,0,12,1,3,2,1,NASDAQ
4618,12-02-2021 16:00,24 hrs.,stocks,LPTH,6,0,6,-6,1,1,0,1,NASDAQ
4618,12-02-2021 16:00,24 hrs.,stocks,LRCX,20,20,0,20,1,3,10,1,NASDAQ
4618,12-02-2021 16:00,24 hrs.,stocks,MBRX,6,0,6,-6,1,1,0,1,NASDAQ
4618,12-02-2021 16:00,24 hrs.,stocks,MELI,41,0,41,-41,1,6,25,1,NASDAQ
4618,12-02-2021 16:00,24 hrs.,stocks,MGNI,64,0,64,-64,1,14,32,1,NASDAQ
4618,12-02-2021 16:00,24 hrs.,stocks,MKSI,12,12,0,12,1,3,2,1,NASDAQ
4618,12-02-2021 16:00,24 hrs.,stocks,MNPR,6,6,0,6,1,1,0,1,NASDAQ
4618,12-02-2021 16:00,24 hrs.,stocks,MSFT,24733,26,24707,-24681,3,11499,1723,3,NASDAQ
4618,12-02-2021 16:00,24 hrs.,stocks,MSTR,6,0,6,-6,1,1,0,1,NASDAQ
4618,12-02-2021 16:00,24 hrs.,stocks,MTCH,274,0,274,-274,1,54,162,1,NASDAQ
4618,12-02-2021 16:00,24 hrs.,stocks,MVIS,12,0,12,-12,2,2,0,2,NASDAQ
4618,12-02-2021 16:00,24 hrs.,stocks,NAKD,25,6,19,-13,3,3,7,3,NASDAQ
4618,12-02-2021 16:00,24 hrs.,stocks,NCMI,32,32,0,32,2,11,2,1,NASDAQ
4618,12-02-2021 16:00,24 hrs.,stocks,NTLA,14,0,14,-14,1,3,4,1,NASDAQ
4618,12-02-2021 16:00,24 hrs.,stocks,NTRS,8,0,8,-8,1,1,2,1,NASDAQ
4618,12-02-2021 16:00,24 hrs.,stocks,NVDA,24790,46,24744,-24698,5,11506,1758,5,NASDAQ
4618,12-02-2021 16:00,24 hrs.,stocks,NXTD,12,12,0,12,2,2,0,1,NASDAQ
4618,12-02-2021 16:00,24 hrs.,stocks,NYMT,8,8,0,8,1,1,2,1,NASDAQ
4618,12-02-2021 16:00,24 hrs.,stocks,OCGN,6,0,6,-6,1,1,0,1,NASDAQ
4618,12-02-2021 16:00,24 hrs.,stocks,OLED,60,60,0,60,1,27,2,1,NASDAQ
4618,12-02-2021 16:00,24 hrs.,stocks,ONVO,6,6,0,6,1,1,0,1,NASDAQ
4618,12-02-2021 16:00,24 hrs.,stocks,OPRX,23,0,23,-23,1,3,13,1,NASDAQ
4618,12-02-2021 16:00,24 hrs.,stocks,PAAS,6,6,0,6,1,1,0,1,NASDAQ
4618,12-02-2021 16:00,24 hrs.,stocks,PENN,7,0,7,-7,1,1,1,1,NASDAQ
4618,12-02-2021 16:00,24 hrs.,stocks,PGNY,23,0,23,-23,1,3,13,1,NASDAQ
4618,12-02-2021 16:00,24 hrs.,stocks,PHUN,6,6,0,6,1,1,0,1,NASDAQ
4618,12-02-2021 16:00,24 hrs.,stocks,POWW,204,0,204,-204,1,74,52,1,NASDAQ
4618,12-02-2021 16:00,24 hrs.,stocks,PSTV,6,6,0,6,1,1,0,1,NASDAQ
4618,12-02-2021 16:00,24 hrs.,stocks,PYPL,587,0,587,-587,2,238,103,2,NASDAQ
4618,12-02-2021 16:00,24 hrs.,stocks,QCLN,24,24,0,24,1,5,10,1,NASDAQ
4618,12-02-2021 16:00,24 hrs.,stocks,QCOM,14,0,14,-14,2,2,2,1,NASDAQ
4618,12-02-2021 16:00,24 hrs.,stocks,QQQM,67,26,41,-15,2,12,35,2,NASDAQ
4618,12-02-2021 16:00,24 hrs.,stocks,RDFN,16,0,16,-16,1,4,4,1,NASDAQ
4618,12-02-2021 16:00,24 hrs.,stocks,RGEN,23,0,23,-23,1,3,13,1,NASDAQ
4618,12-02-2021 16:00,24 hrs.,stocks,RIDE,59,0,59,-59,1,20,15,1,NASDAQ
4618,12-02-2021 16:00,24 hrs.,stocks,AVXL,6,0,6,-6,1,1,0,1,NASDAQ
4618,12-02-2021 16:00,24 hrs.,stocks,AXDX,6,0,6,-6,1,1,0,1,NASDAQ
4618,12-02-2021 16:00,24 hrs.,stocks,AZRX,12,0,12,-12,1,2,4,1,NASDAQ
4618,12-02-2021 16:00,24 hrs.,stocks,BLDP,6,0,6,-6,1,1,0,1,NASDAQ
4618,12-02-2021 16:00,24 hrs.,stocks,BLNK,37,0,37,-37,1,4,25,1,NASDAQ
4618,12-02-2021 16:00,24 hrs.,stocks,BOXL,7,0,7,-7,1,1,1,1,NASDAQ
4618,12-02-2021 16:00,24 hrs.,stocks,CLEU,7,7,0,7,1,1,1,1,NASDAQ
4618,12-02-2021 16:00,24 hrs.,stocks,CLSK,47,7,40,-33,2,13,13,2,NASDAQ
4618,12-02-2021 16:00,24 hrs.,stocks,CLVS,6,0,6,-6,1,1,0,1,NASDAQ
4618,12-02-2021 16:00,24 hrs.,stocks,CMPS,12,12,0,12,2,2,0,1,NASDAQ
4618,12-02-2021 16:00,24 hrs.,stocks,CNDT,14,14,0,14,1,3,4,1,NASDAQ
4618,12-02-2021 16:00,24 hrs.,stocks,COHR,12,12,0,12,1,3,2,1,NASDAQ
4618,12-02-2021 16:00,24 hrs.,stocks,COST,24643,0,24643,-24643,1,11480,1679,1,NASDAQ
4618,12-02-2021 16:00,24 hrs.,stocks,CREE,6,0,6,-6,1,1,0,1,NASDAQ
4618,12-02-2021 16:00,24 hrs.,stocks,CRSR,45,0,45,-45,1,14,13,1,NASDAQ
4618,12-02-2021 16:00,24 hrs.,stocks,CTRM,57,19,38,-19,9,9,3,8,NASDAQ
4618,12-02-2021 16:00,24 hrs.,stocks,CVLB,6,6,0,6,1,1,0,1,NASDAQ
4618,12-02-2021 16:00,24 hrs.,stocks,CXDC,6,0,6,-6,1,1,0,1,NASDAQ
4618,12-02-2021 16:00,24 hrs.,stocks,DDOG,12,12,0,12,1,3,2,1,NASDAQ
4618,12-02-2021 16:00,24 hrs.,stocks,DFFN,9,9,0,9,1,2,1,1,NASDAQ
4618,12-02-2021 16:00,24 hrs.,stocks,DMTK,23,0,23,-23,1,3,13,1,NASDAQ
4618,12-02-2021 16:00,24 hrs.,wallstreetbets,FAST,6,0,6,-6,1,1,0,1,NASDAQ
4618,12-02-2021 16:00,24 hrs.,wallstreetbets,FCAC,8,8,0,8,1,1,2,1,NASDAQ
4618,12-02-2021 16:00,24 hrs.,wallstreetbets,FCEL,19,6,13,-7,3,3,1,3,NASDAQ
4618,12-02-2021 16:00,24 hrs.,wallstreetbets,FLDM,7,7,0,7,1,1,1,1,NASDAQ
4618,12-02-2021 16:00,24 hrs.,wallstreetbets,FLGT,7,7,0,7,1,1,1,1,NASDAQ
4618,12-02-2021 16:00,24 hrs.,wallstreetbets,FLWR,6,0,6,-6,1,1,0,1,NASDAQ
4618,12-02-2021 16:00,24 hrs.,wallstreetbets,FNKO,12,0,12,-12,2,2,0,2,NASDAQ
4618,12-02-2021 16:00,24 hrs.,wallstreetbets,FOLD,6,0,6,-6,1,1,0,1,NASDAQ
4618,12-02-2021 16:00,24 hrs.,wallstreetbets,FORD,21,7,14,-7,3,3,3,2,NASDAQ
4618,12-02-2021 16:00,24 hrs.,wallstreetbets,FROG,6,0,6,-6,1,1,0,1,NASDAQ
4618,12-02-2021 16:00,24 hrs.,wallstreetbets,FRSX,6,0,6,-6,1,1,0,1,NASDAQ
4618,12-02-2021 16:00,24 hrs.,wallstreetbets,FTOC,6,0,6,-6,1,1,0,1,NASDAQ
4618,12-02-2021 16:00,24 hrs.,wallstreetbets,FUTU,382,0,382,-382,1,116,146,1,NASDAQ
4618,12-02-2021 16:00,24 hrs.,wallstreetbets,GAIN,49,22,27,-5,7,7,7,7,NASDAQ
4618,12-02-2021 16:00,24 hrs.,wallstreetbets,GDRX,7,0,7,-7,1,1,1,1,NASDAQ
4618,12-02-2021 16:00,24 hrs.,wallstreetbets,GERN,7,7,0,7,1,1,1,1,NASDAQ
4618,12-02-2021 16:00,24 hrs.,wallstreetbets,GEVO,13,7,6,1,2,2,1,2,NASDAQ
4618,12-02-2021 16:00,24 hrs.,wallstreetbets,GHIV,382,0,382,-382,1,116,146,1,NASDAQ
4618,12-02-2021 16:00,24 hrs.,wallstreetbets,GHSI,20,0,20,-20,3,3,2,2,NASDAQ
4618,12-02-2021 16:00,24 hrs.,wallstreetbets,GLBS,6,0,6,-6,1,1,0,1,NASDAQ
4618,12-02-2021 16:00,24 hrs.,wallstreetbets,GLMD,21,21,0,21,3,3,3,1,NASDAQ
4618,12-02-2021 16:00,24 hrs.,wallstreetbets,GLPG,7,7,0,7,1,1,1,1,NASDAQ
4618,12-02-2021 16:00,24 hrs.,wallstreetbets,GLSI,8,0,8,-8,1,1,2,1,NASDAQ
4618,12-02-2021 16:00,24 hrs.,wallstreetbets,GLUU,37,31,6,25,3,2,21,2,NASDAQ
4618,12-02-2021 16:00,24 hrs.,wallstreetbets,GMBL,7,7,0,7,1,1,1,1,NASDAQ
4618,12-02-2021 16:00,24 hrs.,wallstreetbets,GNLN,6,0,6,-6,1,1,0,1,NASDAQ
4618,12-02-2021 16:00,24 hrs.,wallstreetbets,GNMK,6,0,6,-6,1,1,0,1,NASDAQ
4618,12-02-2021 16:00,24 hrs.,wallstreetbets,GNOG,19,7,12,-5,3,3,1,3,NASDAQ
4618,12-02-2021 16:00,24 hrs.,wallstreetbets,GNRS,14,14,0,14,2,2,2,1,NASDAQ
4618,12-02-2021 16:00,24 hrs.,wallstreetbets,GOEV,56,0,56,-56,9,9,2,2,NASDAQ
4618,12-02-2021 16:00,24 hrs.,wallstreetbets,GOGO,26,7,19,-12,4,4,2,3,NASDAQ
4618,12-02-2021 16:00,24 hrs.,wallstreetbets,GOLD,254,7,247,-240,5,83,68,5,NASDAQ
4618,12-02-2021 16:00,24 hrs.,wallstreetbets,GOOG,1446,0,1446,-1446,1,625,192,1,NASDAQ
4618,12-02-2021 16:00,24 hrs.,wallstreetbets,GPRO,12,0,12,-12,2,2,0,2,NASDAQ
4618,12-02-2021 16:00,24 hrs.,wallstreetbets,GRID,12,0,12,-12,2,2,0,1,NASDAQ
4618,12-02-2021 16:00,24 hrs.,wallstreetbets,GRIL,25,0,25,-25,4,4,1,3,NASDAQ
4618,12-02-2021 16:00,24 hrs.,wallstreetbets,GRMN,6,0,6,-6,1,1,0,1,NASDAQ
4618,12-02-2021 16:00,24 hrs.,wallstreetbets,GRTS,6,0,6,-6,1,1,0,1,NASDAQ
4618,12-02-2021 16:00,24 hrs.,wallstreetbets,GRWG,19,0,19,-19,3,3,1,3,NASDAQ
4618,12-02-2021 16:00,24 hrs.,wallstreetbets,GTEC,12,0,12,-12,2,2,0,1,NASDAQ
4618,12-02-2021 16:00,24 hrs.,wallstreetbets,GTHX,25,18,7,11,4,4,1,3,NASDAQ
4618,12-02-2021 16:00,24 hrs.,wallstreetbets,GWPH,13,13,0,13,1,0,9,1,NASDAQ
4618,12-02-2021 16:00,24 hrs.,wallstreetbets,HALO,7,7,0,7,1,1,1,1,NASDAQ
4618,12-02-2021 16:00,24 hrs.,wallstreetbets,HDSN,7,7,0,7,1,1,1,1,NASDAQ
4618,12-02-2021 16:00,24 hrs.,wallstreetbets,HEPA,9,0,9,-9,1,1,3,1,NASDAQ
4618,12-02-2021 16:00,24 hrs.,wallstreetbets,HGEN,12,0,12,-12,2,2,0,2,NASDAQ
4618,12-02-2021 16:00,24 hrs.,wallstreetbets,HIMX,7,0,7,-7,1,1,1,1,NASDAQ
4618,12-02-2021 16:00,24 hrs.,wallstreetbets,HJLI,14,14,0,14,2,2,2,1,NASDAQ
4618,12-02-2021 16:00,24 hrs.,wallstreetbets,HOFV,12,0,12,-12,2,2,0,1,NASDAQ
4618,12-02-2021 16:00,24 hrs.,wallstreetbets,HSTO,26,26,0,26,4,4,2,3,NASDAQ
4618,12-02-2021 16:00,24 hrs.,wallstreetbets,HTBX,6,6,0,6,1,1,0,1,NASDAQ
4618,12-02-2021 16:00,24 hrs.,wallstreetbets,IBKR,554,0,554,-554,3,180,182,3,NASDAQ
4618,12-02-2021 16:00,24 hrs.,wallstreetbets,ICLN,12,6,6,0,2,2,0,2,NASDAQ
4618,12-02-2021 16:00,24 hrs.,wallstreetbets,ICPT,19,7,12,-5,3,3,1,3,NASDAQ
4618,12-02-2021 16:00,24 hrs.,wallstreetbets,IDEX,150,103,47,56,9,29,56,7,NASDAQ
4618,12-02-2021 16:00,24 hrs.,stocks,YETI,45,45,0,45,1,10,21,1,NYSE
4618,12-02-2021 16:00,24 hrs.,stocks,AAL,46,18,28,-10,2,6,26,2,NASDAQ
4618,12-02-2021 16:00,24 hrs.,stocks,AMD,75,20,55,-35,4,10,39,3,NASDAQ
4618,12-02-2021 16:00,24 hrs.,stocks,AZN,12,12,0,12,1,3,2,1,NASDAQ
4618,12-02-2021 16:00,24 hrs.,stocks,CDC,12,12,0,12,1,3,2,1,NASDAQ
4618,12-02-2021 16:00,24 hrs.,stocks,CGC,12,0,12,-12,2,2,0,2,NASDAQ
4618,12-02-2021 16:00,24 hrs.,stocks,IEA,9,9,0,9,1,2,1,1,NASDAQ
4618,12-02-2021 16:00,24 hrs.,stocks,JFU,6,0,6,-6,1,1,0,1,NASDAQ
4618,12-02-2021 16:00,24 hrs.,stocks,KHC,29,0,29,-29,2,6,9,2,NASDAQ
4618,12-02-2021 16:00,24 hrs.,stocks,LNT,29,0,29,-29,1,9,7,1,NASDAQ
4618,12-02-2021 16:00,24 hrs.,stocks,MIK,6,6,0,6,1,1,0,1,NASDAQ
4618,12-02-2021 16:00,24 hrs.,stocks,NPA,6,0,6,-6,1,1,0,1,NASDAQ
4618,12-02-2021 16:00,24 hrs.,stocks,NWL,12,12,0,12,1,3,2,1,NASDAQ
4618,12-02-2021 16:00,24 hrs.,stocks,OGI,31,18,13,5,5,5,1,5,NASDAQ
4618,12-02-2021 16:00,24 hrs.,stocks,OLB,6,6,0,6,1,1,0,1,NASDAQ
4618,12-02-2021 16:00,24 hrs.,stocks,PEP,6,0,6,-6,1,0,2,1,NASDAQ
4618,12-02-2021 16:00,24 hrs.,stocks,QQQ,48,0,48,-48,2,7,26,2,NASDAQ
4618,12-02-2021 16:00,24 hrs.,stocks,RXT,6,0,6,-6,1,1,0,1,NASDAQ
4618,12-02-2021 16:00,24 hrs.,stocks,SMH,41,0,41,-41,1,6,25,1,NASDAQ
4618,12-02-2021 16:00,24 hrs.,stocks,UFO,35,0,35,-35,3,9,5,1,NASDAQ
4618,12-02-2021 16:00,24 hrs.,stocks,AAPL,24719,0,24719,-24719,4,11496,1711,3,NASDAQ
4618,12-02-2021 16:00,24 hrs.,stocks,ABIO,6,0,6,-6,1,1,0,1,NASDAQ
4618,12-02-2021 16:00,24 hrs.,stocks,ABNB,40,0,40,-40,1,14,8,1,NASDAQ
4618,12-02-2021 16:00,24 hrs.,stocks,ABUS,6,6,0,6,1,1,0,1,NASDAQ
4618,12-02-2021 16:00,24 hrs.,stocks,AEZS,6,0,6,-6,1,1,0,1,NASDAQ
4618,12-02-2021 16:00,24 hrs.,stocks,AGTC,18,12,6,6,3,3,0,2,NASDAQ
4618,12-02-2021 16:00,24 hrs.,stocks,ALJJ,6,0,6,-6,1,1,0,1,NASDAQ
4618,12-02-2021 16:00,24 hrs.,stocks,ALOT,160,0,160,-160,1,41,74,1,NASDAQ
4618,12-02-2021 16:00,24 hrs.,stocks,AMCX,6,0,6,-6,1,1,0,1,NASDAQ
4618,12-02-2021 16:00,24 hrs.,stocks,AMZN,24643,0,24643,-24643,1,11480,1679,1,NASDAQ
4618,12-02-2021 16:00,24 hrs.,stocks,APHA,25628,508,25120,-24612,15,11757,2054,15,NASDAQ
4618,12-02-2021 16:00,24 hrs.,stocks,APXT,6,0,6,-6,1,1,0,1,NASDAQ
4618,12-02-2021 16:00,24 hrs.,stocks,ARTL,18,18,0,18,3,3,0,2,NASDAQ
4618,12-02-2021 16:00,24 hrs.,stocks,ASRT,6,0,6,-6,1,1,0,1,NASDAQ
4618,12-02-2021 16:00,24 hrs.,stocks,ASYS,6,6,0,6,1,1,0,1,NASDAQ
4618,12-02-2021 16:00,24 hrs.,stocks,ATOM,6,0,6,-6,1,1,0,1,NASDAQ
4618,12-02-2021 16:00,24 hrs.,wallstreetbets,CRSR,5555,34,5521,-5487,9,2395,729,7,NASDAQ
4618,12-02-2021 16:00,24 hrs.,wallstreetbets,CSCW,12,0,12,-12,2,2,0,2,NASDAQ
4618,12-02-2021 16:00,24 hrs.,wallstreetbets,CTRM,724,189,535,-346,116,115,30,99,NASDAQ
4618,12-02-2021 16:00,24 hrs.,wallstreetbets,CTRN,6,0,6,-6,1,1,0,1,NASDAQ
4618,12-02-2021 16:00,24 hrs.,wallstreetbets,DBVT,14,8,6,2,2,2,2,2,NASDAQ
4618,12-02-2021 16:00,24 hrs.,wallstreetbets,DCRB,7,0,7,-7,1,1,1,1,NASDAQ
4618,12-02-2021 16:00,24 hrs.,wallstreetbets,DDOG,367,322,45,277,4,136,79,4,NASDAQ
4618,12-02-2021 16:00,24 hrs.,wallstreetbets,DGLY,12,0,12,-12,2,2,0,1,NASDAQ
4618,12-02-2021 16:00,24 hrs.,wallstreetbets,DKNG,976,14,962,-948,4,411,138,4,NASDAQ
4618,12-02-2021 16:00,24 hrs.,wallstreetbets,DLPN,12,0,12,-12,2,2,0,1,NASDAQ
4618,12-02-2021 16:00,24 hrs.,wallstreetbets,DMTK,12,0,12,-12,2,2,0,1,NASDAQ
4618,12-02-2021 16:00,24 hrs.,wallstreetbets,DRRX,7,7,0,7,1,1,1,1,NASDAQ
4618,12-02-2021 16:00,24 hrs.,wallstreetbets,DSKE,7,7,0,7,1,1,1,1,NASDAQ
4618,12-02-2021 16:00,24 hrs.,wallstreetbets,DTIL,6,0,6,-6,1,1,0,1,NASDAQ
4618,12-02-2021 16:00,24 hrs.,wallstreetbets,EDIT,12744,0,12744,-12744,3,5834,1064,3,NASDAQ
4618,12-02-2021 16:00,24 hrs.,wallstreetbets,EDSA,6,6,0,6,1,1,0,1,NASDAQ
4618,12-02-2021 16:00,24 hrs.,wallstreetbets,EHTH,7,7,0,7,1,1,1,1,NASDAQ
4618,12-02-2021 16:00,24 hrs.,wallstreetbets,ENLV,6,0,6,-6,1,1,0,1,NASDAQ
4618,12-02-2021 16:00,24 hrs.,wallstreetbets,ENVB,7,7,0,7,1,1,1,1,NASDAQ
4618,12-02-2021 16:00,24 hrs.,wallstreetbets,ERIC,7,7,0,7,1,1,1,1,NASDAQ
4618,12-02-2021 16:00,24 hrs.,wallstreetbets,ESPR,19,7,12,-5,3,3,1,3,NASDAQ
4618,12-02-2021 16:00,24 hrs.,wallstreetbets,ETSY,12,6,6,0,2,2,0,2,NASDAQ
4618,12-02-2021 16:00,24 hrs.,wallstreetbets,EVER,735,0,735,-735,2,295,137,2,NASDAQ
4618,12-02-2021 16:00,24 hrs.,wallstreetbets,EVFM,6,0,6,-6,1,1,0,1,NASDAQ
4618,12-02-2021 16:00,24 hrs.,wallstreetbets,EXPE,322,322,0,322,1,123,72,1,NASDAQ
4618,12-02-2021 16:00,24 hrs.,wallstreetbets,EYES,26,26,0,26,4,4,2,1,NASDAQ
4618,12-02-2021 16:00,24 hrs.,wallstreetbets,FANG,7,7,0,7,1,1,1,1,NASDAQ
4618,12-02-2021 16:00,24 hrs.,wallstreetbets,FARM,7,7,0,7,1,1,1,1,NASDAQ
4618,12-02-2021 16:00,24 hrs.,stocks,JNJ,24680,0,24680,-24680,2,11484,1704,2,NYSE
4618,12-02-2021 16:00,24 hrs.,stocks,JPM,8,0,8,-8,1,1,2,1,NYSE
4618,12-02-2021 16:00,24 hrs.,stocks,KEY,79,79,0,79,1,30,15,1,NYSE
4618,12-02-2021 16:00,24 hrs.,stocks,KNL,29,0,29,-29,1,9,7,1,NYSE
4618,12-02-2021 16:00,24 hrs.,stocks,LEN,6,6,0,6,1,1,0,1,NYSE
4618,12-02-2021 16:00,24 hrs.,stocks,LMT,6,6,0,6,1,1,0,1,NYSE
4618,12-02-2021 16:00,24 hrs.,stocks,LUV,45,45,0,45,1,10,21,1,NYSE
4618,12-02-2021 16:00,24 hrs.,stocks,MCO,12,12,0,12,1,3,2,1,NYSE
4618,12-02-2021 16:00,24 hrs.,stocks,MFA,8,8,0,8,1,1,2,1,NYSE
4618,12-02-2021 16:00,24 hrs.,stocks,MGM,17,0,17,-17,1,3,7,1,NYSE
4618,12-02-2021 16:00,24 hrs.,stocks,MRO,12,12,0,12,1,3,2,1,NYSE
4618,12-02-2021 16:00,24 hrs.,stocks,NAT,22,0,22,-22,1,4,10,1,NYSE
4618,12-02-2021 16:00,24 hrs.,stocks,NET,364,10,354,-344,2,133,90,2,NYSE
4618,12-02-2021 16:00,24 hrs.,stocks,NGL,6,6,0,6,1,1,0,1,NYSE
4618,12-02-2021 16:00,24 hrs.,stocks,NIO,92,55,37,18,2,18,48,2,NYSE
4618,12-02-2021 16:00,24 hrs.,stocks,NKE,24643,0,24643,-24643,1,11480,1679,1,NYSE
4618,12-02-2021 16:00,24 hrs.,stocks,NOK,16,7,9,-2,2,3,2,2,NYSE
4618,12-02-2021 16:00,24 hrs.,stocks,NOM,35,35,0,35,1,13,5,1,NYSE
4618,12-02-2021 16:00,24 hrs.,stocks,NSA,5869,0,5869,-5869,1,2762,341,1,NYSE
4618,12-02-2021 16:00,24 hrs.,stocks,NVS,18,0,18,-18,3,3,0,1,NYSE
4618,12-02-2021 16:00,24 hrs.,stocks,PDT,6,6,0,6,1,1,0,1,NYSE
4618,12-02-2021 16:00,24 hrs.,stocks,PFE,7,7,0,7,1,1,1,1,NYSE
4618,12-02-2021 16:00,24 hrs.,stocks,RKT,84,0,84,-84,1,32,16,1,NYSE
4618,12-02-2021 16:00,24 hrs.,stocks,RSI,29,0,29,-29,1,9,7,1,NYSE
4618,12-02-2021 16:00,24 hrs.,stocks,SBE,64,0,64,-64,5,21,2,3,NYSE
4618,12-02-2021 16:00,24 hrs.,stocks,SOI,6,6,0,6,1,1,0,1,NYSE
4618,12-02-2021 16:00,24 hrs.,stocks,SOS,24,12,12,0,4,4,0,4,NYSE
4618,12-02-2021 16:00,24 hrs.,stocks,TDA,7,0,7,-7,1,1,1,1,NYSE
4618,12-02-2021 16:00,24 hrs.,stocks,TMO,7,0,7,-7,1,1,1,1,NYSE
4618,12-02-2021 16:00,24 hrs.,stocks,TSM,61,20,41,-21,2,9,35,2,NYSE
4618,12-02-2021 16:00,24 hrs.,stocks,UMC,6,0,6,-6,1,1,0,1,NYSE
4618,12-02-2021 16:00,24 hrs.,stocks,UPS,65,0,65,-65,1,24,13,1,NYSE
4618,12-02-2021 16:00,24 hrs.,stocks,WLL,6,6,0,6,1,1,0,1,NYSE
4618,12-02-2021 16:00,24 hrs.,stocks,WMT,24687,0,24687,-24687,3,11485,1705,3,NYSE
4618,12-02-2021 16:00,24 hrs.,stocks,ALSN,29,0,29,-29,1,9,7,1,NYSE
4618,12-02-2021 16:00,24 hrs.,stocks,AQUA,7,0,7,-7,1,1,1,1,NYSE
4618,12-02-2021 16:00,24 hrs.,stocks,BABA,48,0,48,-48,2,7,26,2,NYSE
4618,12-02-2021 16:00,24 hrs.,stocks,BEPC,22,22,0,22,2,1,12,2,NYSE
4618,12-02-2021 16:00,24 hrs.,stocks,BORR,20,20,0,20,2,6,0,2,NYSE
4618,12-02-2021 16:00,24 hrs.,stocks,CACI,5869,0,5869,-5869,1,2762,341,1,NYSE
4618,12-02-2021 16:00,24 hrs.,stocks,CCIV,12,0,12,-12,2,2,0,2,NYSE
4618,12-02-2021 16:00,24 hrs.,stocks,FTCH,26,26,0,26,1,5,12,1,NYSE
4618,12-02-2021 16:00,24 hrs.,stocks,FVRR,26,26,0,26,1,5,12,1,NYSE
4618,12-02-2021 16:00,24 hrs.,stocks,HUYA,103,63,40,23,2,30,35,2,NYSE
4618,12-02-2021 16:00,24 hrs.,stocks,HYLN,12,0,12,-12,2,2,0,2,NYSE
4618,12-02-2021 16:00,24 hrs.,stocks,JMIA,6,6,0,6,1,1,0,1,NYSE
4618,12-02-2021 16:00,24 hrs.,stocks,MDLY,6,0,6,-6,1,1,0,1,NYSE
4618,12-02-2021 16:00,24 hrs.,stocks,OTIS,29,0,29,-29,1,9,7,1,NYSE
4618,12-02-2021 16:00,24 hrs.,stocks,PINS,41,0,41,-41,1,6,25,1,NYSE
4618,12-02-2021 16:00,24 hrs.,stocks,PLTR,24656,6,24650,-24644,3,11482,1680,3,NYSE
4618,12-02-2021 16:00,24 hrs.,stocks,SKLZ,45,0,45,-45,1,14,13,1,NYSE
4618,12-02-2021 16:00,24 hrs.,stocks,SPCE,24,7,17,-10,3,4,4,3,NYSE
4618,12-02-2021 16:00,24 hrs.,stocks,SPOT,6,0,6,-6,1,1,0,1,NYSE
4618,12-02-2021 16:00,24 hrs.,stocks,TMHC,6,0,6,-6,1,1,0,1,NYSE
4618,12-02-2021 16:00,24 hrs.,stocks,UBER,17,0,17,-17,1,6,1,1,NYSE
4618,12-02-2021 16:00,24 hrs.,stocks,VOYA,29,0,29,-29,1,9,7,1,NYSE
4618,12-02-2021 16:00,24 hrs.,stocks,WORK,6,0,6,-6,1,1,0,1,NYSE
4618,12-02-2021 16:00,24 hrs.,stocks,XPEV,5869,0,5869,-5869,1,2762,341,1,NYSE
4618,12-02-2021 16:00,24 hrs.,wallstreetbets,TER,6,0,6,-6,1,1,0,1,NASDAQ
4618,12-02-2021 16:00,24 hrs.,wallstreetbets,TXN,405,0,405,-405,1,146,109,1,NASDAQ
4618,12-02-2021 16:00,24 hrs.,wallstreetbets,UAL,7,0,7,-7,1,1,1,1,NASDAQ
4618,12-02-2021 16:00,24 hrs.,wallstreetbets,UFO,6,6,0,6,1,1,0,1,NASDAQ
4618,12-02-2021 16:00,24 hrs.,wallstreetbets,VFF,34,14,20,-6,5,5,4,5,NASDAQ
4618,12-02-2021 16:00,24 hrs.,wallstreetbets,WDC,34,0,34,-34,2,10,6,1,NASDAQ
4618,12-02-2021 16:00,24 hrs.,wallstreetbets,WNW,13,7,6,1,2,2,1,2,NASDAQ
4618,12-02-2021 16:00,24 hrs.,wallstreetbets,WVE,6,0,6,-6,1,1,0,1,NASDAQ
4618,12-02-2021 16:00,24 hrs.,wallstreetbets,AACG,7,7,0,7,1,1,1,1,NASDAQ
4618,12-02-2021 16:00,24 hrs.,wallstreetbets,AAPL,1712,14,1698,-1684,10,696,280,10,NASDAQ
4618,12-02-2021 16:00,24 hrs.,wallstreetbets,AAWW,6,6,0,6,1,1,0,1,NASDAQ
4618,12-02-2021 16:00,24 hrs.,wallstreetbets,ABEO,6,0,6,-6,1,1,0,1,NASDAQ
4618,12-02-2021 16:00,24 hrs.,wallstreetbets,ABIO,7,0,7,-7,1,1,1,1,NASDAQ
4618,12-02-2021 16:00,24 hrs.,wallstreetbets,ABNB,29,22,7,15,4,4,5,3,NASDAQ
4618,12-02-2021 16:00,24 hrs.,wallstreetbets,ACIU,19,7,12,-5,3,3,1,3,NASDAQ
4618,12-02-2021 16:00,24 hrs.,wallstreetbets,ACRX,6,0,6,-6,1,1,0,1,NASDAQ
4618,12-02-2021 16:00,24 hrs.,wallstreetbets,ACST,6,0,6,-6,1,1,0,1,NASDAQ
4618,12-02-2021 16:00,24 hrs.,wallstreetbets,ADMP,6,0,6,-6,1,1,0,1,NASDAQ
4618,12-02-2021 16:00,24 hrs.,wallstreetbets,ADXS,6,0,6,-6,1,1,0,1,NASDAQ
4618,12-02-2021 16:00,24 hrs.,wallstreetbets,AESE,30,0,30,-30,5,5,0,2,NASDAQ
4618,12-02-2021 16:00,24 hrs.,wallstreetbets,AEZS,20,14,6,8,3,3,2,2,NASDAQ
4618,12-02-2021 16:00,24 hrs.,wallstreetbets,AGEN,7,7,0,7,1,1,1,1,NASDAQ
4618,12-02-2021 16:00,24 hrs.,wallstreetbets,AGRX,6,0,6,-6,1,1,0,1,NASDAQ
4618,12-02-2021 16:00,24 hrs.,stocks,ICE,25,25,0,25,1,2,17,1,NYSE
4618,12-02-2021 16:00,24 hrs.,stocks,IRS,46,46,0,46,1,16,10,1,NYSE
4618,12-02-2021 16:00,24 hrs.,stocks,IVR,6,0,6,-6,1,1,0,1,NYSE
4618,12-02-2021 16:00,24 hrs.,wallstreetbets,SHOP,963,0,963,-963,2,409,137,2,NYSE
4618,12-02-2021 16:00,24 hrs.,wallstreetbets,SLCA,6,0,6,-6,1,1,0,1,NYSE
4618,12-02-2021 16:00,24 hrs.,wallstreetbets,SNPR,6,0,6,-6,1,1,0,1,NYSE
4618,12-02-2021 16:00,24 hrs.,wallstreetbets,SPCE,1384,670,714,-44,38,508,216,30,NYSE
4618,12-02-2021 16:00,24 hrs.,wallstreetbets,SPOT,7,0,7,-7,1,1,1,1,NYSE
4618,12-02-2021 16:00,24 hrs.,wallstreetbets,STNG,6,0,6,-6,1,1,0,1,NYSE
4618,12-02-2021 16:00,24 hrs.,wallstreetbets,STPK,12,0,12,-12,2,2,0,2,NYSE
4618,12-02-2021 16:00,24 hrs.,wallstreetbets,STWD,96,96,0,96,1,21,50,1,NYSE
4618,12-02-2021 16:00,24 hrs.,wallstreetbets,TDOC,6,6,0,6,1,1,0,1,NYSE
4618,12-02-2021 16:00,24 hrs.,wallstreetbets,TEVA,6,0,6,-6,1,1,0,1,NYSE
4618,12-02-2021 16:00,24 hrs.,wallstreetbets,TWTR,6,0,6,-6,1,1,0,1,NYSE
4618,12-02-2021 16:00,24 hrs.,wallstreetbets,UBER,39,26,13,13,6,6,3,3,NYSE
4618,12-02-2021 16:00,24 hrs.,wallstreetbets,UNVR,6,0,6,-6,1,1,0,1,NYSE
4618,12-02-2021 16:00,24 hrs.,wallstreetbets,VGAC,7,7,0,7,1,1,1,1,NYSE
4618,12-02-2021 16:00,24 hrs.,wallstreetbets,VSTO,8,0,8,-8,1,1,2,1,NYSE
4618,12-02-2021 16:00,24 hrs.,wallstreetbets,WELL,325,0,325,-325,1,123,75,1,NYSE
4618,12-02-2021 16:00,24 hrs.,wallstreetbets,WORK,865,851,14,837,3,311,231,3,NYSE
4618,12-02-2021 16:00,24 hrs.,wallstreetbets,XPEV,13,7,6,1,2,2,1,2,NYSE
4618,12-02-2021 16:00,24 hrs.,wallstreetbets,AAL,39,12,27,-15,6,6,3,5,NASDAQ
4618,12-02-2021 16:00,24 hrs.,wallstreetbets,ADI,405,0,405,-405,1,146,109,1,NASDAQ
4618,12-02-2021 16:00,24 hrs.,wallstreetbets,ADV,6,0,6,-6,1,1,0,1,NASDAQ
4618,12-02-2021 16:00,24 hrs.,wallstreetbets,AMD,3265,856,2409,-1553,29,1183,783,27,NASDAQ
4618,12-02-2021 16:00,24 hrs.,wallstreetbets,AQB,6,0,6,-6,1,1,0,1,NASDAQ
4618,12-02-2021 16:00,24 hrs.,wallstreetbets,ASO,18,6,12,-6,3,3,0,2,NASDAQ
4618,12-02-2021 16:00,24 hrs.,wallstreetbets,AWH,13,0,13,-13,2,2,1,1,NASDAQ
4618,12-02-2021 16:00,24 hrs.,wallstreetbets,AZN,340,322,18,304,4,126,72,4,NASDAQ
4618,12-02-2021 16:00,24 hrs.,wallstreetbets,BBC,6,0,6,-6,1,1,0,1,NASDAQ
4618,12-02-2021 16:00,24 hrs.,wallstreetbets,BFI,39,14,25,-11,6,6,3,3,NASDAQ
4618,12-02-2021 16:00,24 hrs.,wallstreetbets,CDC,322,322,0,322,1,123,72,1,NASDAQ
4618,12-02-2021 16:00,24 hrs.,wallstreetbets,CGC,1513,96,1417,-1321,15,526,401,14,NASDAQ
4618,12-02-2021 16:00,24 hrs.,wallstreetbets,DYN,6,0,6,-6,1,1,0,1,NASDAQ
4618,12-02-2021 16:00,24 hrs.,wallstreetbets,ESG,8,0,8,-8,1,1,2,1,NASDAQ
4618,12-02-2021 16:00,24 hrs.,wallstreetbets,FAT,33,33,0,33,1,10,9,1,NASDAQ
4618,12-02-2021 16:00,24 hrs.,wallstreetbets,FLL,18,0,18,-18,3,3,0,2,NASDAQ
4618,12-02-2021 16:00,24 hrs.,wallstreetbets,FUV,7,7,0,7,1,1,1,1,NASDAQ
4618,12-02-2021 16:00,24 hrs.,wallstreetbets,FWP,6,0,6,-6,1,1,0,1,NASDAQ
4618,12-02-2021 16:00,24 hrs.,wallstreetbets,GBT,6,0,6,-6,1,1,0,1,NASDAQ
4618,12-02-2021 16:00,24 hrs.,wallstreetbets,GSM,6,0,6,-6,1,1,0,1,NASDAQ
4618,12-02-2021 16:00,24 hrs.,wallstreetbets,HAS,77,20,57,-37,12,12,5,12,NASDAQ
4618,12-02-2021 16:00,24 hrs.,wallstreetbets,HPK,6,6,0,6,1,1,0,1,NASDAQ
4618,12-02-2021 16:00,24 hrs.,wallstreetbets,III,6,6,0,6,1,1,0,1,NASDAQ
4618,12-02-2021 16:00,24 hrs.,wallstreetbets,INO,686,617,69,548,19,233,144,17,NASDAQ
4618,12-02-2021 16:00,24 hrs.,wallstreetbets,IPA,7,0,7,-7,1,1,1,1,NASDAQ
4618,12-02-2021 16:00,24 hrs.,wallstreetbets,JFU,6,0,6,-6,1,1,0,1,NASDAQ
4618,12-02-2021 16:00,24 hrs.,wallstreetbets,KHC,12,0,12,-12,2,2,0,2,NASDAQ
4618,12-02-2021 16:00,24 hrs.,wallstreetbets,KOD,6,6,0,6,1,1,0,1,NASDAQ
4618,12-02-2021 16:00,24 hrs.,wallstreetbets,MGI,9,9,0,9,1,1,3,1,NASDAQ
4618,12-02-2021 16:00,24 hrs.,wallstreetbets,MWK,8,0,8,-8,1,2,0,1,NASDAQ
4618,12-02-2021 16:00,24 hrs.,wallstreetbets,NPA,13,6,7,-1,2,2,1,2,NASDAQ
4618,12-02-2021 16:00,24 hrs.,wallstreetbets,NWL,322,322,0,322,1,123,72,1,NASDAQ
4618,12-02-2021 16:00,24 hrs.,wallstreetbets,OGI,415,35,380,-345,29,93,113,27,NASDAQ
4618,12-02-2021 16:00,24 hrs.,wallstreetbets,OPT,13,0,13,-13,2,2,1,2,NASDAQ
4618,12-02-2021 16:00,24 hrs.,wallstreetbets,PTE,35,35,0,35,5,5,5,1,NASDAQ
4618,12-02-2021 16:00,24 hrs.,wallstreetbets,QQQ,962,0,962,-962,2,409,136,2,NASDAQ
4618,12-02-2021 16:00,24 hrs.,wallstreetbets,RCM,6,0,6,-6,1,1,0,1,NASDAQ
4618,12-02-2021 16:00,24 hrs.,wallstreetbets,RUN,19,0,19,-19,3,3,1,3,NASDAQ
4618,12-02-2021 16:00,24 hrs.,wallstreetbets,SDC,6,0,6,-6,1,1,0,1,NASDAQ
4618,12-02-2021 16:00,24 hrs.,wallstreetbets,SLS,6,0,6,-6,1,1,0,1,NASDAQ
4618,12-02-2021 16:00,24 hrs.,wallstreetbets,SMH,12,0,12,-12,2,2,0,2,NASDAQ
4618,12-02-2021 16:00,24 hrs.,wallstreetbets,SND,27,27,0,27,4,4,3,4,NASDAQ
4618,12-02-2021 16:00,24 hrs.,wallstreetbets,SPI,7,7,0,7,1,1,1,1,NASDAQ
4618,12-02-2021 16:00,24 hrs.,stocks,HEMP,6,6,0,6,1,1,0,1,OTC
4618,12-02-2021 16:00,24 hrs.,stocks,KGKG,6,0,6,-6,1,1,0,1,OTC
4618,12-02-2021 16:00,24 hrs.,stocks,KYNC,18,0,18,-18,3,3,0,1,OTC
4618,12-02-2021 16:00,24 hrs.,stocks,LINK,12,12,0,12,1,3,2,1,OTC
4618,12-02-2021 16:00,24 hrs.,stocks,MJNA,6,0,6,-6,1,1,0,1,OTC
4618,12-02-2021 16:00,24 hrs.,stocks,MOJO,6,6,0,6,1,1,0,1,OTC
4618,12-02-2021 16:00,24 hrs.,stocks,OZSC,6,6,0,6,1,1,0,1,OTC
4618,12-02-2021 16:00,24 hrs.,stocks,PURA,6,0,6,-6,1,1,0,1,OTC
4618,12-02-2021 16:00,24 hrs.,stocks,PZOO,6,6,0,6,1,1,0,1,OTC
4618,12-02-2021 16:00,24 hrs.,stocks,RSSV,16,16,0,16,1,5,2,1,OTC
4618,12-02-2021 16:00,24 hrs.,stocks,SGMD,36,0,36,-36,6,6,0,2,OTC
4618,12-02-2021 16:00,24 hrs.,stocks,SUIC,6,0,6,-6,1,1,0,1,OTC
4618,12-02-2021 16:00,24 hrs.,stocks,TSTS,6,0,6,-6,1,1,0,1,OTC
4618,12-02-2021 16:00,24 hrs.,stocks,USPS,65,0,65,-65,1,24,13,1,OTC
4618,12-02-2021 16:00,24 hrs.,stocks,ZAAG,6,0,6,-6,1,1,0,1,OTC
4618,12-02-2021 16:00,24 hrs.,stocks,ACRDF,6,6,0,6,1,1,0,1,OTC
4618,12-02-2021 16:00,24 hrs.,stocks,ACRHF,6,6,0,6,1,1,0,1,OTC
4618,12-02-2021 16:00,24 hrs.,stocks,BDRBF,6,6,0,6,1,1,0,1,OTC
4618,12-02-2021 16:00,24 hrs.,stocks,CBWTF,12,0,12,-12,2,2,0,2,OTC
4618,12-02-2021 16:00,24 hrs.,stocks,FLWPF,6,0,6,-6,1,1,0,1,OTC
4618,12-02-2021 16:00,24 hrs.,stocks,GGTTF,6,0,6,-6,1,1,0,1,OTC
4618,12-02-2021 16:00,24 hrs.,stocks,HITIF,6,0,6,-6,1,1,0,1,OTC
4618,12-02-2021 16:00,24 hrs.,stocks,MMNFF,12,0,12,-12,2,2,0,1,OTC
4618,12-02-2021 16:00,24 hrs.,stocks,RLLCF,12,12,0,12,2,2,0,1,OTC
4618,12-02-2021 16:00,24 hrs.,stocks,RNECY,6,0,6,-6,1,1,0,1,OTC
4618,12-02-2021 16:00,24 hrs.,stocks,SFTBY,22,0,22,-22,1,7,4,1,OTC
4618,12-02-2021 16:00,24 hrs.,stocks,VLNCF,6,0,6,-6,1,1,0,1,OTC
4618,12-02-2021 16:00,24 hrs.,stocks,DNN,37,0,37,-37,3,5,15,3,AMEX
4618,12-02-2021 16:00,24 hrs.,stocks,DPW,12,0,12,-12,1,3,2,1,AMEX
4618,12-02-2021 16:00,24 hrs.,stocks,GDP,25,25,0,25,1,2,17,1,AMEX
4618,12-02-2021 16:00,24 hrs.,stocks,MXC,6,6,0,6,1,1,0,1,AMEX
4618,12-02-2021 16:00,24 hrs.,stocks,PLX,11,11,0,11,1,2,3,1,AMEX
4618,12-02-2021 16:00,24 hrs.,stocks,TRX,47,0,47,-47,2,17,5,2,AMEX
4618,12-02-2021 16:00,24 hrs.,stocks,WYY,6,0,6,-6,1,1,0,1,AMEX
4618,12-02-2021 16:00,24 hrs.,stocks,ZOM,31,12,19,-7,5,5,1,5,AMEX
4618,12-02-2021 16:00,24 hrs.,stocks,TMBR,6,6,0,6,1,1,0,1,AMEX
4618,12-02-2021 16:00,24 hrs.,stocks,UAVS,6,0,6,-6,1,1,0,1,AMEX
4618,12-02-2021 16:00,24 hrs.,stocks,ACB,66,6,60,-54,2,16,26,2,NYSE
4618,12-02-2021 16:00,24 hrs.,stocks,AHT,7,0,7,-7,1,1,1,1,NYSE
4618,12-02-2021 16:00,24 hrs.,stocks,AMC,175,81,94,-13,10,42,51,8,NYSE
4618,12-02-2021 16:00,24 hrs.,stocks,ASX,13,7,6,1,2,2,1,2,NYSE
4618,12-02-2021 16:00,24 hrs.,stocks,ATH,39,25,14,11,2,5,21,2,NYSE
4618,12-02-2021 16:00,24 hrs.,stocks,AUY,6,0,6,-6,1,1,0,1,NYSE
4618,12-02-2021 16:00,24 hrs.,stocks,BBY,58,0,58,-58,1,16,22,1,NYSE
4618,12-02-2021 16:00,24 hrs.,stocks,BEP,54,54,0,54,4,3,32,4,NYSE
4618,12-02-2021 16:00,24 hrs.,stocks,BHC,12,12,0,12,1,3,2,1,NYSE
4618,12-02-2021 16:00,24 hrs.,stocks,BLK,8,0,8,-8,1,1,2,1,NYSE
4618,12-02-2021 16:00,24 hrs.,stocks,BNY,8,0,8,-8,1,1,2,1,NYSE
4618,12-02-2021 16:00,24 hrs.,stocks,BTT,12,6,6,0,2,2,0,2,NYSE
4618,12-02-2021 16:00,24 hrs.,stocks,CIA,5869,0,5869,-5869,1,2762,341,1,NYSE
4618,12-02-2021 16:00,24 hrs.,stocks,CRM,6,6,0,6,1,1,0,1,NYSE
4618,12-02-2021 16:00,24 hrs.,stocks,CVE,6,6,0,6,1,1,0,1,NYSE
4618,12-02-2021 16:00,24 hrs.,stocks,CVS,10,10,0,10,1,1,4,1,NYSE
4618,12-02-2021 16:00,24 hrs.,stocks,DDD,36,0,36,-36,1,7,18,1,NYSE
4618,12-02-2021 16:00,24 hrs.,stocks,DIS,24712,12,24700,-24688,3,11502,1696,3,NYSE
4618,12-02-2021 16:00,24 hrs.,stocks,DTE,25,0,25,-25,1,3,15,1,NYSE
4618,12-02-2021 16:00,24 hrs.,stocks,EOS,12,0,12,-12,2,2,0,1,NYSE
4618,12-02-2021 16:00,24 hrs.,stocks,ETH,6,6,0,6,1,1,0,1,NYSE
4618,12-02-2021 16:00,24 hrs.,stocks,FAF,15,0,15,-15,1,3,5,1,NYSE
4618,12-02-2021 16:00,24 hrs.,stocks,FCF,25,25,0,25,1,2,17,1,NYSE
4618,12-02-2021 16:00,24 hrs.,stocks,FCX,6,0,6,-6,1,1,0,1,NYSE
4618,12-02-2021 16:00,24 hrs.,stocks,FSR,26,6,20,-14,2,9,0,2,NYSE
4618,12-02-2021 16:00,24 hrs.,stocks,GME,29455,182,29273,-29091,22,13415,2537,20,NYSE
4618,12-02-2021 16:00,24 hrs.,stocks,IBM,5869,0,5869,-5869,1,2762,341,1,NYSE
4618,12-02-2021 16:00,24 hrs.,SPACs,THCA,148,148,0,148,1,40,64,1,NASDAQ
4618,12-02-2021 16:00,24 hrs.,SPACs,THCB,21,6,15,-9,3,3,3,3,NASDAQ
4618,12-02-2021 16:00,24 hrs.,SPACs,TLRY,14,0,14,-14,1,0,10,1,NASDAQ
4618,12-02-2021 16:00,24 hrs.,SPACs,TMPM,148,148,0,148,1,40,64,1,NASDAQ
4618,12-02-2021 16:00,24 hrs.,SPACs,TMTS,148,148,0,148,1,40,64,1,NASDAQ
4618,12-02-2021 16:00,24 hrs.,SPACs,TTCF,106,0,106,-106,1,22,58,1,NASDAQ
4618,12-02-2021 16:00,24 hrs.,SPACs,TWCT,148,148,0,148,1,40,64,1,NASDAQ
4618,12-02-2021 16:00,24 hrs.,SPACs,UNIT,25,0,25,-25,1,4,13,1,NASDAQ
4618,12-02-2021 16:00,24 hrs.,SPACs,VACQ,148,148,0,148,1,40,64,1,NASDAQ
4618,12-02-2021 16:00,24 hrs.,SPACs,VMAC,162,155,7,148,3,42,66,3,NASDAQ
4618,12-02-2021 16:00,24 hrs.,SPACs,VSPR,45,0,45,-45,1,12,17,1,NASDAQ
4618,12-02-2021 16:00,24 hrs.,SPACs,VTIQ,15,15,0,15,1,3,5,1,NASDAQ
4618,12-02-2021 16:00,24 hrs.,SPACs,YSAC,148,148,0,148,1,40,64,1,NASDAQ
4618,12-02-2021 16:00,24 hrs.,SPACs,ZGYH,148,148,0,148,1,40,64,1,NASDAQ
4618,12-02-2021 16:00,24 hrs.,SPACs,CMLFW,983,983,0,983,1,32,915,1,NASDAQ
4618,12-02-2021 16:00,24 hrs.,SPACs,EXPCW,983,983,0,983,1,32,915,1,NASDAQ
4618,12-02-2021 16:00,24 hrs.,SPACs,FCACW,983,983,0,983,1,32,915,1,NASDAQ
4618,12-02-2021 16:00,24 hrs.,SPACs,FSRVW,983,983,0,983,1,32,915,1,NASDAQ
4618,12-02-2021 16:00,24 hrs.,SPACs,SRACW,983,983,0,983,1,32,915,1,NASDAQ
4618,12-02-2021 16:00,24 hrs.,stocks,AITX,6,0,6,-6,1,1,0,1,OTC
4618,12-02-2021 16:00,24 hrs.,stocks,ALPP,6,0,6,-6,1,1,0,1,OTC
4618,12-02-2021 16:00,24 hrs.,stocks,APTY,6,6,0,6,1,1,0,1,OTC
4618,12-02-2021 16:00,24 hrs.,stocks,BIEL,6,0,6,-6,1,1,0,1,OTC
4618,12-02-2021 16:00,24 hrs.,stocks,CAGR,23,0,23,-23,1,3,13,1,OTC
4618,12-02-2021 16:00,24 hrs.,stocks,CORG,6,0,6,-6,1,1,0,1,OTC
4618,12-02-2021 16:00,24 hrs.,stocks,DIGI,6,6,0,6,1,1,0,1,OTC
4618,12-02-2021 16:00,24 hrs.,stocks,FNMA,6,6,0,6,1,1,0,1,OTC
4618,12-02-2021 16:00,24 hrs.,stocks,HCMC,78,12,66,-54,6,19,16,6,OTC
4618,12-02-2021 16:00,24 hrs.,wallstreetbets,GTE,143,27,116,-89,23,23,5,20,AMEX
4618,12-02-2021 16:00,24 hrs.,wallstreetbets,GTBIF,670,0,670,-670,2,211,240,2,OTC
4618,12-02-2021 16:00,24 hrs.,wallstreetbets,GUESF,6,0,6,-6,1,1,0,1,OTC
4618,12-02-2021 16:00,24 hrs.,wallstreetbets,HITIF,25,7,18,-11,4,4,1,4,OTC
4618,12-02-2021 16:00,24 hrs.,wallstreetbets,HRSTW,5,5,0,5,1,0,1,1,OTC
4618,12-02-2021 16:00,24 hrs.,wallstreetbets,HUTMF,13,13,0,13,2,2,1,2,OTC
4618,12-02-2021 16:00,24 hrs.,wallstreetbets,HVBTF,7,7,0,7,1,1,1,1,OTC
4618,12-02-2021 16:00,24 hrs.,wallstreetbets,ITHUF,7,7,0,7,1,1,1,1,OTC
4618,12-02-2021 16:00,24 hrs.,wallstreetbets,JUVAF,6,0,6,-6,1,1,0,1,OTC
4618,12-02-2021 16:00,24 hrs.,wallstreetbets,KBEVF,7,7,0,7,1,1,1,1,OTC
4618,12-02-2021 16:00,24 hrs.,wallstreetbets,KPIFF,6,0,6,-6,1,1,0,1,OTC
4618,12-02-2021 16:00,24 hrs.,wallstreetbets,LITOF,6,0,6,-6,1,1,0,1,OTC
4618,12-02-2021 16:00,24 hrs.,wallstreetbets,LKNCY,6,6,0,6,1,1,0,1,OTC
4618,12-02-2021 16:00,24 hrs.,wallstreetbets,LKYSF,7,0,7,-7,1,1,1,1,OTC
4618,12-02-2021 16:00,24 hrs.,wallstreetbets,LLKKF,6,0,6,-6,1,1,0,1,OTC
4618,12-02-2021 16:00,24 hrs.,wallstreetbets,LMLLF,6,0,6,-6,1,1,0,1,OTC
4618,12-02-2021 16:00,24 hrs.,wallstreetbets,LTMCF,12,0,12,-12,2,2,0,2,OTC
4618,12-02-2021 16:00,24 hrs.,wallstreetbets,LXXGF,8,0,8,-8,1,1,2,1,OTC
4618,12-02-2021 16:00,24 hrs.,wallstreetbets,MEDIF,6,6,0,6,1,1,0,1,OTC
4618,12-02-2021 16:00,24 hrs.,wallstreetbets,MMEDF,32,8,24,-16,5,5,2,5,OTC
4618,12-02-2021 16:00,24 hrs.,wallstreetbets,MMNFF,19,0,19,-19,3,3,1,3,OTC
4618,12-02-2021 16:00,24 hrs.,wallstreetbets,MNKKQ,14,0,14,-14,2,2,2,1,OTC
4618,12-02-2021 16:00,24 hrs.,wallstreetbets,NMGRF,13,0,13,-13,2,2,1,2,OTC
4618,12-02-2021 16:00,24 hrs.,wallstreetbets,NSANY,6,0,6,-6,1,1,0,1,OTC
4618,12-02-2021 16:00,24 hrs.,wallstreetbets,NTDOY,15,15,0,15,2,2,3,2,OTC
4618,12-02-2021 16:00,24 hrs.,wallstreetbets,NTSFF,6,0,6,-6,1,1,0,1,OTC
4618,12-02-2021 16:00,24 hrs.,wallstreetbets,NWVCF,6,0,6,-6,1,1,0,1,OTC
4618,12-02-2021 16:00,24 hrs.,wallstreetbets,NXGWF,7,0,7,-7,1,1,1,1,OTC
4618,12-02-2021 16:00,24 hrs.,wallstreetbets,NXTTF,7,7,0,7,1,1,1,1,OTC
4618,12-02-2021 16:00,24 hrs.,wallstreetbets,ORZCF,6,0,6,-6,1,1,0,1,OTC
4618,12-02-2021 16:00,24 hrs.,wallstreetbets,PFFOF,6,0,6,-6,1,1,0,1,OTC
4618,12-02-2021 16:00,24 hrs.,wallstreetbets,PLNHF,18,0,18,-18,3,3,0,3,OTC
4618,12-02-2021 16:00,24 hrs.,wallstreetbets,RAZFF,7,0,7,-7,1,1,1,1,OTC
4618,12-02-2021 16:00,24 hrs.,wallstreetbets,RLLCF,28,22,6,16,4,4,4,4,OTC
4618,12-02-2021 16:00,24 hrs.,wallstreetbets,RYCEY,433,364,69,295,18,109,143,14,OTC
4618,12-02-2021 16:00,24 hrs.,wallstreetbets,SHECY,85,0,85,-85,1,28,25,1,OTC
4618,12-02-2021 16:00,24 hrs.,wallstreetbets,SHERF,6,0,6,-6,1,1,0,1,OTC
4618,12-02-2021 16:00,24 hrs.,wallstreetbets,SPLIF,6,0,6,-6,1,1,0,1,OTC
4618,12-02-2021 16:00,24 hrs.,wallstreetbets,SPRWF,76,14,62,-48,11,13,6,9,OTC
4618,12-02-2021 16:00,24 hrs.,wallstreetbets,TAKOF,261,0,261,-261,3,98,53,3,OTC
4618,12-02-2021 16:00,24 hrs.,wallstreetbets,TCNNF,1113,450,663,-213,6,389,311,2,OTC
4618,12-02-2021 16:00,24 hrs.,wallstreetbets,TGODF,12,0,12,-12,2,2,0,1,OTC
4618,12-02-2021 16:00,24 hrs.,wallstreetbets,TLOFF,7,0,7,-7,1,1,1,1,OTC
4618,12-02-2021 16:00,24 hrs.,wallstreetbets,TPPRF,14,14,0,14,2,2,2,1,OTC
4618,12-02-2021 16:00,24 hrs.,wallstreetbets,TRUFF,7,0,7,-7,1,1,1,1,OTC
4618,12-02-2021 16:00,24 hrs.,wallstreetbets,TSCRF,7,0,7,-7,1,1,1,1,OTC
4618,12-02-2021 16:00,24 hrs.,wallstreetbets,VALPQ,7,0,7,-7,1,1,1,1,OTC
4618,12-02-2021 16:00,24 hrs.,wallstreetbets,VEGGF,6,0,6,-6,1,1,0,1,OTC
4618,12-02-2021 16:00,24 hrs.,wallstreetbets,VLNCF,240,0,240,-240,2,66,100,2,OTC
4618,12-02-2021 16:00,24 hrs.,wallstreetbets,VVCIF,7,0,7,-7,1,1,1,1,OTC
4618,12-02-2021 16:00,24 hrs.,wallstreetbets,VYGVF,12,0,12,-12,1,2,4,1,OTC
4618,12-02-2021 16:00,24 hrs.,wallstreetbets,WDDMF,7,7,0,7,1,1,1,1,OTC
4618,12-02-2021 16:00,24 hrs.,wallstreetbets,WPMLF,8,0,8,-8,1,1,2,1,OTC
4618,12-02-2021 16:00,24 hrs.,wallstreetbets,XIACF,12,0,12,-12,2,2,0,1,OTC
4618,12-02-2021 16:00,24 hrs.,wallstreetbets,XIACY,12,0,12,-12,2,2,0,1,OTC
4618,12-02-2021 16:00,24 hrs.,wallstreetbets,AAU,7,7,0,7,1,1,1,1,AMEX
4618,12-02-2021 16:00,24 hrs.,wallstreetbets,AGE,6,0,6,-6,1,1,0,1,AMEX
4618,12-02-2021 16:00,24 hrs.,wallstreetbets,AMS,6,0,6,-6,1,1,0,1,AMEX
4618,12-02-2021 16:00,24 hrs.,wallstreetbets,CEI,18,0,18,-18,3,3,0,2,AMEX
4618,12-02-2021 16:00,24 hrs.,wallstreetbets,DNN,223,82,141,-59,34,35,17,30,AMEX
4618,12-02-2021 16:00,24 hrs.,wallstreetbets,DPW,19,0,19,-19,3,3,1,3,AMEX
4618,12-02-2021 16:00,24 hrs.,wallstreetbets,FEN,7,7,0,7,1,1,1,1,AMEX
4618,12-02-2021 16:00,24 hrs.,wallstreetbets,GDP,42,42,0,42,2,10,14,2,AMEX
4618,12-02-2021 16:00,24 hrs.,wallstreetbets,GPL,6,0,6,-6,1,1,0,1,AMEX
4618,12-02-2021 16:00,24 hrs.,wallstreetbets,GSV,39,7,32,-25,6,6,3,6,AMEX
4618,12-02-2021 16:00,24 hrs.,SPACs,DGNS,267,267,0,267,2,94,71,2,NASDAQ
4618,12-02-2021 16:00,24 hrs.,SPACs,DSAC,148,148,0,148,1,40,64,1,NASDAQ
4618,12-02-2021 16:00,24 hrs.,SPACs,ERES,148,148,0,148,1,40,64,1,NASDAQ
4618,12-02-2021 16:00,24 hrs.,SPACs,ESSC,148,148,0,148,1,40,64,1,NASDAQ
4618,12-02-2021 16:00,24 hrs.,SPACs,ETAC,148,148,0,148,1,40,64,1,NASDAQ
4618,12-02-2021 16:00,24 hrs.,SPACs,EUCR,148,148,0,148,1,40,64,1,NASDAQ
4618,12-02-2021 16:00,24 hrs.,SPACs,EXPC,983,983,0,983,1,32,915,1,NASDAQ
4618,12-02-2021 16:00,24 hrs.,SPACs,FCAC,1220,1220,0,1220,3,127,954,3,NASDAQ
4618,12-02-2021 16:00,24 hrs.,SPACs,FSRV,983,983,0,983,1,32,915,1,NASDAQ
4618,12-02-2021 16:00,24 hrs.,SPACs,FTOC,287,0,287,-287,2,110,59,2,NASDAQ
4618,12-02-2021 16:00,24 hrs.,SPACs,FVAM,148,148,0,148,1,40,64,1,NASDAQ
4618,12-02-2021 16:00,24 hrs.,SPACs,GNRS,148,148,0,148,1,40,64,1,NASDAQ
4618,12-02-2021 16:00,24 hrs.,SPACs,GRCY,148,148,0,148,1,40,64,1,NASDAQ
4618,12-02-2021 16:00,24 hrs.,SPACs,GRNV,148,148,0,148,1,40,64,1,NASDAQ
4618,12-02-2021 16:00,24 hrs.,SPACs,GRSV,148,148,0,148,1,40,64,1,NASDAQ
4618,12-02-2021 16:00,24 hrs.,SPACs,GWAC,148,148,0,148,1,40,64,1,NASDAQ
4618,12-02-2021 16:00,24 hrs.,SPACs,GXGX,148,148,0,148,1,40,64,1,NASDAQ
4618,12-02-2021 16:00,24 hrs.,SPACs,IGAC,148,148,0,148,1,40,64,1,NASDAQ
4618,12-02-2021 16:00,24 hrs.,SPACs,ITAC,148,148,0,148,1,40,64,1,NASDAQ
4618,12-02-2021 16:00,24 hrs.,SPACs,JYAC,386,148,238,-90,2,153,72,2,NASDAQ
4618,12-02-2021 16:00,24 hrs.,SPACs,KSMT,148,148,0,148,1,40,64,1,NASDAQ
4618,12-02-2021 16:00,24 hrs.,SPACs,LACQ,983,983,0,983,1,32,915,1,NASDAQ
4618,12-02-2021 16:00,24 hrs.,SPACs,LATN,148,148,0,148,1,40,64,1,NASDAQ
4618,12-02-2021 16:00,24 hrs.,SPACs,LCAP,148,148,0,148,1,40,64,1,NASDAQ
4618,12-02-2021 16:00,24 hrs.,SPACs,LFTR,148,148,0,148,1,40,64,1,NASDAQ
4618,12-02-2021 16:00,24 hrs.,SPACs,LIVK,148,148,0,148,1,40,64,1,NASDAQ
4618,12-02-2021 16:00,24 hrs.,SPACs,MAAC,148,148,0,148,1,40,64,1,NASDAQ
4618,12-02-2021 16:00,24 hrs.,SPACs,MACU,148,148,0,148,1,40,64,1,NASDAQ
4618,12-02-2021 16:00,24 hrs.,SPACs,MCMJ,148,148,0,148,1,40,64,1,NASDAQ
4618,12-02-2021 16:00,24 hrs.,SPACs,MLAC,148,148,0,148,1,40,64,1,NASDAQ
4618,12-02-2021 16:00,24 hrs.,SPACs,MOTN,148,148,0,148,1,40,64,1,NASDAQ
4618,12-02-2021 16:00,24 hrs.,SPACs,NGAC,471,0,471,-471,3,206,47,3,NASDAQ
4618,12-02-2021 16:00,24 hrs.,SPACs,OTRA,148,148,0,148,1,40,64,1,NASDAQ
4618,12-02-2021 16:00,24 hrs.,SPACs,PAIC,148,148,0,148,1,40,64,1,NASDAQ
4618,12-02-2021 16:00,24 hrs.,SPACs,PLUG,6,6,0,6,1,1,0,1,NASDAQ
4618,12-02-2021 16:00,24 hrs.,SPACs,QELL,323,192,131,61,3,97,117,3,NASDAQ
4618,12-02-2021 16:00,24 hrs.,SPACs,RCHG,148,148,0,148,1,40,64,1,NASDAQ
4618,12-02-2021 16:00,24 hrs.,SPACs,RIDE,6,6,0,6,1,1,0,1,NASDAQ
4618,12-02-2021 16:00,24 hrs.,SPACs,SGAM,148,148,0,148,1,40,64,1,NASDAQ
4618,12-02-2021 16:00,24 hrs.,SPACs,SSPK,983,983,0,983,1,32,915,1,NASDAQ
4618,12-02-2021 16:00,24 hrs.,SPACs,STWO,148,148,0,148,1,40,64,1,NASDAQ
4618,12-02-2021 16:00,24 hrs.,SPACs,SVAC,148,148,0,148,1,40,64,1,NASDAQ
4618,12-02-2021 16:00,24 hrs.,SPACs,TEKK,148,148,0,148,1,40,64,1,NASDAQ
4618,12-02-2021 16:00,24 hrs.,SPACs,THBR,31,31,0,31,1,6,15,1,NASDAQ
4618,12-02-2021 16:00,24 hrs.,wallstreetbets,BILZF,12,0,12,-12,2,2,0,2,OTC
4618,12-02-2021 16:00,24 hrs.,wallstreetbets,BITCF,6,0,6,-6,1,1,0,1,OTC
4618,12-02-2021 16:00,24 hrs.,wallstreetbets,BLOZF,6,0,6,-6,1,1,0,1,OTC
4618,12-02-2021 16:00,24 hrs.,wallstreetbets,BUSXF,6,0,6,-6,1,1,0,1,OTC
4618,12-02-2021 16:00,24 hrs.,wallstreetbets,BVNNF,7,0,7,-7,1,1,1,1,OTC
4618,12-02-2021 16:00,24 hrs.,wallstreetbets,CBWTF,33,11,22,-11,5,3,7,5,OTC
4618,12-02-2021 16:00,24 hrs.,wallstreetbets,CNTTQ,6,0,6,-6,1,1,0,1,OTC
4618,12-02-2021 16:00,24 hrs.,wallstreetbets,CPXGF,6,0,6,-6,1,1,0,1,OTC
4618,12-02-2021 16:00,24 hrs.,wallstreetbets,CRLBF,13,6,7,-1,2,2,1,2,OTC
4618,12-02-2021 16:00,24 hrs.,wallstreetbets,CURLF,669,0,669,-669,2,211,239,2,OTC
4618,12-02-2021 16:00,24 hrs.,wallstreetbets,DFLYF,33,0,33,-33,3,2,17,2,OTC
4618,12-02-2021 16:00,24 hrs.,wallstreetbets,EHVVF,6,0,6,-6,1,1,0,1,OTC
4618,12-02-2021 16:00,24 hrs.,wallstreetbets,EPWCF,12,0,12,-12,1,0,8,1,OTC
4618,12-02-2021 16:00,24 hrs.,wallstreetbets,FDVRF,12,6,6,0,2,2,0,2,OTC
4618,12-02-2021 16:00,24 hrs.,wallstreetbets,FGPHF,6,0,6,-6,1,1,0,1,OTC
4618,12-02-2021 16:00,24 hrs.,wallstreetbets,FLOOF,6,0,6,-6,1,1,0,1,OTC
4618,12-02-2021 16:00,24 hrs.,wallstreetbets,FLWPF,13,0,13,-13,2,2,1,2,OTC
4618,12-02-2021 16:00,24 hrs.,wallstreetbets,GAYMF,21,0,21,-21,3,3,3,3,OTC
4618,12-02-2021 16:00,24 hrs.,wallstreetbets,GGTTF,12,0,12,-12,2,2,0,1,OTC
4618,12-02-2021 16:00,24 hrs.,wallstreetbets,GPORQ,6,0,6,-6,1,1,0,1,OTC
4618,12-02-2021 16:00,24 hrs.,SPACs,PCPL,148,148,0,148,1,40,64,1,NYSE
4618,12-02-2021 16:00,24 hrs.,SPACs,PIAI,148,148,0,148,1,40,64,1,NYSE
4618,12-02-2021 16:00,24 hrs.,SPACs,PRPB,148,148,0,148,1,40,64,1,NYSE
4618,12-02-2021 16:00,24 hrs.,SPACs,RBAC,148,148,0,148,1,40,64,1,NYSE
4618,12-02-2021 16:00,24 hrs.,SPACs,RPLA,148,148,0,148,1,40,64,1,NYSE
4618,12-02-2021 16:00,24 hrs.,SPACs,SCPE,148,148,0,148,1,40,64,1,NYSE
4618,12-02-2021 16:00,24 hrs.,SPACs,SCVX,1253,1131,122,1009,3,113,1015,2,NYSE
4618,12-02-2021 16:00,24 hrs.,SPACs,SEAH,148,148,0,148,1,40,64,1,NYSE
4618,12-02-2021 16:00,24 hrs.,SPACs,SFTW,148,148,0,148,1,40,64,1,NYSE
4618,12-02-2021 16:00,24 hrs.,SPACs,SKLZ,123,0,123,-123,1,38,43,1,NYSE
4618,12-02-2021 16:00,24 hrs.,SPACs,SNPR,1032,1004,28,976,7,40,924,6,NYSE
4618,12-02-2021 16:00,24 hrs.,SPACs,SPCE,7,7,0,7,1,1,1,1,NYSE
4618,12-02-2021 16:00,24 hrs.,SPACs,SPNV,25,0,25,-25,1,7,7,1,NYSE
4618,12-02-2021 16:00,24 hrs.,SPACs,TPGY,983,983,0,983,1,32,915,1,NYSE
4618,12-02-2021 16:00,24 hrs.,SPACs,TWND,13,0,13,-13,2,2,1,1,NYSE
4618,12-02-2021 16:00,24 hrs.,SPACs,VGAC,983,983,0,983,1,32,915,1,NYSE
4618,12-02-2021 16:00,24 hrs.,SPACs,ADV,1131,1131,0,1131,2,72,979,1,NASDAQ
4618,12-02-2021 16:00,24 hrs.,SPACs,ESG,80,80,0,80,1,23,30,1,NASDAQ
4618,12-02-2021 16:00,24 hrs.,SPACs,HOL,990,990,0,990,2,33,916,2,NASDAQ
4618,12-02-2021 16:00,24 hrs.,SPACs,LCY,148,148,0,148,1,40,64,1,NASDAQ
4618,12-02-2021 16:00,24 hrs.,SPACs,NPA,106,0,106,-106,3,38,18,3,NASDAQ
4618,12-02-2021 16:00,24 hrs.,SPACs,VIH,26,26,0,26,1,8,6,1,NASDAQ
4618,12-02-2021 16:00,24 hrs.,SPACs,ACAC,123,0,123,-123,1,38,43,1,NASDAQ
4618,12-02-2021 16:00,24 hrs.,SPACs,ACEV,227,36,191,-155,7,59,81,4,NASDAQ
4618,12-02-2021 16:00,24 hrs.,SPACs,ADOC,148,148,0,148,1,40,64,1,NASDAQ
4618,12-02-2021 16:00,24 hrs.,SPACs,AGBA,148,148,0,148,1,40,64,1,NASDAQ
4618,12-02-2021 16:00,24 hrs.,SPACs,AHAC,148,148,0,148,1,40,64,1,NASDAQ
4618,12-02-2021 16:00,24 hrs.,SPACs,AMHC,148,148,0,148,1,40,64,1,NASDAQ
4618,12-02-2021 16:00,24 hrs.,SPACs,ANDA,106,0,106,-106,1,22,58,1,NASDAQ
4618,12-02-2021 16:00,24 hrs.,SPACs,BHSE,148,148,0,148,1,40,64,1,NASDAQ
4618,12-02-2021 16:00,24 hrs.,SPACs,BOWX,148,148,0,148,1,40,64,1,NASDAQ
4618,12-02-2021 16:00,24 hrs.,SPACs,BREZ,148,148,0,148,1,40,64,1,NASDAQ
4618,12-02-2021 16:00,24 hrs.,SPACs,BRLI,148,148,0,148,1,40,64,1,NASDAQ
4618,12-02-2021 16:00,24 hrs.,SPACs,BTAQ,154,154,0,154,2,41,64,2,NASDAQ
4618,12-02-2021 16:00,24 hrs.,SPACs,BTWN,60,60,0,60,2,9,34,2,NASDAQ
4618,12-02-2021 16:00,24 hrs.,SPACs,BWAC,148,148,0,148,1,40,64,1,NASDAQ
4618,12-02-2021 16:00,24 hrs.,SPACs,CAPA,148,148,0,148,1,40,64,1,NASDAQ
4618,12-02-2021 16:00,24 hrs.,SPACs,CELH,106,0,106,-106,1,22,58,1,NASDAQ
4618,12-02-2021 16:00,24 hrs.,SPACs,CFII,148,148,0,148,1,40,64,1,NASDAQ
4618,12-02-2021 16:00,24 hrs.,SPACs,CHPM,148,148,0,148,1,40,64,1,NASDAQ
4618,12-02-2021 16:00,24 hrs.,SPACs,CIIC,22,22,0,22,1,7,4,1,NASDAQ
4618,12-02-2021 16:00,24 hrs.,SPACs,CMLF,983,983,0,983,1,32,915,1,NASDAQ
4618,12-02-2021 16:00,24 hrs.,SPACs,CONX,148,148,0,148,1,40,64,1,NASDAQ
4618,12-02-2021 16:00,24 hrs.,SPACs,CRSA,148,148,0,148,1,40,64,1,NASDAQ
4618,12-02-2021 16:00,24 hrs.,SPACs,DBDR,148,148,0,148,1,40,64,1,NASDAQ
4618,12-02-2021 16:00,24 hrs.,SPACs,DCRB,22,22,0,22,1,7,4,1,NASDAQ
4618,12-02-2021 16:00,24 hrs.,SPACs,DFPH,148,148,0,148,1,40,64,1,NASDAQ
4618,12-02-2021 16:00,24 hrs.,wallstreetbets,RLTR,12,0,12,-12,2,2,0,2,OTC
4618,12-02-2021 16:00,24 hrs.,wallstreetbets,RSHN,7,0,7,-7,1,1,1,1,OTC
4618,12-02-2021 16:00,24 hrs.,wallstreetbets,RSSV,9,9,0,9,1,2,1,1,OTC
4618,12-02-2021 16:00,24 hrs.,wallstreetbets,RTON,26,0,26,-26,4,4,2,4,OTC
4618,12-02-2021 16:00,24 hrs.,wallstreetbets,SANP,12,0,12,-12,2,2,0,2,OTC
4618,12-02-2021 16:00,24 hrs.,wallstreetbets,SCNA,14,0,14,-14,2,3,0,2,OTC
4618,12-02-2021 16:00,24 hrs.,wallstreetbets,SFOR,14,0,14,-14,2,2,2,1,OTC
4618,12-02-2021 16:00,24 hrs.,wallstreetbets,SGLN,6,0,6,-6,1,1,0,1,OTC
4618,12-02-2021 16:00,24 hrs.,wallstreetbets,SGMD,49,6,43,-37,8,8,1,7,OTC
4618,12-02-2021 16:00,24 hrs.,wallstreetbets,SHMP,20,14,6,8,3,3,2,3,OTC
4618,12-02-2021 16:00,24 hrs.,wallstreetbets,SHRG,6,0,6,-6,1,1,0,1,OTC
4618,12-02-2021 16:00,24 hrs.,wallstreetbets,SHWZ,6,0,6,-6,1,1,0,1,OTC
4618,12-02-2021 16:00,24 hrs.,wallstreetbets,SIGN,19,6,13,-7,3,3,1,3,OTC
4618,12-02-2021 16:00,24 hrs.,wallstreetbets,SING,19,0,19,-19,3,3,1,3,OTC
4618,12-02-2021 16:00,24 hrs.,wallstreetbets,SMVI,12,0,12,-12,2,2,0,1,OTC
4618,12-02-2021 16:00,24 hrs.,wallstreetbets,SNPW,6,0,6,-6,1,1,0,1,OTC
4618,12-02-2021 16:00,24 hrs.,wallstreetbets,SNRY,6,0,6,-6,1,1,0,1,OTC
4618,12-02-2021 16:00,24 hrs.,wallstreetbets,SRMX,75,14,61,-47,12,12,3,10,OTC
4618,12-02-2021 16:00,24 hrs.,wallstreetbets,SRUP,18,0,18,-18,3,3,0,1,OTC
4618,12-02-2021 16:00,24 hrs.,wallstreetbets,SUND,6,0,6,-6,1,1,0,1,OTC
4618,12-02-2021 16:00,24 hrs.,wallstreetbets,SVTE,6,0,6,-6,1,1,0,1,OTC
4618,12-02-2021 16:00,24 hrs.,wallstreetbets,TCHH,6,6,0,6,1,1,0,1,OTC
4618,12-02-2021 16:00,24 hrs.,wallstreetbets,TGGI,6,0,6,-6,1,1,0,1,OTC
4618,12-02-2021 16:00,24 hrs.,wallstreetbets,TRNX,13,0,13,-13,2,2,1,2,OTC
4618,12-02-2021 16:00,24 hrs.,wallstreetbets,TRTC,13,7,6,1,2,2,1,2,OTC
4618,12-02-2021 16:00,24 hrs.,wallstreetbets,TSNP,31,7,24,-17,5,5,1,5,OTC
4618,12-02-2021 16:00,24 hrs.,wallstreetbets,UNVC,6,0,6,-6,1,1,0,1,OTC
4618,12-02-2021 16:00,24 hrs.,wallstreetbets,UOMO,6,0,6,-6,1,1,0,1,OTC
4618,12-02-2021 16:00,24 hrs.,wallstreetbets,USMJ,12,0,12,-12,2,2,0,2,OTC
4618,12-02-2021 16:00,24 hrs.,wallstreetbets,USPS,84,0,84,-84,2,22,32,1,OTC
4618,12-02-2021 16:00,24 hrs.,wallstreetbets,UVSE,19,7,12,-5,3,3,1,3,OTC
4618,12-02-2021 16:00,24 hrs.,wallstreetbets,VBIO,6,0,6,-6,1,1,0,1,OTC
4618,12-02-2021 16:00,24 hrs.,wallstreetbets,VPOR,6,0,6,-6,1,1,0,1,OTC
4618,12-02-2021 16:00,24 hrs.,wallstreetbets,VTLR,13,7,6,1,2,2,1,2,OTC
4618,12-02-2021 16:00,24 hrs.,wallstreetbets,VYST,6,0,6,-6,1,1,0,1,OTC
4618,12-02-2021 16:00,24 hrs.,wallstreetbets,WARM,18,0,18,-18,3,3,0,1,OTC
4618,12-02-2021 16:00,24 hrs.,wallstreetbets,WHEN,19,13,6,7,3,3,1,3,OTC
4618,12-02-2021 16:00,24 hrs.,wallstreetbets,WNDW,6,0,6,-6,1,1,0,1,OTC
4618,12-02-2021 16:00,24 hrs.,wallstreetbets,WSSE,7,7,0,7,1,1,1,1,OTC
4618,12-02-2021 16:00,24 hrs.,wallstreetbets,ZNOG,6,0,6,-6,1,1,0,1,OTC
4618,12-02-2021 16:00,24 hrs.,wallstreetbets,ABEPF,6,0,6,-6,1,1,0,1,OTC
4618,12-02-2021 16:00,24 hrs.,wallstreetbets,AMYZF,23,23,0,23,3,3,5,2,OTC
4618,12-02-2021 16:00,24 hrs.,wallstreetbets,ARBKF,7,0,7,-7,1,1,1,1,OTC
4618,12-02-2021 16:00,24 hrs.,wallstreetbets,ATURF,7,7,0,7,1,1,1,1,OTC
4618,12-02-2021 16:00,24 hrs.,wallstreetbets,AYRWF,6,0,6,-6,1,1,0,1,OTC
4618,12-02-2021 16:00,24 hrs.,wallstreetbets,BDRBF,84,20,64,-44,10,9,26,10,OTC
4618,12-02-2021 16:00,24 hrs.,SPACs,BOAC,174,174,0,174,2,47,72,2,NYSE
4618,12-02-2021 16:00,24 hrs.,SPACs,CCIV,2904,1260,1644,-384,17,735,1366,16,NYSE
4618,12-02-2021 16:00,24 hrs.,SPACs,CLII,47,8,39,-31,3,12,11,3,NYSE
4618,12-02-2021 16:00,24 hrs.,SPACs,CPSR,148,148,0,148,1,40,64,1,NYSE
4618,12-02-2021 16:00,24 hrs.,SPACs,CTAC,148,148,0,148,1,40,64,1,NYSE
4618,12-02-2021 16:00,24 hrs.,SPACs,DFNS,178,178,0,178,2,52,66,2,NYSE
4618,12-02-2021 16:00,24 hrs.,SPACs,DGNR,192,192,0,192,1,80,28,1,NYSE
4618,12-02-2021 16:00,24 hrs.,SPACs,DMYD,267,267,0,267,2,94,71,2,NYSE
4618,12-02-2021 16:00,24 hrs.,SPACs,EMPW,1131,1131,0,1131,2,72,979,1,NYSE
4618,12-02-2021 16:00,24 hrs.,SPACs,FGNA,983,983,0,983,1,32,915,1,NYSE
4618,12-02-2021 16:00,24 hrs.,SPACs,FUSE,2274,2120,154,1966,13,499,1224,12,NYSE
4618,12-02-2021 16:00,24 hrs.,SPACs,GLEO,148,148,0,148,1,40,64,1,NYSE
4618,12-02-2021 16:00,24 hrs.,SPACs,GOAC,148,148,0,148,1,40,64,1,NYSE
4618,12-02-2021 16:00,24 hrs.,SPACs,GSAH,267,267,0,267,2,94,71,2,NYSE
4618,12-02-2021 16:00,24 hrs.,SPACs,HIGA,148,148,0,148,1,40,64,1,NYSE
4618,12-02-2021 16:00,24 hrs.,SPACs,HYLN,6,0,6,-6,1,1,0,1,NYSE
4618,12-02-2021 16:00,24 hrs.,SPACs,HZAC,148,148,0,148,1,40,64,1,NYSE
4618,12-02-2021 16:00,24 hrs.,SPACs,HZON,148,148,0,148,1,40,64,1,NYSE
4618,12-02-2021 16:00,24 hrs.,SPACs,IMPX,148,148,0,148,1,40,64,1,NYSE
4618,12-02-2021 16:00,24 hrs.,SPACs,IPOE,13,6,7,-1,2,2,1,2,NYSE
4618,12-02-2021 16:00,24 hrs.,SPACs,LGVW,271,264,7,257,4,103,49,3,NYSE
4618,12-02-2021 16:00,24 hrs.,SPACs,OACB,148,148,0,148,1,40,64,1,NYSE
4618,12-02-2021 16:00,24 hrs.,SPACs,PANA,148,148,0,148,1,40,64,1,NYSE
4618,12-02-2021 16:00,24 hrs.,wallstreetbets,MJLB,6,0,6,-6,1,1,0,1,OTC
4618,12-02-2021 16:00,24 hrs.,wallstreetbets,MJNA,56,18,38,-20,9,8,4,8,OTC
4618,12-02-2021 16:00,24 hrs.,wallstreetbets,MMEX,41,21,20,1,6,6,5,5,OTC
4618,12-02-2021 16:00,24 hrs.,wallstreetbets,MMMM,6,0,6,-6,1,1,0,1,OTC
4618,12-02-2021 16:00,24 hrs.,wallstreetbets,MOJO,7,7,0,7,1,1,1,1,OTC
4618,12-02-2021 16:00,24 hrs.,wallstreetbets,MRMD,6,0,6,-6,1,1,0,1,OTC
4618,12-02-2021 16:00,24 hrs.,wallstreetbets,MSRT,6,0,6,-6,1,1,0,1,OTC
4618,12-02-2021 16:00,24 hrs.,wallstreetbets,MTVX,15,6,9,-3,2,3,1,2,OTC
4618,12-02-2021 16:00,24 hrs.,wallstreetbets,NBVG,6,6,0,6,1,1,0,1,OTC
4618,12-02-2021 16:00,24 hrs.,wallstreetbets,NOVC,13,13,0,13,2,2,1,2,OTC
4618,12-02-2021 16:00,24 hrs.,wallstreetbets,NPHC,6,0,6,-6,1,1,0,1,OTC
4618,12-02-2021 16:00,24 hrs.,wallstreetbets,NPTX,14,0,14,-14,2,2,2,1,OTC
4618,12-02-2021 16:00,24 hrs.,wallstreetbets,NSPX,6,0,6,-6,1,1,0,1,OTC
4618,12-02-2021 16:00,24 hrs.,wallstreetbets,NUKK,6,0,6,-6,1,1,0,1,OTC
4618,12-02-2021 16:00,24 hrs.,wallstreetbets,NWPN,19,0,19,-19,3,3,1,2,OTC
4618,12-02-2021 16:00,24 hrs.,wallstreetbets,OTTV,14,14,0,14,2,2,2,1,OTC
4618,12-02-2021 16:00,24 hrs.,wallstreetbets,OZSC,6,0,6,-6,1,1,0,1,OTC
4618,12-02-2021 16:00,24 hrs.,wallstreetbets,PAOG,12,0,12,-12,2,2,0,2,OTC
4618,12-02-2021 16:00,24 hrs.,wallstreetbets,PAPA,6,0,6,-6,1,1,0,1,OTC
4618,12-02-2021 16:00,24 hrs.,wallstreetbets,PASO,6,0,6,-6,1,1,0,1,OTC
4618,12-02-2021 16:00,24 hrs.,wallstreetbets,PDMI,7,0,7,-7,1,1,1,1,OTC
4618,12-02-2021 16:00,24 hrs.,wallstreetbets,PERL,6,0,6,-6,1,1,0,1,OTC
4618,12-02-2021 16:00,24 hrs.,wallstreetbets,PFNO,6,0,6,-6,1,1,0,1,OTC
4618,12-02-2021 16:00,24 hrs.,wallstreetbets,PGIE,6,0,6,-6,1,1,0,1,OTC
4618,12-02-2021 16:00,24 hrs.,wallstreetbets,PNPL,13,13,0,13,2,2,1,1,OTC
4618,12-02-2021 16:00,24 hrs.,wallstreetbets,PPJE,6,0,6,-6,1,1,0,1,OTC
4618,12-02-2021 16:00,24 hrs.,wallstreetbets,PRDL,6,0,6,-6,1,1,0,1,OTC
4618,12-02-2021 16:00,24 hrs.,wallstreetbets,PRED,7,0,7,-7,1,1,1,1,OTC
4618,12-02-2021 16:00,24 hrs.,wallstreetbets,PSYC,18,0,18,-18,3,3,0,1,OTC
4618,12-02-2021 16:00,24 hrs.,wallstreetbets,PTOI,12,0,12,-12,2,2,0,1,OTC
4618,12-02-2021 16:00,24 hrs.,wallstreetbets,PURA,12,0,12,-12,2,2,0,2,OTC
4618,12-02-2021 16:00,24 hrs.,wallstreetbets,PURE,7,0,7,-7,1,1,1,1,OTC
4618,12-02-2021 16:00,24 hrs.,wallstreetbets,PVDG,6,0,6,-6,1,1,0,1,OTC
4618,12-02-2021 16:00,24 hrs.,wallstreetbets,PYYX,6,0,6,-6,1,1,0,1,OTC
4618,12-02-2021 16:00,24 hrs.,wallstreetbets,QEDN,6,0,6,-6,1,1,0,1,OTC
4618,12-02-2021 16:00,24 hrs.,wallstreetbets,QOIL,6,6,0,6,1,1,0,1,OTC
4618,12-02-2021 16:00,24 hrs.,wallstreetbets,QTMM,6,0,6,-6,1,1,0,1,OTC
4618,12-02-2021 16:00,24 hrs.,wallstreetbets,RBDC,7,7,0,7,1,1,1,1,OTC
4618,12-02-2021 16:00,24 hrs.,wallstreetbets,RBNW,19,13,6,7,3,3,1,3,OTC
4618,12-02-2021 16:00,24 hrs.,wallstreetbets,REFG,7,7,0,7,1,1,1,1,OTC
4618,12-02-2021 16:00,24 hrs.,wallstreetbets,RIGH,7,0,7,-7,1,1,1,1,OTC
4618,12-02-2021 16:00,24 hrs.,SPACs,CAGR,106,0,106,-106,1,22,58,1,OTC
4618,12-02-2021 16:00,24 hrs.,SPACs,BGI,31,0,31,-31,1,6,15,1,AMEX
4618,12-02-2021 16:00,24 hrs.,SPACs,CIK,39,14,25,-11,2,5,21,2,AMEX
4618,12-02-2021 16:00,24 hrs.,SPACs,CTO,122,0,122,-122,1,41,36,1,AMEX
4618,12-02-2021 16:00,24 hrs.,SPACs,NBA,148,148,0,148,1,40,64,1,AMEX
4618,12-02-2021 16:00,24 hrs.,SPACs,PTK,148,148,0,148,1,40,64,1,AMEX
4618,12-02-2021 16:00,24 hrs.,SPACs,CHAQ,148,148,0,148,1,40,64,1,AMEX
4618,12-02-2021 16:00,24 hrs.,SPACs,BSN,148,148,0,148,1,40,64,1,NYSE
4618,12-02-2021 16:00,24 hrs.,SPACs,CCX,155,148,7,141,2,41,65,2,NYSE
4618,12-02-2021 16:00,24 hrs.,SPACs,DEH,148,148,0,148,1,40,64,1,NYSE
4618,12-02-2021 16:00,24 hrs.,SPACs,EQD,148,148,0,148,1,40,64,1,NYSE
4618,12-02-2021 16:00,24 hrs.,SPACs,FSR,6,6,0,6,1,1,0,1,NYSE
4618,12-02-2021 16:00,24 hrs.,SPACs,GIK,29,29,0,29,4,2,9,2,NYSE
4618,12-02-2021 16:00,24 hrs.,SPACs,GIX,148,148,0,148,1,40,64,1,NYSE
4618,12-02-2021 16:00,24 hrs.,SPACs,HPX,148,148,0,148,1,40,64,1,NYSE
4618,12-02-2021 16:00,24 hrs.,SPACs,ICE,26,26,0,26,1,8,6,1,NYSE
4618,12-02-2021 16:00,24 hrs.,SPACs,IRR,14,14,0,14,1,2,6,1,NYSE
4618,12-02-2021 16:00,24 hrs.,SPACs,NAV,499,133,366,-233,8,185,97,7,NYSE
4618,12-02-2021 16:00,24 hrs.,SPACs,NGA,37,37,0,37,4,2,17,3,NYSE
4618,12-02-2021 16:00,24 hrs.,SPACs,NSH,148,148,0,148,1,40,64,1,NYSE
4618,12-02-2021 16:00,24 hrs.,SPACs,RMO,7,0,7,-7,1,1,1,1,NYSE
4618,12-02-2021 16:00,24 hrs.,SPACs,RSI,123,0,123,-123,1,38,43,1,NYSE
4618,12-02-2021 16:00,24 hrs.,SPACs,RTP,1677,1175,502,673,12,247,1135,11,NYSE
4618,12-02-2021 16:00,24 hrs.,SPACs,SBE,244,6,238,-232,10,73,58,7,NYSE
4618,12-02-2021 16:00,24 hrs.,SPACs,SBG,148,148,0,148,1,40,64,1,NYSE
4618,12-02-2021 16:00,24 hrs.,SPACs,TDA,7,7,0,7,1,1,1,1,NYSE
4618,12-02-2021 16:00,24 hrs.,SPACs,WPF,154,148,6,142,2,41,64,2,NYSE
4618,12-02-2021 16:00,24 hrs.,SPACs,YAC,148,148,0,148,1,40,64,1,NYSE
4618,12-02-2021 16:00,24 hrs.,SPACs,ACIC,990,983,7,976,2,32,918,2,NYSE
4618,12-02-2021 16:00,24 hrs.,SPACs,ACND,148,148,0,148,1,40,64,1,NYSE
4618,12-02-2021 16:00,24 hrs.,SPACs,ALUS,16,16,0,16,1,5,2,1,NYSE
4618,12-02-2021 16:00,24 hrs.,SPACs,AONE,148,148,0,148,1,40,64,1,NYSE
4618,12-02-2021 16:00,24 hrs.,SPACs,APSG,148,148,0,148,1,40,64,1,NYSE
4618,12-02-2021 16:00,24 hrs.,SPACs,ASAQ,148,148,0,148,1,40,64,1,NYSE
4618,12-02-2021 16:00,24 hrs.,SPACs,ASPL,154,154,0,154,2,41,64,2,NYSE
4618,12-02-2021 16:00,24 hrs.,SPACs,ATAC,148,148,0,148,1,40,64,1,NYSE
4618,12-02-2021 16:00,24 hrs.,SPACs,AVAN,148,148,0,148,1,40,64,1,NYSE
4618,12-02-2021 16:00,24 hrs.,wallstreetbets,INKW,6,0,6,-6,1,1,0,1,OTC
4618,12-02-2021 16:00,24 hrs.,wallstreetbets,INND,13,6,7,-1,2,2,1,2,OTC
4618,12-02-2021 16:00,24 hrs.,wallstreetbets,IQST,18,0,18,-18,3,3,0,3,OTC
4618,12-02-2021 16:00,24 hrs.,wallstreetbets,ISWH,6,0,6,-6,1,1,0,1,OTC
4618,12-02-2021 16:00,24 hrs.,wallstreetbets,ITCJ,6,6,0,6,1,1,0,1,OTC
4618,12-02-2021 16:00,24 hrs.,wallstreetbets,KBLB,12,0,12,-12,2,2,0,2,OTC
4618,12-02-2021 16:00,24 hrs.,wallstreetbets,KGKG,7,7,0,7,1,1,1,1,OTC
4618,12-02-2021 16:00,24 hrs.,wallstreetbets,KRFG,7,0,7,-7,1,1,1,1,OTC
4618,12-02-2021 16:00,24 hrs.,wallstreetbets,KWBT,7,7,0,7,1,1,1,1,OTC
4618,12-02-2021 16:00,24 hrs.,wallstreetbets,KYNC,14,7,7,0,2,2,2,2,OTC
4618,12-02-2021 16:00,24 hrs.,wallstreetbets,LBSR,15,0,15,-15,2,3,1,2,OTC
4618,12-02-2021 16:00,24 hrs.,wallstreetbets,LGIQ,6,0,6,-6,1,1,0,1,OTC
4618,12-02-2021 16:00,24 hrs.,wallstreetbets,LINK,322,322,0,322,1,123,72,1,OTC
4618,12-02-2021 16:00,24 hrs.,wallstreetbets,LOTE,7,7,0,7,1,1,1,1,OTC
4618,12-02-2021 16:00,24 hrs.,wallstreetbets,LQMT,12,0,12,-12,2,2,0,2,OTC
4618,12-02-2021 16:00,24 hrs.,wallstreetbets,LQWC,6,0,6,-6,1,1,0,1,OTC
4618,12-02-2021 16:00,24 hrs.,wallstreetbets,LSCG,7,0,7,-7,1,1,1,1,OTC
4618,12-02-2021 16:00,24 hrs.,wallstreetbets,LTNC,7,7,0,7,1,1,1,1,OTC
4618,12-02-2021 16:00,24 hrs.,wallstreetbets,LTUM,6,0,6,-6,1,1,0,1,OTC
4618,12-02-2021 16:00,24 hrs.,wallstreetbets,LUVU,6,0,6,-6,1,1,0,1,OTC
4618,12-02-2021 16:00,24 hrs.,wallstreetbets,MATN,6,0,6,-6,1,1,0,1,OTC
4618,12-02-2021 16:00,24 hrs.,wallstreetbets,MCOA,7,7,0,7,1,1,1,1,OTC
4618,12-02-2021 16:00,24 hrs.,wallstreetbets,MEDH,7,7,0,7,1,1,1,1,OTC
4618,12-02-2021 16:00,24 hrs.,wallstreetbets,MGLG,6,0,6,-6,1,1,0,1,OTC
4618,12-02-2021 16:00,24 hrs.,wallstreetbets,MINE,63,13,50,-37,10,10,3,9,OTC
4618,12-02-2021 16:00,24 hrs.,wallstreetbets,MITI,6,0,6,-6,1,1,0,1,OTC
4618,12-02-2021 16:00,24 hrs.,wallstreetbets,CATV,6,0,6,-6,1,1,0,1,OTC
4618,12-02-2021 16:00,24 hrs.,wallstreetbets,CBDD,12,0,12,-12,2,2,0,2,OTC
4618,12-02-2021 16:00,24 hrs.,wallstreetbets,CBDL,32,0,32,-32,5,5,2,5,OTC
4618,12-02-2021 16:00,24 hrs.,wallstreetbets,CBGI,12,0,12,-12,2,2,0,1,OTC
4618,12-02-2021 16:00,24 hrs.,wallstreetbets,CBTC,6,0,6,-6,1,1,0,1,OTC
4618,12-02-2021 16:00,24 hrs.,wallstreetbets,CCTL,12,0,12,-12,2,2,0,2,OTC
4618,12-02-2021 16:00,24 hrs.,wallstreetbets,CGEI,7,7,0,7,1,1,1,1,OTC
4618,12-02-2021 16:00,24 hrs.,wallstreetbets,CHUC,7,7,0,7,1,1,1,1,OTC
4618,12-02-2021 16:00,24 hrs.,wallstreetbets,CLIS,6,0,6,-6,1,1,0,1,OTC
4618,12-02-2021 16:00,24 hrs.,wallstreetbets,CLSH,7,0,7,-7,1,1,1,1,OTC
4618,12-02-2021 16:00,24 hrs.,wallstreetbets,CNXS,6,0,6,-6,1,1,0,1,OTC
4618,12-02-2021 16:00,24 hrs.,wallstreetbets,CVSI,6,0,6,-6,1,1,0,1,OTC
4618,12-02-2021 16:00,24 hrs.,wallstreetbets,CYDY,14,7,7,0,2,2,2,2,OTC
4618,12-02-2021 16:00,24 hrs.,wallstreetbets,CYLC,6,0,6,-6,1,1,0,1,OTC
4618,12-02-2021 16:00,24 hrs.,wallstreetbets,DGWR,7,7,0,7,1,1,1,1,OTC
4618,12-02-2021 16:00,24 hrs.,wallstreetbets,DIGI,14,14,0,14,2,2,2,1,OTC
4618,12-02-2021 16:00,24 hrs.,wallstreetbets,DROP,2570,0,2570,-2570,1,844,878,1,OTC
4618,12-02-2021 16:00,24 hrs.,wallstreetbets,DTST,12,0,12,-12,2,2,0,1,OTC
4618,12-02-2021 16:00,24 hrs.,wallstreetbets,DWOG,7,0,7,-7,1,1,1,1,OTC
4618,12-02-2021 16:00,24 hrs.,wallstreetbets,ECEZ,12,0,12,-12,2,2,0,2,OTC
4618,12-02-2021 16:00,24 hrs.,wallstreetbets,EFLN,6,0,6,-6,1,1,0,1,OTC
4618,12-02-2021 16:00,24 hrs.,wallstreetbets,ELCR,40,21,19,2,6,6,4,4,OTC
4618,12-02-2021 16:00,24 hrs.,wallstreetbets,ELTP,7,7,0,7,1,1,1,1,OTC
4618,12-02-2021 16:00,24 hrs.,wallstreetbets,ENZN,7,7,0,7,1,1,1,1,OTC
4618,12-02-2021 16:00,24 hrs.,wallstreetbets,ERBB,6,0,6,-6,1,1,0,1,OTC
4618,12-02-2021 16:00,24 hrs.,wallstreetbets,ETFM,6,0,6,-6,1,1,0,1,OTC
4618,12-02-2021 16:00,24 hrs.,wallstreetbets,EWKS,6,6,0,6,1,1,0,1,OTC
4618,12-02-2021 16:00,24 hrs.,wallstreetbets,EWLL,6,0,6,-6,1,1,0,1,OTC
4618,12-02-2021 16:00,24 hrs.,wallstreetbets,FBSE,8,0,8,-8,1,1,2,1,OTC
4618,12-02-2021 16:00,24 hrs.,wallstreetbets,FORW,6,0,6,-6,1,1,0,1,OTC
4618,12-02-2021 16:00,24 hrs.,wallstreetbets,FTPM,13,7,6,1,2,2,1,2,OTC
4618,12-02-2021 16:00,24 hrs.,wallstreetbets,FUTL,6,0,6,-6,1,1,0,1,OTC
4618,12-02-2021 16:00,24 hrs.,wallstreetbets,GAXY,18,0,18,-18,3,3,0,3,OTC
4618,12-02-2021 16:00,24 hrs.,wallstreetbets,GBLX,6,0,6,-6,1,1,0,1,OTC
4618,12-02-2021 16:00,24 hrs.,wallstreetbets,GBTC,436,436,0,436,3,177,70,2,OTC
4618,12-02-2021 16:00,24 hrs.,wallstreetbets,GFCI,749,0,749,-749,1,291,163,1,OTC
4618,12-02-2021 16:00,24 hrs.,wallstreetbets,GMER,12,0,12,-12,2,2,0,1,OTC
4618,12-02-2021 16:00,24 hrs.,wallstreetbets,GMEV,7,7,0,7,1,1,1,1,OTC
4618,12-02-2021 16:00,24 hrs.,wallstreetbets,GMSC,14,14,0,14,2,2,2,1,OTC
4618,12-02-2021 16:00,24 hrs.,wallstreetbets,GPFT,14,14,0,14,2,2,2,2,OTC
4618,12-02-2021 16:00,24 hrs.,wallstreetbets,GRCU,6,0,6,-6,1,1,0,1,OTC
4618,12-02-2021 16:00,24 hrs.,wallstreetbets,GRNH,12,6,6,0,2,2,0,2,OTC
4618,12-02-2021 16:00,24 hrs.,wallstreetbets,GTBP,6,0,6,-6,1,1,0,1,OTC
4618,12-02-2021 16:00,24 hrs.,wallstreetbets,GTEH,18,0,18,-18,2,4,2,2,OTC
4618,12-02-2021 16:00,24 hrs.,wallstreetbets,GTII,1208,0,1208,-1208,1,433,338,1,OTC
4618,12-02-2021 16:00,24 hrs.,wallstreetbets,GTLL,13,13,0,13,2,2,1,2,OTC
4618,12-02-2021 16:00,24 hrs.,wallstreetbets,GTXO,6,0,6,-6,1,1,0,1,OTC
4618,12-02-2021 16:00,24 hrs.,wallstreetbets,GYOG,6,0,6,-6,1,1,0,1,OTC
4618,12-02-2021 16:00,24 hrs.,wallstreetbets,HCMC,505,173,332,-159,79,80,29,72,OTC
4618,12-02-2021 16:00,24 hrs.,wallstreetbets,HEMP,12,0,12,-12,2,2,0,1,OTC
4618,12-02-2021 16:00,24 hrs.,wallstreetbets,HESG,6,0,6,-6,1,1,0,1,OTC
4618,12-02-2021 16:00,24 hrs.,wallstreetbets,HIHI,7,7,0,7,1,1,1,1,OTC
4618,12-02-2021 16:00,24 hrs.,wallstreetbets,HIPH,14,14,0,14,2,2,2,2,OTC
4618,12-02-2021 16:00,24 hrs.,wallstreetbets,HMNY,40,20,20,0,6,6,4,5,OTC
4618,12-02-2021 16:00,24 hrs.,wallstreetbets,HMPQ,19,7,12,-5,3,3,1,3,OTC
4618,12-02-2021 16:00,24 hrs.,wallstreetbets,HQGE,7,0,7,-7,1,1,1,1,OTC
4618,12-02-2021 16:00,24 hrs.,wallstreetbets,HRBR,6,6,0,6,1,1,0,1,OTC
4618,12-02-2021 16:00,24 hrs.,wallstreetbets,HYSR,12,0,12,-12,2,2,0,2,OTC
4618,12-02-2021 16:00,24 hrs.,wallstreetbets,IGXT,6,0,6,-6,1,1,0,1,OTC
4618,12-02-2021 16:00,24 hrs.,wallstreetbets,IINX,12,0,12,-12,2,2,0,1,OTC
4618,12-02-2021 16:00,24 hrs.,wallstreetbets,INCT,20,0,20,-20,3,3,2,2,OTC
4618,12-02-2021 16:00,24 hrs.,wallstreetbets,BLPG,7,0,7,-7,1,1,1,1,OTC
4618,12-02-2021 16:00,24 hrs.,wallstreetbets,BLSP,14,0,14,-14,2,2,2,1,OTC
4618,12-02-2021 16:00,24 hrs.,wallstreetbets,BMIX,11,11,0,11,1,1,5,1,OTC
4618,12-02-2021 16:00,24 hrs.,wallstreetbets,BOTY,37,0,37,-37,6,6,1,5,OTC
4618,12-02-2021 16:00,24 hrs.,wallstreetbets,BRLL,12,0,12,-12,2,2,0,2,OTC
4618,12-02-2021 16:00,24 hrs.,wallstreetbets,BRTX,6,0,6,-6,1,1,0,1,OTC
4618,12-02-2021 16:00,24 hrs.,wallstreetbets,BTCY,6,0,6,-6,1,1,0,1,OTC
4618,12-02-2021 16:00,24 hrs.,wallstreetbets,BTSC,7,7,0,7,1,1,1,1,OTC
4618,12-02-2021 16:00,24 hrs.,wallstreetbets,BTZI,6,6,0,6,1,1,0,1,OTC
4618,12-02-2021 16:00,24 hrs.,wallstreetbets,BUDZ,6,0,6,-6,1,1,0,1,OTC
4618,12-02-2021 16:00,24 hrs.,wallstreetbets,CALI,6,0,6,-6,1,1,0,1,OTC
4618,12-02-2021 16:00,24 hrs.,pennystocks,PHIO,52,0,52,-52,1,22,4,1,NASDAQ
4618,12-02-2021 16:00,24 hrs.,pennystocks,PHUN,13,0,13,-13,2,2,1,2,NASDAQ
4618,12-02-2021 16:00,24 hrs.,pennystocks,PLUG,107,17,90,-73,2,22,55,2,NASDAQ
4618,12-02-2021 16:00,24 hrs.,pennystocks,PPBT,10,0,10,-10,1,2,2,1,NASDAQ
4618,12-02-2021 16:00,24 hrs.,pennystocks,PSTV,67,67,0,67,2,24,11,2,NASDAQ
4618,12-02-2021 16:00,24 hrs.,pennystocks,PULM,355,49,306,-257,4,126,87,4,NASDAQ
4618,12-02-2021 16:00,24 hrs.,pennystocks,RAVE,43,0,43,-43,1,14,11,1,NASDAQ
4618,12-02-2021 16:00,24 hrs.,pennystocks,REAL,124,47,77,-30,3,25,62,3,NASDAQ
4618,12-02-2021 16:00,24 hrs.,pennystocks,RIGL,12,0,12,-12,2,2,0,2,NASDAQ
4618,12-02-2021 16:00,24 hrs.,pennystocks,RMTI,58,0,58,-58,2,15,20,2,NASDAQ
4618,12-02-2021 16:00,24 hrs.,pennystocks,SEAC,12,12,0,12,1,2,4,1,NASDAQ
4618,12-02-2021 16:00,24 hrs.,pennystocks,SEEL,203,0,203,-203,1,84,31,1,NASDAQ
4618,12-02-2021 16:00,24 hrs.,pennystocks,SFET,6,6,0,6,1,1,0,1,NASDAQ
4618,12-02-2021 16:00,24 hrs.,pennystocks,SHIP,6,6,0,6,1,1,0,1,NASDAQ
4618,12-02-2021 16:00,24 hrs.,pennystocks,SNCA,6,0,6,-6,1,1,0,1,NASDAQ
4618,12-02-2021 16:00,24 hrs.,pennystocks,SNDL,298,99,199,-100,40,61,16,31,NASDAQ
4618,12-02-2021 16:00,24 hrs.,pennystocks,SNGX,682,565,117,448,6,259,140,4,NASDAQ
4618,12-02-2021 16:00,24 hrs.,pennystocks,SOLO,17,17,0,17,1,6,1,1,NASDAQ
4618,12-02-2021 16:00,24 hrs.,pennystocks,SXTC,13,0,13,-13,2,2,1,1,NASDAQ
4618,12-02-2021 16:00,24 hrs.,pennystocks,TBLT,6,6,0,6,1,1,0,1,NASDAQ
4618,12-02-2021 16:00,24 hrs.,pennystocks,TLRY,79,14,65,-51,4,28,7,4,NASDAQ
4618,12-02-2021 16:00,24 hrs.,pennystocks,TMDI,6,6,0,6,1,1,0,1,NASDAQ
4618,12-02-2021 16:00,24 hrs.,pennystocks,TNXP,1235,297,938,-641,14,494,191,12,NASDAQ
4618,12-02-2021 16:00,24 hrs.,pennystocks,TRCH,24,0,24,-24,4,4,0,2,NASDAQ
4618,12-02-2021 16:00,24 hrs.,pennystocks,TRIP,203,0,203,-203,1,84,31,1,NASDAQ
4618,12-02-2021 16:00,24 hrs.,pennystocks,TSLA,6,6,0,6,1,1,0,1,NASDAQ
4618,12-02-2021 16:00,24 hrs.,pennystocks,TTWO,6,0,6,-6,1,1,0,1,NASDAQ
4618,12-02-2021 16:00,24 hrs.,pennystocks,TXMD,65,7,58,-51,3,16,21,3,NASDAQ
4618,12-02-2021 16:00,24 hrs.,pennystocks,TYME,52,0,52,-52,1,14,20,1,NASDAQ
4618,12-02-2021 16:00,24 hrs.,pennystocks,USWS,12,0,12,-12,2,2,0,2,NASDAQ
4618,12-02-2021 16:00,24 hrs.,pennystocks,VRME,21,0,21,-21,1,6,5,1,NASDAQ
4618,12-02-2021 16:00,24 hrs.,pennystocks,VTVT,7,0,7,-7,1,1,1,1,NASDAQ
4618,12-02-2021 16:00,24 hrs.,pennystocks,WTER,28,0,28,-28,1,4,16,1,NASDAQ
4618,12-02-2021 16:00,24 hrs.,pennystocks,WTRH,80,0,80,-80,2,27,18,2,NASDAQ
4618,12-02-2021 16:00,24 hrs.,pennystocks,XELA,129,129,0,129,1,56,13,1,NASDAQ
4618,12-02-2021 16:00,24 hrs.,pennystocks,XERS,6,0,6,-6,1,1,0,1,NASDAQ
4618,12-02-2021 16:00,24 hrs.,pennystocks,ZSAN,167,33,134,-101,7,48,43,7,NASDAQ
4618,12-02-2021 16:00,24 hrs.,pennystocks,ZYNE,52,0,52,-52,1,22,4,1,NASDAQ
4618,12-02-2021 16:00,24 hrs.,pennystocks,SGAMW,49,0,49,-49,1,18,9,1,NASDAQ
4618,12-02-2021 16:00,24 hrs.,wallstreetbets,ABML,33,20,13,7,5,5,3,5,OTC
4618,12-02-2021 16:00,24 hrs.,wallstreetbets,ABQQ,7,7,0,7,1,1,1,1,OTC
4618,12-02-2021 16:00,24 hrs.,wallstreetbets,ABWN,6,0,6,-6,1,1,0,1,OTC
4618,12-02-2021 16:00,24 hrs.,wallstreetbets,ACRL,6,6,0,6,1,1,0,1,OTC
4618,12-02-2021 16:00,24 hrs.,wallstreetbets,ADTM,6,0,6,-6,1,1,0,1,OTC
4618,12-02-2021 16:00,24 hrs.,wallstreetbets,AEGY,6,0,6,-6,1,1,0,1,OTC
4618,12-02-2021 16:00,24 hrs.,wallstreetbets,AFTM,12,0,12,-12,2,2,0,1,OTC
4618,12-02-2021 16:00,24 hrs.,wallstreetbets,AHFD,7,0,7,-7,1,1,1,1,OTC
4618,12-02-2021 16:00,24 hrs.,wallstreetbets,AITX,44,14,30,-16,7,7,2,7,OTC
4618,12-02-2021 16:00,24 hrs.,wallstreetbets,ALKM,6,0,6,-6,1,1,0,1,OTC
4618,12-02-2021 16:00,24 hrs.,wallstreetbets,ALPP,26,14,12,2,4,4,2,4,OTC
4618,12-02-2021 16:00,24 hrs.,wallstreetbets,ALYI,13,0,13,-13,2,2,1,2,OTC
4618,12-02-2021 16:00,24 hrs.,wallstreetbets,AMNE,19,13,6,7,3,3,1,2,OTC
4618,12-02-2021 16:00,24 hrs.,wallstreetbets,ANDD,6,0,6,-6,1,1,0,1,OTC
4618,12-02-2021 16:00,24 hrs.,wallstreetbets,ANTI,13,0,13,-13,2,2,1,2,OTC
4618,12-02-2021 16:00,24 hrs.,wallstreetbets,APRU,19,0,19,-19,3,3,1,1,OTC
4618,12-02-2021 16:00,24 hrs.,wallstreetbets,ASTI,30,0,30,-30,5,5,0,3,OTC
4618,12-02-2021 16:00,24 hrs.,wallstreetbets,BBRW,6,6,0,6,1,1,0,1,OTC
4618,12-02-2021 16:00,24 hrs.,wallstreetbets,BCAP,24,0,24,-24,4,4,0,2,OTC
4618,12-02-2021 16:00,24 hrs.,wallstreetbets,BCCI,14,0,14,-14,2,2,2,1,OTC
4618,12-02-2021 16:00,24 hrs.,wallstreetbets,BFCH,13,0,13,-13,2,2,1,2,OTC
4618,12-02-2021 16:00,24 hrs.,wallstreetbets,BFRE,6,0,6,-6,1,1,0,1,OTC
4618,12-02-2021 16:00,24 hrs.,wallstreetbets,BIEL,43,19,24,-5,7,7,1,6,OTC
4618,12-02-2021 16:00,24 hrs.,wallstreetbets,BIGG,6,0,6,-6,1,1,0,1,OTC
4618,12-02-2021 16:00,24 hrs.,wallstreetbets,BLDV,6,0,6,-6,1,1,0,1,OTC
4618,12-02-2021 16:00,24 hrs.,pennystocks,MOTS,7,0,7,-7,1,1,1,1,NASDAQ
4618,12-02-2021 16:00,24 hrs.,pennystocks,MTRX,14,0,14,-14,1,4,2,1,NASDAQ
4618,12-02-2021 16:00,24 hrs.,pennystocks,MVIS,58,0,58,-58,2,23,4,2,NASDAQ
4618,12-02-2021 16:00,24 hrs.,pennystocks,NAKD,20,7,13,-6,3,3,2,3,NASDAQ
4618,12-02-2021 16:00,24 hrs.,pennystocks,NDAQ,17,17,0,17,1,6,1,1,NASDAQ
4618,12-02-2021 16:00,24 hrs.,pennystocks,NOVN,36,6,30,-24,3,8,8,3,NASDAQ
4618,12-02-2021 16:00,24 hrs.,pennystocks,NTEC,52,0,52,-52,1,22,4,1,NASDAQ
4618,12-02-2021 16:00,24 hrs.,pennystocks,NVCN,48,35,13,22,3,12,12,3,NASDAQ
4618,12-02-2021 16:00,24 hrs.,pennystocks,NXTD,60,0,60,-60,2,23,6,2,NASDAQ
4618,12-02-2021 16:00,24 hrs.,pennystocks,OCGN,2501,30,2471,-2441,3,1157,175,3,NASDAQ
4618,12-02-2021 16:00,24 hrs.,pennystocks,ONTX,12,6,6,0,2,2,0,2,NASDAQ
4594,12-02-2021 12:00,24 hrs.,RobinHoodPennyStocks,CTRM,1160,191,969,-778,32,338,356,27,NASDAQ
4594,12-02-2021 12:00,24 hrs.,RobinHoodPennyStocks,DFFN,19,6,13,-7,2,3,5,2,NASDAQ
4594,12-02-2021 12:00,24 hrs.,RobinHoodPennyStocks,EAST,166,48,118,-70,5,52,42,5,NASDAQ
4594,12-02-2021 12:00,24 hrs.,RobinHoodPennyStocks,PDT,117,0,117,-117,2,38,33,2,NYSE
4594,12-02-2021 12:00,24 hrs.,RobinHoodPennyStocks,PSA,54,16,38,-22,2,15,16,2,NYSE
4594,12-02-2021 12:00,24 hrs.,RobinHoodPennyStocks,RFP,96,96,0,96,1,35,22,1,NYSE
4594,12-02-2021 12:00,24 hrs.,RobinHoodPennyStocks,SOS,169,109,60,49,12,46,29,10,NYSE
4594,12-02-2021 12:00,24 hrs.,RobinHoodPennyStocks,SUZ,96,96,0,96,1,35,22,1,NYSE
4594,12-02-2021 12:00,24 hrs.,RobinHoodPennyStocks,TAL,96,96,0,96,1,35,22,1,NYSE
4594,12-02-2021 12:00,24 hrs.,RobinHoodPennyStocks,WEI,104,96,8,88,2,36,24,2,NYSE
4594,12-02-2021 12:00,24 hrs.,RobinHoodPennyStocks,BABA,96,96,0,96,1,35,22,1,NYSE
4594,12-02-2021 12:00,24 hrs.,RobinHoodPennyStocks,CEIX,96,96,0,96,1,35,22,1,NYSE
4594,12-02-2021 12:00,24 hrs.,RobinHoodPennyStocks,CMCM,96,96,0,96,1,35,22,1,NYSE
4594,12-02-2021 12:00,24 hrs.,RobinHoodPennyStocks,EXPR,6,0,6,-6,1,1,0,1,NYSE
4594,12-02-2021 12:00,24 hrs.,RobinHoodPennyStocks,FUBO,102,96,6,90,2,36,22,2,NYSE
4594,12-02-2021 12:00,24 hrs.,RobinHoodPennyStocks,LAIX,96,96,0,96,1,35,22,1,NYSE
4594,12-02-2021 12:00,24 hrs.,RobinHoodPennyStocks,RLGY,96,96,0,96,1,35,22,1,NYSE
4594,12-02-2021 12:00,24 hrs.,RobinHoodPennyStocks,XPEV,96,96,0,96,1,35,22,1,NYSE
4594,12-02-2021 12:00,24 hrs.,RobinHoodPennyStocks,AIH,96,96,0,96,1,35,22,1,NASDAQ
4594,12-02-2021 12:00,24 hrs.,RobinHoodPennyStocks,BBI,6,0,6,-6,1,1,0,1,NASDAQ
4594,12-02-2021 12:00,24 hrs.,RobinHoodPennyStocks,ENG,96,96,0,96,1,35,22,1,NASDAQ
4594,12-02-2021 12:00,24 hrs.,RobinHoodPennyStocks,EVK,96,96,0,96,1,35,22,1,NASDAQ
4594,12-02-2021 12:00,24 hrs.,RobinHoodPennyStocks,JFU,12,0,12,-12,2,2,0,2,NASDAQ
4594,12-02-2021 12:00,24 hrs.,RobinHoodPennyStocks,MGI,96,96,0,96,1,35,22,1,NASDAQ
4594,12-02-2021 12:00,24 hrs.,RobinHoodPennyStocks,OCG,96,96,0,96,1,35,22,1,NASDAQ
4594,12-02-2021 12:00,24 hrs.,RobinHoodPennyStocks,OEG,96,96,0,96,1,35,22,1,NASDAQ
4594,12-02-2021 12:00,24 hrs.,RobinHoodPennyStocks,OGI,3764,0,3764,-3764,4,1640,468,4,NASDAQ
4594,12-02-2021 12:00,24 hrs.,pennystocks,NAK,18,6,12,-6,3,3,0,3,AMEX
4594,12-02-2021 12:00,24 hrs.,pennystocks,NBY,21,0,21,-21,1,5,7,1,AMEX
4594,12-02-2021 12:00,24 hrs.,pennystocks,NHS,17,0,17,-17,1,0,13,1,AMEX
4594,12-02-2021 12:00,24 hrs.,pennystocks,PTN,11,0,11,-11,1,2,3,1,AMEX
4594,12-02-2021 12:00,24 hrs.,pennystocks,SIM,6,0,6,-6,1,1,0,1,AMEX
4594,12-02-2021 12:00,24 hrs.,pennystocks,TGC,48,0,48,-48,1,20,4,1,AMEX
4594,12-02-2021 12:00,24 hrs.,pennystocks,TRX,20,7,13,-6,3,3,2,3,AMEX
4594,12-02-2021 12:00,24 hrs.,pennystocks,URG,21,0,21,-21,1,8,1,1,AMEX
4594,12-02-2021 12:00,24 hrs.,pennystocks,WRN,6,0,6,-6,1,1,0,1,AMEX
4594,12-02-2021 12:00,24 hrs.,pennystocks,ZOM,190,122,68,54,6,65,36,6,AMEX
4594,12-02-2021 12:00,24 hrs.,pennystocks,GSAT,12,0,12,-12,2,2,0,2,AMEX
4594,12-02-2021 12:00,24 hrs.,pennystocks,IBIO,7,0,7,-7,1,1,1,1,AMEX
4594,12-02-2021 12:00,24 hrs.,pennystocks,INUV,23,23,0,23,1,8,3,1,AMEX
4594,12-02-2021 12:00,24 hrs.,pennystocks,OGEN,6,0,6,-6,1,1,0,1,AMEX
4594,12-02-2021 12:00,24 hrs.,RobinHoodPennyStocks,PTE,140,12,128,-116,6,53,10,4,NASDAQ
4594,12-02-2021 12:00,24 hrs.,RobinHoodPennyStocks,QTT,96,96,0,96,1,35,22,1,NASDAQ
4594,12-02-2021 12:00,24 hrs.,RobinHoodPennyStocks,SPI,96,96,0,96,1,35,22,1,NASDAQ
4594,12-02-2021 12:00,24 hrs.,RobinHoodPennyStocks,WNW,96,96,0,96,1,35,22,1,NASDAQ
4594,12-02-2021 12:00,24 hrs.,RobinHoodPennyStocks,WWR,96,96,0,96,1,35,22,1,NASDAQ
4594,12-02-2021 12:00,24 hrs.,RobinHoodPennyStocks,AAOI,96,96,0,96,1,35,22,1,NASDAQ
4594,12-02-2021 12:00,24 hrs.,RobinHoodPennyStocks,ABEO,141,0,141,-141,2,53,27,2,NASDAQ
4594,12-02-2021 12:00,24 hrs.,RobinHoodPennyStocks,ABIO,26,26,0,26,1,3,16,1,NASDAQ
4594,12-02-2021 12:00,24 hrs.,RobinHoodPennyStocks,ACOR,96,96,0,96,1,35,22,1,NASDAQ
4594,12-02-2021 12:00,24 hrs.,RobinHoodPennyStocks,ADMA,37,0,37,-37,1,12,9,1,NASDAQ
4594,12-02-2021 12:00,24 hrs.,RobinHoodPennyStocks,ADXS,12,0,12,-12,2,2,0,1,NASDAQ
4594,12-02-2021 12:00,24 hrs.,RobinHoodPennyStocks,AEHR,96,96,0,96,1,35,22,1,NASDAQ
4594,12-02-2021 12:00,24 hrs.,RobinHoodPennyStocks,AESE,6,0,6,-6,1,1,0,1,NASDAQ
4594,12-02-2021 12:00,24 hrs.,RobinHoodPennyStocks,AEZS,43,0,43,-43,2,6,23,2,NASDAQ
4594,12-02-2021 12:00,24 hrs.,RobinHoodPennyStocks,AGTC,5106,688,4418,-3730,43,2002,930,38,NASDAQ
4594,12-02-2021 12:00,24 hrs.,RobinHoodPennyStocks,AIHS,102,96,6,90,2,36,22,2,NASDAQ
4594,12-02-2021 12:00,24 hrs.,RobinHoodPennyStocks,ALAC,96,96,0,96,1,35,22,1,NASDAQ
4594,12-02-2021 12:00,24 hrs.,RobinHoodPennyStocks,AMTX,96,96,0,96,1,35,22,1,NASDAQ
4594,12-02-2021 12:00,24 hrs.,RobinHoodPennyStocks,APHA,30,6,24,-18,5,5,0,4,NASDAQ
4594,12-02-2021 12:00,24 hrs.,RobinHoodPennyStocks,ARPO,6,6,0,6,1,1,0,1,NASDAQ
4594,12-02-2021 12:00,24 hrs.,RobinHoodPennyStocks,ARTL,6,0,6,-6,1,1,0,1,NASDAQ
4594,12-02-2021 12:00,24 hrs.,RobinHoodPennyStocks,ASRT,212,0,212,-212,5,70,52,4,NASDAQ
4594,12-02-2021 12:00,24 hrs.,RobinHoodPennyStocks,ASYS,96,96,0,96,1,35,22,1,NASDAQ
4594,12-02-2021 12:00,24 hrs.,RobinHoodPennyStocks,ATIF,96,96,0,96,1,35,22,1,NASDAQ
4594,12-02-2021 12:00,24 hrs.,RobinHoodPennyStocks,ATNI,96,96,0,96,1,35,22,1,NASDAQ
4594,12-02-2021 12:00,24 hrs.,RobinHoodPennyStocks,ATOS,188,24,164,-140,8,56,44,8,NASDAQ
4594,12-02-2021 12:00,24 hrs.,RobinHoodPennyStocks,AVCO,96,96,0,96,1,35,22,1,NASDAQ
4594,12-02-2021 12:00,24 hrs.,RobinHoodPennyStocks,AYTU,15,0,15,-15,1,4,3,1,NASDAQ
4594,12-02-2021 12:00,24 hrs.,RobinHoodPennyStocks,BBIG,12,6,6,0,2,2,0,2,NASDAQ
4594,12-02-2021 12:00,24 hrs.,RobinHoodPennyStocks,BCLI,6,0,6,-6,1,1,0,1,NASDAQ
4594,12-02-2021 12:00,24 hrs.,RobinHoodPennyStocks,BCRX,44,0,44,-44,1,9,22,1,NASDAQ
4594,12-02-2021 12:00,24 hrs.,RobinHoodPennyStocks,BFRA,96,96,0,96,1,35,22,1,NASDAQ
4594,12-02-2021 12:00,24 hrs.,RobinHoodPennyStocks,BHAT,96,96,0,96,1,35,22,1,NASDAQ
4594,12-02-2021 12:00,24 hrs.,RobinHoodPennyStocks,BIOL,23,0,23,-23,2,5,5,2,NASDAQ
4594,12-02-2021 12:00,24 hrs.,RobinHoodPennyStocks,BRQS,115,109,6,103,3,37,29,3,NASDAQ
4594,12-02-2021 12:00,24 hrs.,RobinHoodPennyStocks,BYFC,96,96,0,96,1,35,22,1,NASDAQ
4594,12-02-2021 12:00,24 hrs.,RobinHoodPennyStocks,CAAS,96,96,0,96,1,35,22,1,NASDAQ
4594,12-02-2021 12:00,24 hrs.,RobinHoodPennyStocks,CARV,96,96,0,96,1,35,22,1,NASDAQ
4594,12-02-2021 12:00,24 hrs.,RobinHoodPennyStocks,CBAT,96,96,0,96,1,35,22,1,NASDAQ
4594,12-02-2021 12:00,24 hrs.,RobinHoodPennyStocks,CCNC,96,96,0,96,1,35,22,1,NASDAQ
4594,12-02-2021 12:00,24 hrs.,RobinHoodPennyStocks,CHNR,96,96,0,96,1,35,22,1,NASDAQ
4594,12-02-2021 12:00,24 hrs.,RobinHoodPennyStocks,CIDM,6,0,6,-6,1,1,0,1,NASDAQ
4594,12-02-2021 12:00,24 hrs.,RobinHoodPennyStocks,CKPT,270,0,270,-270,1,53,160,1,NASDAQ
4594,12-02-2021 12:00,24 hrs.,RobinHoodPennyStocks,CLEU,96,96,0,96,1,35,22,1,NASDAQ
4594,12-02-2021 12:00,24 hrs.,RobinHoodPennyStocks,CLRB,21,0,21,-21,1,8,1,1,NASDAQ
4594,12-02-2021 12:00,24 hrs.,RobinHoodPennyStocks,CLSK,96,96,0,96,1,35,22,1,NASDAQ
4594,12-02-2021 12:00,24 hrs.,RobinHoodPennyStocks,CLSN,12,0,12,-12,2,2,0,2,NASDAQ
4594,12-02-2021 12:00,24 hrs.,RobinHoodPennyStocks,CMLF,96,96,0,96,1,35,22,1,NASDAQ
4594,12-02-2021 12:00,24 hrs.,RobinHoodPennyStocks,CRBP,10,0,10,-10,1,2,2,1,NASDAQ
4594,12-02-2021 12:00,24 hrs.,RobinHoodPennyStocks,CSCW,96,96,0,96,1,35,22,1,NASDAQ
4594,12-02-2021 12:00,24 hrs.,pennystocks,GME,49,12,37,-25,8,8,1,7,NYSE
4594,12-02-2021 12:00,24 hrs.,pennystocks,JKS,47,0,47,-47,1,16,11,1,NYSE
4594,12-02-2021 12:00,24 hrs.,pennystocks,LEE,110,0,110,-110,2,16,70,2,NYSE
4594,12-02-2021 12:00,24 hrs.,pennystocks,LOW,125,125,0,125,1,53,15,1,NYSE
4594,12-02-2021 12:00,24 hrs.,pennystocks,MUX,6,0,6,-6,1,1,0,1,NYSE
4594,12-02-2021 12:00,24 hrs.,pennystocks,NOK,60,0,60,-60,3,14,20,2,NYSE
4594,12-02-2021 12:00,24 hrs.,pennystocks,NYC,752,0,752,-752,1,322,104,1,NYSE
4594,12-02-2021 12:00,24 hrs.,pennystocks,PHI,6,0,6,-6,1,1,0,1,NYSE
4594,12-02-2021 12:00,24 hrs.,pennystocks,PSA,600,7,593,-586,5,264,52,5,NYSE
4594,12-02-2021 12:00,24 hrs.,pennystocks,RSI,35,23,12,11,3,9,5,3,NYSE
4594,12-02-2021 12:00,24 hrs.,pennystocks,SAP,200,0,200,-200,1,84,28,1,NYSE
4594,12-02-2021 12:00,24 hrs.,pennystocks,SOS,51,15,36,-21,5,8,15,5,NYSE
4594,12-02-2021 12:00,24 hrs.,pennystocks,TDA,23,0,23,-23,1,3,13,1,NYSE
4594,12-02-2021 12:00,24 hrs.,pennystocks,THC,309,0,309,-309,3,121,55,3,NYSE
4594,12-02-2021 12:00,24 hrs.,pennystocks,TKR,13,0,13,-13,1,3,3,1,NYSE
4594,12-02-2021 12:00,24 hrs.,pennystocks,TTI,12,0,12,-12,2,2,0,1,NYSE
4594,12-02-2021 12:00,24 hrs.,pennystocks,VET,9,0,9,-9,1,2,1,1,NYSE
4594,12-02-2021 12:00,24 hrs.,pennystocks,WWE,7,7,0,7,1,1,1,1,NYSE
4594,12-02-2021 12:00,24 hrs.,pennystocks,AQUA,7,0,7,-7,1,1,1,1,NYSE
4594,12-02-2021 12:00,24 hrs.,pennystocks,BORR,6,0,6,-6,1,1,0,1,NYSE
4594,12-02-2021 12:00,24 hrs.,pennystocks,DASH,6,0,6,-6,1,1,0,1,NYSE
4594,12-02-2021 12:00,24 hrs.,pennystocks,FENG,6,0,6,-6,1,1,0,1,NYSE
4594,12-02-2021 12:00,24 hrs.,pennystocks,HYLN,19,0,19,-19,3,3,1,2,NYSE
4594,12-02-2021 12:00,24 hrs.,pennystocks,LEAF,48,0,48,-48,1,16,12,1,NYSE
4594,12-02-2021 12:00,24 hrs.,pennystocks,NOVA,200,0,200,-200,1,84,28,1,NYSE
4594,12-02-2021 12:00,24 hrs.,pennystocks,VIST,12,12,0,12,1,2,4,1,NYSE
4594,12-02-2021 12:00,24 hrs.,pennystocks,AQB,27,6,21,-15,2,9,1,2,NASDAQ
4594,12-02-2021 12:00,24 hrs.,pennystocks,AZN,30,0,30,-30,1,6,14,1,NASDAQ
4594,12-02-2021 12:00,24 hrs.,pennystocks,BBI,47,41,6,35,2,16,7,2,NASDAQ
4594,12-02-2021 12:00,24 hrs.,pennystocks,CFO,29,0,29,-29,1,7,11,1,NASDAQ
4594,12-02-2021 12:00,24 hrs.,pennystocks,GBT,7,0,7,-7,1,1,1,1,NASDAQ
4594,12-02-2021 12:00,24 hrs.,pennystocks,JFU,6,0,6,-6,1,1,0,1,NASDAQ
4594,12-02-2021 12:00,24 hrs.,pennystocks,KOD,6,6,0,6,1,1,0,1,NASDAQ
4594,12-02-2021 12:00,24 hrs.,RobinHoodPennyStocks,ENVB,70,0,70,-70,2,24,14,2,NASDAQ
4594,12-02-2021 12:00,24 hrs.,RobinHoodPennyStocks,EQOS,96,96,0,96,1,35,22,1,NASDAQ
4594,12-02-2021 12:00,24 hrs.,RobinHoodPennyStocks,FCEL,96,96,0,96,1,35,22,1,NASDAQ
4594,12-02-2021 12:00,24 hrs.,RobinHoodPennyStocks,GHSI,136,0,136,-136,3,51,22,3,NASDAQ
4594,12-02-2021 12:00,24 hrs.,RobinHoodPennyStocks,GLMD,270,0,270,-270,1,53,160,1,NASDAQ
4594,12-02-2021 12:00,24 hrs.,RobinHoodPennyStocks,GMDA,6,6,0,6,1,1,0,1,NASDAQ
4594,12-02-2021 12:00,24 hrs.,RobinHoodPennyStocks,GRIL,96,96,0,96,1,35,22,1,NASDAQ
4594,12-02-2021 12:00,24 hrs.,RobinHoodPennyStocks,GRWG,6,0,6,-6,1,1,0,1,NASDAQ
4594,12-02-2021 12:00,24 hrs.,RobinHoodPennyStocks,HCDI,96,96,0,96,1,35,22,1,NASDAQ
4594,12-02-2021 12:00,24 hrs.,RobinHoodPennyStocks,HGSH,96,96,0,96,1,35,22,1,NASDAQ
4594,12-02-2021 12:00,24 hrs.,pennystocks,TSCRF,29,29,0,29,1,9,7,1,OTC
4594,12-02-2021 12:00,24 hrs.,pennystocks,TSKFF,33,33,0,33,1,12,5,1,OTC
4594,12-02-2021 12:00,24 hrs.,pennystocks,TTTSF,12,6,6,0,2,2,0,2,OTC
4594,12-02-2021 12:00,24 hrs.,pennystocks,VLNCF,16,0,16,-16,2,2,4,2,OTC
4594,12-02-2021 12:00,24 hrs.,pennystocks,VRNDF,6,0,6,-6,1,1,0,1,OTC
4594,12-02-2021 12:00,24 hrs.,pennystocks,XELAW,38,38,0,38,1,12,10,1,OTC
4594,12-02-2021 12:00,24 hrs.,pennystocks,ZBISF,12,0,12,-12,2,2,0,2,OTC
4594,12-02-2021 12:00,24 hrs.,pennystocks,AIM,7,7,0,7,1,1,1,1,AMEX
4594,12-02-2021 12:00,24 hrs.,pennystocks,APT,12,0,12,-12,2,2,0,1,AMEX
4594,12-02-2021 12:00,24 hrs.,pennystocks,CEI,6,0,6,-6,1,1,0,1,AMEX
4594,12-02-2021 12:00,24 hrs.,pennystocks,CTO,41,23,18,5,4,5,15,2,AMEX
4594,12-02-2021 12:00,24 hrs.,pennystocks,DNN,884,194,690,-496,10,302,240,8,AMEX
4594,12-02-2021 12:00,24 hrs.,pennystocks,DPW,6,6,0,6,1,1,0,1,AMEX
4594,12-02-2021 12:00,24 hrs.,pennystocks,DSS,18,0,18,-18,2,1,8,2,AMEX
4594,12-02-2021 12:00,24 hrs.,pennystocks,GPL,33,33,0,33,1,12,5,1,AMEX
4594,12-02-2021 12:00,24 hrs.,pennystocks,GSV,120,0,120,-120,5,39,22,4,AMEX
4594,12-02-2021 12:00,24 hrs.,pennystocks,GTE,39,7,32,-25,4,8,7,4,AMEX
4594,12-02-2021 12:00,24 hrs.,pennystocks,ITP,26,26,0,26,2,3,12,2,AMEX
4594,12-02-2021 12:00,24 hrs.,pennystocks,LNG,9,0,9,-9,1,2,1,1,AMEX
4594,12-02-2021 12:00,24 hrs.,pennystocks,MCF,6,0,6,-6,1,1,0,1,AMEX
4594,12-02-2021 12:00,24 hrs.,pennystocks,MXC,45,7,38,-31,2,16,5,2,AMEX
4594,12-02-2021 12:00,24 hrs.,RobinHoodPennyStocks,MOSY,96,96,0,96,1,35,22,1,NASDAQ
4594,12-02-2021 12:00,24 hrs.,RobinHoodPennyStocks,MOTS,9,0,9,-9,1,2,1,1,NASDAQ
4594,12-02-2021 12:00,24 hrs.,RobinHoodPennyStocks,MOXC,96,96,0,96,1,35,22,1,NASDAQ
4594,12-02-2021 12:00,24 hrs.,RobinHoodPennyStocks,MVIS,102,96,6,90,2,36,22,2,NASDAQ
4594,12-02-2021 12:00,24 hrs.,RobinHoodPennyStocks,NAKD,210,108,102,6,7,53,76,7,NASDAQ
4594,12-02-2021 12:00,24 hrs.,RobinHoodPennyStocks,NCTY,96,96,0,96,1,35,22,1,NASDAQ
4594,12-02-2021 12:00,24 hrs.,RobinHoodPennyStocks,NDRA,6,0,6,-6,1,1,0,1,NASDAQ
4594,12-02-2021 12:00,24 hrs.,RobinHoodPennyStocks,NEOS,15,0,15,-15,1,4,3,1,NASDAQ
4594,12-02-2021 12:00,24 hrs.,RobinHoodPennyStocks,NOVN,195,120,75,45,7,57,53,5,NASDAQ
4594,12-02-2021 12:00,24 hrs.,RobinHoodPennyStocks,NVCN,119,0,119,-119,5,29,41,5,NASDAQ
4594,12-02-2021 12:00,24 hrs.,RobinHoodPennyStocks,NVIV,12,12,0,12,1,2,4,1,NASDAQ
4594,12-02-2021 12:00,24 hrs.,RobinHoodPennyStocks,NXTD,102,96,6,90,2,36,22,2,NASDAQ
4594,12-02-2021 12:00,24 hrs.,RobinHoodPennyStocks,OCGN,138,0,138,-138,7,24,62,7,NASDAQ
4594,12-02-2021 12:00,24 hrs.,RobinHoodPennyStocks,ONTX,34,6,28,-22,3,9,4,3,NASDAQ
4594,12-02-2021 12:00,24 hrs.,RobinHoodPennyStocks,OPGN,18,6,12,-6,3,3,0,2,NASDAQ
4594,12-02-2021 12:00,24 hrs.,RobinHoodPennyStocks,OPTT,96,96,0,96,1,35,22,1,NASDAQ
4594,12-02-2021 12:00,24 hrs.,RobinHoodPennyStocks,PECK,96,96,0,96,1,35,22,1,NASDAQ
4594,12-02-2021 12:00,24 hrs.,RobinHoodPennyStocks,PEIX,96,96,0,96,1,35,22,1,NASDAQ
4594,12-02-2021 12:00,24 hrs.,RobinHoodPennyStocks,PETZ,96,96,0,96,1,35,22,1,NASDAQ
4594,12-02-2021 12:00,24 hrs.,RobinHoodPennyStocks,PHUN,96,96,0,96,1,35,22,1,NASDAQ
4594,12-02-2021 12:00,24 hrs.,RobinHoodPennyStocks,PIXY,96,96,0,96,1,35,22,1,NASDAQ
4594,12-02-2021 12:00,24 hrs.,RobinHoodPennyStocks,PLIN,102,96,6,90,2,36,22,2,NASDAQ
4594,12-02-2021 12:00,24 hrs.,RobinHoodPennyStocks,PLUG,96,96,0,96,1,35,22,1,NASDAQ
4594,12-02-2021 12:00,24 hrs.,RobinHoodPennyStocks,PSEC,25,0,25,-25,4,4,1,2,NASDAQ
4594,12-02-2021 12:00,24 hrs.,RobinHoodPennyStocks,PSTV,45,39,6,33,2,15,7,2,NASDAQ
4594,12-02-2021 12:00,24 hrs.,RobinHoodPennyStocks,PULM,251,0,251,-251,3,95,49,3,NASDAQ
4594,12-02-2021 12:00,24 hrs.,RobinHoodPennyStocks,PXLW,6,6,0,6,1,1,0,1,NASDAQ
4594,12-02-2021 12:00,24 hrs.,RobinHoodPennyStocks,QUIK,96,96,0,96,1,35,22,1,NASDAQ
4594,12-02-2021 12:00,24 hrs.,RobinHoodPennyStocks,RAVE,96,96,0,96,1,35,22,1,NASDAQ
4594,12-02-2021 12:00,24 hrs.,RobinHoodPennyStocks,RCMT,96,96,0,96,1,35,22,1,NASDAQ
4594,12-02-2021 12:00,24 hrs.,RobinHoodPennyStocks,REAL,58,58,0,58,1,18,18,1,NASDAQ
4594,12-02-2021 12:00,24 hrs.,RobinHoodPennyStocks,RETO,6,0,6,-6,1,1,0,1,NASDAQ
4594,12-02-2021 12:00,24 hrs.,RobinHoodPennyStocks,RIOT,96,96,0,96,1,35,22,1,NASDAQ
4594,12-02-2021 12:00,24 hrs.,RobinHoodPennyStocks,RWLK,6,0,6,-6,1,1,0,1,NASDAQ
4594,12-02-2021 12:00,24 hrs.,RobinHoodPennyStocks,SALM,96,96,0,96,1,35,22,1,NASDAQ
4594,12-02-2021 12:00,24 hrs.,RobinHoodPennyStocks,SAVA,96,96,0,96,1,35,22,1,NASDAQ
4594,12-02-2021 12:00,24 hrs.,RobinHoodPennyStocks,SEED,96,96,0,96,1,35,22,1,NASDAQ
4594,12-02-2021 12:00,24 hrs.,RobinHoodPennyStocks,SGOC,96,96,0,96,1,35,22,1,NASDAQ
4594,12-02-2021 12:00,24 hrs.,RobinHoodPennyStocks,SHIP,18,6,12,-6,3,3,0,2,NASDAQ
4594,12-02-2021 12:00,24 hrs.,RobinHoodPennyStocks,SNDL,6272,163,6109,-5946,75,2343,1286,64,NASDAQ
4594,12-02-2021 12:00,24 hrs.,RobinHoodPennyStocks,SNGX,120,41,79,-38,5,42,16,5,NASDAQ
4594,12-02-2021 12:00,24 hrs.,RobinHoodPennyStocks,SONM,55,0,55,-55,1,21,9,1,NASDAQ
4594,12-02-2021 12:00,24 hrs.,RobinHoodPennyStocks,SRGA,17,0,17,-17,1,5,3,1,NASDAQ
4594,12-02-2021 12:00,24 hrs.,pennystocks,SENS,60,33,27,6,3,22,4,3,AMEX
4594,12-02-2021 12:00,24 hrs.,pennystocks,TMBR,48,0,48,-48,1,20,4,1,AMEX
4594,12-02-2021 12:00,24 hrs.,pennystocks,TRXC,6,6,0,6,1,1,0,1,AMEX
4594,12-02-2021 12:00,24 hrs.,pennystocks,UUUU,45,0,45,-45,2,13,11,2,AMEX
4594,12-02-2021 12:00,24 hrs.,pennystocks,XXII,37,0,37,-37,2,12,5,1,AMEX
4594,12-02-2021 12:00,24 hrs.,pennystocks,YCBD,6,0,6,-6,1,1,0,1,AMEX
4594,12-02-2021 12:00,24 hrs.,pennystocks,AMC,26,0,26,-26,4,4,2,3,NYSE
4594,12-02-2021 12:00,24 hrs.,pennystocks,AMP,98,0,98,-98,2,33,24,2,NYSE
4594,12-02-2021 12:00,24 hrs.,pennystocks,ASX,13,7,6,1,2,2,1,2,NYSE
4594,12-02-2021 12:00,24 hrs.,pennystocks,AUY,6,0,6,-6,1,1,0,1,NYSE
4594,12-02-2021 12:00,24 hrs.,pennystocks,BIO,292,166,126,40,2,125,34,2,NYSE
4594,12-02-2021 12:00,24 hrs.,pennystocks,CBD,377,13,364,-351,14,127,67,11,NYSE
4594,12-02-2021 12:00,24 hrs.,pennystocks,CMO,29,0,29,-29,1,7,11,1,NYSE
4594,12-02-2021 12:00,24 hrs.,pennystocks,CRL,6,0,6,-6,1,1,0,1,NYSE
4594,12-02-2021 12:00,24 hrs.,pennystocks,CTK,48,0,48,-48,1,20,4,1,NYSE
4594,12-02-2021 12:00,24 hrs.,pennystocks,CVE,14,8,6,2,2,2,2,2,NYSE
4594,12-02-2021 12:00,24 hrs.,pennystocks,DDS,47,0,47,-47,1,16,11,1,NYSE
4594,12-02-2021 12:00,24 hrs.,pennystocks,ETH,6,0,6,-6,1,1,0,1,NYSE
4594,12-02-2021 12:00,24 hrs.,pennystocks,EXP,10,0,10,-10,1,2,2,1,NYSE
4594,12-02-2021 12:00,24 hrs.,pennystocks,FLT,13,0,13,-13,2,2,1,2,NYSE
4594,12-02-2021 12:00,24 hrs.,pennystocks,GIK,9,0,9,-9,1,0,5,1,NYSE
4594,12-02-2021 12:00,24 hrs.,pennystocks,IFMK,86,38,48,-10,2,32,14,2,NASDAQ
4594,12-02-2021 12:00,24 hrs.,pennystocks,INFI,48,0,48,-48,1,20,4,1,NASDAQ
4594,12-02-2021 12:00,24 hrs.,pennystocks,INFO,6,0,6,-6,1,0,2,1,NASDAQ
4594,12-02-2021 12:00,24 hrs.,pennystocks,INPX,88,13,75,-62,7,26,8,6,NASDAQ
4594,12-02-2021 12:00,24 hrs.,pennystocks,ITRM,10,0,10,-10,1,2,2,1,NASDAQ
4594,12-02-2021 12:00,24 hrs.,pennystocks,JAGX,17,0,17,-17,2,4,1,2,NASDAQ
4594,12-02-2021 12:00,24 hrs.,pennystocks,KTRA,73,66,7,59,3,22,17,3,NASDAQ
4594,12-02-2021 12:00,24 hrs.,pennystocks,KXIN,7,0,7,-7,1,1,1,1,NASDAQ
4594,12-02-2021 12:00,24 hrs.,pennystocks,LIFE,17,0,17,-17,2,4,1,2,NASDAQ
4594,12-02-2021 12:00,24 hrs.,pennystocks,LKCO,74,7,67,-60,5,24,6,4,NASDAQ
4594,12-02-2021 12:00,24 hrs.,pennystocks,LMFA,47,0,47,-47,1,16,11,1,NASDAQ
4594,12-02-2021 12:00,24 hrs.,pennystocks,LPCN,61,40,21,19,2,21,11,2,NASDAQ
4594,12-02-2021 12:00,24 hrs.,pennystocks,MARA,9,9,0,9,1,0,5,1,NASDAQ
4594,12-02-2021 12:00,24 hrs.,pennystocks,MARK,80,80,0,80,1,12,52,1,NASDAQ
4594,12-02-2021 12:00,24 hrs.,pennystocks,MDGS,6,6,0,6,1,1,0,1,NASDAQ
4594,12-02-2021 12:00,24 hrs.,pennystocks,MICT,7,0,7,-7,1,1,1,1,NASDAQ
4594,12-02-2021 12:00,24 hrs.,RobinHoodPennyStocks,TAIT,96,96,0,96,1,35,22,1,NASDAQ
4594,12-02-2021 12:00,24 hrs.,pennystocks,MFH,48,0,48,-48,1,20,4,1,NASDAQ
4594,12-02-2021 12:00,24 hrs.,pennystocks,NEO,380,0,380,-380,2,161,50,2,NASDAQ
4594,12-02-2021 12:00,24 hrs.,pennystocks,OGI,20,7,13,-6,3,3,2,3,NASDAQ
4594,12-02-2021 12:00,24 hrs.,pennystocks,PTE,20,0,20,-20,3,3,2,2,NASDAQ
4594,12-02-2021 12:00,24 hrs.,pennystocks,RUN,4,0,4,-4,1,0,0,1,NASDAQ
4594,12-02-2021 12:00,24 hrs.,pennystocks,UFO,6,6,0,6,1,1,0,1,NASDAQ
4594,12-02-2021 12:00,24 hrs.,pennystocks,ABEO,51,0,51,-51,8,8,3,3,NASDAQ
4594,12-02-2021 12:00,24 hrs.,pennystocks,ABIO,36,30,6,24,2,12,4,2,NASDAQ
4594,12-02-2021 12:00,24 hrs.,pennystocks,ACRX,21,0,21,-21,1,8,1,1,NASDAQ
4594,12-02-2021 12:00,24 hrs.,pennystocks,ACST,7,7,0,7,1,1,1,1,NASDAQ
4594,12-02-2021 12:00,24 hrs.,pennystocks,ADTX,44,0,44,-44,2,11,14,2,NASDAQ
4594,12-02-2021 12:00,24 hrs.,pennystocks,ADXS,26,0,26,-26,4,4,2,3,NASDAQ
4594,12-02-2021 12:00,24 hrs.,pennystocks,AEMD,38,0,38,-38,1,14,6,1,NASDAQ
4594,12-02-2021 12:00,24 hrs.,pennystocks,AGTC,570,15,555,-540,6,235,76,6,NASDAQ
4594,12-02-2021 12:00,24 hrs.,pennystocks,AIHS,6,0,6,-6,1,1,0,1,NASDAQ
4594,12-02-2021 12:00,24 hrs.,pennystocks,AKBA,14,0,14,-14,2,3,0,1,NASDAQ
4594,12-02-2021 12:00,24 hrs.,pennystocks,AKER,7,0,7,-7,1,1,1,1,NASDAQ
4594,12-02-2021 12:00,24 hrs.,pennystocks,ALRN,18,18,0,18,1,2,10,1,NASDAQ
4594,12-02-2021 12:00,24 hrs.,pennystocks,AMTX,21,0,21,-21,1,8,1,1,NASDAQ
4594,12-02-2021 12:00,24 hrs.,pennystocks,ANDA,17,0,17,-17,1,0,13,1,NASDAQ
4594,12-02-2021 12:00,24 hrs.,pennystocks,ARTL,118,0,118,-118,1,40,34,1,NASDAQ
4594,12-02-2021 12:00,24 hrs.,pennystocks,ASRT,503,246,257,-11,10,188,87,4,NASDAQ
4594,12-02-2021 12:00,24 hrs.,pennystocks,ATHE,21,0,21,-21,1,8,1,1,NASDAQ
4594,12-02-2021 12:00,24 hrs.,RobinHoodPennyStocks,SUNW,96,96,0,96,1,35,22,1,NASDAQ
4594,12-02-2021 12:00,24 hrs.,RobinHoodPennyStocks,SXTC,96,96,0,96,1,35,22,1,NASDAQ
4594,12-02-2021 12:00,24 hrs.,RobinHoodPennyStocks,SYPR,96,96,0,96,1,35,22,1,NASDAQ
4594,12-02-2021 12:00,24 hrs.,RobinHoodPennyStocks,IDEX,96,96,0,96,1,35,22,1,NASDAQ
4594,12-02-2021 12:00,24 hrs.,RobinHoodPennyStocks,IFMK,96,96,0,96,1,35,22,1,NASDAQ
4594,12-02-2021 12:00,24 hrs.,RobinHoodPennyStocks,IMTE,96,96,0,96,1,35,22,1,NASDAQ
4594,12-02-2021 12:00,24 hrs.,RobinHoodPennyStocks,INPX,25,0,25,-25,4,4,1,4,NASDAQ
4594,12-02-2021 12:00,24 hrs.,RobinHoodPennyStocks,ITRM,22,0,22,-22,3,4,2,3,NASDAQ
4594,12-02-2021 12:00,24 hrs.,RobinHoodPennyStocks,IZEA,96,96,0,96,1,35,22,1,NASDAQ
4594,12-02-2021 12:00,24 hrs.,RobinHoodPennyStocks,JFIN,96,96,0,96,1,35,22,1,NASDAQ
4594,12-02-2021 12:00,24 hrs.,RobinHoodPennyStocks,JRJC,96,96,0,96,1,35,22,1,NASDAQ
4594,12-02-2021 12:00,24 hrs.,RobinHoodPennyStocks,KNDI,96,96,0,96,1,35,22,1,NASDAQ
4594,12-02-2021 12:00,24 hrs.,RobinHoodPennyStocks,KTRA,52,34,18,16,4,15,6,3,NASDAQ
4594,12-02-2021 12:00,24 hrs.,RobinHoodPennyStocks,KXIN,96,96,0,96,1,35,22,1,NASDAQ
4594,12-02-2021 12:00,24 hrs.,RobinHoodPennyStocks,LEDS,96,96,0,96,1,35,22,1,NASDAQ
4594,12-02-2021 12:00,24 hrs.,RobinHoodPennyStocks,LIVE,10,0,10,-10,1,0,6,1,NASDAQ
4594,12-02-2021 12:00,24 hrs.,RobinHoodPennyStocks,LKCO,42,6,36,-30,7,7,0,5,NASDAQ
4594,12-02-2021 12:00,24 hrs.,RobinHoodPennyStocks,LLNW,36,0,36,-36,1,9,14,1,NASDAQ
4594,12-02-2021 12:00,24 hrs.,RobinHoodPennyStocks,LMFA,96,96,0,96,1,35,22,1,NASDAQ
4594,12-02-2021 12:00,24 hrs.,RobinHoodPennyStocks,LXEH,96,96,0,96,1,35,22,1,NASDAQ
4594,12-02-2021 12:00,24 hrs.,RobinHoodPennyStocks,MARA,96,96,0,96,1,35,22,1,NASDAQ
4594,12-02-2021 12:00,24 hrs.,RobinHoodPennyStocks,METX,96,96,0,96,1,35,22,1,NASDAQ
4594,12-02-2021 12:00,24 hrs.,RobinHoodPennyStocks,MOGO,96,96,0,96,1,35,22,1,NASDAQ
4594,12-02-2021 12:00,24 hrs.,RobinHoodPennyStocks,MOMO,96,96,0,96,1,35,22,1,NASDAQ
4594,12-02-2021 12:00,24 hrs.,RobinHoodPennyStocks,TXMD,573,43,530,-487,11,148,233,11,NASDAQ
4594,12-02-2021 12:00,24 hrs.,RobinHoodPennyStocks,TYME,13,13,0,13,1,1,7,1,NASDAQ
4594,12-02-2021 12:00,24 hrs.,RobinHoodPennyStocks,UONE,96,96,0,96,1,35,22,1,NASDAQ
4594,12-02-2021 12:00,24 hrs.,RobinHoodPennyStocks,USEG,96,96,0,96,1,35,22,1,NASDAQ
4594,12-02-2021 12:00,24 hrs.,RobinHoodPennyStocks,USWS,12,0,12,-12,2,2,0,2,NASDAQ
4594,12-02-2021 12:00,24 hrs.,RobinHoodPennyStocks,UXIN,96,96,0,96,1,35,22,1,NASDAQ
4594,12-02-2021 12:00,24 hrs.,RobinHoodPennyStocks,VYNE,6,0,6,-6,1,1,0,1,NASDAQ
4594,12-02-2021 12:00,24 hrs.,RobinHoodPennyStocks,WATT,96,96,0,96,1,35,22,1,NASDAQ
4594,12-02-2021 12:00,24 hrs.,RobinHoodPennyStocks,WIMI,96,96,0,96,1,35,22,1,NASDAQ
4594,12-02-2021 12:00,24 hrs.,RobinHoodPennyStocks,WKEY,96,96,0,96,1,35,22,1,NASDAQ
4594,12-02-2021 12:00,24 hrs.,RobinHoodPennyStocks,WRAP,96,96,0,96,1,35,22,1,NASDAQ
4594,12-02-2021 12:00,24 hrs.,RobinHoodPennyStocks,XCUR,67,0,67,-67,1,26,11,1,NASDAQ
4594,12-02-2021 12:00,24 hrs.,RobinHoodPennyStocks,XSPA,34,0,34,-34,1,11,8,1,NASDAQ
4594,12-02-2021 12:00,24 hrs.,RobinHoodPennyStocks,YGMZ,96,96,0,96,1,35,22,1,NASDAQ
4594,12-02-2021 12:00,24 hrs.,RobinHoodPennyStocks,ZSAN,315,48,267,-219,7,77,133,7,NASDAQ
4594,12-02-2021 12:00,24 hrs.,RobinHoodPennyStocks,ZYNE,57,0,57,-57,1,10,33,1,NASDAQ
4594,12-02-2021 12:00,24 hrs.,RobinHoodPennyStocks,UONEK,96,96,0,96,1,35,22,1,NASDAQ
4594,12-02-2021 12:00,24 hrs.,pennystocks,ATOM,6,0,6,-6,1,1,0,1,NASDAQ
4594,12-02-2021 12:00,24 hrs.,pennystocks,ATOS,284,0,284,-284,6,95,70,6,NASDAQ
4594,12-02-2021 12:00,24 hrs.,pennystocks,AVXL,7,0,7,-7,1,1,1,1,NASDAQ
4594,12-02-2021 12:00,24 hrs.,pennystocks,AYTU,6,0,6,-6,1,1,0,1,NASDAQ
4594,12-02-2021 12:00,24 hrs.,pennystocks,AZRX,9,0,9,-9,1,1,3,1,NASDAQ
4594,12-02-2021 12:00,24 hrs.,pennystocks,BBIG,6,6,0,6,1,1,0,1,NASDAQ
4594,12-02-2021 12:00,24 hrs.,pennystocks,BEEM,47,0,47,-47,1,16,11,1,NASDAQ
4594,12-02-2021 12:00,24 hrs.,pennystocks,BHTG,19,0,19,-19,2,1,9,1,NASDAQ
4594,12-02-2021 12:00,24 hrs.,pennystocks,BKEP,16,16,0,16,1,4,4,1,NASDAQ
4594,12-02-2021 12:00,24 hrs.,pennystocks,BLCM,48,0,48,-48,1,20,4,1,NASDAQ
4594,12-02-2021 12:00,24 hrs.,pennystocks,BLUE,6,0,6,-6,1,1,0,1,NASDAQ
4594,12-02-2021 12:00,24 hrs.,pennystocks,BNGO,21,0,21,-21,1,8,1,1,NASDAQ
4594,12-02-2021 12:00,24 hrs.,pennystocks,BOXL,21,0,21,-21,1,8,1,1,NASDAQ
4594,12-02-2021 12:00,24 hrs.,pennystocks,BPTH,31,0,31,-31,1,5,17,1,NASDAQ
4594,12-02-2021 12:00,24 hrs.,pennystocks,BRQS,60,0,60,-60,1,20,16,1,NASDAQ
4594,12-02-2021 12:00,24 hrs.,pennystocks,BVXV,7,0,7,-7,1,1,1,1,NASDAQ
4594,12-02-2021 12:00,24 hrs.,pennystocks,CAPR,6,0,6,-6,1,1,0,1,NASDAQ
4594,12-02-2021 12:00,24 hrs.,pennystocks,CIDM,13,0,13,-13,2,2,1,2,NASDAQ
4594,12-02-2021 12:00,24 hrs.,pennystocks,CJJD,48,0,48,-48,1,20,4,1,NASDAQ
4594,12-02-2021 12:00,24 hrs.,pennystocks,CKPT,60,6,54,-48,3,22,4,3,NASDAQ
4594,12-02-2021 12:00,24 hrs.,pennystocks,CLBS,7,0,7,-7,1,1,1,1,NASDAQ
4594,12-02-2021 12:00,24 hrs.,pennystocks,CLRB,6,0,6,-6,1,1,0,1,NASDAQ
4594,12-02-2021 12:00,24 hrs.,pennystocks,CMPS,331,125,206,-81,3,138,43,3,NASDAQ
4594,12-02-2021 12:00,24 hrs.,pennystocks,CNET,13,0,13,-13,1,3,3,1,NASDAQ
4594,12-02-2021 12:00,24 hrs.,pennystocks,CRBP,154,0,154,-154,2,59,28,2,NASDAQ
4594,12-02-2021 12:00,24 hrs.,pennystocks,CRSR,48,0,48,-48,1,12,20,1,NASDAQ
4594,12-02-2021 12:00,24 hrs.,pennystocks,CTRM,822,73,749,-676,29,271,164,22,NASDAQ
4594,12-02-2021 12:00,24 hrs.,pennystocks,CTXR,6,0,6,-6,1,1,0,1,NASDAQ
4594,12-02-2021 12:00,24 hrs.,pennystocks,DFFN,20,20,0,20,1,7,2,1,NASDAQ
4594,12-02-2021 12:00,24 hrs.,pennystocks,DGLY,35,0,35,-35,5,5,5,1,NASDAQ
4594,12-02-2021 12:00,24 hrs.,pennystocks,DYNT,48,0,48,-48,1,20,4,1,NASDAQ
4594,12-02-2021 12:00,24 hrs.,pennystocks,EBON,6,0,6,-6,1,1,0,1,NASDAQ
4594,12-02-2021 12:00,24 hrs.,pennystocks,EDIT,1524,0,1524,-1524,3,635,242,3,NASDAQ
4594,12-02-2021 12:00,24 hrs.,pennystocks,ENPH,80,80,0,80,1,12,52,1,NASDAQ
4594,12-02-2021 12:00,24 hrs.,pennystocks,EVFM,12,6,6,0,2,2,0,2,NASDAQ
4594,12-02-2021 12:00,24 hrs.,pennystocks,FCEL,80,80,0,80,1,12,52,1,NASDAQ
4594,12-02-2021 12:00,24 hrs.,pennystocks,FIVE,125,125,0,125,1,53,15,1,NASDAQ
4594,12-02-2021 12:00,24 hrs.,pennystocks,GEVO,63,63,0,63,3,16,19,2,NASDAQ
4594,12-02-2021 12:00,24 hrs.,pennystocks,GHSI,106,6,100,-94,2,39,20,2,NASDAQ
4594,12-02-2021 12:00,24 hrs.,pennystocks,GLBS,18,0,18,-18,1,0,14,1,NASDAQ
4594,12-02-2021 12:00,24 hrs.,pennystocks,GNLN,7,0,7,-7,1,1,1,1,NASDAQ
4594,12-02-2021 12:00,24 hrs.,pennystocks,GOLD,12,0,12,-12,2,2,0,2,NASDAQ
4594,12-02-2021 12:00,24 hrs.,pennystocks,GRIL,44,38,6,32,2,13,10,2,NASDAQ
4594,12-02-2021 12:00,24 hrs.,pennystocks,GRNQ,48,0,48,-48,1,20,4,1,NASDAQ
4594,12-02-2021 12:00,24 hrs.,pennystocks,HALO,12,6,6,0,2,2,0,2,NASDAQ
4594,12-02-2021 12:00,24 hrs.,pennystocks,HJLI,15,0,15,-15,1,4,3,1,NASDAQ
4594,12-02-2021 12:00,24 hrs.,pennystocks,HSTO,6,6,0,6,1,1,0,1,NASDAQ
4594,12-02-2021 12:00,24 hrs.,pennystocks,PPBT,10,10,0,10,1,2,2,1,NASDAQ
4594,12-02-2021 12:00,24 hrs.,pennystocks,PRQR,26,0,26,-26,2,5,8,1,NASDAQ
4594,12-02-2021 12:00,24 hrs.,pennystocks,PSTV,65,53,12,41,4,20,9,4,NASDAQ
4594,12-02-2021 12:00,24 hrs.,pennystocks,PULM,845,0,845,-845,4,338,153,4,NASDAQ
4594,12-02-2021 12:00,24 hrs.,pennystocks,RAVE,38,38,0,38,1,12,10,1,NASDAQ
4594,12-02-2021 12:00,24 hrs.,pennystocks,RCMT,31,0,31,-31,1,5,17,1,NASDAQ
4594,12-02-2021 12:00,24 hrs.,pennystocks,RDHL,15,0,15,-15,1,4,3,1,NASDAQ
4594,12-02-2021 12:00,24 hrs.,pennystocks,REAL,113,38,75,-37,3,23,55,3,NASDAQ
4594,12-02-2021 12:00,24 hrs.,pennystocks,RIDE,48,0,48,-48,1,16,12,1,NASDAQ
4594,12-02-2021 12:00,24 hrs.,pennystocks,RIGL,12,12,0,12,2,2,0,2,NASDAQ
4594,12-02-2021 12:00,24 hrs.,pennystocks,RIOT,9,9,0,9,1,0,5,1,NASDAQ
4594,12-02-2021 12:00,24 hrs.,pennystocks,RMTI,54,6,48,-42,2,13,20,2,NASDAQ
4594,12-02-2021 12:00,24 hrs.,pennystocks,SEAC,12,12,0,12,1,2,4,1,NASDAQ
4594,12-02-2021 12:00,24 hrs.,pennystocks,SEEL,200,0,200,-200,1,84,28,1,NASDAQ
4594,12-02-2021 12:00,24 hrs.,pennystocks,SHIP,22,6,16,-10,3,4,2,3,NASDAQ
4594,12-02-2021 12:00,24 hrs.,pennystocks,SNCA,6,0,6,-6,1,1,0,1,NASDAQ
4594,12-02-2021 12:00,24 hrs.,pennystocks,SNDL,358,38,320,-282,50,70,18,40,NASDAQ
4594,12-02-2021 12:00,24 hrs.,pennystocks,SNGX,3742,31,3711,-3680,5,1579,564,3,NASDAQ
4594,12-02-2021 12:00,24 hrs.,pennystocks,SRGA,14,0,14,-14,1,4,2,1,NASDAQ
4594,12-02-2021 12:00,24 hrs.,pennystocks,SXTC,20,0,20,-20,3,2,4,2,NASDAQ
4594,12-02-2021 12:00,24 hrs.,pennystocks,TBLT,6,0,6,-6,1,1,0,1,NASDAQ
4594,12-02-2021 12:00,24 hrs.,pennystocks,TELL,28,0,28,-28,1,8,8,1,NASDAQ
4594,12-02-2021 12:00,24 hrs.,pennystocks,TLRY,70,7,63,-56,3,26,6,3,NASDAQ
4594,12-02-2021 12:00,24 hrs.,pennystocks,TMDI,27,6,21,-15,2,9,1,2,NASDAQ
4594,12-02-2021 12:00,24 hrs.,pennystocks,TNXP,1881,173,1708,-1535,18,766,277,15,NASDAQ
4594,12-02-2021 12:00,24 hrs.,pennystocks,TRCH,24,0,24,-24,4,4,0,2,NASDAQ
4594,12-02-2021 12:00,24 hrs.,pennystocks,TRIP,200,0,200,-200,1,84,28,1,NASDAQ
4594,12-02-2021 12:00,24 hrs.,pennystocks,TSLA,6,6,0,6,1,1,0,1,NASDAQ
4594,12-02-2021 12:00,24 hrs.,pennystocks,TTWO,6,0,6,-6,1,1,0,1,NASDAQ
4594,12-02-2021 12:00,24 hrs.,pennystocks,TXMD,54,0,54,-54,2,13,20,2,NASDAQ
4594,12-02-2021 12:00,24 hrs.,pennystocks,TYME,48,0,48,-48,1,12,20,1,NASDAQ
4594,12-02-2021 12:00,24 hrs.,pennystocks,USWS,12,6,6,0,2,2,0,2,NASDAQ
4594,12-02-2021 12:00,24 hrs.,pennystocks,VRME,23,23,0,23,1,7,5,1,NASDAQ
4594,12-02-2021 12:00,24 hrs.,pennystocks,VTVT,7,0,7,-7,1,1,1,1,NASDAQ
4594,12-02-2021 12:00,24 hrs.,pennystocks,WTER,26,0,26,-26,1,3,16,1,NASDAQ
4594,12-02-2021 12:00,24 hrs.,pennystocks,WTRH,73,38,35,3,2,24,17,2,NASDAQ
4594,12-02-2021 12:00,24 hrs.,pennystocks,XCUR,6,0,6,-6,1,1,0,1,NASDAQ
4594,12-02-2021 12:00,24 hrs.,pennystocks,XELA,38,38,0,38,1,12,10,1,NASDAQ
4594,12-02-2021 12:00,24 hrs.,pennystocks,XERS,6,0,6,-6,1,1,0,1,NASDAQ
4594,12-02-2021 12:00,24 hrs.,pennystocks,XSPA,8,0,8,-8,1,2,0,1,NASDAQ
4594,12-02-2021 12:00,24 hrs.,pennystocks,ZSAN,203,12,191,-179,8,57,57,8,NASDAQ
4594,12-02-2021 12:00,24 hrs.,pennystocks,ZYNE,48,0,48,-48,1,20,4,1,NASDAQ
4594,12-02-2021 12:00,24 hrs.,pennystocks,SGAMW,47,0,47,-47,1,17,9,1,NASDAQ
4594,12-02-2021 12:00,24 hrs.,wallstreetbets,AABB,6,0,6,-6,1,1,0,1,OTC
4594,12-02-2021 12:00,24 hrs.,wallstreetbets,ABML,32,20,12,8,5,5,2,5,OTC
4594,12-02-2021 12:00,24 hrs.,wallstreetbets,ABQQ,7,7,0,7,1,1,1,1,OTC
4594,12-02-2021 12:00,24 hrs.,wallstreetbets,ABWN,6,0,6,-6,1,1,0,1,OTC
4594,12-02-2021 12:00,24 hrs.,wallstreetbets,ADTM,6,0,6,-6,1,1,0,1,OTC
4594,12-02-2021 12:00,24 hrs.,wallstreetbets,AEGY,6,0,6,-6,1,1,0,1,OTC
4594,12-02-2021 12:00,24 hrs.,pennystocks,MNDO,6,0,6,-6,1,1,0,1,NASDAQ
4594,12-02-2021 12:00,24 hrs.,pennystocks,MOGO,28,0,28,-28,3,2,12,1,NASDAQ
4594,12-02-2021 12:00,24 hrs.,pennystocks,MOSY,48,0,48,-48,1,20,4,1,NASDAQ
4594,12-02-2021 12:00,24 hrs.,pennystocks,MOTS,28,0,28,-28,2,9,2,2,NASDAQ
4594,12-02-2021 12:00,24 hrs.,pennystocks,MTRX,8,8,0,8,1,1,2,1,NASDAQ
4594,12-02-2021 12:00,24 hrs.,RobinHoodPennyStocks,TANH,96,96,0,96,1,35,22,1,NASDAQ
4594,12-02-2021 12:00,24 hrs.,RobinHoodPennyStocks,TAOP,96,96,0,96,1,35,22,1,NASDAQ
4594,12-02-2021 12:00,24 hrs.,RobinHoodPennyStocks,TEDU,96,96,0,96,1,35,22,1,NASDAQ
4594,12-02-2021 12:00,24 hrs.,RobinHoodPennyStocks,TIGR,96,96,0,96,1,35,22,1,NASDAQ
4594,12-02-2021 12:00,24 hrs.,RobinHoodPennyStocks,TLRY,35,0,35,-35,4,8,3,2,NASDAQ
4594,12-02-2021 12:00,24 hrs.,RobinHoodPennyStocks,TNXP,568,216,352,-136,9,211,110,8,NASDAQ
4594,12-02-2021 12:00,24 hrs.,RobinHoodPennyStocks,TRCH,302,96,206,-110,6,94,90,5,NASDAQ
4594,12-02-2021 12:00,24 hrs.,RobinHoodPennyStocks,TRIL,6,0,6,-6,1,1,0,1,NASDAQ
4594,12-02-2021 12:00,24 hrs.,RobinHoodPennyStocks,TRVN,6,0,6,-6,1,1,0,1,NASDAQ
4594,12-02-2021 12:00,24 hrs.,RobinHoodPennyStocks,TTOO,23,0,23,-23,1,7,5,1,NASDAQ
4594,12-02-2021 12:00,24 hrs.,wallstreetbets,CBDL,50,0,50,-50,8,8,2,7,OTC
4594,12-02-2021 12:00,24 hrs.,wallstreetbets,CBGI,12,0,12,-12,2,2,0,1,OTC
4594,12-02-2021 12:00,24 hrs.,wallstreetbets,CBTC,6,0,6,-6,1,1,0,1,OTC
4594,12-02-2021 12:00,24 hrs.,wallstreetbets,CCTL,12,6,6,0,2,2,0,2,OTC
4594,12-02-2021 12:00,24 hrs.,wallstreetbets,CGEI,7,7,0,7,1,1,1,1,OTC
4594,12-02-2021 12:00,24 hrs.,wallstreetbets,CHUC,7,7,0,7,1,1,1,1,OTC
4594,12-02-2021 12:00,24 hrs.,wallstreetbets,CLIS,6,0,6,-6,1,1,0,1,OTC
4594,12-02-2021 12:00,24 hrs.,wallstreetbets,CLSH,13,0,13,-13,2,2,1,2,OTC
4594,12-02-2021 12:00,24 hrs.,wallstreetbets,CNNA,12,0,12,-12,2,2,0,1,OTC
4594,12-02-2021 12:00,24 hrs.,wallstreetbets,CNXS,6,0,6,-6,1,1,0,1,OTC
4594,12-02-2021 12:00,24 hrs.,wallstreetbets,CVSI,6,0,6,-6,1,1,0,1,OTC
4594,12-02-2021 12:00,24 hrs.,wallstreetbets,CYDY,7,0,7,-7,1,1,1,1,OTC
4594,12-02-2021 12:00,24 hrs.,wallstreetbets,CYLC,6,0,6,-6,1,1,0,1,OTC
4594,12-02-2021 12:00,24 hrs.,wallstreetbets,DIGI,14,14,0,14,2,2,2,1,OTC
4594,12-02-2021 12:00,24 hrs.,wallstreetbets,DROP,2487,0,2487,-2487,1,810,863,1,OTC
4594,12-02-2021 12:00,24 hrs.,wallstreetbets,DTST,12,0,12,-12,2,2,0,1,OTC
4594,12-02-2021 12:00,24 hrs.,wallstreetbets,DWOG,7,7,0,7,1,1,1,1,OTC
4594,12-02-2021 12:00,24 hrs.,wallstreetbets,ECEZ,18,0,18,-18,3,3,0,3,OTC
4594,12-02-2021 12:00,24 hrs.,wallstreetbets,EDXC,6,0,6,-6,1,1,0,1,OTC
4594,12-02-2021 12:00,24 hrs.,wallstreetbets,EFLN,6,0,6,-6,1,1,0,1,OTC
4594,12-02-2021 12:00,24 hrs.,wallstreetbets,ELCR,46,21,25,-4,7,7,4,5,OTC
4594,12-02-2021 12:00,24 hrs.,wallstreetbets,ENDO,6,0,6,-6,1,1,0,1,OTC
4594,12-02-2021 12:00,24 hrs.,wallstreetbets,ERBB,36,0,36,-36,6,6,0,6,OTC
4594,12-02-2021 12:00,24 hrs.,wallstreetbets,ETFM,6,6,0,6,1,1,0,1,OTC
4594,12-02-2021 12:00,24 hrs.,wallstreetbets,EWLL,12,0,12,-12,2,2,0,2,OTC
4594,12-02-2021 12:00,24 hrs.,wallstreetbets,FBEC,6,0,6,-6,1,1,0,1,OTC
4594,12-02-2021 12:00,24 hrs.,wallstreetbets,FBSE,8,0,8,-8,1,1,2,1,OTC
4594,12-02-2021 12:00,24 hrs.,wallstreetbets,FORW,6,0,6,-6,1,1,0,1,OTC
4594,12-02-2021 12:00,24 hrs.,wallstreetbets,FPVD,6,0,6,-6,1,1,0,1,OTC
4594,12-02-2021 12:00,24 hrs.,wallstreetbets,FTPM,6,0,6,-6,1,1,0,1,OTC
4594,12-02-2021 12:00,24 hrs.,wallstreetbets,FUTL,6,0,6,-6,1,1,0,1,OTC
4594,12-02-2021 12:00,24 hrs.,wallstreetbets,GARB,7,0,7,-7,1,1,1,1,OTC
4594,12-02-2021 12:00,24 hrs.,wallstreetbets,AFTM,12,0,12,-12,2,2,0,1,OTC
4594,12-02-2021 12:00,24 hrs.,wallstreetbets,AGYP,6,0,6,-6,1,1,0,1,OTC
4594,12-02-2021 12:00,24 hrs.,wallstreetbets,AHFD,7,0,7,-7,1,1,1,1,OTC
4594,12-02-2021 12:00,24 hrs.,wallstreetbets,AITX,50,14,36,-22,8,8,2,8,OTC
4594,12-02-2021 12:00,24 hrs.,wallstreetbets,ALKM,12,0,12,-12,2,2,0,2,OTC
4594,12-02-2021 12:00,24 hrs.,wallstreetbets,ALPP,12,0,12,-12,2,2,0,2,OTC
4594,12-02-2021 12:00,24 hrs.,wallstreetbets,ALYI,13,7,6,1,2,2,1,2,OTC
4594,12-02-2021 12:00,24 hrs.,wallstreetbets,AMMJ,6,0,6,-6,1,1,0,1,OTC
4594,12-02-2021 12:00,24 hrs.,wallstreetbets,AMNE,6,0,6,-6,1,1,0,1,OTC
4594,12-02-2021 12:00,24 hrs.,wallstreetbets,ANDD,6,0,6,-6,1,1,0,1,OTC
4594,12-02-2021 12:00,24 hrs.,wallstreetbets,ANTI,13,0,13,-13,2,2,1,2,OTC
4594,12-02-2021 12:00,24 hrs.,wallstreetbets,APRU,19,0,19,-19,3,3,1,1,OTC
4594,12-02-2021 12:00,24 hrs.,wallstreetbets,ASTI,30,0,30,-30,5,5,0,3,OTC
4594,12-02-2021 12:00,24 hrs.,wallstreetbets,AZFL,6,0,6,-6,1,1,0,1,OTC
4594,12-02-2021 12:00,24 hrs.,wallstreetbets,BBRW,12,6,6,0,2,2,0,2,OTC
4594,12-02-2021 12:00,24 hrs.,wallstreetbets,BCAP,24,0,24,-24,4,4,0,2,OTC
4594,12-02-2021 12:00,24 hrs.,wallstreetbets,BCCI,14,0,14,-14,2,2,2,1,OTC
4594,12-02-2021 12:00,24 hrs.,pennystocks,MVIS,54,6,48,-42,2,21,4,2,NASDAQ
4594,12-02-2021 12:00,24 hrs.,pennystocks,NAKD,85,6,79,-73,7,22,13,7,NASDAQ
4594,12-02-2021 12:00,24 hrs.,pennystocks,NEOS,6,0,6,-6,1,1,0,1,NASDAQ
4594,12-02-2021 12:00,24 hrs.,pennystocks,NOVN,58,0,58,-58,4,16,10,4,NASDAQ
4594,12-02-2021 12:00,24 hrs.,pennystocks,NTEC,48,0,48,-48,1,20,4,1,NASDAQ
4594,12-02-2021 12:00,24 hrs.,pennystocks,NVCN,13,0,13,-13,2,2,1,2,NASDAQ
4594,12-02-2021 12:00,24 hrs.,pennystocks,NVIV,6,0,6,-6,1,1,0,1,NASDAQ
4594,12-02-2021 12:00,24 hrs.,pennystocks,NXTD,56,0,56,-56,2,21,6,2,NASDAQ
4594,12-02-2021 12:00,24 hrs.,pennystocks,OCGN,2346,0,2346,-2346,4,1077,176,3,NASDAQ
4594,12-02-2021 12:00,24 hrs.,pennystocks,ONTX,12,6,6,0,2,2,0,2,NASDAQ
4594,12-02-2021 12:00,24 hrs.,pennystocks,PHIO,48,0,48,-48,1,20,4,1,NASDAQ
4594,12-02-2021 12:00,24 hrs.,pennystocks,PHUN,13,0,13,-13,2,2,1,2,NASDAQ
4594,12-02-2021 12:00,24 hrs.,pennystocks,PLUG,127,80,47,33,2,28,63,2,NASDAQ
4594,12-02-2021 12:00,24 hrs.,pennystocks,POAI,7,0,7,-7,1,0,3,1,NASDAQ
4594,12-02-2021 12:00,24 hrs.,pennystocks,POWW,12,0,12,-12,2,1,2,2,NASDAQ
4594,12-02-2021 12:00,24 hrs.,SPACs,CHAQ,217,217,0,217,1,11,191,1,AMEX
4594,12-02-2021 12:00,24 hrs.,SPACs,AMC,13,13,0,13,1,0,9,1,NYSE
4594,12-02-2021 12:00,24 hrs.,SPACs,BFT,217,217,0,217,1,11,191,1,NYSE
4594,12-02-2021 12:00,24 hrs.,SPACs,CCX,7,0,7,-7,1,1,1,1,NYSE
4594,12-02-2021 12:00,24 hrs.,SPACs,CLA,20,0,20,-20,1,6,4,1,NYSE
4594,12-02-2021 12:00,24 hrs.,SPACs,COO,32,0,32,-32,1,9,10,1,NYSE
4594,12-02-2021 12:00,24 hrs.,SPACs,GIK,35,29,6,23,5,3,9,3,NYSE
4594,12-02-2021 12:00,24 hrs.,SPACs,GME,204,13,191,-178,2,59,78,2,NYSE
4594,12-02-2021 12:00,24 hrs.,SPACs,HLF,191,0,191,-191,1,59,69,1,NYSE
4594,12-02-2021 12:00,24 hrs.,SPACs,IPV,217,217,0,217,1,11,191,1,NYSE
4594,12-02-2021 12:00,24 hrs.,wallstreetbets,GAXY,18,0,18,-18,3,3,0,3,OTC
4594,12-02-2021 12:00,24 hrs.,wallstreetbets,GBLX,6,0,6,-6,1,1,0,1,OTC
4594,12-02-2021 12:00,24 hrs.,wallstreetbets,GFCI,693,0,693,-693,1,268,153,1,OTC
4594,12-02-2021 12:00,24 hrs.,wallstreetbets,GMER,12,0,12,-12,2,2,0,1,OTC
4594,12-02-2021 12:00,24 hrs.,wallstreetbets,GPFT,15,7,8,-1,2,2,3,2,OTC
4594,12-02-2021 12:00,24 hrs.,wallstreetbets,GRCU,6,0,6,-6,1,1,0,1,OTC
4594,12-02-2021 12:00,24 hrs.,wallstreetbets,GRNH,24,6,18,-12,4,4,0,4,OTC
4594,12-02-2021 12:00,24 hrs.,wallstreetbets,GTBP,6,0,6,-6,1,1,0,1,OTC
4594,12-02-2021 12:00,24 hrs.,wallstreetbets,GTEH,24,0,24,-24,3,5,2,3,OTC
4594,12-02-2021 12:00,24 hrs.,wallstreetbets,GTII,1044,1044,0,1044,1,368,304,1,OTC
4594,12-02-2021 12:00,24 hrs.,wallstreetbets,GTLL,7,7,0,7,1,1,1,1,OTC
4594,12-02-2021 12:00,24 hrs.,wallstreetbets,GTXO,6,0,6,-6,1,1,0,1,OTC
4594,12-02-2021 12:00,24 hrs.,wallstreetbets,GYOG,18,0,18,-18,3,3,0,1,OTC
4594,12-02-2021 12:00,24 hrs.,wallstreetbets,HCMC,544,114,430,-316,87,88,20,79,OTC
4594,12-02-2021 12:00,24 hrs.,wallstreetbets,HEMP,36,0,36,-36,6,6,0,5,OTC
4594,12-02-2021 12:00,24 hrs.,wallstreetbets,HESG,6,0,6,-6,1,1,0,1,OTC
4594,12-02-2021 12:00,24 hrs.,wallstreetbets,HIPH,14,14,0,14,2,2,2,2,OTC
4594,12-02-2021 12:00,24 hrs.,wallstreetbets,HMNY,63,20,43,-23,10,10,3,9,OTC
4594,12-02-2021 12:00,24 hrs.,wallstreetbets,HMPQ,12,0,12,-12,2,2,0,2,OTC
4594,12-02-2021 12:00,24 hrs.,wallstreetbets,HPTY,22,0,22,-22,2,6,2,1,OTC
4594,12-02-2021 12:00,24 hrs.,wallstreetbets,HQGE,7,0,7,-7,1,1,1,1,OTC
4594,12-02-2021 12:00,24 hrs.,wallstreetbets,HYSR,12,6,6,0,2,2,0,2,OTC
4594,12-02-2021 12:00,24 hrs.,wallstreetbets,ICCT,12,0,12,-12,2,2,0,1,OTC
4594,12-02-2021 12:00,24 hrs.,wallstreetbets,IGXT,6,0,6,-6,1,1,0,1,OTC
4594,12-02-2021 12:00,24 hrs.,wallstreetbets,IINX,12,0,12,-12,2,2,0,1,OTC
4594,12-02-2021 12:00,24 hrs.,wallstreetbets,INCT,26,0,26,-26,4,4,2,2,OTC
4594,12-02-2021 12:00,24 hrs.,wallstreetbets,INKW,6,0,6,-6,1,1,0,1,OTC
4594,12-02-2021 12:00,24 hrs.,wallstreetbets,INND,13,6,7,-1,2,2,1,2,OTC
4594,12-02-2021 12:00,24 hrs.,wallstreetbets,INQD,6,0,6,-6,1,1,0,1,OTC
4594,12-02-2021 12:00,24 hrs.,wallstreetbets,IPKL,6,0,6,-6,1,1,0,1,OTC
4594,12-02-2021 12:00,24 hrs.,wallstreetbets,IQST,18,0,18,-18,3,3,0,3,OTC
4594,12-02-2021 12:00,24 hrs.,wallstreetbets,ISWH,6,0,6,-6,1,1,0,1,OTC
4594,12-02-2021 12:00,24 hrs.,wallstreetbets,KBLB,12,0,12,-12,2,2,0,2,OTC
4594,12-02-2021 12:00,24 hrs.,wallstreetbets,KGET,6,0,6,-6,1,1,0,1,OTC
4594,12-02-2021 12:00,24 hrs.,wallstreetbets,KGKG,7,7,0,7,1,1,1,1,OTC
4594,12-02-2021 12:00,24 hrs.,wallstreetbets,KRFG,7,7,0,7,1,1,1,1,OTC
4594,12-02-2021 12:00,24 hrs.,wallstreetbets,BFCH,19,0,19,-19,3,3,1,3,OTC
4594,12-02-2021 12:00,24 hrs.,wallstreetbets,BFRE,6,0,6,-6,1,1,0,1,OTC
4594,12-02-2021 12:00,24 hrs.,wallstreetbets,BIEL,43,19,24,-5,7,7,1,6,OTC
4594,12-02-2021 12:00,24 hrs.,wallstreetbets,BIGG,6,6,0,6,1,1,0,1,OTC
4594,12-02-2021 12:00,24 hrs.,wallstreetbets,BLDV,18,0,18,-18,3,3,0,2,OTC
4594,12-02-2021 12:00,24 hrs.,wallstreetbets,BLPG,7,0,7,-7,1,1,1,1,OTC
4594,12-02-2021 12:00,24 hrs.,wallstreetbets,BLSP,14,0,14,-14,2,2,2,1,OTC
4594,12-02-2021 12:00,24 hrs.,wallstreetbets,BMIX,11,11,0,11,1,1,5,1,OTC
4594,12-02-2021 12:00,24 hrs.,wallstreetbets,BOTY,37,6,31,-25,6,6,1,5,OTC
4594,12-02-2021 12:00,24 hrs.,wallstreetbets,BRLL,12,0,12,-12,2,2,0,2,OTC
4594,12-02-2021 12:00,24 hrs.,wallstreetbets,BRTX,6,0,6,-6,1,1,0,1,OTC
4594,12-02-2021 12:00,24 hrs.,wallstreetbets,BTCY,6,0,6,-6,1,1,0,1,OTC
4594,12-02-2021 12:00,24 hrs.,wallstreetbets,BUDZ,6,0,6,-6,1,1,0,1,OTC
4594,12-02-2021 12:00,24 hrs.,wallstreetbets,CALI,6,0,6,-6,1,1,0,1,OTC
4594,12-02-2021 12:00,24 hrs.,wallstreetbets,CANN,6,0,6,-6,1,1,0,1,OTC
4594,12-02-2021 12:00,24 hrs.,wallstreetbets,CAPC,6,0,6,-6,1,1,0,1,OTC
4594,12-02-2021 12:00,24 hrs.,wallstreetbets,CATV,6,0,6,-6,1,1,0,1,OTC
4594,12-02-2021 12:00,24 hrs.,wallstreetbets,CBDD,24,0,24,-24,4,4,0,4,OTC
4594,12-02-2021 12:00,24 hrs.,SPACs,RTP,475,25,450,-425,10,127,181,10,NYSE
4594,12-02-2021 12:00,24 hrs.,SPACs,SBE,694,223,471,-248,12,181,284,10,NYSE
4594,12-02-2021 12:00,24 hrs.,SPACs,WPF,6,0,6,-6,1,1,0,1,NYSE
4594,12-02-2021 12:00,24 hrs.,SPACs,ACIC,236,217,19,198,3,11,202,3,NYSE
4594,12-02-2021 12:00,24 hrs.,SPACs,ASPL,6,6,0,6,1,1,0,1,NYSE
4594,12-02-2021 12:00,24 hrs.,SPACs,AVAN,6,0,6,-6,1,1,0,1,NYSE
4594,12-02-2021 12:00,24 hrs.,SPACs,CCAC,64,0,64,-64,3,11,30,2,NYSE
4594,12-02-2021 12:00,24 hrs.,SPACs,CCIV,1806,273,1533,-1260,16,572,598,15,NYSE
4594,12-02-2021 12:00,24 hrs.,SPACs,CLII,47,8,39,-31,3,12,11,3,NYSE
4594,12-02-2021 12:00,24 hrs.,SPACs,DMYD,269,269,0,269,2,20,221,2,NYSE
4594,12-02-2021 12:00,24 hrs.,SPACs,FAII,7,0,7,-7,1,1,1,1,NYSE
4594,12-02-2021 12:00,24 hrs.,SPACs,FUSE,148,0,148,-148,1,56,32,1,NYSE
4594,12-02-2021 12:00,24 hrs.,SPACs,GSAH,52,52,0,52,1,9,30,1,NYSE
4594,12-02-2021 12:00,24 hrs.,SPACs,HYLN,6,0,6,-6,1,1,0,1,NYSE
4594,12-02-2021 12:00,24 hrs.,SPACs,IPOC,181,0,181,-181,1,74,29,1,NYSE
4594,12-02-2021 12:00,24 hrs.,SPACs,IPOD,181,0,181,-181,1,74,29,1,NYSE
4594,12-02-2021 12:00,24 hrs.,SPACs,IPOE,1077,223,854,-631,5,333,391,5,NYSE
4594,12-02-2021 12:00,24 hrs.,SPACs,IPOF,181,0,181,-181,1,74,29,1,NYSE
4594,12-02-2021 12:00,24 hrs.,SPACs,LGVW,49,49,0,49,3,12,13,2,NYSE
4594,12-02-2021 12:00,24 hrs.,SPACs,SCPE,217,217,0,217,1,11,191,1,NYSE
4594,12-02-2021 12:00,24 hrs.,SPACs,SCVX,131,0,131,-131,2,44,35,2,NYSE
4594,12-02-2021 12:00,24 hrs.,SPACs,SKLZ,101,101,0,101,1,32,33,1,NYSE
4594,12-02-2021 12:00,24 hrs.,SPACs,SNPR,251,223,28,195,6,16,195,5,NYSE
4594,12-02-2021 12:00,24 hrs.,SPACs,SPCE,188,7,181,-174,2,75,30,2,NYSE
4594,12-02-2021 12:00,24 hrs.,SPACs,SPNV,23,0,23,-23,1,6,7,1,NYSE
4594,12-02-2021 12:00,24 hrs.,SPACs,TWND,13,0,13,-13,2,2,1,1,NYSE
4594,12-02-2021 12:00,24 hrs.,SPACs,VYGG,217,217,0,217,1,11,191,1,NYSE
4594,12-02-2021 12:00,24 hrs.,SPACs,ADV,217,217,0,217,1,11,191,1,NASDAQ
4594,12-02-2021 12:00,24 hrs.,SPACs,ESG,17,17,0,17,1,3,7,1,NASDAQ
4594,12-02-2021 12:00,24 hrs.,SPACs,HOL,224,224,0,224,2,12,192,2,NASDAQ
4594,12-02-2021 12:00,24 hrs.,SPACs,NPA,182,0,182,-182,6,57,44,5,NASDAQ
4594,12-02-2021 12:00,24 hrs.,SPACs,ACAC,101,101,0,101,1,32,33,1,NASDAQ
4594,12-02-2021 12:00,24 hrs.,SPACs,ACEV,395,225,170,55,7,64,239,5,NASDAQ
4594,12-02-2021 12:00,24 hrs.,SPACs,ACTC,181,0,181,-181,1,74,29,1,NASDAQ
4594,12-02-2021 12:00,24 hrs.,SPACs,ANDA,110,110,0,110,1,24,58,1,NASDAQ
4594,12-02-2021 12:00,24 hrs.,SPACs,ARYA,217,217,0,217,1,11,191,1,NASDAQ
4594,12-02-2021 12:00,24 hrs.,SPACs,BRLI,217,217,0,217,1,11,191,1,NASDAQ
4594,12-02-2021 12:00,24 hrs.,SPACs,BTWN,54,54,0,54,2,7,32,2,NASDAQ
4594,12-02-2021 12:00,24 hrs.,SPACs,CELH,110,110,0,110,1,24,58,1,NASDAQ
4594,12-02-2021 12:00,24 hrs.,SPACs,CFII,7,0,7,-7,1,1,1,1,NASDAQ
4594,12-02-2021 12:00,24 hrs.,SPACs,CIIC,11,11,0,11,1,3,1,1,NASDAQ
4594,12-02-2021 12:00,24 hrs.,SPACs,CLVR,8,0,8,-8,1,0,4,1,NASDAQ
4594,12-02-2021 12:00,24 hrs.,wallstreetbets,KWBT,7,7,0,7,1,1,1,1,OTC
4594,12-02-2021 12:00,24 hrs.,wallstreetbets,KYNC,7,7,0,7,1,1,1,1,OTC
4594,12-02-2021 12:00,24 hrs.,wallstreetbets,LBSR,15,0,15,-15,2,3,1,2,OTC
4594,12-02-2021 12:00,24 hrs.,wallstreetbets,LBUY,6,0,6,-6,1,1,0,1,OTC
4594,12-02-2021 12:00,24 hrs.,wallstreetbets,LGIQ,6,0,6,-6,1,1,0,1,OTC
4594,12-02-2021 12:00,24 hrs.,wallstreetbets,LINK,634,0,634,-634,1,249,132,1,OTC
4594,12-02-2021 12:00,24 hrs.,wallstreetbets,LOTE,7,7,0,7,1,1,1,1,OTC
4594,12-02-2021 12:00,24 hrs.,wallstreetbets,LQMT,12,0,12,-12,2,2,0,2,OTC
4594,12-02-2021 12:00,24 hrs.,wallstreetbets,LQWC,6,0,6,-6,1,1,0,1,OTC
4594,12-02-2021 12:00,24 hrs.,wallstreetbets,LSCG,7,7,0,7,1,1,1,1,OTC
4594,12-02-2021 12:00,24 hrs.,wallstreetbets,LTUM,6,6,0,6,1,1,0,1,OTC
4594,12-02-2021 12:00,24 hrs.,wallstreetbets,LUVU,6,0,6,-6,1,1,0,1,OTC
4594,12-02-2021 12:00,24 hrs.,wallstreetbets,LVVV,6,0,6,-6,1,1,0,1,OTC
4594,12-02-2021 12:00,24 hrs.,wallstreetbets,MATN,6,0,6,-6,1,1,0,1,OTC
4594,12-02-2021 12:00,24 hrs.,wallstreetbets,MCOA,18,0,18,-18,3,3,0,3,OTC
4594,12-02-2021 12:00,24 hrs.,wallstreetbets,MGLG,6,0,6,-6,1,1,0,1,OTC
4594,12-02-2021 12:00,24 hrs.,wallstreetbets,MINE,56,20,36,-16,9,9,2,8,OTC
4594,12-02-2021 12:00,24 hrs.,SPACs,CAGR,110,110,0,110,1,24,58,1,OTC
4594,12-02-2021 12:00,24 hrs.,SPACs,SBVRF,37,0,37,-37,1,10,13,1,OTC
4594,12-02-2021 12:00,24 hrs.,SPACs,BGI,29,0,29,-29,1,5,15,1,AMEX
4594,12-02-2021 12:00,24 hrs.,SPACs,CIK,21,0,21,-21,1,2,13,1,AMEX
4594,12-02-2021 12:00,24 hrs.,SPACs,CTO,125,0,125,-125,1,43,35,1,AMEX
4594,12-02-2021 12:00,24 hrs.,wallstreetbets,MOST,12,0,12,-12,2,2,0,2,OTC
4594,12-02-2021 12:00,24 hrs.,wallstreetbets,MRMD,6,0,6,-6,1,1,0,1,OTC
4594,12-02-2021 12:00,24 hrs.,wallstreetbets,MSRT,6,0,6,-6,1,1,0,1,OTC
4594,12-02-2021 12:00,24 hrs.,wallstreetbets,MTVX,15,6,9,-3,2,3,1,2,OTC
4594,12-02-2021 12:00,24 hrs.,wallstreetbets,MYDX,6,0,6,-6,1,1,0,1,OTC
4594,12-02-2021 12:00,24 hrs.,wallstreetbets,NPHC,6,0,6,-6,1,1,0,1,OTC
4594,12-02-2021 12:00,24 hrs.,wallstreetbets,NPTX,14,14,0,14,2,2,2,1,OTC
4594,12-02-2021 12:00,24 hrs.,wallstreetbets,NSPX,6,0,6,-6,1,1,0,1,OTC
4594,12-02-2021 12:00,24 hrs.,wallstreetbets,NUGS,13,0,13,-13,1,4,1,1,OTC
4594,12-02-2021 12:00,24 hrs.,wallstreetbets,NUKK,12,0,12,-12,2,2,0,2,OTC
4594,12-02-2021 12:00,24 hrs.,wallstreetbets,NWPN,19,0,19,-19,3,3,1,2,OTC
4594,12-02-2021 12:00,24 hrs.,wallstreetbets,OPMZ,6,0,6,-6,1,1,0,1,OTC
4594,12-02-2021 12:00,24 hrs.,wallstreetbets,OWCP,12,0,12,-12,2,2,0,2,OTC
4594,12-02-2021 12:00,24 hrs.,wallstreetbets,OZSC,12,0,12,-12,2,2,0,2,OTC
4594,12-02-2021 12:00,24 hrs.,wallstreetbets,PAOG,12,0,12,-12,2,2,0,2,OTC
4594,12-02-2021 12:00,24 hrs.,wallstreetbets,PAPA,6,0,6,-6,1,1,0,1,OTC
4594,12-02-2021 12:00,24 hrs.,wallstreetbets,PASO,6,0,6,-6,1,1,0,1,OTC
4594,12-02-2021 12:00,24 hrs.,wallstreetbets,PDMI,7,7,0,7,1,1,1,1,OTC
4594,12-02-2021 12:00,24 hrs.,wallstreetbets,PERL,6,0,6,-6,1,1,0,1,OTC
4594,12-02-2021 12:00,24 hrs.,wallstreetbets,PFNO,6,0,6,-6,1,1,0,1,OTC
4594,12-02-2021 12:00,24 hrs.,wallstreetbets,PGIE,6,0,6,-6,1,1,0,1,OTC
4594,12-02-2021 12:00,24 hrs.,wallstreetbets,PHIL,6,0,6,-6,1,1,0,1,OTC
4594,12-02-2021 12:00,24 hrs.,wallstreetbets,PHOT,18,0,18,-18,3,3,0,1,OTC
4594,12-02-2021 12:00,24 hrs.,wallstreetbets,PNPL,13,13,0,13,2,2,1,1,OTC
4594,12-02-2021 12:00,24 hrs.,wallstreetbets,POTN,6,0,6,-6,1,1,0,1,OTC
4594,12-02-2021 12:00,24 hrs.,wallstreetbets,PPJE,6,0,6,-6,1,1,0,1,OTC
4594,12-02-2021 12:00,24 hrs.,wallstreetbets,PRDL,6,0,6,-6,1,1,0,1,OTC
4594,12-02-2021 12:00,24 hrs.,wallstreetbets,PRED,7,7,0,7,1,1,1,1,OTC
4594,12-02-2021 12:00,24 hrs.,wallstreetbets,PSYC,30,0,30,-30,5,5,0,3,OTC
4594,12-02-2021 12:00,24 hrs.,wallstreetbets,PTOI,12,0,12,-12,2,2,0,1,OTC
4594,12-02-2021 12:00,24 hrs.,wallstreetbets,PURA,36,0,36,-36,6,6,0,4,OTC
4594,12-02-2021 12:00,24 hrs.,wallstreetbets,PURE,7,7,0,7,1,1,1,1,OTC
4594,12-02-2021 12:00,24 hrs.,wallstreetbets,PVDG,6,0,6,-6,1,1,0,1,OTC
4594,12-02-2021 12:00,24 hrs.,wallstreetbets,PYYX,6,0,6,-6,1,1,0,1,OTC
4594,12-02-2021 12:00,24 hrs.,wallstreetbets,PZOO,6,0,6,-6,1,1,0,1,OTC
4594,12-02-2021 12:00,24 hrs.,wallstreetbets,QEDN,6,0,6,-6,1,1,0,1,OTC
4594,12-02-2021 12:00,24 hrs.,wallstreetbets,QTMM,6,0,6,-6,1,1,0,1,OTC
4594,12-02-2021 12:00,24 hrs.,wallstreetbets,RBNW,13,7,6,1,2,2,1,2,OTC
4594,12-02-2021 12:00,24 hrs.,wallstreetbets,REFG,6,0,6,-6,1,1,0,1,OTC
4594,12-02-2021 12:00,24 hrs.,wallstreetbets,RIGH,7,7,0,7,1,1,1,1,OTC
4594,12-02-2021 12:00,24 hrs.,wallstreetbets,RITE,6,0,6,-6,1,1,0,1,OTC
4594,12-02-2021 12:00,24 hrs.,wallstreetbets,RKLC,6,0,6,-6,1,1,0,1,OTC
4594,12-02-2021 12:00,24 hrs.,wallstreetbets,RLTR,18,0,18,-18,3,3,0,3,OTC
4594,12-02-2021 12:00,24 hrs.,wallstreetbets,RSHN,7,7,0,7,1,1,1,1,OTC
4594,12-02-2021 12:00,24 hrs.,wallstreetbets,RTON,32,13,19,-6,5,5,2,5,OTC
4594,12-02-2021 12:00,24 hrs.,wallstreetbets,RWMI,6,0,6,-6,1,1,0,1,OTC
4594,12-02-2021 12:00,24 hrs.,wallstreetbets,SANP,18,0,18,-18,3,3,0,3,OTC
4594,12-02-2021 12:00,24 hrs.,wallstreetbets,SCNA,14,0,14,-14,2,3,0,2,OTC
4594,12-02-2021 12:00,24 hrs.,wallstreetbets,SFOR,14,14,0,14,2,2,2,1,OTC
4594,12-02-2021 12:00,24 hrs.,wallstreetbets,SGLN,6,0,6,-6,1,1,0,1,OTC
4594,12-02-2021 12:00,24 hrs.,wallstreetbets,SGMD,85,25,60,-35,14,14,1,10,OTC
4594,12-02-2021 12:00,24 hrs.,wallstreetbets,SHMP,25,13,12,1,4,4,1,3,OTC
4594,12-02-2021 12:00,24 hrs.,wallstreetbets,SHRG,6,0,6,-6,1,1,0,1,OTC
4594,12-02-2021 12:00,24 hrs.,wallstreetbets,SHWZ,6,0,6,-6,1,1,0,1,OTC
4594,12-02-2021 12:00,24 hrs.,wallstreetbets,SIGN,19,6,13,-7,3,3,1,3,OTC
4594,12-02-2021 12:00,24 hrs.,wallstreetbets,SING,19,0,19,-19,3,3,1,3,OTC
4594,12-02-2021 12:00,24 hrs.,wallstreetbets,SMVI,12,0,12,-12,2,2,0,1,OTC
4594,12-02-2021 12:00,24 hrs.,wallstreetbets,SNDD,6,0,6,-6,1,1,0,1,OTC
4594,12-02-2021 12:00,24 hrs.,wallstreetbets,SNPW,6,0,6,-6,1,1,0,1,OTC
4594,12-02-2021 12:00,24 hrs.,SPACs,MLM,191,0,191,-191,1,59,69,1,NYSE
4594,12-02-2021 12:00,24 hrs.,SPACs,NAV,428,66,362,-296,6,165,74,5,NYSE
4594,12-02-2021 12:00,24 hrs.,SPACs,NGA,32,23,9,14,4,3,10,3,NYSE
4594,12-02-2021 12:00,24 hrs.,SPACs,RMO,7,0,7,-7,1,1,1,1,NYSE
4594,12-02-2021 12:00,24 hrs.,SPACs,RSI,101,101,0,101,1,32,33,1,NYSE
4594,12-02-2021 12:00,24 hrs.,SPACs,GRNVW,217,217,0,217,1,11,191,1,NASDAQ
4594,12-02-2021 12:00,24 hrs.,SPACs,LACQW,217,217,0,217,1,11,191,1,NASDAQ
4594,12-02-2021 12:00,24 hrs.,SPACs,THBRW,217,217,0,217,1,11,191,1,NASDAQ
4594,12-02-2021 12:00,24 hrs.,SPACs,VSPRW,217,217,0,217,1,11,191,1,NASDAQ
4594,12-02-2021 12:00,24 hrs.,SPACs,ZGYHW,217,217,0,217,1,11,191,1,NASDAQ
4594,12-02-2021 12:00,24 hrs.,stocks,AITX,6,0,6,-6,1,1,0,1,OTC
4594,12-02-2021 12:00,24 hrs.,stocks,ALPP,6,0,6,-6,1,1,0,1,OTC
4594,12-02-2021 12:00,24 hrs.,stocks,APTY,6,6,0,6,1,1,0,1,OTC
4594,12-02-2021 12:00,24 hrs.,stocks,BIEL,6,0,6,-6,1,1,0,1,OTC
4594,12-02-2021 12:00,24 hrs.,stocks,BUDZ,7,0,7,-7,1,1,1,1,OTC
4594,12-02-2021 12:00,24 hrs.,stocks,CAGR,23,23,0,23,1,3,13,1,OTC
4594,12-02-2021 12:00,24 hrs.,stocks,CBDD,6,0,6,-6,1,1,0,1,OTC
4594,12-02-2021 12:00,24 hrs.,stocks,CORG,6,0,6,-6,1,1,0,1,OTC
4594,12-02-2021 12:00,24 hrs.,stocks,CYPW,12,0,12,-12,2,2,0,1,OTC
4594,12-02-2021 12:00,24 hrs.,stocks,DIGI,6,6,0,6,1,1,0,1,OTC
4594,12-02-2021 12:00,24 hrs.,stocks,FNMA,6,6,0,6,1,1,0,1,OTC
4594,12-02-2021 12:00,24 hrs.,stocks,HCMC,85,6,79,-73,7,21,15,6,OTC
4594,12-02-2021 12:00,24 hrs.,stocks,HEMP,6,6,0,6,1,1,0,1,OTC
4594,12-02-2021 12:00,24 hrs.,stocks,KGKG,6,6,0,6,1,1,0,1,OTC
4594,12-02-2021 12:00,24 hrs.,stocks,KYNC,18,18,0,18,3,3,0,1,OTC
4594,12-02-2021 12:00,24 hrs.,stocks,LINK,110,0,110,-110,1,47,12,1,OTC
4594,12-02-2021 12:00,24 hrs.,stocks,MJNA,12,0,12,-12,2,2,0,2,OTC
4594,12-02-2021 12:00,24 hrs.,stocks,MOST,7,0,7,-7,1,1,1,1,OTC
4594,12-02-2021 12:00,24 hrs.,stocks,NTRR,6,0,6,-6,1,1,0,1,OTC
4594,12-02-2021 12:00,24 hrs.,stocks,NTWN,12,0,12,-12,1,4,0,1,OTC
4594,12-02-2021 12:00,24 hrs.,stocks,OPTI,6,0,6,-6,1,1,0,1,OTC
4594,12-02-2021 12:00,24 hrs.,stocks,PURA,6,0,6,-6,1,1,0,1,OTC
4594,12-02-2021 12:00,24 hrs.,stocks,PZOO,6,6,0,6,1,1,0,1,OTC
4594,12-02-2021 12:00,24 hrs.,stocks,SGMD,36,0,36,-36,6,6,0,2,OTC
4594,12-02-2021 12:00,24 hrs.,stocks,SUIC,6,6,0,6,1,1,0,1,OTC
4594,12-02-2021 12:00,24 hrs.,stocks,TSTS,6,0,6,-6,1,1,0,1,OTC
4594,12-02-2021 12:00,24 hrs.,stocks,TZPC,7,0,7,-7,1,1,1,1,OTC
4594,12-02-2021 12:00,24 hrs.,stocks,USPS,68,0,68,-68,3,23,10,2,OTC
4594,12-02-2021 12:00,24 hrs.,stocks,ZAAG,6,0,6,-6,1,1,0,1,OTC
4594,12-02-2021 12:00,24 hrs.,stocks,CBWTF,12,12,0,12,2,2,0,2,OTC
4594,12-02-2021 12:00,24 hrs.,stocks,CURLF,12,0,12,-12,2,2,0,1,OTC
4594,12-02-2021 12:00,24 hrs.,stocks,FLWPF,6,0,6,-6,1,1,0,1,OTC
4594,12-02-2021 12:00,24 hrs.,stocks,GGTTF,6,0,6,-6,1,1,0,1,OTC
4594,12-02-2021 12:00,24 hrs.,stocks,GRUSF,6,0,6,-6,1,1,0,1,OTC
4594,12-02-2021 12:00,24 hrs.,stocks,HITIF,6,0,6,-6,1,1,0,1,OTC
4594,12-02-2021 12:00,24 hrs.,stocks,KONAQ,12,0,12,-12,2,2,0,1,OTC
4594,12-02-2021 12:00,24 hrs.,stocks,LGORF,6,0,6,-6,1,1,0,1,OTC
4594,12-02-2021 12:00,24 hrs.,stocks,MMNFF,12,6,6,0,2,2,0,2,OTC
4594,12-02-2021 12:00,24 hrs.,stocks,PLNHF,56,0,56,-56,1,22,8,1,OTC
4594,12-02-2021 12:00,24 hrs.,SPACs,CMLF,217,217,0,217,1,11,191,1,NASDAQ
4594,12-02-2021 12:00,24 hrs.,SPACs,CONX,46,0,46,-46,1,9,24,1,NASDAQ
4594,12-02-2021 12:00,24 hrs.,SPACs,DCRB,11,11,0,11,1,3,1,1,NASDAQ
4594,12-02-2021 12:00,24 hrs.,SPACs,DFHT,217,217,0,217,1,11,191,1,NASDAQ
4594,12-02-2021 12:00,24 hrs.,SPACs,DGNS,52,52,0,52,1,9,30,1,NASDAQ
4594,12-02-2021 12:00,24 hrs.,SPACs,EDIT,191,0,191,-191,1,59,69,1,NASDAQ
4594,12-02-2021 12:00,24 hrs.,SPACs,FCAC,27,27,0,27,1,9,5,1,NASDAQ
4594,12-02-2021 12:00,24 hrs.,SPACs,FSRV,217,217,0,217,1,11,191,1,NASDAQ
4594,12-02-2021 12:00,24 hrs.,SPACs,FTOC,281,0,281,-281,3,106,57,3,NASDAQ
4594,12-02-2021 12:00,24 hrs.,wallstreetbets,SNRY,6,0,6,-6,1,1,0,1,OTC
4594,12-02-2021 12:00,24 hrs.,wallstreetbets,SRMX,68,14,54,-40,11,11,2,9,OTC
4594,12-02-2021 12:00,24 hrs.,wallstreetbets,SRUP,30,0,30,-30,5,5,0,1,OTC
4594,12-02-2021 12:00,24 hrs.,wallstreetbets,SUGR,8,0,8,-8,1,2,0,1,OTC
4594,12-02-2021 12:00,24 hrs.,wallstreetbets,SUIC,6,0,6,-6,1,1,0,1,OTC
4594,12-02-2021 12:00,24 hrs.,wallstreetbets,SUND,6,0,6,-6,1,1,0,1,OTC
4594,12-02-2021 12:00,24 hrs.,wallstreetbets,MITI,6,0,6,-6,1,1,0,1,OTC
4594,12-02-2021 12:00,24 hrs.,wallstreetbets,MJLB,6,0,6,-6,1,1,0,1,OTC
4594,12-02-2021 12:00,24 hrs.,wallstreetbets,MJNA,165,21,144,-123,27,27,3,23,OTC
4594,12-02-2021 12:00,24 hrs.,wallstreetbets,MMEX,47,28,19,9,7,7,5,5,OTC
4594,12-02-2021 12:00,24 hrs.,wallstreetbets,MMMM,6,0,6,-6,1,1,0,1,OTC
4594,12-02-2021 12:00,24 hrs.,stocks,AMC,151,78,73,5,10,34,43,8,NYSE
4594,12-02-2021 12:00,24 hrs.,wallstreetbets,SVTE,6,0,6,-6,1,1,0,1,OTC
4594,12-02-2021 12:00,24 hrs.,wallstreetbets,TGGI,6,0,6,-6,1,1,0,1,OTC
4594,12-02-2021 12:00,24 hrs.,wallstreetbets,TMRC,6,0,6,-6,1,1,0,1,OTC
4594,12-02-2021 12:00,24 hrs.,wallstreetbets,TRNX,13,7,6,1,2,2,1,2,OTC
4594,12-02-2021 12:00,24 hrs.,wallstreetbets,TRTC,18,0,18,-18,3,3,0,3,OTC
4594,12-02-2021 12:00,24 hrs.,wallstreetbets,TSNP,42,6,36,-30,7,7,0,7,OTC
4594,12-02-2021 12:00,24 hrs.,wallstreetbets,TSTS,6,0,6,-6,1,1,0,1,OTC
4594,12-02-2021 12:00,24 hrs.,wallstreetbets,UATG,12,0,12,-12,2,2,0,1,OTC
4594,12-02-2021 12:00,24 hrs.,wallstreetbets,UNVC,6,0,6,-6,1,1,0,1,OTC
4594,12-02-2021 12:00,24 hrs.,wallstreetbets,UOMO,6,0,6,-6,1,1,0,1,OTC
4594,12-02-2021 12:00,24 hrs.,wallstreetbets,USMJ,12,0,12,-12,2,2,0,2,OTC
4594,12-02-2021 12:00,24 hrs.,wallstreetbets,USPS,88,0,88,-88,3,22,32,2,OTC
4594,12-02-2021 12:00,24 hrs.,wallstreetbets,UVSE,18,0,18,-18,3,3,0,3,OTC
4594,12-02-2021 12:00,24 hrs.,wallstreetbets,VBIO,6,0,6,-6,1,1,0,1,OTC
4594,12-02-2021 12:00,24 hrs.,wallstreetbets,VIBI,12,0,12,-12,2,2,0,2,OTC
4594,12-02-2021 12:00,24 hrs.,wallstreetbets,VPOR,12,0,12,-12,2,2,0,2,OTC
4594,12-02-2021 12:00,24 hrs.,wallstreetbets,VTLR,6,0,6,-6,1,1,0,1,OTC
4594,12-02-2021 12:00,24 hrs.,wallstreetbets,VYST,6,0,6,-6,1,1,0,1,OTC
4594,12-02-2021 12:00,24 hrs.,wallstreetbets,WARM,18,0,18,-18,3,3,0,1,OTC
4594,12-02-2021 12:00,24 hrs.,wallstreetbets,WCVC,6,0,6,-6,1,1,0,1,OTC
4594,12-02-2021 12:00,24 hrs.,wallstreetbets,WDLF,6,0,6,-6,1,1,0,1,OTC
4594,12-02-2021 12:00,24 hrs.,wallstreetbets,WHEN,43,13,30,-17,7,7,1,4,OTC
4594,12-02-2021 12:00,24 hrs.,wallstreetbets,WNDW,6,0,6,-6,1,1,0,1,OTC
4594,12-02-2021 12:00,24 hrs.,wallstreetbets,WSGF,12,0,12,-12,2,2,0,1,OTC
4594,12-02-2021 12:00,24 hrs.,wallstreetbets,YAYO,6,0,6,-6,1,1,0,1,OTC
4594,12-02-2021 12:00,24 hrs.,wallstreetbets,ZNOG,12,0,12,-12,2,2,0,2,OTC
4594,12-02-2021 12:00,24 hrs.,wallstreetbets,ABEPF,19,0,19,-19,3,3,1,3,OTC
4594,12-02-2021 12:00,24 hrs.,wallstreetbets,ACUIF,6,0,6,-6,1,1,0,1,OTC
4594,12-02-2021 12:00,24 hrs.,wallstreetbets,ALEAF,25,0,25,-25,4,4,1,2,OTC
4594,12-02-2021 12:00,24 hrs.,wallstreetbets,ARBKF,7,0,7,-7,1,1,1,1,OTC
4594,12-02-2021 12:00,24 hrs.,wallstreetbets,AYRWF,6,0,6,-6,1,1,0,1,OTC
4594,12-02-2021 12:00,24 hrs.,wallstreetbets,AYTUW,6,0,6,-6,1,1,0,1,OTC
4594,12-02-2021 12:00,24 hrs.,wallstreetbets,AYTUZ,6,0,6,-6,1,1,0,1,OTC
4594,12-02-2021 12:00,24 hrs.,wallstreetbets,BDRBF,92,13,79,-66,11,12,24,11,OTC
4594,12-02-2021 12:00,24 hrs.,wallstreetbets,BHNGF,12,0,12,-12,2,2,0,1,OTC
4594,12-02-2021 12:00,24 hrs.,wallstreetbets,BILZF,24,0,24,-24,4,4,0,3,OTC
4594,12-02-2021 12:00,24 hrs.,wallstreetbets,BITCF,6,0,6,-6,1,1,0,1,OTC
4594,12-02-2021 12:00,24 hrs.,wallstreetbets,BLOZF,6,0,6,-6,1,1,0,1,OTC
4594,12-02-2021 12:00,24 hrs.,wallstreetbets,BUSXF,6,0,6,-6,1,1,0,1,OTC
4594,12-02-2021 12:00,24 hrs.,wallstreetbets,BVNNF,7,0,7,-7,1,1,1,1,OTC
4594,12-02-2021 12:00,24 hrs.,wallstreetbets,CBWTF,33,11,22,-11,5,3,7,5,OTC
4594,12-02-2021 12:00,24 hrs.,wallstreetbets,CCHWF,6,0,6,-6,1,1,0,1,OTC
4594,12-02-2021 12:00,24 hrs.,wallstreetbets,CNABQ,12,0,12,-12,2,2,0,2,OTC
4594,12-02-2021 12:00,24 hrs.,SPACs,GRNV,217,217,0,217,1,11,191,1,NASDAQ
4594,12-02-2021 12:00,24 hrs.,SPACs,JYAC,231,0,231,-231,1,110,7,1,NASDAQ
4594,12-02-2021 12:00,24 hrs.,SPACs,NBAC,22,0,22,-22,1,7,4,1,NASDAQ
4594,12-02-2021 12:00,24 hrs.,SPACs,NGAC,451,0,451,-451,3,197,45,3,NASDAQ
4594,12-02-2021 12:00,24 hrs.,SPACs,PLUG,6,6,0,6,1,1,0,1,NASDAQ
4594,12-02-2021 12:00,24 hrs.,SPACs,QELL,126,126,0,126,2,19,80,2,NASDAQ
4594,12-02-2021 12:00,24 hrs.,SPACs,REAL,191,0,191,-191,1,59,69,1,NASDAQ
4594,12-02-2021 12:00,24 hrs.,SPACs,RIDE,6,6,0,6,1,1,0,1,NASDAQ
4594,12-02-2021 12:00,24 hrs.,SPACs,ROCH,217,217,0,217,1,11,191,1,NASDAQ
4594,12-02-2021 12:00,24 hrs.,SPACs,SGAM,111,0,111,-111,3,38,23,2,NASDAQ
4594,12-02-2021 12:00,24 hrs.,SPACs,THBR,217,217,0,217,1,11,191,1,NASDAQ
4594,12-02-2021 12:00,24 hrs.,SPACs,THCB,30,0,30,-30,4,4,6,4,NASDAQ
4594,12-02-2021 12:00,24 hrs.,SPACs,TLRY,14,0,14,-14,1,0,10,1,NASDAQ
4594,12-02-2021 12:00,24 hrs.,SPACs,TSIA,181,0,181,-181,1,74,29,1,NASDAQ
4594,12-02-2021 12:00,24 hrs.,SPACs,TTCF,110,110,0,110,1,24,58,1,NASDAQ
4594,12-02-2021 12:00,24 hrs.,SPACs,UNIT,21,0,21,-21,1,2,13,1,NASDAQ
4594,12-02-2021 12:00,24 hrs.,SPACs,VMAC,14,14,0,14,2,2,2,1,NASDAQ
4594,12-02-2021 12:00,24 hrs.,SPACs,VSPR,39,39,0,39,1,10,15,1,NASDAQ
4594,12-02-2021 12:00,24 hrs.,SPACs,ACEVW,217,217,0,217,1,11,191,1,NASDAQ
4594,12-02-2021 12:00,24 hrs.,SPACs,DSACW,217,217,0,217,1,11,191,1,NASDAQ
4594,12-02-2021 12:00,24 hrs.,stocks,MGM,19,0,19,-19,1,4,7,1,NYSE
4594,12-02-2021 12:00,24 hrs.,wallstreetbets,CNTTQ,6,0,6,-6,1,1,0,1,OTC
4594,12-02-2021 12:00,24 hrs.,wallstreetbets,CPXGF,6,0,6,-6,1,1,0,1,OTC
4594,12-02-2021 12:00,24 hrs.,wallstreetbets,CRLBF,19,0,19,-19,3,3,1,3,OTC
4594,12-02-2021 12:00,24 hrs.,wallstreetbets,CURLF,654,0,654,-654,2,205,236,2,OTC
4594,12-02-2021 12:00,24 hrs.,wallstreetbets,CXXIF,125,0,125,-125,1,26,69,1,OTC
4594,12-02-2021 12:00,24 hrs.,wallstreetbets,DFLYF,33,33,0,33,3,2,17,2,OTC
4594,12-02-2021 12:00,24 hrs.,wallstreetbets,EHVVF,6,0,6,-6,1,1,0,1,OTC
4594,12-02-2021 12:00,24 hrs.,wallstreetbets,EPWCF,12,0,12,-12,1,0,8,1,OTC
4594,12-02-2021 12:00,24 hrs.,wallstreetbets,FDVRF,6,0,6,-6,1,1,0,1,OTC
4594,12-02-2021 12:00,24 hrs.,wallstreetbets,FGPHF,6,0,6,-6,1,1,0,1,OTC
4594,12-02-2021 12:00,24 hrs.,wallstreetbets,FLOOF,18,0,18,-18,3,3,0,3,OTC
4594,12-02-2021 12:00,24 hrs.,wallstreetbets,FLWPF,13,0,13,-13,2,2,1,2,OTC
4594,12-02-2021 12:00,24 hrs.,wallstreetbets,GAYMF,21,0,21,-21,3,3,3,3,OTC
4594,12-02-2021 12:00,24 hrs.,wallstreetbets,GGTTF,12,0,12,-12,2,2,0,1,OTC
4594,12-02-2021 12:00,24 hrs.,wallstreetbets,GPORQ,6,0,6,-6,1,1,0,1,OTC
4594,12-02-2021 12:00,24 hrs.,wallstreetbets,GTBIF,655,0,655,-655,2,205,237,2,OTC
4594,12-02-2021 12:00,24 hrs.,wallstreetbets,GUESF,6,0,6,-6,1,1,0,1,OTC
4594,12-02-2021 12:00,24 hrs.,wallstreetbets,HITIF,85,0,85,-85,6,17,27,6,OTC
4594,12-02-2021 12:00,24 hrs.,wallstreetbets,HRVOF,6,0,6,-6,1,1,0,1,OTC
4594,12-02-2021 12:00,24 hrs.,wallstreetbets,HRVSF,6,0,6,-6,1,1,0,1,OTC
4594,12-02-2021 12:00,24 hrs.,wallstreetbets,HSTRF,6,0,6,-6,1,1,0,1,OTC
4594,12-02-2021 12:00,24 hrs.,wallstreetbets,HTZGQ,24,0,24,-24,4,4,0,2,OTC
4594,12-02-2021 12:00,24 hrs.,wallstreetbets,HVBTF,13,7,6,1,2,2,1,2,OTC
4594,12-02-2021 12:00,24 hrs.,wallstreetbets,ITHUF,6,0,6,-6,1,1,0,1,OTC
4594,12-02-2021 12:00,24 hrs.,wallstreetbets,JUVAF,6,0,6,-6,1,1,0,1,OTC
4594,12-02-2021 12:00,24 hrs.,wallstreetbets,KPIFF,6,0,6,-6,1,1,0,1,OTC
4594,12-02-2021 12:00,24 hrs.,wallstreetbets,LHSIF,6,0,6,-6,1,1,0,1,OTC
4594,12-02-2021 12:00,24 hrs.,wallstreetbets,LIACF,12,0,12,-12,2,2,0,2,OTC
4594,12-02-2021 12:00,24 hrs.,wallstreetbets,LITOF,6,0,6,-6,1,1,0,1,OTC
4594,12-02-2021 12:00,24 hrs.,wallstreetbets,LKNCY,12,6,6,0,2,2,0,2,OTC
4594,12-02-2021 12:00,24 hrs.,wallstreetbets,LKYSF,7,0,7,-7,1,1,1,1,OTC
4594,12-02-2021 12:00,24 hrs.,wallstreetbets,LLKKF,6,6,0,6,1,1,0,1,OTC
4594,12-02-2021 12:00,24 hrs.,wallstreetbets,LMLLF,6,6,0,6,1,1,0,1,OTC
4594,12-02-2021 12:00,24 hrs.,wallstreetbets,LTMAQ,6,0,6,-6,1,1,0,1,OTC
4594,12-02-2021 12:00,24 hrs.,wallstreetbets,LTMCF,12,6,6,0,2,2,0,2,OTC
4594,12-02-2021 12:00,24 hrs.,wallstreetbets,LXXGF,8,8,0,8,1,1,2,1,OTC
4594,12-02-2021 12:00,24 hrs.,wallstreetbets,MEDIF,6,6,0,6,1,1,0,1,OTC
4594,12-02-2021 12:00,24 hrs.,wallstreetbets,MMEDF,94,40,54,-14,10,22,10,8,OTC
4594,12-02-2021 12:00,24 hrs.,wallstreetbets,MMNFF,43,0,43,-43,7,7,1,6,OTC
4594,12-02-2021 12:00,24 hrs.,wallstreetbets,MNKKQ,14,0,14,-14,2,2,2,1,OTC
4594,12-02-2021 12:00,24 hrs.,wallstreetbets,NMGRF,13,6,7,-1,2,2,1,2,OTC
4594,12-02-2021 12:00,24 hrs.,wallstreetbets,NMHLY,6,0,6,-6,1,1,0,1,OTC
4594,12-02-2021 12:00,24 hrs.,wallstreetbets,NSANY,6,0,6,-6,1,1,0,1,OTC
4594,12-02-2021 12:00,24 hrs.,stocks,RLLCF,6,6,0,6,1,1,0,1,OTC
4594,12-02-2021 12:00,24 hrs.,stocks,RNECY,6,0,6,-6,1,1,0,1,OTC
4594,12-02-2021 12:00,24 hrs.,stocks,SFTBY,20,0,20,-20,1,6,4,1,OTC
4594,12-02-2021 12:00,24 hrs.,stocks,TAKOF,13,0,13,-13,1,3,3,1,OTC
4594,12-02-2021 12:00,24 hrs.,stocks,TGIFF,6,0,6,-6,1,1,0,1,OTC
4594,12-02-2021 12:00,24 hrs.,stocks,VLNCF,6,0,6,-6,1,1,0,1,OTC
4594,12-02-2021 12:00,24 hrs.,stocks,DNN,37,6,31,-25,3,5,15,3,AMEX
4594,12-02-2021 12:00,24 hrs.,stocks,DPW,12,12,0,12,1,3,2,1,AMEX
4594,12-02-2021 12:00,24 hrs.,stocks,GDP,574,23,551,-528,2,216,134,2,AMEX
4594,12-02-2021 12:00,24 hrs.,stocks,MXC,6,6,0,6,1,1,0,1,AMEX
4594,12-02-2021 12:00,24 hrs.,stocks,NAK,6,0,6,-6,1,1,0,1,AMEX
4594,12-02-2021 12:00,24 hrs.,stocks,NBA,551,0,551,-551,1,212,123,1,AMEX
4594,12-02-2021 12:00,24 hrs.,stocks,TRX,47,0,47,-47,2,17,5,2,AMEX
4594,12-02-2021 12:00,24 hrs.,stocks,WYY,6,0,6,-6,1,1,0,1,AMEX
4594,12-02-2021 12:00,24 hrs.,stocks,ZOM,31,18,13,5,5,5,1,5,AMEX
4594,12-02-2021 12:00,24 hrs.,stocks,NSPR,6,0,6,-6,1,1,0,1,AMEX
4594,12-02-2021 12:00,24 hrs.,stocks,TRXC,6,0,6,-6,1,1,0,1,AMEX
4594,12-02-2021 12:00,24 hrs.,stocks,UAVS,6,0,6,-6,1,1,0,1,AMEX
4594,12-02-2021 12:00,24 hrs.,stocks,ACB,70,64,6,58,3,18,22,3,NYSE
4594,12-02-2021 12:00,24 hrs.,stocks,AHT,7,0,7,-7,1,1,1,1,NYSE
4594,12-02-2021 12:00,24 hrs.,stocks,FVRR,17,17,0,17,1,3,7,1,NYSE
4594,12-02-2021 12:00,24 hrs.,stocks,GNRC,110,0,110,-110,1,47,12,1,NYSE
4594,12-02-2021 12:00,24 hrs.,stocks,HUYA,60,24,36,-12,2,15,22,2,NYSE
4594,12-02-2021 12:00,24 hrs.,stocks,HYLN,12,0,12,-12,2,2,0,2,NYSE
4594,12-02-2021 12:00,24 hrs.,stocks,IPOD,7,0,7,-7,1,1,1,1,NYSE
4594,12-02-2021 12:00,24 hrs.,stocks,IPOE,7,0,7,-7,1,1,1,1,NYSE
4594,12-02-2021 12:00,24 hrs.,stocks,IPOF,7,0,7,-7,1,1,1,1,NYSE
4594,12-02-2021 12:00,24 hrs.,stocks,MDLY,6,0,6,-6,1,1,0,1,NYSE
4594,12-02-2021 12:00,24 hrs.,stocks,OTIS,30,30,0,30,1,10,6,1,NYSE
4594,12-02-2021 12:00,24 hrs.,stocks,PINS,217,0,217,-217,3,78,49,3,NYSE
4594,12-02-2021 12:00,24 hrs.,stocks,PLTR,20094,6,20088,-20082,3,9327,1428,3,NYSE
4594,12-02-2021 12:00,24 hrs.,stocks,PSTH,6,0,6,-6,1,1,0,1,NYSE
4594,12-02-2021 12:00,24 hrs.,stocks,SKLZ,40,0,40,-40,1,12,12,1,NYSE
4594,12-02-2021 12:00,24 hrs.,stocks,SPCE,24,7,17,-10,3,4,4,3,NYSE
4594,12-02-2021 12:00,24 hrs.,stocks,SPOT,6,0,6,-6,1,1,0,1,NYSE
4594,12-02-2021 12:00,24 hrs.,stocks,TMHC,6,0,6,-6,1,1,0,1,NYSE
4594,12-02-2021 12:00,24 hrs.,stocks,UBER,129,0,129,-129,2,54,13,2,NYSE
4594,12-02-2021 12:00,24 hrs.,stocks,VOYA,30,30,0,30,1,10,6,1,NYSE
4594,12-02-2021 12:00,24 hrs.,stocks,WORK,6,0,6,-6,1,1,0,1,NYSE
4594,12-02-2021 12:00,24 hrs.,stocks,XPEV,2658,2658,0,2658,1,1229,196,1,NYSE
4594,12-02-2021 12:00,24 hrs.,stocks,YETI,18,18,0,18,1,5,4,1,NYSE
4594,12-02-2021 12:00,24 hrs.,stocks,AAL,56,56,0,56,2,11,26,2,NASDAQ
4594,12-02-2021 12:00,24 hrs.,stocks,AMD,68,0,68,-68,4,6,40,3,NASDAQ
4594,12-02-2021 12:00,24 hrs.,stocks,CGC,18,0,18,-18,3,3,0,3,NASDAQ
4594,12-02-2021 12:00,24 hrs.,stocks,III,551,0,551,-551,1,212,123,1,NASDAQ
4594,12-02-2021 12:00,24 hrs.,wallstreetbets,NTSFF,6,6,0,6,1,1,0,1,OTC
4594,12-02-2021 12:00,24 hrs.,wallstreetbets,NWARF,12,0,12,-12,2,2,0,2,OTC
4594,12-02-2021 12:00,24 hrs.,wallstreetbets,NWVCF,6,0,6,-6,1,1,0,1,OTC
4594,12-02-2021 12:00,24 hrs.,wallstreetbets,NXGWF,7,7,0,7,1,1,1,1,OTC
4594,12-02-2021 12:00,24 hrs.,wallstreetbets,NXTTF,6,0,6,-6,1,1,0,1,OTC
4594,12-02-2021 12:00,24 hrs.,stocks,ASX,6,6,0,6,1,1,0,1,NYSE
4594,12-02-2021 12:00,24 hrs.,stocks,ATH,37,23,14,9,2,7,15,2,NYSE
4594,12-02-2021 12:00,24 hrs.,stocks,AUY,6,0,6,-6,1,1,0,1,NYSE
4594,12-02-2021 12:00,24 hrs.,stocks,BBD,6,0,6,-6,1,1,0,1,NYSE
4594,12-02-2021 12:00,24 hrs.,stocks,BBY,56,0,56,-56,1,15,22,1,NYSE
4594,12-02-2021 12:00,24 hrs.,stocks,BLK,8,0,8,-8,1,1,2,1,NYSE
4594,12-02-2021 12:00,24 hrs.,stocks,BNY,8,0,8,-8,1,1,2,1,NYSE
4594,12-02-2021 12:00,24 hrs.,stocks,BTT,12,6,6,0,2,2,0,2,NYSE
4594,12-02-2021 12:00,24 hrs.,stocks,BYD,13,0,13,-13,1,4,1,1,NYSE
4594,12-02-2021 12:00,24 hrs.,stocks,CIA,2658,2658,0,2658,1,1229,196,1,NYSE
4594,12-02-2021 12:00,24 hrs.,stocks,CRM,551,0,551,-551,1,212,123,1,NYSE
4594,12-02-2021 12:00,24 hrs.,stocks,DCF,551,0,551,-551,1,212,123,1,NYSE
4594,12-02-2021 12:00,24 hrs.,stocks,DDD,37,0,37,-37,1,8,17,1,NYSE
4594,12-02-2021 12:00,24 hrs.,stocks,DIS,20138,0,20138,-20138,2,9344,1442,2,NYSE
4594,12-02-2021 12:00,24 hrs.,stocks,DTE,25,0,25,-25,1,3,15,1,NYSE
4594,12-02-2021 12:00,24 hrs.,stocks,EOS,12,0,12,-12,2,2,0,1,NYSE
4594,12-02-2021 12:00,24 hrs.,stocks,FAF,15,0,15,-15,1,3,5,1,NYSE
4594,12-02-2021 12:00,24 hrs.,stocks,FCF,23,23,0,23,1,4,11,1,NYSE
4594,12-02-2021 12:00,24 hrs.,stocks,FCX,6,6,0,6,1,1,0,1,NYSE
4594,12-02-2021 12:00,24 hrs.,stocks,FSR,20,20,0,20,1,8,0,1,NYSE
4594,12-02-2021 12:00,24 hrs.,stocks,GME,24539,531,24008,-23477,22,11117,2217,21,NYSE
4594,12-02-2021 12:00,24 hrs.,stocks,HRL,110,0,110,-110,1,47,12,1,NYSE
4594,12-02-2021 12:00,24 hrs.,stocks,IBM,2658,2658,0,2658,1,1229,196,1,NYSE
4594,12-02-2021 12:00,24 hrs.,stocks,ICE,30,23,7,16,2,5,12,2,NYSE
4594,12-02-2021 12:00,24 hrs.,stocks,IRS,25,25,0,25,1,7,7,1,NYSE
4594,12-02-2021 12:00,24 hrs.,stocks,IVR,6,0,6,-6,1,1,0,1,NYSE
4594,12-02-2021 12:00,24 hrs.,stocks,JNJ,20118,0,20118,-20118,2,9329,1452,2,NYSE
4594,12-02-2021 12:00,24 hrs.,stocks,JPM,8,0,8,-8,1,1,2,1,NYSE
4594,12-02-2021 12:00,24 hrs.,stocks,KEY,55,55,0,55,1,20,11,1,NYSE
4594,12-02-2021 12:00,24 hrs.,stocks,KNL,30,30,0,30,1,10,6,1,NYSE
4594,12-02-2021 12:00,24 hrs.,stocks,LEN,6,6,0,6,1,1,0,1,NYSE
4594,12-02-2021 12:00,24 hrs.,stocks,LMT,6,6,0,6,1,1,0,1,NYSE
4594,12-02-2021 12:00,24 hrs.,stocks,LUV,18,18,0,18,1,5,4,1,NYSE
4594,12-02-2021 12:00,24 hrs.,stocks,MFA,8,8,0,8,1,1,2,1,NYSE
4594,12-02-2021 12:00,24 hrs.,wallstreetbets,AGE,6,0,6,-6,1,1,0,1,AMEX
4594,12-02-2021 12:00,24 hrs.,wallstreetbets,AMS,6,0,6,-6,1,1,0,1,AMEX
4594,12-02-2021 12:00,24 hrs.,wallstreetbets,CEI,18,0,18,-18,3,3,0,2,AMEX
4594,12-02-2021 12:00,24 hrs.,wallstreetbets,DNN,178,26,152,-126,28,29,8,26,AMEX
4594,12-02-2021 12:00,24 hrs.,wallstreetbets,DPW,19,0,19,-19,3,3,1,3,AMEX
4594,12-02-2021 12:00,24 hrs.,wallstreetbets,FEN,7,7,0,7,1,1,1,1,AMEX
4594,12-02-2021 12:00,24 hrs.,wallstreetbets,GPL,6,0,6,-6,1,1,0,1,AMEX
4594,12-02-2021 12:00,24 hrs.,wallstreetbets,GSV,45,14,31,-17,7,7,3,7,AMEX
4594,12-02-2021 12:00,24 hrs.,wallstreetbets,GTE,160,20,140,-120,26,26,4,21,AMEX
4594,12-02-2021 12:00,24 hrs.,wallstreetbets,IGC,79,7,72,-65,13,13,1,6,AMEX
4594,12-02-2021 12:00,24 hrs.,wallstreetbets,ISR,6,6,0,6,1,1,0,1,AMEX
4594,12-02-2021 12:00,24 hrs.,wallstreetbets,ITP,6,0,6,-6,1,1,0,1,AMEX
4594,12-02-2021 12:00,24 hrs.,wallstreetbets,JOB,6,0,6,-6,1,1,0,1,AMEX
4594,12-02-2021 12:00,24 hrs.,wallstreetbets,KIQ,12,0,12,-12,2,2,0,1,AMEX
4594,12-02-2021 12:00,24 hrs.,wallstreetbets,LOV,18,0,18,-18,3,3,0,1,AMEX
4594,12-02-2021 12:00,24 hrs.,wallstreetbets,LSF,7,7,0,7,1,1,1,1,AMEX
4594,12-02-2021 12:00,24 hrs.,wallstreetbets,MMX,6,0,6,-6,1,1,0,1,AMEX
4594,12-02-2021 12:00,24 hrs.,wallstreetbets,MXC,21,21,0,21,3,3,3,3,AMEX
4594,12-02-2021 12:00,24 hrs.,wallstreetbets,NAK,258,27,231,-204,42,42,6,31,AMEX
4594,12-02-2021 12:00,24 hrs.,wallstreetbets,NGD,15,0,15,-15,2,2,3,1,AMEX
4594,12-02-2021 12:00,24 hrs.,wallstreetbets,NXE,6,0,6,-6,1,1,0,1,AMEX
4594,12-02-2021 12:00,24 hrs.,wallstreetbets,REI,6,0,6,-6,1,1,0,1,AMEX
4594,12-02-2021 12:00,24 hrs.,wallstreetbets,SYN,12,0,12,-12,2,2,0,2,AMEX
4594,12-02-2021 12:00,24 hrs.,wallstreetbets,TMQ,8,8,0,8,1,1,2,1,AMEX
4594,12-02-2021 12:00,24 hrs.,wallstreetbets,TRX,102,41,61,-20,16,16,6,12,AMEX
4594,12-02-2021 12:00,24 hrs.,wallstreetbets,URG,7,0,7,-7,1,1,1,1,AMEX
4594,12-02-2021 12:00,24 hrs.,wallstreetbets,XPL,12,0,12,-12,2,2,0,1,AMEX
4594,12-02-2021 12:00,24 hrs.,wallstreetbets,ZOM,283,75,208,-133,45,45,13,38,AMEX
4594,12-02-2021 12:00,24 hrs.,wallstreetbets,AMPE,13,7,6,1,2,2,1,2,AMEX
4594,12-02-2021 12:00,24 hrs.,wallstreetbets,CANF,6,0,6,-6,1,1,0,1,AMEX
4594,12-02-2021 12:00,24 hrs.,stocks,MRK,110,0,110,-110,1,47,12,1,NYSE
4594,12-02-2021 12:00,24 hrs.,stocks,NAT,24,0,24,-24,1,5,10,1,NYSE
4594,12-02-2021 12:00,24 hrs.,stocks,NET,333,0,333,-333,1,122,85,1,NYSE
4594,12-02-2021 12:00,24 hrs.,stocks,NIO,37,0,37,-37,1,4,25,1,NYSE
4594,12-02-2021 12:00,24 hrs.,stocks,NKE,20081,0,20081,-20081,1,9325,1427,1,NYSE
4594,12-02-2021 12:00,24 hrs.,stocks,NOK,9,0,9,-9,1,2,1,1,NYSE
4594,12-02-2021 12:00,24 hrs.,stocks,NSA,2658,2658,0,2658,1,1229,196,1,NYSE
4594,12-02-2021 12:00,24 hrs.,stocks,NVS,18,18,0,18,3,3,0,1,NYSE
4594,12-02-2021 12:00,24 hrs.,stocks,PBI,21,0,21,-21,1,7,3,1,NYSE
4594,12-02-2021 12:00,24 hrs.,stocks,PDT,6,6,0,6,1,1,0,1,NYSE
4594,12-02-2021 12:00,24 hrs.,stocks,QSR,110,0,110,-110,1,47,12,1,NYSE
4594,12-02-2021 12:00,24 hrs.,stocks,RKT,70,70,0,70,1,25,16,1,NYSE
4594,12-02-2021 12:00,24 hrs.,stocks,RSI,30,30,0,30,1,10,6,1,NYSE
4594,12-02-2021 12:00,24 hrs.,stocks,SBE,70,46,24,22,6,22,2,4,NYSE
4594,12-02-2021 12:00,24 hrs.,stocks,SIX,10,0,10,-10,1,3,0,1,NYSE
4594,12-02-2021 12:00,24 hrs.,stocks,SOI,13,6,7,-1,2,2,1,2,NYSE
4594,12-02-2021 12:00,24 hrs.,stocks,SOS,24,18,6,12,4,4,0,4,NYSE
4594,12-02-2021 12:00,24 hrs.,stocks,TAP,110,0,110,-110,1,47,12,1,NYSE
4594,12-02-2021 12:00,24 hrs.,stocks,TDA,7,0,7,-7,1,1,1,1,NYSE
4594,12-02-2021 12:00,24 hrs.,stocks,TME,6,0,6,-6,1,1,0,1,NYSE
4594,12-02-2021 12:00,24 hrs.,stocks,TMO,7,7,0,7,1,1,1,1,NYSE
4594,12-02-2021 12:00,24 hrs.,stocks,TPX,110,0,110,-110,1,47,12,1,NYSE
4594,12-02-2021 12:00,24 hrs.,stocks,TSM,40,0,40,-40,1,5,26,1,NYSE
4594,12-02-2021 12:00,24 hrs.,stocks,UMC,6,0,6,-6,1,1,0,1,NYSE
4594,12-02-2021 12:00,24 hrs.,stocks,UPS,56,0,56,-56,1,21,10,1,NYSE
4594,12-02-2021 12:00,24 hrs.,stocks,WMT,20141,0,20141,-20141,4,9333,1459,4,NYSE
4594,12-02-2021 12:00,24 hrs.,stocks,XPO,110,0,110,-110,1,47,12,1,NYSE
4594,12-02-2021 12:00,24 hrs.,stocks,ALSN,30,30,0,30,1,10,6,1,NYSE
4594,12-02-2021 12:00,24 hrs.,stocks,AQUA,7,0,7,-7,1,1,1,1,NYSE
4594,12-02-2021 12:00,24 hrs.,stocks,BABA,114,67,47,20,3,34,34,3,NYSE
4594,12-02-2021 12:00,24 hrs.,stocks,BORR,6,0,6,-6,1,1,0,1,NYSE
4594,12-02-2021 12:00,24 hrs.,stocks,CACI,2658,2658,0,2658,1,1229,196,1,NYSE
4594,12-02-2021 12:00,24 hrs.,stocks,CCIV,24,0,24,-24,4,4,0,4,NYSE
4594,12-02-2021 12:00,24 hrs.,stocks,FTCH,17,17,0,17,1,3,7,1,NYSE
4594,12-02-2021 12:00,24 hrs.,stocks,GLUU,16,0,16,-16,1,4,4,1,NASDAQ
4594,12-02-2021 12:00,24 hrs.,stocks,GNUS,6,6,0,6,1,1,0,1,NASDAQ
4594,12-02-2021 12:00,24 hrs.,stocks,GOEV,6,0,6,-6,1,1,0,1,NASDAQ
4594,12-02-2021 12:00,24 hrs.,stocks,GOOG,15,0,15,-15,1,0,11,1,NASDAQ
4594,12-02-2021 12:00,24 hrs.,stocks,GRWG,6,0,6,-6,1,1,0,1,NASDAQ
4594,12-02-2021 12:00,24 hrs.,stocks,GTEC,6,0,6,-6,1,1,0,1,NASDAQ
4594,12-02-2021 12:00,24 hrs.,stocks,GTHX,6,0,6,-6,1,1,0,1,NASDAQ
4594,12-02-2021 12:00,24 hrs.,stocks,HTBX,6,6,0,6,1,1,0,1,NASDAQ
4594,12-02-2021 12:00,24 hrs.,stocks,ICPT,17,0,17,-17,1,4,5,1,NASDAQ
4594,12-02-2021 12:00,24 hrs.,stocks,JFU,6,6,0,6,1,1,0,1,NASDAQ
4594,12-02-2021 12:00,24 hrs.,stocks,KHC,141,6,135,-129,3,54,21,3,NASDAQ
4594,12-02-2021 12:00,24 hrs.,stocks,LNT,30,30,0,30,1,10,6,1,NASDAQ
4594,12-02-2021 12:00,24 hrs.,stocks,MIK,6,6,0,6,1,1,0,1,NASDAQ
4594,12-02-2021 12:00,24 hrs.,stocks,NPA,6,0,6,-6,1,1,0,1,NASDAQ
4594,12-02-2021 12:00,24 hrs.,wallstreetbets,CRMD,12,0,12,-12,2,2,0,2,AMEX
4594,12-02-2021 12:00,24 hrs.,wallstreetbets,EMAN,7,7,0,7,1,1,1,1,AMEX
4594,12-02-2021 12:00,24 hrs.,wallstreetbets,GSAT,224,61,163,-102,36,36,8,25,AMEX
4594,12-02-2021 12:00,24 hrs.,wallstreetbets,IBIO,18,0,18,-18,3,3,0,1,AMEX
4594,12-02-2021 12:00,24 hrs.,wallstreetbets,LODE,6,0,6,-6,1,1,0,1,AMEX
4594,12-02-2021 12:00,24 hrs.,wallstreetbets,NSPR,31,7,24,-17,5,5,1,4,AMEX
4594,12-02-2021 12:00,24 hrs.,wallstreetbets,OGEN,37,7,30,-23,6,6,1,5,AMEX
4594,12-02-2021 12:00,24 hrs.,wallstreetbets,RLGT,21,21,0,21,3,3,3,1,AMEX
4594,12-02-2021 12:00,24 hrs.,wallstreetbets,SENS,117,7,110,-103,19,18,5,16,AMEX
4594,12-02-2021 12:00,24 hrs.,wallstreetbets,TMBR,32,20,12,8,5,5,2,5,AMEX
4594,12-02-2021 12:00,24 hrs.,wallstreetbets,TRXC,69,20,49,-29,11,11,3,7,AMEX
4594,12-02-2021 12:00,24 hrs.,wallstreetbets,UAVS,25,7,18,-11,4,4,1,4,AMEX
4594,12-02-2021 12:00,24 hrs.,wallstreetbets,UUUU,33,7,26,-19,5,5,3,4,AMEX
4594,12-02-2021 12:00,24 hrs.,wallstreetbets,VOLT,6,0,6,-6,1,1,0,1,AMEX
4594,12-02-2021 12:00,24 hrs.,wallstreetbets,XXII,6,0,6,-6,1,1,0,1,AMEX
4594,12-02-2021 12:00,24 hrs.,wallstreetbets,YCBD,13,7,6,1,2,2,1,2,AMEX
4594,12-02-2021 12:00,24 hrs.,wallstreetbets,ORZCF,6,0,6,-6,1,1,0,1,OTC
4594,12-02-2021 12:00,24 hrs.,wallstreetbets,PFFOF,6,0,6,-6,1,1,0,1,OTC
4594,12-02-2021 12:00,24 hrs.,wallstreetbets,PLNHF,149,0,149,-149,5,30,69,5,OTC
4594,12-02-2021 12:00,24 hrs.,wallstreetbets,RAZFF,7,0,7,-7,1,1,1,1,OTC
4594,12-02-2021 12:00,24 hrs.,wallstreetbets,RLFTF,6,0,6,-6,1,1,0,1,OTC
4594,12-02-2021 12:00,24 hrs.,wallstreetbets,RLLCF,6,0,6,-6,1,1,0,1,OTC
4594,12-02-2021 12:00,24 hrs.,wallstreetbets,RYCEY,303,223,80,143,19,74,79,13,OTC
4594,12-02-2021 12:00,24 hrs.,wallstreetbets,RYMDF,6,0,6,-6,1,1,0,1,OTC
4594,12-02-2021 12:00,24 hrs.,wallstreetbets,SEOVF,6,0,6,-6,1,1,0,1,OTC
4594,12-02-2021 12:00,24 hrs.,wallstreetbets,SHECY,77,0,77,-77,1,24,25,1,OTC
4594,12-02-2021 12:00,24 hrs.,wallstreetbets,SHERF,6,0,6,-6,1,1,0,1,OTC
4594,12-02-2021 12:00,24 hrs.,wallstreetbets,SHRMF,40,40,0,40,1,13,10,1,OTC
4594,12-02-2021 12:00,24 hrs.,wallstreetbets,SLGWF,12,0,12,-12,2,2,0,1,OTC
4594,12-02-2021 12:00,24 hrs.,wallstreetbets,SPLIF,6,0,6,-6,1,1,0,1,OTC
4594,12-02-2021 12:00,24 hrs.,wallstreetbets,SPRWF,68,32,36,-4,10,12,4,9,OTC
4594,12-02-2021 12:00,24 hrs.,wallstreetbets,TAKOF,263,0,263,-263,3,99,53,3,OTC
4594,12-02-2021 12:00,24 hrs.,wallstreetbets,TBUIF,24,0,24,-24,4,4,0,1,OTC
4594,12-02-2021 12:00,24 hrs.,wallstreetbets,TCNNF,773,0,773,-773,2,230,305,2,OTC
4594,12-02-2021 12:00,24 hrs.,wallstreetbets,TGODF,30,0,30,-30,5,5,0,3,OTC
4594,12-02-2021 12:00,24 hrs.,wallstreetbets,TLOFF,7,0,7,-7,1,1,1,1,OTC
4594,12-02-2021 12:00,24 hrs.,wallstreetbets,TLVLF,6,0,6,-6,1,1,0,1,OTC
4594,12-02-2021 12:00,24 hrs.,wallstreetbets,TRUFF,7,0,7,-7,1,1,1,1,OTC
4594,12-02-2021 12:00,24 hrs.,wallstreetbets,TSCRF,13,0,13,-13,2,2,1,2,OTC
4594,12-02-2021 12:00,24 hrs.,wallstreetbets,VALPQ,13,7,6,1,2,2,1,2,OTC
4594,12-02-2021 12:00,24 hrs.,wallstreetbets,VEGGF,6,0,6,-6,1,1,0,1,OTC
4594,12-02-2021 12:00,24 hrs.,wallstreetbets,VLNCF,242,0,242,-242,4,63,100,4,OTC
4594,12-02-2021 12:00,24 hrs.,wallstreetbets,VRYYF,6,0,6,-6,1,1,0,1,OTC
4594,12-02-2021 12:00,24 hrs.,wallstreetbets,VVCIF,7,7,0,7,1,1,1,1,OTC
4594,12-02-2021 12:00,24 hrs.,wallstreetbets,VYGVF,12,0,12,-12,1,2,4,1,OTC
4594,12-02-2021 12:00,24 hrs.,wallstreetbets,WDDMF,13,7,6,1,2,2,1,2,OTC
4594,12-02-2021 12:00,24 hrs.,wallstreetbets,WPMLF,8,8,0,8,1,1,2,1,OTC
4594,12-02-2021 12:00,24 hrs.,wallstreetbets,XIACF,12,0,12,-12,2,2,0,1,OTC
4594,12-02-2021 12:00,24 hrs.,wallstreetbets,XIACY,12,0,12,-12,2,2,0,1,OTC
4594,12-02-2021 12:00,24 hrs.,wallstreetbets,AAU,6,0,6,-6,1,1,0,1,AMEX
4594,12-02-2021 12:00,24 hrs.,wallstreetbets,CRL,6,0,6,-6,1,1,0,1,NYSE
4594,12-02-2021 12:00,24 hrs.,wallstreetbets,CRM,7,0,7,-7,1,1,1,1,NYSE
4594,12-02-2021 12:00,24 hrs.,wallstreetbets,CUB,37,0,37,-37,6,6,1,1,NYSE
4594,12-02-2021 12:00,24 hrs.,wallstreetbets,CVA,13,0,13,-13,2,2,1,2,NYSE
4594,12-02-2021 12:00,24 hrs.,wallstreetbets,CVE,6,0,6,-6,1,1,0,1,NYSE
4594,12-02-2021 12:00,24 hrs.,wallstreetbets,CVS,13,0,13,-13,2,2,1,2,NYSE
4594,12-02-2021 12:00,24 hrs.,wallstreetbets,DAL,190,0,190,-190,1,63,60,1,NYSE
4594,12-02-2021 12:00,24 hrs.,wallstreetbets,DCF,225,0,225,-225,1,79,63,1,NYSE
4594,12-02-2021 12:00,24 hrs.,wallstreetbets,DDD,6,0,6,-6,1,1,0,1,NYSE
4594,12-02-2021 12:00,24 hrs.,stocks,OGI,33,19,14,5,5,5,3,5,NASDAQ
4594,12-02-2021 12:00,24 hrs.,stocks,OLB,6,6,0,6,1,1,0,1,NASDAQ
4594,12-02-2021 12:00,24 hrs.,stocks,PEP,116,0,116,-116,2,47,14,2,NASDAQ
4594,12-02-2021 12:00,24 hrs.,stocks,QQQ,47,0,47,-47,2,6,27,2,NASDAQ
4594,12-02-2021 12:00,24 hrs.,stocks,RXT,6,0,6,-6,1,1,0,1,NASDAQ
4594,12-02-2021 12:00,24 hrs.,stocks,SMH,40,0,40,-40,1,5,26,1,NASDAQ
4594,12-02-2021 12:00,24 hrs.,stocks,UFO,35,0,35,-35,3,9,5,1,NASDAQ
4594,12-02-2021 12:00,24 hrs.,stocks,AAPL,20164,54,20110,-20056,5,9336,1472,4,NASDAQ
4594,12-02-2021 12:00,24 hrs.,stocks,ABIO,6,6,0,6,1,1,0,1,NASDAQ
4594,12-02-2021 12:00,24 hrs.,stocks,ABNB,31,0,31,-31,1,10,7,1,NASDAQ
4594,12-02-2021 12:00,24 hrs.,stocks,AEZS,6,0,6,-6,1,1,0,1,NASDAQ
4594,12-02-2021 12:00,24 hrs.,stocks,AGTC,6,6,0,6,1,1,0,1,NASDAQ
4594,12-02-2021 12:00,24 hrs.,stocks,ALJJ,6,0,6,-6,1,1,0,1,NASDAQ
4594,12-02-2021 12:00,24 hrs.,stocks,ALOT,141,0,141,-141,1,34,69,1,NASDAQ
4594,12-02-2021 12:00,24 hrs.,stocks,AMCX,6,0,6,-6,1,1,0,1,NASDAQ
4594,12-02-2021 12:00,24 hrs.,stocks,AMZN,20081,0,20081,-20081,1,9325,1427,1,NASDAQ
4594,12-02-2021 12:00,24 hrs.,stocks,APHA,20505,220,20285,-20065,13,9444,1565,13,NASDAQ
4594,12-02-2021 12:00,24 hrs.,stocks,APXT,6,6,0,6,1,1,0,1,NASDAQ
4594,12-02-2021 12:00,24 hrs.,stocks,ASRT,24,0,24,-24,2,8,0,2,NASDAQ
4594,12-02-2021 12:00,24 hrs.,stocks,ATOM,6,0,6,-6,1,1,0,1,NASDAQ
4594,12-02-2021 12:00,24 hrs.,stocks,AVXL,6,0,6,-6,1,1,0,1,NASDAQ
4594,12-02-2021 12:00,24 hrs.,stocks,AXDX,6,0,6,-6,1,1,0,1,NASDAQ
4594,12-02-2021 12:00,24 hrs.,stocks,AZRX,12,0,12,-12,1,2,4,1,NASDAQ
4594,12-02-2021 12:00,24 hrs.,stocks,BBIG,6,0,6,-6,1,1,0,1,NASDAQ
4594,12-02-2021 12:00,24 hrs.,stocks,BLDP,6,0,6,-6,1,1,0,1,NASDAQ
4594,12-02-2021 12:00,24 hrs.,stocks,BLNK,37,0,37,-37,1,4,25,1,NASDAQ
4594,12-02-2021 12:00,24 hrs.,stocks,BOXL,7,0,7,-7,1,1,1,1,NASDAQ
4594,12-02-2021 12:00,24 hrs.,stocks,CLEU,7,7,0,7,1,1,1,1,NASDAQ
4594,12-02-2021 12:00,24 hrs.,stocks,CLSK,35,35,0,35,2,8,11,2,NASDAQ
4594,12-02-2021 12:00,24 hrs.,stocks,CLVS,6,0,6,-6,1,1,0,1,NASDAQ
4594,12-02-2021 12:00,24 hrs.,stocks,CMPS,12,12,0,12,2,2,0,1,NASDAQ
4594,12-02-2021 12:00,24 hrs.,stocks,CNDT,13,13,0,13,1,3,3,1,NASDAQ
4594,12-02-2021 12:00,24 hrs.,stocks,COST,20097,0,20097,-20097,2,9328,1433,2,NASDAQ
4594,12-02-2021 12:00,24 hrs.,stocks,CREE,6,6,0,6,1,1,0,1,NASDAQ
4594,12-02-2021 12:00,24 hrs.,stocks,CRSR,40,0,40,-40,1,12,12,1,NASDAQ
4594,12-02-2021 12:00,24 hrs.,stocks,CTRM,50,32,18,14,8,8,2,7,NASDAQ
4594,12-02-2021 12:00,24 hrs.,stocks,CVLB,6,6,0,6,1,1,0,1,NASDAQ
4594,12-02-2021 12:00,24 hrs.,stocks,CXDC,6,0,6,-6,1,1,0,1,NASDAQ
4594,12-02-2021 12:00,24 hrs.,stocks,DFFN,9,9,0,9,1,2,1,1,NASDAQ
4594,12-02-2021 12:00,24 hrs.,stocks,DMTK,23,23,0,23,1,3,13,1,NASDAQ
4594,12-02-2021 12:00,24 hrs.,stocks,DOMO,21,0,21,-21,1,7,3,1,NASDAQ
4594,12-02-2021 12:00,24 hrs.,stocks,DOYU,7,0,7,-7,1,1,1,1,NASDAQ
4594,12-02-2021 12:00,24 hrs.,stocks,EKSO,6,0,6,-6,1,1,0,1,NASDAQ
4594,12-02-2021 12:00,24 hrs.,stocks,ENTX,7,7,0,7,1,1,1,1,NASDAQ
4594,12-02-2021 12:00,24 hrs.,stocks,EOLS,6,0,6,-6,1,1,0,1,NASDAQ
4594,12-02-2021 12:00,24 hrs.,stocks,ETSY,17,17,0,17,1,3,7,1,NASDAQ
4594,12-02-2021 12:00,24 hrs.,stocks,EVFM,22,22,0,22,2,7,0,1,NASDAQ
4594,12-02-2021 12:00,24 hrs.,stocks,EXAS,23,23,0,23,1,3,13,1,NASDAQ
4594,12-02-2021 12:00,24 hrs.,stocks,EXPI,6,0,6,-6,1,1,0,1,NASDAQ
4594,12-02-2021 12:00,24 hrs.,stocks,FLXN,30,30,0,30,1,10,6,1,NASDAQ
4594,12-02-2021 12:00,24 hrs.,stocks,FROG,6,0,6,-6,1,1,0,1,NASDAQ
4594,12-02-2021 12:00,24 hrs.,stocks,FSRV,6,6,0,6,1,1,0,1,NASDAQ
4594,12-02-2021 12:00,24 hrs.,stocks,GEVO,12,0,12,-12,2,2,0,1,NASDAQ
4594,12-02-2021 12:00,24 hrs.,stocks,GILT,40,0,40,-40,1,12,12,1,NASDAQ
4594,12-02-2021 12:00,24 hrs.,stocks,GLBS,6,0,6,-6,1,1,0,1,NASDAQ
4594,12-02-2021 12:00,24 hrs.,wallstreetbets,IVR,186,6,180,-174,3,62,50,3,NYSE
4594,12-02-2021 12:00,24 hrs.,wallstreetbets,JEF,6,0,6,-6,1,1,0,1,NYSE
4594,12-02-2021 12:00,24 hrs.,wallstreetbets,JKS,6,0,6,-6,1,1,0,1,NYSE
4594,12-02-2021 12:00,24 hrs.,wallstreetbets,JNJ,6,6,0,6,1,1,0,1,NYSE
4594,12-02-2021 12:00,24 hrs.,wallstreetbets,JOE,6,0,6,-6,1,1,0,1,NYSE
4594,12-02-2021 12:00,24 hrs.,wallstreetbets,KGC,18,0,18,-18,3,3,0,2,NYSE
4594,12-02-2021 12:00,24 hrs.,wallstreetbets,LAC,19,19,0,19,3,3,1,3,NYSE
4594,12-02-2021 12:00,24 hrs.,wallstreetbets,LEG,6,0,6,-6,1,1,0,1,NYSE
4594,12-02-2021 12:00,24 hrs.,wallstreetbets,LEN,6,6,0,6,1,1,0,1,NYSE
4594,12-02-2021 12:00,24 hrs.,stocks,IFMK,6,0,6,-6,1,1,0,1,NASDAQ
4594,12-02-2021 12:00,24 hrs.,stocks,INPX,18,18,0,18,3,3,0,1,NASDAQ
4594,12-02-2021 12:00,24 hrs.,stocks,INTC,40,0,40,-40,1,5,26,1,NASDAQ
4594,12-02-2021 12:00,24 hrs.,stocks,IRBT,110,0,110,-110,1,47,12,1,NASDAQ
4594,12-02-2021 12:00,24 hrs.,stocks,KLIC,6,0,6,-6,1,1,0,1,NASDAQ
4594,12-02-2021 12:00,24 hrs.,stocks,KPTI,30,30,0,30,1,10,6,1,NASDAQ
4594,12-02-2021 12:00,24 hrs.,stocks,LIVE,110,0,110,-110,1,47,12,1,NASDAQ
4594,12-02-2021 12:00,24 hrs.,stocks,LPTH,6,0,6,-6,1,1,0,1,NASDAQ
4594,12-02-2021 12:00,24 hrs.,stocks,MBRX,6,0,6,-6,1,1,0,1,NASDAQ
4594,12-02-2021 12:00,24 hrs.,stocks,MELI,40,0,40,-40,1,5,26,1,NASDAQ
4594,12-02-2021 12:00,24 hrs.,stocks,MGNI,54,54,0,54,1,9,32,1,NASDAQ
4594,12-02-2021 12:00,24 hrs.,stocks,MNPR,6,6,0,6,1,1,0,1,NASDAQ
4594,12-02-2021 12:00,24 hrs.,stocks,MSFT,20262,71,20191,-20120,4,9384,1478,4,NASDAQ
4594,12-02-2021 12:00,24 hrs.,stocks,MSTR,6,0,6,-6,1,1,0,1,NASDAQ
4594,12-02-2021 12:00,24 hrs.,stocks,MTCH,256,0,256,-256,1,49,154,1,NASDAQ
4594,12-02-2021 12:00,24 hrs.,stocks,MVIS,12,0,12,-12,2,2,0,2,NASDAQ
4594,12-02-2021 12:00,24 hrs.,stocks,NAKD,31,0,31,-31,4,4,7,4,NASDAQ
4594,12-02-2021 12:00,24 hrs.,stocks,NTLA,14,0,14,-14,1,3,4,1,NASDAQ
4594,12-02-2021 12:00,24 hrs.,stocks,NTRS,8,0,8,-8,1,1,2,1,NASDAQ
4594,12-02-2021 12:00,24 hrs.,stocks,NVDA,20189,71,20118,-20047,4,9341,1491,4,NASDAQ
4594,12-02-2021 12:00,24 hrs.,stocks,NXTD,12,12,0,12,2,2,0,1,NASDAQ
4594,12-02-2021 12:00,24 hrs.,stocks,NYMT,8,8,0,8,1,1,2,1,NASDAQ
4594,12-02-2021 12:00,24 hrs.,stocks,OCGN,6,0,6,-6,1,1,0,1,NASDAQ
4594,12-02-2021 12:00,24 hrs.,wallstreetbets,ABT,13,7,6,1,2,2,1,2,NYSE
4594,12-02-2021 12:00,24 hrs.,wallstreetbets,ACB,269,14,255,-241,44,44,5,30,NYSE
4594,12-02-2021 12:00,24 hrs.,wallstreetbets,ACI,6,0,6,-6,1,1,0,1,NYSE
4594,12-02-2021 12:00,24 hrs.,wallstreetbets,ADT,18,0,18,-18,3,3,0,2,NYSE
4594,12-02-2021 12:00,24 hrs.,wallstreetbets,ADX,12,0,12,-12,2,2,0,1,NYSE
4594,12-02-2021 12:00,24 hrs.,wallstreetbets,AFC,12,0,12,-12,2,2,0,1,NYSE
4594,12-02-2021 12:00,24 hrs.,wallstreetbets,AHT,14,0,14,-14,2,2,2,2,NYSE
4594,12-02-2021 12:00,24 hrs.,wallstreetbets,AIR,7,7,0,7,1,1,1,1,NYSE
4594,12-02-2021 12:00,24 hrs.,wallstreetbets,AMC,68323,3326,64997,-61671,297,31176,4783,248,NYSE
4594,12-02-2021 12:00,24 hrs.,wallstreetbets,AMP,33,14,19,-5,5,5,3,5,NYSE
4594,12-02-2021 12:00,24 hrs.,wallstreetbets,ASX,14,14,0,14,2,2,2,2,NYSE
4594,12-02-2021 12:00,24 hrs.,wallstreetbets,ATH,6,0,6,-6,1,1,0,1,NYSE
4594,12-02-2021 12:00,24 hrs.,wallstreetbets,AUY,12,0,12,-12,2,2,0,2,NYSE
4594,12-02-2021 12:00,24 hrs.,wallstreetbets,AYX,6,0,6,-6,1,1,0,1,NYSE
4594,12-02-2021 12:00,24 hrs.,wallstreetbets,BBW,19,13,6,7,3,3,1,3,NYSE
4594,12-02-2021 12:00,24 hrs.,wallstreetbets,BBY,20,14,6,8,3,3,2,2,NYSE
4594,12-02-2021 12:00,24 hrs.,wallstreetbets,BEP,6,0,6,-6,1,1,0,1,NYSE
4594,12-02-2021 12:00,24 hrs.,wallstreetbets,BFT,14,7,7,0,2,2,2,2,NYSE
4594,12-02-2021 12:00,24 hrs.,wallstreetbets,BGS,12,0,12,-12,2,2,0,1,NYSE
4594,12-02-2021 12:00,24 hrs.,wallstreetbets,BHC,21,21,0,21,3,3,3,1,NYSE
4594,12-02-2021 12:00,24 hrs.,wallstreetbets,BIO,65,0,65,-65,4,14,21,4,NYSE
4594,12-02-2021 12:00,24 hrs.,wallstreetbets,BIT,7,7,0,7,1,1,1,1,NYSE
4594,12-02-2021 12:00,24 hrs.,wallstreetbets,BNY,6,0,6,-6,1,1,0,1,NYSE
4594,12-02-2021 12:00,24 hrs.,wallstreetbets,BTT,63,26,37,-11,10,10,3,10,NYSE
4594,12-02-2021 12:00,24 hrs.,wallstreetbets,BUD,13,0,13,-13,2,2,1,2,NYSE
4594,12-02-2021 12:00,24 hrs.,wallstreetbets,CBD,58,28,30,-2,8,10,6,7,NYSE
4594,12-02-2021 12:00,24 hrs.,wallstreetbets,CCJ,6,0,6,-6,1,1,0,1,NYSE
4594,12-02-2021 12:00,24 hrs.,wallstreetbets,CCL,30,0,30,-30,5,5,0,5,NYSE
4594,12-02-2021 12:00,24 hrs.,wallstreetbets,CHS,14,8,6,2,2,2,2,2,NYSE
4594,12-02-2021 12:00,24 hrs.,wallstreetbets,CMO,6,0,6,-6,1,1,0,1,NYSE
4594,12-02-2021 12:00,24 hrs.,wallstreetbets,COO,6,0,6,-6,1,1,0,1,NYSE
4594,12-02-2021 12:00,24 hrs.,wallstreetbets,COP,6,0,6,-6,1,1,0,1,NYSE
4594,12-02-2021 12:00,24 hrs.,stocks,RIDE,65,0,65,-65,1,23,15,1,NASDAQ
4594,12-02-2021 12:00,24 hrs.,stocks,RIOT,6,0,6,-6,1,1,0,1,NASDAQ
4594,12-02-2021 12:00,24 hrs.,stocks,SABR,18,18,0,18,1,5,4,1,NASDAQ
4594,12-02-2021 12:00,24 hrs.,stocks,SEEL,18,18,0,18,3,3,0,2,NASDAQ
4594,12-02-2021 12:00,24 hrs.,stocks,SNDL,124,31,93,-62,20,20,4,16,NASDAQ
4594,12-02-2021 12:00,24 hrs.,stocks,SNGX,11,11,0,11,1,3,1,1,NASDAQ
4594,12-02-2021 12:00,24 hrs.,stocks,SONO,110,0,110,-110,1,47,12,1,NASDAQ
4594,12-02-2021 12:00,24 hrs.,stocks,SPRO,23,23,0,23,1,3,13,1,NASDAQ
4594,12-02-2021 12:00,24 hrs.,stocks,SQQQ,7,0,7,-7,1,1,1,1,NASDAQ
4594,12-02-2021 12:00,24 hrs.,stocks,SRAC,8,8,0,8,1,2,0,1,NASDAQ
4594,12-02-2021 12:00,24 hrs.,stocks,SSPK,42,0,42,-42,1,12,14,1,NASDAQ
4594,12-02-2021 12:00,24 hrs.,stocks,SSYS,37,0,37,-37,1,8,17,1,NASDAQ
4594,12-02-2021 12:00,24 hrs.,stocks,SWAV,23,23,0,23,1,3,13,1,NASDAQ
4594,12-02-2021 12:00,24 hrs.,stocks,SWBI,7,0,7,-7,1,1,1,1,NASDAQ
4594,12-02-2021 12:00,24 hrs.,stocks,TLRY,349,225,124,101,11,114,77,11,NASDAQ
4594,12-02-2021 12:00,24 hrs.,stocks,TMDX,23,23,0,23,1,3,13,1,NASDAQ
4594,12-02-2021 12:00,24 hrs.,stocks,TNXP,18,0,18,-18,3,3,0,2,NASDAQ
4594,12-02-2021 12:00,24 hrs.,stocks,TOPS,7,0,7,-7,1,1,1,1,NASDAQ
4594,12-02-2021 12:00,24 hrs.,stocks,TRVN,6,0,6,-6,1,1,0,1,NASDAQ
4594,12-02-2021 12:00,24 hrs.,stocks,TSLA,129,92,37,55,4,14,85,4,NASDAQ
4594,12-02-2021 12:00,24 hrs.,stocks,TTWO,6,0,6,-6,1,1,0,1,NASDAQ
4594,12-02-2021 12:00,24 hrs.,stocks,TWOU,23,0,23,-23,2,5,5,1,NASDAQ
4594,12-02-2021 12:00,24 hrs.,stocks,TXMD,12,0,12,-12,2,2,0,2,NASDAQ
4594,12-02-2021 12:00,24 hrs.,stocks,VCEL,23,23,0,23,1,3,13,1,NASDAQ
4594,12-02-2021 12:00,24 hrs.,stocks,VECO,6,6,0,6,1,1,0,1,NASDAQ
4594,12-02-2021 12:00,24 hrs.,stocks,VUZI,36,0,36,-36,1,9,14,1,NASDAQ
4594,12-02-2021 12:00,24 hrs.,stocks,VXRT,12,0,12,-12,2,2,0,2,NASDAQ
4594,12-02-2021 12:00,24 hrs.,stocks,VXUS,28,0,28,-28,1,7,10,1,NASDAQ
4594,12-02-2021 12:00,24 hrs.,wallstreetbets,DIS,2120,957,1163,-206,18,834,380,16,NYSE
4594,12-02-2021 12:00,24 hrs.,wallstreetbets,DMS,6,0,6,-6,1,1,0,1,NYSE
4594,12-02-2021 12:00,24 hrs.,wallstreetbets,DNB,7,7,0,7,1,1,1,1,NYSE
4594,12-02-2021 12:00,24 hrs.,wallstreetbets,DOC,7,7,0,7,1,1,1,1,NYSE
4594,12-02-2021 12:00,24 hrs.,wallstreetbets,DTE,921,0,921,-921,1,392,133,1,NYSE
4594,12-02-2021 12:00,24 hrs.,wallstreetbets,EAT,20,14,6,8,3,3,2,3,NYSE
4594,12-02-2021 12:00,24 hrs.,wallstreetbets,EHC,6,0,6,-6,1,1,0,1,NYSE
4594,12-02-2021 12:00,24 hrs.,wallstreetbets,ELY,6,0,6,-6,1,1,0,1,NYSE
4594,12-02-2021 12:00,24 hrs.,wallstreetbets,EMO,6,0,6,-6,1,1,0,1,NYSE
4594,12-02-2021 12:00,24 hrs.,wallstreetbets,ENJ,6,0,6,-6,1,1,0,1,NYSE
4594,12-02-2021 12:00,24 hrs.,wallstreetbets,EOS,13,0,13,-13,2,2,1,2,NYSE
4594,12-02-2021 12:00,24 hrs.,wallstreetbets,FAF,12,0,12,-12,2,2,0,2,NYSE
4594,12-02-2021 12:00,24 hrs.,wallstreetbets,FCF,225,0,225,-225,1,79,63,1,NYSE
4594,12-02-2021 12:00,24 hrs.,wallstreetbets,FCX,98,98,0,98,6,23,28,3,NYSE
4594,12-02-2021 12:00,24 hrs.,wallstreetbets,FLT,24,0,24,-24,4,4,0,3,NYSE
4594,12-02-2021 12:00,24 hrs.,wallstreetbets,FMS,13,7,6,1,2,2,1,2,NYSE
4594,12-02-2021 12:00,24 hrs.,wallstreetbets,FOF,6,6,0,6,1,1,0,1,NYSE
4594,12-02-2021 12:00,24 hrs.,wallstreetbets,FSD,18,0,18,-18,3,3,0,2,NYSE
4594,12-02-2021 12:00,24 hrs.,wallstreetbets,FSR,403,377,26,351,8,135,101,6,NYSE
4594,12-02-2021 12:00,24 hrs.,wallstreetbets,FTI,7,0,7,-7,1,1,1,1,NYSE
4594,12-02-2021 12:00,24 hrs.,wallstreetbets,GEL,6,0,6,-6,1,1,0,1,NYSE
4594,12-02-2021 12:00,24 hrs.,wallstreetbets,GEO,38,14,24,-10,6,6,2,3,NYSE
4594,12-02-2021 12:00,24 hrs.,wallstreetbets,GLW,7,7,0,7,1,1,1,1,NYSE
4594,12-02-2021 12:00,24 hrs.,wallstreetbets,GME,148634,17776,130858,-113082,528,61891,22740,422,NYSE
4594,12-02-2021 12:00,24 hrs.,wallstreetbets,GTT,6,0,6,-6,1,1,0,1,NYSE
4594,12-02-2021 12:00,24 hrs.,wallstreetbets,GUT,6,0,6,-6,1,1,0,1,NYSE
4594,12-02-2021 12:00,24 hrs.,wallstreetbets,HAL,6,0,6,-6,1,1,0,1,NYSE
4594,12-02-2021 12:00,24 hrs.,wallstreetbets,HII,12,0,12,-12,2,2,0,1,NYSE
4594,12-02-2021 12:00,24 hrs.,wallstreetbets,HON,6,6,0,6,1,1,0,1,NYSE
4594,12-02-2021 12:00,24 hrs.,wallstreetbets,HRB,102,0,102,-102,1,24,50,1,NYSE
4594,12-02-2021 12:00,24 hrs.,wallstreetbets,HRL,634,0,634,-634,1,249,132,1,NYSE
4594,12-02-2021 12:00,24 hrs.,wallstreetbets,HVT,55,0,55,-55,9,9,1,2,NYSE
4594,12-02-2021 12:00,24 hrs.,wallstreetbets,IAG,25,7,18,-11,4,4,1,3,NYSE
4594,12-02-2021 12:00,24 hrs.,wallstreetbets,IBM,12,0,12,-12,2,2,0,2,NYSE
4594,12-02-2021 12:00,24 hrs.,wallstreetbets,INN,6,0,6,-6,1,1,0,1,NYSE
4594,12-02-2021 12:00,24 hrs.,wallstreetbets,IVC,6,0,6,-6,1,1,0,1,NYSE
4594,12-02-2021 12:00,24 hrs.,Daytrading,MJNA,6,0,6,-6,1,1,0,1,OTC
4594,12-02-2021 12:00,24 hrs.,Daytrading,OWCP,6,0,6,-6,1,1,0,1,OTC
4594,12-02-2021 12:00,24 hrs.,Daytrading,RLTR,6,6,0,6,1,1,0,1,OTC
4594,12-02-2021 12:00,24 hrs.,Daytrading,TSTS,31,25,6,19,2,9,5,2,OTC
4594,12-02-2021 12:00,24 hrs.,Daytrading,MNKKQ,6,0,6,-6,1,1,0,1,OTC
4594,12-02-2021 12:00,24 hrs.,Daytrading,IGC,715,0,715,-715,1,291,129,1,AMEX
4594,12-02-2021 12:00,24 hrs.,Daytrading,MXC,6,6,0,6,1,1,0,1,AMEX
4594,12-02-2021 12:00,24 hrs.,Daytrading,TRX,6,6,0,6,1,1,0,1,AMEX
4594,12-02-2021 12:00,24 hrs.,Daytrading,ZOM,6,0,6,-6,1,1,0,1,AMEX
4594,12-02-2021 12:00,24 hrs.,Daytrading,TMBR,715,0,715,-715,1,291,129,1,AMEX
4594,12-02-2021 12:00,24 hrs.,Daytrading,TRXC,6,6,0,6,1,1,0,1,AMEX
4594,12-02-2021 12:00,24 hrs.,Daytrading,AMC,6,0,6,-6,1,1,0,1,NYSE
4594,12-02-2021 12:00,24 hrs.,Daytrading,ATH,777,0,777,-777,2,316,137,2,NYSE
4594,12-02-2021 12:00,24 hrs.,Daytrading,BFT,14,14,0,14,1,4,2,1,NYSE
4594,12-02-2021 12:00,24 hrs.,Daytrading,FSD,6,0,6,-6,1,1,0,1,NYSE
4594,12-02-2021 12:00,24 hrs.,Daytrading,FSR,62,0,62,-62,1,25,8,1,NYSE
4594,12-02-2021 12:00,24 hrs.,Daytrading,GME,6,6,0,6,1,1,0,1,NYSE
4594,12-02-2021 12:00,24 hrs.,Daytrading,MSM,19,0,19,-19,1,5,5,1,NYSE
4594,12-02-2021 12:00,24 hrs.,Daytrading,NOK,14,14,0,14,1,0,10,1,NYSE
4594,12-02-2021 12:00,24 hrs.,Daytrading,PDT,9,0,9,-9,1,2,1,1,NYSE
4594,12-02-2021 12:00,24 hrs.,Daytrading,SCI,6,6,0,6,1,1,0,1,NYSE
4594,12-02-2021 12:00,24 hrs.,Daytrading,TDA,11,0,11,-11,1,3,1,1,NYSE
4594,12-02-2021 12:00,24 hrs.,Daytrading,TSM,62,0,62,-62,1,25,8,1,NYSE
4594,12-02-2021 12:00,24 hrs.,Daytrading,WMT,6,0,6,-6,1,1,0,1,NYSE
4594,12-02-2021 12:00,24 hrs.,Daytrading,SPCE,7,7,0,7,1,1,1,1,NYSE
4594,12-02-2021 12:00,24 hrs.,Daytrading,AMD,72,10,62,-52,2,25,14,2,NASDAQ
4594,12-02-2021 12:00,24 hrs.,Daytrading,CGC,715,0,715,-715,1,291,129,1,NASDAQ
4594,12-02-2021 12:00,24 hrs.,Daytrading,OGI,11,11,0,11,1,0,7,1,NASDAQ
4594,12-02-2021 12:00,24 hrs.,Daytrading,RCM,112,0,112,-112,1,49,10,1,NASDAQ
4594,12-02-2021 12:00,24 hrs.,Daytrading,RUN,7,0,7,-7,1,1,1,1,NASDAQ
4594,12-02-2021 12:00,24 hrs.,Daytrading,ACIU,827,0,827,-827,2,340,139,2,NASDAQ
4594,12-02-2021 12:00,24 hrs.,Daytrading,AKER,715,0,715,-715,1,291,129,1,NASDAQ
4594,12-02-2021 12:00,24 hrs.,Daytrading,AMGN,8,0,8,-8,1,1,2,1,NASDAQ
4594,12-02-2021 12:00,24 hrs.,Daytrading,APHA,876,0,876,-876,5,339,178,4,NASDAQ
4594,12-02-2021 12:00,24 hrs.,Daytrading,AYRO,62,0,62,-62,1,25,8,1,NASDAQ
4594,12-02-2021 12:00,24 hrs.,Daytrading,AZRX,7,0,7,-7,1,1,1,1,NASDAQ
4594,12-02-2021 12:00,24 hrs.,Daytrading,BYND,6,6,0,6,1,1,0,1,NASDAQ
4594,12-02-2021 12:00,24 hrs.,Daytrading,CIIC,62,0,62,-62,1,25,8,1,NASDAQ
4594,12-02-2021 12:00,24 hrs.,Daytrading,CLSN,112,0,112,-112,1,49,10,1,NASDAQ
4594,12-02-2021 12:00,24 hrs.,wallstreetbets,LMT,13,7,6,1,2,2,1,2,NYSE
4594,12-02-2021 12:00,24 hrs.,wallstreetbets,LOW,957,0,957,-957,7,398,133,7,NYSE
4594,12-02-2021 12:00,24 hrs.,wallstreetbets,LTC,13,7,6,1,2,2,1,2,NYSE
4594,12-02-2021 12:00,24 hrs.,wallstreetbets,MEN,6,0,6,-6,1,1,0,1,NYSE
4594,12-02-2021 12:00,24 hrs.,wallstreetbets,MIN,7,0,7,-7,1,1,1,1,NYSE
4594,12-02-2021 12:00,24 hrs.,wallstreetbets,MRK,634,0,634,-634,1,249,132,1,NYSE
4594,12-02-2021 12:00,24 hrs.,wallstreetbets,MRO,12,6,6,0,2,2,0,2,NYSE
4594,12-02-2021 12:00,24 hrs.,wallstreetbets,MTL,6,6,0,6,1,1,0,1,NYSE
4594,12-02-2021 12:00,24 hrs.,wallstreetbets,NAT,25,7,18,-11,4,4,1,2,NYSE
4594,12-02-2021 12:00,24 hrs.,wallstreetbets,NAV,353,0,353,-353,1,104,141,1,NYSE
4594,12-02-2021 12:00,24 hrs.,wallstreetbets,NET,18,0,18,-18,3,3,0,2,NYSE
4594,12-02-2021 12:00,24 hrs.,wallstreetbets,NGA,6,6,0,6,1,1,0,1,NYSE
4594,12-02-2021 12:00,24 hrs.,wallstreetbets,NHI,6,0,6,-6,1,1,0,1,NYSE
4594,12-02-2021 12:00,24 hrs.,stocks,OPRX,23,23,0,23,1,3,13,1,NASDAQ
4594,12-02-2021 12:00,24 hrs.,stocks,OPTT,7,0,7,-7,1,1,1,1,NASDAQ
4594,12-02-2021 12:00,24 hrs.,stocks,PAAS,6,0,6,-6,1,1,0,1,NASDAQ
4594,12-02-2021 12:00,24 hrs.,stocks,PENN,7,7,0,7,1,1,1,1,NASDAQ
4594,12-02-2021 12:00,24 hrs.,stocks,PGNY,23,23,0,23,1,3,13,1,NASDAQ
4594,12-02-2021 12:00,24 hrs.,stocks,PLAY,7,0,7,-7,1,1,1,1,NASDAQ
4594,12-02-2021 12:00,24 hrs.,stocks,POWW,215,0,215,-215,2,78,51,2,NASDAQ
4594,12-02-2021 12:00,24 hrs.,stocks,PYPL,460,0,460,-460,2,184,84,2,NASDAQ
4594,12-02-2021 12:00,24 hrs.,stocks,QCOM,21,14,7,7,3,3,3,2,NASDAQ
4594,12-02-2021 12:00,24 hrs.,stocks,QQQM,61,21,40,-19,2,9,35,2,NASDAQ
4594,12-02-2021 12:00,24 hrs.,stocks,RDFN,16,0,16,-16,1,4,4,1,NASDAQ
4594,12-02-2021 12:00,24 hrs.,stocks,RGEN,23,23,0,23,1,3,13,1,NASDAQ
4594,12-02-2021 12:00,24 hrs.,wallstreetbets,PFE,12,6,6,0,2,2,0,2,NYSE
4594,12-02-2021 12:00,24 hrs.,wallstreetbets,PMO,19,7,12,-5,3,3,1,2,NYSE
4594,12-02-2021 12:00,24 hrs.,wallstreetbets,PPL,7,0,7,-7,1,1,1,1,NYSE
4594,12-02-2021 12:00,24 hrs.,wallstreetbets,PSA,1315,28,1287,-1259,6,519,253,6,NYSE
4594,12-02-2021 12:00,24 hrs.,wallstreetbets,PSX,1828,1828,0,1828,1,744,336,1,NYSE
4594,12-02-2021 12:00,24 hrs.,wallstreetbets,QSR,634,0,634,-634,1,249,132,1,NYSE
4594,12-02-2021 12:00,24 hrs.,wallstreetbets,RAD,76,0,76,-76,1,26,20,1,NYSE
4594,12-02-2021 12:00,24 hrs.,wallstreetbets,RCL,190,0,190,-190,1,63,60,1,NYSE
4594,12-02-2021 12:00,24 hrs.,wallstreetbets,RDY,6,6,0,6,1,1,0,1,NYSE
4594,12-02-2021 12:00,24 hrs.,wallstreetbets,RIG,6,0,6,-6,1,1,0,1,NYSE
4594,12-02-2021 12:00,24 hrs.,wallstreetbets,RKT,1209,233,976,-743,21,345,435,17,NYSE
4594,12-02-2021 12:00,24 hrs.,wallstreetbets,RMO,20,14,6,8,3,3,2,3,NYSE
4594,12-02-2021 12:00,24 hrs.,wallstreetbets,RSI,24,6,18,-12,4,4,0,3,NYSE
4594,12-02-2021 12:00,24 hrs.,wallstreetbets,RTX,7,7,0,7,1,1,1,1,NYSE
4594,12-02-2021 12:00,24 hrs.,wallstreetbets,SBE,18,6,12,-6,3,3,0,3,NYSE
4594,12-02-2021 12:00,24 hrs.,wallstreetbets,SBI,7,7,0,7,1,1,1,1,NYSE
4594,12-02-2021 12:00,24 hrs.,wallstreetbets,SCI,512,512,0,512,3,192,116,2,NYSE
4594,12-02-2021 12:00,24 hrs.,wallstreetbets,SCU,6,0,6,-6,1,1,0,1,NYSE
4594,12-02-2021 12:00,24 hrs.,wallstreetbets,SKM,25,25,0,25,1,0,21,1,NYSE
4594,12-02-2021 12:00,24 hrs.,wallstreetbets,SKT,26,14,12,2,4,4,2,3,NYSE
4594,12-02-2021 12:00,24 hrs.,wallstreetbets,SKY,6,0,6,-6,1,1,0,1,NYSE
4594,12-02-2021 12:00,24 hrs.,wallstreetbets,SMG,6,0,6,-6,1,1,0,1,NYSE
4594,12-02-2021 12:00,24 hrs.,wallstreetbets,SNP,6,0,6,-6,1,1,0,1,NYSE
4594,12-02-2021 12:00,24 hrs.,wallstreetbets,SNX,6,6,0,6,1,1,0,1,NYSE
4594,12-02-2021 12:00,24 hrs.,wallstreetbets,SOL,14,14,0,14,2,2,2,2,NYSE
4594,12-02-2021 12:00,24 hrs.,wallstreetbets,SOS,290,110,180,-70,46,45,16,34,NYSE
4594,12-02-2021 12:00,24 hrs.,wallstreetbets,SPG,58,52,6,46,2,1,48,2,NYSE
4594,12-02-2021 12:00,24 hrs.,wallstreetbets,SPH,13,13,0,13,2,2,1,2,NYSE
4594,12-02-2021 12:00,24 hrs.,wallstreetbets,STM,389,0,389,-389,1,139,107,1,NYSE
4594,12-02-2021 12:00,24 hrs.,wallstreetbets,SUN,19,6,13,-7,3,3,1,3,NYSE
4594,12-02-2021 12:00,24 hrs.,wallstreetbets,TAP,646,0,646,-646,3,251,132,3,NYSE
4594,12-02-2021 12:00,24 hrs.,wallstreetbets,TDA,1078,1071,7,1064,3,472,122,3,NYSE
4594,12-02-2021 12:00,24 hrs.,wallstreetbets,TDC,12,0,12,-12,2,2,0,2,NYSE
4594,12-02-2021 12:00,24 hrs.,wallstreetbets,TGT,7,0,7,-7,1,1,1,1,NYSE
4594,12-02-2021 12:00,24 hrs.,wallstreetbets,THC,90,0,90,-90,3,23,32,3,NYSE
4594,12-02-2021 12:00,24 hrs.,wallstreetbets,THR,14,0,14,-14,2,2,2,2,NYSE
4594,12-02-2021 12:00,24 hrs.,wallstreetbets,TPB,6,0,6,-6,1,1,0,1,NYSE
4594,12-02-2021 12:00,24 hrs.,wallstreetbets,TPX,634,0,634,-634,1,249,132,1,NYSE
4594,12-02-2021 12:00,24 hrs.,wallstreetbets,TRQ,6,6,0,6,1,1,0,1,NYSE
4594,12-02-2021 12:00,24 hrs.,wallstreetbets,TSE,188,0,188,-188,3,38,100,3,NYSE
4594,12-02-2021 12:00,24 hrs.,wallstreetbets,TSM,2262,12,2250,-2238,10,854,514,7,NYSE
4594,12-02-2021 12:00,24 hrs.,wallstreetbets,UBS,2072,20,2052,-2032,8,834,372,6,NYSE
4594,12-02-2021 12:00,24 hrs.,wallstreetbets,UMC,18,0,18,-18,3,3,0,3,NYSE
4594,12-02-2021 12:00,24 hrs.,wallstreetbets,USB,693,0,693,-693,1,268,153,1,NYSE
4594,12-02-2021 12:00,24 hrs.,wallstreetbets,UTZ,13,0,13,-13,2,2,1,1,NYSE
4594,12-02-2021 12:00,24 hrs.,wallstreetbets,VET,20,7,13,-6,3,3,2,3,NYSE
4594,12-02-2021 12:00,24 hrs.,wallstreetbets,VHC,6,0,6,-6,1,1,0,1,NYSE
4594,12-02-2021 12:00,24 hrs.,wallstreetbets,VST,18,0,18,-18,3,3,0,2,NYSE
4594,12-02-2021 12:00,24 hrs.,wallstreetbets,WFC,6,0,6,-6,1,1,0,1,NYSE
4594,12-02-2021 12:00,24 hrs.,wallstreetbets,WMT,19,7,12,-5,3,3,1,3,NYSE
4594,12-02-2021 12:00,24 hrs.,wallstreetbets,WWE,7,7,0,7,1,1,1,1,NYSE
4594,12-02-2021 12:00,24 hrs.,wallstreetbets,XOM,12,0,12,-12,2,2,0,2,NYSE
4594,12-02-2021 12:00,24 hrs.,stocks,XCUR,6,6,0,6,1,1,0,1,NASDAQ
4594,12-02-2021 12:00,24 hrs.,stocks,XERS,24,6,18,-12,3,5,2,3,NASDAQ
4594,12-02-2021 12:00,24 hrs.,stocks,XSPA,6,0,6,-6,1,1,0,1,NASDAQ
4594,12-02-2021 12:00,24 hrs.,stocks,ZNGA,110,0,110,-110,1,47,12,1,NASDAQ
4594,12-02-2021 12:00,24 hrs.,stocks,ZSAN,12,0,12,-12,2,2,0,2,NASDAQ
4594,12-02-2021 12:00,24 hrs.,stocks,ZYXI,23,23,0,23,1,3,13,1,NASDAQ
4594,12-02-2021 12:00,24 hrs.,Daytrading,AABB,25,25,0,25,1,8,5,1,OTC
4594,12-02-2021 12:00,24 hrs.,Daytrading,HCMC,25,25,0,25,1,8,5,1,OTC
4594,12-02-2021 12:00,24 hrs.,Daytrading,HMPQ,16,0,16,-16,1,4,4,1,OTC
4594,12-02-2021 12:00,24 hrs.,Daytrading,IDEA,6,6,0,6,1,1,0,1,OTC
4594,12-02-2021 12:00,24 hrs.,Daytrading,INKW,17,8,9,-1,2,4,1,2,OTC
4594,12-02-2021 12:00,24 hrs.,Daytrading,LVVV,25,25,0,25,1,8,5,1,OTC
4594,12-02-2021 12:00,24 hrs.,trakstocks,ZOM,62,0,62,-62,1,24,10,1,AMEX
4594,12-02-2021 12:00,24 hrs.,trakstocks,TRXC,53,53,0,53,1,21,7,1,AMEX
4594,12-02-2021 12:00,24 hrs.,trakstocks,UAVS,15,0,15,-15,1,4,3,1,AMEX
4594,12-02-2021 12:00,24 hrs.,trakstocks,UUUU,49,0,49,-49,1,13,19,1,AMEX
4594,12-02-2021 12:00,24 hrs.,trakstocks,AMC,39,0,39,-39,1,10,15,1,NYSE
4594,12-02-2021 12:00,24 hrs.,trakstocks,BFT,44,0,44,-44,1,11,18,1,NYSE
4594,12-02-2021 12:00,24 hrs.,trakstocks,CPS,41,41,0,41,1,17,3,1,NYSE
4594,12-02-2021 12:00,24 hrs.,trakstocks,GIK,63,0,63,-63,2,21,13,1,NYSE
4594,12-02-2021 12:00,24 hrs.,trakstocks,GME,39,0,39,-39,1,10,15,1,NYSE
4594,12-02-2021 12:00,24 hrs.,trakstocks,LEN,7,7,0,7,1,1,1,1,NYSE
4594,12-02-2021 12:00,24 hrs.,trakstocks,NAV,39,0,39,-39,1,10,15,1,NYSE
4594,12-02-2021 12:00,24 hrs.,trakstocks,PCG,39,0,39,-39,1,10,15,1,NYSE
4594,12-02-2021 12:00,24 hrs.,trakstocks,RKT,39,0,39,-39,1,10,15,1,NYSE
4594,12-02-2021 12:00,24 hrs.,trakstocks,SOS,53,0,53,-53,1,24,1,1,NYSE
4594,12-02-2021 12:00,24 hrs.,trakstocks,SPH,10,10,0,10,1,3,0,1,NYSE
4594,12-02-2021 12:00,24 hrs.,trakstocks,WPF,6,0,6,-6,1,1,0,1,NYSE
4594,12-02-2021 12:00,24 hrs.,trakstocks,BEKE,39,0,39,-39,1,10,15,1,NYSE
4594,12-02-2021 12:00,24 hrs.,trakstocks,CCIV,37,23,14,9,4,7,7,4,NYSE
4594,12-02-2021 12:00,24 hrs.,trakstocks,FUSE,6,0,6,-6,1,1,0,1,NYSE
4594,12-02-2021 12:00,24 hrs.,trakstocks,IIPR,12,0,12,-12,1,4,0,1,NYSE
4594,12-02-2021 12:00,24 hrs.,trakstocks,MDLY,6,0,6,-6,1,1,0,1,NYSE
4594,12-02-2021 12:00,24 hrs.,trakstocks,SKLZ,6,6,0,6,1,1,0,1,NYSE
4594,12-02-2021 12:00,24 hrs.,trakstocks,STIC,17,17,0,17,1,6,1,1,NYSE
4594,12-02-2021 12:00,24 hrs.,trakstocks,STPK,84,0,84,-84,3,27,18,3,NYSE
4594,12-02-2021 12:00,24 hrs.,trakstocks,CFO,255,0,255,-255,1,106,39,1,NASDAQ
4594,12-02-2021 12:00,24 hrs.,trakstocks,HOL,44,0,44,-44,1,11,18,1,NASDAQ
4594,12-02-2021 12:00,24 hrs.,trakstocks,PTE,19,0,19,-19,1,5,5,1,NASDAQ
4594,12-02-2021 12:00,24 hrs.,trakstocks,ABEO,29,6,23,-17,2,9,3,2,NASDAQ
4594,12-02-2021 12:00,24 hrs.,trakstocks,AESE,16,0,16,-16,1,4,4,1,NASDAQ
4594,12-02-2021 12:00,24 hrs.,trakstocks,AYRO,590,0,590,-590,4,231,112,4,NASDAQ
4594,12-02-2021 12:00,24 hrs.,trakstocks,BTBT,13,0,13,-13,1,3,3,1,NASDAQ
4594,12-02-2021 12:00,24 hrs.,trakstocks,CHEF,26,26,0,26,1,8,6,1,NASDAQ
4594,12-02-2021 12:00,24 hrs.,trakstocks,CPSH,55,55,0,55,2,21,5,2,NASDAQ
4594,12-02-2021 12:00,24 hrs.,trakstocks,CRNT,25,0,25,-25,1,9,3,1,NASDAQ
4594,12-02-2021 12:00,24 hrs.,Daytrading,CLVR,715,0,715,-715,1,291,129,1,NASDAQ
4594,12-02-2021 12:00,24 hrs.,Daytrading,COST,6,0,6,-6,1,1,0,1,NASDAQ
4594,12-02-2021 12:00,24 hrs.,Daytrading,CRBP,715,0,715,-715,1,291,129,1,NASDAQ
4594,12-02-2021 12:00,24 hrs.,Daytrading,CRWD,62,0,62,-62,1,25,8,1,NASDAQ
4594,12-02-2021 12:00,24 hrs.,Daytrading,CTRM,112,0,112,-112,1,49,10,1,NASDAQ
4594,12-02-2021 12:00,24 hrs.,Daytrading,DMTK,715,0,715,-715,1,291,129,1,NASDAQ
4594,12-02-2021 12:00,24 hrs.,Daytrading,ENVB,715,0,715,-715,1,291,129,1,NASDAQ
4594,12-02-2021 12:00,24 hrs.,Daytrading,EXPE,4,4,0,4,1,0,0,1,NASDAQ
4594,12-02-2021 12:00,24 hrs.,Daytrading,GEVO,834,0,834,-834,2,330,166,2,NASDAQ
4594,12-02-2021 12:00,24 hrs.,Daytrading,GNLN,6,0,6,-6,1,1,0,1,NASDAQ
4594,12-02-2021 12:00,24 hrs.,wallstreetbets,XPO,634,0,634,-634,1,249,132,1,NYSE
4594,12-02-2021 12:00,24 hrs.,wallstreetbets,ABBV,6,0,6,-6,1,1,0,1,NYSE
4594,12-02-2021 12:00,24 hrs.,wallstreetbets,ACIC,43,7,36,-29,7,7,1,5,NYSE
4594,12-02-2021 12:00,24 hrs.,wallstreetbets,ALUS,6,0,6,-6,1,1,0,1,NYSE
4594,12-02-2021 12:00,24 hrs.,wallstreetbets,AQUA,6,0,6,-6,1,1,0,1,NYSE
4594,12-02-2021 12:00,24 hrs.,wallstreetbets,BABA,19,13,6,7,3,3,1,3,NYSE
4594,12-02-2021 12:00,24 hrs.,wallstreetbets,BEKE,353,0,353,-353,1,104,141,1,NYSE
4594,12-02-2021 12:00,24 hrs.,wallstreetbets,BORR,6,0,6,-6,1,1,0,1,NYSE
4594,12-02-2021 12:00,24 hrs.,wallstreetbets,NIO,433,341,92,249,21,77,195,16,NYSE
4594,12-02-2021 12:00,24 hrs.,wallstreetbets,NOC,7,7,0,7,1,1,1,1,NYSE
4594,12-02-2021 12:00,24 hrs.,wallstreetbets,NOK,333,82,251,-169,53,54,13,42,NYSE
4594,12-02-2021 12:00,24 hrs.,wallstreetbets,NVO,66,6,60,-54,7,6,26,4,NYSE
4594,12-02-2021 12:00,24 hrs.,wallstreetbets,NYC,7,7,0,7,1,1,1,1,NYSE
4594,12-02-2021 12:00,24 hrs.,wallstreetbets,OGE,7,7,0,7,1,1,1,1,NYSE
4594,12-02-2021 12:00,24 hrs.,wallstreetbets,OPP,7,7,0,7,1,1,1,1,NYSE
4594,12-02-2021 12:00,24 hrs.,wallstreetbets,OPY,6,0,6,-6,1,1,0,1,NYSE
4594,12-02-2021 12:00,24 hrs.,wallstreetbets,OXY,13,6,7,-1,2,2,1,2,NYSE
4594,12-02-2021 12:00,24 hrs.,wallstreetbets,PCG,353,0,353,-353,1,104,141,1,NYSE
4594,12-02-2021 12:00,24 hrs.,wallstreetbets,PDT,13,13,0,13,2,2,1,2,NYSE
4594,12-02-2021 12:00,24 hrs.,wallstreetbets,PEG,225,0,225,-225,1,79,63,1,NYSE
4594,12-02-2021 12:00,24 hrs.,wallstreetbets,FUBO,20,14,6,8,3,3,2,3,NYSE
4594,12-02-2021 12:00,24 hrs.,wallstreetbets,FUSE,6,0,6,-6,1,1,0,1,NYSE
4594,12-02-2021 12:00,24 hrs.,wallstreetbets,FVRR,14,8,6,2,2,2,2,2,NYSE
4594,12-02-2021 12:00,24 hrs.,wallstreetbets,GNRC,634,0,634,-634,1,249,132,1,NYSE
4594,12-02-2021 12:00,24 hrs.,wallstreetbets,GRUB,6,0,6,-6,1,1,0,1,NYSE
4594,12-02-2021 12:00,24 hrs.,wallstreetbets,HEXO,31,0,31,-31,5,5,1,5,NYSE
4594,12-02-2021 12:00,24 hrs.,wallstreetbets,HUYA,194,21,173,-152,8,69,24,7,NYSE
4594,12-02-2021 12:00,24 hrs.,wallstreetbets,HYLN,2300,62,2238,-2176,65,801,438,57,NYSE
4594,12-02-2021 12:00,24 hrs.,wallstreetbets,IIPR,180,0,180,-180,2,36,100,2,NYSE
4594,12-02-2021 12:00,24 hrs.,wallstreetbets,IPOD,18,0,18,-18,3,3,0,1,NYSE
4594,12-02-2021 12:00,24 hrs.,wallstreetbets,IPOE,54,6,48,-42,9,9,0,7,NYSE
4594,12-02-2021 12:00,24 hrs.,wallstreetbets,IPOF,18,0,18,-18,3,3,0,1,NYSE
4594,12-02-2021 12:00,24 hrs.,wallstreetbets,JMIA,6,0,6,-6,1,1,0,1,NYSE
4594,12-02-2021 12:00,24 hrs.,wallstreetbets,KODK,12,0,12,-12,2,2,0,2,NYSE
4594,12-02-2021 12:00,24 hrs.,wallstreetbets,LDOS,6,0,6,-6,1,1,0,1,NYSE
4594,12-02-2021 12:00,24 hrs.,wallstreetbets,LEAP,12,0,12,-12,2,2,0,2,NYSE
4594,12-02-2021 12:00,24 hrs.,wallstreetbets,LGVW,34,27,7,20,5,5,4,4,NYSE
4594,12-02-2021 12:00,24 hrs.,wallstreetbets,LMND,12,0,12,-12,2,2,0,1,NYSE
4594,12-02-2021 12:00,24 hrs.,wallstreetbets,LSPD,7,7,0,7,1,1,1,1,NYSE
4594,12-02-2021 12:00,24 hrs.,wallstreetbets,LUMN,46,0,46,-46,4,3,24,4,NYSE
4594,12-02-2021 12:00,24 hrs.,wallstreetbets,MAIN,14,7,7,0,2,2,2,2,NYSE
4594,12-02-2021 12:00,24 hrs.,wallstreetbets,MAXR,6,0,6,-6,1,1,0,1,NYSE
4594,12-02-2021 12:00,24 hrs.,wallstreetbets,MDLY,19,0,19,-19,3,3,1,1,NYSE
4594,12-02-2021 12:00,24 hrs.,wallstreetbets,NVTA,12,0,12,-12,2,2,0,1,NYSE
4594,12-02-2021 12:00,24 hrs.,wallstreetbets,ORAN,6,0,6,-6,1,1,0,1,NYSE
4594,12-02-2021 12:00,24 hrs.,wallstreetbets,PGRE,6,0,6,-6,1,1,0,1,NYSE
4594,12-02-2021 12:00,24 hrs.,wallstreetbets,PINS,654,7,647,-640,4,252,134,4,NYSE
4594,12-02-2021 12:00,24 hrs.,wallstreetbets,PLNT,6,0,6,-6,1,1,0,1,NYSE
4594,12-02-2021 12:00,24 hrs.,wallstreetbets,PLTR,1305,113,1192,-1079,45,418,289,30,NYSE
4594,12-02-2021 12:00,24 hrs.,wallstreetbets,PRTY,6,0,6,-6,1,1,0,1,NYSE
4594,12-02-2021 12:00,24 hrs.,wallstreetbets,PSXP,12,0,12,-12,2,2,0,2,NYSE
4594,12-02-2021 12:00,24 hrs.,wallstreetbets,PUMP,6,0,6,-6,1,1,0,1,NYSE
4594,12-02-2021 12:00,24 hrs.,wallstreetbets,QUAD,8,8,0,8,1,1,2,1,NYSE
4594,12-02-2021 12:00,24 hrs.,wallstreetbets,SCVX,6,6,0,6,1,1,0,1,NYSE
4594,12-02-2021 12:00,24 hrs.,Daytrading,GOEV,62,0,62,-62,1,25,8,1,NASDAQ
4594,12-02-2021 12:00,24 hrs.,Daytrading,GRNQ,715,0,715,-715,1,291,129,1,NASDAQ
4594,12-02-2021 12:00,24 hrs.,Daytrading,IBKR,25,13,12,1,2,3,11,2,NASDAQ
4594,12-02-2021 12:00,24 hrs.,Daytrading,ITRM,6,0,6,-6,1,1,0,1,NASDAQ
4594,12-02-2021 12:00,24 hrs.,Daytrading,MARA,715,0,715,-715,1,291,129,1,NASDAQ
4594,12-02-2021 12:00,24 hrs.,Daytrading,MESA,6,0,6,-6,1,1,0,1,NASDAQ
4594,12-02-2021 12:00,24 hrs.,Daytrading,MESO,715,0,715,-715,1,291,129,1,NASDAQ
4594,12-02-2021 12:00,24 hrs.,Daytrading,MNPR,827,0,827,-827,2,340,139,2,NASDAQ
4594,12-02-2021 12:00,24 hrs.,Daytrading,MOGO,715,0,715,-715,1,291,129,1,NASDAQ
4594,12-02-2021 12:00,24 hrs.,Daytrading,MOMO,62,0,62,-62,1,25,8,1,NASDAQ
4594,12-02-2021 12:00,24 hrs.,Daytrading,MTEM,119,0,119,-119,1,39,37,1,NASDAQ
4594,12-02-2021 12:00,24 hrs.,Daytrading,MVIS,715,0,715,-715,1,291,129,1,NASDAQ
4594,12-02-2021 12:00,24 hrs.,Daytrading,NNOX,715,0,715,-715,1,291,129,1,NASDAQ
4594,12-02-2021 12:00,24 hrs.,Daytrading,OCGN,6,0,6,-6,1,1,0,1,NASDAQ
4594,12-02-2021 12:00,24 hrs.,Daytrading,PLAY,10,10,0,10,1,0,6,1,NASDAQ
4594,12-02-2021 12:00,24 hrs.,Daytrading,PLUS,7,7,0,7,1,1,1,1,NASDAQ
4594,12-02-2021 12:00,24 hrs.,Daytrading,RCMT,827,0,827,-827,2,340,139,2,NASDAQ
4594,12-02-2021 12:00,24 hrs.,Daytrading,RIOT,946,0,946,-946,3,379,176,3,NASDAQ
4594,12-02-2021 12:00,24 hrs.,Daytrading,SNDL,982,11,971,-960,6,385,188,6,NASDAQ
4594,12-02-2021 12:00,24 hrs.,Daytrading,TLRY,887,11,876,-865,5,341,185,5,NASDAQ
4594,12-02-2021 12:00,24 hrs.,Daytrading,ZYNE,119,0,119,-119,1,39,37,1,NASDAQ
4594,12-02-2021 12:00,24 hrs.,trakstocks,BRGO,6,0,6,-6,1,1,0,1,OTC
4594,12-02-2021 12:00,24 hrs.,trakstocks,BRLL,13,0,13,-13,1,4,1,1,OTC
4594,12-02-2021 12:00,24 hrs.,trakstocks,SGSI,12,0,12,-12,1,4,0,1,OTC
4594,12-02-2021 12:00,24 hrs.,trakstocks,SMVI,6,0,6,-6,1,1,0,1,OTC
4594,12-02-2021 12:00,24 hrs.,trakstocks,SNPW,12,0,12,-12,1,2,4,1,OTC
4594,12-02-2021 12:00,24 hrs.,trakstocks,SUIC,6,6,0,6,1,1,0,1,OTC
4594,12-02-2021 12:00,24 hrs.,trakstocks,DFLYF,61,0,61,-61,1,19,19,1,OTC
4594,12-02-2021 12:00,24 hrs.,trakstocks,HUTMF,14,0,14,-14,1,2,6,1,OTC
4594,12-02-2021 12:00,24 hrs.,trakstocks,VVCIF,14,0,14,-14,1,3,4,1,OTC
4594,12-02-2021 12:00,24 hrs.,StockMarket,ITP,8,8,0,8,1,1,2,1,AMEX
4594,12-02-2021 12:00,24 hrs.,wallstreetbets,SHAK,18,0,18,-18,3,3,0,1,NYSE
4594,12-02-2021 12:00,24 hrs.,wallstreetbets,SHOP,946,7,939,-932,5,396,134,3,NYSE
4594,12-02-2021 12:00,24 hrs.,wallstreetbets,SLCA,6,0,6,-6,1,1,0,1,NYSE
4594,12-02-2021 12:00,24 hrs.,wallstreetbets,SNOW,6,0,6,-6,1,1,0,1,NYSE
4594,12-02-2021 12:00,24 hrs.,wallstreetbets,SNPR,6,0,6,-6,1,1,0,1,NYSE
4594,12-02-2021 12:00,24 hrs.,wallstreetbets,SPCE,3039,485,2554,-2069,34,1203,497,29,NYSE
4594,12-02-2021 12:00,24 hrs.,wallstreetbets,SPOT,7,0,7,-7,1,1,1,1,NYSE
4594,12-02-2021 12:00,24 hrs.,wallstreetbets,STNG,6,0,6,-6,1,1,0,1,NYSE
4594,12-02-2021 12:00,24 hrs.,wallstreetbets,STPK,12,0,12,-12,2,2,0,2,NYSE
4594,12-02-2021 12:00,24 hrs.,wallstreetbets,TDOC,6,6,0,6,1,1,0,1,NYSE
4594,12-02-2021 12:00,24 hrs.,wallstreetbets,TEVA,12,0,12,-12,2,2,0,2,NYSE
4594,12-02-2021 12:00,24 hrs.,wallstreetbets,TWTR,6,0,6,-6,1,1,0,1,NYSE
4594,12-02-2021 12:00,24 hrs.,wallstreetbets,UBER,679,33,646,-613,8,256,135,5,NYSE
4594,12-02-2021 12:00,24 hrs.,wallstreetbets,UNVR,6,0,6,-6,1,1,0,1,NYSE
4594,12-02-2021 12:00,24 hrs.,wallstreetbets,VSTO,8,0,8,-8,1,1,2,1,NYSE
4594,12-02-2021 12:00,24 hrs.,wallstreetbets,WELL,316,0,316,-316,1,119,74,1,NYSE
4594,12-02-2021 12:00,24 hrs.,wallstreetbets,WORK,54,47,7,40,3,15,12,3,NYSE
4594,12-02-2021 12:00,24 hrs.,wallstreetbets,XPEV,13,7,6,1,2,2,1,2,NYSE
4594,12-02-2021 12:00,24 hrs.,wallstreetbets,YALA,6,0,6,-6,1,1,0,1,NYSE
4594,12-02-2021 12:00,24 hrs.,wallstreetbets,YETI,12,0,12,-12,2,2,0,1,NYSE
4594,12-02-2021 12:00,24 hrs.,wallstreetbets,AAL,75,27,48,-21,12,12,3,6,NASDAQ
4594,12-02-2021 12:00,24 hrs.,wallstreetbets,ADI,389,0,389,-389,1,139,107,1,NASDAQ
4594,12-02-2021 12:00,24 hrs.,wallstreetbets,ADV,6,0,6,-6,1,1,0,1,NASDAQ
4594,12-02-2021 12:00,24 hrs.,wallstreetbets,AMD,2326,625,1701,-1076,27,835,548,26,NASDAQ
4594,12-02-2021 12:00,24 hrs.,wallstreetbets,AQB,12,6,6,0,2,2,0,2,NASDAQ
4594,12-02-2021 12:00,24 hrs.,wallstreetbets,ASO,18,0,18,-18,3,3,0,2,NASDAQ
4594,12-02-2021 12:00,24 hrs.,wallstreetbets,AWH,13,0,13,-13,2,2,1,1,NASDAQ
4594,12-02-2021 12:00,24 hrs.,wallstreetbets,AZN,18,0,18,-18,3,3,0,3,NASDAQ
4594,12-02-2021 12:00,24 hrs.,wallstreetbets,BBC,12,0,12,-12,2,2,0,2,NASDAQ
4594,12-02-2021 12:00,24 hrs.,wallstreetbets,BFI,25,7,18,-11,4,4,1,2,NASDAQ
4594,12-02-2021 12:00,24 hrs.,wallstreetbets,CGC,1286,1072,214,858,17,440,338,16,NASDAQ
4594,12-02-2021 12:00,24 hrs.,wallstreetbets,DYN,6,0,6,-6,1,1,0,1,NASDAQ
4594,12-02-2021 12:00,24 hrs.,wallstreetbets,ESG,8,8,0,8,1,1,2,1,NASDAQ
4594,12-02-2021 12:00,24 hrs.,trakstocks,CTRM,125,0,125,-125,3,48,17,2,NASDAQ
4594,12-02-2021 12:00,24 hrs.,trakstocks,DARE,6,0,6,-6,1,1,0,1,NASDAQ
4594,12-02-2021 12:00,24 hrs.,trakstocks,EXPC,21,21,0,21,1,8,1,1,NASDAQ
4594,12-02-2021 12:00,24 hrs.,trakstocks,FUTU,39,0,39,-39,1,10,15,1,NASDAQ
4594,12-02-2021 12:00,24 hrs.,trakstocks,GEVO,73,73,0,73,1,30,9,1,NASDAQ
4594,12-02-2021 12:00,24 hrs.,trakstocks,GHIV,39,0,39,-39,1,10,15,1,NASDAQ
4594,12-02-2021 12:00,24 hrs.,trakstocks,GHSI,6,0,6,-6,1,1,0,1,NASDAQ
4594,12-02-2021 12:00,24 hrs.,trakstocks,GMBL,16,0,16,-16,1,4,4,1,NASDAQ
4594,12-02-2021 12:00,24 hrs.,trakstocks,GMDA,12,0,12,-12,1,1,6,1,NASDAQ
4594,12-02-2021 12:00,24 hrs.,trakstocks,IBKR,39,0,39,-39,1,10,15,1,NASDAQ
4594,12-02-2021 12:00,24 hrs.,trakstocks,INMD,8,0,8,-8,1,2,0,1,NASDAQ
4594,12-02-2021 12:00,24 hrs.,trakstocks,INPX,20,0,20,-20,1,8,0,1,NASDAQ
4594,12-02-2021 12:00,24 hrs.,trakstocks,IRBT,27,0,27,-27,1,8,7,1,NASDAQ
4594,12-02-2021 12:00,24 hrs.,wallstreetbets,CCIV,172,84,88,-4,25,25,22,21,NYSE
4594,12-02-2021 12:00,24 hrs.,wallstreetbets,CLDR,120,120,0,120,1,32,52,1,NYSE
4594,12-02-2021 12:00,24 hrs.,wallstreetbets,CLII,24,0,24,-24,4,4,0,3,NYSE
4594,12-02-2021 12:00,24 hrs.,wallstreetbets,CODI,6,0,6,-6,1,1,0,1,NYSE
4594,12-02-2021 12:00,24 hrs.,wallstreetbets,CORR,6,0,6,-6,1,1,0,1,NYSE
4594,12-02-2021 12:00,24 hrs.,wallstreetbets,COTY,18,0,18,-18,3,3,0,1,NYSE
4594,12-02-2021 12:00,24 hrs.,wallstreetbets,CSPR,6,0,6,-6,1,1,0,1,NYSE
4594,12-02-2021 12:00,24 hrs.,wallstreetbets,CURO,13,0,13,-13,2,2,1,1,NYSE
4594,12-02-2021 12:00,24 hrs.,wallstreetbets,DASH,514,27,487,-460,4,167,164,3,NYSE
4594,12-02-2021 12:00,24 hrs.,wallstreetbets,DECK,7,0,7,-7,1,1,1,1,NYSE
4594,12-02-2021 12:00,24 hrs.,wallstreetbets,DMYD,6,0,6,-6,1,1,0,1,NYSE
4594,12-02-2021 12:00,24 hrs.,wallstreetbets,DNMR,7,0,7,-7,1,1,1,1,NYSE
4594,12-02-2021 12:00,24 hrs.,wallstreetbets,DOOR,6,0,6,-6,1,1,0,1,NYSE
4594,12-02-2021 12:00,24 hrs.,wallstreetbets,ENLC,6,0,6,-6,1,1,0,1,NYSE
4594,12-02-2021 12:00,24 hrs.,wallstreetbets,EXPR,8,0,8,-8,1,2,0,1,NYSE
4594,12-02-2021 12:00,24 hrs.,wallstreetbets,FENG,6,6,0,6,1,1,0,1,NYSE
4594,12-02-2021 12:00,24 hrs.,wallstreetbets,FINV,14,0,14,-14,2,2,2,1,NYSE
4594,12-02-2021 12:00,24 hrs.,wallstreetbets,MWK,8,0,8,-8,1,2,0,1,NASDAQ
4594,12-02-2021 12:00,24 hrs.,wallstreetbets,NPA,7,0,7,-7,1,1,1,1,NASDAQ
4594,12-02-2021 12:00,24 hrs.,wallstreetbets,OGI,578,41,537,-496,42,117,176,38,NASDAQ
4594,12-02-2021 12:00,24 hrs.,wallstreetbets,OPK,6,0,6,-6,1,1,0,1,NASDAQ
4594,12-02-2021 12:00,24 hrs.,wallstreetbets,OPT,13,0,13,-13,2,2,1,2,NASDAQ
4594,12-02-2021 12:00,24 hrs.,wallstreetbets,PEP,634,0,634,-634,1,249,132,1,NASDAQ
4594,12-02-2021 12:00,24 hrs.,wallstreetbets,PTE,35,35,0,35,5,5,5,1,NASDAQ
4594,12-02-2021 12:00,24 hrs.,wallstreetbets,QQQ,927,0,927,-927,2,393,133,2,NASDAQ
4594,12-02-2021 12:00,24 hrs.,wallstreetbets,QTT,6,0,6,-6,1,1,0,1,NASDAQ
4594,12-02-2021 12:00,24 hrs.,wallstreetbets,RCM,6,0,6,-6,1,1,0,1,NASDAQ
4594,12-02-2021 12:00,24 hrs.,wallstreetbets,RUN,25,7,18,-11,4,4,1,4,NASDAQ
4594,12-02-2021 12:00,24 hrs.,wallstreetbets,SDC,6,0,6,-6,1,1,0,1,NASDAQ
4594,12-02-2021 12:00,24 hrs.,wallstreetbets,SLS,6,0,6,-6,1,1,0,1,NASDAQ
4594,12-02-2021 12:00,24 hrs.,trakstocks,LKCO,21,0,21,-21,1,7,3,1,NASDAQ
4594,12-02-2021 12:00,24 hrs.,trakstocks,MARA,27,0,27,-27,2,5,9,2,NASDAQ
4594,12-02-2021 12:00,24 hrs.,trakstocks,MSTR,4,0,4,-4,1,0,0,1,NASDAQ
4594,12-02-2021 12:00,24 hrs.,trakstocks,OBSV,14,0,14,-14,1,5,0,1,NASDAQ
4594,12-02-2021 12:00,24 hrs.,trakstocks,RIOT,33,0,33,-33,3,6,9,3,NASDAQ
4594,12-02-2021 12:00,24 hrs.,trakstocks,SNGX,28,0,28,-28,1,10,4,1,NASDAQ
4594,12-02-2021 12:00,24 hrs.,trakstocks,TTCF,26,26,0,26,1,8,6,1,NASDAQ
4594,12-02-2021 12:00,24 hrs.,trakstocks,USWS,185,0,185,-185,2,70,37,2,NASDAQ
4594,12-02-2021 12:00,24 hrs.,trakstocks,VNDA,8,8,0,8,1,2,0,1,NASDAQ
4594,12-02-2021 12:00,24 hrs.,trakstocks,VRME,8,8,0,8,1,2,0,1,NASDAQ
4594,12-02-2021 12:00,24 hrs.,trakstocks,VTRS,7,0,7,-7,1,1,1,1,NASDAQ
4594,12-02-2021 12:00,24 hrs.,trakstocks,XSPA,11,11,0,11,1,2,3,1,NASDAQ
4594,12-02-2021 12:00,24 hrs.,trakstocks,HOLUW,8,0,8,-8,1,1,2,1,NASDAQ
4594,12-02-2021 12:00,24 hrs.,StockMarket,BIIO,6,0,6,-6,1,1,0,1,OTC
4594,12-02-2021 12:00,24 hrs.,StockMarket,BLDV,21,0,21,-21,1,6,5,1,OTC
4594,12-02-2021 12:00,24 hrs.,StockMarket,BOTY,40,36,4,32,3,5,18,2,OTC
4594,12-02-2021 12:00,24 hrs.,StockMarket,CAPC,6,0,6,-6,1,1,0,1,OTC
4594,12-02-2021 12:00,24 hrs.,StockMarket,DIGI,6,6,0,6,1,1,0,1,OTC
4594,12-02-2021 12:00,24 hrs.,StockMarket,FMCC,58,58,0,58,1,15,24,1,OTC
4594,12-02-2021 12:00,24 hrs.,StockMarket,FNMA,58,58,0,58,1,15,24,1,OTC
4594,12-02-2021 12:00,24 hrs.,StockMarket,GAXY,22,0,22,-22,1,9,0,1,OTC
4594,12-02-2021 12:00,24 hrs.,StockMarket,GDMK,6,0,6,-6,1,1,0,1,OTC
4594,12-02-2021 12:00,24 hrs.,StockMarket,GTSO,11,0,11,-11,1,3,1,1,OTC
4594,12-02-2021 12:00,24 hrs.,StockMarket,HCMC,25,25,0,25,2,7,3,2,OTC
4594,12-02-2021 12:00,24 hrs.,StockMarket,ISWH,6,0,6,-6,1,1,0,1,OTC
4594,12-02-2021 12:00,24 hrs.,StockMarket,LINK,26,0,26,-26,1,10,2,1,OTC
4594,12-02-2021 12:00,24 hrs.,StockMarket,MJNA,6,0,6,-6,1,1,0,1,OTC
4594,12-02-2021 12:00,24 hrs.,StockMarket,MOST,26,0,26,-26,1,10,2,1,OTC
4594,12-02-2021 12:00,24 hrs.,StockMarket,NSPX,6,0,6,-6,1,1,0,1,OTC
4594,12-02-2021 12:00,24 hrs.,StockMarket,OPMZ,6,0,6,-6,1,1,0,1,OTC
4594,12-02-2021 12:00,24 hrs.,StockMarket,PURA,6,0,6,-6,1,1,0,1,OTC
4594,12-02-2021 12:00,24 hrs.,StockMarket,RLTR,6,6,0,6,1,1,0,1,OTC
4594,12-02-2021 12:00,24 hrs.,StockMarket,RTON,12,6,6,0,2,2,0,2,OTC
4594,12-02-2021 12:00,24 hrs.,StockMarket,SGMD,12,0,12,-12,1,2,4,1,OTC
4594,12-02-2021 12:00,24 hrs.,StockMarket,SIRC,6,0,6,-6,1,1,0,1,OTC
4594,12-02-2021 12:00,24 hrs.,StockMarket,SRMX,6,0,6,-6,1,1,0,1,OTC
4594,12-02-2021 12:00,24 hrs.,StockMarket,SUIC,6,6,0,6,1,1,0,1,OTC
4594,12-02-2021 12:00,24 hrs.,StockMarket,VIBI,13,0,13,-13,1,0,9,1,OTC
4594,12-02-2021 12:00,24 hrs.,StockMarket,XALL,6,0,6,-6,1,1,0,1,OTC
4594,12-02-2021 12:00,24 hrs.,StockMarket,ABEPF,6,0,6,-6,1,1,0,1,OTC
4594,12-02-2021 12:00,24 hrs.,StockMarket,CLUBQ,21,0,21,-21,2,2,9,1,OTC
4594,12-02-2021 12:00,24 hrs.,StockMarket,CWGYF,29,0,29,-29,1,1,23,1,OTC
4594,12-02-2021 12:00,24 hrs.,StockMarket,HITIF,79,0,79,-79,1,20,35,1,OTC
4594,12-02-2021 12:00,24 hrs.,StockMarket,HRVOF,6,0,6,-6,1,1,0,1,OTC
4594,12-02-2021 12:00,24 hrs.,StockMarket,MNKKQ,12,0,12,-12,2,2,0,1,OTC
4594,12-02-2021 12:00,24 hrs.,StockMarket,NXGWF,19,19,0,19,1,7,1,1,OTC
4594,12-02-2021 12:00,24 hrs.,StockMarket,OILFF,4,0,4,-4,1,0,0,1,OTC
4594,12-02-2021 12:00,24 hrs.,StockMarket,RYCEY,14,6,8,-2,2,1,4,2,OTC
4594,12-02-2021 12:00,24 hrs.,StockMarket,DNN,23,23,0,23,1,5,9,1,AMEX
4594,12-02-2021 12:00,24 hrs.,StockMarket,GSV,29,0,29,-29,1,5,15,1,AMEX
4594,12-02-2021 12:00,24 hrs.,StockMarket,IGC,16,0,16,-16,1,5,2,1,AMEX
4594,12-02-2021 12:00,24 hrs.,wallstreetbets,APRE,12,0,12,-12,2,2,0,1,NASDAQ
4594,12-02-2021 12:00,24 hrs.,wallstreetbets,APXT,35,29,6,23,5,5,5,4,NASDAQ
4594,12-02-2021 12:00,24 hrs.,wallstreetbets,AQMS,7,7,0,7,1,1,1,1,NASDAQ
4594,12-02-2021 12:00,24 hrs.,wallstreetbets,AQST,6,6,0,6,1,1,0,1,NASDAQ
4594,12-02-2021 12:00,24 hrs.,wallstreetbets,ARAY,6,0,6,-6,1,1,0,1,NASDAQ
4594,12-02-2021 12:00,24 hrs.,wallstreetbets,ARCT,18,0,18,-18,3,3,0,1,NASDAQ
4594,12-02-2021 12:00,24 hrs.,wallstreetbets,ARTL,7,7,0,7,1,1,1,1,NASDAQ
4594,12-02-2021 12:00,24 hrs.,wallstreetbets,ASML,21,12,9,3,3,3,3,2,NASDAQ
4594,12-02-2021 12:00,24 hrs.,wallstreetbets,ASRT,30,0,30,-30,5,5,0,5,NASDAQ
4594,12-02-2021 12:00,24 hrs.,wallstreetbets,ATEC,6,0,6,-6,1,1,0,1,NASDAQ
4594,12-02-2021 12:00,24 hrs.,wallstreetbets,ATHA,6,0,6,-6,1,1,0,1,NASDAQ
4594,12-02-2021 12:00,24 hrs.,wallstreetbets,ATHX,37,7,30,-23,6,6,1,3,NASDAQ
4594,12-02-2021 12:00,24 hrs.,wallstreetbets,ATNF,25,0,25,-25,4,4,1,4,NASDAQ
4594,12-02-2021 12:00,24 hrs.,StockMarket,MCF,6,0,6,-6,1,1,0,1,AMEX
4594,12-02-2021 12:00,24 hrs.,StockMarket,NAK,6,0,6,-6,1,1,0,1,AMEX
4594,12-02-2021 12:00,24 hrs.,StockMarket,REI,10,10,0,10,1,3,0,1,AMEX
4594,12-02-2021 12:00,24 hrs.,StockMarket,URG,23,23,0,23,1,5,9,1,AMEX
4594,12-02-2021 12:00,24 hrs.,StockMarket,ZOM,63,0,63,-63,4,13,21,4,AMEX
4594,12-02-2021 12:00,24 hrs.,StockMarket,GSAT,6,0,6,-6,1,1,0,1,AMEX
4594,12-02-2021 12:00,24 hrs.,StockMarket,NSPR,29,0,29,-29,1,9,7,1,AMEX
4594,12-02-2021 12:00,24 hrs.,StockMarket,RLGT,6,6,0,6,1,1,0,1,AMEX
4594,12-02-2021 12:00,24 hrs.,StockMarket,UUUU,23,23,0,23,1,5,9,1,AMEX
4594,12-02-2021 12:00,24 hrs.,StockMarket,ACB,26,0,26,-26,1,10,2,1,NYSE
4594,12-02-2021 12:00,24 hrs.,StockMarket,ACI,6,0,6,-6,1,1,0,1,NYSE
4594,12-02-2021 12:00,24 hrs.,StockMarket,AHC,15,0,15,-15,1,3,5,1,NYSE
4594,12-02-2021 12:00,24 hrs.,StockMarket,ALV,13,13,0,13,1,1,7,1,NYSE
4594,12-02-2021 12:00,24 hrs.,StockMarket,AMC,205,158,47,111,9,77,15,7,NYSE
4594,12-02-2021 12:00,24 hrs.,StockMarket,CHL,6,0,6,-6,1,1,0,1,NYSE
4594,12-02-2021 12:00,24 hrs.,StockMarket,CIA,311,311,0,311,1,138,31,1,NYSE
4594,12-02-2021 12:00,24 hrs.,StockMarket,CMI,53,0,53,-53,1,18,13,1,NYSE
4594,12-02-2021 12:00,24 hrs.,StockMarket,DAC,4,0,4,-4,1,0,0,1,NYSE
4594,12-02-2021 12:00,24 hrs.,StockMarket,FAF,6,0,6,-6,1,1,0,1,NYSE
4594,12-02-2021 12:00,24 hrs.,StockMarket,GME,387,279,108,171,14,135,61,14,NYSE
4594,12-02-2021 12:00,24 hrs.,StockMarket,HRL,26,0,26,-26,1,10,2,1,NYSE
4594,12-02-2021 12:00,24 hrs.,StockMarket,IBM,311,311,0,311,1,138,31,1,NYSE
4594,12-02-2021 12:00,24 hrs.,StockMarket,KGC,6,0,6,-6,1,1,0,1,NYSE
4594,12-02-2021 12:00,24 hrs.,StockMarket,LAC,12,6,6,0,2,2,0,2,NYSE
4594,12-02-2021 12:00,24 hrs.,StockMarket,LMT,16,16,0,16,1,3,6,1,NYSE
4594,12-02-2021 12:00,24 hrs.,StockMarket,MRK,26,0,26,-26,1,10,2,1,NYSE
4594,12-02-2021 12:00,24 hrs.,StockMarket,NIO,7,0,7,-7,1,0,3,1,NYSE
4594,12-02-2021 12:00,24 hrs.,StockMarket,NOK,4,0,4,-4,1,0,0,1,NYSE
4594,12-02-2021 12:00,24 hrs.,StockMarket,NSA,311,311,0,311,1,138,31,1,NYSE
4594,12-02-2021 12:00,24 hrs.,StockMarket,PDT,10,10,0,10,1,2,2,1,NYSE
4594,12-02-2021 12:00,24 hrs.,StockMarket,PFE,7,0,7,-7,1,1,1,1,NYSE
4594,12-02-2021 12:00,24 hrs.,StockMarket,QSR,26,0,26,-26,1,10,2,1,NYSE
4594,12-02-2021 12:00,24 hrs.,StockMarket,RMO,7,0,7,-7,1,0,3,1,NYSE
4594,12-02-2021 12:00,24 hrs.,StockMarket,RSI,6,6,0,6,1,1,0,1,NYSE
4594,12-02-2021 12:00,24 hrs.,StockMarket,SBE,6,0,6,-6,1,1,0,1,NYSE
4594,12-02-2021 12:00,24 hrs.,StockMarket,SKY,22,0,22,-22,1,4,10,1,NYSE
4594,12-02-2021 12:00,24 hrs.,StockMarket,SOS,24,12,12,0,4,4,0,3,NYSE
4594,12-02-2021 12:00,24 hrs.,wallstreetbets,FLL,18,0,18,-18,3,3,0,2,NASDAQ
4594,12-02-2021 12:00,24 hrs.,wallstreetbets,FWP,6,0,6,-6,1,1,0,1,NASDAQ
4594,12-02-2021 12:00,24 hrs.,wallstreetbets,GBT,6,0,6,-6,1,1,0,1,NASDAQ
4594,12-02-2021 12:00,24 hrs.,wallstreetbets,GSM,6,6,0,6,1,1,0,1,NASDAQ
4594,12-02-2021 12:00,24 hrs.,wallstreetbets,HAS,95,20,75,-55,15,15,5,13,NASDAQ
4594,12-02-2021 12:00,24 hrs.,wallstreetbets,HPK,6,6,0,6,1,1,0,1,NASDAQ
4594,12-02-2021 12:00,24 hrs.,wallstreetbets,III,6,6,0,6,1,1,0,1,NASDAQ
4594,12-02-2021 12:00,24 hrs.,wallstreetbets,INO,380,333,47,286,13,122,84,11,NASDAQ
4594,12-02-2021 12:00,24 hrs.,wallstreetbets,IPA,13,0,13,-13,2,2,1,2,NASDAQ
4594,12-02-2021 12:00,24 hrs.,wallstreetbets,JFU,18,0,18,-18,3,3,0,3,NASDAQ
4594,12-02-2021 12:00,24 hrs.,wallstreetbets,KHC,646,0,646,-646,3,251,132,3,NASDAQ
4594,12-02-2021 12:00,24 hrs.,wallstreetbets,KOD,6,6,0,6,1,1,0,1,NASDAQ
4594,12-02-2021 12:00,24 hrs.,wallstreetbets,MGI,9,9,0,9,1,1,3,1,NASDAQ
4594,12-02-2021 12:00,24 hrs.,wallstreetbets,MOR,60,0,60,-60,1,11,34,1,NASDAQ
4594,12-02-2021 12:00,24 hrs.,StockMarket,TTM,19,19,0,19,1,3,9,1,NYSE
4594,12-02-2021 12:00,24 hrs.,StockMarket,UBS,53,0,53,-53,1,18,13,1,NYSE
4594,12-02-2021 12:00,24 hrs.,StockMarket,XPO,26,0,26,-26,1,10,2,1,NYSE
4594,12-02-2021 12:00,24 hrs.,StockMarket,ACIC,4,0,4,-4,1,0,0,1,NYSE
4594,12-02-2021 12:00,24 hrs.,StockMarket,AVLR,53,0,53,-53,1,18,13,1,NYSE
4594,12-02-2021 12:00,24 hrs.,StockMarket,CACI,311,311,0,311,1,138,31,1,NYSE
4594,12-02-2021 12:00,24 hrs.,StockMarket,CCIV,39,0,39,-39,1,12,11,1,NYSE
4594,12-02-2021 12:00,24 hrs.,StockMarket,GLOP,4,0,4,-4,1,0,0,1,NYSE
4594,12-02-2021 12:00,24 hrs.,StockMarket,GNRC,26,0,26,-26,1,10,2,1,NYSE
4594,12-02-2021 12:00,24 hrs.,StockMarket,MDLY,6,0,6,-6,1,0,2,1,NYSE
4594,12-02-2021 12:00,24 hrs.,StockMarket,PAYC,53,0,53,-53,1,18,13,1,NYSE
4594,12-02-2021 12:00,24 hrs.,StockMarket,PINS,32,0,32,-32,2,11,2,2,NYSE
4594,12-02-2021 12:00,24 hrs.,StockMarket,RLGY,6,0,6,-6,1,1,0,1,NYSE
4594,12-02-2021 12:00,24 hrs.,StockMarket,SPCE,12,0,12,-12,2,2,0,2,NYSE
4594,12-02-2021 12:00,24 hrs.,StockMarket,TEVA,6,0,6,-6,1,1,0,1,NYSE
4594,12-02-2021 12:00,24 hrs.,StockMarket,UBER,79,0,79,-79,2,28,15,2,NYSE
4594,12-02-2021 12:00,24 hrs.,StockMarket,XPEV,311,311,0,311,1,138,31,1,NYSE
4594,12-02-2021 12:00,24 hrs.,StockMarket,YETI,6,6,0,6,1,1,0,1,NYSE
4594,12-02-2021 12:00,24 hrs.,StockMarket,AMD,18,18,0,18,2,1,8,2,NASDAQ
4594,12-02-2021 12:00,24 hrs.,StockMarket,API,21,0,21,-21,3,4,1,1,NASDAQ
4594,12-02-2021 12:00,24 hrs.,StockMarket,AQB,4,0,4,-4,1,0,0,1,NASDAQ
4594,12-02-2021 12:00,24 hrs.,wallstreetbets,SMH,12,0,12,-12,2,2,0,2,NASDAQ
4594,12-02-2021 12:00,24 hrs.,wallstreetbets,SND,14,14,0,14,2,2,2,2,NASDAQ
4594,12-02-2021 12:00,24 hrs.,wallstreetbets,TER,12,0,12,-12,2,2,0,1,NASDAQ
4594,12-02-2021 12:00,24 hrs.,wallstreetbets,TTD,6,0,6,-6,1,1,0,1,NASDAQ
4594,12-02-2021 12:00,24 hrs.,wallstreetbets,TXN,389,0,389,-389,1,139,107,1,NASDAQ
4594,12-02-2021 12:00,24 hrs.,wallstreetbets,UAL,7,7,0,7,1,1,1,1,NASDAQ
4594,12-02-2021 12:00,24 hrs.,wallstreetbets,UFO,6,6,0,6,1,1,0,1,NASDAQ
4594,12-02-2021 12:00,24 hrs.,wallstreetbets,VFF,208,0,208,-208,6,41,102,6,NASDAQ
4594,12-02-2021 12:00,24 hrs.,wallstreetbets,WDC,34,0,34,-34,2,10,6,1,NASDAQ
4594,12-02-2021 12:00,24 hrs.,wallstreetbets,WNW,12,0,12,-12,2,2,0,2,NASDAQ
4594,12-02-2021 12:00,24 hrs.,wallstreetbets,WVE,6,0,6,-6,1,1,0,1,NASDAQ
4594,12-02-2021 12:00,24 hrs.,wallstreetbets,AACG,6,0,6,-6,1,1,0,1,NASDAQ
4594,12-02-2021 12:00,24 hrs.,wallstreetbets,AAPL,1800,215,1585,-1370,11,709,338,11,NASDAQ
4594,12-02-2021 12:00,24 hrs.,wallstreetbets,ABEO,6,0,6,-6,1,1,0,1,NASDAQ
4594,12-02-2021 12:00,24 hrs.,wallstreetbets,ABIO,7,7,0,7,1,1,1,1,NASDAQ
4594,12-02-2021 12:00,24 hrs.,wallstreetbets,ABNB,14,14,0,14,2,2,2,2,NASDAQ
4594,12-02-2021 12:00,24 hrs.,wallstreetbets,ACEV,6,0,6,-6,1,1,0,1,NASDAQ
4594,12-02-2021 12:00,24 hrs.,wallstreetbets,ACIU,54,0,54,-54,9,9,0,6,NASDAQ
4594,12-02-2021 12:00,24 hrs.,wallstreetbets,ACRX,6,0,6,-6,1,1,0,1,NASDAQ
4594,12-02-2021 12:00,24 hrs.,wallstreetbets,ACST,6,0,6,-6,1,1,0,1,NASDAQ
4594,12-02-2021 12:00,24 hrs.,wallstreetbets,ADMA,6,0,6,-6,1,1,0,1,NASDAQ
4594,12-02-2021 12:00,24 hrs.,wallstreetbets,ADMP,12,0,12,-12,2,2,0,2,NASDAQ
4594,12-02-2021 12:00,24 hrs.,wallstreetbets,ADTX,7,0,7,-7,1,1,1,1,NASDAQ
4594,12-02-2021 12:00,24 hrs.,wallstreetbets,ADXS,6,0,6,-6,1,1,0,1,NASDAQ
4594,12-02-2021 12:00,24 hrs.,wallstreetbets,AESE,30,0,30,-30,5,5,0,2,NASDAQ
4594,12-02-2021 12:00,24 hrs.,wallstreetbets,AEZS,6,0,6,-6,1,1,0,1,NASDAQ
4594,12-02-2021 12:00,24 hrs.,wallstreetbets,AGRX,6,0,6,-6,1,1,0,1,NASDAQ
4594,12-02-2021 12:00,24 hrs.,wallstreetbets,AGTC,62,7,55,-48,10,10,2,10,NASDAQ
4594,12-02-2021 12:00,24 hrs.,wallstreetbets,AIKI,19,0,19,-19,3,3,1,1,NASDAQ
4594,12-02-2021 12:00,24 hrs.,wallstreetbets,AKAM,6,0,6,-6,1,1,0,1,NASDAQ
4594,12-02-2021 12:00,24 hrs.,wallstreetbets,AKBA,12,0,12,-12,2,2,0,1,NASDAQ
4594,12-02-2021 12:00,24 hrs.,wallstreetbets,AKER,6,0,6,-6,1,1,0,1,NASDAQ
4594,12-02-2021 12:00,24 hrs.,wallstreetbets,ALGM,6,0,6,-6,1,1,0,1,NASDAQ
4594,12-02-2021 12:00,24 hrs.,wallstreetbets,ALJJ,7,0,7,-7,1,1,1,1,NASDAQ
4594,12-02-2021 12:00,24 hrs.,wallstreetbets,ALOT,6,0,6,-6,1,1,0,1,NASDAQ
4594,12-02-2021 12:00,24 hrs.,wallstreetbets,AMAT,19,19,0,19,3,3,1,2,NASDAQ
4594,12-02-2021 12:00,24 hrs.,wallstreetbets,AMKR,419,0,419,-419,5,150,99,3,NASDAQ
4594,12-02-2021 12:00,24 hrs.,wallstreetbets,AMRK,6,0,6,-6,1,1,0,1,NASDAQ
4594,12-02-2021 12:00,24 hrs.,wallstreetbets,AMRN,6,0,6,-6,1,1,0,1,NASDAQ
4594,12-02-2021 12:00,24 hrs.,wallstreetbets,AMZN,2626,225,2401,-2176,9,1102,386,7,NASDAQ
4594,12-02-2021 12:00,24 hrs.,wallstreetbets,ANTE,6,0,6,-6,1,1,0,1,NASDAQ
4594,12-02-2021 12:00,24 hrs.,wallstreetbets,APHA,125338,55221,70117,-14896,158,57964,8778,121,NASDAQ
4594,12-02-2021 12:00,24 hrs.,wallstreetbets,APOP,6,0,6,-6,1,1,0,1,NASDAQ
4594,12-02-2021 12:00,24 hrs.,StockMarket,OGI,65,33,32,1,3,22,9,3,NASDAQ
4594,12-02-2021 12:00,24 hrs.,StockMarket,PEP,26,0,26,-26,1,10,2,1,NASDAQ
4594,12-02-2021 12:00,24 hrs.,StockMarket,QQQ,24,0,24,-24,1,9,2,1,NASDAQ
4594,12-02-2021 12:00,24 hrs.,StockMarket,RCM,197,6,191,-185,2,69,51,2,NASDAQ
4594,12-02-2021 12:00,24 hrs.,StockMarket,SDC,15,0,15,-15,1,3,5,1,NASDAQ
4594,12-02-2021 12:00,24 hrs.,StockMarket,SND,10,10,0,10,1,3,0,1,NASDAQ
4594,12-02-2021 12:00,24 hrs.,StockMarket,VFF,44,0,44,-44,4,13,2,2,NASDAQ
4594,12-02-2021 12:00,24 hrs.,StockMarket,AAPL,59,0,59,-59,2,19,13,2,NASDAQ
4594,12-02-2021 12:00,24 hrs.,StockMarket,ABIO,6,0,6,-6,1,1,0,1,NASDAQ
4594,12-02-2021 12:00,24 hrs.,StockMarket,ACIU,191,0,191,-191,1,68,51,1,NASDAQ
4594,12-02-2021 12:00,24 hrs.,StockMarket,AEZS,8,8,0,8,1,2,0,1,NASDAQ
4594,12-02-2021 12:00,24 hrs.,StockMarket,AGTC,71,0,71,-71,2,19,25,2,NASDAQ
4594,12-02-2021 12:00,24 hrs.,StockMarket,APHA,728,0,728,-728,8,229,238,7,NASDAQ
4594,12-02-2021 12:00,24 hrs.,StockMarket,ASYS,4,0,4,-4,1,0,0,1,NASDAQ
4594,12-02-2021 12:00,24 hrs.,StockMarket,ATOM,28,0,28,-28,1,11,2,1,NASDAQ
4594,12-02-2021 12:00,24 hrs.,StockMarket,ATOS,7,7,0,7,1,1,1,1,NASDAQ
4594,12-02-2021 12:00,24 hrs.,StockMarket,AVXL,6,0,6,-6,1,1,0,1,NASDAQ
4594,12-02-2021 12:00,24 hrs.,StockMarket,BBBY,6,0,6,-6,1,1,0,1,NASDAQ
4594,12-02-2021 12:00,24 hrs.,StockMarket,BSQR,17,0,17,-17,1,1,11,1,NASDAQ
4594,12-02-2021 12:00,24 hrs.,StockMarket,CECE,12,12,0,12,1,4,0,1,NASDAQ
4594,12-02-2021 12:00,24 hrs.,StockMarket,CLNE,53,0,53,-53,1,18,13,1,NASDAQ
4594,12-02-2021 12:00,24 hrs.,StockMarket,CLSK,8,8,0,8,1,1,2,1,NASDAQ
4594,12-02-2021 12:00,24 hrs.,StockMarket,CLSN,197,0,197,-197,2,69,51,2,NASDAQ
4594,12-02-2021 12:00,24 hrs.,StockMarket,CRSP,6,6,0,6,1,1,0,1,NASDAQ
4594,12-02-2021 12:00,24 hrs.,StockMarket,CTHR,16,0,16,-16,1,5,2,1,NASDAQ
4594,12-02-2021 12:00,24 hrs.,StockMarket,CTRM,248,0,248,-248,6,81,62,6,NASDAQ
4594,12-02-2021 12:00,24 hrs.,StockMarket,ENTX,8,8,0,8,1,2,0,1,NASDAQ
4594,12-02-2021 12:00,24 hrs.,StockMarket,FANG,73,0,73,-73,1,28,13,1,NASDAQ
4594,12-02-2021 12:00,24 hrs.,StockMarket,FNKO,23,0,23,-23,1,7,5,1,NASDAQ
4594,12-02-2021 12:00,24 hrs.,StockMarket,GRWG,10,0,10,-10,2,1,0,2,NASDAQ
4594,12-02-2021 12:00,24 hrs.,StockMarket,HTBX,6,6,0,6,1,1,0,1,NASDAQ
4594,12-02-2021 12:00,24 hrs.,StockMarket,IBKR,6,0,6,-6,1,1,0,1,NASDAQ
4594,12-02-2021 12:00,24 hrs.,StockMarket,IMMR,4,0,4,-4,1,0,0,1,NASDAQ
4594,12-02-2021 12:00,24 hrs.,StockMarket,INMD,53,0,53,-53,1,18,13,1,NASDAQ
4594,12-02-2021 12:00,24 hrs.,StockMarket,INTZ,4,4,0,4,1,0,0,1,NASDAQ
4594,12-02-2021 12:00,24 hrs.,StockMarket,INVE,21,21,0,21,2,5,3,1,NASDAQ
4594,12-02-2021 12:00,24 hrs.,StockMarket,IRBT,26,0,26,-26,1,10,2,1,NASDAQ
4594,12-02-2021 12:00,24 hrs.,StockMarket,LAZR,6,6,0,6,1,1,0,1,NASDAQ
4594,12-02-2021 12:00,24 hrs.,StockMarket,LGND,6,6,0,6,1,1,0,1,NASDAQ
4594,12-02-2021 12:00,24 hrs.,StockMarket,LIFE,1306,1306,0,1306,1,628,46,1,NASDAQ
4594,12-02-2021 12:00,24 hrs.,StockMarket,LIVE,26,0,26,-26,1,10,2,1,NASDAQ
4594,12-02-2021 12:00,24 hrs.,StockMarket,LLNW,12,12,0,12,2,2,0,1,NASDAQ
4594,12-02-2021 12:00,24 hrs.,StockMarket,LYFT,53,0,53,-53,1,18,13,1,NASDAQ
4594,12-02-2021 12:00,24 hrs.,StockMarket,MGNI,4,0,4,-4,1,0,0,1,NASDAQ
4594,12-02-2021 12:00,24 hrs.,StockMarket,MNPR,191,0,191,-191,1,68,51,1,NASDAQ
4594,12-02-2021 12:00,24 hrs.,StockMarket,MSFT,50,0,50,-50,2,19,4,2,NASDAQ
4594,12-02-2021 12:00,24 hrs.,StockMarket,MSTR,12,12,0,12,2,2,0,1,NASDAQ
4594,12-02-2021 12:00,24 hrs.,StockMarket,MVIS,26,0,26,-26,1,10,2,1,NASDAQ
4594,12-02-2021 12:00,24 hrs.,StockMarket,OCGN,12,0,12,-12,2,2,0,1,NASDAQ
4594,12-02-2021 12:00,24 hrs.,StockMarket,OPTT,22,0,22,-22,1,5,8,1,NASDAQ
4594,12-02-2021 12:00,24 hrs.,StockMarket,PACB,6,6,0,6,1,1,0,1,NASDAQ
4594,12-02-2021 12:00,24 hrs.,StockMarket,PLUG,4,0,4,-4,1,0,0,1,NASDAQ
4594,12-02-2021 12:00,24 hrs.,StockMarket,PRCH,4,0,4,-4,1,0,0,1,NASDAQ
4594,12-02-2021 12:00,24 hrs.,StockMarket,PTGX,6,0,6,-6,1,1,0,1,NASDAQ
4594,12-02-2021 12:00,24 hrs.,StockMarket,PYPL,11,11,0,11,1,2,3,1,NASDAQ
4594,12-02-2021 12:00,24 hrs.,StockMarket,QELL,26,0,26,-26,1,10,2,1,NASDAQ
4594,12-02-2021 12:00,24 hrs.,StockMarket,RCMT,197,6,191,-185,2,69,51,2,NASDAQ
4594,12-02-2021 12:00,24 hrs.,StockMarket,RIGL,6,6,0,6,1,1,0,1,NASDAQ
4594,12-02-2021 12:00,24 hrs.,wallstreetbets,ATOS,19,7,12,-5,3,3,1,2,NASDAQ
4594,12-02-2021 12:00,24 hrs.,wallstreetbets,AUTL,14,14,0,14,2,2,2,1,NASDAQ
4594,12-02-2021 12:00,24 hrs.,StockMarket,TAP,26,0,26,-26,1,10,2,1,NYSE
4594,12-02-2021 12:00,24 hrs.,StockMarket,TMX,4,0,4,-4,1,0,0,1,NYSE
4594,12-02-2021 12:00,24 hrs.,StockMarket,TPX,26,0,26,-26,1,10,2,1,NYSE
4594,12-02-2021 12:00,24 hrs.,StockMarket,TSE,31,25,6,19,2,11,1,2,NYSE
4594,12-02-2021 12:00,24 hrs.,wallstreetbets,AXDX,27,21,6,15,4,4,3,2,NASDAQ
4594,12-02-2021 12:00,24 hrs.,wallstreetbets,AYRO,19,7,12,-5,3,3,1,2,NASDAQ
4594,12-02-2021 12:00,24 hrs.,wallstreetbets,BBBY,36,0,36,-36,6,6,0,6,NASDAQ
4594,12-02-2021 12:00,24 hrs.,wallstreetbets,BCRX,6,0,6,-6,1,1,0,1,NASDAQ
4594,12-02-2021 12:00,24 hrs.,wallstreetbets,BEAT,12,6,6,0,2,2,0,2,NASDAQ
4594,12-02-2021 12:00,24 hrs.,wallstreetbets,BHAT,12,0,12,-12,2,2,0,2,NASDAQ
4594,12-02-2021 12:00,24 hrs.,wallstreetbets,BIGC,47,35,12,23,7,7,5,4,NASDAQ
4594,12-02-2021 12:00,24 hrs.,wallstreetbets,BILI,12,0,12,-12,2,2,0,1,NASDAQ
4594,12-02-2021 12:00,24 hrs.,wallstreetbets,BIOC,14,7,7,0,2,2,2,2,NASDAQ
4594,12-02-2021 12:00,24 hrs.,wallstreetbets,BLCM,6,0,6,-6,1,1,0,1,NASDAQ
4594,12-02-2021 12:00,24 hrs.,wallstreetbets,BLCT,6,0,6,-6,1,1,0,1,NASDAQ
4594,12-02-2021 12:00,24 hrs.,wallstreetbets,BLNK,6,0,6,-6,1,1,0,1,NASDAQ
4594,12-02-2021 12:00,24 hrs.,wallstreetbets,BLUE,18,0,18,-18,3,3,0,3,NASDAQ
4594,12-02-2021 12:00,24 hrs.,wallstreetbets,BNGO,31,7,24,-17,5,5,1,5,NASDAQ
4594,12-02-2021 12:00,24 hrs.,wallstreetbets,BPTH,26,7,19,-12,4,4,2,3,NASDAQ
4594,12-02-2021 12:00,24 hrs.,wallstreetbets,BRQS,31,7,24,-17,5,5,1,4,NASDAQ
4594,12-02-2021 12:00,24 hrs.,wallstreetbets,BSGM,6,0,6,-6,1,1,0,1,NASDAQ
4594,12-02-2021 12:00,24 hrs.,wallstreetbets,BWEN,6,0,6,-6,1,1,0,1,NASDAQ
4594,12-02-2021 12:00,24 hrs.,wallstreetbets,CAKE,6,0,6,-6,1,1,0,1,NASDAQ
4594,12-02-2021 12:00,24 hrs.,wallstreetbets,CALM,6,0,6,-6,1,1,0,1,NASDAQ
4594,12-02-2021 12:00,24 hrs.,wallstreetbets,CARV,13,7,6,1,2,2,1,2,NASDAQ
4594,12-02-2021 12:00,24 hrs.,wallstreetbets,CASA,6,0,6,-6,1,1,0,1,NASDAQ
4594,12-02-2021 12:00,24 hrs.,wallstreetbets,CASH,6,0,6,-6,1,1,0,1,NASDAQ
4594,12-02-2021 12:00,24 hrs.,wallstreetbets,CCNC,6,0,6,-6,1,1,0,1,NASDAQ
4594,12-02-2021 12:00,24 hrs.,wallstreetbets,CCRN,6,0,6,-6,1,1,0,1,NASDAQ
4594,12-02-2021 12:00,24 hrs.,wallstreetbets,CFII,6,0,6,-6,1,1,0,1,NASDAQ
4594,12-02-2021 12:00,24 hrs.,wallstreetbets,CGIX,20,14,6,8,3,3,2,2,NASDAQ
4594,12-02-2021 12:00,24 hrs.,wallstreetbets,CGRO,12,0,12,-12,2,2,0,2,NASDAQ
4594,12-02-2021 12:00,24 hrs.,wallstreetbets,CHKP,6,0,6,-6,1,1,0,1,NASDAQ
4594,12-02-2021 12:00,24 hrs.,wallstreetbets,CIDM,6,0,6,-6,1,1,0,1,NASDAQ
4594,12-02-2021 12:00,24 hrs.,wallstreetbets,CKPT,25,7,18,-11,4,4,1,3,NASDAQ
4594,12-02-2021 12:00,24 hrs.,wallstreetbets,CLBS,12,0,12,-12,2,2,0,2,NASDAQ
4594,12-02-2021 12:00,24 hrs.,wallstreetbets,CLCT,6,0,6,-6,1,1,0,1,NASDAQ
4594,12-02-2021 12:00,24 hrs.,wallstreetbets,CLEU,7,7,0,7,1,1,1,1,NASDAQ
4594,12-02-2021 12:00,24 hrs.,wallstreetbets,CLNE,128,0,128,-128,2,39,42,2,NASDAQ
4594,12-02-2021 12:00,24 hrs.,wallstreetbets,CLSN,19,0,19,-19,3,3,1,3,NASDAQ
4594,12-02-2021 12:00,24 hrs.,wallstreetbets,CLVR,32,0,32,-32,6,4,0,5,NASDAQ
4594,12-02-2021 12:00,24 hrs.,wallstreetbets,CLVS,40,14,26,-12,6,6,4,5,NASDAQ
4594,12-02-2021 12:00,24 hrs.,wallstreetbets,CMLF,7,7,0,7,1,1,1,1,NASDAQ
4594,12-02-2021 12:00,24 hrs.,wallstreetbets,CMPS,110,55,55,0,11,24,18,6,NASDAQ
4594,12-02-2021 12:00,24 hrs.,wallstreetbets,CNDT,13,0,13,-13,2,2,1,2,NASDAQ
4594,12-02-2021 12:00,24 hrs.,wallstreetbets,CNET,6,0,6,-6,1,1,0,1,NASDAQ
4594,12-02-2021 12:00,24 hrs.,wallstreetbets,CNSP,7,7,0,7,1,1,1,1,NASDAQ
4594,12-02-2021 12:00,24 hrs.,wallstreetbets,CODX,13,7,6,1,2,2,1,2,NASDAQ
4594,12-02-2021 12:00,24 hrs.,wallstreetbets,COST,18,0,18,-18,3,3,0,3,NASDAQ
4594,12-02-2021 12:00,24 hrs.,wallstreetbets,CPRX,6,0,6,-6,1,1,0,1,NASDAQ
4594,12-02-2021 12:00,24 hrs.,wallstreetbets,CPST,12,0,12,-12,2,2,0,1,NASDAQ
4594,12-02-2021 12:00,24 hrs.,wallstreetbets,CRBP,31,7,24,-17,5,5,1,5,NASDAQ
4594,12-02-2021 12:00,24 hrs.,wallstreetbets,CREG,12,0,12,-12,2,2,0,2,NASDAQ
4594,12-02-2021 12:00,24 hrs.,wallstreetbets,CRIS,6,0,6,-6,1,1,0,1,NASDAQ
4594,12-02-2021 12:00,24 hrs.,wallstreetbets,CRNT,18,6,12,-6,3,3,0,3,NASDAQ
4594,12-02-2021 12:00,24 hrs.,wallstreetbets,CRON,189,0,189,-189,12,36,69,8,NASDAQ
4594,12-02-2021 12:00,24 hrs.,wallstreetbets,CROX,6,0,6,-6,1,1,0,1,NASDAQ
4594,12-02-2021 12:00,24 hrs.,wallstreetbets,CRSP,6,0,6,-6,1,1,0,1,NASDAQ
4594,12-02-2021 12:00,24 hrs.,wallstreetbets,CRSR,4267,3655,612,3043,4,1827,597,4,NASDAQ
4594,12-02-2021 12:00,24 hrs.,wallstreetbets,CSCW,12,0,12,-12,2,2,0,2,NASDAQ
4594,12-02-2021 12:00,24 hrs.,wallstreetbets,CTRM,776,116,660,-544,127,126,16,107,NASDAQ
4594,12-02-2021 12:00,24 hrs.,wallstreetbets,CTRN,6,0,6,-6,1,1,0,1,NASDAQ
4594,12-02-2021 12:00,24 hrs.,wallstreetbets,CVAC,6,0,6,-6,1,1,0,1,NASDAQ
4594,12-02-2021 12:00,24 hrs.,wallstreetbets,DBVT,14,8,6,2,2,2,2,2,NASDAQ
4594,12-02-2021 12:00,24 hrs.,StockMarket,AZN,26,0,26,-26,1,10,2,1,NASDAQ
4594,12-02-2021 12:00,24 hrs.,StockMarket,HAS,6,6,0,6,1,1,0,1,NASDAQ
4594,12-02-2021 12:00,24 hrs.,StockMarket,KHC,26,0,26,-26,1,10,2,1,NASDAQ
4594,12-02-2021 12:00,24 hrs.,StockMarket,MGI,11,11,0,11,1,3,1,1,NASDAQ
4594,12-02-2021 12:00,24 hrs.,pennystocks,ALPP,34,0,34,-34,4,4,10,4,OTC
4594,12-02-2021 12:00,24 hrs.,pennystocks,ALYI,162,120,42,78,3,53,44,3,OTC
4594,12-02-2021 12:00,24 hrs.,pennystocks,ANDI,7,7,0,7,1,1,1,1,OTC
4594,12-02-2021 12:00,24 hrs.,pennystocks,APEX,124,0,124,-124,1,44,32,1,OTC
4594,12-02-2021 12:00,24 hrs.,pennystocks,ASTI,53,0,53,-53,6,11,7,5,OTC
4594,12-02-2021 12:00,24 hrs.,pennystocks,ATVK,21,0,21,-21,1,8,1,1,OTC
4594,12-02-2021 12:00,24 hrs.,pennystocks,AXXA,12,0,12,-12,2,2,0,2,OTC
4594,12-02-2021 12:00,24 hrs.,pennystocks,AZFL,61,55,6,49,4,5,35,3,OTC
4594,12-02-2021 12:00,24 hrs.,pennystocks,BANT,13,13,0,13,1,1,7,1,OTC
4594,12-02-2021 12:00,24 hrs.,pennystocks,BBDA,7,0,7,-7,1,1,1,1,OTC
4594,12-02-2021 12:00,24 hrs.,pennystocks,BBRW,6,0,6,-6,1,1,0,1,OTC
4594,12-02-2021 12:00,24 hrs.,pennystocks,BCCI,7,0,7,-7,1,1,1,1,OTC
4594,12-02-2021 12:00,24 hrs.,pennystocks,BDGR,19,0,19,-19,3,3,1,2,OTC
4594,12-02-2021 12:00,24 hrs.,pennystocks,BFCH,9,0,9,-9,1,2,1,1,OTC
4594,12-02-2021 12:00,24 hrs.,pennystocks,BKMP,6,6,0,6,1,1,0,1,OTC
4594,12-02-2021 12:00,24 hrs.,pennystocks,BLDV,130,0,130,-130,8,33,32,7,OTC
4594,12-02-2021 12:00,24 hrs.,pennystocks,BLLB,6,0,6,-6,1,1,0,1,OTC
4594,12-02-2021 12:00,24 hrs.,pennystocks,BLSP,96,7,89,-82,4,22,36,4,OTC
4594,12-02-2021 12:00,24 hrs.,pennystocks,BMIX,49,42,7,35,3,8,21,3,OTC
4594,12-02-2021 12:00,24 hrs.,pennystocks,BNGI,19,0,19,-19,3,3,1,1,OTC
4594,12-02-2021 12:00,24 hrs.,pennystocks,BOTY,120,20,100,-80,6,31,34,5,OTC
4594,12-02-2021 12:00,24 hrs.,pennystocks,BRAV,6,0,6,-6,1,1,0,1,OTC
4594,12-02-2021 12:00,24 hrs.,pennystocks,BRGO,12,12,0,12,1,3,2,1,OTC
4594,12-02-2021 12:00,24 hrs.,pennystocks,BRLL,38,0,38,-38,4,5,12,3,OTC
4594,12-02-2021 12:00,24 hrs.,pennystocks,BTCS,7,0,7,-7,1,1,1,1,OTC
4594,12-02-2021 12:00,24 hrs.,pennystocks,BTSC,13,0,13,-13,2,2,1,1,OTC
4594,12-02-2021 12:00,24 hrs.,pennystocks,BUDZ,10,10,0,10,1,2,2,1,OTC
4594,12-02-2021 12:00,24 hrs.,pennystocks,BWMG,10,0,10,-10,1,2,2,1,OTC
4594,12-02-2021 12:00,24 hrs.,pennystocks,BXNG,23,0,23,-23,1,3,13,1,OTC
4594,12-02-2021 12:00,24 hrs.,pennystocks,CAPC,287,0,287,-287,1,118,47,1,OTC
4594,12-02-2021 12:00,24 hrs.,pennystocks,CATV,6,0,6,-6,1,1,0,1,OTC
4594,12-02-2021 12:00,24 hrs.,pennystocks,CBBT,439,83,356,-273,14,132,119,13,OTC
4594,12-02-2021 12:00,24 hrs.,pennystocks,CBDD,116,5,111,-106,6,36,20,6,OTC
4594,12-02-2021 12:00,24 hrs.,pennystocks,CBDL,183,157,26,131,5,37,89,5,OTC
4594,12-02-2021 12:00,24 hrs.,pennystocks,CBDS,6,0,6,-6,1,1,0,1,OTC
4594,12-02-2021 12:00,24 hrs.,pennystocks,CBGI,6,0,6,-6,1,1,0,1,OTC
4594,12-02-2021 12:00,24 hrs.,pennystocks,CBTC,7,0,7,-7,1,1,1,1,OTC
4594,12-02-2021 12:00,24 hrs.,pennystocks,CCTL,6,0,6,-6,1,1,0,1,OTC
4594,12-02-2021 12:00,24 hrs.,pennystocks,CETY,27,0,27,-27,2,9,1,2,OTC
4594,12-02-2021 12:00,24 hrs.,pennystocks,CHUC,6,0,6,-6,1,1,0,1,OTC
4594,12-02-2021 12:00,24 hrs.,StockMarket,RIOT,191,0,191,-191,1,68,51,1,NASDAQ
4594,12-02-2021 12:00,24 hrs.,StockMarket,SNDL,11576,305,11271,-10966,24,5218,1044,23,NASDAQ
4594,12-02-2021 12:00,24 hrs.,StockMarket,SONO,79,0,79,-79,2,28,15,2,NASDAQ
4594,12-02-2021 12:00,24 hrs.,wallstreetbets,DCRB,7,0,7,-7,1,1,1,1,NASDAQ
4594,12-02-2021 12:00,24 hrs.,wallstreetbets,DDOG,49,0,49,-49,3,15,7,3,NASDAQ
4594,12-02-2021 12:00,24 hrs.,wallstreetbets,DGLY,12,0,12,-12,2,2,0,1,NASDAQ
4594,12-02-2021 12:00,24 hrs.,wallstreetbets,DKNG,940,6,934,-928,4,395,134,3,NASDAQ
4594,12-02-2021 12:00,24 hrs.,wallstreetbets,DLPN,12,0,12,-12,2,2,0,1,NASDAQ
4594,12-02-2021 12:00,24 hrs.,wallstreetbets,DMTK,12,0,12,-12,2,2,0,1,NASDAQ
4594,12-02-2021 12:00,24 hrs.,wallstreetbets,DTIL,6,0,6,-6,1,1,0,1,NASDAQ
4594,12-02-2021 12:00,24 hrs.,wallstreetbets,DXCM,6,0,6,-6,1,1,0,1,NASDAQ
4594,12-02-2021 12:00,24 hrs.,wallstreetbets,EBON,6,0,6,-6,1,1,0,1,NASDAQ
4594,12-02-2021 12:00,24 hrs.,wallstreetbets,EDIT,11510,1044,10466,-9422,3,5255,988,3,NASDAQ
4594,12-02-2021 12:00,24 hrs.,wallstreetbets,EDSA,24,0,24,-24,4,4,0,2,NASDAQ
4594,12-02-2021 12:00,24 hrs.,wallstreetbets,ELSE,6,0,6,-6,1,1,0,1,NASDAQ
4594,12-02-2021 12:00,24 hrs.,wallstreetbets,ENLV,6,0,6,-6,1,1,0,1,NASDAQ
4594,12-02-2021 12:00,24 hrs.,wallstreetbets,ENVB,13,7,6,1,2,2,1,2,NASDAQ
4594,12-02-2021 12:00,24 hrs.,wallstreetbets,ERIC,7,7,0,7,1,1,1,1,NASDAQ
4594,12-02-2021 12:00,24 hrs.,wallstreetbets,ESPR,13,7,6,1,2,2,1,2,NASDAQ
4594,12-02-2021 12:00,24 hrs.,wallstreetbets,ETSY,12,6,6,0,2,2,0,2,NASDAQ
4594,12-02-2021 12:00,24 hrs.,wallstreetbets,AUVI,6,0,6,-6,1,1,0,1,NASDAQ
4594,12-02-2021 12:00,24 hrs.,wallstreetbets,AVAV,6,0,6,-6,1,1,0,1,NASDAQ
4594,12-02-2021 12:00,24 hrs.,wallstreetbets,AVGR,24,0,24,-24,4,4,0,3,NASDAQ
4594,12-02-2021 12:00,24 hrs.,wallstreetbets,AVXL,6,0,6,-6,1,1,0,1,NASDAQ
4594,12-02-2021 12:00,24 hrs.,wallstreetbets,EYES,26,26,0,26,4,4,2,1,NASDAQ
4594,12-02-2021 12:00,24 hrs.,wallstreetbets,FANG,7,7,0,7,1,1,1,1,NASDAQ
4594,12-02-2021 12:00,24 hrs.,wallstreetbets,FAST,6,0,6,-6,1,1,0,1,NASDAQ
4594,12-02-2021 12:00,24 hrs.,wallstreetbets,FCEL,19,0,19,-19,3,3,1,3,NASDAQ
4594,12-02-2021 12:00,24 hrs.,wallstreetbets,FLDM,7,7,0,7,1,1,1,1,NASDAQ
4594,12-02-2021 12:00,24 hrs.,wallstreetbets,FLUX,12,0,12,-12,2,2,0,1,NASDAQ
4594,12-02-2021 12:00,24 hrs.,wallstreetbets,FLWR,18,0,18,-18,3,3,0,3,NASDAQ
4594,12-02-2021 12:00,24 hrs.,wallstreetbets,FNKO,12,0,12,-12,2,2,0,2,NASDAQ
4594,12-02-2021 12:00,24 hrs.,wallstreetbets,FOLD,6,0,6,-6,1,1,0,1,NASDAQ
4594,12-02-2021 12:00,24 hrs.,wallstreetbets,FORD,20,0,20,-20,3,3,2,3,NASDAQ
4594,12-02-2021 12:00,24 hrs.,wallstreetbets,FROG,6,0,6,-6,1,1,0,1,NASDAQ
4594,12-02-2021 12:00,24 hrs.,wallstreetbets,FRSX,6,0,6,-6,1,1,0,1,NASDAQ
4594,12-02-2021 12:00,24 hrs.,wallstreetbets,FTOC,6,0,6,-6,1,1,0,1,NASDAQ
4594,12-02-2021 12:00,24 hrs.,wallstreetbets,FUTU,353,0,353,-353,1,104,141,1,NASDAQ
4594,12-02-2021 12:00,24 hrs.,wallstreetbets,GAIN,48,15,33,-18,7,7,6,7,NASDAQ
4594,12-02-2021 12:00,24 hrs.,wallstreetbets,GDRX,7,0,7,-7,1,1,1,1,NASDAQ
4594,12-02-2021 12:00,24 hrs.,wallstreetbets,GERN,7,7,0,7,1,1,1,1,NASDAQ
4594,12-02-2021 12:00,24 hrs.,wallstreetbets,GEVO,38,7,31,-24,6,6,2,5,NASDAQ
4594,12-02-2021 12:00,24 hrs.,wallstreetbets,GHIV,353,0,353,-353,1,104,141,1,NASDAQ
4594,12-02-2021 12:00,24 hrs.,wallstreetbets,GHSI,26,0,26,-26,4,4,2,3,NASDAQ
4594,12-02-2021 12:00,24 hrs.,wallstreetbets,GILT,6,0,6,-6,1,1,0,1,NASDAQ
4594,12-02-2021 12:00,24 hrs.,wallstreetbets,GLBS,6,0,6,-6,1,1,0,1,NASDAQ
4594,12-02-2021 12:00,24 hrs.,wallstreetbets,GLMD,7,7,0,7,1,1,1,1,NASDAQ
4594,12-02-2021 12:00,24 hrs.,wallstreetbets,GLPG,7,7,0,7,1,1,1,1,NASDAQ
4594,12-02-2021 12:00,24 hrs.,wallstreetbets,GLSI,8,0,8,-8,1,1,2,1,NASDAQ
4594,12-02-2021 12:00,24 hrs.,wallstreetbets,GLUU,6,0,6,-6,1,1,0,1,NASDAQ
4594,12-02-2021 12:00,24 hrs.,wallstreetbets,GNLN,12,0,12,-12,2,2,0,2,NASDAQ
4594,12-02-2021 12:00,24 hrs.,wallstreetbets,GNMK,6,0,6,-6,1,1,0,1,NASDAQ
4594,12-02-2021 12:00,24 hrs.,wallstreetbets,GNOG,19,13,6,7,3,3,1,3,NASDAQ
4594,12-02-2021 12:00,24 hrs.,wallstreetbets,GOEV,232,0,232,-232,10,73,46,3,NASDAQ
4594,12-02-2021 12:00,24 hrs.,wallstreetbets,GOGO,31,19,12,7,5,5,1,3,NASDAQ
4594,12-02-2021 12:00,24 hrs.,wallstreetbets,GOLD,259,16,243,-227,6,84,67,6,NASDAQ
4594,12-02-2021 12:00,24 hrs.,wallstreetbets,GOOG,1424,0,1424,-1424,1,614,192,1,NASDAQ
4594,12-02-2021 12:00,24 hrs.,wallstreetbets,GPRO,12,0,12,-12,2,2,0,2,NASDAQ
4594,12-02-2021 12:00,24 hrs.,wallstreetbets,GRID,12,0,12,-12,2,2,0,1,NASDAQ
4594,12-02-2021 12:00,24 hrs.,wallstreetbets,GRIL,25,0,25,-25,4,4,1,3,NASDAQ
4594,12-02-2021 12:00,24 hrs.,wallstreetbets,GRMN,6,0,6,-6,1,1,0,1,NASDAQ
4594,12-02-2021 12:00,24 hrs.,wallstreetbets,GRTS,6,0,6,-6,1,1,0,1,NASDAQ
4594,12-02-2021 12:00,24 hrs.,wallstreetbets,GRWG,213,0,213,-213,7,42,101,7,NASDAQ
4594,12-02-2021 12:00,24 hrs.,wallstreetbets,GTEC,12,0,12,-12,2,2,0,1,NASDAQ
4594,12-02-2021 12:00,24 hrs.,StockMarket,SRNE,12,0,12,-12,2,2,0,2,NASDAQ
4594,12-02-2021 12:00,24 hrs.,StockMarket,TELL,6,0,6,-6,1,1,0,1,NASDAQ
4594,12-02-2021 12:00,24 hrs.,StockMarket,TLRY,796,33,763,-730,13,254,236,12,NASDAQ
4594,12-02-2021 12:00,24 hrs.,StockMarket,TLSA,6,6,0,6,1,1,0,1,NASDAQ
4594,12-02-2021 12:00,24 hrs.,StockMarket,TNXP,56,0,56,-56,1,23,6,1,NASDAQ
4594,12-02-2021 12:00,24 hrs.,StockMarket,TSLA,37,0,37,-37,3,10,5,3,NASDAQ
4594,12-02-2021 12:00,24 hrs.,StockMarket,TXMD,6,0,6,-6,1,1,0,1,NASDAQ
4594,12-02-2021 12:00,24 hrs.,StockMarket,VRAY,20,0,20,-20,3,3,2,2,NASDAQ
4594,12-02-2021 12:00,24 hrs.,StockMarket,VXRT,14,0,14,-14,1,4,2,1,NASDAQ
4594,12-02-2021 12:00,24 hrs.,StockMarket,ZNGA,62,0,62,-62,4,19,8,3,NASDAQ
4594,12-02-2021 12:00,24 hrs.,StockMarket,UONEK,6,0,6,-6,1,1,0,1,NASDAQ
4594,12-02-2021 12:00,24 hrs.,pennystocks,AABB,18,18,0,18,3,3,0,2,OTC
4594,12-02-2021 12:00,24 hrs.,pennystocks,ABML,82,0,82,-82,1,31,16,1,OTC
4594,12-02-2021 12:00,24 hrs.,pennystocks,ABQQ,27,0,27,-27,2,9,1,2,OTC
4594,12-02-2021 12:00,24 hrs.,pennystocks,ABVG,7,0,7,-7,1,1,1,1,OTC
4594,12-02-2021 12:00,24 hrs.,pennystocks,ACRL,44,0,44,-44,2,13,10,2,OTC
4594,12-02-2021 12:00,24 hrs.,pennystocks,ADGO,12,0,12,-12,1,1,6,1,OTC
4594,12-02-2021 12:00,24 hrs.,pennystocks,ADTM,107,0,107,-107,4,29,33,4,OTC
4594,12-02-2021 12:00,24 hrs.,pennystocks,AEPT,6,6,0,6,1,1,0,1,OTC
4594,12-02-2021 12:00,24 hrs.,pennystocks,AGTK,7,0,7,-7,1,1,1,1,OTC
4594,12-02-2021 12:00,24 hrs.,pennystocks,AHFD,6,0,6,-6,1,1,0,1,OTC
4594,12-02-2021 12:00,24 hrs.,pennystocks,AITX,207,163,44,119,5,48,91,5,OTC
4594,12-02-2021 12:00,24 hrs.,pennystocks,ALKM,19,19,0,19,3,3,1,1,OTC
4594,12-02-2021 12:00,24 hrs.,pennystocks,ALLM,6,0,6,-6,1,1,0,1,OTC
4594,12-02-2021 12:00,24 hrs.,wallstreetbets,GWPH,13,13,0,13,1,0,9,1,NASDAQ
4594,12-02-2021 12:00,24 hrs.,wallstreetbets,HALO,6,0,6,-6,1,1,0,1,NASDAQ
4594,12-02-2021 12:00,24 hrs.,wallstreetbets,HEPA,9,0,9,-9,1,1,3,1,NASDAQ
4594,12-02-2021 12:00,24 hrs.,wallstreetbets,HGEN,12,0,12,-12,2,2,0,2,NASDAQ
4594,12-02-2021 12:00,24 hrs.,wallstreetbets,HIMX,7,7,0,7,1,1,1,1,NASDAQ
4594,12-02-2021 12:00,24 hrs.,wallstreetbets,HJLI,7,7,0,7,1,1,1,1,NASDAQ
4594,12-02-2021 12:00,24 hrs.,wallstreetbets,HOFV,12,0,12,-12,2,2,0,1,NASDAQ
4594,12-02-2021 12:00,24 hrs.,wallstreetbets,HSTO,13,7,6,1,2,2,1,2,NASDAQ
4594,12-02-2021 12:00,24 hrs.,wallstreetbets,HTBX,6,6,0,6,1,1,0,1,NASDAQ
4594,12-02-2021 12:00,24 hrs.,wallstreetbets,IBKR,532,0,532,-532,6,166,176,5,NASDAQ
4594,12-02-2021 12:00,24 hrs.,wallstreetbets,ICLN,12,0,12,-12,2,2,0,2,NASDAQ
4594,12-02-2021 12:00,24 hrs.,wallstreetbets,ICPT,12,0,12,-12,2,2,0,2,NASDAQ
4594,12-02-2021 12:00,24 hrs.,wallstreetbets,IDEX,65,35,30,5,10,10,5,6,NASDAQ
4594,12-02-2021 12:00,24 hrs.,wallstreetbets,IDXG,12,0,12,-12,2,2,0,1,NASDAQ
4594,12-02-2021 12:00,24 hrs.,wallstreetbets,IFMK,26,0,26,-26,4,4,2,3,NASDAQ
4594,12-02-2021 12:00,24 hrs.,wallstreetbets,IMGN,82,0,82,-82,1,26,26,1,NASDAQ
4594,12-02-2021 12:00,24 hrs.,wallstreetbets,IMMR,8,0,8,-8,1,1,2,1,NASDAQ
4594,12-02-2021 12:00,24 hrs.,wallstreetbets,INFI,70,21,49,-28,11,11,4,3,NASDAQ
4594,12-02-2021 12:00,24 hrs.,wallstreetbets,INFO,8,8,0,8,1,1,2,1,NASDAQ
4594,12-02-2021 12:00,24 hrs.,wallstreetbets,INPX,67,19,48,-29,11,11,1,10,NASDAQ
4594,12-02-2021 12:00,24 hrs.,wallstreetbets,INTC,39,7,32,-25,6,7,1,4,NASDAQ
4594,12-02-2021 12:00,24 hrs.,wallstreetbets,IRBT,654,7,647,-640,4,252,134,4,NASDAQ
4594,12-02-2021 12:00,24 hrs.,wallstreetbets,IRDM,6,0,6,-6,1,1,0,1,NASDAQ
4594,12-02-2021 12:00,24 hrs.,wallstreetbets,ITRM,12,0,12,-12,2,2,0,2,NASDAQ
4594,12-02-2021 12:00,24 hrs.,wallstreetbets,JAGX,18,0,18,-18,3,3,0,2,NASDAQ
4594,12-02-2021 12:00,24 hrs.,wallstreetbets,JBLU,12,12,0,12,2,2,0,2,NASDAQ
4594,12-02-2021 12:00,24 hrs.,wallstreetbets,JNCE,6,6,0,6,1,1,0,1,NASDAQ
4594,12-02-2021 12:00,24 hrs.,wallstreetbets,KERN,19,7,12,-5,3,3,1,3,NASDAQ
4594,12-02-2021 12:00,24 hrs.,wallstreetbets,KTRA,12,0,12,-12,2,2,0,1,NASDAQ
4594,12-02-2021 12:00,24 hrs.,wallstreetbets,KXIN,12,0,12,-12,2,2,0,1,NASDAQ
4594,12-02-2021 12:00,24 hrs.,wallstreetbets,LAKE,6,6,0,6,1,1,0,1,NASDAQ
4594,12-02-2021 12:00,24 hrs.,wallstreetbets,LAZR,7,7,0,7,1,1,1,1,NASDAQ
4594,12-02-2021 12:00,24 hrs.,wallstreetbets,LGHL,6,0,6,-6,1,1,0,1,NASDAQ
4594,12-02-2021 12:00,24 hrs.,wallstreetbets,LGND,6,6,0,6,1,1,0,1,NASDAQ
4594,12-02-2021 12:00,24 hrs.,wallstreetbets,LIFE,19,13,6,7,3,3,1,3,NASDAQ
4594,12-02-2021 12:00,24 hrs.,wallstreetbets,LIVE,1095,0,1095,-1095,3,430,223,3,NASDAQ
4594,12-02-2021 12:00,24 hrs.,wallstreetbets,LIVX,15,15,0,15,2,2,3,1,NASDAQ
4594,12-02-2021 12:00,24 hrs.,wallstreetbets,LKCO,67,6,61,-55,11,11,1,5,NASDAQ
4594,12-02-2021 12:00,24 hrs.,wallstreetbets,LLIT,6,0,6,-6,1,1,0,1,NASDAQ
4594,12-02-2021 12:00,24 hrs.,wallstreetbets,LLNW,35,14,21,-7,5,5,5,4,NASDAQ
4594,12-02-2021 12:00,24 hrs.,pennystocks,CLHI,19,0,19,-19,1,5,5,1,OTC
4594,12-02-2021 12:00,24 hrs.,pennystocks,CLIS,6,0,6,-6,1,1,0,1,OTC
4594,12-02-2021 12:00,24 hrs.,pennystocks,CLWD,41,0,41,-41,3,14,1,3,OTC
4594,12-02-2021 12:00,24 hrs.,pennystocks,CNNA,23,23,0,23,2,2,11,2,OTC
4594,12-02-2021 12:00,24 hrs.,pennystocks,CNXS,6,0,6,-6,1,1,0,1,OTC
4594,12-02-2021 12:00,24 hrs.,pennystocks,COMS,30,0,30,-30,1,6,14,1,OTC
4594,12-02-2021 12:00,24 hrs.,pennystocks,CORG,147,0,147,-147,8,28,59,3,OTC
4594,12-02-2021 12:00,24 hrs.,pennystocks,CTLE,6,6,0,6,1,1,0,1,OTC
4594,12-02-2021 12:00,24 hrs.,pennystocks,CVAT,6,0,6,-6,1,1,0,1,OTC
4594,12-02-2021 12:00,24 hrs.,pennystocks,CYPW,6,6,0,6,1,1,0,1,OTC
4594,12-02-2021 12:00,24 hrs.,pennystocks,DGMA,6,6,0,6,1,1,0,1,OTC
4594,12-02-2021 12:00,24 hrs.,pennystocks,DGTW,6,0,6,-6,1,1,0,1,OTC
4594,12-02-2021 12:00,24 hrs.,pennystocks,DIGI,13,13,0,13,2,2,1,1,OTC
4594,12-02-2021 12:00,24 hrs.,pennystocks,DPLS,263,257,6,251,7,67,101,6,OTC
4594,12-02-2021 12:00,24 hrs.,pennystocks,DSGT,7,0,7,-7,1,1,1,1,OTC
4594,12-02-2021 12:00,24 hrs.,pennystocks,DTST,45,0,45,-45,2,13,11,2,OTC
4594,12-02-2021 12:00,24 hrs.,pennystocks,ECCI,6,6,0,6,1,1,0,1,OTC
4594,12-02-2021 12:00,24 hrs.,pennystocks,ECEZ,197,101,96,5,8,57,51,6,OTC
4594,12-02-2021 12:00,24 hrs.,pennystocks,EDXC,14,0,14,-14,2,2,2,2,OTC
4594,12-02-2021 12:00,24 hrs.,pennystocks,EHOS,7,0,7,-7,1,1,1,1,OTC
4594,12-02-2021 12:00,24 hrs.,pennystocks,ELCR,13,0,13,-13,2,2,1,2,OTC
4594,12-02-2021 12:00,24 hrs.,pennystocks,ELRA,6,0,6,-6,1,1,0,1,OTC
4594,12-02-2021 12:00,24 hrs.,wallstreetbets,EVER,737,6,731,-725,2,296,137,2,NASDAQ
4594,12-02-2021 12:00,24 hrs.,wallstreetbets,EVFM,6,0,6,-6,1,1,0,1,NASDAQ
4594,12-02-2021 12:00,24 hrs.,wallstreetbets,LRCX,6,0,6,-6,1,1,0,1,NASDAQ
4594,12-02-2021 12:00,24 hrs.,wallstreetbets,MARA,78,12,66,-54,12,13,4,10,NASDAQ
4594,12-02-2021 12:00,24 hrs.,wallstreetbets,MARK,13,7,6,1,2,2,1,2,NASDAQ
4594,12-02-2021 12:00,24 hrs.,wallstreetbets,MBRX,19,19,0,19,3,3,1,2,NASDAQ
4594,12-02-2021 12:00,24 hrs.,wallstreetbets,MCHP,389,0,389,-389,1,139,107,1,NASDAQ
4594,12-02-2021 12:00,24 hrs.,wallstreetbets,MESO,6,0,6,-6,1,1,0,1,NASDAQ
4594,12-02-2021 12:00,24 hrs.,wallstreetbets,METX,6,0,6,-6,1,1,0,1,NASDAQ
4594,12-02-2021 12:00,24 hrs.,wallstreetbets,MGNI,35,0,35,-35,5,5,5,5,NASDAQ
4594,12-02-2021 12:00,24 hrs.,wallstreetbets,MITK,6,0,6,-6,1,1,0,1,NASDAQ
4594,12-02-2021 12:00,24 hrs.,wallstreetbets,MITO,6,0,6,-6,1,1,0,1,NASDAQ
4594,12-02-2021 12:00,24 hrs.,wallstreetbets,MNPR,6,6,0,6,1,1,0,1,NASDAQ
4594,12-02-2021 12:00,24 hrs.,wallstreetbets,MOGO,7,7,0,7,1,1,1,1,NASDAQ
4594,12-02-2021 12:00,24 hrs.,wallstreetbets,MOSY,7,7,0,7,1,1,1,1,NASDAQ
4594,12-02-2021 12:00,24 hrs.,wallstreetbets,MOTS,12,0,12,-12,2,2,0,1,NASDAQ
4594,12-02-2021 12:00,24 hrs.,wallstreetbets,MRAM,6,0,6,-6,1,1,0,1,NASDAQ
4594,12-02-2021 12:00,24 hrs.,wallstreetbets,MSFT,1562,7,1555,-1548,3,642,266,3,NASDAQ
4594,12-02-2021 12:00,24 hrs.,wallstreetbets,MSTR,45,33,12,21,7,7,3,4,NASDAQ
4594,12-02-2021 12:00,24 hrs.,wallstreetbets,MVIS,760,8,752,-744,19,248,188,14,NASDAQ
4594,12-02-2021 12:00,24 hrs.,wallstreetbets,NAKD,490,78,412,-334,79,80,14,66,NASDAQ
4594,12-02-2021 12:00,24 hrs.,pennystocks,ENCS,6,6,0,6,1,1,0,1,OTC
4594,12-02-2021 12:00,24 hrs.,pennystocks,ENDV,6,6,0,6,1,1,0,1,OTC
4594,12-02-2021 12:00,24 hrs.,pennystocks,ENTI,13,0,13,-13,2,2,1,1,OTC
4594,12-02-2021 12:00,24 hrs.,pennystocks,ENZC,13,0,13,-13,2,2,1,1,OTC
4594,12-02-2021 12:00,24 hrs.,pennystocks,EPAZ,139,0,139,-139,3,48,31,2,OTC
4594,12-02-2021 12:00,24 hrs.,pennystocks,ERBB,6,0,6,-6,1,1,0,1,OTC
4594,12-02-2021 12:00,24 hrs.,pennystocks,ETFM,118,6,112,-106,4,28,46,4,OTC
4594,12-02-2021 12:00,24 hrs.,pennystocks,EUOT,7,0,7,-7,1,1,1,1,OTC
4594,12-02-2021 12:00,24 hrs.,pennystocks,EVSV,6,0,6,-6,1,1,0,1,OTC
4594,12-02-2021 12:00,24 hrs.,pennystocks,EWLL,12,0,12,-12,2,2,0,1,OTC
4594,12-02-2021 12:00,24 hrs.,pennystocks,EXMT,19,0,19,-19,2,4,3,2,OTC
4594,12-02-2021 12:00,24 hrs.,pennystocks,FBEC,6,6,0,6,1,1,0,1,OTC
4594,12-02-2021 12:00,24 hrs.,pennystocks,FDBH,7,7,0,7,1,1,1,1,OTC
4594,12-02-2021 12:00,24 hrs.,pennystocks,FMCC,124,0,124,-124,1,44,32,1,OTC
4594,12-02-2021 12:00,24 hrs.,pennystocks,FNMA,124,0,124,-124,1,44,32,1,OTC
4594,12-02-2021 12:00,24 hrs.,pennystocks,FPVD,15,0,15,-15,2,3,1,2,OTC
4594,12-02-2021 12:00,24 hrs.,pennystocks,FTFY,6,6,0,6,1,1,0,1,OTC
4594,12-02-2021 12:00,24 hrs.,pennystocks,FUTL,7,7,0,7,1,1,1,1,OTC
4594,12-02-2021 12:00,24 hrs.,pennystocks,FWAV,6,0,6,-6,1,1,0,1,OTC
4594,12-02-2021 12:00,24 hrs.,pennystocks,GAHC,39,0,39,-39,1,10,15,1,OTC
4594,12-02-2021 12:00,24 hrs.,pennystocks,GARB,12,0,12,-12,2,2,0,2,OTC
4594,12-02-2021 12:00,24 hrs.,pennystocks,GAXY,108,0,108,-108,2,28,44,2,OTC
4594,12-02-2021 12:00,24 hrs.,pennystocks,GDET,13,0,13,-13,2,2,1,2,OTC
4594,12-02-2021 12:00,24 hrs.,pennystocks,GEGI,6,0,6,-6,1,1,0,1,OTC
4594,12-02-2021 12:00,24 hrs.,pennystocks,GLGI,124,0,124,-124,1,44,32,1,OTC
4594,12-02-2021 12:00,24 hrs.,pennystocks,GMER,6,0,6,-6,1,1,0,1,OTC
4594,12-02-2021 12:00,24 hrs.,pennystocks,GMEV,569,563,6,557,2,224,113,2,OTC
4594,12-02-2021 12:00,24 hrs.,pennystocks,GNCP,10,0,10,-10,1,1,4,1,OTC
4594,12-02-2021 12:00,24 hrs.,pennystocks,GPFT,37,24,13,11,3,6,13,3,OTC
4594,12-02-2021 12:00,24 hrs.,pennystocks,GRCU,6,6,0,6,1,1,0,1,OTC
4594,12-02-2021 12:00,24 hrs.,pennystocks,GRCV,6,0,6,-6,1,1,0,1,OTC
4594,12-02-2021 12:00,24 hrs.,pennystocks,GTCH,48,23,25,-2,5,6,16,2,OTC
4594,12-02-2021 12:00,24 hrs.,pennystocks,GTEH,164,86,78,8,6,57,26,6,OTC
4594,12-02-2021 12:00,24 hrs.,pennystocks,GTLL,59,24,35,-11,2,19,13,2,OTC
4594,12-02-2021 12:00,24 hrs.,pennystocks,HCMC,296,50,246,-196,43,54,16,35,OTC
4594,12-02-2021 12:00,24 hrs.,pennystocks,HCYT,12,0,12,-12,2,2,0,1,OTC
4594,12-02-2021 12:00,24 hrs.,pennystocks,HEMP,39,7,32,-25,6,6,3,6,OTC
4594,12-02-2021 12:00,24 hrs.,pennystocks,HIPH,1255,6,1249,-1243,6,554,123,4,OTC
4594,12-02-2021 12:00,24 hrs.,pennystocks,HMNY,20,0,20,-20,3,3,2,3,OTC
4594,12-02-2021 12:00,24 hrs.,pennystocks,HPMM,17,0,17,-17,2,2,5,2,OTC
4594,12-02-2021 12:00,24 hrs.,pennystocks,HPTY,188,0,188,-188,2,63,54,2,OTC
4594,12-02-2021 12:00,24 hrs.,pennystocks,HQGE,19,6,13,-7,3,3,1,3,OTC
4594,12-02-2021 12:00,24 hrs.,pennystocks,HRTH,124,0,124,-124,1,44,32,1,OTC
4594,12-02-2021 12:00,24 hrs.,pennystocks,HYII,7,7,0,7,1,1,1,1,OTC
4594,12-02-2021 12:00,24 hrs.,wallstreetbets,GTHX,7,0,7,-7,1,1,1,1,NASDAQ
4594,12-02-2021 12:00,24 hrs.,wallstreetbets,PZZA,7,7,0,7,1,1,1,1,NASDAQ
4594,12-02-2021 12:00,24 hrs.,wallstreetbets,QCOM,6,0,6,-6,1,1,0,1,NASDAQ
4594,12-02-2021 12:00,24 hrs.,wallstreetbets,QRVO,34,0,34,-34,2,10,6,1,NASDAQ
4594,12-02-2021 12:00,24 hrs.,wallstreetbets,QUIK,19,6,13,-7,3,3,1,2,NASDAQ
4594,12-02-2021 12:00,24 hrs.,wallstreetbets,RBBN,12,0,12,-12,2,2,0,1,NASDAQ
4594,12-02-2021 12:00,24 hrs.,wallstreetbets,RCMT,50,7,43,-36,8,8,2,8,NASDAQ
4594,12-02-2021 12:00,24 hrs.,wallstreetbets,REAL,54,29,25,4,8,8,6,8,NASDAQ
4594,12-02-2021 12:00,24 hrs.,wallstreetbets,REGI,12,6,6,0,2,2,0,2,NASDAQ
4594,12-02-2021 12:00,24 hrs.,wallstreetbets,REGN,7,7,0,7,1,1,1,1,NASDAQ
4594,12-02-2021 12:00,24 hrs.,wallstreetbets,RIDE,24,6,18,-12,4,4,0,4,NASDAQ
4594,12-02-2021 12:00,24 hrs.,wallstreetbets,RIOT,59,6,53,-47,9,10,3,8,NASDAQ
4594,12-02-2021 12:00,24 hrs.,wallstreetbets,RKDA,6,0,6,-6,1,1,0,1,NASDAQ
4594,12-02-2021 12:00,24 hrs.,wallstreetbets,RMTI,32,20,12,8,5,5,2,4,NASDAQ
4594,12-02-2021 12:00,24 hrs.,wallstreetbets,ROCK,6,0,6,-6,1,1,0,1,NASDAQ
4594,12-02-2021 12:00,24 hrs.,wallstreetbets,ROLL,6,0,6,-6,1,1,0,1,NASDAQ
4594,12-02-2021 12:00,24 hrs.,wallstreetbets,ROOT,6,0,6,-6,1,1,0,1,NASDAQ
4594,12-02-2021 12:00,24 hrs.,wallstreetbets,SABR,7,7,0,7,1,1,1,1,NASDAQ
4594,12-02-2021 12:00,24 hrs.,wallstreetbets,SAGE,6,0,6,-6,1,1,0,1,NASDAQ
4594,12-02-2021 12:00,24 hrs.,wallstreetbets,SALM,6,0,6,-6,1,1,0,1,NASDAQ
4594,12-02-2021 12:00,24 hrs.,pennystocks,HYSR,138,126,12,114,4,43,36,4,OTC
4594,12-02-2021 12:00,24 hrs.,pennystocks,IBRC,10,0,10,-10,1,2,2,1,OTC
4594,12-02-2021 12:00,24 hrs.,pennystocks,ICBU,7,0,7,-7,1,1,1,1,OTC
4594,12-02-2021 12:00,24 hrs.,pennystocks,ICLD,12,0,12,-12,2,2,0,1,OTC
4594,12-02-2021 12:00,24 hrs.,pennystocks,IDCN,6,0,6,-6,1,1,0,1,OTC
4594,12-02-2021 12:00,24 hrs.,pennystocks,IDGC,8,0,8,-8,1,1,2,1,OTC
4594,12-02-2021 12:00,24 hrs.,pennystocks,ILUS,6,0,6,-6,1,1,0,1,OTC
4594,12-02-2021 12:00,24 hrs.,pennystocks,IMJX,6,6,0,6,1,1,0,1,OTC
4594,12-02-2021 12:00,24 hrs.,pennystocks,IMTL,6,0,6,-6,1,1,0,1,OTC
4594,12-02-2021 12:00,24 hrs.,pennystocks,INCT,7,0,7,-7,1,1,1,1,OTC
4594,12-02-2021 12:00,24 hrs.,pennystocks,INIS,21,0,21,-21,1,8,1,1,OTC
4594,12-02-2021 12:00,24 hrs.,pennystocks,INKW,58,6,52,-46,7,14,2,7,OTC
4594,12-02-2021 12:00,24 hrs.,pennystocks,INND,111,36,75,-39,8,23,33,8,OTC
4594,12-02-2021 12:00,24 hrs.,pennystocks,INTV,7,0,7,-7,1,1,1,1,OTC
4594,12-02-2021 12:00,24 hrs.,pennystocks,INVU,6,0,6,-6,1,1,0,1,OTC
4594,12-02-2021 12:00,24 hrs.,pennystocks,IONI,21,0,21,-21,1,8,1,1,OTC
4594,12-02-2021 12:00,24 hrs.,pennystocks,IPIX,52,52,0,52,1,8,32,1,OTC
4594,12-02-2021 12:00,24 hrs.,pennystocks,IPSI,6,6,0,6,1,1,0,1,OTC
4594,12-02-2021 12:00,24 hrs.,pennystocks,IQST,12,0,12,-12,2,2,0,2,OTC
4594,12-02-2021 12:00,24 hrs.,pennystocks,ISWH,19,0,19,-19,1,7,1,1,OTC
4594,12-02-2021 12:00,24 hrs.,pennystocks,IWSY,21,0,21,-21,1,8,1,1,OTC
4594,12-02-2021 12:00,24 hrs.,pennystocks,JETR,6,0,6,-6,1,1,0,1,OTC
4594,12-02-2021 12:00,24 hrs.,pennystocks,JKSM,6,0,6,-6,1,1,0,1,OTC
4594,12-02-2021 12:00,24 hrs.,pennystocks,KAVL,6,0,6,-6,1,1,0,1,OTC
4594,12-02-2021 12:00,24 hrs.,pennystocks,KGET,8,0,8,-8,1,1,2,1,OTC
4594,12-02-2021 12:00,24 hrs.,pennystocks,KGKG,43,25,18,7,5,8,7,3,OTC
4594,12-02-2021 12:00,24 hrs.,pennystocks,KSHB,26,0,26,-26,1,9,4,1,OTC
4594,12-02-2021 12:00,24 hrs.,pennystocks,KWBT,138,7,131,-124,3,46,34,3,OTC
4594,12-02-2021 12:00,24 hrs.,pennystocks,KYNC,38,31,7,24,6,6,2,2,OTC
4594,12-02-2021 12:00,24 hrs.,pennystocks,LBSR,7,0,7,-7,1,1,1,1,OTC
4594,12-02-2021 12:00,24 hrs.,pennystocks,LIVC,5,0,5,-5,1,0,1,1,OTC
4594,12-02-2021 12:00,24 hrs.,pennystocks,LOGQ,6,0,6,-6,1,1,0,1,OTC
4594,12-02-2021 12:00,24 hrs.,pennystocks,LQMT,70,70,0,70,1,23,20,1,OTC
4594,12-02-2021 12:00,24 hrs.,pennystocks,LTNC,13,6,7,-1,2,2,1,2,OTC
4594,12-02-2021 12:00,24 hrs.,pennystocks,LTUM,6,0,6,-6,1,1,0,1,OTC
4594,12-02-2021 12:00,24 hrs.,pennystocks,LUVU,144,0,144,-144,4,48,32,3,OTC
4594,12-02-2021 12:00,24 hrs.,pennystocks,LVVV,63,24,39,-15,5,13,17,3,OTC
4594,12-02-2021 12:00,24 hrs.,pennystocks,MAXD,20,0,20,-20,3,3,2,3,OTC
4594,12-02-2021 12:00,24 hrs.,pennystocks,MCOA,13,7,6,1,2,2,1,2,OTC
4594,12-02-2021 12:00,24 hrs.,pennystocks,MGLG,6,6,0,6,1,1,0,1,OTC
4594,12-02-2021 12:00,24 hrs.,pennystocks,MIKP,6,6,0,6,1,1,0,1,OTC
4594,12-02-2021 12:00,24 hrs.,pennystocks,MINE,710,172,538,-366,5,297,96,5,OTC
4594,12-02-2021 12:00,24 hrs.,pennystocks,MJNA,161,69,92,-23,9,43,39,7,OTC
4594,12-02-2021 12:00,24 hrs.,pennystocks,MLFB,35,0,35,-35,3,10,3,3,OTC
4594,12-02-2021 12:00,24 hrs.,pennystocks,MMEX,49,21,28,-7,4,11,11,4,OTC
4594,12-02-2021 12:00,24 hrs.,pennystocks,MOPN,7,0,7,-7,1,1,1,1,OTC
4594,12-02-2021 12:00,24 hrs.,pennystocks,MRMD,46,46,0,46,1,19,4,1,OTC
4594,12-02-2021 12:00,24 hrs.,pennystocks,MRNJ,13,13,0,13,2,2,1,1,OTC
4594,12-02-2021 12:00,24 hrs.,pennystocks,MRPI,7,0,7,-7,1,1,1,1,OTC
4594,12-02-2021 12:00,24 hrs.,pennystocks,NBVG,6,0,6,-6,1,1,0,1,OTC
4594,12-02-2021 12:00,24 hrs.,pennystocks,NPHC,52,0,52,-52,3,11,18,2,OTC
4594,12-02-2021 12:00,24 hrs.,pennystocks,NSAV,39,0,39,-39,2,6,19,2,OTC
4594,12-02-2021 12:00,24 hrs.,pennystocks,NSEO,6,6,0,6,1,1,0,1,OTC
4594,12-02-2021 12:00,24 hrs.,pennystocks,NSPX,14,0,14,-14,2,2,2,2,OTC
4594,12-02-2021 12:00,24 hrs.,pennystocks,NUKK,7,0,7,-7,1,1,1,1,OTC
4594,12-02-2021 12:00,24 hrs.,pennystocks,NVNT,5,0,5,-5,1,0,1,1,OTC
4594,12-02-2021 12:00,24 hrs.,pennystocks,NWPN,6,0,6,-6,1,1,0,1,OTC
4594,12-02-2021 12:00,24 hrs.,pennystocks,OPTI,39,0,39,-39,4,11,1,4,OTC
4594,12-02-2021 12:00,24 hrs.,pennystocks,OPVS,6,0,6,-6,1,1,0,1,OTC
4594,12-02-2021 12:00,24 hrs.,pennystocks,OWCP,7,0,7,-7,1,1,1,1,OTC
4594,12-02-2021 12:00,24 hrs.,pennystocks,OZSC,214,193,21,172,4,52,94,4,OTC
4594,12-02-2021 12:00,24 hrs.,pennystocks,PAOG,44,0,44,-44,2,15,6,2,OTC
4594,12-02-2021 12:00,24 hrs.,pennystocks,PASO,225,62,163,-101,5,69,67,5,OTC
4594,12-02-2021 12:00,24 hrs.,pennystocks,PHIL,6,0,6,-6,1,1,0,1,OTC
4594,12-02-2021 12:00,24 hrs.,wallstreetbets,NAOV,6,0,6,-6,1,1,0,1,NASDAQ
4594,12-02-2021 12:00,24 hrs.,wallstreetbets,NBEV,8,0,8,-8,1,2,0,1,NASDAQ
4594,12-02-2021 12:00,24 hrs.,wallstreetbets,NCLH,7,0,7,-7,1,1,1,1,NASDAQ
4594,12-02-2021 12:00,24 hrs.,wallstreetbets,NDRA,13,7,6,1,2,2,1,2,NASDAQ
4594,12-02-2021 12:00,24 hrs.,wallstreetbets,NEOS,6,0,6,-6,1,1,0,1,NASDAQ
4594,12-02-2021 12:00,24 hrs.,wallstreetbets,NEPT,31,0,31,-31,5,5,1,4,NASDAQ
4594,12-02-2021 12:00,24 hrs.,wallstreetbets,NKLA,26,0,26,-26,4,4,2,4,NASDAQ
4594,12-02-2021 12:00,24 hrs.,wallstreetbets,NLOK,13,0,13,-13,2,2,1,1,NASDAQ
4594,12-02-2021 12:00,24 hrs.,wallstreetbets,NNDM,33,7,26,-19,5,6,1,4,NASDAQ
4594,12-02-2021 12:00,24 hrs.,wallstreetbets,NNOX,6,0,6,-6,1,1,0,1,NASDAQ
4594,12-02-2021 12:00,24 hrs.,wallstreetbets,NOVN,7,0,7,-7,1,1,1,1,NASDAQ
4594,12-02-2021 12:00,24 hrs.,wallstreetbets,NUAN,6,0,6,-6,1,1,0,1,NASDAQ
4594,12-02-2021 12:00,24 hrs.,wallstreetbets,NVAX,6,6,0,6,1,1,0,1,NASDAQ
4594,12-02-2021 12:00,24 hrs.,wallstreetbets,NVCN,32,6,26,-20,5,5,2,5,NASDAQ
4594,12-02-2021 12:00,24 hrs.,wallstreetbets,NVDA,344,0,344,-344,6,132,56,3,NASDAQ
4594,12-02-2021 12:00,24 hrs.,wallstreetbets,NVIV,6,0,6,-6,1,1,0,1,NASDAQ
4594,12-02-2021 12:00,24 hrs.,wallstreetbets,NXPI,389,0,389,-389,1,139,107,1,NASDAQ
4594,12-02-2021 12:00,24 hrs.,wallstreetbets,NXTD,18,0,18,-18,3,3,0,2,NASDAQ
4594,12-02-2021 12:00,24 hrs.,wallstreetbets,OCGN,109,0,109,-109,18,18,1,15,NASDAQ
4594,12-02-2021 12:00,24 hrs.,wallstreetbets,ONTX,6,0,6,-6,1,1,0,1,NASDAQ
4594,12-02-2021 12:00,24 hrs.,wallstreetbets,ONVO,13,7,6,1,2,2,1,2,NASDAQ
4594,12-02-2021 12:00,24 hrs.,wallstreetbets,OPGN,7,7,0,7,1,1,1,1,NASDAQ
4594,12-02-2021 12:00,24 hrs.,wallstreetbets,OPTT,18,0,18,-18,3,3,0,3,NASDAQ
4594,12-02-2021 12:00,24 hrs.,wallstreetbets,OSTK,9,0,9,-9,1,1,3,1,NASDAQ
4594,12-02-2021 12:00,24 hrs.,wallstreetbets,OTLK,6,0,6,-6,1,1,0,1,NASDAQ
4594,12-02-2021 12:00,24 hrs.,wallstreetbets,PACB,14,0,14,-14,2,2,2,1,NASDAQ
4594,12-02-2021 12:00,24 hrs.,wallstreetbets,PAVM,6,0,6,-6,1,1,0,1,NASDAQ
4594,12-02-2021 12:00,24 hrs.,wallstreetbets,PDSB,12,0,12,-12,2,2,0,1,NASDAQ
4594,12-02-2021 12:00,24 hrs.,wallstreetbets,PHIO,7,0,7,-7,1,1,1,1,NASDAQ
4594,12-02-2021 12:00,24 hrs.,wallstreetbets,PLAY,403,6,397,-391,12,110,135,9,NASDAQ
4594,12-02-2021 12:00,24 hrs.,wallstreetbets,PLUG,18,0,18,-18,3,3,0,3,NASDAQ
4594,12-02-2021 12:00,24 hrs.,wallstreetbets,PODD,6,0,6,-6,1,1,0,1,NASDAQ
4594,12-02-2021 12:00,24 hrs.,wallstreetbets,POTX,12,0,12,-12,2,2,0,2,NASDAQ
4594,12-02-2021 12:00,24 hrs.,wallstreetbets,POWW,142,28,114,-86,23,23,4,17,NASDAQ
4594,12-02-2021 12:00,24 hrs.,wallstreetbets,PPBT,6,0,6,-6,1,1,0,1,NASDAQ
4594,12-02-2021 12:00,24 hrs.,wallstreetbets,PRCH,24,6,18,-12,4,4,0,3,NASDAQ
4594,12-02-2021 12:00,24 hrs.,wallstreetbets,PRPL,921,0,921,-921,1,392,133,1,NASDAQ
4594,12-02-2021 12:00,24 hrs.,wallstreetbets,PRQR,6,0,6,-6,1,1,0,1,NASDAQ
4594,12-02-2021 12:00,24 hrs.,wallstreetbets,PRTS,7,0,7,-7,1,1,1,1,NASDAQ
4594,12-02-2021 12:00,24 hrs.,wallstreetbets,PSEC,31,19,12,7,3,2,15,2,NASDAQ
4594,12-02-2021 12:00,24 hrs.,wallstreetbets,PSTV,19,7,12,-5,3,3,1,3,NASDAQ
4594,12-02-2021 12:00,24 hrs.,wallstreetbets,PTMN,12,0,12,-12,2,2,0,1,NASDAQ
4594,12-02-2021 12:00,24 hrs.,wallstreetbets,PTPI,6,0,6,-6,1,1,0,1,NASDAQ
4594,12-02-2021 12:00,24 hrs.,wallstreetbets,PUBM,12,0,12,-12,2,2,0,2,NASDAQ
4594,12-02-2021 12:00,24 hrs.,wallstreetbets,PYPL,20,0,20,-20,3,3,2,3,NASDAQ
4594,12-02-2021 12:00,24 hrs.,pennystocks,PMCB,19,0,19,-19,3,3,1,1,OTC
4594,12-02-2021 12:00,24 hrs.,pennystocks,PMDP,6,0,6,-6,1,1,0,1,OTC
4594,12-02-2021 12:00,24 hrs.,pennystocks,PPJE,14,0,14,-14,2,2,2,2,OTC
4594,12-02-2021 12:00,24 hrs.,pennystocks,PRPM,6,0,6,-6,1,1,0,1,OTC
4594,12-02-2021 12:00,24 hrs.,pennystocks,PSYC,290,0,290,-290,6,107,52,3,OTC
4594,12-02-2021 12:00,24 hrs.,pennystocks,PUGE,6,6,0,6,1,1,0,1,OTC
4594,12-02-2021 12:00,24 hrs.,pennystocks,PZOO,7,7,0,7,1,1,1,1,OTC
4594,12-02-2021 12:00,24 hrs.,pennystocks,QEBR,6,0,6,-6,1,1,0,1,OTC
4594,12-02-2021 12:00,24 hrs.,pennystocks,QMCI,6,0,6,-6,1,1,0,1,OTC
4594,12-02-2021 12:00,24 hrs.,pennystocks,QPRC,13,0,13,-13,2,2,1,1,OTC
4594,12-02-2021 12:00,24 hrs.,pennystocks,RELI,27,0,27,-27,1,6,11,1,OTC
4594,12-02-2021 12:00,24 hrs.,pennystocks,RITE,36,36,0,36,1,6,20,1,OTC
4594,12-02-2021 12:00,24 hrs.,pennystocks,RLBD,12,12,0,12,1,3,2,1,OTC
4594,12-02-2021 12:00,24 hrs.,pennystocks,RLTR,12,0,12,-12,2,2,0,2,OTC
4594,12-02-2021 12:00,24 hrs.,pennystocks,RMTD,6,6,0,6,1,1,0,1,OTC
4594,12-02-2021 12:00,24 hrs.,pennystocks,RNVA,124,0,124,-124,1,44,32,1,OTC
4594,12-02-2021 12:00,24 hrs.,pennystocks,ROTH,6,0,6,-6,1,1,0,1,OTC
4594,12-02-2021 12:00,24 hrs.,pennystocks,RRTS,124,0,124,-124,1,44,32,1,OTC
4594,12-02-2021 12:00,24 hrs.,pennystocks,RSSV,12,6,6,0,2,2,0,2,OTC
4594,12-02-2021 12:00,24 hrs.,pennystocks,RTON,192,6,186,-180,8,50,60,7,OTC
4594,12-02-2021 12:00,24 hrs.,pennystocks,SCIE,326,326,0,326,2,138,42,2,OTC
4594,12-02-2021 12:00,24 hrs.,pennystocks,SEEK,7,0,7,-7,1,1,1,1,OTC
4594,12-02-2021 12:00,24 hrs.,pennystocks,SFOR,6,0,6,-6,1,1,0,1,OTC
4594,12-02-2021 12:00,24 hrs.,pennystocks,SGLN,87,0,87,-87,1,16,51,1,OTC
4594,12-02-2021 12:00,24 hrs.,pennystocks,SGMD,254,0,254,-254,9,75,68,9,OTC
4594,12-02-2021 12:00,24 hrs.,pennystocks,SGSI,155,6,149,-143,5,50,35,4,OTC
4594,12-02-2021 12:00,24 hrs.,pennystocks,SHMP,23,6,17,-11,2,1,13,2,OTC
4594,12-02-2021 12:00,24 hrs.,pennystocks,SHRG,7,0,7,-7,1,1,1,1,OTC
4594,12-02-2021 12:00,24 hrs.,pennystocks,SILO,15,0,15,-15,1,3,5,1,OTC
4594,12-02-2021 12:00,24 hrs.,pennystocks,SIML,103,0,103,-103,6,25,29,2,OTC
4594,12-02-2021 12:00,24 hrs.,pennystocks,SING,28,0,28,-28,2,1,18,2,OTC
4594,12-02-2021 12:00,24 hrs.,pennystocks,SNPW,498,333,165,168,5,179,120,5,OTC
4594,12-02-2021 12:00,24 hrs.,pennystocks,SPRN,6,0,6,-6,1,1,0,1,OTC
4594,12-02-2021 12:00,24 hrs.,pennystocks,SRMX,341,174,167,7,14,73,139,12,OTC
4594,12-02-2021 12:00,24 hrs.,pennystocks,SSFT,39,0,39,-39,4,11,1,2,OTC
4594,12-02-2021 12:00,24 hrs.,pennystocks,STEV,35,0,35,-35,4,7,5,2,OTC
4594,12-02-2021 12:00,24 hrs.,pennystocks,SUGR,6,0,6,-6,1,1,0,1,OTC
4594,12-02-2021 12:00,24 hrs.,pennystocks,SUIC,18,6,12,-6,3,3,0,2,OTC
4594,12-02-2021 12:00,24 hrs.,pennystocks,SURG,124,0,124,-124,1,44,32,1,OTC
4594,12-02-2021 12:00,24 hrs.,pennystocks,TBEV,6,0,6,-6,1,1,0,1,OTC
4594,12-02-2021 12:00,24 hrs.,pennystocks,TFZI,6,6,0,6,1,1,0,1,OTC
4594,12-02-2021 12:00,24 hrs.,pennystocks,TLSS,236,157,79,78,4,59,102,4,OTC
4594,12-02-2021 12:00,24 hrs.,pennystocks,TPAC,6,6,0,6,1,1,0,1,OTC
4594,12-02-2021 12:00,24 hrs.,pennystocks,TREP,6,6,0,6,1,1,0,1,OTC
4594,12-02-2021 12:00,24 hrs.,pennystocks,TRTC,15,0,15,-15,1,0,11,1,OTC
4594,12-02-2021 12:00,24 hrs.,pennystocks,TSNP,36,6,30,-24,6,6,0,6,OTC
4594,12-02-2021 12:00,24 hrs.,pennystocks,TSOI,7,0,7,-7,1,1,1,1,OTC
4594,12-02-2021 12:00,24 hrs.,pennystocks,TSTS,12,12,0,12,2,2,0,1,OTC
4594,12-02-2021 12:00,24 hrs.,pennystocks,TXMC,6,0,6,-6,1,1,0,1,OTC
4594,12-02-2021 12:00,24 hrs.,pennystocks,UATG,12,0,12,-12,2,2,0,2,OTC
4594,12-02-2021 12:00,24 hrs.,pennystocks,UNVC,6,0,6,-6,1,1,0,1,OTC
4594,12-02-2021 12:00,24 hrs.,pennystocks,USMJ,27,0,27,-27,4,4,3,3,OTC
4594,12-02-2021 12:00,24 hrs.,pennystocks,USRM,6,6,0,6,1,1,0,1,OTC
4594,12-02-2021 12:00,24 hrs.,pennystocks,UVSE,25,0,25,-25,3,4,5,3,OTC
4594,12-02-2021 12:00,24 hrs.,pennystocks,VNUE,21,0,21,-21,1,8,1,1,OTC
4594,12-02-2021 12:00,24 hrs.,pennystocks,VPER,6,0,6,-6,1,1,0,1,OTC
4594,12-02-2021 12:00,24 hrs.,pennystocks,VSYM,18,0,18,-18,3,3,0,1,OTC
4594,12-02-2021 12:00,24 hrs.,pennystocks,VTLR,6,6,0,6,1,1,0,1,OTC
4594,12-02-2021 12:00,24 hrs.,pennystocks,VYST,6,0,6,-6,1,1,0,1,OTC
4594,12-02-2021 12:00,24 hrs.,pennystocks,WARM,143,0,143,-143,2,50,35,2,OTC
4594,12-02-2021 12:00,24 hrs.,pennystocks,WDHR,14,0,14,-14,2,2,2,1,OTC
4594,12-02-2021 12:00,24 hrs.,pennystocks,WDLF,193,176,17,159,6,40,89,6,OTC
4594,12-02-2021 12:00,24 hrs.,pennystocks,WHEN,7,7,0,7,1,1,1,1,OTC
4594,12-02-2021 12:00,24 hrs.,pennystocks,MODC,6,6,0,6,1,1,0,1,OTC
4594,12-02-2021 12:00,24 hrs.,pennystocks,XDSL,8,0,8,-8,1,1,2,1,OTC
4594,12-02-2021 12:00,24 hrs.,pennystocks,XMET,8,8,0,8,1,0,4,1,OTC
4594,12-02-2021 12:00,24 hrs.,pennystocks,XTRM,6,6,0,6,1,1,0,1,OTC
4594,12-02-2021 12:00,24 hrs.,pennystocks,ZAAG,6,0,6,-6,1,1,0,1,OTC
4594,12-02-2021 12:00,24 hrs.,wallstreetbets,SAVA,18,6,12,-6,3,3,0,3,NASDAQ
4594,12-02-2021 12:00,24 hrs.,wallstreetbets,SAVE,33,0,33,-33,5,5,3,3,NASDAQ
4594,12-02-2021 12:00,24 hrs.,wallstreetbets,SEEL,12,0,12,-12,2,2,0,2,NASDAQ
4594,12-02-2021 12:00,24 hrs.,wallstreetbets,SESN,6,0,6,-6,1,1,0,1,NASDAQ
4594,12-02-2021 12:00,24 hrs.,wallstreetbets,SFET,18,0,18,-18,3,3,0,2,NASDAQ
4594,12-02-2021 12:00,24 hrs.,wallstreetbets,SHIP,44,20,24,-4,7,7,2,7,NASDAQ
4594,12-02-2021 12:00,24 hrs.,wallstreetbets,SIEB,6,0,6,-6,1,1,0,1,NASDAQ
4594,12-02-2021 12:00,24 hrs.,wallstreetbets,SINT,18,6,12,-6,3,3,0,2,NASDAQ
4594,12-02-2021 12:00,24 hrs.,wallstreetbets,SLRX,12,0,12,-12,2,2,0,2,NASDAQ
4594,12-02-2021 12:00,24 hrs.,wallstreetbets,SNCR,7,0,7,-7,1,1,1,1,NASDAQ
4594,12-02-2021 12:00,24 hrs.,wallstreetbets,SNDL,73146,4631,68515,-63884,783,32279,5456,621,NASDAQ
4594,12-02-2021 12:00,24 hrs.,wallstreetbets,SNGX,7,7,0,7,1,1,1,1,NASDAQ
4594,12-02-2021 12:00,24 hrs.,wallstreetbets,SOHU,6,0,6,-6,1,1,0,1,NASDAQ
4594,12-02-2021 12:00,24 hrs.,wallstreetbets,SOLO,6,0,6,-6,1,1,0,1,NASDAQ
4594,12-02-2021 12:00,24 hrs.,wallstreetbets,SONN,6,0,6,-6,1,1,0,1,NASDAQ
4594,12-02-2021 12:00,24 hrs.,wallstreetbets,SONO,787,0,787,-787,3,293,189,3,NASDAQ
4594,12-02-2021 12:00,24 hrs.,wallstreetbets,SPWR,6,0,6,-6,1,1,0,1,NASDAQ
4594,12-02-2021 12:00,24 hrs.,wallstreetbets,SQQQ,7,7,0,7,1,1,1,1,NASDAQ
4594,12-02-2021 12:00,24 hrs.,wallstreetbets,SRGA,6,0,6,-6,1,1,0,1,NASDAQ
4594,12-02-2021 12:00,24 hrs.,wallstreetbets,SRNE,20,20,0,20,2,4,4,2,NASDAQ
4594,12-02-2021 12:00,24 hrs.,wallstreetbets,SSPK,6,0,6,-6,1,1,0,1,NASDAQ
4594,12-02-2021 12:00,24 hrs.,wallstreetbets,STAF,7,0,7,-7,1,1,1,1,NASDAQ
4594,12-02-2021 12:00,24 hrs.,wallstreetbets,STAY,24,6,18,-12,4,4,0,4,NASDAQ
4594,12-02-2021 12:00,24 hrs.,wallstreetbets,STCN,6,0,6,-6,1,1,0,1,NASDAQ
4594,12-02-2021 12:00,24 hrs.,wallstreetbets,SWBI,6,0,6,-6,1,1,0,1,NASDAQ
4594,12-02-2021 12:00,24 hrs.,wallstreetbets,SXTC,6,0,6,-6,1,1,0,1,NASDAQ
4594,12-02-2021 12:00,24 hrs.,wallstreetbets,TEAM,12,12,0,12,2,2,0,1,NASDAQ
4594,12-02-2021 12:00,24 hrs.,wallstreetbets,TECH,7,0,7,-7,1,1,1,1,NASDAQ
4594,12-02-2021 12:00,24 hrs.,wallstreetbets,TELL,13907,13901,6,13895,4,6597,697,4,NASDAQ
4594,12-02-2021 12:00,24 hrs.,wallstreetbets,THBR,25,7,18,-11,4,4,1,3,NASDAQ
4594,12-02-2021 12:00,24 hrs.,wallstreetbets,THCB,10,0,10,-10,2,1,0,2,NASDAQ
4594,12-02-2021 12:00,24 hrs.,wallstreetbets,THMO,18,0,18,-18,3,3,0,1,NASDAQ
4594,12-02-2021 12:00,24 hrs.,wallstreetbets,TIGR,13,0,13,-13,2,2,1,2,NASDAQ
4594,12-02-2021 12:00,24 hrs.,wallstreetbets,TLGT,6,0,6,-6,1,1,0,1,NASDAQ
4594,12-02-2021 12:00,24 hrs.,wallstreetbets,TLRY,122920,54235,68685,-14450,221,56862,8312,182,NASDAQ
4594,12-02-2021 12:00,24 hrs.,wallstreetbets,TNDM,6,0,6,-6,1,1,0,1,NASDAQ
4594,12-02-2021 12:00,24 hrs.,wallstreetbets,TNXP,212,34,178,-144,33,35,10,29,NASDAQ
4594,12-02-2021 12:00,24 hrs.,wallstreetbets,TOPS,19,7,12,-5,3,3,1,3,NASDAQ
4594,12-02-2021 12:00,24 hrs.,wallstreetbets,TPCO,6,0,6,-6,1,1,0,1,NASDAQ
4594,12-02-2021 12:00,24 hrs.,wallstreetbets,TRCH,49,7,42,-35,8,8,1,6,NASDAQ
4594,12-02-2021 12:00,24 hrs.,wallstreetbets,TRIT,75,7,68,-61,12,12,3,8,NASDAQ
4594,12-02-2021 12:00,24 hrs.,wallstreetbets,TRVN,13,0,13,-13,2,2,1,2,NASDAQ
4594,12-02-2021 12:00,24 hrs.,wallstreetbets,TSLA,64229,330,63899,-63569,39,29911,4251,30,NASDAQ
4594,12-02-2021 12:00,24 hrs.,wallstreetbets,TTCF,7,7,0,7,1,1,1,1,NASDAQ
4594,12-02-2021 12:00,24 hrs.,wallstreetbets,TTWO,7,7,0,7,1,1,1,1,NASDAQ
4594,12-02-2021 12:00,24 hrs.,wallstreetbets,TURN,20,12,8,4,3,3,2,2,NASDAQ
4594,12-02-2021 12:00,24 hrs.,wallstreetbets,TWOU,12,0,12,-12,2,2,0,1,NASDAQ
4594,12-02-2021 12:00,24 hrs.,wallstreetbets,TXMD,140,29,111,-82,22,22,8,18,NASDAQ
4594,12-02-2021 12:00,24 hrs.,wallstreetbets,TYME,12,0,12,-12,2,2,0,2,NASDAQ
4594,12-02-2021 12:00,24 hrs.,wallstreetbets,UPST,6,0,6,-6,1,1,0,1,NASDAQ
4594,12-02-2021 12:00,24 hrs.,wallstreetbets,UPWK,18,0,18,-18,3,3,0,3,NASDAQ
4594,12-02-2021 12:00,24 hrs.,wallstreetbets,UXIN,12,0,12,-12,2,2,0,1,NASDAQ
4594,12-02-2021 12:00,24 hrs.,wallstreetbets,VBLT,6,0,6,-6,1,1,0,1,NASDAQ
4594,12-02-2021 12:00,24 hrs.,wallstreetbets,VIAC,72,0,72,-72,1,24,20,1,NASDAQ
4594,12-02-2021 12:00,24 hrs.,wallstreetbets,VISL,6,0,6,-6,1,1,0,1,NASDAQ
4594,12-02-2021 12:00,24 hrs.,wallstreetbets,VIVE,6,0,6,-6,1,1,0,1,NASDAQ
4594,12-02-2021 12:00,24 hrs.,wallstreetbets,VKTX,6,0,6,-6,1,1,0,1,NASDAQ
4594,12-02-2021 12:00,24 hrs.,wallstreetbets,VNDA,36,36,0,36,5,5,6,1,NASDAQ
4594,12-02-2021 12:00,24 hrs.,wallstreetbets,VRAY,6,0,6,-6,1,1,0,1,NASDAQ
4594,12-02-2021 12:00,24 hrs.,pennystocks,PLSB,6,6,0,6,1,1,0,1,OTC
4594,12-02-2021 12:00,24 hrs.,pennystocks,FUNFF,33,0,33,-33,1,7,15,1,OTC
4594,12-02-2021 12:00,24 hrs.,pennystocks,GBOKF,200,0,200,-200,1,84,28,1,OTC
4594,12-02-2021 12:00,24 hrs.,pennystocks,GCPEF,25,0,25,-25,1,7,7,1,OTC
4594,12-02-2021 12:00,24 hrs.,pennystocks,GLDFF,6,0,6,-6,1,1,0,1,OTC
4594,12-02-2021 12:00,24 hrs.,pennystocks,GNOLF,6,0,6,-6,1,1,0,1,OTC
4594,12-02-2021 12:00,24 hrs.,pennystocks,GUESF,7,7,0,7,1,1,1,1,OTC
4594,12-02-2021 12:00,24 hrs.,pennystocks,HAVLF,200,0,200,-200,1,84,28,1,OTC
4594,12-02-2021 12:00,24 hrs.,pennystocks,HITIF,439,35,404,-369,20,89,181,17,OTC
4594,12-02-2021 12:00,24 hrs.,pennystocks,HNLMF,200,0,200,-200,1,84,28,1,OTC
4594,12-02-2021 12:00,24 hrs.,pennystocks,ICAGY,6,0,6,-6,1,1,0,1,OTC
4594,12-02-2021 12:00,24 hrs.,pennystocks,IDXAF,6,6,0,6,1,1,0,1,OTC
4594,12-02-2021 12:00,24 hrs.,pennystocks,ISCNF,12,0,12,-12,2,2,0,1,OTC
4594,12-02-2021 12:00,24 hrs.,pennystocks,ISRJF,10,0,10,-10,1,0,6,1,OTC
4594,12-02-2021 12:00,24 hrs.,pennystocks,KONAQ,6,0,6,-6,1,1,0,1,OTC
4594,12-02-2021 12:00,24 hrs.,pennystocks,KWHIY,6,0,6,-6,1,0,2,1,OTC
4594,12-02-2021 12:00,24 hrs.,pennystocks,LIACF,37,0,37,-37,2,11,7,2,OTC
4594,12-02-2021 12:00,24 hrs.,pennystocks,LIBFF,200,0,200,-200,1,84,28,1,OTC
4594,12-02-2021 12:00,24 hrs.,pennystocks,LKYSF,325,125,200,-75,2,137,43,2,OTC
4594,12-02-2021 12:00,24 hrs.,pennystocks,LLKKF,6,6,0,6,1,1,0,1,OTC
4594,12-02-2021 12:00,24 hrs.,pennystocks,LTMCF,172,0,172,-172,6,48,52,5,OTC
4594,12-02-2021 12:00,24 hrs.,pennystocks,MCURF,200,0,200,-200,1,84,28,1,OTC
4594,12-02-2021 12:00,24 hrs.,pennystocks,MGCLF,38,0,38,-38,1,15,4,1,OTC
4594,12-02-2021 12:00,24 hrs.,pennystocks,MMEDF,552,125,427,-302,4,230,76,4,OTC
4594,12-02-2021 12:00,24 hrs.,pennystocks,MMNFF,54,6,48,-42,2,21,4,2,OTC
4594,12-02-2021 12:00,24 hrs.,pennystocks,MNXXF,29,8,21,-13,2,8,5,2,OTC
4594,12-02-2021 12:00,24 hrs.,pennystocks,MSNVF,21,0,21,-21,1,8,1,1,OTC
4594,12-02-2021 12:00,24 hrs.,pennystocks,MYCOF,200,0,200,-200,1,84,28,1,OTC
4594,12-02-2021 12:00,24 hrs.,pennystocks,NCNNF,12,0,12,-12,2,2,0,1,OTC
4594,12-02-2021 12:00,24 hrs.,pennystocks,NEBLQ,6,0,6,-6,1,1,0,1,OTC
4594,12-02-2021 12:00,24 hrs.,pennystocks,NMGRF,127,6,121,-115,5,37,33,5,OTC
4594,12-02-2021 12:00,24 hrs.,pennystocks,NMHLY,6,0,6,-6,1,1,0,1,OTC
4594,12-02-2021 12:00,24 hrs.,pennystocks,NRGOF,14,7,7,0,2,2,2,2,OTC
4594,12-02-2021 12:00,24 hrs.,pennystocks,NTDOY,13,0,13,-13,2,2,1,2,OTC
4594,12-02-2021 12:00,24 hrs.,pennystocks,NTSFF,6,6,0,6,1,1,0,1,OTC
4594,12-02-2021 12:00,24 hrs.,pennystocks,NXTTF,31,6,25,-19,5,5,1,5,OTC
4594,12-02-2021 12:00,24 hrs.,pennystocks,ORVRF,24,0,24,-24,1,6,8,1,OTC
4594,12-02-2021 12:00,24 hrs.,pennystocks,PFWIQ,88,0,88,-88,1,26,32,1,OTC
4594,12-02-2021 12:00,24 hrs.,pennystocks,PLNHF,27,0,27,-27,1,6,11,1,OTC
4594,12-02-2021 12:00,24 hrs.,pennystocks,PLUUF,30,0,30,-30,1,10,6,1,OTC
4594,12-02-2021 12:00,24 hrs.,pennystocks,PYRNF,6,6,0,6,1,1,0,1,OTC
4594,12-02-2021 12:00,24 hrs.,wallstreetbets,VTIQ,24,0,24,-24,4,4,0,1,NASDAQ
4594,12-02-2021 12:00,24 hrs.,wallstreetbets,VUZI,15,0,15,-15,2,2,3,2,NASDAQ
4594,12-02-2021 12:00,24 hrs.,wallstreetbets,VXRT,6,6,0,6,1,1,0,1,NASDAQ
4594,12-02-2021 12:00,24 hrs.,wallstreetbets,VYNE,7,0,7,-7,1,1,1,1,NASDAQ
4594,12-02-2021 12:00,24 hrs.,wallstreetbets,WATT,80,0,80,-80,11,12,12,5,NASDAQ
4594,12-02-2021 12:00,24 hrs.,wallstreetbets,WIMI,8,0,8,-8,1,1,2,1,NASDAQ
4594,12-02-2021 12:00,24 hrs.,wallstreetbets,WKHS,94,0,94,-94,4,23,32,3,NASDAQ
4594,12-02-2021 12:00,24 hrs.,wallstreetbets,WTER,7,7,0,7,1,1,1,1,NASDAQ
4594,12-02-2021 12:00,24 hrs.,wallstreetbets,XERS,8,8,0,8,1,1,2,1,NASDAQ
4594,12-02-2021 12:00,24 hrs.,wallstreetbets,XSPA,68,19,49,-30,11,11,2,11,NASDAQ
4594,12-02-2021 12:00,24 hrs.,wallstreetbets,YNDX,377,377,0,377,1,138,97,1,NASDAQ
4594,12-02-2021 12:00,24 hrs.,wallstreetbets,ZNGA,665,7,658,-651,6,254,133,5,NASDAQ
4594,12-02-2021 12:00,24 hrs.,wallstreetbets,ZSAN,6,0,6,-6,1,1,0,1,NASDAQ
4594,12-02-2021 12:00,24 hrs.,wallstreetbets,ZYNE,24,0,24,-24,4,4,0,4,NASDAQ
4594,12-02-2021 12:00,24 hrs.,RobinHoodPennyStocks,AHFD,6,0,6,-6,1,1,0,1,OTC
4594,12-02-2021 12:00,24 hrs.,RobinHoodPennyStocks,AITX,13,0,13,-13,1,1,7,1,OTC
4594,12-02-2021 12:00,24 hrs.,RobinHoodPennyStocks,AZFL,6,6,0,6,1,0,2,1,OTC
4594,12-02-2021 12:00,24 hrs.,RobinHoodPennyStocks,BNGI,12,0,12,-12,2,2,0,2,OTC
4594,12-02-2021 12:00,24 hrs.,RobinHoodPennyStocks,CAPS,6,6,0,6,1,1,0,1,OTC
4594,12-02-2021 12:00,24 hrs.,RobinHoodPennyStocks,CBDD,6,0,6,-6,1,1,0,1,OTC
4594,12-02-2021 12:00,24 hrs.,RobinHoodPennyStocks,CBDL,6,0,6,-6,1,1,0,1,OTC
4594,12-02-2021 12:00,24 hrs.,RobinHoodPennyStocks,COMS,6,0,6,-6,1,1,0,1,OTC
4594,12-02-2021 12:00,24 hrs.,RobinHoodPennyStocks,CYTR,6,0,6,-6,1,1,0,1,OTC
4594,12-02-2021 12:00,24 hrs.,pennystocks,WSTL,124,0,124,-124,1,44,32,1,OTC
4594,12-02-2021 12:00,24 hrs.,RobinHoodPennyStocks,DIGI,6,6,0,6,1,1,0,1,OTC
4594,12-02-2021 12:00,24 hrs.,RobinHoodPennyStocks,ETEK,6,0,6,-6,1,1,0,1,OTC
4594,12-02-2021 12:00,24 hrs.,RobinHoodPennyStocks,GPFT,6,6,0,6,1,0,2,1,OTC
4594,12-02-2021 12:00,24 hrs.,RobinHoodPennyStocks,GTBP,20,0,20,-20,1,4,8,1,OTC
4594,12-02-2021 12:00,24 hrs.,RobinHoodPennyStocks,HCMC,48,0,48,-48,8,8,0,7,OTC
4594,12-02-2021 12:00,24 hrs.,RobinHoodPennyStocks,HQGE,6,0,6,-6,1,1,0,1,OTC
4594,12-02-2021 12:00,24 hrs.,RobinHoodPennyStocks,INOH,6,0,6,-6,1,1,0,1,OTC
4594,12-02-2021 12:00,24 hrs.,RobinHoodPennyStocks,MCOA,6,0,6,-6,1,1,0,1,OTC
4594,12-02-2021 12:00,24 hrs.,RobinHoodPennyStocks,NUGS,6,0,6,-6,1,1,0,1,OTC
4594,12-02-2021 12:00,24 hrs.,RobinHoodPennyStocks,NWPN,8,0,8,-8,1,0,4,1,OTC
4594,12-02-2021 12:00,24 hrs.,RobinHoodPennyStocks,OPMZ,6,0,6,-6,1,1,0,1,OTC
4594,12-02-2021 12:00,24 hrs.,RobinHoodPennyStocks,OPTI,6,6,0,6,1,1,0,1,OTC
4594,12-02-2021 12:00,24 hrs.,RobinHoodPennyStocks,PAOG,6,0,6,-6,1,1,0,1,OTC
4594,12-02-2021 12:00,24 hrs.,RobinHoodPennyStocks,PHIL,6,0,6,-6,1,1,0,1,OTC
4594,12-02-2021 12:00,24 hrs.,RobinHoodPennyStocks,QTMM,6,0,6,-6,1,1,0,1,OTC
4594,12-02-2021 12:00,24 hrs.,RobinHoodPennyStocks,SGMD,18,0,18,-18,1,3,8,1,OTC
4594,12-02-2021 12:00,24 hrs.,RobinHoodPennyStocks,SRMX,12,0,12,-12,2,2,0,2,OTC
4594,12-02-2021 12:00,24 hrs.,RobinHoodPennyStocks,SUIC,6,0,6,-6,1,1,0,1,OTC
4594,12-02-2021 12:00,24 hrs.,RobinHoodPennyStocks,TLSS,6,0,6,-6,1,1,0,1,OTC
4594,12-02-2021 12:00,24 hrs.,RobinHoodPennyStocks,USMJ,6,0,6,-6,1,1,0,1,OTC
4594,12-02-2021 12:00,24 hrs.,RobinHoodPennyStocks,VPRB,6,0,6,-6,1,1,0,1,OTC
4594,12-02-2021 12:00,24 hrs.,RobinHoodPennyStocks,ABEPF,8,0,8,-8,1,0,4,1,OTC
4594,12-02-2021 12:00,24 hrs.,RobinHoodPennyStocks,BDRBF,241,18,223,-205,13,59,71,13,OTC
4594,12-02-2021 12:00,24 hrs.,RobinHoodPennyStocks,HITIF,32,0,32,-32,3,2,16,3,OTC
4594,12-02-2021 12:00,24 hrs.,RobinHoodPennyStocks,MZDAY,22,0,22,-22,1,4,10,1,OTC
4594,12-02-2021 12:00,24 hrs.,RobinHoodPennyStocks,PLNHF,6,0,6,-6,1,1,0,1,OTC
4594,12-02-2021 12:00,24 hrs.,RobinHoodPennyStocks,RYCEY,6,0,6,-6,1,1,0,1,OTC
4594,12-02-2021 12:00,24 hrs.,RobinHoodPennyStocks,TLOFF,6,6,0,6,1,1,0,1,OTC
4594,12-02-2021 12:00,24 hrs.,RobinHoodPennyStocks,VRYYF,6,0,6,-6,1,1,0,1,OTC
4594,12-02-2021 12:00,24 hrs.,RobinHoodPennyStocks,AAU,96,96,0,96,1,35,22,1,AMEX
4594,12-02-2021 12:00,24 hrs.,RobinHoodPennyStocks,CEI,6,0,6,-6,1,1,0,1,AMEX
4594,12-02-2021 12:00,24 hrs.,RobinHoodPennyStocks,DNN,523,386,137,249,11,168,143,10,AMEX
4594,12-02-2021 12:00,24 hrs.,RobinHoodPennyStocks,DPW,96,96,0,96,1,35,22,1,AMEX
4594,12-02-2021 12:00,24 hrs.,RobinHoodPennyStocks,GSV,161,96,65,31,3,45,59,3,AMEX
4594,12-02-2021 12:00,24 hrs.,RobinHoodPennyStocks,GTE,787,176,611,-435,33,221,213,28,AMEX
4594,12-02-2021 12:00,24 hrs.,RobinHoodPennyStocks,IGC,6,0,6,-6,1,1,0,1,AMEX
4594,12-02-2021 12:00,24 hrs.,RobinHoodPennyStocks,ITP,7,0,7,-7,1,1,1,1,AMEX
4594,12-02-2021 12:00,24 hrs.,RobinHoodPennyStocks,KIQ,17,0,17,-17,1,0,13,1,AMEX
4594,12-02-2021 12:00,24 hrs.,RobinHoodPennyStocks,NAK,137,96,41,55,4,46,29,4,AMEX
4594,12-02-2021 12:00,24 hrs.,RobinHoodPennyStocks,PLM,37,0,37,-37,1,14,5,1,AMEX
4594,12-02-2021 12:00,24 hrs.,pennystocks,ZPAS,12,6,6,0,2,2,0,2,OTC
4594,12-02-2021 12:00,24 hrs.,pennystocks,ABEPF,151,31,120,-89,8,35,49,8,OTC
4594,12-02-2021 12:00,24 hrs.,pennystocks,ALLIF,65,65,0,65,1,22,17,1,OTC
4594,12-02-2021 12:00,24 hrs.,pennystocks,AQSZF,35,0,35,-35,1,12,7,1,OTC
4594,12-02-2021 12:00,24 hrs.,pennystocks,ARBKF,113,113,0,113,1,30,49,1,OTC
4594,12-02-2021 12:00,24 hrs.,pennystocks,BDRBF,48,0,48,-48,1,14,16,1,OTC
4594,12-02-2021 12:00,24 hrs.,pennystocks,BLOZF,12,0,12,-12,2,2,0,1,OTC
4594,12-02-2021 12:00,24 hrs.,pennystocks,CBLAQ,7,0,7,-7,1,1,1,1,OTC
4594,12-02-2021 12:00,24 hrs.,pennystocks,CBWTF,19,0,19,-19,3,3,1,3,OTC
4594,12-02-2021 12:00,24 hrs.,pennystocks,CCIHY,107,0,107,-107,1,43,17,1,OTC
4594,12-02-2021 12:00,24 hrs.,pennystocks,CINGF,39,0,39,-39,1,10,15,1,OTC
4594,12-02-2021 12:00,24 hrs.,pennystocks,CNIKF,59,0,59,-59,1,14,27,1,OTC
4594,12-02-2021 12:00,24 hrs.,pennystocks,COCSF,6,6,0,6,1,1,0,1,OTC
4594,12-02-2021 12:00,24 hrs.,pennystocks,COPRF,4,0,4,-4,1,0,0,1,OTC
4594,12-02-2021 12:00,24 hrs.,pennystocks,CPHRF,33,0,33,-33,1,9,11,1,OTC
4594,12-02-2021 12:00,24 hrs.,pennystocks,CWGYF,6,0,6,-6,1,1,0,1,OTC
4594,12-02-2021 12:00,24 hrs.,pennystocks,CXXIF,6,6,0,6,1,1,0,1,OTC
4594,12-02-2021 12:00,24 hrs.,pennystocks,DFLYF,44,44,0,44,1,15,10,1,OTC
4594,12-02-2021 12:00,24 hrs.,pennystocks,DIGAF,7,0,7,-7,1,1,1,1,OTC
4594,12-02-2021 12:00,24 hrs.,pennystocks,EHVVF,200,0,200,-200,1,84,28,1,OTC
4594,12-02-2021 12:00,24 hrs.,pennystocks,ENTBF,200,0,200,-200,1,84,28,1,OTC
4594,12-02-2021 12:00,24 hrs.,pennystocks,FIORF,8,8,0,8,1,1,2,1,OTC
4594,12-02-2021 12:00,24 hrs.,pennystocks,FLWPF,13,0,13,-13,2,2,1,2,OTC
4594,12-02-2021 12:00,24 hrs.,pennystocks,FTRPF,325,125,200,-75,2,137,43,2,OTC
4594,12-02-2021 12:00,24 hrs.,RobinHoodPennyStocks,PTN,20,0,20,-20,2,3,6,2,AMEX
4594,12-02-2021 12:00,24 hrs.,RobinHoodPennyStocks,RHE,96,96,0,96,1,35,22,1,AMEX
4594,12-02-2021 12:00,24 hrs.,RobinHoodPennyStocks,SSY,6,0,6,-6,1,1,0,1,AMEX
4594,12-02-2021 12:00,24 hrs.,RobinHoodPennyStocks,SYN,6,6,0,6,1,1,0,1,AMEX
4594,12-02-2021 12:00,24 hrs.,RobinHoodPennyStocks,TGB,90,75,15,60,3,35,8,3,AMEX
4594,12-02-2021 12:00,24 hrs.,RobinHoodPennyStocks,TRT,96,96,0,96,1,35,22,1,AMEX
4594,12-02-2021 12:00,24 hrs.,RobinHoodPennyStocks,TRX,188,188,0,188,2,62,56,2,AMEX
4594,12-02-2021 12:00,24 hrs.,RobinHoodPennyStocks,XPL,96,96,0,96,1,35,22,1,AMEX
4594,12-02-2021 12:00,24 hrs.,RobinHoodPennyStocks,ZOM,978,24,954,-930,18,262,382,16,AMEX
4594,12-02-2021 12:00,24 hrs.,RobinHoodPennyStocks,AMBO,96,96,0,96,1,35,22,1,AMEX
4594,12-02-2021 12:00,24 hrs.,RobinHoodPennyStocks,AUMN,194,188,6,182,3,63,56,3,AMEX
4594,12-02-2021 12:00,24 hrs.,RobinHoodPennyStocks,GSAT,35,0,35,-35,3,6,11,3,AMEX
4594,12-02-2021 12:00,24 hrs.,RobinHoodPennyStocks,NSPR,7,7,0,7,1,1,1,1,AMEX
4594,12-02-2021 12:00,24 hrs.,RobinHoodPennyStocks,OGEN,6,0,6,-6,1,1,0,1,AMEX
4594,12-02-2021 12:00,24 hrs.,RobinHoodPennyStocks,PLAG,96,96,0,96,1,35,22,1,AMEX
4594,12-02-2021 12:00,24 hrs.,RobinHoodPennyStocks,SENS,48,0,48,-48,1,19,6,1,AMEX
4594,12-02-2021 12:00,24 hrs.,RobinHoodPennyStocks,SMTS,6,6,0,6,1,1,0,1,AMEX
4594,12-02-2021 12:00,24 hrs.,RobinHoodPennyStocks,TKAT,96,96,0,96,1,35,22,1,AMEX
4594,12-02-2021 12:00,24 hrs.,RobinHoodPennyStocks,TRXC,158,158,0,158,2,61,28,2,AMEX
4594,12-02-2021 12:00,24 hrs.,RobinHoodPennyStocks,UUUU,36,0,36,-36,1,11,10,1,AMEX
4594,12-02-2021 12:00,24 hrs.,RobinHoodPennyStocks,YCBD,6,6,0,6,1,1,0,1,AMEX
4594,12-02-2021 12:00,24 hrs.,RobinHoodPennyStocks,ACB,16,0,16,-16,1,5,2,1,NYSE
4594,12-02-2021 12:00,24 hrs.,RobinHoodPennyStocks,AMC,4012,136,3876,-3740,11,1709,550,9,NYSE
4594,12-02-2021 12:00,24 hrs.,RobinHoodPennyStocks,ASX,6,0,6,-6,1,1,0,1,NYSE
4594,12-02-2021 12:00,24 hrs.,RobinHoodPennyStocks,AUY,92,92,0,92,1,27,34,1,NYSE
4594,12-02-2021 12:00,24 hrs.,RobinHoodPennyStocks,BBW,6,0,6,-6,1,1,0,1,NYSE
4594,12-02-2021 12:00,24 hrs.,RobinHoodPennyStocks,BTU,96,96,0,96,1,35,22,1,NYSE
4594,12-02-2021 12:00,24 hrs.,RobinHoodPennyStocks,CCM,96,96,0,96,1,35,22,1,NYSE
4594,12-02-2021 12:00,24 hrs.,RobinHoodPennyStocks,COO,92,92,0,92,1,27,34,1,NYSE
4594,12-02-2021 12:00,24 hrs.,RobinHoodPennyStocks,CTK,96,96,0,96,1,35,22,1,NYSE
4594,12-02-2021 12:00,24 hrs.,RobinHoodPennyStocks,DNK,6,0,6,-6,1,1,0,1,NYSE
4594,12-02-2021 12:00,24 hrs.,RobinHoodPennyStocks,FSR,96,96,0,96,1,35,22,1,NYSE
4594,12-02-2021 12:00,24 hrs.,RobinHoodPennyStocks,FTK,6,0,6,-6,1,1,0,1,NYSE
4594,12-02-2021 12:00,24 hrs.,RobinHoodPennyStocks,GME,3936,40,3896,-3856,9,1683,534,7,NYSE
4594,12-02-2021 12:00,24 hrs.,RobinHoodPennyStocks,GSX,96,96,0,96,1,35,22,1,NYSE
4594,12-02-2021 12:00,24 hrs.,RobinHoodPennyStocks,IRL,303,0,303,-303,1,143,13,1,NYSE
4594,12-02-2021 12:00,24 hrs.,RobinHoodPennyStocks,IVR,6,6,0,6,1,1,0,1,NYSE
4594,12-02-2021 12:00,24 hrs.,RobinHoodPennyStocks,LOW,6,6,0,6,1,1,0,1,NYSE
4594,12-02-2021 12:00,24 hrs.,RobinHoodPennyStocks,LYG,6,6,0,6,1,1,0,1,NYSE
4594,12-02-2021 12:00,24 hrs.,RobinHoodPennyStocks,NIO,96,96,0,96,1,35,22,1,NYSE
4594,12-02-2021 12:00,24 hrs.,pennystocks,RACMF,8,8,0,8,1,1,2,1,OTC
4594,12-02-2021 12:00,24 hrs.,pennystocks,RECAF,21,0,21,-21,1,8,1,1,OTC
4594,12-02-2021 12:00,24 hrs.,pennystocks,REGRF,39,0,39,-39,1,10,15,1,OTC
4594,12-02-2021 12:00,24 hrs.,pennystocks,RLFTF,6,0,6,-6,1,1,0,1,OTC
4594,12-02-2021 12:00,24 hrs.,pennystocks,RLLCF,7,0,7,-7,1,1,1,1,OTC
4594,12-02-2021 12:00,24 hrs.,pennystocks,ROYTL,6,0,6,-6,1,1,0,1,OTC
4594,12-02-2021 12:00,24 hrs.,pennystocks,RQHTF,55,0,55,-55,1,20,11,1,OTC
4594,12-02-2021 12:00,24 hrs.,pennystocks,RVVTF,262,0,262,-262,3,97,56,2,OTC
4594,12-02-2021 12:00,24 hrs.,pennystocks,RWBYF,7,0,7,-7,1,1,1,1,OTC
4594,12-02-2021 12:00,24 hrs.,pennystocks,RYCEY,13,0,13,-13,2,2,1,2,OTC
4594,12-02-2021 12:00,24 hrs.,pennystocks,RYMDF,46,0,46,-46,4,12,6,3,OTC
4594,12-02-2021 12:00,24 hrs.,pennystocks,SBSAA,5,0,5,-5,1,0,1,1,OTC
4594,12-02-2021 12:00,24 hrs.,pennystocks,SHRMF,325,125,200,-75,2,137,43,2,OTC
4594,12-02-2021 12:00,24 hrs.,pennystocks,SMRTQ,6,0,6,-6,1,1,0,1,OTC
4594,12-02-2021 12:00,24 hrs.,pennystocks,SORHF,8,0,8,-8,1,1,2,1,OTC
4594,12-02-2021 12:00,24 hrs.,pennystocks,SPLIF,24,0,24,-24,4,4,0,3,OTC
4594,12-02-2021 12:00,24 hrs.,pennystocks,SPMTF,8,0,8,-8,1,1,2,1,OTC
4594,12-02-2021 12:00,24 hrs.,pennystocks,SPRWF,1860,237,1623,-1386,10,803,214,9,OTC
4594,12-02-2021 12:00,24 hrs.,pennystocks,TAKOF,361,0,361,-361,4,136,73,2,OTC
4594,12-02-2021 12:00,24 hrs.,pennystocks,TFECF,4,0,4,-4,1,0,0,1,OTC
4594,12-02-2021 12:00,24 hrs.,pennystocks,TFECY,4,0,4,-4,1,0,0,1,OTC
4594,12-02-2021 12:00,24 hrs.,pennystocks,TLOFF,71,12,59,-47,3,16,27,2,OTC
4594,12-02-2021 12:00,24 hrs.,pennystocks,TMASF,24,0,24,-24,4,4,0,2,OTC
4594,12-02-2021 12:00,24 hrs.,pennystocks,TRUFF,200,0,200,-200,1,84,28,1,OTC
4583,12-02-2021 10:00,24 hrs.,pennystocks,UVSE,25,7,18,-11,3,4,5,3,OTC
4583,12-02-2021 10:00,24 hrs.,pennystocks,VNUE,23,0,23,-23,1,9,1,1,OTC
4583,12-02-2021 10:00,24 hrs.,pennystocks,VPER,6,0,6,-6,1,1,0,1,OTC
4583,12-02-2021 10:00,24 hrs.,pennystocks,VSYM,18,0,18,-18,3,3,0,1,OTC
4583,12-02-2021 10:00,24 hrs.,pennystocks,CINGF,41,0,41,-41,1,11,15,1,OTC
4583,12-02-2021 10:00,24 hrs.,pennystocks,CNIKF,57,0,57,-57,1,13,27,1,OTC
4583,12-02-2021 10:00,24 hrs.,pennystocks,COCSF,6,6,0,6,1,1,0,1,OTC
4583,12-02-2021 10:00,24 hrs.,pennystocks,COPRF,4,0,4,-4,1,0,0,1,OTC
4583,12-02-2021 10:00,24 hrs.,pennystocks,CPHRF,35,35,0,35,1,10,11,1,OTC
4583,12-02-2021 10:00,24 hrs.,pennystocks,CWGYF,6,0,6,-6,1,1,0,1,OTC
4583,12-02-2021 10:00,24 hrs.,pennystocks,CXXIF,6,6,0,6,1,1,0,1,OTC
4583,12-02-2021 10:00,24 hrs.,pennystocks,DFLYF,44,44,0,44,1,15,10,1,OTC
4583,12-02-2021 10:00,24 hrs.,pennystocks,DIGAF,7,0,7,-7,1,1,1,1,OTC
4583,12-02-2021 10:00,24 hrs.,pennystocks,EFLVF,1682,0,1682,-1682,1,742,194,1,OTC
4583,12-02-2021 10:00,24 hrs.,pennystocks,EHVVF,198,0,198,-198,1,83,28,1,OTC
4583,12-02-2021 10:00,24 hrs.,pennystocks,ENTBF,198,0,198,-198,1,83,28,1,OTC
4583,12-02-2021 10:00,24 hrs.,pennystocks,FIORF,8,8,0,8,1,1,2,1,OTC
4583,12-02-2021 10:00,24 hrs.,pennystocks,FLWPF,13,0,13,-13,2,2,1,2,OTC
4583,12-02-2021 10:00,24 hrs.,pennystocks,FTRPF,285,87,198,-111,2,118,41,2,OTC
4583,12-02-2021 10:00,24 hrs.,pennystocks,FUNFF,31,0,31,-31,1,6,15,1,OTC
4583,12-02-2021 10:00,24 hrs.,pennystocks,GBOKF,198,0,198,-198,1,83,28,1,OTC
4583,12-02-2021 10:00,24 hrs.,pennystocks,GCPEF,23,23,0,23,1,6,7,1,OTC
4583,12-02-2021 10:00,24 hrs.,pennystocks,GLDFF,1701,6,1695,-1689,4,745,195,4,OTC
4583,12-02-2021 10:00,24 hrs.,pennystocks,GNOLF,6,0,6,-6,1,1,0,1,OTC
4583,12-02-2021 10:00,24 hrs.,pennystocks,GUESF,7,7,0,7,1,1,1,1,OTC
4583,12-02-2021 10:00,24 hrs.,pennystocks,HAVLF,198,0,198,-198,1,83,28,1,OTC
4583,12-02-2021 10:00,24 hrs.,pennystocks,HITIF,454,41,413,-372,21,94,182,18,OTC
4583,12-02-2021 10:00,24 hrs.,pennystocks,HNLMF,198,0,198,-198,1,83,28,1,OTC
4583,12-02-2021 10:00,24 hrs.,pennystocks,RLTR,12,6,6,0,2,2,0,2,OTC
4583,12-02-2021 10:00,24 hrs.,pennystocks,RNVA,116,0,116,-116,1,40,32,1,OTC
4583,12-02-2021 10:00,24 hrs.,pennystocks,ROTH,81,0,81,-81,2,30,13,2,OTC
4583,12-02-2021 10:00,24 hrs.,pennystocks,RRTS,116,0,116,-116,1,40,32,1,OTC
4583,12-02-2021 10:00,24 hrs.,pennystocks,RSSV,12,6,6,0,2,2,0,2,OTC
4583,12-02-2021 10:00,24 hrs.,pennystocks,RTON,192,96,96,0,8,50,60,7,OTC
4583,12-02-2021 10:00,24 hrs.,pennystocks,SCIE,307,307,0,307,1,131,41,1,OTC
4583,12-02-2021 10:00,24 hrs.,pennystocks,SEEK,7,0,7,-7,1,1,1,1,OTC
4583,12-02-2021 10:00,24 hrs.,pennystocks,SENY,44,0,44,-44,1,15,10,1,OTC
4583,12-02-2021 10:00,24 hrs.,pennystocks,SFOR,6,6,0,6,1,1,0,1,OTC
4583,12-02-2021 10:00,24 hrs.,pennystocks,SGLN,83,0,83,-83,1,14,51,1,OTC
4583,12-02-2021 10:00,24 hrs.,pennystocks,SGMD,248,50,198,-148,9,72,68,9,OTC
4583,12-02-2021 10:00,24 hrs.,pennystocks,SGSI,147,25,122,-97,5,46,35,4,OTC
4583,12-02-2021 10:00,24 hrs.,pennystocks,SHMP,23,6,17,-11,2,1,13,2,OTC
4583,12-02-2021 10:00,24 hrs.,pennystocks,SHRG,7,0,7,-7,1,1,1,1,OTC
4583,12-02-2021 10:00,24 hrs.,pennystocks,SILO,15,15,0,15,1,3,5,1,OTC
4583,12-02-2021 10:00,24 hrs.,pennystocks,SIML,99,0,99,-99,6,23,29,2,OTC
4583,12-02-2021 10:00,24 hrs.,pennystocks,SING,28,0,28,-28,2,1,18,2,OTC
4583,12-02-2021 10:00,24 hrs.,pennystocks,SNPW,892,295,597,-302,6,332,204,6,OTC
4583,12-02-2021 10:00,24 hrs.,pennystocks,SPRN,6,0,6,-6,1,1,0,1,OTC
4583,12-02-2021 10:00,24 hrs.,pennystocks,SRMX,330,161,169,-8,14,69,136,12,OTC
4583,12-02-2021 10:00,24 hrs.,pennystocks,SSFT,41,0,41,-41,4,12,1,2,OTC
4583,12-02-2021 10:00,24 hrs.,pennystocks,STEV,37,16,21,-5,4,8,5,2,OTC
4583,12-02-2021 10:00,24 hrs.,pennystocks,SUGR,6,0,6,-6,1,1,0,1,OTC
4583,12-02-2021 10:00,24 hrs.,pennystocks,SUIC,18,6,12,-6,3,3,0,2,OTC
4583,12-02-2021 10:00,24 hrs.,pennystocks,SURG,116,0,116,-116,1,40,32,1,OTC
4583,12-02-2021 10:00,24 hrs.,pennystocks,TBEV,6,0,6,-6,1,1,0,1,OTC
4583,12-02-2021 10:00,24 hrs.,pennystocks,TFZI,6,6,0,6,1,1,0,1,OTC
4583,12-02-2021 10:00,24 hrs.,pennystocks,TLSS,232,151,81,70,4,58,100,4,OTC
4583,12-02-2021 10:00,24 hrs.,pennystocks,TPAC,6,6,0,6,1,1,0,1,OTC
4583,12-02-2021 10:00,24 hrs.,pennystocks,TREP,6,6,0,6,1,1,0,1,OTC
4583,12-02-2021 10:00,24 hrs.,pennystocks,TRTC,15,0,15,-15,1,0,11,1,OTC
4583,12-02-2021 10:00,24 hrs.,pennystocks,TSNP,36,6,30,-24,6,6,0,6,OTC
4583,12-02-2021 10:00,24 hrs.,pennystocks,TSOI,7,0,7,-7,1,1,1,1,OTC
4583,12-02-2021 10:00,24 hrs.,pennystocks,TSTS,12,12,0,12,2,2,0,1,OTC
4583,12-02-2021 10:00,24 hrs.,pennystocks,TXMC,6,0,6,-6,1,1,0,1,OTC
4583,12-02-2021 10:00,24 hrs.,pennystocks,UATG,12,12,0,12,2,2,0,2,OTC
4583,12-02-2021 10:00,24 hrs.,pennystocks,UNVC,6,0,6,-6,1,1,0,1,OTC
4583,12-02-2021 10:00,24 hrs.,pennystocks,USMJ,27,0,27,-27,4,4,3,3,OTC
4583,12-02-2021 10:00,24 hrs.,pennystocks,USRM,6,6,0,6,1,1,0,1,OTC
4583,12-02-2021 10:00,24 hrs.,pennystocks,ZOM,183,138,45,93,7,60,35,7,AMEX
4583,12-02-2021 10:00,24 hrs.,pennystocks,GSAT,12,0,12,-12,2,2,0,2,AMEX
4583,12-02-2021 10:00,24 hrs.,pennystocks,ICAGY,6,0,6,-6,1,1,0,1,OTC
4583,12-02-2021 10:00,24 hrs.,pennystocks,ISCNF,12,0,12,-12,2,2,0,1,OTC
4583,12-02-2021 10:00,24 hrs.,pennystocks,ISRJF,10,0,10,-10,1,0,6,1,OTC
4583,12-02-2021 10:00,24 hrs.,pennystocks,JETMF,1682,0,1682,-1682,1,742,194,1,OTC
4583,12-02-2021 10:00,24 hrs.,pennystocks,KONAQ,6,0,6,-6,1,1,0,1,OTC
4583,12-02-2021 10:00,24 hrs.,pennystocks,KWHIY,6,0,6,-6,1,0,2,1,OTC
4583,12-02-2021 10:00,24 hrs.,pennystocks,LIACF,41,0,41,-41,2,13,7,2,OTC
4583,12-02-2021 10:00,24 hrs.,pennystocks,LIBFF,198,0,198,-198,1,83,28,1,OTC
4583,12-02-2021 10:00,24 hrs.,pennystocks,LKYSF,285,87,198,-111,2,118,41,2,OTC
4583,12-02-2021 10:00,24 hrs.,pennystocks,LLKKF,33,6,27,-21,2,7,11,2,OTC
4583,12-02-2021 10:00,24 hrs.,pennystocks,LTMCF,321,0,321,-321,7,94,105,6,OTC
4583,12-02-2021 10:00,24 hrs.,pennystocks,MCURF,198,0,198,-198,1,83,28,1,OTC
4583,12-02-2021 10:00,24 hrs.,pennystocks,MGCLF,36,0,36,-36,1,14,4,1,OTC
4583,12-02-2021 10:00,24 hrs.,pennystocks,MMEDF,510,87,423,-336,4,210,74,4,OTC
4583,12-02-2021 10:00,24 hrs.,pennystocks,MMNFF,54,54,0,54,2,21,4,2,OTC
4583,12-02-2021 10:00,24 hrs.,pennystocks,MNXXF,23,0,23,-23,1,9,1,1,OTC
4583,12-02-2021 10:00,24 hrs.,pennystocks,MSNVF,23,0,23,-23,1,9,1,1,OTC
4583,12-02-2021 10:00,24 hrs.,pennystocks,MYCOF,198,0,198,-198,1,83,28,1,OTC
4583,12-02-2021 10:00,24 hrs.,pennystocks,NCNNF,12,0,12,-12,2,2,0,1,OTC
4583,12-02-2021 10:00,24 hrs.,pennystocks,NEBLQ,6,0,6,-6,1,1,0,1,OTC
4583,12-02-2021 10:00,24 hrs.,pennystocks,NMGRF,114,95,19,76,5,31,32,5,OTC
4583,12-02-2021 10:00,24 hrs.,pennystocks,NMHLY,6,0,6,-6,1,1,0,1,OTC
4583,12-02-2021 10:00,24 hrs.,pennystocks,NMTLF,1682,0,1682,-1682,1,742,194,1,OTC
4583,12-02-2021 10:00,24 hrs.,pennystocks,NRGOF,14,7,7,0,2,2,2,2,OTC
4583,12-02-2021 10:00,24 hrs.,pennystocks,NTDOY,13,0,13,-13,2,2,1,2,OTC
4583,12-02-2021 10:00,24 hrs.,pennystocks,NTSFF,6,6,0,6,1,1,0,1,OTC
4583,12-02-2021 10:00,24 hrs.,pennystocks,NXTTF,31,6,25,-19,5,5,1,5,OTC
4583,12-02-2021 10:00,24 hrs.,pennystocks,ORVRF,22,0,22,-22,1,5,8,1,OTC
4583,12-02-2021 10:00,24 hrs.,pennystocks,PFWIQ,90,90,0,90,1,27,32,1,OTC
4583,12-02-2021 10:00,24 hrs.,pennystocks,PLCKF,1682,0,1682,-1682,1,742,194,1,OTC
4583,12-02-2021 10:00,24 hrs.,pennystocks,PLNHF,26,0,26,-26,1,6,10,1,OTC
4583,12-02-2021 10:00,24 hrs.,pennystocks,PLUUF,34,0,34,-34,1,12,6,1,OTC
4583,12-02-2021 10:00,24 hrs.,pennystocks,PYRNF,6,6,0,6,1,1,0,1,OTC
4583,12-02-2021 10:00,24 hrs.,pennystocks,RACMF,8,8,0,8,1,1,2,1,OTC
4583,12-02-2021 10:00,24 hrs.,pennystocks,RECAF,23,0,23,-23,1,9,1,1,OTC
4583,12-02-2021 10:00,24 hrs.,pennystocks,REGRF,41,0,41,-41,1,11,15,1,OTC
4583,12-02-2021 10:00,24 hrs.,pennystocks,REZZF,1784,0,1784,-1784,2,778,220,2,OTC
4583,12-02-2021 10:00,24 hrs.,pennystocks,RLFTF,19,0,19,-19,3,3,1,2,OTC
4583,12-02-2021 10:00,24 hrs.,pennystocks,RLLCF,7,0,7,-7,1,1,1,1,OTC
4583,12-02-2021 10:00,24 hrs.,pennystocks,ROYTL,6,0,6,-6,1,1,0,1,OTC
4583,12-02-2021 10:00,24 hrs.,pennystocks,RQHTF,55,0,55,-55,1,20,11,1,OTC
4583,12-02-2021 10:00,24 hrs.,pennystocks,RVVTF,262,0,262,-262,3,97,56,2,OTC
4583,12-02-2021 10:00,24 hrs.,pennystocks,VYST,6,0,6,-6,1,1,0,1,OTC
4583,12-02-2021 10:00,24 hrs.,pennystocks,WARM,141,0,141,-141,2,49,35,2,OTC
4583,12-02-2021 10:00,24 hrs.,pennystocks,WDHR,14,0,14,-14,2,2,2,1,OTC
4583,12-02-2021 10:00,24 hrs.,pennystocks,WDLF,187,170,17,153,6,38,87,6,OTC
4583,12-02-2021 10:00,24 hrs.,pennystocks,WHEN,7,7,0,7,1,1,1,1,OTC
4583,12-02-2021 10:00,24 hrs.,pennystocks,WSTL,116,0,116,-116,1,40,32,1,OTC
4583,12-02-2021 10:00,24 hrs.,pennystocks,XDSL,8,0,8,-8,1,1,2,1,OTC
4583,12-02-2021 10:00,24 hrs.,pennystocks,XMET,8,8,0,8,1,0,4,1,OTC
4583,12-02-2021 10:00,24 hrs.,pennystocks,XTRM,6,6,0,6,1,1,0,1,OTC
4583,12-02-2021 10:00,24 hrs.,pennystocks,ZAAG,6,0,6,-6,1,1,0,1,OTC
4583,12-02-2021 10:00,24 hrs.,pennystocks,ZPAS,12,6,6,0,2,2,0,2,OTC
4583,12-02-2021 10:00,24 hrs.,pennystocks,ABEPF,1954,63,1891,-1828,13,816,270,12,OTC
4583,12-02-2021 10:00,24 hrs.,pennystocks,ALLIF,43,43,0,43,1,14,11,1,OTC
4583,12-02-2021 10:00,24 hrs.,pennystocks,AQSZF,37,0,37,-37,1,13,7,1,OTC
4583,12-02-2021 10:00,24 hrs.,pennystocks,ARBKF,101,101,0,101,1,27,43,1,OTC
4583,12-02-2021 10:00,24 hrs.,pennystocks,BDRBF,50,0,50,-50,1,15,16,1,OTC
4583,12-02-2021 10:00,24 hrs.,pennystocks,BLOZF,12,0,12,-12,2,2,0,1,OTC
4583,12-02-2021 10:00,24 hrs.,pennystocks,CBLAQ,7,0,7,-7,1,1,1,1,OTC
4583,12-02-2021 10:00,24 hrs.,pennystocks,CBWTF,19,6,13,-7,3,3,1,3,OTC
4583,12-02-2021 10:00,24 hrs.,pennystocks,CCIHY,107,0,107,-107,1,43,17,1,OTC
4583,12-02-2021 10:00,24 hrs.,pennystocks,LOW,87,87,0,87,1,35,13,1,NYSE
4583,12-02-2021 10:00,24 hrs.,pennystocks,MUX,6,0,6,-6,1,1,0,1,NYSE
4583,12-02-2021 10:00,24 hrs.,pennystocks,NOK,60,0,60,-60,3,14,20,2,NYSE
4583,12-02-2021 10:00,24 hrs.,pennystocks,NYC,746,0,746,-746,1,319,104,1,NYSE
4583,12-02-2021 10:00,24 hrs.,pennystocks,PHI,6,0,6,-6,1,1,0,1,NYSE
4583,12-02-2021 10:00,24 hrs.,pennystocks,PSA,586,7,579,-572,5,257,52,5,NYSE
4583,12-02-2021 10:00,24 hrs.,pennystocks,RSI,33,21,12,9,3,8,5,3,NYSE
4583,12-02-2021 10:00,24 hrs.,pennystocks,SAP,198,0,198,-198,1,83,28,1,NYSE
4583,12-02-2021 10:00,24 hrs.,pennystocks,SOS,54,14,40,-26,5,10,14,5,NYSE
4583,12-02-2021 10:00,24 hrs.,pennystocks,TDA,25,0,25,-25,1,4,13,1,NYSE
4583,12-02-2021 10:00,24 hrs.,pennystocks,THC,301,0,301,-301,3,117,55,3,NYSE
4583,12-02-2021 10:00,24 hrs.,pennystocks,TKR,11,0,11,-11,1,2,3,1,NYSE
4583,12-02-2021 10:00,24 hrs.,pennystocks,TTI,12,0,12,-12,2,2,0,1,NYSE
4583,12-02-2021 10:00,24 hrs.,pennystocks,VET,9,0,9,-9,1,2,1,1,NYSE
4583,12-02-2021 10:00,24 hrs.,pennystocks,WWE,7,7,0,7,1,1,1,1,NYSE
4583,12-02-2021 10:00,24 hrs.,pennystocks,AQUA,7,0,7,-7,1,1,1,1,NYSE
4583,12-02-2021 10:00,24 hrs.,pennystocks,BORR,6,0,6,-6,1,1,0,1,NYSE
4583,12-02-2021 10:00,24 hrs.,pennystocks,DASH,6,0,6,-6,1,1,0,1,NYSE
4583,12-02-2021 10:00,24 hrs.,pennystocks,FENG,6,0,6,-6,1,1,0,1,NYSE
4583,12-02-2021 10:00,24 hrs.,pennystocks,HYLN,19,7,12,-5,3,3,1,2,NYSE
4583,12-02-2021 10:00,24 hrs.,pennystocks,RWBYF,7,0,7,-7,1,1,1,1,OTC
4583,12-02-2021 10:00,24 hrs.,pennystocks,RYCEY,13,6,7,-1,2,2,1,2,OTC
4583,12-02-2021 10:00,24 hrs.,pennystocks,RYMDF,52,0,52,-52,5,13,6,4,OTC
4583,12-02-2021 10:00,24 hrs.,pennystocks,SBSAA,5,5,0,5,1,0,1,1,OTC
4583,12-02-2021 10:00,24 hrs.,pennystocks,SHRMF,285,87,198,-111,2,118,41,2,OTC
4583,12-02-2021 10:00,24 hrs.,pennystocks,SMRTQ,6,0,6,-6,1,1,0,1,OTC
4583,12-02-2021 10:00,24 hrs.,pennystocks,SORHF,8,0,8,-8,1,1,2,1,OTC
4583,12-02-2021 10:00,24 hrs.,pennystocks,SPLIF,24,0,24,-24,4,4,0,3,OTC
4583,12-02-2021 10:00,24 hrs.,pennystocks,SPMTF,8,0,8,-8,1,1,2,1,OTC
4583,12-02-2021 10:00,24 hrs.,pennystocks,SPRWF,1658,1652,6,1646,10,709,200,9,OTC
4583,12-02-2021 10:00,24 hrs.,pennystocks,TAKOF,364,6,358,-352,4,138,72,3,OTC
4583,12-02-2021 10:00,24 hrs.,pennystocks,TFECF,6,6,0,6,1,1,0,1,OTC
4583,12-02-2021 10:00,24 hrs.,pennystocks,TFECY,6,6,0,6,1,1,0,1,OTC
4583,12-02-2021 10:00,24 hrs.,pennystocks,TLOFF,69,12,57,-45,3,15,27,2,OTC
4583,12-02-2021 10:00,24 hrs.,pennystocks,TMASF,24,0,24,-24,4,4,0,2,OTC
4583,12-02-2021 10:00,24 hrs.,pennystocks,TRUFF,198,0,198,-198,1,83,28,1,OTC
4583,12-02-2021 10:00,24 hrs.,pennystocks,TSCRF,29,29,0,29,1,9,7,1,OTC
4583,12-02-2021 10:00,24 hrs.,pennystocks,TSKFF,39,39,0,39,1,15,5,1,OTC
4583,12-02-2021 10:00,24 hrs.,pennystocks,TTTSF,12,6,6,0,2,2,0,2,OTC
4583,12-02-2021 10:00,24 hrs.,pennystocks,VLNCF,16,0,16,-16,2,2,4,2,OTC
4583,12-02-2021 10:00,24 hrs.,pennystocks,VRNDF,6,0,6,-6,1,1,0,1,OTC
4583,12-02-2021 10:00,24 hrs.,pennystocks,ZBISF,12,0,12,-12,2,2,0,2,OTC
4583,12-02-2021 10:00,24 hrs.,pennystocks,APT,12,0,12,-12,2,2,0,1,AMEX
4583,12-02-2021 10:00,24 hrs.,pennystocks,CEI,6,0,6,-6,1,1,0,1,AMEX
4583,12-02-2021 10:00,24 hrs.,pennystocks,CTO,36,36,0,36,4,7,6,1,AMEX
4583,12-02-2021 10:00,24 hrs.,pennystocks,DNN,870,302,568,-266,10,296,238,8,AMEX
4583,12-02-2021 10:00,24 hrs.,pennystocks,DPW,6,6,0,6,1,1,0,1,AMEX
4583,12-02-2021 10:00,24 hrs.,pennystocks,DSS,18,0,18,-18,2,1,8,2,AMEX
4583,12-02-2021 10:00,24 hrs.,pennystocks,GPL,31,31,0,31,1,11,5,1,AMEX
4583,12-02-2021 10:00,24 hrs.,pennystocks,GSV,116,0,116,-116,5,37,22,4,AMEX
4583,12-02-2021 10:00,24 hrs.,pennystocks,GTE,41,7,34,-27,4,9,7,4,AMEX
4583,12-02-2021 10:00,24 hrs.,pennystocks,ITP,28,14,14,0,2,5,10,2,AMEX
4583,12-02-2021 10:00,24 hrs.,pennystocks,LNG,11,0,11,-11,1,3,1,1,AMEX
4583,12-02-2021 10:00,24 hrs.,pennystocks,MCF,6,0,6,-6,1,1,0,1,AMEX
4583,12-02-2021 10:00,24 hrs.,pennystocks,MXC,36,0,36,-36,1,14,4,1,AMEX
4583,12-02-2021 10:00,24 hrs.,pennystocks,NAK,18,6,12,-6,3,3,0,3,AMEX
4583,12-02-2021 10:00,24 hrs.,pennystocks,NBY,21,0,21,-21,1,5,7,1,AMEX
4583,12-02-2021 10:00,24 hrs.,pennystocks,NHS,17,0,17,-17,1,0,13,1,AMEX
4583,12-02-2021 10:00,24 hrs.,pennystocks,PTN,11,0,11,-11,1,2,3,1,AMEX
4583,12-02-2021 10:00,24 hrs.,pennystocks,SIM,6,0,6,-6,1,1,0,1,AMEX
4583,12-02-2021 10:00,24 hrs.,pennystocks,TGC,48,48,0,48,1,20,4,1,AMEX
4583,12-02-2021 10:00,24 hrs.,pennystocks,TRX,20,14,6,8,3,3,2,3,AMEX
4583,12-02-2021 10:00,24 hrs.,pennystocks,URG,23,0,23,-23,1,9,1,1,AMEX
4583,12-02-2021 10:00,24 hrs.,pennystocks,WRN,6,0,6,-6,1,1,0,1,AMEX
4583,12-02-2021 10:00,24 hrs.,pennystocks,AZN,28,28,0,28,1,5,14,1,NASDAQ
4583,12-02-2021 10:00,24 hrs.,pennystocks,BBI,40,34,6,28,2,13,6,2,NASDAQ
4583,12-02-2021 10:00,24 hrs.,pennystocks,CFO,33,33,0,33,1,9,11,1,NASDAQ
4583,12-02-2021 10:00,24 hrs.,pennystocks,GBT,7,0,7,-7,1,1,1,1,NASDAQ
4583,12-02-2021 10:00,24 hrs.,pennystocks,JFU,6,0,6,-6,1,1,0,1,NASDAQ
4583,12-02-2021 10:00,24 hrs.,pennystocks,MFH,48,48,0,48,1,20,4,1,NASDAQ
4583,12-02-2021 10:00,24 hrs.,pennystocks,NEO,378,0,378,-378,2,160,50,2,NASDAQ
4583,12-02-2021 10:00,24 hrs.,pennystocks,OGI,20,7,13,-6,3,3,2,3,NASDAQ
4583,12-02-2021 10:00,24 hrs.,pennystocks,PTE,20,0,20,-20,3,3,2,2,NASDAQ
4583,12-02-2021 10:00,24 hrs.,pennystocks,RUN,4,0,4,-4,1,0,0,1,NASDAQ
4583,12-02-2021 10:00,24 hrs.,pennystocks,UFO,6,6,0,6,1,1,0,1,NASDAQ
4583,12-02-2021 10:00,24 hrs.,pennystocks,ABEO,51,0,51,-51,8,8,3,3,NASDAQ
4583,12-02-2021 10:00,24 hrs.,pennystocks,ABIO,32,26,6,20,2,10,4,2,NASDAQ
4583,12-02-2021 10:00,24 hrs.,pennystocks,ACRX,23,0,23,-23,1,9,1,1,NASDAQ
4583,12-02-2021 10:00,24 hrs.,pennystocks,ACST,7,7,0,7,1,1,1,1,NASDAQ
4583,12-02-2021 10:00,24 hrs.,pennystocks,ADMA,1682,0,1682,-1682,1,742,194,1,NASDAQ
4583,12-02-2021 10:00,24 hrs.,pennystocks,ADTX,46,0,46,-46,2,12,14,2,NASDAQ
4583,12-02-2021 10:00,24 hrs.,pennystocks,ADXS,26,0,26,-26,4,4,2,3,NASDAQ
4583,12-02-2021 10:00,24 hrs.,pennystocks,AEMD,36,0,36,-36,1,13,6,1,NASDAQ
4583,12-02-2021 10:00,24 hrs.,pennystocks,AGTC,556,17,539,-522,6,228,76,6,NASDAQ
4583,12-02-2021 10:00,24 hrs.,pennystocks,AIHS,6,0,6,-6,1,1,0,1,NASDAQ
4583,12-02-2021 10:00,24 hrs.,pennystocks,AKBA,14,0,14,-14,2,3,0,1,NASDAQ
4583,12-02-2021 10:00,24 hrs.,pennystocks,AKER,7,0,7,-7,1,1,1,1,NASDAQ
4583,12-02-2021 10:00,24 hrs.,pennystocks,ALRN,18,18,0,18,1,2,10,1,NASDAQ
4583,12-02-2021 10:00,24 hrs.,pennystocks,AMTX,23,0,23,-23,1,9,1,1,NASDAQ
4583,12-02-2021 10:00,24 hrs.,pennystocks,ANDA,17,0,17,-17,1,0,13,1,NASDAQ
4583,12-02-2021 10:00,24 hrs.,pennystocks,APHA,6,0,6,-6,1,1,0,1,NASDAQ
4583,12-02-2021 10:00,24 hrs.,pennystocks,ARTL,142,0,142,-142,3,47,36,2,NASDAQ
4583,12-02-2021 10:00,24 hrs.,pennystocks,ASRT,373,120,253,-133,10,134,65,4,NASDAQ
4583,12-02-2021 10:00,24 hrs.,pennystocks,ATHE,23,0,23,-23,1,9,1,1,NASDAQ
4583,12-02-2021 10:00,24 hrs.,pennystocks,ATOM,6,0,6,-6,1,1,0,1,NASDAQ
4583,12-02-2021 10:00,24 hrs.,pennystocks,ATOS,287,146,141,5,7,95,69,7,NASDAQ
4583,12-02-2021 10:00,24 hrs.,pennystocks,AVXL,7,0,7,-7,1,1,1,1,NASDAQ
4583,12-02-2021 10:00,24 hrs.,pennystocks,AYTU,6,0,6,-6,1,1,0,1,NASDAQ
4583,12-02-2021 10:00,24 hrs.,pennystocks,AZRX,9,9,0,9,1,1,3,1,NASDAQ
4583,12-02-2021 10:00,24 hrs.,pennystocks,BBIG,6,6,0,6,1,1,0,1,NASDAQ
4583,12-02-2021 10:00,24 hrs.,pennystocks,BEEM,45,0,45,-45,1,15,11,1,NASDAQ
4583,12-02-2021 10:00,24 hrs.,pennystocks,BHTG,19,0,19,-19,2,1,9,1,NASDAQ
4583,12-02-2021 10:00,24 hrs.,pennystocks,IBIO,7,0,7,-7,1,1,1,1,AMEX
4583,12-02-2021 10:00,24 hrs.,pennystocks,OGEN,1688,0,1688,-1688,2,743,194,2,AMEX
4583,12-02-2021 10:00,24 hrs.,pennystocks,SENS,64,35,29,6,3,24,4,3,AMEX
4583,12-02-2021 10:00,24 hrs.,pennystocks,TMBR,48,48,0,48,1,20,4,1,AMEX
4583,12-02-2021 10:00,24 hrs.,pennystocks,TRXC,6,0,6,-6,1,1,0,1,AMEX
4583,12-02-2021 10:00,24 hrs.,pennystocks,UUUU,43,0,43,-43,2,12,11,2,AMEX
4583,12-02-2021 10:00,24 hrs.,pennystocks,XXII,33,0,33,-33,2,10,5,1,AMEX
4583,12-02-2021 10:00,24 hrs.,pennystocks,YCBD,6,0,6,-6,1,1,0,1,AMEX
4583,12-02-2021 10:00,24 hrs.,pennystocks,AMC,26,0,26,-26,4,4,2,3,NYSE
4583,12-02-2021 10:00,24 hrs.,pennystocks,AMP,102,0,102,-102,3,33,24,2,NYSE
4583,12-02-2021 10:00,24 hrs.,pennystocks,ASX,6,0,6,-6,1,1,0,1,NYSE
4583,12-02-2021 10:00,24 hrs.,pennystocks,AUY,6,0,6,-6,1,1,0,1,NYSE
4583,12-02-2021 10:00,24 hrs.,pennystocks,BIO,266,128,138,-10,3,112,30,3,NYSE
4583,12-02-2021 10:00,24 hrs.,pennystocks,CBD,373,57,316,-259,14,125,67,11,NYSE
4583,12-02-2021 10:00,24 hrs.,pennystocks,CMO,33,33,0,33,1,9,11,1,NYSE
4583,12-02-2021 10:00,24 hrs.,pennystocks,CRL,6,0,6,-6,1,1,0,1,NYSE
4583,12-02-2021 10:00,24 hrs.,pennystocks,CTK,48,48,0,48,1,20,4,1,NYSE
4583,12-02-2021 10:00,24 hrs.,pennystocks,CVE,14,8,6,2,2,2,2,2,NYSE
4583,12-02-2021 10:00,24 hrs.,pennystocks,DDS,45,0,45,-45,1,15,11,1,NYSE
4583,12-02-2021 10:00,24 hrs.,pennystocks,ETH,6,0,6,-6,1,1,0,1,NYSE
4583,12-02-2021 10:00,24 hrs.,pennystocks,EXP,10,0,10,-10,1,2,2,1,NYSE
4583,12-02-2021 10:00,24 hrs.,pennystocks,FLT,13,6,7,-1,2,2,1,2,NYSE
4583,12-02-2021 10:00,24 hrs.,pennystocks,GIK,9,0,9,-9,1,0,5,1,NYSE
4583,12-02-2021 10:00,24 hrs.,pennystocks,GME,49,12,37,-25,8,8,1,7,NYSE
4583,12-02-2021 10:00,24 hrs.,pennystocks,JKS,45,0,45,-45,1,15,11,1,NYSE
4583,12-02-2021 10:00,24 hrs.,pennystocks,LEE,110,0,110,-110,2,16,70,2,NYSE
4583,12-02-2021 10:00,24 hrs.,pennystocks,PHIO,48,48,0,48,1,20,4,1,NASDAQ
4583,12-02-2021 10:00,24 hrs.,pennystocks,PHUN,13,13,0,13,2,2,1,2,NASDAQ
4583,12-02-2021 10:00,24 hrs.,pennystocks,PLUG,126,81,45,36,2,28,62,2,NASDAQ
4583,12-02-2021 10:00,24 hrs.,pennystocks,POAI,7,0,7,-7,1,0,3,1,NASDAQ
4583,12-02-2021 10:00,24 hrs.,pennystocks,POWW,12,0,12,-12,2,1,2,2,NASDAQ
4583,12-02-2021 10:00,24 hrs.,pennystocks,PPBT,10,10,0,10,1,2,2,1,NASDAQ
4583,12-02-2021 10:00,24 hrs.,pennystocks,PRQR,24,0,24,-24,2,4,8,1,NASDAQ
4583,12-02-2021 10:00,24 hrs.,pennystocks,PSTV,56,44,12,32,3,18,8,3,NASDAQ
4583,12-02-2021 10:00,24 hrs.,pennystocks,PULM,847,48,799,-751,4,339,153,4,NASDAQ
4583,12-02-2021 10:00,24 hrs.,pennystocks,RAVE,38,38,0,38,1,12,10,1,NASDAQ
4583,12-02-2021 10:00,24 hrs.,pennystocks,BKEP,14,14,0,14,1,3,4,1,NASDAQ
4583,12-02-2021 10:00,24 hrs.,pennystocks,BLCM,48,48,0,48,1,20,4,1,NASDAQ
4583,12-02-2021 10:00,24 hrs.,pennystocks,BLUE,6,0,6,-6,1,1,0,1,NASDAQ
4583,12-02-2021 10:00,24 hrs.,pennystocks,BNGO,23,0,23,-23,1,9,1,1,NASDAQ
4583,12-02-2021 10:00,24 hrs.,pennystocks,BOXL,23,0,23,-23,1,9,1,1,NASDAQ
4583,12-02-2021 10:00,24 hrs.,pennystocks,BPTH,29,0,29,-29,1,4,17,1,NASDAQ
4583,12-02-2021 10:00,24 hrs.,pennystocks,BRQS,58,0,58,-58,1,20,14,1,NASDAQ
4583,12-02-2021 10:00,24 hrs.,pennystocks,BVXV,7,0,7,-7,1,1,1,1,NASDAQ
4583,12-02-2021 10:00,24 hrs.,pennystocks,BYFC,6,0,6,-6,1,1,0,1,NASDAQ
4583,12-02-2021 10:00,24 hrs.,pennystocks,CAPR,6,0,6,-6,1,1,0,1,NASDAQ
4583,12-02-2021 10:00,24 hrs.,pennystocks,CIDM,13,0,13,-13,2,2,1,2,NASDAQ
4583,12-02-2021 10:00,24 hrs.,pennystocks,CJJD,48,48,0,48,1,20,4,1,NASDAQ
4583,12-02-2021 10:00,24 hrs.,pennystocks,CKPT,60,60,0,60,3,22,4,2,NASDAQ
4583,12-02-2021 10:00,24 hrs.,pennystocks,CLBS,7,7,0,7,1,1,1,1,NASDAQ
4583,12-02-2021 10:00,24 hrs.,pennystocks,CLRB,6,0,6,-6,1,1,0,1,NASDAQ
4583,12-02-2021 10:00,24 hrs.,pennystocks,CMPS,291,87,204,-117,3,119,41,3,NASDAQ
4583,12-02-2021 10:00,24 hrs.,pennystocks,CNET,13,0,13,-13,1,3,3,1,NASDAQ
4583,12-02-2021 10:00,24 hrs.,pennystocks,CRBP,152,0,152,-152,2,58,28,2,NASDAQ
4583,12-02-2021 10:00,24 hrs.,pennystocks,CRSR,48,0,48,-48,1,12,20,1,NASDAQ
4583,12-02-2021 10:00,24 hrs.,pennystocks,CTRM,2500,72,2428,-2356,30,1013,354,23,NASDAQ
4583,12-02-2021 10:00,24 hrs.,pennystocks,CTXR,6,0,6,-6,1,1,0,1,NASDAQ
4583,12-02-2021 10:00,24 hrs.,pennystocks,DFFN,16,16,0,16,1,5,2,1,NASDAQ
4583,12-02-2021 10:00,24 hrs.,pennystocks,DGLY,35,0,35,-35,5,5,5,1,NASDAQ
4583,12-02-2021 10:00,24 hrs.,pennystocks,DYNT,48,48,0,48,1,20,4,1,NASDAQ
4583,12-02-2021 10:00,24 hrs.,pennystocks,EAST,1682,0,1682,-1682,1,742,194,1,NASDAQ
4583,12-02-2021 10:00,24 hrs.,pennystocks,EBON,6,0,6,-6,1,1,0,1,NASDAQ
4583,12-02-2021 10:00,24 hrs.,pennystocks,EDIT,1517,0,1517,-1517,3,633,239,3,NASDAQ
4583,12-02-2021 10:00,24 hrs.,pennystocks,ENPH,81,81,0,81,1,13,51,1,NASDAQ
4583,12-02-2021 10:00,24 hrs.,pennystocks,EVFM,12,6,6,0,2,2,0,2,NASDAQ
4583,12-02-2021 10:00,24 hrs.,pennystocks,FCEL,81,81,0,81,1,13,51,1,NASDAQ
4583,12-02-2021 10:00,24 hrs.,pennystocks,FIVE,87,87,0,87,1,35,13,1,NASDAQ
4583,12-02-2021 10:00,24 hrs.,pennystocks,GEVO,57,57,0,57,3,13,19,2,NASDAQ
4583,12-02-2021 10:00,24 hrs.,pennystocks,GHSI,94,6,88,-82,2,33,20,2,NASDAQ
4583,12-02-2021 10:00,24 hrs.,pennystocks,GLBS,18,0,18,-18,1,0,14,1,NASDAQ
4583,12-02-2021 10:00,24 hrs.,pennystocks,GNLN,7,0,7,-7,1,1,1,1,NASDAQ
4583,12-02-2021 10:00,24 hrs.,pennystocks,GOLD,12,0,12,-12,2,2,0,2,NASDAQ
4583,12-02-2021 10:00,24 hrs.,pennystocks,GRIL,44,44,0,44,2,13,10,2,NASDAQ
4583,12-02-2021 10:00,24 hrs.,pennystocks,GRNQ,48,48,0,48,1,20,4,1,NASDAQ
4583,12-02-2021 10:00,24 hrs.,pennystocks,HALO,12,6,6,0,2,2,0,2,NASDAQ
4583,12-02-2021 10:00,24 hrs.,pennystocks,HJLI,11,0,11,-11,1,2,3,1,NASDAQ
4583,12-02-2021 10:00,24 hrs.,pennystocks,HSTO,6,6,0,6,1,1,0,1,NASDAQ
4583,12-02-2021 10:00,24 hrs.,pennystocks,IDEX,6,0,6,-6,1,1,0,1,NASDAQ
4583,12-02-2021 10:00,24 hrs.,pennystocks,IFMK,86,86,0,86,2,32,14,2,NASDAQ
4583,12-02-2021 10:00,24 hrs.,pennystocks,INFI,48,48,0,48,1,20,4,1,NASDAQ
4583,12-02-2021 10:00,24 hrs.,pennystocks,INFO,6,0,6,-6,1,0,2,1,NASDAQ
4583,12-02-2021 10:00,24 hrs.,pennystocks,INPX,88,61,27,34,7,26,8,6,NASDAQ
4583,12-02-2021 10:00,24 hrs.,pennystocks,ITRM,10,0,10,-10,1,2,2,1,NASDAQ
4583,12-02-2021 10:00,24 hrs.,pennystocks,JAGX,17,6,11,-5,2,4,1,2,NASDAQ
4583,12-02-2021 10:00,24 hrs.,pennystocks,KERN,6,0,6,-6,1,1,0,1,NASDAQ
4583,12-02-2021 10:00,24 hrs.,pennystocks,KTRA,1748,59,1689,-1630,4,761,210,4,NASDAQ
4583,12-02-2021 10:00,24 hrs.,pennystocks,LEAF,47,0,47,-47,1,16,11,1,NYSE
4583,12-02-2021 10:00,24 hrs.,pennystocks,NOVA,198,0,198,-198,1,83,28,1,NYSE
4583,12-02-2021 10:00,24 hrs.,pennystocks,WELL,6,0,6,-6,1,1,0,1,NYSE
4583,12-02-2021 10:00,24 hrs.,pennystocks,AQB,29,6,23,-17,2,10,1,2,NASDAQ
4583,12-02-2021 10:00,24 hrs.,wallstreetbets,BVNNF,7,0,7,-7,1,1,1,1,OTC
4583,12-02-2021 10:00,24 hrs.,wallstreetbets,CBWTF,33,11,22,-11,5,3,7,5,OTC
4583,12-02-2021 10:00,24 hrs.,wallstreetbets,CCHWF,6,0,6,-6,1,1,0,1,OTC
4583,12-02-2021 10:00,24 hrs.,wallstreetbets,CHOOF,6,0,6,-6,1,1,0,1,OTC
4583,12-02-2021 10:00,24 hrs.,wallstreetbets,CNABQ,12,0,12,-12,2,2,0,2,OTC
4583,12-02-2021 10:00,24 hrs.,wallstreetbets,CNTTQ,6,0,6,-6,1,1,0,1,OTC
4583,12-02-2021 10:00,24 hrs.,wallstreetbets,CPXGF,6,0,6,-6,1,1,0,1,OTC
4583,12-02-2021 10:00,24 hrs.,wallstreetbets,CRLBF,19,0,19,-19,3,3,1,3,OTC
4583,12-02-2021 10:00,24 hrs.,wallstreetbets,CURLF,655,0,655,-655,3,204,235,3,OTC
4583,12-02-2021 10:00,24 hrs.,wallstreetbets,CXXIF,118,0,118,-118,1,23,68,1,OTC
4583,12-02-2021 10:00,24 hrs.,wallstreetbets,DFLYF,33,33,0,33,3,2,17,2,OTC
4583,12-02-2021 10:00,24 hrs.,wallstreetbets,EHVVF,6,0,6,-6,1,1,0,1,OTC
4583,12-02-2021 10:00,24 hrs.,wallstreetbets,EPWCF,12,0,12,-12,1,0,8,1,OTC
4583,12-02-2021 10:00,24 hrs.,wallstreetbets,FDVRF,6,0,6,-6,1,1,0,1,OTC
4583,12-02-2021 10:00,24 hrs.,wallstreetbets,FGPHF,6,0,6,-6,1,1,0,1,OTC
4583,12-02-2021 10:00,24 hrs.,wallstreetbets,FLOOF,18,0,18,-18,3,3,0,3,OTC
4583,12-02-2021 10:00,24 hrs.,wallstreetbets,FLWPF,13,7,6,1,2,2,1,2,OTC
4583,12-02-2021 10:00,24 hrs.,wallstreetbets,GAYMF,21,14,7,7,3,3,3,3,OTC
4583,12-02-2021 10:00,24 hrs.,wallstreetbets,GGTTF,12,0,12,-12,2,2,0,1,OTC
4583,12-02-2021 10:00,24 hrs.,wallstreetbets,GLDFF,6,0,6,-6,1,1,0,1,OTC
4583,12-02-2021 10:00,24 hrs.,wallstreetbets,GPORQ,6,0,6,-6,1,1,0,1,OTC
4583,12-02-2021 10:00,24 hrs.,wallstreetbets,GTBIF,650,0,650,-650,2,203,236,2,OTC
4583,12-02-2021 10:00,24 hrs.,wallstreetbets,GUESF,6,0,6,-6,1,1,0,1,OTC
4583,12-02-2021 10:00,24 hrs.,wallstreetbets,HITIF,113,0,113,-113,10,22,29,9,OTC
4583,12-02-2021 10:00,24 hrs.,wallstreetbets,HRVOF,6,0,6,-6,1,1,0,1,OTC
4583,12-02-2021 10:00,24 hrs.,wallstreetbets,HRVSF,12,0,12,-12,2,2,0,2,OTC
4583,12-02-2021 10:00,24 hrs.,wallstreetbets,HSTRF,6,0,6,-6,1,1,0,1,OTC
4583,12-02-2021 10:00,24 hrs.,wallstreetbets,HTZGQ,24,0,24,-24,4,4,0,2,OTC
4583,12-02-2021 10:00,24 hrs.,wallstreetbets,HVBTF,6,0,6,-6,1,1,0,1,OTC
4583,12-02-2021 10:00,24 hrs.,wallstreetbets,ITHUF,6,0,6,-6,1,1,0,1,OTC
4583,12-02-2021 10:00,24 hrs.,wallstreetbets,JUVAF,6,0,6,-6,1,1,0,1,OTC
4583,12-02-2021 10:00,24 hrs.,wallstreetbets,KPIFF,6,6,0,6,1,1,0,1,OTC
4583,12-02-2021 10:00,24 hrs.,wallstreetbets,LHSIF,6,0,6,-6,1,1,0,1,OTC
4583,12-02-2021 10:00,24 hrs.,wallstreetbets,LIACF,12,0,12,-12,2,2,0,2,OTC
4583,12-02-2021 10:00,24 hrs.,wallstreetbets,LITOF,6,0,6,-6,1,1,0,1,OTC
4583,12-02-2021 10:00,24 hrs.,wallstreetbets,LKNCY,12,6,6,0,2,2,0,2,OTC
4583,12-02-2021 10:00,24 hrs.,wallstreetbets,LKYSF,7,0,7,-7,1,1,1,1,OTC
4583,12-02-2021 10:00,24 hrs.,wallstreetbets,LLKKF,6,6,0,6,1,1,0,1,OTC
4583,12-02-2021 10:00,24 hrs.,pennystocks,KXIN,7,0,7,-7,1,1,1,1,NASDAQ
4583,12-02-2021 10:00,24 hrs.,pennystocks,LGHL,1682,0,1682,-1682,1,742,194,1,NASDAQ
4583,12-02-2021 10:00,24 hrs.,pennystocks,LIFE,17,0,17,-17,2,4,1,2,NASDAQ
4583,12-02-2021 10:00,24 hrs.,pennystocks,LKCO,74,55,19,36,5,24,6,4,NASDAQ
4583,12-02-2021 10:00,24 hrs.,pennystocks,LMFA,45,0,45,-45,1,15,11,1,NASDAQ
4583,12-02-2021 10:00,24 hrs.,pennystocks,LPCN,58,35,23,12,2,20,10,2,NASDAQ
4583,12-02-2021 10:00,24 hrs.,pennystocks,MARA,8,8,0,8,1,0,4,1,NASDAQ
4583,12-02-2021 10:00,24 hrs.,pennystocks,MARK,81,81,0,81,1,13,51,1,NASDAQ
4583,12-02-2021 10:00,24 hrs.,pennystocks,MDGS,6,6,0,6,1,1,0,1,NASDAQ
4583,12-02-2021 10:00,24 hrs.,pennystocks,MICT,7,0,7,-7,1,1,1,1,NASDAQ
4583,12-02-2021 10:00,24 hrs.,pennystocks,MNDO,6,0,6,-6,1,1,0,1,NASDAQ
4583,12-02-2021 10:00,24 hrs.,pennystocks,MOGO,28,0,28,-28,3,2,12,1,NASDAQ
4583,12-02-2021 10:00,24 hrs.,pennystocks,MOSY,48,48,0,48,1,20,4,1,NASDAQ
4583,12-02-2021 10:00,24 hrs.,pennystocks,MOTS,30,0,30,-30,2,10,2,2,NASDAQ
4583,12-02-2021 10:00,24 hrs.,pennystocks,MTRX,8,8,0,8,1,1,2,1,NASDAQ
4583,12-02-2021 10:00,24 hrs.,pennystocks,MVIS,54,54,0,54,2,21,4,2,NASDAQ
4583,12-02-2021 10:00,24 hrs.,pennystocks,NAKD,176,6,170,-164,8,54,36,8,NASDAQ
4583,12-02-2021 10:00,24 hrs.,pennystocks,NEOS,6,0,6,-6,1,1,0,1,NASDAQ
4583,12-02-2021 10:00,24 hrs.,pennystocks,NOVN,60,30,30,0,4,17,10,4,NASDAQ
4583,12-02-2021 10:00,24 hrs.,pennystocks,NTEC,48,48,0,48,1,20,4,1,NASDAQ
4583,12-02-2021 10:00,24 hrs.,pennystocks,NVCN,1701,7,1694,-1687,4,745,195,4,NASDAQ
4583,12-02-2021 10:00,24 hrs.,pennystocks,NVIV,6,0,6,-6,1,1,0,1,NASDAQ
4583,12-02-2021 10:00,24 hrs.,pennystocks,NXTD,56,48,8,40,2,21,6,2,NASDAQ
4583,12-02-2021 10:00,24 hrs.,pennystocks,OCGN,2308,0,2308,-2308,4,1059,174,3,NASDAQ
4583,12-02-2021 10:00,24 hrs.,pennystocks,ONTX,12,6,6,0,2,2,0,2,NASDAQ
4583,12-02-2021 10:00,24 hrs.,pennystocks,OPGN,1682,0,1682,-1682,1,742,194,1,NASDAQ
4583,12-02-2021 10:00,24 hrs.,SPACs,CIK,21,0,21,-21,1,2,13,1,AMEX
4583,12-02-2021 10:00,24 hrs.,SPACs,CTO,118,0,118,-118,1,41,32,1,AMEX
4583,12-02-2021 10:00,24 hrs.,SPACs,CHAQ,2360,136,2224,-2088,2,56,2240,2,AMEX
4583,12-02-2021 10:00,24 hrs.,SPACs,BFT,2360,136,2224,-2088,2,56,2240,2,NYSE
4583,12-02-2021 10:00,24 hrs.,SPACs,CCX,7,0,7,-7,1,1,1,1,NYSE
4583,12-02-2021 10:00,24 hrs.,SPACs,CLA,24,0,24,-24,1,8,4,1,NYSE
4583,12-02-2021 10:00,24 hrs.,SPACs,COO,32,0,32,-32,1,9,10,1,NYSE
4583,12-02-2021 10:00,24 hrs.,SPACs,GIK,47,27,20,7,6,4,15,4,NYSE
4583,12-02-2021 10:00,24 hrs.,SPACs,GME,187,0,187,-187,1,57,69,1,NYSE
4583,12-02-2021 10:00,24 hrs.,SPACs,HLF,187,0,187,-187,1,57,69,1,NYSE
4583,12-02-2021 10:00,24 hrs.,SPACs,IPV,2360,136,2224,-2088,2,56,2240,2,NYSE
4583,12-02-2021 10:00,24 hrs.,SPACs,MLM,187,0,187,-187,1,57,69,1,NYSE
4583,12-02-2021 10:00,24 hrs.,SPACs,NAV,428,53,375,-322,7,166,68,6,NYSE
4583,12-02-2021 10:00,24 hrs.,SPACs,NGA,44,21,23,-2,5,4,16,4,NYSE
4583,12-02-2021 10:00,24 hrs.,SPACs,NSH,2224,0,2224,-2224,1,47,2126,1,NYSE
4583,12-02-2021 10:00,24 hrs.,wallstreetbets,ASX,20,14,6,8,3,3,2,3,NYSE
4583,12-02-2021 10:00,24 hrs.,wallstreetbets,LMLLF,6,6,0,6,1,1,0,1,OTC
4583,12-02-2021 10:00,24 hrs.,wallstreetbets,LTMAQ,6,0,6,-6,1,1,0,1,OTC
4583,12-02-2021 10:00,24 hrs.,wallstreetbets,LTMCF,12,6,6,0,2,2,0,2,OTC
4583,12-02-2021 10:00,24 hrs.,wallstreetbets,LXXGF,8,8,0,8,1,1,2,1,OTC
4583,12-02-2021 10:00,24 hrs.,wallstreetbets,MEDIF,6,6,0,6,1,1,0,1,OTC
4583,12-02-2021 10:00,24 hrs.,wallstreetbets,MMEDF,3357,0,3357,-3357,11,1362,589,9,OTC
4583,12-02-2021 10:00,24 hrs.,wallstreetbets,MMNFF,43,0,43,-43,7,7,1,6,OTC
4583,12-02-2021 10:00,24 hrs.,wallstreetbets,MNKKQ,14,14,0,14,2,2,2,1,OTC
4583,12-02-2021 10:00,24 hrs.,wallstreetbets,NMGRF,13,6,7,-1,2,2,1,2,OTC
4583,12-02-2021 10:00,24 hrs.,wallstreetbets,NMHLY,6,0,6,-6,1,1,0,1,OTC
4583,12-02-2021 10:00,24 hrs.,wallstreetbets,NSANY,6,0,6,-6,1,1,0,1,OTC
4583,12-02-2021 10:00,24 hrs.,wallstreetbets,NTSFF,6,6,0,6,1,1,0,1,OTC
4583,12-02-2021 10:00,24 hrs.,wallstreetbets,NWARF,12,0,12,-12,2,2,0,2,OTC
4583,12-02-2021 10:00,24 hrs.,wallstreetbets,NWVCF,6,0,6,-6,1,1,0,1,OTC
4583,12-02-2021 10:00,24 hrs.,wallstreetbets,NXGWF,7,7,0,7,1,1,1,1,OTC
4583,12-02-2021 10:00,24 hrs.,wallstreetbets,NXTTF,6,0,6,-6,1,1,0,1,OTC
4583,12-02-2021 10:00,24 hrs.,wallstreetbets,ORZCF,6,0,6,-6,1,1,0,1,OTC
4583,12-02-2021 10:00,24 hrs.,wallstreetbets,PFFOF,6,0,6,-6,1,1,0,1,OTC
4583,12-02-2021 10:00,24 hrs.,wallstreetbets,PLNHF,154,0,154,-154,7,29,68,5,OTC
4583,12-02-2021 10:00,24 hrs.,wallstreetbets,RAZFF,7,7,0,7,1,1,1,1,OTC
4583,12-02-2021 10:00,24 hrs.,wallstreetbets,RLFTF,24,0,24,-24,4,4,0,2,OTC
4583,12-02-2021 10:00,24 hrs.,wallstreetbets,RLLCF,6,0,6,-6,1,1,0,1,OTC
4583,12-02-2021 10:00,24 hrs.,wallstreetbets,RVVTF,6,0,6,-6,1,1,0,1,OTC
4583,12-02-2021 10:00,24 hrs.,wallstreetbets,RYCEY,145,84,61,23,19,28,13,13,OTC
4583,12-02-2021 10:00,24 hrs.,wallstreetbets,RYMDF,6,0,6,-6,1,1,0,1,OTC
4583,12-02-2021 10:00,24 hrs.,wallstreetbets,SEOVF,6,0,6,-6,1,1,0,1,OTC
4583,12-02-2021 10:00,24 hrs.,wallstreetbets,VYST,6,0,6,-6,1,1,0,1,OTC
4583,12-02-2021 10:00,24 hrs.,wallstreetbets,WARM,18,0,18,-18,3,3,0,1,OTC
4583,12-02-2021 10:00,24 hrs.,wallstreetbets,WCVC,6,0,6,-6,1,1,0,1,OTC
4583,12-02-2021 10:00,24 hrs.,wallstreetbets,WDLF,6,0,6,-6,1,1,0,1,OTC
4583,12-02-2021 10:00,24 hrs.,wallstreetbets,WHEN,43,13,30,-17,7,7,1,4,OTC
4583,12-02-2021 10:00,24 hrs.,wallstreetbets,WNDW,6,0,6,-6,1,1,0,1,OTC
4583,12-02-2021 10:00,24 hrs.,wallstreetbets,WSGF,12,0,12,-12,2,2,0,1,OTC
4583,12-02-2021 10:00,24 hrs.,wallstreetbets,YAYO,6,0,6,-6,1,1,0,1,OTC
4583,12-02-2021 10:00,24 hrs.,wallstreetbets,ZNOG,12,0,12,-12,2,2,0,2,OTC
4583,12-02-2021 10:00,24 hrs.,wallstreetbets,ABEPF,25,0,25,-25,4,4,1,4,OTC
4583,12-02-2021 10:00,24 hrs.,wallstreetbets,ACUIF,6,0,6,-6,1,1,0,1,OTC
4583,12-02-2021 10:00,24 hrs.,wallstreetbets,ALEAF,37,0,37,-37,6,6,1,2,OTC
4583,12-02-2021 10:00,24 hrs.,wallstreetbets,ARBKF,7,7,0,7,1,1,1,1,OTC
4583,12-02-2021 10:00,24 hrs.,wallstreetbets,AYRWF,6,0,6,-6,1,1,0,1,OTC
4583,12-02-2021 10:00,24 hrs.,wallstreetbets,AYTUW,6,0,6,-6,1,1,0,1,OTC
4583,12-02-2021 10:00,24 hrs.,wallstreetbets,AYTUZ,6,0,6,-6,1,1,0,1,OTC
4583,12-02-2021 10:00,24 hrs.,wallstreetbets,BDRBF,92,13,79,-66,11,12,24,11,OTC
4583,12-02-2021 10:00,24 hrs.,wallstreetbets,BHNGF,12,0,12,-12,2,2,0,1,OTC
4583,12-02-2021 10:00,24 hrs.,wallstreetbets,BILZF,24,0,24,-24,4,4,0,3,OTC
4583,12-02-2021 10:00,24 hrs.,wallstreetbets,BITCF,6,0,6,-6,1,1,0,1,OTC
4583,12-02-2021 10:00,24 hrs.,wallstreetbets,BLOZF,6,0,6,-6,1,1,0,1,OTC
4583,12-02-2021 10:00,24 hrs.,wallstreetbets,BUSXF,6,0,6,-6,1,1,0,1,OTC
4583,12-02-2021 10:00,24 hrs.,wallstreetbets,BBY,20,14,6,8,3,3,2,2,NYSE
4583,12-02-2021 10:00,24 hrs.,wallstreetbets,BEP,6,0,6,-6,1,1,0,1,NYSE
4583,12-02-2021 10:00,24 hrs.,wallstreetbets,BFT,14,7,7,0,2,2,2,2,NYSE
4583,12-02-2021 10:00,24 hrs.,wallstreetbets,BGS,12,0,12,-12,2,2,0,1,NYSE
4583,12-02-2021 10:00,24 hrs.,wallstreetbets,BHC,21,21,0,21,3,3,3,1,NYSE
4583,12-02-2021 10:00,24 hrs.,wallstreetbets,BIO,67,0,67,-67,4,15,21,4,NYSE
4583,12-02-2021 10:00,24 hrs.,wallstreetbets,BIT,7,7,0,7,1,1,1,1,NYSE
4583,12-02-2021 10:00,24 hrs.,wallstreetbets,BNY,6,0,6,-6,1,1,0,1,NYSE
4583,12-02-2021 10:00,24 hrs.,wallstreetbets,BTT,69,33,36,-3,11,11,3,11,NYSE
4583,12-02-2021 10:00,24 hrs.,wallstreetbets,BUD,13,7,6,1,2,2,1,2,NYSE
4583,12-02-2021 10:00,24 hrs.,wallstreetbets,CBD,51,21,30,-9,7,9,5,6,NYSE
4583,12-02-2021 10:00,24 hrs.,wallstreetbets,CCJ,6,0,6,-6,1,1,0,1,NYSE
4583,12-02-2021 10:00,24 hrs.,wallstreetbets,CCL,30,0,30,-30,5,5,0,5,NYSE
4583,12-02-2021 10:00,24 hrs.,wallstreetbets,CHS,14,8,6,2,2,2,2,2,NYSE
4583,12-02-2021 10:00,24 hrs.,wallstreetbets,CMO,6,0,6,-6,1,1,0,1,NYSE
4583,12-02-2021 10:00,24 hrs.,wallstreetbets,COO,6,0,6,-6,1,1,0,1,NYSE
4583,12-02-2021 10:00,24 hrs.,wallstreetbets,COP,6,0,6,-6,1,1,0,1,NYSE
4583,12-02-2021 10:00,24 hrs.,wallstreetbets,CRL,6,0,6,-6,1,1,0,1,NYSE
4583,12-02-2021 10:00,24 hrs.,wallstreetbets,CRM,7,0,7,-7,1,1,1,1,NYSE
4583,12-02-2021 10:00,24 hrs.,wallstreetbets,CUB,37,0,37,-37,6,6,1,1,NYSE
4583,12-02-2021 10:00,24 hrs.,wallstreetbets,CVA,13,7,6,1,2,2,1,2,NYSE
4583,12-02-2021 10:00,24 hrs.,wallstreetbets,CVE,6,0,6,-6,1,1,0,1,NYSE
4583,12-02-2021 10:00,24 hrs.,wallstreetbets,CVS,13,0,13,-13,2,2,1,2,NYSE
4583,12-02-2021 10:00,24 hrs.,wallstreetbets,DAL,200,0,200,-200,1,68,60,1,NYSE
4583,12-02-2021 10:00,24 hrs.,wallstreetbets,DCF,225,0,225,-225,1,79,63,1,NYSE
4583,12-02-2021 10:00,24 hrs.,wallstreetbets,DDD,6,0,6,-6,1,1,0,1,NYSE
4583,12-02-2021 10:00,24 hrs.,wallstreetbets,DIS,1989,889,1100,-211,17,776,369,15,NYSE
4583,12-02-2021 10:00,24 hrs.,wallstreetbets,DMS,6,0,6,-6,1,1,0,1,NYSE
4583,12-02-2021 10:00,24 hrs.,wallstreetbets,DNB,7,7,0,7,1,1,1,1,NYSE
4583,12-02-2021 10:00,24 hrs.,wallstreetbets,DOC,7,7,0,7,1,1,1,1,NYSE
4583,12-02-2021 10:00,24 hrs.,wallstreetbets,DTE,895,0,895,-895,1,380,131,1,NYSE
4583,12-02-2021 10:00,24 hrs.,wallstreetbets,EAT,20,14,6,8,3,3,2,3,NYSE
4583,12-02-2021 10:00,24 hrs.,wallstreetbets,EHC,6,0,6,-6,1,1,0,1,NYSE
4583,12-02-2021 10:00,24 hrs.,wallstreetbets,ELY,6,0,6,-6,1,1,0,1,NYSE
4583,12-02-2021 10:00,24 hrs.,wallstreetbets,EMO,6,0,6,-6,1,1,0,1,NYSE
4583,12-02-2021 10:00,24 hrs.,wallstreetbets,ENJ,6,0,6,-6,1,1,0,1,NYSE
4583,12-02-2021 10:00,24 hrs.,wallstreetbets,EOS,13,13,0,13,2,2,1,2,NYSE
4583,12-02-2021 10:00,24 hrs.,wallstreetbets,FAF,12,6,6,0,2,2,0,2,NYSE
4583,12-02-2021 10:00,24 hrs.,wallstreetbets,FCF,225,0,225,-225,1,79,63,1,NYSE
4583,12-02-2021 10:00,24 hrs.,wallstreetbets,FCX,99,99,0,99,6,24,27,3,NYSE
4583,12-02-2021 10:00,24 hrs.,wallstreetbets,FLR,6,0,6,-6,1,1,0,1,NYSE
4583,12-02-2021 10:00,24 hrs.,wallstreetbets,FLT,24,6,18,-12,4,4,0,4,NYSE
4583,12-02-2021 10:00,24 hrs.,wallstreetbets,FMS,13,7,6,1,2,2,1,2,NYSE
4583,12-02-2021 10:00,24 hrs.,wallstreetbets,FOF,6,6,0,6,1,1,0,1,NYSE
4583,12-02-2021 10:00,24 hrs.,wallstreetbets,FSD,24,0,24,-24,4,4,0,3,NYSE
4583,12-02-2021 10:00,24 hrs.,wallstreetbets,FSR,374,368,6,362,8,122,98,6,NYSE
4583,12-02-2021 10:00,24 hrs.,wallstreetbets,FTI,7,7,0,7,1,1,1,1,NYSE
4583,12-02-2021 10:00,24 hrs.,wallstreetbets,GEL,6,0,6,-6,1,1,0,1,NYSE
4583,12-02-2021 10:00,24 hrs.,wallstreetbets,GEO,38,14,24,-10,6,6,2,3,NYSE
4583,12-02-2021 10:00,24 hrs.,wallstreetbets,GLW,7,7,0,7,1,1,1,1,NYSE
4583,12-02-2021 10:00,24 hrs.,wallstreetbets,GME,152358,33464,118894,-85430,533,63267,23692,425,NYSE
4583,12-02-2021 10:00,24 hrs.,wallstreetbets,GTT,6,0,6,-6,1,1,0,1,NYSE
4583,12-02-2021 10:00,24 hrs.,wallstreetbets,GUT,6,0,6,-6,1,1,0,1,NYSE
4583,12-02-2021 10:00,24 hrs.,wallstreetbets,HAL,6,0,6,-6,1,1,0,1,NYSE
4583,12-02-2021 10:00,24 hrs.,wallstreetbets,HII,12,0,12,-12,2,2,0,1,NYSE
4583,12-02-2021 10:00,24 hrs.,wallstreetbets,HON,6,6,0,6,1,1,0,1,NYSE
4583,12-02-2021 10:00,24 hrs.,wallstreetbets,HRB,100,0,100,-100,1,23,50,1,NYSE
4583,12-02-2021 10:00,24 hrs.,wallstreetbets,HRL,622,0,622,-622,1,243,132,1,NYSE
4583,12-02-2021 10:00,24 hrs.,wallstreetbets,HVT,61,0,61,-61,10,10,1,3,NYSE
4583,12-02-2021 10:00,24 hrs.,wallstreetbets,IAG,25,7,18,-11,4,4,1,3,NYSE
4583,12-02-2021 10:00,24 hrs.,SPACs,CAGR,107,107,0,107,1,23,57,1,OTC
4583,12-02-2021 10:00,24 hrs.,SPACs,SENY,7,0,7,-7,1,1,1,1,OTC
4583,12-02-2021 10:00,24 hrs.,SPACs,SBVRF,37,0,37,-37,1,10,13,1,OTC
4583,12-02-2021 10:00,24 hrs.,SPACs,BGI,29,0,29,-29,1,5,15,1,AMEX
4583,12-02-2021 10:00,24 hrs.,SPACs,TLRY,14,14,0,14,1,0,10,1,NASDAQ
4583,12-02-2021 10:00,24 hrs.,SPACs,TSIA,172,0,172,-172,1,70,28,1,NASDAQ
4583,12-02-2021 10:00,24 hrs.,SPACs,TTCF,107,107,0,107,1,23,57,1,NASDAQ
4583,12-02-2021 10:00,24 hrs.,SPACs,UNIT,21,0,21,-21,1,2,13,1,NASDAQ
4583,12-02-2021 10:00,24 hrs.,SPACs,VMAC,7,7,0,7,1,1,1,1,NASDAQ
4583,12-02-2021 10:00,24 hrs.,SPACs,VSPR,38,38,0,38,1,10,14,1,NASDAQ
4583,12-02-2021 10:00,24 hrs.,SPACs,ACEVW,2360,136,2224,-2088,2,56,2240,2,NASDAQ
4583,12-02-2021 10:00,24 hrs.,SPACs,DSACW,2360,136,2224,-2088,2,56,2240,2,NASDAQ
4583,12-02-2021 10:00,24 hrs.,SPACs,ESSCW,2224,0,2224,-2224,1,47,2126,1,NASDAQ
4583,12-02-2021 10:00,24 hrs.,SPACs,GRNVW,2360,136,2224,-2088,2,56,2240,2,NASDAQ
4583,12-02-2021 10:00,24 hrs.,SPACs,LACQW,2360,136,2224,-2088,2,56,2240,2,NASDAQ
4583,12-02-2021 10:00,24 hrs.,SPACs,THBRW,136,136,0,136,1,9,114,1,NASDAQ
4583,12-02-2021 10:00,24 hrs.,SPACs,VACQW,2224,0,2224,-2224,1,47,2126,1,NASDAQ
4583,12-02-2021 10:00,24 hrs.,SPACs,VSPRW,2360,136,2224,-2088,2,56,2240,2,NASDAQ
4583,12-02-2021 10:00,24 hrs.,SPACs,ZGYHW,136,136,0,136,1,9,114,1,NASDAQ
4583,12-02-2021 10:00,24 hrs.,stocks,AITX,6,0,6,-6,1,1,0,1,OTC
4583,12-02-2021 10:00,24 hrs.,stocks,ALPP,6,0,6,-6,1,1,0,1,OTC
4583,12-02-2021 10:00,24 hrs.,stocks,BIEL,6,6,0,6,1,1,0,1,OTC
4583,12-02-2021 10:00,24 hrs.,stocks,BUDZ,7,0,7,-7,1,1,1,1,OTC
4583,12-02-2021 10:00,24 hrs.,SPACs,RMO,7,0,7,-7,1,1,1,1,NYSE
4583,12-02-2021 10:00,24 hrs.,SPACs,RSI,94,94,0,94,1,29,32,1,NYSE
4583,12-02-2021 10:00,24 hrs.,SPACs,RTP,465,32,433,-401,10,125,175,10,NYSE
4583,12-02-2021 10:00,24 hrs.,SPACs,SBE,2881,190,2691,-2501,14,236,2353,13,NYSE
4583,12-02-2021 10:00,24 hrs.,SPACs,WPF,6,6,0,6,1,1,0,1,NYSE
4583,12-02-2021 10:00,24 hrs.,SPACs,ACIC,2379,136,2243,-2107,4,56,2251,4,NYSE
4583,12-02-2021 10:00,24 hrs.,SPACs,ALUS,2224,0,2224,-2224,1,47,2126,1,NYSE
4583,12-02-2021 10:00,24 hrs.,SPACs,ASPL,6,6,0,6,1,1,0,1,NYSE
4583,12-02-2021 10:00,24 hrs.,SPACs,AVAN,6,0,6,-6,1,1,0,1,NYSE
4583,12-02-2021 10:00,24 hrs.,SPACs,CCAC,62,0,62,-62,3,10,30,2,NYSE
4583,12-02-2021 10:00,24 hrs.,SPACs,CCIV,3844,1606,2238,-632,15,578,2628,14,NYSE
4583,12-02-2021 10:00,24 hrs.,SPACs,CLII,47,8,39,-31,3,12,11,3,NYSE
4583,12-02-2021 10:00,24 hrs.,SPACs,DMYD,169,169,0,169,2,14,133,2,NYSE
4583,12-02-2021 10:00,24 hrs.,SPACs,FAII,2231,0,2231,-2231,2,48,2127,2,NYSE
4583,12-02-2021 10:00,24 hrs.,SPACs,FGNA,2224,0,2224,-2224,1,47,2126,1,NYSE
4583,12-02-2021 10:00,24 hrs.,SPACs,FUSE,144,0,144,-144,1,54,32,1,NYSE
4583,12-02-2021 10:00,24 hrs.,SPACs,GSAH,33,33,0,33,1,5,19,1,NYSE
4583,12-02-2021 10:00,24 hrs.,SPACs,HYLN,20,0,20,-20,2,2,8,2,NYSE
4583,12-02-2021 10:00,24 hrs.,SPACs,IPOC,172,0,172,-172,1,70,28,1,NYSE
4583,12-02-2021 10:00,24 hrs.,SPACs,IPOD,172,0,172,-172,1,70,28,1,NYSE
4583,12-02-2021 10:00,24 hrs.,wallstreetbets,IBM,12,0,12,-12,2,2,0,2,NYSE
4583,12-02-2021 10:00,24 hrs.,wallstreetbets,INN,6,0,6,-6,1,1,0,1,NYSE
4583,12-02-2021 10:00,24 hrs.,wallstreetbets,IVC,6,0,6,-6,1,1,0,1,NYSE
4583,12-02-2021 10:00,24 hrs.,wallstreetbets,IVR,186,6,180,-174,3,62,50,3,NYSE
4583,12-02-2021 10:00,24 hrs.,wallstreetbets,JEF,6,0,6,-6,1,1,0,1,NYSE
4583,12-02-2021 10:00,24 hrs.,wallstreetbets,JKS,6,0,6,-6,1,1,0,1,NYSE
4583,12-02-2021 10:00,24 hrs.,wallstreetbets,JNJ,6,6,0,6,1,1,0,1,NYSE
4583,12-02-2021 10:00,24 hrs.,wallstreetbets,JOE,6,0,6,-6,1,1,0,1,NYSE
4583,12-02-2021 10:00,24 hrs.,wallstreetbets,KGC,18,0,18,-18,3,3,0,2,NYSE
4583,12-02-2021 10:00,24 hrs.,wallstreetbets,LAC,19,19,0,19,3,3,1,3,NYSE
4583,12-02-2021 10:00,24 hrs.,wallstreetbets,LEG,6,0,6,-6,1,1,0,1,NYSE
4583,12-02-2021 10:00,24 hrs.,wallstreetbets,LEN,6,6,0,6,1,1,0,1,NYSE
4583,12-02-2021 10:00,24 hrs.,wallstreetbets,LMT,13,7,6,1,2,2,1,2,NYSE
4583,12-02-2021 10:00,24 hrs.,wallstreetbets,LOW,931,0,931,-931,7,386,131,7,NYSE
4583,12-02-2021 10:00,24 hrs.,wallstreetbets,LTC,13,7,6,1,2,2,1,2,NYSE
4583,12-02-2021 10:00,24 hrs.,wallstreetbets,MEN,6,0,6,-6,1,1,0,1,NYSE
4583,12-02-2021 10:00,24 hrs.,wallstreetbets,MIN,7,0,7,-7,1,1,1,1,NYSE
4583,12-02-2021 10:00,24 hrs.,wallstreetbets,MRK,622,0,622,-622,1,243,132,1,NYSE
4583,12-02-2021 10:00,24 hrs.,wallstreetbets,MRO,12,6,6,0,2,2,0,2,NYSE
4583,12-02-2021 10:00,24 hrs.,wallstreetbets,MTL,6,6,0,6,1,1,0,1,NYSE
4583,12-02-2021 10:00,24 hrs.,wallstreetbets,NAT,25,7,18,-11,4,4,1,2,NYSE
4583,12-02-2021 10:00,24 hrs.,wallstreetbets,ATH,56236,6,56230,-56224,2,26538,3152,2,NYSE
4583,12-02-2021 10:00,24 hrs.,wallstreetbets,AUY,12,0,12,-12,2,2,0,2,NYSE
4583,12-02-2021 10:00,24 hrs.,wallstreetbets,AYX,6,0,6,-6,1,1,0,1,NYSE
4583,12-02-2021 10:00,24 hrs.,wallstreetbets,BBW,19,13,6,7,3,3,1,3,NYSE
4583,12-02-2021 10:00,24 hrs.,wallstreetbets,GTEH,24,0,24,-24,3,5,2,3,OTC
4583,12-02-2021 10:00,24 hrs.,wallstreetbets,GTII,932,932,0,932,1,316,296,1,OTC
4583,12-02-2021 10:00,24 hrs.,wallstreetbets,GTLL,7,7,0,7,1,1,1,1,OTC
4583,12-02-2021 10:00,24 hrs.,wallstreetbets,GTXO,6,0,6,-6,1,1,0,1,OTC
4583,12-02-2021 10:00,24 hrs.,wallstreetbets,GYOG,18,0,18,-18,3,3,0,1,OTC
4583,12-02-2021 10:00,24 hrs.,wallstreetbets,HCMC,563,161,402,-241,90,91,21,82,OTC
4583,12-02-2021 10:00,24 hrs.,wallstreetbets,HEMP,43,0,43,-43,7,7,1,6,OTC
4583,12-02-2021 10:00,24 hrs.,wallstreetbets,HESG,6,0,6,-6,1,1,0,1,OTC
4583,12-02-2021 10:00,24 hrs.,wallstreetbets,HIPH,7,7,0,7,1,1,1,1,OTC
4583,12-02-2021 10:00,24 hrs.,wallstreetbets,HMNY,63,27,36,-9,10,10,3,9,OTC
4583,12-02-2021 10:00,24 hrs.,wallstreetbets,HMPQ,12,0,12,-12,2,2,0,2,OTC
4583,12-02-2021 10:00,24 hrs.,wallstreetbets,HPST,6,0,6,-6,1,1,0,1,OTC
4583,12-02-2021 10:00,24 hrs.,wallstreetbets,HPTY,20,0,20,-20,2,5,2,1,OTC
4583,12-02-2021 10:00,24 hrs.,wallstreetbets,HQGE,7,0,7,-7,1,1,1,1,OTC
4583,12-02-2021 10:00,24 hrs.,wallstreetbets,HYSR,12,6,6,0,2,2,0,2,OTC
4583,12-02-2021 10:00,24 hrs.,wallstreetbets,ICCT,12,0,12,-12,2,2,0,1,OTC
4583,12-02-2021 10:00,24 hrs.,wallstreetbets,IGXT,6,0,6,-6,1,1,0,1,OTC
4583,12-02-2021 10:00,24 hrs.,wallstreetbets,IINX,12,0,12,-12,2,2,0,1,OTC
4583,12-02-2021 10:00,24 hrs.,wallstreetbets,INCT,26,6,20,-14,4,4,2,2,OTC
4583,12-02-2021 10:00,24 hrs.,SPACs,IPOE,3215,142,3073,-2931,6,374,2443,6,NYSE
4583,12-02-2021 10:00,24 hrs.,SPACs,IPOF,172,0,172,-172,1,70,28,1,NYSE
4583,12-02-2021 10:00,24 hrs.,SPACs,LGVW,51,51,0,51,3,13,13,2,NYSE
4583,12-02-2021 10:00,24 hrs.,SPACs,SCPE,136,136,0,136,1,9,114,1,NYSE
4583,12-02-2021 10:00,24 hrs.,SPACs,SCVX,124,0,124,-124,2,42,32,2,NYSE
4583,12-02-2021 10:00,24 hrs.,SPACs,SKLZ,94,94,0,94,1,29,32,1,NYSE
4583,12-02-2021 10:00,24 hrs.,SPACs,SNPR,2408,142,2266,-2124,8,62,2252,7,NYSE
4583,12-02-2021 10:00,24 hrs.,SPACs,SPCE,179,7,172,-165,2,71,29,2,NYSE
4583,12-02-2021 10:00,24 hrs.,SPACs,SPNV,25,0,25,-25,1,7,7,1,NYSE
4583,12-02-2021 10:00,24 hrs.,SPACs,TWND,13,7,6,1,2,2,1,2,NYSE
4583,12-02-2021 10:00,24 hrs.,SPACs,VYGG,2360,136,2224,-2088,2,56,2240,2,NYSE
4583,12-02-2021 10:00,24 hrs.,SPACs,ADV,2360,136,2224,-2088,2,56,2240,2,NASDAQ
4583,12-02-2021 10:00,24 hrs.,SPACs,HOL,2367,143,2224,-2081,3,57,2241,3,NASDAQ
4583,12-02-2021 10:00,24 hrs.,SPACs,NPA,198,0,198,-198,7,63,44,5,NASDAQ
4583,12-02-2021 10:00,24 hrs.,SPACs,ACAC,94,94,0,94,1,29,32,1,NASDAQ
4583,12-02-2021 10:00,24 hrs.,SPACs,ACEV,2536,144,2392,-2248,8,108,2288,6,NASDAQ
4583,12-02-2021 10:00,24 hrs.,SPACs,ACTC,172,0,172,-172,1,70,28,1,NASDAQ
4583,12-02-2021 10:00,24 hrs.,SPACs,ANDA,107,107,0,107,1,23,57,1,NASDAQ
4583,12-02-2021 10:00,24 hrs.,SPACs,ARYA,2360,136,2224,-2088,2,56,2240,2,NASDAQ
4583,12-02-2021 10:00,24 hrs.,SPACs,BRLI,2360,136,2224,-2088,2,56,2240,2,NASDAQ
4583,12-02-2021 10:00,24 hrs.,SPACs,BTWN,96,54,42,12,3,21,42,3,NASDAQ
4583,12-02-2021 10:00,24 hrs.,SPACs,CELH,107,107,0,107,1,23,57,1,NASDAQ
4583,12-02-2021 10:00,24 hrs.,SPACs,CFII,7,0,7,-7,1,1,1,1,NASDAQ
4583,12-02-2021 10:00,24 hrs.,SPACs,CLVR,8,0,8,-8,1,0,4,1,NASDAQ
4583,12-02-2021 10:00,24 hrs.,SPACs,CMLF,2360,136,2224,-2088,2,56,2240,2,NASDAQ
4583,12-02-2021 10:00,24 hrs.,SPACs,CONX,46,0,46,-46,1,9,24,1,NASDAQ
4583,12-02-2021 10:00,24 hrs.,SPACs,DFHT,136,136,0,136,1,9,114,1,NASDAQ
4583,12-02-2021 10:00,24 hrs.,SPACs,DGNS,33,33,0,33,1,5,19,1,NASDAQ
4583,12-02-2021 10:00,24 hrs.,SPACs,EDIT,187,0,187,-187,1,57,69,1,NASDAQ
4583,12-02-2021 10:00,24 hrs.,SPACs,FSRV,2360,136,2224,-2088,2,56,2240,2,NASDAQ
4583,12-02-2021 10:00,24 hrs.,SPACs,FTOC,277,0,277,-277,3,104,57,3,NASDAQ
4583,12-02-2021 10:00,24 hrs.,SPACs,GOEV,14,0,14,-14,1,1,8,1,NASDAQ
4583,12-02-2021 10:00,24 hrs.,SPACs,GRNV,2360,136,2224,-2088,2,56,2240,2,NASDAQ
4583,12-02-2021 10:00,24 hrs.,SPACs,JYAC,231,0,231,-231,1,110,7,1,NASDAQ
4583,12-02-2021 10:00,24 hrs.,SPACs,NBAC,22,0,22,-22,1,7,4,1,NASDAQ
4583,12-02-2021 10:00,24 hrs.,SPACs,NGAC,439,44,395,-351,3,192,43,3,NASDAQ
4583,12-02-2021 10:00,24 hrs.,SPACs,PLUG,6,6,0,6,1,1,0,1,NASDAQ
4583,12-02-2021 10:00,24 hrs.,SPACs,QELL,123,123,0,123,2,19,77,2,NASDAQ
4583,12-02-2021 10:00,24 hrs.,SPACs,RACA,2224,0,2224,-2224,1,47,2126,1,NASDAQ
4583,12-02-2021 10:00,24 hrs.,SPACs,REAL,187,0,187,-187,1,57,69,1,NASDAQ
4583,12-02-2021 10:00,24 hrs.,SPACs,RIDE,6,6,0,6,1,1,0,1,NASDAQ
4583,12-02-2021 10:00,24 hrs.,SPACs,ROCH,136,136,0,136,1,9,114,1,NASDAQ
4583,12-02-2021 10:00,24 hrs.,SPACs,SGAM,111,0,111,-111,3,38,23,2,NASDAQ
4583,12-02-2021 10:00,24 hrs.,SPACs,THBR,2360,136,2224,-2088,2,56,2240,2,NASDAQ
4583,12-02-2021 10:00,24 hrs.,SPACs,THCB,2254,0,2254,-2254,5,51,2132,5,NASDAQ
4583,12-02-2021 10:00,24 hrs.,wallstreetbets,KYNC,7,7,0,7,1,1,1,1,OTC
4583,12-02-2021 10:00,24 hrs.,wallstreetbets,LBSR,15,0,15,-15,2,3,1,2,OTC
4583,12-02-2021 10:00,24 hrs.,wallstreetbets,LBUY,6,0,6,-6,1,1,0,1,OTC
4583,12-02-2021 10:00,24 hrs.,wallstreetbets,LGIQ,6,0,6,-6,1,1,0,1,OTC
4583,12-02-2021 10:00,24 hrs.,wallstreetbets,LINK,622,0,622,-622,1,243,132,1,OTC
4583,12-02-2021 10:00,24 hrs.,wallstreetbets,LOTE,7,7,0,7,1,1,1,1,OTC
4583,12-02-2021 10:00,24 hrs.,wallstreetbets,LQMT,12,0,12,-12,2,2,0,2,OTC
4583,12-02-2021 10:00,24 hrs.,wallstreetbets,LQWC,6,6,0,6,1,1,0,1,OTC
4583,12-02-2021 10:00,24 hrs.,wallstreetbets,LSCG,7,7,0,7,1,1,1,1,OTC
4583,12-02-2021 10:00,24 hrs.,wallstreetbets,LTUM,6,6,0,6,1,1,0,1,OTC
4583,12-02-2021 10:00,24 hrs.,wallstreetbets,LUVU,6,0,6,-6,1,1,0,1,OTC
4583,12-02-2021 10:00,24 hrs.,wallstreetbets,LVVV,12,0,12,-12,2,2,0,2,OTC
4583,12-02-2021 10:00,24 hrs.,wallstreetbets,MATN,6,0,6,-6,1,1,0,1,OTC
4583,12-02-2021 10:00,24 hrs.,wallstreetbets,MCOA,18,0,18,-18,3,3,0,3,OTC
4583,12-02-2021 10:00,24 hrs.,wallstreetbets,MGLG,6,0,6,-6,1,1,0,1,OTC
4583,12-02-2021 10:00,24 hrs.,wallstreetbets,MINE,56,20,36,-16,9,9,2,8,OTC
4583,12-02-2021 10:00,24 hrs.,wallstreetbets,MITI,6,0,6,-6,1,1,0,1,OTC
4583,12-02-2021 10:00,24 hrs.,wallstreetbets,MJLB,6,0,6,-6,1,1,0,1,OTC
4583,12-02-2021 10:00,24 hrs.,wallstreetbets,MJNA,165,21,144,-123,27,27,3,23,OTC
4583,12-02-2021 10:00,24 hrs.,stocks,CAGR,21,21,0,21,1,2,13,1,OTC
4583,12-02-2021 10:00,24 hrs.,stocks,CBDD,6,0,6,-6,1,1,0,1,OTC
4583,12-02-2021 10:00,24 hrs.,stocks,CORG,6,6,0,6,1,1,0,1,OTC
4583,12-02-2021 10:00,24 hrs.,stocks,CYPW,12,0,12,-12,2,2,0,1,OTC
4583,12-02-2021 10:00,24 hrs.,stocks,DIGI,6,6,0,6,1,1,0,1,OTC
4583,12-02-2021 10:00,24 hrs.,stocks,FNMA,6,6,0,6,1,1,0,1,OTC
4583,12-02-2021 10:00,24 hrs.,stocks,HCMC,82,12,70,-58,7,20,14,6,OTC
4583,12-02-2021 10:00,24 hrs.,wallstreetbets,CHGI,12,0,12,-12,2,2,0,1,OTC
4583,12-02-2021 10:00,24 hrs.,wallstreetbets,CHMP,3297,0,3297,-3297,1,1352,589,1,OTC
4583,12-02-2021 10:00,24 hrs.,wallstreetbets,CLIS,6,0,6,-6,1,1,0,1,OTC
4583,12-02-2021 10:00,24 hrs.,wallstreetbets,CLSH,13,7,6,1,2,2,1,2,OTC
4583,12-02-2021 10:00,24 hrs.,wallstreetbets,CNNA,12,0,12,-12,2,2,0,1,OTC
4583,12-02-2021 10:00,24 hrs.,wallstreetbets,CNXS,6,0,6,-6,1,1,0,1,OTC
4583,12-02-2021 10:00,24 hrs.,wallstreetbets,CVSI,6,0,6,-6,1,1,0,1,OTC
4583,12-02-2021 10:00,24 hrs.,wallstreetbets,CYBL,6,0,6,-6,1,1,0,1,OTC
4583,12-02-2021 10:00,24 hrs.,wallstreetbets,CYDY,7,7,0,7,1,1,1,1,OTC
4583,12-02-2021 10:00,24 hrs.,wallstreetbets,CYLC,6,0,6,-6,1,1,0,1,OTC
4583,12-02-2021 10:00,24 hrs.,wallstreetbets,DIGI,14,14,0,14,2,2,2,1,OTC
4583,12-02-2021 10:00,24 hrs.,wallstreetbets,DKAM,6,0,6,-6,1,1,0,1,OTC
4583,12-02-2021 10:00,24 hrs.,wallstreetbets,DROP,2406,0,2406,-2406,1,775,852,1,OTC
4583,12-02-2021 10:00,24 hrs.,wallstreetbets,DTST,12,0,12,-12,2,2,0,1,OTC
4583,12-02-2021 10:00,24 hrs.,wallstreetbets,DWOG,7,7,0,7,1,1,1,1,OTC
4583,12-02-2021 10:00,24 hrs.,wallstreetbets,ECEZ,18,0,18,-18,3,3,0,3,OTC
4583,12-02-2021 10:00,24 hrs.,wallstreetbets,EDXC,18,0,18,-18,3,3,0,2,OTC
4583,12-02-2021 10:00,24 hrs.,wallstreetbets,EFLN,6,0,6,-6,1,1,0,1,OTC
4583,12-02-2021 10:00,24 hrs.,wallstreetbets,ELCR,46,21,25,-4,7,7,4,5,OTC
4583,12-02-2021 10:00,24 hrs.,wallstreetbets,ENDO,6,0,6,-6,1,1,0,1,OTC
4583,12-02-2021 10:00,24 hrs.,wallstreetbets,ERBB,36,0,36,-36,6,6,0,6,OTC
4583,12-02-2021 10:00,24 hrs.,wallstreetbets,ETFM,6,6,0,6,1,1,0,1,OTC
4583,12-02-2021 10:00,24 hrs.,wallstreetbets,EWLL,12,0,12,-12,2,2,0,2,OTC
4583,12-02-2021 10:00,24 hrs.,wallstreetbets,FBEC,6,0,6,-6,1,1,0,1,OTC
4583,12-02-2021 10:00,24 hrs.,wallstreetbets,FBSE,8,8,0,8,1,1,2,1,OTC
4583,12-02-2021 10:00,24 hrs.,wallstreetbets,FORW,6,0,6,-6,1,1,0,1,OTC
4583,12-02-2021 10:00,24 hrs.,wallstreetbets,FPVD,6,0,6,-6,1,1,0,1,OTC
4583,12-02-2021 10:00,24 hrs.,wallstreetbets,FTPM,6,0,6,-6,1,1,0,1,OTC
4583,12-02-2021 10:00,24 hrs.,wallstreetbets,FUTL,6,0,6,-6,1,1,0,1,OTC
4583,12-02-2021 10:00,24 hrs.,wallstreetbets,GARB,7,0,7,-7,1,1,1,1,OTC
4583,12-02-2021 10:00,24 hrs.,wallstreetbets,GAXY,18,0,18,-18,3,3,0,3,OTC
4583,12-02-2021 10:00,24 hrs.,wallstreetbets,GBLX,6,6,0,6,1,1,0,1,OTC
4583,12-02-2021 10:00,24 hrs.,wallstreetbets,GFCI,656,0,656,-656,1,250,152,1,OTC
4583,12-02-2021 10:00,24 hrs.,wallstreetbets,GMER,12,0,12,-12,2,2,0,1,OTC
4583,12-02-2021 10:00,24 hrs.,wallstreetbets,GPFT,15,7,8,-1,2,2,3,2,OTC
4583,12-02-2021 10:00,24 hrs.,wallstreetbets,GRCU,6,0,6,-6,1,1,0,1,OTC
4583,12-02-2021 10:00,24 hrs.,wallstreetbets,GRNH,24,6,18,-12,4,4,0,4,OTC
4583,12-02-2021 10:00,24 hrs.,wallstreetbets,GTBP,6,0,6,-6,1,1,0,1,OTC
4583,12-02-2021 10:00,24 hrs.,stocks,BNY,8,0,8,-8,1,1,2,1,NYSE
4583,12-02-2021 10:00,24 hrs.,stocks,BTT,12,6,6,0,2,2,0,2,NYSE
4583,12-02-2021 10:00,24 hrs.,stocks,BUD,6,0,6,-6,1,1,0,1,NYSE
4583,12-02-2021 10:00,24 hrs.,stocks,BYD,13,0,13,-13,1,4,1,1,NYSE
4583,12-02-2021 10:00,24 hrs.,stocks,CIA,1980,1980,0,1980,1,911,154,1,NYSE
4583,12-02-2021 10:00,24 hrs.,stocks,CRM,549,0,549,-549,1,211,123,1,NYSE
4583,12-02-2021 10:00,24 hrs.,stocks,DCF,549,0,549,-549,1,211,123,1,NYSE
4583,12-02-2021 10:00,24 hrs.,stocks,DDD,40,40,0,40,1,10,16,1,NYSE
4583,12-02-2021 10:00,24 hrs.,stocks,DIS,18023,54,17969,-17915,2,8339,1337,2,NYSE
4583,12-02-2021 10:00,24 hrs.,stocks,DTE,25,0,25,-25,1,3,15,1,NYSE
4583,12-02-2021 10:00,24 hrs.,stocks,ENB,16,16,0,16,1,2,8,1,NYSE
4583,12-02-2021 10:00,24 hrs.,stocks,EOS,12,12,0,12,2,2,0,1,NYSE
4583,12-02-2021 10:00,24 hrs.,stocks,FAF,15,0,15,-15,1,3,5,1,NYSE
4583,12-02-2021 10:00,24 hrs.,stocks,FCF,16,16,0,16,1,2,8,1,NYSE
4583,12-02-2021 10:00,24 hrs.,stocks,FCX,6,6,0,6,1,1,0,1,NYSE
4583,12-02-2021 10:00,24 hrs.,stocks,FSR,20,20,0,20,1,8,0,1,NYSE
4583,12-02-2021 10:00,24 hrs.,stocks,GME,22102,474,21628,-21154,24,9982,2042,22,NYSE
4583,12-02-2021 10:00,24 hrs.,stocks,HRL,112,0,112,-112,1,48,12,1,NYSE
4583,12-02-2021 10:00,24 hrs.,stocks,IBM,1980,1980,0,1980,1,911,154,1,NYSE
4583,12-02-2021 10:00,24 hrs.,stocks,ICE,23,16,7,9,2,3,9,2,NYSE
4583,12-02-2021 10:00,24 hrs.,stocks,IRS,25,25,0,25,1,7,7,1,NYSE
4583,12-02-2021 10:00,24 hrs.,stocks,IVR,6,0,6,-6,1,1,0,1,NYSE
4583,12-02-2021 10:00,24 hrs.,stocks,JNJ,18006,0,18006,-18006,2,8325,1348,2,NYSE
4583,12-02-2021 10:00,24 hrs.,stocks,JPM,8,0,8,-8,1,1,2,1,NYSE
4583,12-02-2021 10:00,24 hrs.,stocks,KEY,54,54,0,54,1,20,10,1,NYSE
4583,12-02-2021 10:00,24 hrs.,stocks,KNL,26,26,0,26,1,8,6,1,NYSE
4583,12-02-2021 10:00,24 hrs.,stocks,LEN,6,6,0,6,1,1,0,1,NYSE
4583,12-02-2021 10:00,24 hrs.,stocks,LMT,6,6,0,6,1,1,0,1,NYSE
4583,12-02-2021 10:00,24 hrs.,stocks,LUV,7,7,0,7,1,1,1,1,NYSE
4583,12-02-2021 10:00,24 hrs.,stocks,MFA,6,6,0,6,1,1,0,1,NYSE
4583,12-02-2021 10:00,24 hrs.,stocks,HEMP,6,6,0,6,1,1,0,1,OTC
4583,12-02-2021 10:00,24 hrs.,stocks,KGKG,6,6,0,6,1,1,0,1,OTC
4583,12-02-2021 10:00,24 hrs.,stocks,KYNC,18,18,0,18,3,3,0,1,OTC
4583,12-02-2021 10:00,24 hrs.,stocks,LINK,112,0,112,-112,1,48,12,1,OTC
4583,12-02-2021 10:00,24 hrs.,stocks,MJNA,18,0,18,-18,3,3,0,3,OTC
4583,12-02-2021 10:00,24 hrs.,stocks,MOST,7,0,7,-7,1,1,1,1,OTC
4583,12-02-2021 10:00,24 hrs.,stocks,NTRR,6,0,6,-6,1,1,0,1,OTC
4583,12-02-2021 10:00,24 hrs.,stocks,NTWN,12,0,12,-12,1,4,0,1,OTC
4583,12-02-2021 10:00,24 hrs.,stocks,OPTI,6,0,6,-6,1,1,0,1,OTC
4583,12-02-2021 10:00,24 hrs.,stocks,PURA,6,0,6,-6,1,1,0,1,OTC
4583,12-02-2021 10:00,24 hrs.,stocks,PZOO,6,6,0,6,1,1,0,1,OTC
4583,12-02-2021 10:00,24 hrs.,stocks,SGMD,36,0,36,-36,6,6,0,2,OTC
4583,12-02-2021 10:00,24 hrs.,stocks,SUIC,6,6,0,6,1,1,0,1,OTC
4583,12-02-2021 10:00,24 hrs.,stocks,TSTS,6,0,6,-6,1,1,0,1,OTC
4583,12-02-2021 10:00,24 hrs.,stocks,TXMC,6,0,6,-6,1,1,0,1,OTC
4583,12-02-2021 10:00,24 hrs.,stocks,TZPC,7,0,7,-7,1,1,1,1,OTC
4583,12-02-2021 10:00,24 hrs.,stocks,USMJ,6,0,6,-6,1,1,0,1,OTC
4583,12-02-2021 10:00,24 hrs.,stocks,USPS,74,0,74,-74,3,26,10,2,OTC
4583,12-02-2021 10:00,24 hrs.,stocks,UVSE,12,0,12,-12,2,2,0,1,OTC
4583,12-02-2021 10:00,24 hrs.,stocks,ZAAG,6,0,6,-6,1,1,0,1,OTC
4583,12-02-2021 10:00,24 hrs.,stocks,CBWTF,12,12,0,12,2,2,0,2,OTC
4583,12-02-2021 10:00,24 hrs.,stocks,CURLF,12,0,12,-12,2,2,0,1,OTC
4583,12-02-2021 10:00,24 hrs.,stocks,FLWPF,6,0,6,-6,1,1,0,1,OTC
4583,12-02-2021 10:00,24 hrs.,stocks,GGTTF,6,0,6,-6,1,1,0,1,OTC
4583,12-02-2021 10:00,24 hrs.,wallstreetbets,INKW,6,0,6,-6,1,1,0,1,OTC
4583,12-02-2021 10:00,24 hrs.,wallstreetbets,INND,13,13,0,13,2,2,1,2,OTC
4583,12-02-2021 10:00,24 hrs.,wallstreetbets,INQD,6,0,6,-6,1,1,0,1,OTC
4583,12-02-2021 10:00,24 hrs.,wallstreetbets,IPKL,6,0,6,-6,1,1,0,1,OTC
4583,12-02-2021 10:00,24 hrs.,wallstreetbets,IQST,18,0,18,-18,3,3,0,3,OTC
4583,12-02-2021 10:00,24 hrs.,wallstreetbets,ISWH,6,0,6,-6,1,1,0,1,OTC
4583,12-02-2021 10:00,24 hrs.,wallstreetbets,KBLB,12,0,12,-12,2,2,0,2,OTC
4583,12-02-2021 10:00,24 hrs.,wallstreetbets,KGET,6,0,6,-6,1,1,0,1,OTC
4583,12-02-2021 10:00,24 hrs.,wallstreetbets,KGKG,7,7,0,7,1,1,1,1,OTC
4583,12-02-2021 10:00,24 hrs.,wallstreetbets,KRFG,7,7,0,7,1,1,1,1,OTC
4583,12-02-2021 10:00,24 hrs.,wallstreetbets,RMO,20,14,6,8,3,3,2,3,NYSE
4583,12-02-2021 10:00,24 hrs.,wallstreetbets,RSI,24,6,18,-12,4,4,0,3,NYSE
4583,12-02-2021 10:00,24 hrs.,wallstreetbets,RTX,7,7,0,7,1,1,1,1,NYSE
4583,12-02-2021 10:00,24 hrs.,wallstreetbets,SBE,18,12,6,6,3,3,0,3,NYSE
4583,12-02-2021 10:00,24 hrs.,wallstreetbets,SBI,7,7,0,7,1,1,1,1,NYSE
4583,12-02-2021 10:00,24 hrs.,wallstreetbets,SCI,481,481,0,481,3,178,113,2,NYSE
4583,12-02-2021 10:00,24 hrs.,wallstreetbets,SCU,6,0,6,-6,1,1,0,1,NYSE
4583,12-02-2021 10:00,24 hrs.,wallstreetbets,SKM,25,25,0,25,1,0,21,1,NYSE
4583,12-02-2021 10:00,24 hrs.,wallstreetbets,SKT,26,14,12,2,4,4,2,3,NYSE
4583,12-02-2021 10:00,24 hrs.,wallstreetbets,SKY,6,0,6,-6,1,1,0,1,NYSE
4583,12-02-2021 10:00,24 hrs.,wallstreetbets,SMG,6,0,6,-6,1,1,0,1,NYSE
4583,12-02-2021 10:00,24 hrs.,wallstreetbets,SNP,6,0,6,-6,1,1,0,1,NYSE
4583,12-02-2021 10:00,24 hrs.,wallstreetbets,SNX,6,6,0,6,1,1,0,1,NYSE
4583,12-02-2021 10:00,24 hrs.,wallstreetbets,SOL,14,14,0,14,2,2,2,2,NYSE
4583,12-02-2021 10:00,24 hrs.,wallstreetbets,SOS,277,130,147,-17,44,43,15,34,NYSE
4583,12-02-2021 10:00,24 hrs.,wallstreetbets,SPG,58,52,6,46,2,1,48,2,NYSE
4583,12-02-2021 10:00,24 hrs.,wallstreetbets,SPH,13,13,0,13,2,2,1,2,NYSE
4583,12-02-2021 10:00,24 hrs.,wallstreetbets,STM,383,0,383,-383,1,136,107,1,NYSE
4583,12-02-2021 10:00,24 hrs.,wallstreetbets,SUN,13,0,13,-13,2,2,1,2,NYSE
4583,12-02-2021 10:00,24 hrs.,wallstreetbets,TAP,634,0,634,-634,3,245,132,3,NYSE
4583,12-02-2021 10:00,24 hrs.,wallstreetbets,TDA,985,985,0,985,3,427,119,3,NYSE
4583,12-02-2021 10:00,24 hrs.,wallstreetbets,TDC,12,0,12,-12,2,2,0,2,NYSE
4583,12-02-2021 10:00,24 hrs.,wallstreetbets,TGT,7,0,7,-7,1,1,1,1,NYSE
4583,12-02-2021 10:00,24 hrs.,wallstreetbets,THC,100,0,100,-100,3,28,32,3,NYSE
4583,12-02-2021 10:00,24 hrs.,wallstreetbets,THR,14,8,6,2,2,2,2,2,NYSE
4583,12-02-2021 10:00,24 hrs.,wallstreetbets,TPB,6,0,6,-6,1,1,0,1,NYSE
4583,12-02-2021 10:00,24 hrs.,wallstreetbets,TPR,6,0,6,-6,1,1,0,1,NYSE
4583,12-02-2021 10:00,24 hrs.,wallstreetbets,TPX,622,0,622,-622,1,243,132,1,NYSE
4583,12-02-2021 10:00,24 hrs.,wallstreetbets,TSE,199,0,199,-199,3,44,99,3,NYSE
4583,12-02-2021 10:00,24 hrs.,wallstreetbets,TSM,2189,12,2177,-2165,10,819,511,7,NYSE
4583,12-02-2021 10:00,24 hrs.,stocks,GLDFF,6,0,6,-6,1,1,0,1,OTC
4583,12-02-2021 10:00,24 hrs.,stocks,GNZUF,32,0,32,-32,1,12,4,1,OTC
4583,12-02-2021 10:00,24 hrs.,stocks,GRUSF,6,0,6,-6,1,1,0,1,OTC
4583,12-02-2021 10:00,24 hrs.,stocks,HITIF,6,0,6,-6,1,1,0,1,OTC
4583,12-02-2021 10:00,24 hrs.,stocks,KONAQ,12,0,12,-12,2,2,0,1,OTC
4583,12-02-2021 10:00,24 hrs.,stocks,LGORF,6,0,6,-6,1,1,0,1,OTC
4583,12-02-2021 10:00,24 hrs.,stocks,MMNFF,12,6,6,0,2,2,0,2,OTC
4583,12-02-2021 10:00,24 hrs.,stocks,PLNHF,67,0,67,-67,2,25,9,1,OTC
4583,12-02-2021 10:00,24 hrs.,stocks,RLLCF,6,6,0,6,1,1,0,1,OTC
4583,12-02-2021 10:00,24 hrs.,stocks,RNECY,6,0,6,-6,1,1,0,1,OTC
4583,12-02-2021 10:00,24 hrs.,stocks,SFTBY,20,0,20,-20,1,6,4,1,OTC
4583,12-02-2021 10:00,24 hrs.,stocks,TAKOF,13,0,13,-13,1,3,3,1,OTC
4583,12-02-2021 10:00,24 hrs.,stocks,TGIFF,6,0,6,-6,1,1,0,1,OTC
4583,12-02-2021 10:00,24 hrs.,stocks,VLNCF,6,0,6,-6,1,1,0,1,OTC
4583,12-02-2021 10:00,24 hrs.,stocks,DNN,37,6,31,-25,3,5,15,3,AMEX
4583,12-02-2021 10:00,24 hrs.,stocks,DPW,12,12,0,12,1,3,2,1,AMEX
4583,12-02-2021 10:00,24 hrs.,stocks,GDP,565,16,549,-533,2,213,131,2,AMEX
4583,12-02-2021 10:00,24 hrs.,stocks,NAK,6,0,6,-6,1,1,0,1,AMEX
4583,12-02-2021 10:00,24 hrs.,stocks,NBA,549,0,549,-549,1,211,123,1,AMEX
4583,12-02-2021 10:00,24 hrs.,stocks,TRX,41,0,41,-41,2,14,5,2,AMEX
4583,12-02-2021 10:00,24 hrs.,stocks,WYY,6,0,6,-6,1,1,0,1,AMEX
4583,12-02-2021 10:00,24 hrs.,stocks,ZOM,31,25,6,19,5,5,1,5,AMEX
4583,12-02-2021 10:00,24 hrs.,stocks,NSPR,6,0,6,-6,1,1,0,1,AMEX
4583,12-02-2021 10:00,24 hrs.,stocks,TRXC,6,0,6,-6,1,1,0,1,AMEX
4583,12-02-2021 10:00,24 hrs.,stocks,UAVS,6,0,6,-6,1,1,0,1,AMEX
4583,12-02-2021 10:00,24 hrs.,stocks,ACB,65,59,6,53,3,16,21,3,NYSE
4583,12-02-2021 10:00,24 hrs.,stocks,AHT,7,0,7,-7,1,1,1,1,NYSE
4583,12-02-2021 10:00,24 hrs.,stocks,AMC,182,122,60,62,13,40,50,11,NYSE
4583,12-02-2021 10:00,24 hrs.,stocks,ASX,6,6,0,6,1,1,0,1,NYSE
4583,12-02-2021 10:00,24 hrs.,stocks,ATH,30,16,14,2,2,5,12,2,NYSE
4583,12-02-2021 10:00,24 hrs.,stocks,AUY,6,0,6,-6,1,1,0,1,NYSE
4583,12-02-2021 10:00,24 hrs.,stocks,BBD,6,0,6,-6,1,1,0,1,NYSE
4583,12-02-2021 10:00,24 hrs.,stocks,BBY,54,0,54,-54,1,14,22,1,NYSE
4583,12-02-2021 10:00,24 hrs.,stocks,BLK,8,0,8,-8,1,1,2,1,NYSE
4583,12-02-2021 10:00,24 hrs.,stocks,WORK,6,6,0,6,1,1,0,1,NYSE
4583,12-02-2021 10:00,24 hrs.,stocks,XPEV,1980,1980,0,1980,1,911,154,1,NYSE
4583,12-02-2021 10:00,24 hrs.,wallstreetbets,UBS,2039,13,2026,-2013,7,821,369,5,NYSE
4583,12-02-2021 10:00,24 hrs.,wallstreetbets,UMC,18,0,18,-18,3,3,0,3,NYSE
4583,12-02-2021 10:00,24 hrs.,wallstreetbets,USB,656,0,656,-656,1,250,152,1,NYSE
4583,12-02-2021 10:00,24 hrs.,wallstreetbets,UTZ,13,0,13,-13,2,2,1,1,NYSE
4583,12-02-2021 10:00,24 hrs.,wallstreetbets,VET,32,14,18,-4,5,5,2,5,NYSE
4583,12-02-2021 10:00,24 hrs.,wallstreetbets,VHC,6,0,6,-6,1,1,0,1,NYSE
4583,12-02-2021 10:00,24 hrs.,wallstreetbets,VST,18,0,18,-18,3,3,0,2,NYSE
4583,12-02-2021 10:00,24 hrs.,wallstreetbets,WFC,6,0,6,-6,1,1,0,1,NYSE
4583,12-02-2021 10:00,24 hrs.,wallstreetbets,WMT,19,7,12,-5,3,3,1,3,NYSE
4583,12-02-2021 10:00,24 hrs.,wallstreetbets,WWE,7,7,0,7,1,1,1,1,NYSE
4583,12-02-2021 10:00,24 hrs.,wallstreetbets,XOM,12,0,12,-12,2,2,0,2,NYSE
4583,12-02-2021 10:00,24 hrs.,wallstreetbets,XPO,622,0,622,-622,1,243,132,1,NYSE
4583,12-02-2021 10:00,24 hrs.,wallstreetbets,ABBV,6,0,6,-6,1,1,0,1,NYSE
4583,12-02-2021 10:00,24 hrs.,wallstreetbets,ACIC,43,7,36,-29,7,7,1,5,NYSE
4583,12-02-2021 10:00,24 hrs.,wallstreetbets,ALUS,6,0,6,-6,1,1,0,1,NYSE
4583,12-02-2021 10:00,24 hrs.,wallstreetbets,AQUA,6,0,6,-6,1,1,0,1,NYSE
4583,12-02-2021 10:00,24 hrs.,wallstreetbets,BABA,12,6,6,0,2,2,0,2,NYSE
4583,12-02-2021 10:00,24 hrs.,wallstreetbets,BEKE,346,0,346,-346,1,102,138,1,NYSE
4583,12-02-2021 10:00,24 hrs.,wallstreetbets,BORR,6,0,6,-6,1,1,0,1,NYSE
4583,12-02-2021 10:00,24 hrs.,wallstreetbets,CCIV,178,160,18,142,26,26,22,22,NYSE
4583,12-02-2021 10:00,24 hrs.,wallstreetbets,CLDR,123,123,0,123,1,34,51,1,NYSE
4583,12-02-2021 10:00,24 hrs.,wallstreetbets,CLII,24,0,24,-24,4,4,0,3,NYSE
4583,12-02-2021 10:00,24 hrs.,wallstreetbets,CODI,6,0,6,-6,1,1,0,1,NYSE
4583,12-02-2021 10:00,24 hrs.,wallstreetbets,CORR,6,0,6,-6,1,1,0,1,NYSE
4583,12-02-2021 10:00,24 hrs.,wallstreetbets,COTY,18,6,12,-6,3,3,0,2,NYSE
4583,12-02-2021 10:00,24 hrs.,wallstreetbets,CSPR,6,0,6,-6,1,1,0,1,NYSE
4583,12-02-2021 10:00,24 hrs.,wallstreetbets,CURO,13,0,13,-13,2,2,1,1,NYSE
4583,12-02-2021 10:00,24 hrs.,wallstreetbets,DASH,509,27,482,-455,4,165,163,3,NYSE
4583,12-02-2021 10:00,24 hrs.,stocks,MGM,17,17,0,17,1,3,7,1,NYSE
4583,12-02-2021 10:00,24 hrs.,stocks,MRK,112,0,112,-112,1,48,12,1,NYSE
4583,12-02-2021 10:00,24 hrs.,stocks,NAT,24,24,0,24,1,5,10,1,NYSE
4583,12-02-2021 10:00,24 hrs.,stocks,NET,326,0,326,-326,1,119,84,1,NYSE
4583,12-02-2021 10:00,24 hrs.,stocks,NIO,37,0,37,-37,1,4,25,1,NYSE
4583,12-02-2021 10:00,24 hrs.,stocks,NKE,17969,0,17969,-17969,1,8321,1323,1,NYSE
4583,12-02-2021 10:00,24 hrs.,stocks,NOK,9,0,9,-9,1,2,1,1,NYSE
4583,12-02-2021 10:00,24 hrs.,wallstreetbets,NAV,346,0,346,-346,1,102,138,1,NYSE
4583,12-02-2021 10:00,24 hrs.,wallstreetbets,NET,18,6,12,-6,3,3,0,3,NYSE
4583,12-02-2021 10:00,24 hrs.,wallstreetbets,NGA,6,6,0,6,1,1,0,1,NYSE
4583,12-02-2021 10:00,24 hrs.,wallstreetbets,NHI,6,0,6,-6,1,1,0,1,NYSE
4583,12-02-2021 10:00,24 hrs.,wallstreetbets,NIO,405,320,85,235,21,73,175,16,NYSE
4583,12-02-2021 10:00,24 hrs.,wallstreetbets,NOC,7,7,0,7,1,1,1,1,NYSE
4583,12-02-2021 10:00,24 hrs.,wallstreetbets,NOK,332,87,245,-158,53,54,12,42,NYSE
4583,12-02-2021 10:00,24 hrs.,wallstreetbets,NVO,66,6,60,-54,7,6,26,4,NYSE
4583,12-02-2021 10:00,24 hrs.,wallstreetbets,NYC,7,7,0,7,1,1,1,1,NYSE
4583,12-02-2021 10:00,24 hrs.,wallstreetbets,OGE,7,7,0,7,1,1,1,1,NYSE
4583,12-02-2021 10:00,24 hrs.,wallstreetbets,OPP,7,7,0,7,1,1,1,1,NYSE
4583,12-02-2021 10:00,24 hrs.,wallstreetbets,OPY,6,0,6,-6,1,1,0,1,NYSE
4583,12-02-2021 10:00,24 hrs.,wallstreetbets,OXY,13,13,0,13,2,2,1,2,NYSE
4583,12-02-2021 10:00,24 hrs.,wallstreetbets,PCG,346,0,346,-346,1,102,138,1,NYSE
4583,12-02-2021 10:00,24 hrs.,wallstreetbets,PDT,13,13,0,13,2,2,1,2,NYSE
4583,12-02-2021 10:00,24 hrs.,wallstreetbets,PEG,225,0,225,-225,1,79,63,1,NYSE
4583,12-02-2021 10:00,24 hrs.,wallstreetbets,PFE,12,6,6,0,2,2,0,2,NYSE
4583,12-02-2021 10:00,24 hrs.,wallstreetbets,PMO,19,7,12,-5,3,3,1,2,NYSE
4583,12-02-2021 10:00,24 hrs.,wallstreetbets,PPL,7,0,7,-7,1,1,1,1,NYSE
4583,12-02-2021 10:00,24 hrs.,wallstreetbets,PSA,1279,7,1272,-1265,5,513,233,5,NYSE
4583,12-02-2021 10:00,24 hrs.,wallstreetbets,PSX,932,932,0,932,1,363,202,1,NYSE
4583,12-02-2021 10:00,24 hrs.,wallstreetbets,QSR,622,0,622,-622,1,243,132,1,NYSE
4583,12-02-2021 10:00,24 hrs.,wallstreetbets,RAD,82,0,82,-82,1,29,20,1,NYSE
4583,12-02-2021 10:00,24 hrs.,wallstreetbets,RCL,200,0,200,-200,1,68,60,1,NYSE
4583,12-02-2021 10:00,24 hrs.,wallstreetbets,RDY,6,6,0,6,1,1,0,1,NYSE
4583,12-02-2021 10:00,24 hrs.,wallstreetbets,RIG,6,0,6,-6,1,1,0,1,NYSE
4583,12-02-2021 10:00,24 hrs.,wallstreetbets,RKT,1162,209,953,-744,20,326,430,16,NYSE
4583,12-02-2021 10:00,24 hrs.,wallstreetbets,DMYD,6,0,6,-6,1,1,0,1,NYSE
4583,12-02-2021 10:00,24 hrs.,wallstreetbets,DNMR,19,0,19,-19,3,3,1,2,NYSE
4583,12-02-2021 10:00,24 hrs.,wallstreetbets,DOOR,6,0,6,-6,1,1,0,1,NYSE
4583,12-02-2021 10:00,24 hrs.,wallstreetbets,ENLC,6,0,6,-6,1,1,0,1,NYSE
4583,12-02-2021 10:00,24 hrs.,wallstreetbets,EXPR,8,0,8,-8,1,2,0,1,NYSE
4583,12-02-2021 10:00,24 hrs.,wallstreetbets,FENG,6,6,0,6,1,1,0,1,NYSE
4583,12-02-2021 10:00,24 hrs.,wallstreetbets,FINV,14,14,0,14,2,2,2,1,NYSE
4583,12-02-2021 10:00,24 hrs.,wallstreetbets,FUBO,20,20,0,20,3,3,2,3,NYSE
4583,12-02-2021 10:00,24 hrs.,wallstreetbets,FUSE,6,0,6,-6,1,1,0,1,NYSE
4583,12-02-2021 10:00,24 hrs.,wallstreetbets,FVRR,14,8,6,2,2,2,2,2,NYSE
4583,12-02-2021 10:00,24 hrs.,wallstreetbets,GNRC,622,0,622,-622,1,243,132,1,NYSE
4583,12-02-2021 10:00,24 hrs.,wallstreetbets,GRUB,6,0,6,-6,1,1,0,1,NYSE
4583,12-02-2021 10:00,24 hrs.,wallstreetbets,HEXO,31,0,31,-31,5,5,1,5,NYSE
4583,12-02-2021 10:00,24 hrs.,wallstreetbets,HUYA,166,15,151,-136,6,60,22,6,NYSE
4583,12-02-2021 10:00,24 hrs.,wallstreetbets,HYLN,2251,113,2138,-2025,65,778,435,57,NYSE
4583,12-02-2021 10:00,24 hrs.,wallstreetbets,IIPR,191,0,191,-191,2,42,99,2,NYSE
4583,12-02-2021 10:00,24 hrs.,wallstreetbets,IPOD,18,0,18,-18,3,3,0,1,NYSE
4583,12-02-2021 10:00,24 hrs.,wallstreetbets,IPOE,60,6,54,-48,10,10,0,8,NYSE
4583,12-02-2021 10:00,24 hrs.,stocks,NSA,1980,1980,0,1980,1,911,154,1,NYSE
4583,12-02-2021 10:00,24 hrs.,stocks,NVS,18,18,0,18,3,3,0,1,NYSE
4583,12-02-2021 10:00,24 hrs.,stocks,PBI,19,0,19,-19,1,6,3,1,NYSE
4583,12-02-2021 10:00,24 hrs.,stocks,PDT,6,6,0,6,1,1,0,1,NYSE
4583,12-02-2021 10:00,24 hrs.,stocks,QSR,112,0,112,-112,1,48,12,1,NYSE
4583,12-02-2021 10:00,24 hrs.,stocks,RKT,66,66,0,66,1,23,16,1,NYSE
4583,12-02-2021 10:00,24 hrs.,stocks,RSI,26,26,0,26,1,8,6,1,NYSE
4583,12-02-2021 10:00,24 hrs.,stocks,SBE,70,64,6,58,6,22,2,4,NYSE
4583,12-02-2021 10:00,24 hrs.,stocks,SIX,10,0,10,-10,1,3,0,1,NYSE
4583,12-02-2021 10:00,24 hrs.,stocks,SOI,13,6,7,-1,2,2,1,2,NYSE
4583,12-02-2021 10:00,24 hrs.,stocks,SOS,18,18,0,18,3,3,0,3,NYSE
4583,12-02-2021 10:00,24 hrs.,stocks,TAP,112,0,112,-112,1,48,12,1,NYSE
4583,12-02-2021 10:00,24 hrs.,stocks,TDA,7,0,7,-7,1,1,1,1,NYSE
4583,12-02-2021 10:00,24 hrs.,stocks,TME,6,0,6,-6,1,1,0,1,NYSE
4583,12-02-2021 10:00,24 hrs.,stocks,TMO,7,7,0,7,1,1,1,1,NYSE
4583,12-02-2021 10:00,24 hrs.,stocks,TPX,112,0,112,-112,1,48,12,1,NYSE
4583,12-02-2021 10:00,24 hrs.,stocks,TSM,42,0,42,-42,1,6,26,1,NYSE
4583,12-02-2021 10:00,24 hrs.,stocks,UMC,6,0,6,-6,1,1,0,1,NYSE
4583,12-02-2021 10:00,24 hrs.,stocks,UPS,62,0,62,-62,1,24,10,1,NYSE
4583,12-02-2021 10:00,24 hrs.,stocks,WMT,18029,0,18029,-18029,4,8329,1355,4,NYSE
4583,12-02-2021 10:00,24 hrs.,stocks,XPO,112,0,112,-112,1,48,12,1,NYSE
4583,12-02-2021 10:00,24 hrs.,stocks,ALSN,26,26,0,26,1,8,6,1,NYSE
4583,12-02-2021 10:00,24 hrs.,stocks,AQUA,7,0,7,-7,1,1,1,1,NYSE
4583,12-02-2021 10:00,24 hrs.,stocks,BABA,115,66,49,17,3,35,33,3,NYSE
4583,12-02-2021 10:00,24 hrs.,stocks,BORR,6,0,6,-6,1,1,0,1,NYSE
4583,12-02-2021 10:00,24 hrs.,stocks,CACI,1980,1980,0,1980,1,911,154,1,NYSE
4583,12-02-2021 10:00,24 hrs.,stocks,CCIV,24,12,12,0,4,4,0,4,NYSE
4583,12-02-2021 10:00,24 hrs.,stocks,FTCH,16,16,0,16,1,3,6,1,NYSE
4583,12-02-2021 10:00,24 hrs.,stocks,FVRR,16,16,0,16,1,3,6,1,NYSE
4583,12-02-2021 10:00,24 hrs.,stocks,GNRC,112,0,112,-112,1,48,12,1,NYSE
4583,12-02-2021 10:00,24 hrs.,stocks,HUYA,38,0,38,-38,1,7,20,1,NYSE
4583,12-02-2021 10:00,24 hrs.,stocks,HYLN,12,0,12,-12,2,2,0,2,NYSE
4583,12-02-2021 10:00,24 hrs.,stocks,IPOD,7,0,7,-7,1,1,1,1,NYSE
4583,12-02-2021 10:00,24 hrs.,stocks,IPOE,13,0,13,-13,2,2,1,2,NYSE
4583,12-02-2021 10:00,24 hrs.,stocks,IPOF,7,0,7,-7,1,1,1,1,NYSE
4583,12-02-2021 10:00,24 hrs.,stocks,MDLY,6,0,6,-6,1,1,0,1,NYSE
4583,12-02-2021 10:00,24 hrs.,stocks,OTIS,26,26,0,26,1,8,6,1,NYSE
4583,12-02-2021 10:00,24 hrs.,stocks,PINS,223,0,223,-223,3,81,49,3,NYSE
4583,12-02-2021 10:00,24 hrs.,stocks,PLTR,17982,6,17976,-17970,3,8323,1324,3,NYSE
4583,12-02-2021 10:00,24 hrs.,stocks,PSTH,6,0,6,-6,1,1,0,1,NYSE
4583,12-02-2021 10:00,24 hrs.,stocks,SKLZ,38,0,38,-38,1,11,12,1,NYSE
4583,12-02-2021 10:00,24 hrs.,stocks,SPCE,24,13,11,2,3,4,4,3,NYSE
4583,12-02-2021 10:00,24 hrs.,stocks,SPOT,6,6,0,6,1,1,0,1,NYSE
4583,12-02-2021 10:00,24 hrs.,stocks,TMHC,6,0,6,-6,1,1,0,1,NYSE
4583,12-02-2021 10:00,24 hrs.,stocks,UBER,127,0,127,-127,2,53,13,2,NYSE
4583,12-02-2021 10:00,24 hrs.,stocks,VOYA,26,26,0,26,1,8,6,1,NYSE
4583,12-02-2021 10:00,24 hrs.,wallstreetbets,AMD,2256,680,1576,-896,27,805,538,26,NASDAQ
4583,12-02-2021 10:00,24 hrs.,wallstreetbets,AQB,12,6,6,0,2,2,0,2,NASDAQ
4583,12-02-2021 10:00,24 hrs.,wallstreetbets,ASO,18,0,18,-18,3,3,0,2,NASDAQ
4583,12-02-2021 10:00,24 hrs.,wallstreetbets,AWH,13,13,0,13,2,2,1,1,NASDAQ
4583,12-02-2021 10:00,24 hrs.,wallstreetbets,AZN,18,0,18,-18,3,3,0,3,NASDAQ
4583,12-02-2021 10:00,24 hrs.,wallstreetbets,BBC,12,0,12,-12,2,2,0,2,NASDAQ
4583,12-02-2021 10:00,24 hrs.,wallstreetbets,BFI,25,7,18,-11,4,4,1,2,NASDAQ
4583,12-02-2021 10:00,24 hrs.,wallstreetbets,CGC,1166,953,213,740,16,387,328,15,NASDAQ
4583,12-02-2021 10:00,24 hrs.,wallstreetbets,DYN,6,0,6,-6,1,1,0,1,NASDAQ
4583,12-02-2021 10:00,24 hrs.,wallstreetbets,ESG,8,8,0,8,1,1,2,1,NASDAQ
4583,12-02-2021 10:00,24 hrs.,wallstreetbets,FLL,18,0,18,-18,3,3,0,2,NASDAQ
4583,12-02-2021 10:00,24 hrs.,wallstreetbets,FWP,6,0,6,-6,1,1,0,1,NASDAQ
4583,12-02-2021 10:00,24 hrs.,wallstreetbets,GBT,6,0,6,-6,1,1,0,1,NASDAQ
4583,12-02-2021 10:00,24 hrs.,wallstreetbets,GSM,6,6,0,6,1,1,0,1,NASDAQ
4583,12-02-2021 10:00,24 hrs.,wallstreetbets,HAS,101,34,67,-33,16,16,5,14,NASDAQ
4583,12-02-2021 10:00,24 hrs.,wallstreetbets,HPK,6,6,0,6,1,1,0,1,NASDAQ
4583,12-02-2021 10:00,24 hrs.,wallstreetbets,III,12,6,6,0,2,2,0,2,NASDAQ
4583,12-02-2021 10:00,24 hrs.,wallstreetbets,INO,264,240,24,216,12,77,62,10,NASDAQ
4583,12-02-2021 10:00,24 hrs.,stocks,YETI,7,7,0,7,1,1,1,1,NYSE
4583,12-02-2021 10:00,24 hrs.,stocks,AAL,43,43,0,43,2,6,23,2,NASDAQ
4583,12-02-2021 10:00,24 hrs.,stocks,AMD,70,14,56,-42,4,7,40,3,NASDAQ
4583,12-02-2021 10:00,24 hrs.,stocks,CGC,18,0,18,-18,3,3,0,3,NASDAQ
4583,12-02-2021 10:00,24 hrs.,stocks,III,549,0,549,-549,1,211,123,1,NASDAQ
4583,12-02-2021 10:00,24 hrs.,stocks,JFU,6,6,0,6,1,1,0,1,NASDAQ
4583,12-02-2021 10:00,24 hrs.,stocks,KHC,143,6,137,-131,3,55,21,3,NASDAQ
4583,12-02-2021 10:00,24 hrs.,stocks,LNT,26,26,0,26,1,8,6,1,NASDAQ
4583,12-02-2021 10:00,24 hrs.,stocks,MIK,6,6,0,6,1,1,0,1,NASDAQ
4583,12-02-2021 10:00,24 hrs.,stocks,NPA,6,6,0,6,1,1,0,1,NASDAQ
4583,12-02-2021 10:00,24 hrs.,stocks,OGI,33,19,14,5,5,5,3,5,NASDAQ
4583,12-02-2021 10:00,24 hrs.,stocks,OLB,6,6,0,6,1,1,0,1,NASDAQ
4583,12-02-2021 10:00,24 hrs.,stocks,PEP,118,0,118,-118,2,48,14,2,NASDAQ
4583,12-02-2021 10:00,24 hrs.,stocks,QQQ,49,0,49,-49,2,7,27,2,NASDAQ
4583,12-02-2021 10:00,24 hrs.,stocks,RXT,6,0,6,-6,1,1,0,1,NASDAQ
4583,12-02-2021 10:00,24 hrs.,stocks,SMH,42,0,42,-42,1,6,26,1,NASDAQ
4583,12-02-2021 10:00,24 hrs.,stocks,UFO,35,0,35,-35,3,9,5,1,NASDAQ
4583,12-02-2021 10:00,24 hrs.,stocks,AAPL,18050,52,17998,-17946,5,8331,1368,4,NASDAQ
4583,12-02-2021 10:00,24 hrs.,stocks,ABIO,6,6,0,6,1,1,0,1,NASDAQ
4583,12-02-2021 10:00,24 hrs.,stocks,ABNB,29,0,29,-29,1,9,7,1,NASDAQ
4583,12-02-2021 10:00,24 hrs.,stocks,AEZS,6,0,6,-6,1,1,0,1,NASDAQ
4583,12-02-2021 10:00,24 hrs.,stocks,AGTC,6,6,0,6,1,1,0,1,NASDAQ
4583,12-02-2021 10:00,24 hrs.,stocks,ALJJ,6,6,0,6,1,1,0,1,NASDAQ
4583,12-02-2021 10:00,24 hrs.,stocks,ALOT,141,141,0,141,1,37,63,1,NASDAQ
4583,12-02-2021 10:00,24 hrs.,stocks,AMCX,6,0,6,-6,1,1,0,1,NASDAQ
4583,12-02-2021 10:00,24 hrs.,stocks,AMZN,17969,0,17969,-17969,1,8321,1323,1,NASDAQ
4583,12-02-2021 10:00,24 hrs.,stocks,APHA,18393,276,18117,-17841,15,8436,1461,14,NASDAQ
4583,12-02-2021 10:00,24 hrs.,stocks,APXT,6,6,0,6,1,1,0,1,NASDAQ
4583,12-02-2021 10:00,24 hrs.,stocks,ASRT,20,0,20,-20,2,6,0,2,NASDAQ
4583,12-02-2021 10:00,24 hrs.,stocks,ATOM,6,0,6,-6,1,1,0,1,NASDAQ
4583,12-02-2021 10:00,24 hrs.,stocks,AVXL,6,0,6,-6,1,1,0,1,NASDAQ
4583,12-02-2021 10:00,24 hrs.,stocks,AXDX,6,0,6,-6,1,1,0,1,NASDAQ
4583,12-02-2021 10:00,24 hrs.,stocks,AZRX,12,12,0,12,1,2,4,1,NASDAQ
4583,12-02-2021 10:00,24 hrs.,stocks,BBIG,6,0,6,-6,1,1,0,1,NASDAQ
4583,12-02-2021 10:00,24 hrs.,stocks,BLDP,6,0,6,-6,1,1,0,1,NASDAQ
4583,12-02-2021 10:00,24 hrs.,stocks,BLNK,37,0,37,-37,1,4,25,1,NASDAQ
4583,12-02-2021 10:00,24 hrs.,stocks,BOXL,7,0,7,-7,1,1,1,1,NASDAQ
4583,12-02-2021 10:00,24 hrs.,stocks,CLEU,7,7,0,7,1,1,1,1,NASDAQ
4583,12-02-2021 10:00,24 hrs.,stocks,CLSK,35,35,0,35,2,8,11,2,NASDAQ
4583,12-02-2021 10:00,24 hrs.,stocks,CLVS,6,6,0,6,1,1,0,1,NASDAQ
4583,12-02-2021 10:00,24 hrs.,stocks,CMPS,12,12,0,12,2,2,0,1,NASDAQ
4583,12-02-2021 10:00,24 hrs.,stocks,CNDT,11,11,0,11,1,2,3,1,NASDAQ
4583,12-02-2021 10:00,24 hrs.,stocks,COST,17985,0,17985,-17985,2,8324,1329,2,NASDAQ
4583,12-02-2021 10:00,24 hrs.,stocks,CREE,6,6,0,6,1,1,0,1,NASDAQ
4583,12-02-2021 10:00,24 hrs.,stocks,CRSR,38,0,38,-38,1,11,12,1,NASDAQ
4583,12-02-2021 10:00,24 hrs.,wallstreetbets,DECK,7,7,0,7,1,1,1,1,NYSE
4583,12-02-2021 10:00,24 hrs.,stocks,SNDL,144,44,100,-56,23,23,6,19,NASDAQ
4583,12-02-2021 10:00,24 hrs.,stocks,SNGX,11,11,0,11,1,3,1,1,NASDAQ
4583,12-02-2021 10:00,24 hrs.,stocks,SONO,112,0,112,-112,1,48,12,1,NASDAQ
4583,12-02-2021 10:00,24 hrs.,stocks,SPRO,21,21,0,21,1,2,13,1,NASDAQ
4583,12-02-2021 10:00,24 hrs.,stocks,SQQQ,7,7,0,7,1,1,1,1,NASDAQ
4583,12-02-2021 10:00,24 hrs.,stocks,SRAC,8,8,0,8,1,2,0,1,NASDAQ
4583,12-02-2021 10:00,24 hrs.,stocks,SSPK,46,46,0,46,1,14,14,1,NASDAQ
4583,12-02-2021 10:00,24 hrs.,stocks,CTRM,50,32,18,14,8,8,2,7,NASDAQ
4583,12-02-2021 10:00,24 hrs.,stocks,CXDC,6,0,6,-6,1,1,0,1,NASDAQ
4583,12-02-2021 10:00,24 hrs.,stocks,DFFN,11,11,0,11,1,3,1,1,NASDAQ
4583,12-02-2021 10:00,24 hrs.,stocks,DMTK,21,21,0,21,1,2,13,1,NASDAQ
4583,12-02-2021 10:00,24 hrs.,stocks,DOMO,19,0,19,-19,1,6,3,1,NASDAQ
4583,12-02-2021 10:00,24 hrs.,stocks,DOYU,7,0,7,-7,1,1,1,1,NASDAQ
4583,12-02-2021 10:00,24 hrs.,stocks,EKSO,6,0,6,-6,1,1,0,1,NASDAQ
4583,12-02-2021 10:00,24 hrs.,stocks,ENTX,7,7,0,7,1,1,1,1,NASDAQ
4583,12-02-2021 10:00,24 hrs.,stocks,EOLS,6,0,6,-6,1,1,0,1,NASDAQ
4583,12-02-2021 10:00,24 hrs.,stocks,ETSY,16,16,0,16,1,3,6,1,NASDAQ
4583,12-02-2021 10:00,24 hrs.,wallstreetbets,IPA,13,7,6,1,2,2,1,2,NASDAQ
4583,12-02-2021 10:00,24 hrs.,wallstreetbets,IPOF,18,0,18,-18,3,3,0,1,NYSE
4583,12-02-2021 10:00,24 hrs.,wallstreetbets,JMIA,12,0,12,-12,2,2,0,2,NYSE
4583,12-02-2021 10:00,24 hrs.,wallstreetbets,KODK,19,0,19,-19,3,3,1,2,NYSE
4583,12-02-2021 10:00,24 hrs.,wallstreetbets,LDOS,6,0,6,-6,1,1,0,1,NYSE
4583,12-02-2021 10:00,24 hrs.,wallstreetbets,LEAP,12,0,12,-12,2,2,0,2,NYSE
4583,12-02-2021 10:00,24 hrs.,wallstreetbets,LGVW,34,34,0,34,5,5,4,4,NYSE
4583,12-02-2021 10:00,24 hrs.,wallstreetbets,LMND,12,6,6,0,2,2,0,2,NYSE
4583,12-02-2021 10:00,24 hrs.,wallstreetbets,LSPD,7,7,0,7,1,1,1,1,NYSE
4583,12-02-2021 10:00,24 hrs.,wallstreetbets,LUMN,46,0,46,-46,4,3,24,4,NYSE
4583,12-02-2021 10:00,24 hrs.,wallstreetbets,MAIN,14,14,0,14,2,2,2,2,NYSE
4583,12-02-2021 10:00,24 hrs.,wallstreetbets,MAXR,6,0,6,-6,1,1,0,1,NYSE
4583,12-02-2021 10:00,24 hrs.,wallstreetbets,MDLY,19,0,19,-19,3,3,1,1,NYSE
4583,12-02-2021 10:00,24 hrs.,wallstreetbets,NVTA,12,0,12,-12,2,2,0,1,NYSE
4583,12-02-2021 10:00,24 hrs.,wallstreetbets,ORAN,6,0,6,-6,1,1,0,1,NYSE
4583,12-02-2021 10:00,24 hrs.,wallstreetbets,PGRE,6,0,6,-6,1,1,0,1,NYSE
4583,12-02-2021 10:00,24 hrs.,wallstreetbets,PINS,642,7,635,-628,4,246,134,4,NYSE
4583,12-02-2021 10:00,24 hrs.,wallstreetbets,PLNT,6,0,6,-6,1,1,0,1,NYSE
4583,12-02-2021 10:00,24 hrs.,wallstreetbets,PLTR,1268,189,1079,-890,46,399,286,31,NYSE
4583,12-02-2021 10:00,24 hrs.,wallstreetbets,PRTY,6,0,6,-6,1,1,0,1,NYSE
4583,12-02-2021 10:00,24 hrs.,wallstreetbets,PSXP,12,0,12,-12,2,2,0,2,NYSE
4583,12-02-2021 10:00,24 hrs.,wallstreetbets,PUMP,6,0,6,-6,1,1,0,1,NYSE
4583,12-02-2021 10:00,24 hrs.,wallstreetbets,QUAD,8,8,0,8,1,1,2,1,NYSE
4583,12-02-2021 10:00,24 hrs.,wallstreetbets,SCVX,6,6,0,6,1,1,0,1,NYSE
4583,12-02-2021 10:00,24 hrs.,wallstreetbets,SHAK,18,0,18,-18,3,3,0,1,NYSE
4583,12-02-2021 10:00,24 hrs.,wallstreetbets,SHOP,920,7,913,-906,5,384,132,3,NYSE
4583,12-02-2021 10:00,24 hrs.,wallstreetbets,SLCA,6,0,6,-6,1,1,0,1,NYSE
4583,12-02-2021 10:00,24 hrs.,wallstreetbets,SNOW,6,0,6,-6,1,1,0,1,NYSE
4583,12-02-2021 10:00,24 hrs.,wallstreetbets,SNPR,6,0,6,-6,1,1,0,1,NYSE
4583,12-02-2021 10:00,24 hrs.,wallstreetbets,SPCE,2887,405,2482,-2077,33,1139,477,29,NYSE
4583,12-02-2021 10:00,24 hrs.,wallstreetbets,SPOT,7,7,0,7,1,1,1,1,NYSE
4583,12-02-2021 10:00,24 hrs.,wallstreetbets,STNG,6,0,6,-6,1,1,0,1,NYSE
4583,12-02-2021 10:00,24 hrs.,wallstreetbets,STPK,12,0,12,-12,2,2,0,2,NYSE
4583,12-02-2021 10:00,24 hrs.,wallstreetbets,TDOC,6,6,0,6,1,1,0,1,NYSE
4583,12-02-2021 10:00,24 hrs.,wallstreetbets,TEVA,12,0,12,-12,2,2,0,2,NYSE
4583,12-02-2021 10:00,24 hrs.,wallstreetbets,TWTR,6,0,6,-6,1,1,0,1,NYSE
4583,12-02-2021 10:00,24 hrs.,wallstreetbets,UBER,667,33,634,-601,8,250,135,5,NYSE
4583,12-02-2021 10:00,24 hrs.,wallstreetbets,UNVR,6,0,6,-6,1,1,0,1,NYSE
4583,12-02-2021 10:00,24 hrs.,wallstreetbets,VSTO,8,0,8,-8,1,1,2,1,NYSE
4583,12-02-2021 10:00,24 hrs.,wallstreetbets,WELL,306,0,306,-306,1,114,74,1,NYSE
4583,12-02-2021 10:00,24 hrs.,wallstreetbets,WORK,14,14,0,14,2,2,2,2,NYSE
4583,12-02-2021 10:00,24 hrs.,wallstreetbets,XPEV,13,7,6,1,2,2,1,2,NYSE
4583,12-02-2021 10:00,24 hrs.,wallstreetbets,YALA,6,0,6,-6,1,1,0,1,NYSE
4583,12-02-2021 10:00,24 hrs.,wallstreetbets,YETI,12,0,12,-12,2,2,0,1,NYSE
4583,12-02-2021 10:00,24 hrs.,wallstreetbets,AAL,81,21,60,-39,13,13,3,6,NASDAQ
4583,12-02-2021 10:00,24 hrs.,wallstreetbets,ADI,383,0,383,-383,1,136,107,1,NASDAQ
4583,12-02-2021 10:00,24 hrs.,wallstreetbets,ADV,6,0,6,-6,1,1,0,1,NASDAQ
4583,12-02-2021 10:00,24 hrs.,wallstreetbets,RBNW,13,7,6,1,2,2,1,2,OTC
4583,12-02-2021 10:00,24 hrs.,wallstreetbets,REFG,12,0,12,-12,2,2,0,1,OTC
4583,12-02-2021 10:00,24 hrs.,wallstreetbets,RIGH,7,7,0,7,1,1,1,1,OTC
4583,12-02-2021 10:00,24 hrs.,wallstreetbets,RITE,6,0,6,-6,1,1,0,1,OTC
4583,12-02-2021 10:00,24 hrs.,wallstreetbets,RKLC,6,0,6,-6,1,1,0,1,OTC
4583,12-02-2021 10:00,24 hrs.,wallstreetbets,RLTR,18,0,18,-18,3,3,0,3,OTC
4583,12-02-2021 10:00,24 hrs.,wallstreetbets,RSHN,7,7,0,7,1,1,1,1,OTC
4583,12-02-2021 10:00,24 hrs.,stocks,EVFM,18,18,0,18,2,5,0,1,NASDAQ
4583,12-02-2021 10:00,24 hrs.,stocks,EXAS,21,21,0,21,1,2,13,1,NASDAQ
4583,12-02-2021 10:00,24 hrs.,stocks,EXPI,6,0,6,-6,1,1,0,1,NASDAQ
4583,12-02-2021 10:00,24 hrs.,stocks,FLXN,26,26,0,26,1,8,6,1,NASDAQ
4583,12-02-2021 10:00,24 hrs.,stocks,FROG,6,0,6,-6,1,1,0,1,NASDAQ
4583,12-02-2021 10:00,24 hrs.,stocks,FSRV,6,6,0,6,1,1,0,1,NASDAQ
4583,12-02-2021 10:00,24 hrs.,stocks,GEVO,12,0,12,-12,2,2,0,1,NASDAQ
4583,12-02-2021 10:00,24 hrs.,stocks,GILT,45,0,45,-45,2,12,13,2,NASDAQ
4583,12-02-2021 10:00,24 hrs.,stocks,GLBS,6,0,6,-6,1,1,0,1,NASDAQ
4583,12-02-2021 10:00,24 hrs.,stocks,GLUU,18,0,18,-18,1,5,4,1,NASDAQ
4583,12-02-2021 10:00,24 hrs.,stocks,GNUS,6,6,0,6,1,1,0,1,NASDAQ
4583,12-02-2021 10:00,24 hrs.,stocks,GOEV,6,0,6,-6,1,1,0,1,NASDAQ
4583,12-02-2021 10:00,24 hrs.,stocks,GOOG,15,0,15,-15,1,0,11,1,NASDAQ
4583,12-02-2021 10:00,24 hrs.,stocks,GRWG,6,0,6,-6,1,1,0,1,NASDAQ
4583,12-02-2021 10:00,24 hrs.,stocks,GTEC,6,0,6,-6,1,1,0,1,NASDAQ
4583,12-02-2021 10:00,24 hrs.,stocks,GTHX,6,6,0,6,1,1,0,1,NASDAQ
4583,12-02-2021 10:00,24 hrs.,stocks,HTBX,6,6,0,6,1,1,0,1,NASDAQ
4583,12-02-2021 10:00,24 hrs.,stocks,ICPT,17,0,17,-17,1,4,5,1,NASDAQ
4583,12-02-2021 10:00,24 hrs.,stocks,IFMK,6,0,6,-6,1,1,0,1,NASDAQ
4583,12-02-2021 10:00,24 hrs.,stocks,INPX,18,18,0,18,3,3,0,1,NASDAQ
4583,12-02-2021 10:00,24 hrs.,stocks,INTC,42,0,42,-42,1,6,26,1,NASDAQ
4583,12-02-2021 10:00,24 hrs.,stocks,IRBT,112,0,112,-112,1,48,12,1,NASDAQ
4583,12-02-2021 10:00,24 hrs.,stocks,KLIC,6,0,6,-6,1,1,0,1,NASDAQ
4583,12-02-2021 10:00,24 hrs.,stocks,KPTI,26,26,0,26,1,8,6,1,NASDAQ
4583,12-02-2021 10:00,24 hrs.,stocks,LIVE,126,0,126,-126,3,50,14,2,NASDAQ
4583,12-02-2021 10:00,24 hrs.,stocks,LPTH,6,0,6,-6,1,1,0,1,NASDAQ
4583,12-02-2021 10:00,24 hrs.,stocks,MBRX,6,0,6,-6,1,1,0,1,NASDAQ
4583,12-02-2021 10:00,24 hrs.,stocks,MELI,42,0,42,-42,1,6,26,1,NASDAQ
4583,12-02-2021 10:00,24 hrs.,stocks,MGNI,52,52,0,52,1,8,32,1,NASDAQ
4583,12-02-2021 10:00,24 hrs.,stocks,MNPR,6,6,0,6,1,1,0,1,NASDAQ
4583,12-02-2021 10:00,24 hrs.,stocks,MSFT,18149,68,18081,-18013,4,8380,1373,4,NASDAQ
4583,12-02-2021 10:00,24 hrs.,stocks,MSTR,6,6,0,6,1,1,0,1,NASDAQ
4583,12-02-2021 10:00,24 hrs.,stocks,MTCH,258,0,258,-258,1,54,146,1,NASDAQ
4583,12-02-2021 10:00,24 hrs.,stocks,MVIS,12,0,12,-12,2,2,0,2,NASDAQ
4583,12-02-2021 10:00,24 hrs.,stocks,NAKD,43,0,43,-43,6,6,7,6,NASDAQ
4583,12-02-2021 10:00,24 hrs.,stocks,NTLA,14,0,14,-14,1,3,4,1,NASDAQ
4583,12-02-2021 10:00,24 hrs.,stocks,NTRS,8,0,8,-8,1,1,2,1,NASDAQ
4583,12-02-2021 10:00,24 hrs.,stocks,NVCN,34,0,34,-34,1,10,10,1,NASDAQ
4583,12-02-2021 10:00,24 hrs.,stocks,NVDA,18074,68,18006,-17938,4,8336,1386,4,NASDAQ
4583,12-02-2021 10:00,24 hrs.,stocks,NYMT,6,6,0,6,1,1,0,1,NASDAQ
4583,12-02-2021 10:00,24 hrs.,stocks,OCGN,6,0,6,-6,1,1,0,1,NASDAQ
4583,12-02-2021 10:00,24 hrs.,stocks,OPRX,21,21,0,21,1,2,13,1,NASDAQ
4583,12-02-2021 10:00,24 hrs.,stocks,OPTT,7,0,7,-7,1,1,1,1,NASDAQ
4583,12-02-2021 10:00,24 hrs.,stocks,PAAS,6,0,6,-6,1,1,0,1,NASDAQ
4583,12-02-2021 10:00,24 hrs.,stocks,PENN,7,7,0,7,1,1,1,1,NASDAQ
4583,12-02-2021 10:00,24 hrs.,stocks,PGNY,21,21,0,21,1,2,13,1,NASDAQ
4583,12-02-2021 10:00,24 hrs.,stocks,PLAY,7,0,7,-7,1,1,1,1,NASDAQ
4583,12-02-2021 10:00,24 hrs.,stocks,POWW,197,0,197,-197,2,70,49,2,NASDAQ
4583,12-02-2021 10:00,24 hrs.,stocks,PYPL,431,423,8,415,2,172,79,2,NASDAQ
4583,12-02-2021 10:00,24 hrs.,stocks,QCOM,21,14,7,7,3,3,3,2,NASDAQ
4583,12-02-2021 10:00,24 hrs.,stocks,QQQM,63,21,42,-21,2,10,35,2,NASDAQ
4583,12-02-2021 10:00,24 hrs.,stocks,RDFN,14,0,14,-14,1,3,4,1,NASDAQ
4583,12-02-2021 10:00,24 hrs.,stocks,RGEN,21,21,0,21,1,2,13,1,NASDAQ
4583,12-02-2021 10:00,24 hrs.,stocks,RIDE,61,0,61,-61,1,21,15,1,NASDAQ
4583,12-02-2021 10:00,24 hrs.,stocks,RIOT,6,6,0,6,1,1,0,1,NASDAQ
4583,12-02-2021 10:00,24 hrs.,stocks,SABR,7,7,0,7,1,1,1,1,NASDAQ
4583,12-02-2021 10:00,24 hrs.,stocks,SEEL,18,18,0,18,3,3,0,2,NASDAQ
4583,12-02-2021 10:00,24 hrs.,wallstreetbets,USMJ,18,0,18,-18,3,3,0,3,OTC
4583,12-02-2021 10:00,24 hrs.,wallstreetbets,USPS,98,0,98,-98,3,27,32,2,OTC
4583,12-02-2021 10:00,24 hrs.,wallstreetbets,UVSE,18,0,18,-18,3,3,0,3,OTC
4583,12-02-2021 10:00,24 hrs.,wallstreetbets,VBIO,6,0,6,-6,1,1,0,1,OTC
4583,12-02-2021 10:00,24 hrs.,wallstreetbets,VIBI,12,0,12,-12,2,2,0,2,OTC
4583,12-02-2021 10:00,24 hrs.,wallstreetbets,VPOR,12,0,12,-12,2,2,0,2,OTC
4583,12-02-2021 10:00,24 hrs.,wallstreetbets,VTLR,6,0,6,-6,1,1,0,1,OTC
4583,12-02-2021 10:00,24 hrs.,stocks,SSYS,40,40,0,40,1,10,16,1,NASDAQ
4583,12-02-2021 10:00,24 hrs.,stocks,SWAV,21,21,0,21,1,2,13,1,NASDAQ
4583,12-02-2021 10:00,24 hrs.,stocks,SWBI,7,0,7,-7,1,1,1,1,NASDAQ
4583,12-02-2021 10:00,24 hrs.,stocks,TLRY,355,281,74,207,14,111,77,13,NASDAQ
4583,12-02-2021 10:00,24 hrs.,stocks,TMDX,21,21,0,21,1,2,13,1,NASDAQ
4583,12-02-2021 10:00,24 hrs.,stocks,TNXP,25,6,19,-13,4,4,1,3,NASDAQ
4583,12-02-2021 10:00,24 hrs.,stocks,TOPS,7,0,7,-7,1,1,1,1,NASDAQ
4583,12-02-2021 10:00,24 hrs.,stocks,TRVN,6,0,6,-6,1,1,0,1,NASDAQ
4583,12-02-2021 10:00,24 hrs.,stocks,TSLA,132,83,49,34,6,13,82,5,NASDAQ
4583,12-02-2021 10:00,24 hrs.,stocks,TTWO,6,0,6,-6,1,1,0,1,NASDAQ
4583,12-02-2021 10:00,24 hrs.,stocks,TWOU,25,0,25,-25,2,6,5,1,NASDAQ
4583,12-02-2021 10:00,24 hrs.,stocks,TXMD,12,0,12,-12,2,2,0,2,NASDAQ
4583,12-02-2021 10:00,24 hrs.,stocks,VCEL,21,21,0,21,1,2,13,1,NASDAQ
4583,12-02-2021 10:00,24 hrs.,stocks,VECO,6,6,0,6,1,1,0,1,NASDAQ
4583,12-02-2021 10:00,24 hrs.,stocks,VUZI,38,0,38,-38,1,10,14,1,NASDAQ
4583,12-02-2021 10:00,24 hrs.,stocks,VXRT,12,6,6,0,2,2,0,2,NASDAQ
4583,12-02-2021 10:00,24 hrs.,stocks,VXUS,30,0,30,-30,1,8,10,1,NASDAQ
4583,12-02-2021 10:00,24 hrs.,stocks,XCUR,6,6,0,6,1,1,0,1,NASDAQ
4583,12-02-2021 10:00,24 hrs.,wallstreetbets,MMEX,59,35,24,11,9,9,5,6,OTC
4583,12-02-2021 10:00,24 hrs.,wallstreetbets,MMMM,6,0,6,-6,1,1,0,1,OTC
4583,12-02-2021 10:00,24 hrs.,wallstreetbets,MOST,12,0,12,-12,2,2,0,2,OTC
4583,12-02-2021 10:00,24 hrs.,wallstreetbets,MRMD,6,0,6,-6,1,1,0,1,OTC
4583,12-02-2021 10:00,24 hrs.,wallstreetbets,MSRT,6,0,6,-6,1,1,0,1,OTC
4583,12-02-2021 10:00,24 hrs.,wallstreetbets,MTVX,15,15,0,15,2,3,1,2,OTC
4583,12-02-2021 10:00,24 hrs.,wallstreetbets,MYDX,12,0,12,-12,2,2,0,2,OTC
4583,12-02-2021 10:00,24 hrs.,wallstreetbets,NPHC,6,0,6,-6,1,1,0,1,OTC
4583,12-02-2021 10:00,24 hrs.,wallstreetbets,NPTX,14,14,0,14,2,2,2,1,OTC
4583,12-02-2021 10:00,24 hrs.,wallstreetbets,NSPX,6,0,6,-6,1,1,0,1,OTC
4583,12-02-2021 10:00,24 hrs.,wallstreetbets,NUGS,17,0,17,-17,1,6,1,1,OTC
4583,12-02-2021 10:00,24 hrs.,wallstreetbets,NUKK,12,0,12,-12,2,2,0,2,OTC
4583,12-02-2021 10:00,24 hrs.,wallstreetbets,NWPN,19,0,19,-19,3,3,1,2,OTC
4583,12-02-2021 10:00,24 hrs.,wallstreetbets,OPMZ,6,0,6,-6,1,1,0,1,OTC
4583,12-02-2021 10:00,24 hrs.,wallstreetbets,OWCP,12,0,12,-12,2,2,0,2,OTC
4583,12-02-2021 10:00,24 hrs.,wallstreetbets,OZSC,12,0,12,-12,2,2,0,2,OTC
4583,12-02-2021 10:00,24 hrs.,wallstreetbets,PAOG,12,0,12,-12,2,2,0,2,OTC
4583,12-02-2021 10:00,24 hrs.,wallstreetbets,PAPA,6,0,6,-6,1,1,0,1,OTC
4583,12-02-2021 10:00,24 hrs.,wallstreetbets,PASO,6,0,6,-6,1,1,0,1,OTC
4583,12-02-2021 10:00,24 hrs.,wallstreetbets,PDMI,7,7,0,7,1,1,1,1,OTC
4583,12-02-2021 10:00,24 hrs.,wallstreetbets,PERL,6,0,6,-6,1,1,0,1,OTC
4583,12-02-2021 10:00,24 hrs.,wallstreetbets,PFNO,6,0,6,-6,1,1,0,1,OTC
4583,12-02-2021 10:00,24 hrs.,wallstreetbets,PGIE,6,0,6,-6,1,1,0,1,OTC
4583,12-02-2021 10:00,24 hrs.,wallstreetbets,PHIL,6,0,6,-6,1,1,0,1,OTC
4583,12-02-2021 10:00,24 hrs.,wallstreetbets,PHOT,18,0,18,-18,3,3,0,1,OTC
4583,12-02-2021 10:00,24 hrs.,wallstreetbets,PNPL,19,13,6,7,3,3,1,2,OTC
4583,12-02-2021 10:00,24 hrs.,wallstreetbets,POTN,6,0,6,-6,1,1,0,1,OTC
4583,12-02-2021 10:00,24 hrs.,wallstreetbets,PPJE,6,0,6,-6,1,1,0,1,OTC
4583,12-02-2021 10:00,24 hrs.,wallstreetbets,PRDL,6,0,6,-6,1,1,0,1,OTC
4583,12-02-2021 10:00,24 hrs.,wallstreetbets,PRED,7,7,0,7,1,1,1,1,OTC
4583,12-02-2021 10:00,24 hrs.,wallstreetbets,PSYC,30,0,30,-30,5,5,0,3,OTC
4583,12-02-2021 10:00,24 hrs.,wallstreetbets,PTOI,12,0,12,-12,2,2,0,1,OTC
4583,12-02-2021 10:00,24 hrs.,wallstreetbets,PURA,36,0,36,-36,6,6,0,4,OTC
4583,12-02-2021 10:00,24 hrs.,wallstreetbets,PURE,7,7,0,7,1,1,1,1,OTC
4583,12-02-2021 10:00,24 hrs.,wallstreetbets,PVDG,6,0,6,-6,1,1,0,1,OTC
4583,12-02-2021 10:00,24 hrs.,wallstreetbets,PYYX,6,0,6,-6,1,1,0,1,OTC
4583,12-02-2021 10:00,24 hrs.,wallstreetbets,PZOO,6,0,6,-6,1,1,0,1,OTC
4583,12-02-2021 10:00,24 hrs.,wallstreetbets,QEDN,6,0,6,-6,1,1,0,1,OTC
4583,12-02-2021 10:00,24 hrs.,wallstreetbets,QTMM,6,0,6,-6,1,1,0,1,OTC
4583,12-02-2021 10:00,24 hrs.,Daytrading,HCMC,27,27,0,27,1,9,5,1,OTC
4583,12-02-2021 10:00,24 hrs.,Daytrading,HMPQ,14,0,14,-14,1,3,4,1,OTC
4583,12-02-2021 10:00,24 hrs.,Daytrading,IDEA,6,6,0,6,1,1,0,1,OTC
4583,12-02-2021 10:00,24 hrs.,Daytrading,INKW,15,8,7,1,2,3,1,2,OTC
4583,12-02-2021 10:00,24 hrs.,Daytrading,LVVV,27,27,0,27,1,9,5,1,OTC
4583,12-02-2021 10:00,24 hrs.,Daytrading,MJNA,6,0,6,-6,1,1,0,1,OTC
4583,12-02-2021 10:00,24 hrs.,Daytrading,OWCP,6,0,6,-6,1,1,0,1,OTC
4583,12-02-2021 10:00,24 hrs.,Daytrading,RLTR,6,6,0,6,1,1,0,1,OTC
4583,12-02-2021 10:00,24 hrs.,Daytrading,TSTS,33,27,6,21,2,10,5,2,OTC
4583,12-02-2021 10:00,24 hrs.,Daytrading,MNKKQ,6,6,0,6,1,1,0,1,OTC
4583,12-02-2021 10:00,24 hrs.,Daytrading,IGC,723,0,723,-723,1,295,129,1,AMEX
4583,12-02-2021 10:00,24 hrs.,Daytrading,TRX,6,6,0,6,1,1,0,1,AMEX
4583,12-02-2021 10:00,24 hrs.,Daytrading,ZOM,6,0,6,-6,1,1,0,1,AMEX
4583,12-02-2021 10:00,24 hrs.,Daytrading,TMBR,723,0,723,-723,1,295,129,1,AMEX
4583,12-02-2021 10:00,24 hrs.,Daytrading,TRXC,6,6,0,6,1,1,0,1,AMEX
4583,12-02-2021 10:00,24 hrs.,Daytrading,AMC,6,6,0,6,1,1,0,1,NYSE
4583,12-02-2021 10:00,24 hrs.,Daytrading,ATH,783,0,783,-783,2,319,137,2,NYSE
4583,12-02-2021 10:00,24 hrs.,Daytrading,BFT,14,14,0,14,1,4,2,1,NYSE
4583,12-02-2021 10:00,24 hrs.,Daytrading,FSD,6,0,6,-6,1,1,0,1,NYSE
4583,12-02-2021 10:00,24 hrs.,Daytrading,FSR,60,0,60,-60,1,24,8,1,NYSE
4583,12-02-2021 10:00,24 hrs.,Daytrading,GME,6,6,0,6,1,1,0,1,NYSE
4583,12-02-2021 10:00,24 hrs.,Daytrading,MSM,19,0,19,-19,1,5,5,1,NYSE
4583,12-02-2021 10:00,24 hrs.,Daytrading,NOK,14,14,0,14,1,0,10,1,NYSE
4583,12-02-2021 10:00,24 hrs.,Daytrading,PDT,9,0,9,-9,1,2,1,1,NYSE
4583,12-02-2021 10:00,24 hrs.,Daytrading,SCI,6,6,0,6,1,1,0,1,NYSE
4583,12-02-2021 10:00,24 hrs.,Daytrading,TDA,15,0,15,-15,1,5,1,1,NYSE
4583,12-02-2021 10:00,24 hrs.,Daytrading,TSM,60,0,60,-60,1,24,8,1,NYSE
4583,12-02-2021 10:00,24 hrs.,Daytrading,WMT,6,0,6,-6,1,1,0,1,NYSE
4583,12-02-2021 10:00,24 hrs.,Daytrading,SPCE,7,7,0,7,1,1,1,1,NYSE
4583,12-02-2021 10:00,24 hrs.,Daytrading,AMD,70,10,60,-50,2,24,14,2,NASDAQ
4583,12-02-2021 10:00,24 hrs.,Daytrading,CGC,723,0,723,-723,1,295,129,1,NASDAQ
4583,12-02-2021 10:00,24 hrs.,wallstreetbets,RTON,32,13,19,-6,5,5,2,5,OTC
4583,12-02-2021 10:00,24 hrs.,wallstreetbets,RWMI,6,0,6,-6,1,1,0,1,OTC
4583,12-02-2021 10:00,24 hrs.,wallstreetbets,SANP,18,0,18,-18,3,3,0,3,OTC
4583,12-02-2021 10:00,24 hrs.,wallstreetbets,SCNA,14,0,14,-14,2,3,0,2,OTC
4583,12-02-2021 10:00,24 hrs.,wallstreetbets,SFOR,14,14,0,14,2,2,2,1,OTC
4583,12-02-2021 10:00,24 hrs.,wallstreetbets,SGLN,6,0,6,-6,1,1,0,1,OTC
4583,12-02-2021 10:00,24 hrs.,wallstreetbets,SGMD,85,19,66,-47,14,14,1,11,OTC
4583,12-02-2021 10:00,24 hrs.,wallstreetbets,SHMP,25,13,12,1,4,4,1,3,OTC
4583,12-02-2021 10:00,24 hrs.,wallstreetbets,SHRG,6,0,6,-6,1,1,0,1,OTC
4583,12-02-2021 10:00,24 hrs.,wallstreetbets,SHWZ,6,0,6,-6,1,1,0,1,OTC
4583,12-02-2021 10:00,24 hrs.,wallstreetbets,SIGN,25,13,12,1,4,4,1,4,OTC
4583,12-02-2021 10:00,24 hrs.,wallstreetbets,SING,19,0,19,-19,3,3,1,3,OTC
4583,12-02-2021 10:00,24 hrs.,wallstreetbets,SIRC,12,0,12,-12,2,2,0,2,OTC
4583,12-02-2021 10:00,24 hrs.,wallstreetbets,SMVI,12,0,12,-12,2,2,0,1,OTC
4583,12-02-2021 10:00,24 hrs.,wallstreetbets,SNDD,6,0,6,-6,1,1,0,1,OTC
4583,12-02-2021 10:00,24 hrs.,wallstreetbets,SNPW,6,0,6,-6,1,1,0,1,OTC
4583,12-02-2021 10:00,24 hrs.,wallstreetbets,SNRY,6,0,6,-6,1,1,0,1,OTC
4583,12-02-2021 10:00,24 hrs.,wallstreetbets,SRMX,68,20,48,-28,11,11,2,9,OTC
4583,12-02-2021 10:00,24 hrs.,wallstreetbets,SRUP,30,0,30,-30,5,5,0,1,OTC
4583,12-02-2021 10:00,24 hrs.,wallstreetbets,SSOK,6,0,6,-6,1,1,0,1,OTC
4583,12-02-2021 10:00,24 hrs.,wallstreetbets,SUGR,8,0,8,-8,1,2,0,1,OTC
4583,12-02-2021 10:00,24 hrs.,wallstreetbets,SUIC,6,0,6,-6,1,1,0,1,OTC
4583,12-02-2021 10:00,24 hrs.,wallstreetbets,SUND,6,0,6,-6,1,1,0,1,OTC
4583,12-02-2021 10:00,24 hrs.,wallstreetbets,SVTE,6,0,6,-6,1,1,0,1,OTC
4583,12-02-2021 10:00,24 hrs.,wallstreetbets,TGGI,6,0,6,-6,1,1,0,1,OTC
4583,12-02-2021 10:00,24 hrs.,wallstreetbets,TMRC,6,0,6,-6,1,1,0,1,OTC
4583,12-02-2021 10:00,24 hrs.,wallstreetbets,TRNX,13,7,6,1,2,2,1,2,OTC
4583,12-02-2021 10:00,24 hrs.,wallstreetbets,TRTC,18,0,18,-18,3,3,0,3,OTC
4583,12-02-2021 10:00,24 hrs.,wallstreetbets,TSNP,42,6,36,-30,7,7,0,7,OTC
4583,12-02-2021 10:00,24 hrs.,wallstreetbets,TSTS,6,0,6,-6,1,1,0,1,OTC
4583,12-02-2021 10:00,24 hrs.,wallstreetbets,UATG,12,0,12,-12,2,2,0,1,OTC
4583,12-02-2021 10:00,24 hrs.,wallstreetbets,UNVC,6,0,6,-6,1,1,0,1,OTC
4583,12-02-2021 10:00,24 hrs.,wallstreetbets,UOMO,6,0,6,-6,1,1,0,1,OTC
4583,12-02-2021 10:00,24 hrs.,Daytrading,APHA,894,0,894,-894,5,349,176,4,NASDAQ
4583,12-02-2021 10:00,24 hrs.,Daytrading,AYRO,60,0,60,-60,1,24,8,1,NASDAQ
4583,12-02-2021 10:00,24 hrs.,Daytrading,AZRX,7,7,0,7,1,1,1,1,NASDAQ
4583,12-02-2021 10:00,24 hrs.,Daytrading,BYND,6,6,0,6,1,1,0,1,NASDAQ
4583,12-02-2021 10:00,24 hrs.,Daytrading,CIIC,60,0,60,-60,1,24,8,1,NASDAQ
4583,12-02-2021 10:00,24 hrs.,Daytrading,CLSN,114,0,114,-114,1,50,10,1,NASDAQ
4583,12-02-2021 10:00,24 hrs.,Daytrading,CLVR,723,0,723,-723,1,295,129,1,NASDAQ
4583,12-02-2021 10:00,24 hrs.,Daytrading,COST,6,0,6,-6,1,1,0,1,NASDAQ
4583,12-02-2021 10:00,24 hrs.,Daytrading,CRBP,723,0,723,-723,1,295,129,1,NASDAQ
4583,12-02-2021 10:00,24 hrs.,Daytrading,CRWD,60,0,60,-60,1,24,8,1,NASDAQ
4583,12-02-2021 10:00,24 hrs.,Daytrading,CTRM,114,0,114,-114,1,50,10,1,NASDAQ
4583,12-02-2021 10:00,24 hrs.,Daytrading,DMTK,723,0,723,-723,1,295,129,1,NASDAQ
4583,12-02-2021 10:00,24 hrs.,Daytrading,ENVB,723,0,723,-723,1,295,129,1,NASDAQ
4583,12-02-2021 10:00,24 hrs.,Daytrading,EVFM,12,0,12,-12,2,2,0,1,NASDAQ
4583,12-02-2021 10:00,24 hrs.,Daytrading,EXPE,4,4,0,4,1,0,0,1,NASDAQ
4583,12-02-2021 10:00,24 hrs.,Daytrading,GEVO,848,0,848,-848,2,338,164,2,NASDAQ
4583,12-02-2021 10:00,24 hrs.,Daytrading,GNLN,6,0,6,-6,1,1,0,1,NASDAQ
4583,12-02-2021 10:00,24 hrs.,Daytrading,GOEV,60,0,60,-60,1,24,8,1,NASDAQ
4583,12-02-2021 10:00,24 hrs.,Daytrading,GRNQ,723,0,723,-723,1,295,129,1,NASDAQ
4583,12-02-2021 10:00,24 hrs.,Daytrading,IBKR,24,12,12,0,2,3,10,2,NASDAQ
4583,12-02-2021 10:00,24 hrs.,Daytrading,ITRM,6,0,6,-6,1,1,0,1,NASDAQ
4583,12-02-2021 10:00,24 hrs.,Daytrading,MARA,723,0,723,-723,1,295,129,1,NASDAQ
4583,12-02-2021 10:00,24 hrs.,Daytrading,MESA,6,0,6,-6,1,1,0,1,NASDAQ
4583,12-02-2021 10:00,24 hrs.,Daytrading,MESO,723,0,723,-723,1,295,129,1,NASDAQ
4583,12-02-2021 10:00,24 hrs.,Daytrading,MNPR,837,0,837,-837,2,345,139,2,NASDAQ
4583,12-02-2021 10:00,24 hrs.,Daytrading,MOGO,723,0,723,-723,1,295,129,1,NASDAQ
4583,12-02-2021 10:00,24 hrs.,Daytrading,MOMO,60,0,60,-60,1,24,8,1,NASDAQ
4583,12-02-2021 10:00,24 hrs.,Daytrading,MTEM,125,0,125,-125,1,43,35,1,NASDAQ
4583,12-02-2021 10:00,24 hrs.,Daytrading,MVIS,723,0,723,-723,1,295,129,1,NASDAQ
4583,12-02-2021 10:00,24 hrs.,Daytrading,NNOX,723,0,723,-723,1,295,129,1,NASDAQ
4583,12-02-2021 10:00,24 hrs.,Daytrading,OCGN,6,0,6,-6,1,1,0,1,NASDAQ
4583,12-02-2021 10:00,24 hrs.,Daytrading,PLAY,10,10,0,10,1,0,6,1,NASDAQ
4583,12-02-2021 10:00,24 hrs.,Daytrading,PLUS,7,7,0,7,1,1,1,1,NASDAQ
4583,12-02-2021 10:00,24 hrs.,Daytrading,RCMT,837,0,837,-837,2,345,139,2,NASDAQ
4583,12-02-2021 10:00,24 hrs.,Daytrading,RIOT,962,0,962,-962,3,388,174,3,NASDAQ
4583,12-02-2021 10:00,24 hrs.,Daytrading,SNDL,1063,15,1048,-1033,7,414,207,7,NASDAQ
4583,12-02-2021 10:00,24 hrs.,Daytrading,TLRY,909,15,894,-879,5,353,183,5,NASDAQ
4583,12-02-2021 10:00,24 hrs.,Daytrading,ZYNE,125,0,125,-125,1,43,35,1,NASDAQ
4583,12-02-2021 10:00,24 hrs.,trakstocks,BRGO,6,0,6,-6,1,1,0,1,OTC
4583,12-02-2021 10:00,24 hrs.,trakstocks,BRLL,11,0,11,-11,1,3,1,1,OTC
4583,12-02-2021 10:00,24 hrs.,trakstocks,SGSI,12,0,12,-12,1,4,0,1,OTC
4583,12-02-2021 10:00,24 hrs.,trakstocks,SMVI,6,0,6,-6,1,1,0,1,OTC
4583,12-02-2021 10:00,24 hrs.,trakstocks,SNPW,12,0,12,-12,1,2,4,1,OTC
4583,12-02-2021 10:00,24 hrs.,trakstocks,SUIC,6,6,0,6,1,1,0,1,OTC
4583,12-02-2021 10:00,24 hrs.,trakstocks,DFLYF,61,0,61,-61,1,19,19,1,OTC
4583,12-02-2021 10:00,24 hrs.,wallstreetbets,SFTBY,12,0,12,-12,2,2,0,2,OTC
4583,12-02-2021 10:00,24 hrs.,wallstreetbets,SHECY,76,0,76,-76,1,24,24,1,OTC
4583,12-02-2021 10:00,24 hrs.,wallstreetbets,SHERF,6,0,6,-6,1,1,0,1,OTC
4583,12-02-2021 10:00,24 hrs.,wallstreetbets,SHRMF,3297,0,3297,-3297,1,1352,589,1,OTC
4583,12-02-2021 10:00,24 hrs.,wallstreetbets,SLGWF,12,0,12,-12,2,2,0,1,OTC
4583,12-02-2021 10:00,24 hrs.,wallstreetbets,SPLIF,6,0,6,-6,1,1,0,1,OTC
4583,12-02-2021 10:00,24 hrs.,wallstreetbets,SPRWF,68,62,6,56,10,12,4,9,OTC
4583,12-02-2021 10:00,24 hrs.,wallstreetbets,TAKOF,269,0,269,-269,3,102,53,3,OTC
4583,12-02-2021 10:00,24 hrs.,wallstreetbets,TBUIF,24,0,24,-24,4,4,0,1,OTC
4583,12-02-2021 10:00,24 hrs.,wallstreetbets,TCNNF,761,0,761,-761,2,225,303,2,OTC
4583,12-02-2021 10:00,24 hrs.,wallstreetbets,TGODF,42,0,42,-42,7,7,0,5,OTC
4583,12-02-2021 10:00,24 hrs.,wallstreetbets,TLOFF,7,7,0,7,1,1,1,1,OTC
4583,12-02-2021 10:00,24 hrs.,wallstreetbets,TLVLF,6,0,6,-6,1,1,0,1,OTC
4583,12-02-2021 10:00,24 hrs.,stocks,XERS,18,0,18,-18,2,4,2,2,NASDAQ
4583,12-02-2021 10:00,24 hrs.,stocks,XSPA,6,0,6,-6,1,1,0,1,NASDAQ
4583,12-02-2021 10:00,24 hrs.,stocks,ZNGA,112,0,112,-112,1,48,12,1,NASDAQ
4583,12-02-2021 10:00,24 hrs.,stocks,ZSAN,12,0,12,-12,2,2,0,2,NASDAQ
4583,12-02-2021 10:00,24 hrs.,stocks,ZYXI,21,21,0,21,1,2,13,1,NASDAQ
4583,12-02-2021 10:00,24 hrs.,Daytrading,AABB,27,27,0,27,1,9,5,1,OTC
4583,12-02-2021 10:00,24 hrs.,wallstreetbets,VVCIF,7,7,0,7,1,1,1,1,OTC
4583,12-02-2021 10:00,24 hrs.,wallstreetbets,VYGVF,12,0,12,-12,1,2,4,1,OTC
4583,12-02-2021 10:00,24 hrs.,wallstreetbets,WDDMF,6,0,6,-6,1,1,0,1,OTC
4583,12-02-2021 10:00,24 hrs.,wallstreetbets,WPMLF,8,8,0,8,1,1,2,1,OTC
4583,12-02-2021 10:00,24 hrs.,wallstreetbets,XIACF,12,0,12,-12,2,2,0,1,OTC
4583,12-02-2021 10:00,24 hrs.,wallstreetbets,XIACY,12,0,12,-12,2,2,0,1,OTC
4583,12-02-2021 10:00,24 hrs.,wallstreetbets,AAU,6,0,6,-6,1,1,0,1,AMEX
4583,12-02-2021 10:00,24 hrs.,wallstreetbets,AGE,6,0,6,-6,1,1,0,1,AMEX
4583,12-02-2021 10:00,24 hrs.,wallstreetbets,AMS,6,0,6,-6,1,1,0,1,AMEX
4583,12-02-2021 10:00,24 hrs.,wallstreetbets,CEI,18,0,18,-18,3,3,0,2,AMEX
4583,12-02-2021 10:00,24 hrs.,wallstreetbets,DNN,177,55,122,-67,28,29,7,27,AMEX
4583,12-02-2021 10:00,24 hrs.,wallstreetbets,DPW,19,7,12,-5,3,3,1,3,AMEX
4583,12-02-2021 10:00,24 hrs.,wallstreetbets,FEN,7,7,0,7,1,1,1,1,AMEX
4583,12-02-2021 10:00,24 hrs.,wallstreetbets,GPL,6,0,6,-6,1,1,0,1,AMEX
4583,12-02-2021 10:00,24 hrs.,wallstreetbets,GSV,45,21,24,-3,7,7,3,7,AMEX
4583,12-02-2021 10:00,24 hrs.,wallstreetbets,GTE,166,40,126,-86,27,27,4,23,AMEX
4583,12-02-2021 10:00,24 hrs.,wallstreetbets,IGC,79,7,72,-65,13,13,1,6,AMEX
4583,12-02-2021 10:00,24 hrs.,wallstreetbets,ISR,6,6,0,6,1,1,0,1,AMEX
4583,12-02-2021 10:00,24 hrs.,wallstreetbets,ITP,6,0,6,-6,1,1,0,1,AMEX
4583,12-02-2021 10:00,24 hrs.,wallstreetbets,JOB,6,0,6,-6,1,1,0,1,AMEX
4583,12-02-2021 10:00,24 hrs.,wallstreetbets,KIQ,12,0,12,-12,2,2,0,1,AMEX
4583,12-02-2021 10:00,24 hrs.,wallstreetbets,LNG,12,0,12,-12,2,2,0,2,AMEX
4583,12-02-2021 10:00,24 hrs.,wallstreetbets,LOV,18,0,18,-18,3,3,0,1,AMEX
4583,12-02-2021 10:00,24 hrs.,wallstreetbets,LSF,7,7,0,7,1,1,1,1,AMEX
4583,12-02-2021 10:00,24 hrs.,wallstreetbets,MMX,6,0,6,-6,1,1,0,1,AMEX
4583,12-02-2021 10:00,24 hrs.,wallstreetbets,MXC,13,7,6,1,2,2,1,2,AMEX
4583,12-02-2021 10:00,24 hrs.,wallstreetbets,NAK,267,59,208,-149,43,44,7,33,AMEX
4583,12-02-2021 10:00,24 hrs.,wallstreetbets,NGD,15,15,0,15,2,2,3,1,AMEX
4583,12-02-2021 10:00,24 hrs.,wallstreetbets,NXE,6,0,6,-6,1,1,0,1,AMEX
4583,12-02-2021 10:00,24 hrs.,wallstreetbets,PTN,12,0,12,-12,2,2,0,1,AMEX
4583,12-02-2021 10:00,24 hrs.,wallstreetbets,REI,6,0,6,-6,1,1,0,1,AMEX
4583,12-02-2021 10:00,24 hrs.,wallstreetbets,SYN,12,0,12,-12,2,2,0,2,AMEX
4583,12-02-2021 10:00,24 hrs.,wallstreetbets,TMQ,8,8,0,8,1,1,2,1,AMEX
4583,12-02-2021 10:00,24 hrs.,wallstreetbets,TRX,101,40,61,-21,16,16,5,13,AMEX
4583,12-02-2021 10:00,24 hrs.,wallstreetbets,URG,7,7,0,7,1,1,1,1,AMEX
4583,12-02-2021 10:00,24 hrs.,wallstreetbets,XPL,12,0,12,-12,2,2,0,1,AMEX
4583,12-02-2021 10:00,24 hrs.,wallstreetbets,ZOM,294,118,176,-58,47,47,12,41,AMEX
4583,12-02-2021 10:00,24 hrs.,wallstreetbets,AMPE,6,0,6,-6,1,1,0,1,AMEX
4583,12-02-2021 10:00,24 hrs.,wallstreetbets,CANF,6,0,6,-6,1,1,0,1,AMEX
4583,12-02-2021 10:00,24 hrs.,wallstreetbets,CRMD,12,0,12,-12,2,2,0,2,AMEX
4583,12-02-2021 10:00,24 hrs.,wallstreetbets,EMAN,7,7,0,7,1,1,1,1,AMEX
4583,12-02-2021 10:00,24 hrs.,wallstreetbets,GSAT,224,79,145,-66,36,36,8,25,AMEX
4583,12-02-2021 10:00,24 hrs.,wallstreetbets,IBIO,18,0,18,-18,3,3,0,1,AMEX
4583,12-02-2021 10:00,24 hrs.,wallstreetbets,INUV,6,0,6,-6,1,1,0,1,AMEX
4583,12-02-2021 10:00,24 hrs.,wallstreetbets,LODE,6,0,6,-6,1,1,0,1,AMEX
4583,12-02-2021 10:00,24 hrs.,wallstreetbets,NSPR,31,7,24,-17,5,5,1,4,AMEX
4583,12-02-2021 10:00,24 hrs.,wallstreetbets,OGEN,37,7,30,-23,6,6,1,5,AMEX
4583,12-02-2021 10:00,24 hrs.,wallstreetbets,RLGT,21,21,0,21,3,3,3,1,AMEX
4583,12-02-2021 10:00,24 hrs.,wallstreetbets,SENS,3874,7,3867,-3860,21,1554,682,18,AMEX
4583,12-02-2021 10:00,24 hrs.,wallstreetbets,TMBR,25,13,12,1,4,4,1,4,AMEX
4583,12-02-2021 10:00,24 hrs.,wallstreetbets,TRXC,69,21,48,-27,11,11,3,7,AMEX
4583,12-02-2021 10:00,24 hrs.,wallstreetbets,UAVS,25,13,12,1,4,4,1,4,AMEX
4583,12-02-2021 10:00,24 hrs.,wallstreetbets,UUUU,26,14,12,2,4,4,2,3,AMEX
4583,12-02-2021 10:00,24 hrs.,wallstreetbets,VOLT,6,0,6,-6,1,1,0,1,AMEX
4583,12-02-2021 10:00,24 hrs.,wallstreetbets,XXII,6,0,6,-6,1,1,0,1,AMEX
4583,12-02-2021 10:00,24 hrs.,wallstreetbets,YCBD,13,7,6,1,2,2,1,2,AMEX
4583,12-02-2021 10:00,24 hrs.,wallstreetbets,ABT,6,0,6,-6,1,1,0,1,NYSE
4583,12-02-2021 10:00,24 hrs.,wallstreetbets,ACB,281,26,255,-229,46,46,5,32,NYSE
4583,12-02-2021 10:00,24 hrs.,Daytrading,OGI,15,15,0,15,1,2,7,1,NASDAQ
4583,12-02-2021 10:00,24 hrs.,Daytrading,RCM,114,0,114,-114,1,50,10,1,NASDAQ
4583,12-02-2021 10:00,24 hrs.,Daytrading,RUN,7,0,7,-7,1,1,1,1,NASDAQ
4583,12-02-2021 10:00,24 hrs.,Daytrading,ACIU,837,0,837,-837,2,345,139,2,NASDAQ
4583,12-02-2021 10:00,24 hrs.,Daytrading,AKER,723,0,723,-723,1,295,129,1,NASDAQ
4583,12-02-2021 10:00,24 hrs.,Daytrading,AMGN,8,0,8,-8,1,1,2,1,NASDAQ
4583,12-02-2021 10:00,24 hrs.,trakstocks,CFO,263,0,263,-263,1,110,39,1,NASDAQ
4583,12-02-2021 10:00,24 hrs.,trakstocks,HOL,45,0,45,-45,1,12,17,1,NASDAQ
4583,12-02-2021 10:00,24 hrs.,trakstocks,PTE,17,0,17,-17,1,4,5,1,NASDAQ
4583,12-02-2021 10:00,24 hrs.,trakstocks,ABEO,25,6,19,-13,2,7,3,2,NASDAQ
4583,12-02-2021 10:00,24 hrs.,trakstocks,AESE,18,0,18,-18,1,5,4,1,NASDAQ
4583,12-02-2021 10:00,24 hrs.,trakstocks,APHA,27,0,27,-27,1,8,7,1,NASDAQ
4583,12-02-2021 10:00,24 hrs.,trakstocks,AYRO,572,0,572,-572,4,222,112,4,NASDAQ
4583,12-02-2021 10:00,24 hrs.,trakstocks,BTBT,13,0,13,-13,1,3,3,1,NASDAQ
4583,12-02-2021 10:00,24 hrs.,trakstocks,CHEF,28,28,0,28,1,9,6,1,NASDAQ
4583,12-02-2021 10:00,24 hrs.,trakstocks,CPSH,43,43,0,43,2,16,3,2,NASDAQ
4583,12-02-2021 10:00,24 hrs.,trakstocks,CRNT,27,0,27,-27,1,10,3,1,NASDAQ
4583,12-02-2021 10:00,24 hrs.,trakstocks,CTRM,120,0,120,-120,3,46,16,2,NASDAQ
4583,12-02-2021 10:00,24 hrs.,trakstocks,DARE,6,0,6,-6,1,1,0,1,NASDAQ
4583,12-02-2021 10:00,24 hrs.,trakstocks,EXPC,41,19,22,-3,2,15,3,2,NASDAQ
4583,12-02-2021 10:00,24 hrs.,trakstocks,FUTU,41,41,0,41,1,12,13,1,NASDAQ
4583,12-02-2021 10:00,24 hrs.,trakstocks,GEVO,75,75,0,75,1,31,9,1,NASDAQ
4583,12-02-2021 10:00,24 hrs.,trakstocks,GHIV,41,41,0,41,1,12,13,1,NASDAQ
4583,12-02-2021 10:00,24 hrs.,trakstocks,GHSI,6,0,6,-6,1,1,0,1,NASDAQ
4583,12-02-2021 10:00,24 hrs.,trakstocks,GMBL,18,0,18,-18,1,5,4,1,NASDAQ
4583,12-02-2021 10:00,24 hrs.,trakstocks,GMDA,12,12,0,12,1,1,6,1,NASDAQ
4583,12-02-2021 10:00,24 hrs.,trakstocks,IBKR,41,41,0,41,1,12,13,1,NASDAQ
4583,12-02-2021 10:00,24 hrs.,trakstocks,INMD,8,0,8,-8,1,2,0,1,NASDAQ
4583,12-02-2021 10:00,24 hrs.,trakstocks,INPX,20,0,20,-20,1,8,0,1,NASDAQ
4583,12-02-2021 10:00,24 hrs.,trakstocks,IRBT,27,0,27,-27,1,8,7,1,NASDAQ
4583,12-02-2021 10:00,24 hrs.,trakstocks,LKCO,20,0,20,-20,1,7,2,1,NASDAQ
4583,12-02-2021 10:00,24 hrs.,trakstocks,MARA,27,14,13,1,2,5,9,2,NASDAQ
4583,12-02-2021 10:00,24 hrs.,trakstocks,MSTR,4,0,4,-4,1,0,0,1,NASDAQ
4583,12-02-2021 10:00,24 hrs.,trakstocks,OBSV,14,0,14,-14,1,5,0,1,NASDAQ
4583,12-02-2021 10:00,24 hrs.,trakstocks,RIOT,33,14,19,-5,3,6,9,3,NASDAQ
4583,12-02-2021 10:00,24 hrs.,trakstocks,SNGX,28,0,28,-28,1,10,4,1,NASDAQ
4583,12-02-2021 10:00,24 hrs.,trakstocks,TTCF,28,28,0,28,1,9,6,1,NASDAQ
4583,12-02-2021 10:00,24 hrs.,trakstocks,USWS,174,174,0,174,2,69,28,2,NASDAQ
4583,12-02-2021 10:00,24 hrs.,trakstocks,VNDA,8,8,0,8,1,2,0,1,NASDAQ
4583,12-02-2021 10:00,24 hrs.,trakstocks,VRME,8,8,0,8,1,2,0,1,NASDAQ
4583,12-02-2021 10:00,24 hrs.,trakstocks,VTRS,7,0,7,-7,1,1,1,1,NASDAQ
4583,12-02-2021 10:00,24 hrs.,trakstocks,XSPA,11,11,0,11,1,2,3,1,NASDAQ
4583,12-02-2021 10:00,24 hrs.,trakstocks,HOLUW,8,0,8,-8,1,1,2,1,NASDAQ
4583,12-02-2021 10:00,24 hrs.,StockMarket,BIIO,6,0,6,-6,1,1,0,1,OTC
4583,12-02-2021 10:00,24 hrs.,StockMarket,BLDV,21,0,21,-21,1,6,5,1,OTC
4583,12-02-2021 10:00,24 hrs.,StockMarket,BOTY,38,34,4,30,3,4,18,2,OTC
4583,12-02-2021 10:00,24 hrs.,StockMarket,CAPC,6,0,6,-6,1,1,0,1,OTC
4583,12-02-2021 10:00,24 hrs.,StockMarket,DIGI,6,6,0,6,1,1,0,1,OTC
4583,12-02-2021 10:00,24 hrs.,StockMarket,FMCC,56,56,0,56,1,14,24,1,OTC
4583,12-02-2021 10:00,24 hrs.,StockMarket,FNMA,56,56,0,56,1,14,24,1,OTC
4583,12-02-2021 10:00,24 hrs.,trakstocks,HUTMF,14,14,0,14,1,2,6,1,OTC
4583,12-02-2021 10:00,24 hrs.,trakstocks,VVCIF,12,0,12,-12,1,2,4,1,OTC
4583,12-02-2021 10:00,24 hrs.,trakstocks,ZOM,62,0,62,-62,1,24,10,1,AMEX
4583,12-02-2021 10:00,24 hrs.,trakstocks,TRXC,53,53,0,53,1,22,5,1,AMEX
4583,12-02-2021 10:00,24 hrs.,trakstocks,UAVS,15,0,15,-15,1,4,3,1,AMEX
4583,12-02-2021 10:00,24 hrs.,trakstocks,UUUU,47,47,0,47,1,12,19,1,AMEX
4583,12-02-2021 10:00,24 hrs.,wallstreetbets,ACI,6,0,6,-6,1,1,0,1,NYSE
4583,12-02-2021 10:00,24 hrs.,wallstreetbets,ADT,18,0,18,-18,3,3,0,2,NYSE
4583,12-02-2021 10:00,24 hrs.,wallstreetbets,ADX,12,0,12,-12,2,2,0,1,NYSE
4583,12-02-2021 10:00,24 hrs.,wallstreetbets,AFC,12,0,12,-12,2,2,0,1,NYSE
4583,12-02-2021 10:00,24 hrs.,wallstreetbets,AHT,14,14,0,14,2,2,2,2,NYSE
4583,12-02-2021 10:00,24 hrs.,wallstreetbets,AIR,7,7,0,7,1,1,1,1,NYSE
4583,12-02-2021 10:00,24 hrs.,wallstreetbets,AMC,66402,2302,64100,-61798,302,30296,4602,251,NYSE
4583,12-02-2021 10:00,24 hrs.,wallstreetbets,AMP,33,27,6,21,5,5,3,5,NYSE
4583,12-02-2021 10:00,24 hrs.,wallstreetbets,TRUFF,7,0,7,-7,1,1,1,1,OTC
4583,12-02-2021 10:00,24 hrs.,wallstreetbets,TSCRF,13,7,6,1,2,2,1,2,OTC
4583,12-02-2021 10:00,24 hrs.,wallstreetbets,VALPQ,13,7,6,1,2,2,1,2,OTC
4583,12-02-2021 10:00,24 hrs.,wallstreetbets,VEGGF,6,0,6,-6,1,1,0,1,OTC
4583,12-02-2021 10:00,24 hrs.,wallstreetbets,VLNCF,240,0,240,-240,4,62,100,4,OTC
4583,12-02-2021 10:00,24 hrs.,wallstreetbets,VRYYF,6,0,6,-6,1,1,0,1,OTC
4583,12-02-2021 10:00,24 hrs.,pennystocks,RDHL,13,0,13,-13,1,3,3,1,NASDAQ
4583,12-02-2021 10:00,24 hrs.,pennystocks,REAL,113,36,77,-41,3,23,55,3,NASDAQ
4583,12-02-2021 10:00,24 hrs.,pennystocks,RIDE,47,0,47,-47,1,16,11,1,NASDAQ
4583,12-02-2021 10:00,24 hrs.,pennystocks,RIGL,12,12,0,12,2,2,0,2,NASDAQ
4583,12-02-2021 10:00,24 hrs.,pennystocks,RIOT,8,8,0,8,1,0,4,1,NASDAQ
4583,12-02-2021 10:00,24 hrs.,pennystocks,RMTI,54,6,48,-42,2,13,20,2,NASDAQ
4583,12-02-2021 10:00,24 hrs.,pennystocks,SAVA,6,0,6,-6,1,1,0,1,NASDAQ
4583,12-02-2021 10:00,24 hrs.,pennystocks,SEEL,198,0,198,-198,1,83,28,1,NASDAQ
4583,12-02-2021 10:00,24 hrs.,pennystocks,SHIP,16,0,16,-16,2,3,2,2,NASDAQ
4583,12-02-2021 10:00,24 hrs.,pennystocks,SLRX,7,0,7,-7,1,1,1,1,NASDAQ
4583,12-02-2021 10:00,24 hrs.,pennystocks,SNCA,6,0,6,-6,1,1,0,1,NASDAQ
4583,12-02-2021 10:00,24 hrs.,pennystocks,SNDL,371,98,273,-175,52,72,19,42,NASDAQ
4583,12-02-2021 10:00,24 hrs.,pennystocks,SNGX,3688,0,3688,-3688,4,1564,544,2,NASDAQ
4583,12-02-2021 10:00,24 hrs.,pennystocks,SRGA,1698,0,1698,-1698,2,747,196,2,NASDAQ
4583,12-02-2021 10:00,24 hrs.,pennystocks,SUNW,7,0,7,-7,1,1,1,1,NASDAQ
4583,12-02-2021 10:00,24 hrs.,pennystocks,SXTC,20,13,7,6,3,2,4,2,NASDAQ
4583,12-02-2021 10:00,24 hrs.,pennystocks,TBLT,6,0,6,-6,1,1,0,1,NASDAQ
4583,12-02-2021 10:00,24 hrs.,pennystocks,TELL,32,0,32,-32,2,8,8,2,NASDAQ
4583,12-02-2021 10:00,24 hrs.,pennystocks,TLRY,70,70,0,70,3,26,6,3,NASDAQ
4583,12-02-2021 10:00,24 hrs.,pennystocks,TMDI,29,6,23,-17,2,10,1,2,NASDAQ
4583,12-02-2021 10:00,24 hrs.,pennystocks,TNXP,1827,190,1637,-1447,19,741,269,16,NASDAQ
4583,12-02-2021 10:00,24 hrs.,pennystocks,TRCH,24,6,18,-12,4,4,0,2,NASDAQ
4583,12-02-2021 10:00,24 hrs.,pennystocks,TRIP,198,0,198,-198,1,83,28,1,NASDAQ
4583,12-02-2021 10:00,24 hrs.,pennystocks,TTOO,6,0,6,-6,1,1,0,1,NASDAQ
4583,12-02-2021 10:00,24 hrs.,pennystocks,TTWO,6,0,6,-6,1,1,0,1,NASDAQ
4583,12-02-2021 10:00,24 hrs.,pennystocks,TXMD,54,0,54,-54,2,13,20,2,NASDAQ
4583,12-02-2021 10:00,24 hrs.,pennystocks,TYME,48,0,48,-48,1,12,20,1,NASDAQ
4583,12-02-2021 10:00,24 hrs.,pennystocks,USWS,18,12,6,6,3,3,0,3,NASDAQ
4583,12-02-2021 10:00,24 hrs.,pennystocks,VRME,21,21,0,21,1,6,5,1,NASDAQ
4583,12-02-2021 10:00,24 hrs.,pennystocks,VTVT,7,0,7,-7,1,1,1,1,NASDAQ
4583,12-02-2021 10:00,24 hrs.,pennystocks,WTER,24,0,24,-24,1,2,16,1,NASDAQ
4583,12-02-2021 10:00,24 hrs.,pennystocks,WTRH,67,38,29,9,2,21,17,2,NASDAQ
4583,12-02-2021 10:00,24 hrs.,pennystocks,XCUR,6,0,6,-6,1,1,0,1,NASDAQ
4583,12-02-2021 10:00,24 hrs.,pennystocks,XERS,6,0,6,-6,1,1,0,1,NASDAQ
4583,12-02-2021 10:00,24 hrs.,pennystocks,XNET,6,0,6,-6,1,1,0,1,NASDAQ
4583,12-02-2021 10:00,24 hrs.,pennystocks,XSPA,8,0,8,-8,1,2,0,1,NASDAQ
4583,12-02-2021 10:00,24 hrs.,pennystocks,ZSAN,1887,113,1774,-1661,10,798,251,10,NASDAQ
4583,12-02-2021 10:00,24 hrs.,pennystocks,ZYNE,48,48,0,48,1,20,4,1,NASDAQ
4583,12-02-2021 10:00,24 hrs.,pennystocks,SGAMW,45,0,45,-45,1,16,9,1,NASDAQ
4583,12-02-2021 10:00,24 hrs.,wallstreetbets,AABB,6,0,6,-6,1,1,0,1,OTC
4583,12-02-2021 10:00,24 hrs.,wallstreetbets,ABML,25,13,12,1,4,4,1,4,OTC
4583,12-02-2021 10:00,24 hrs.,wallstreetbets,ABQQ,7,7,0,7,1,1,1,1,OTC
4583,12-02-2021 10:00,24 hrs.,wallstreetbets,ABWN,6,0,6,-6,1,1,0,1,OTC
4583,12-02-2021 10:00,24 hrs.,wallstreetbets,ADTM,6,0,6,-6,1,1,0,1,OTC
4583,12-02-2021 10:00,24 hrs.,trakstocks,AMC,41,41,0,41,1,12,13,1,NYSE
4583,12-02-2021 10:00,24 hrs.,trakstocks,BFT,45,0,45,-45,1,12,17,1,NYSE
4583,12-02-2021 10:00,24 hrs.,trakstocks,CPS,29,29,0,29,1,12,1,1,NYSE
4583,12-02-2021 10:00,24 hrs.,trakstocks,GIK,63,0,63,-63,2,21,13,1,NYSE
4583,12-02-2021 10:00,24 hrs.,trakstocks,GME,41,41,0,41,1,12,13,1,NYSE
4583,12-02-2021 10:00,24 hrs.,trakstocks,LEN,9,9,0,9,1,2,1,1,NYSE
4583,12-02-2021 10:00,24 hrs.,trakstocks,NAV,41,41,0,41,1,12,13,1,NYSE
4583,12-02-2021 10:00,24 hrs.,trakstocks,PCG,41,41,0,41,1,12,13,1,NYSE
4583,12-02-2021 10:00,24 hrs.,trakstocks,RKT,41,41,0,41,1,12,13,1,NYSE
4583,12-02-2021 10:00,24 hrs.,trakstocks,SOS,49,0,49,-49,1,22,1,1,NYSE
4583,12-02-2021 10:00,24 hrs.,trakstocks,SPH,10,10,0,10,1,3,0,1,NYSE
4583,12-02-2021 10:00,24 hrs.,trakstocks,WPF,6,6,0,6,1,1,0,1,NYSE
4583,12-02-2021 10:00,24 hrs.,trakstocks,BEKE,41,41,0,41,1,12,13,1,NYSE
4583,12-02-2021 10:00,24 hrs.,trakstocks,CCIV,39,39,0,39,4,8,7,3,NYSE
4583,12-02-2021 10:00,24 hrs.,trakstocks,FUSE,6,0,6,-6,1,1,0,1,NYSE
4583,12-02-2021 10:00,24 hrs.,trakstocks,IIPR,14,0,14,-14,1,5,0,1,NYSE
4583,12-02-2021 10:00,24 hrs.,trakstocks,MDLY,6,6,0,6,1,1,0,1,NYSE
4583,12-02-2021 10:00,24 hrs.,trakstocks,SKLZ,6,6,0,6,1,1,0,1,NYSE
4583,12-02-2021 10:00,24 hrs.,trakstocks,STIC,17,17,0,17,1,6,1,1,NYSE
4583,12-02-2021 10:00,24 hrs.,trakstocks,STPK,83,0,83,-83,3,27,17,3,NYSE
4583,12-02-2021 10:00,24 hrs.,StockMarket,MRK,26,0,26,-26,1,10,2,1,NYSE
4583,12-02-2021 10:00,24 hrs.,StockMarket,NIO,65,0,65,-65,2,24,9,2,NYSE
4583,12-02-2021 10:00,24 hrs.,StockMarket,NOK,4,0,4,-4,1,0,0,1,NYSE
4583,12-02-2021 10:00,24 hrs.,wallstreetbets,AEGY,6,6,0,6,1,1,0,1,OTC
4583,12-02-2021 10:00,24 hrs.,wallstreetbets,AFTM,12,0,12,-12,2,2,0,1,OTC
4583,12-02-2021 10:00,24 hrs.,wallstreetbets,AGYP,6,0,6,-6,1,1,0,1,OTC
4583,12-02-2021 10:00,24 hrs.,wallstreetbets,AHFD,7,7,0,7,1,1,1,1,OTC
4583,12-02-2021 10:00,24 hrs.,wallstreetbets,AITX,50,20,30,-10,8,8,2,8,OTC
4583,12-02-2021 10:00,24 hrs.,wallstreetbets,ALKM,12,0,12,-12,2,2,0,2,OTC
4583,12-02-2021 10:00,24 hrs.,wallstreetbets,ALPP,12,0,12,-12,2,2,0,2,OTC
4583,12-02-2021 10:00,24 hrs.,wallstreetbets,ALYI,13,7,6,1,2,2,1,2,OTC
4583,12-02-2021 10:00,24 hrs.,wallstreetbets,AMMJ,12,0,12,-12,2,2,0,2,OTC
4583,12-02-2021 10:00,24 hrs.,wallstreetbets,AMNE,6,0,6,-6,1,1,0,1,OTC
4583,12-02-2021 10:00,24 hrs.,wallstreetbets,ANDD,6,0,6,-6,1,1,0,1,OTC
4583,12-02-2021 10:00,24 hrs.,wallstreetbets,ANTI,13,6,7,-1,2,2,1,2,OTC
4583,12-02-2021 10:00,24 hrs.,wallstreetbets,APRU,19,0,19,-19,3,3,1,1,OTC
4583,12-02-2021 10:00,24 hrs.,wallstreetbets,ASTI,30,18,12,6,5,5,0,3,OTC
4583,12-02-2021 10:00,24 hrs.,wallstreetbets,AZFL,6,0,6,-6,1,1,0,1,OTC
4583,12-02-2021 10:00,24 hrs.,wallstreetbets,BBRW,12,6,6,0,2,2,0,2,OTC
4583,12-02-2021 10:00,24 hrs.,wallstreetbets,BCAP,24,0,24,-24,4,4,0,2,OTC
4583,12-02-2021 10:00,24 hrs.,wallstreetbets,BCCI,14,14,0,14,2,2,2,1,OTC
4583,12-02-2021 10:00,24 hrs.,wallstreetbets,BFCH,19,7,12,-5,3,3,1,3,OTC
4583,12-02-2021 10:00,24 hrs.,wallstreetbets,BFRE,6,0,6,-6,1,1,0,1,OTC
4583,12-02-2021 10:00,24 hrs.,wallstreetbets,BIEL,31,7,24,-17,5,5,1,4,OTC
4583,12-02-2021 10:00,24 hrs.,wallstreetbets,BIGG,6,6,0,6,1,1,0,1,OTC
4583,12-02-2021 10:00,24 hrs.,wallstreetbets,BLDV,18,0,18,-18,3,3,0,2,OTC
4583,12-02-2021 10:00,24 hrs.,wallstreetbets,BLPG,7,7,0,7,1,1,1,1,OTC
4583,12-02-2021 10:00,24 hrs.,wallstreetbets,BLSP,14,0,14,-14,2,2,2,1,OTC
4583,12-02-2021 10:00,24 hrs.,wallstreetbets,BOTH,6,0,6,-6,1,1,0,1,OTC
4583,12-02-2021 10:00,24 hrs.,wallstreetbets,BOTY,37,13,24,-11,6,6,1,5,OTC
4583,12-02-2021 10:00,24 hrs.,wallstreetbets,BRLL,12,0,12,-12,2,2,0,2,OTC
4583,12-02-2021 10:00,24 hrs.,wallstreetbets,BRTX,6,0,6,-6,1,1,0,1,OTC
4583,12-02-2021 10:00,24 hrs.,wallstreetbets,BTCY,6,0,6,-6,1,1,0,1,OTC
4583,12-02-2021 10:00,24 hrs.,wallstreetbets,BUDZ,12,0,12,-12,2,2,0,2,OTC
4583,12-02-2021 10:00,24 hrs.,wallstreetbets,CALI,6,0,6,-6,1,1,0,1,OTC
4583,12-02-2021 10:00,24 hrs.,wallstreetbets,CANN,6,0,6,-6,1,1,0,1,OTC
4583,12-02-2021 10:00,24 hrs.,wallstreetbets,CAPC,6,0,6,-6,1,1,0,1,OTC
4583,12-02-2021 10:00,24 hrs.,wallstreetbets,CATV,6,0,6,-6,1,1,0,1,OTC
4583,12-02-2021 10:00,24 hrs.,wallstreetbets,CBDD,24,0,24,-24,4,4,0,4,OTC
4583,12-02-2021 10:00,24 hrs.,wallstreetbets,CBDL,50,0,50,-50,8,8,2,7,OTC
4583,12-02-2021 10:00,24 hrs.,wallstreetbets,CBGI,12,0,12,-12,2,2,0,1,OTC
4583,12-02-2021 10:00,24 hrs.,wallstreetbets,CBTC,6,0,6,-6,1,1,0,1,OTC
4583,12-02-2021 10:00,24 hrs.,wallstreetbets,CCTL,12,6,6,0,2,2,0,2,OTC
4583,12-02-2021 10:00,24 hrs.,wallstreetbets,CGEI,7,7,0,7,1,1,1,1,OTC
4583,12-02-2021 10:00,24 hrs.,StockMarket,GAXY,22,0,22,-22,1,9,0,1,OTC
4583,12-02-2021 10:00,24 hrs.,StockMarket,GDMK,6,0,6,-6,1,1,0,1,OTC
4583,12-02-2021 10:00,24 hrs.,StockMarket,GTSO,11,0,11,-11,1,3,1,1,OTC
4583,12-02-2021 10:00,24 hrs.,StockMarket,HCMC,22,22,0,22,2,6,2,2,OTC
4583,12-02-2021 10:00,24 hrs.,StockMarket,ISWH,6,0,6,-6,1,1,0,1,OTC
4583,12-02-2021 10:00,24 hrs.,StockMarket,LINK,26,0,26,-26,1,10,2,1,OTC
4583,12-02-2021 10:00,24 hrs.,StockMarket,MJNA,6,0,6,-6,1,1,0,1,OTC
4583,12-02-2021 10:00,24 hrs.,StockMarket,MOST,26,0,26,-26,1,10,2,1,OTC
4583,12-02-2021 10:00,24 hrs.,StockMarket,NSPX,6,0,6,-6,1,1,0,1,OTC
4583,12-02-2021 10:00,24 hrs.,StockMarket,OPMZ,6,0,6,-6,1,1,0,1,OTC
4583,12-02-2021 10:00,24 hrs.,StockMarket,PURA,6,0,6,-6,1,1,0,1,OTC
4583,12-02-2021 10:00,24 hrs.,StockMarket,RLTR,6,6,0,6,1,1,0,1,OTC
4583,12-02-2021 10:00,24 hrs.,StockMarket,ROTH,54,0,54,-54,1,24,2,1,OTC
4583,12-02-2021 10:00,24 hrs.,StockMarket,RTON,12,6,6,0,2,2,0,2,OTC
4583,12-02-2021 10:00,24 hrs.,StockMarket,SGMD,12,0,12,-12,1,2,4,1,OTC
4583,12-02-2021 10:00,24 hrs.,StockMarket,SIRC,6,0,6,-6,1,1,0,1,OTC
4583,12-02-2021 10:00,24 hrs.,StockMarket,SRMX,6,0,6,-6,1,1,0,1,OTC
4583,12-02-2021 10:00,24 hrs.,StockMarket,SUIC,6,6,0,6,1,1,0,1,OTC
4583,12-02-2021 10:00,24 hrs.,StockMarket,VIBI,13,0,13,-13,1,0,9,1,OTC
4583,12-02-2021 10:00,24 hrs.,pennystocks,RCMT,41,0,41,-41,2,7,19,2,NASDAQ
4583,12-02-2021 10:00,24 hrs.,StockMarket,MDLY,6,6,0,6,1,0,2,1,NYSE
4583,12-02-2021 10:00,24 hrs.,StockMarket,PAYC,55,0,55,-55,1,19,13,1,NYSE
4583,12-02-2021 10:00,24 hrs.,StockMarket,PINS,32,0,32,-32,2,11,2,2,NYSE
4583,12-02-2021 10:00,24 hrs.,StockMarket,RLGY,6,0,6,-6,1,1,0,1,NYSE
4583,12-02-2021 10:00,24 hrs.,StockMarket,SPCE,12,0,12,-12,2,2,0,2,NYSE
4583,12-02-2021 10:00,24 hrs.,StockMarket,TEVA,6,0,6,-6,1,1,0,1,NYSE
4583,12-02-2021 10:00,24 hrs.,StockMarket,UBER,81,0,81,-81,2,29,15,2,NYSE
4583,12-02-2021 10:00,24 hrs.,StockMarket,WELL,6,0,6,-6,1,1,0,1,NYSE
4583,12-02-2021 10:00,24 hrs.,StockMarket,XPEV,271,271,0,271,1,120,27,1,NYSE
4583,12-02-2021 10:00,24 hrs.,StockMarket,YETI,6,6,0,6,1,1,0,1,NYSE
4583,12-02-2021 10:00,24 hrs.,StockMarket,AMD,18,18,0,18,2,1,8,2,NASDAQ
4583,12-02-2021 10:00,24 hrs.,StockMarket,API,21,0,21,-21,3,4,1,1,NASDAQ
4583,12-02-2021 10:00,24 hrs.,StockMarket,AQB,4,0,4,-4,1,0,0,1,NASDAQ
4583,12-02-2021 10:00,24 hrs.,StockMarket,AZN,26,0,26,-26,1,10,2,1,NASDAQ
4583,12-02-2021 10:00,24 hrs.,StockMarket,HAS,6,6,0,6,1,1,0,1,NASDAQ
4583,12-02-2021 10:00,24 hrs.,StockMarket,KHC,26,0,26,-26,1,10,2,1,NASDAQ
4583,12-02-2021 10:00,24 hrs.,StockMarket,MGI,7,7,0,7,1,1,1,1,NASDAQ
4583,12-02-2021 10:00,24 hrs.,StockMarket,OGI,65,33,32,1,3,22,9,3,NASDAQ
4583,12-02-2021 10:00,24 hrs.,StockMarket,PEP,26,0,26,-26,1,10,2,1,NASDAQ
4583,12-02-2021 10:00,24 hrs.,StockMarket,QQQ,22,0,22,-22,1,8,2,1,NASDAQ
4583,12-02-2021 10:00,24 hrs.,StockMarket,RCM,207,6,201,-195,2,74,51,2,NASDAQ
4583,12-02-2021 10:00,24 hrs.,StockMarket,SDC,15,0,15,-15,1,3,5,1,NASDAQ
4583,12-02-2021 10:00,24 hrs.,StockMarket,SND,10,10,0,10,1,3,0,1,NASDAQ
4583,12-02-2021 10:00,24 hrs.,StockMarket,VFF,44,0,44,-44,4,13,2,2,NASDAQ
4583,12-02-2021 10:00,24 hrs.,StockMarket,AAOI,6,0,6,-6,1,1,0,1,NASDAQ
4583,12-02-2021 10:00,24 hrs.,StockMarket,XALL,6,0,6,-6,1,1,0,1,OTC
4583,12-02-2021 10:00,24 hrs.,StockMarket,ABEPF,6,0,6,-6,1,1,0,1,OTC
4583,12-02-2021 10:00,24 hrs.,StockMarket,CLUBQ,21,0,21,-21,2,2,9,1,OTC
4583,12-02-2021 10:00,24 hrs.,StockMarket,CWGYF,31,0,31,-31,1,2,23,1,OTC
4583,12-02-2021 10:00,24 hrs.,StockMarket,HITIF,77,0,77,-77,1,19,35,1,OTC
4583,12-02-2021 10:00,24 hrs.,StockMarket,HRVOF,6,0,6,-6,1,1,0,1,OTC
4583,12-02-2021 10:00,24 hrs.,StockMarket,MNKKQ,12,0,12,-12,2,2,0,1,OTC
4583,12-02-2021 10:00,24 hrs.,StockMarket,NXGWF,17,17,0,17,1,6,1,1,OTC
4583,12-02-2021 10:00,24 hrs.,StockMarket,OILFF,4,0,4,-4,1,0,0,1,OTC
4583,12-02-2021 10:00,24 hrs.,StockMarket,RYCEY,14,6,8,-2,2,1,4,2,OTC
4583,12-02-2021 10:00,24 hrs.,StockMarket,DNN,20,20,0,20,1,4,8,1,AMEX
4583,12-02-2021 10:00,24 hrs.,StockMarket,GSV,31,0,31,-31,1,4,19,1,AMEX
4583,12-02-2021 10:00,24 hrs.,StockMarket,IGC,16,0,16,-16,1,5,2,1,AMEX
4583,12-02-2021 10:00,24 hrs.,StockMarket,ITP,8,8,0,8,1,1,2,1,AMEX
4583,12-02-2021 10:00,24 hrs.,StockMarket,MCF,6,0,6,-6,1,1,0,1,AMEX
4583,12-02-2021 10:00,24 hrs.,StockMarket,NAK,6,0,6,-6,1,1,0,1,AMEX
4583,12-02-2021 10:00,24 hrs.,StockMarket,REI,10,10,0,10,1,3,0,1,AMEX
4583,12-02-2021 10:00,24 hrs.,StockMarket,URG,20,20,0,20,1,4,8,1,AMEX
4583,12-02-2021 10:00,24 hrs.,StockMarket,ZOM,63,57,6,51,4,13,21,4,AMEX
4583,12-02-2021 10:00,24 hrs.,StockMarket,GSAT,6,0,6,-6,1,1,0,1,AMEX
4583,12-02-2021 10:00,24 hrs.,StockMarket,NSPR,25,0,25,-25,1,7,7,1,AMEX
4583,12-02-2021 10:00,24 hrs.,StockMarket,RLGT,6,6,0,6,1,1,0,1,AMEX
4583,12-02-2021 10:00,24 hrs.,StockMarket,UUUU,20,20,0,20,1,4,8,1,AMEX
4583,12-02-2021 10:00,24 hrs.,StockMarket,ACB,26,0,26,-26,1,10,2,1,NYSE
4583,12-02-2021 10:00,24 hrs.,StockMarket,ACI,6,0,6,-6,1,1,0,1,NYSE
4583,12-02-2021 10:00,24 hrs.,StockMarket,AHC,15,0,15,-15,1,3,5,1,NYSE
4583,12-02-2021 10:00,24 hrs.,StockMarket,ALV,11,11,0,11,1,1,5,1,NYSE
4583,12-02-2021 10:00,24 hrs.,StockMarket,AMC,157,116,41,75,9,55,11,8,NYSE
4583,12-02-2021 10:00,24 hrs.,StockMarket,CHL,6,0,6,-6,1,1,0,1,NYSE
4583,12-02-2021 10:00,24 hrs.,StockMarket,CIA,271,271,0,271,1,120,27,1,NYSE
4583,12-02-2021 10:00,24 hrs.,StockMarket,CMI,55,0,55,-55,1,19,13,1,NYSE
4583,12-02-2021 10:00,24 hrs.,StockMarket,DAC,4,0,4,-4,1,0,0,1,NYSE
4583,12-02-2021 10:00,24 hrs.,StockMarket,FAF,6,6,0,6,1,1,0,1,NYSE
4583,12-02-2021 10:00,24 hrs.,StockMarket,GME,350,236,114,122,14,119,56,14,NYSE
4583,12-02-2021 10:00,24 hrs.,StockMarket,HRL,26,0,26,-26,1,10,2,1,NYSE
4583,12-02-2021 10:00,24 hrs.,StockMarket,IBM,271,271,0,271,1,120,27,1,NYSE
4583,12-02-2021 10:00,24 hrs.,StockMarket,KGC,6,0,6,-6,1,1,0,1,NYSE
4583,12-02-2021 10:00,24 hrs.,StockMarket,LAC,12,6,6,0,2,2,0,2,NYSE
4583,12-02-2021 10:00,24 hrs.,StockMarket,LMT,13,13,0,13,1,2,5,1,NYSE
4583,12-02-2021 10:00,24 hrs.,pennystocks,AMNL,1682,0,1682,-1682,1,742,194,1,OTC
4583,12-02-2021 10:00,24 hrs.,pennystocks,APEX,116,0,116,-116,1,40,32,1,OTC
4583,12-02-2021 10:00,24 hrs.,pennystocks,ASTI,53,0,53,-53,6,11,7,5,OTC
4583,12-02-2021 10:00,24 hrs.,pennystocks,ATVK,23,0,23,-23,1,9,1,1,OTC
4583,12-02-2021 10:00,24 hrs.,pennystocks,AXXA,12,0,12,-12,2,2,0,2,OTC
4583,12-02-2021 10:00,24 hrs.,pennystocks,AZFL,62,56,6,50,4,6,34,3,OTC
4583,12-02-2021 10:00,24 hrs.,pennystocks,BANT,11,11,0,11,1,0,7,1,OTC
4583,12-02-2021 10:00,24 hrs.,StockMarket,AAPL,61,0,61,-61,2,20,13,2,NASDAQ
4583,12-02-2021 10:00,24 hrs.,StockMarket,ABIO,6,0,6,-6,1,1,0,1,NASDAQ
4583,12-02-2021 10:00,24 hrs.,StockMarket,ACIU,201,0,201,-201,1,73,51,1,NASDAQ
4583,12-02-2021 10:00,24 hrs.,StockMarket,AEZS,6,6,0,6,1,1,0,1,NASDAQ
4583,12-02-2021 10:00,24 hrs.,StockMarket,AGTC,73,0,73,-73,2,20,25,2,NASDAQ
4583,12-02-2021 10:00,24 hrs.,StockMarket,APHA,722,34,688,-654,8,231,228,7,NASDAQ
4583,12-02-2021 10:00,24 hrs.,StockMarket,ASYS,4,0,4,-4,1,0,0,1,NASDAQ
4583,12-02-2021 10:00,24 hrs.,StockMarket,ATOM,26,0,26,-26,1,10,2,1,NASDAQ
4583,12-02-2021 10:00,24 hrs.,StockMarket,ATOS,7,7,0,7,1,1,1,1,NASDAQ
4583,12-02-2021 10:00,24 hrs.,StockMarket,AVXL,6,0,6,-6,1,1,0,1,NASDAQ
4583,12-02-2021 10:00,24 hrs.,StockMarket,BBBY,6,0,6,-6,1,1,0,1,NASDAQ
4583,12-02-2021 10:00,24 hrs.,StockMarket,BSQR,17,0,17,-17,1,1,11,1,NASDAQ
4583,12-02-2021 10:00,24 hrs.,StockMarket,CECE,10,10,0,10,1,3,0,1,NASDAQ
4583,12-02-2021 10:00,24 hrs.,StockMarket,CLNE,55,0,55,-55,1,19,13,1,NASDAQ
4583,12-02-2021 10:00,24 hrs.,StockMarket,CLSK,8,8,0,8,1,1,2,1,NASDAQ
4583,12-02-2021 10:00,24 hrs.,StockMarket,CLSN,207,0,207,-207,2,74,51,2,NASDAQ
4583,12-02-2021 10:00,24 hrs.,StockMarket,CRSP,6,6,0,6,1,1,0,1,NASDAQ
4583,12-02-2021 10:00,24 hrs.,StockMarket,CTHR,14,14,0,14,1,4,2,1,NASDAQ
4583,12-02-2021 10:00,24 hrs.,StockMarket,CTRM,262,0,262,-262,7,86,62,7,NASDAQ
4583,12-02-2021 10:00,24 hrs.,StockMarket,ENTX,8,8,0,8,1,2,0,1,NASDAQ
4583,12-02-2021 10:00,24 hrs.,StockMarket,FANG,71,0,71,-71,1,27,13,1,NASDAQ
4583,12-02-2021 10:00,24 hrs.,StockMarket,FNKO,23,23,0,23,1,7,5,1,NASDAQ
4583,12-02-2021 10:00,24 hrs.,StockMarket,GRWG,10,0,10,-10,2,1,0,2,NASDAQ
4583,12-02-2021 10:00,24 hrs.,StockMarket,HTBX,6,6,0,6,1,1,0,1,NASDAQ
4583,12-02-2021 10:00,24 hrs.,StockMarket,IBKR,6,0,6,-6,1,1,0,1,NASDAQ
4583,12-02-2021 10:00,24 hrs.,StockMarket,IMMR,4,0,4,-4,1,0,0,1,NASDAQ
4583,12-02-2021 10:00,24 hrs.,StockMarket,INMD,55,0,55,-55,1,19,13,1,NASDAQ
4583,12-02-2021 10:00,24 hrs.,StockMarket,INVE,21,21,0,21,2,5,3,1,NASDAQ
4583,12-02-2021 10:00,24 hrs.,StockMarket,IRBT,26,0,26,-26,1,10,2,1,NASDAQ
4583,12-02-2021 10:00,24 hrs.,StockMarket,LAZR,6,6,0,6,1,1,0,1,NASDAQ
4583,12-02-2021 10:00,24 hrs.,StockMarket,LGND,6,6,0,6,1,1,0,1,NASDAQ
4583,12-02-2021 10:00,24 hrs.,StockMarket,LIFE,765,765,0,765,1,368,25,1,NASDAQ
4583,12-02-2021 10:00,24 hrs.,StockMarket,LIVE,26,0,26,-26,1,10,2,1,NASDAQ
4583,12-02-2021 10:00,24 hrs.,StockMarket,LYFT,55,0,55,-55,1,19,13,1,NASDAQ
4583,12-02-2021 10:00,24 hrs.,StockMarket,MGNI,4,0,4,-4,1,0,0,1,NASDAQ
4583,12-02-2021 10:00,24 hrs.,StockMarket,NSA,271,271,0,271,1,120,27,1,NYSE
4583,12-02-2021 10:00,24 hrs.,StockMarket,PDT,14,14,0,14,1,4,2,1,NYSE
4583,12-02-2021 10:00,24 hrs.,StockMarket,PFE,7,0,7,-7,1,1,1,1,NYSE
4583,12-02-2021 10:00,24 hrs.,StockMarket,QSR,26,0,26,-26,1,10,2,1,NYSE
4583,12-02-2021 10:00,24 hrs.,StockMarket,RMO,7,0,7,-7,1,0,3,1,NYSE
4583,12-02-2021 10:00,24 hrs.,StockMarket,RSI,6,6,0,6,1,1,0,1,NYSE
4583,12-02-2021 10:00,24 hrs.,StockMarket,SBE,6,0,6,-6,1,1,0,1,NYSE
4583,12-02-2021 10:00,24 hrs.,StockMarket,SKY,30,0,30,-30,1,8,10,1,NYSE
4583,12-02-2021 10:00,24 hrs.,StockMarket,SOS,18,6,12,-6,3,3,0,2,NYSE
4583,12-02-2021 10:00,24 hrs.,StockMarket,TAP,26,0,26,-26,1,10,2,1,NYSE
4583,12-02-2021 10:00,24 hrs.,StockMarket,TMX,4,0,4,-4,1,0,0,1,NYSE
4583,12-02-2021 10:00,24 hrs.,StockMarket,TPX,26,0,26,-26,1,10,2,1,NYSE
4583,12-02-2021 10:00,24 hrs.,StockMarket,TSE,29,29,0,29,2,10,1,2,NYSE
4583,12-02-2021 10:00,24 hrs.,StockMarket,TTM,19,19,0,19,1,3,9,1,NYSE
4583,12-02-2021 10:00,24 hrs.,StockMarket,UBS,55,0,55,-55,1,19,13,1,NYSE
4583,12-02-2021 10:00,24 hrs.,StockMarket,XPO,26,0,26,-26,1,10,2,1,NYSE
4583,12-02-2021 10:00,24 hrs.,StockMarket,ACIC,4,0,4,-4,1,0,0,1,NYSE
4583,12-02-2021 10:00,24 hrs.,StockMarket,AVLR,55,0,55,-55,1,19,13,1,NYSE
4583,12-02-2021 10:00,24 hrs.,StockMarket,CACI,271,271,0,271,1,120,27,1,NYSE
4583,12-02-2021 10:00,24 hrs.,StockMarket,CCIV,43,0,43,-43,1,14,11,1,NYSE
4583,12-02-2021 10:00,24 hrs.,StockMarket,GLOP,4,0,4,-4,1,0,0,1,NYSE
4583,12-02-2021 10:00,24 hrs.,StockMarket,GNRC,26,0,26,-26,1,10,2,1,NYSE
4583,12-02-2021 10:00,24 hrs.,pennystocks,BRLL,36,0,36,-36,4,4,12,3,OTC
4583,12-02-2021 10:00,24 hrs.,pennystocks,BRRN,1682,0,1682,-1682,1,742,194,1,OTC
4583,12-02-2021 10:00,24 hrs.,pennystocks,BTCS,7,0,7,-7,1,1,1,1,OTC
4583,12-02-2021 10:00,24 hrs.,pennystocks,BTSC,13,0,13,-13,2,2,1,1,OTC
4583,12-02-2021 10:00,24 hrs.,pennystocks,BWMG,10,0,10,-10,1,2,2,1,OTC
4583,12-02-2021 10:00,24 hrs.,pennystocks,BXNG,21,21,0,21,1,2,13,1,OTC
4583,12-02-2021 10:00,24 hrs.,pennystocks,CAPC,279,0,279,-279,1,114,47,1,OTC
4583,12-02-2021 10:00,24 hrs.,pennystocks,CATV,6,0,6,-6,1,1,0,1,OTC
4583,12-02-2021 10:00,24 hrs.,pennystocks,CBBT,416,266,150,116,14,123,114,13,OTC
4583,12-02-2021 10:00,24 hrs.,pennystocks,CBDD,112,57,55,2,6,34,20,6,OTC
4583,12-02-2021 10:00,24 hrs.,pennystocks,CBDL,177,157,20,137,5,35,87,5,OTC
4583,12-02-2021 10:00,24 hrs.,pennystocks,CBDS,6,0,6,-6,1,1,0,1,OTC
4583,12-02-2021 10:00,24 hrs.,pennystocks,CBGI,6,0,6,-6,1,1,0,1,OTC
4583,12-02-2021 10:00,24 hrs.,pennystocks,CBTC,7,0,7,-7,1,1,1,1,OTC
4583,12-02-2021 10:00,24 hrs.,pennystocks,CCTL,6,0,6,-6,1,1,0,1,OTC
4583,12-02-2021 10:00,24 hrs.,pennystocks,CETY,29,0,29,-29,2,10,1,2,OTC
4583,12-02-2021 10:00,24 hrs.,pennystocks,CHUC,6,0,6,-6,1,1,0,1,OTC
4583,12-02-2021 10:00,24 hrs.,pennystocks,CLHI,19,0,19,-19,1,5,5,1,OTC
4583,12-02-2021 10:00,24 hrs.,pennystocks,CLIS,6,6,0,6,1,1,0,1,OTC
4583,12-02-2021 10:00,24 hrs.,StockMarket,MNPR,201,0,201,-201,1,73,51,1,NASDAQ
4583,12-02-2021 10:00,24 hrs.,StockMarket,MSFT,48,0,48,-48,2,18,4,2,NASDAQ
4583,12-02-2021 10:00,24 hrs.,StockMarket,MSTR,12,12,0,12,2,2,0,1,NASDAQ
4583,12-02-2021 10:00,24 hrs.,StockMarket,MVIS,26,0,26,-26,1,10,2,1,NASDAQ
4583,12-02-2021 10:00,24 hrs.,StockMarket,OCGN,12,0,12,-12,2,2,0,1,NASDAQ
4583,12-02-2021 10:00,24 hrs.,StockMarket,OPTT,26,0,26,-26,1,7,8,1,NASDAQ
4583,12-02-2021 10:00,24 hrs.,StockMarket,PACB,6,6,0,6,1,1,0,1,NASDAQ
4583,12-02-2021 10:00,24 hrs.,StockMarket,PLUG,4,0,4,-4,1,0,0,1,NASDAQ
4583,12-02-2021 10:00,24 hrs.,StockMarket,PRCH,4,0,4,-4,1,0,0,1,NASDAQ
4583,12-02-2021 10:00,24 hrs.,StockMarket,PTGX,12,0,12,-12,2,2,0,1,NASDAQ
4583,12-02-2021 10:00,24 hrs.,StockMarket,PYPL,6,6,0,6,1,1,0,1,NASDAQ
4583,12-02-2021 10:00,24 hrs.,StockMarket,QELL,26,0,26,-26,1,10,2,1,NASDAQ
4583,12-02-2021 10:00,24 hrs.,StockMarket,RCMT,207,6,201,-195,2,74,51,2,NASDAQ
4583,12-02-2021 10:00,24 hrs.,StockMarket,RIGL,6,6,0,6,1,1,0,1,NASDAQ
4583,12-02-2021 10:00,24 hrs.,StockMarket,RIOT,201,0,201,-201,1,73,51,1,NASDAQ
4583,12-02-2021 10:00,24 hrs.,StockMarket,SLRX,6,0,6,-6,1,1,0,1,NASDAQ
4583,12-02-2021 10:00,24 hrs.,StockMarket,SNDL,11567,374,11193,-10819,25,5219,1029,24,NASDAQ
4583,12-02-2021 10:00,24 hrs.,StockMarket,SONO,81,0,81,-81,2,29,15,2,NASDAQ
4583,12-02-2021 10:00,24 hrs.,StockMarket,SRNE,18,0,18,-18,3,3,0,2,NASDAQ
4583,12-02-2021 10:00,24 hrs.,StockMarket,TELL,6,0,6,-6,1,1,0,1,NASDAQ
4583,12-02-2021 10:00,24 hrs.,StockMarket,TLRY,938,67,871,-804,14,304,274,13,NASDAQ
4583,12-02-2021 10:00,24 hrs.,StockMarket,TLSA,6,6,0,6,1,1,0,1,NASDAQ
4583,12-02-2021 10:00,24 hrs.,StockMarket,TNXP,56,0,56,-56,1,23,6,1,NASDAQ
4583,12-02-2021 10:00,24 hrs.,StockMarket,TSLA,35,0,35,-35,3,9,5,3,NASDAQ
4583,12-02-2021 10:00,24 hrs.,StockMarket,TXMD,6,0,6,-6,1,1,0,1,NASDAQ
4583,12-02-2021 10:00,24 hrs.,StockMarket,USWS,6,0,6,-6,1,1,0,1,NASDAQ
4583,12-02-2021 10:00,24 hrs.,StockMarket,VRAY,20,0,20,-20,3,3,2,2,NASDAQ
4583,12-02-2021 10:00,24 hrs.,StockMarket,VXRT,14,14,0,14,1,4,2,1,NASDAQ
4583,12-02-2021 10:00,24 hrs.,StockMarket,ZNGA,60,6,54,-48,4,18,8,3,NASDAQ
4583,12-02-2021 10:00,24 hrs.,StockMarket,UONEK,6,0,6,-6,1,1,0,1,NASDAQ
4583,12-02-2021 10:00,24 hrs.,pennystocks,AABB,18,18,0,18,3,3,0,2,OTC
4583,12-02-2021 10:00,24 hrs.,pennystocks,ABML,82,0,82,-82,1,31,16,1,OTC
4583,12-02-2021 10:00,24 hrs.,pennystocks,ABQQ,29,0,29,-29,2,10,1,2,OTC
4583,12-02-2021 10:00,24 hrs.,pennystocks,ABVG,7,0,7,-7,1,1,1,1,OTC
4583,12-02-2021 10:00,24 hrs.,pennystocks,ACRL,42,0,42,-42,2,12,10,2,OTC
4583,12-02-2021 10:00,24 hrs.,pennystocks,ADGO,14,14,0,14,1,2,6,1,OTC
4583,12-02-2021 10:00,24 hrs.,pennystocks,ADTM,109,90,19,71,4,30,33,4,OTC
4583,12-02-2021 10:00,24 hrs.,pennystocks,AEPT,6,6,0,6,1,1,0,1,OTC
4583,12-02-2021 10:00,24 hrs.,pennystocks,AGTK,7,0,7,-7,1,1,1,1,OTC
4583,12-02-2021 10:00,24 hrs.,pennystocks,AHFD,6,6,0,6,1,1,0,1,OTC
4583,12-02-2021 10:00,24 hrs.,pennystocks,AITX,203,163,40,123,5,47,89,5,OTC
4583,12-02-2021 10:00,24 hrs.,pennystocks,ALKM,19,19,0,19,3,3,1,1,OTC
4583,12-02-2021 10:00,24 hrs.,pennystocks,ALLM,6,0,6,-6,1,1,0,1,OTC
4583,12-02-2021 10:00,24 hrs.,pennystocks,ALPP,34,0,34,-34,4,4,10,4,OTC
4583,12-02-2021 10:00,24 hrs.,pennystocks,ALYI,154,110,44,66,3,51,40,3,OTC
4583,12-02-2021 10:00,24 hrs.,pennystocks,CTLE,6,6,0,6,1,1,0,1,OTC
4583,12-02-2021 10:00,24 hrs.,pennystocks,CVAT,6,0,6,-6,1,1,0,1,OTC
4583,12-02-2021 10:00,24 hrs.,pennystocks,CYPW,6,6,0,6,1,1,0,1,OTC
4583,12-02-2021 10:00,24 hrs.,pennystocks,DGMA,6,6,0,6,1,1,0,1,OTC
4583,12-02-2021 10:00,24 hrs.,pennystocks,DGTW,6,0,6,-6,1,1,0,1,OTC
4583,12-02-2021 10:00,24 hrs.,pennystocks,DIGI,13,13,0,13,2,2,1,1,OTC
4583,12-02-2021 10:00,24 hrs.,pennystocks,DPLS,247,241,6,235,6,62,99,5,OTC
4583,12-02-2021 10:00,24 hrs.,pennystocks,DRWN,7,0,7,-7,1,1,1,1,OTC
4583,12-02-2021 10:00,24 hrs.,pennystocks,DSGT,7,0,7,-7,1,1,1,1,OTC
4583,12-02-2021 10:00,24 hrs.,pennystocks,DTST,41,0,41,-41,2,11,11,2,OTC
4583,12-02-2021 10:00,24 hrs.,pennystocks,ECCI,6,6,0,6,1,1,0,1,OTC
4583,12-02-2021 10:00,24 hrs.,pennystocks,ECEZ,205,123,82,41,8,62,49,6,OTC
4583,12-02-2021 10:00,24 hrs.,pennystocks,EDXC,14,0,14,-14,2,2,2,2,OTC
4583,12-02-2021 10:00,24 hrs.,pennystocks,EHOS,7,0,7,-7,1,1,1,1,OTC
4583,12-02-2021 10:00,24 hrs.,pennystocks,ELCR,13,0,13,-13,2,2,1,2,OTC
4583,12-02-2021 10:00,24 hrs.,pennystocks,ELRA,6,0,6,-6,1,1,0,1,OTC
4583,12-02-2021 10:00,24 hrs.,pennystocks,ENCS,6,6,0,6,1,1,0,1,OTC
4583,12-02-2021 10:00,24 hrs.,pennystocks,ENDV,6,6,0,6,1,1,0,1,OTC
4583,12-02-2021 10:00,24 hrs.,pennystocks,ENTI,13,0,13,-13,2,2,1,1,OTC
4583,12-02-2021 10:00,24 hrs.,pennystocks,ENZC,13,0,13,-13,2,2,1,1,OTC
4583,12-02-2021 10:00,24 hrs.,pennystocks,EPAZ,139,0,139,-139,3,48,31,2,OTC
4583,12-02-2021 10:00,24 hrs.,pennystocks,ERBB,13,0,13,-13,2,2,1,2,OTC
4583,12-02-2021 10:00,24 hrs.,pennystocks,ETFM,1802,96,1706,-1610,5,771,240,5,OTC
4583,12-02-2021 10:00,24 hrs.,pennystocks,EUOT,7,0,7,-7,1,1,1,1,OTC
4583,12-02-2021 10:00,24 hrs.,pennystocks,EVSV,6,0,6,-6,1,1,0,1,OTC
4583,12-02-2021 10:00,24 hrs.,pennystocks,EWLL,12,0,12,-12,2,2,0,1,OTC
4583,12-02-2021 10:00,24 hrs.,pennystocks,EXMT,19,0,19,-19,2,4,3,2,OTC
4583,12-02-2021 10:00,24 hrs.,pennystocks,FDBH,7,7,0,7,1,1,1,1,OTC
4583,12-02-2021 10:00,24 hrs.,pennystocks,FMCC,116,0,116,-116,1,40,32,1,OTC
4583,12-02-2021 10:00,24 hrs.,pennystocks,FNMA,116,0,116,-116,1,40,32,1,OTC
4583,12-02-2021 10:00,24 hrs.,pennystocks,FPVD,15,9,6,3,2,3,1,2,OTC
4583,12-02-2021 10:00,24 hrs.,pennystocks,FTFY,6,6,0,6,1,1,0,1,OTC
4583,12-02-2021 10:00,24 hrs.,pennystocks,FUTL,7,7,0,7,1,1,1,1,OTC
4583,12-02-2021 10:00,24 hrs.,pennystocks,FWAV,6,0,6,-6,1,1,0,1,OTC
4583,12-02-2021 10:00,24 hrs.,pennystocks,GAHC,41,0,41,-41,1,11,15,1,OTC
4583,12-02-2021 10:00,24 hrs.,pennystocks,GARB,12,0,12,-12,2,2,0,2,OTC
4583,12-02-2021 10:00,24 hrs.,pennystocks,GAXY,110,0,110,-110,2,29,44,2,OTC
4583,12-02-2021 10:00,24 hrs.,pennystocks,GDET,13,7,6,1,2,2,1,2,OTC
4583,12-02-2021 10:00,24 hrs.,pennystocks,GEGI,6,0,6,-6,1,1,0,1,OTC
4583,12-02-2021 10:00,24 hrs.,pennystocks,GLGI,116,0,116,-116,1,40,32,1,OTC
4583,12-02-2021 10:00,24 hrs.,pennystocks,GMER,6,0,6,-6,1,1,0,1,OTC
4583,12-02-2021 10:00,24 hrs.,pennystocks,GMEV,535,529,6,523,2,211,105,2,OTC
4583,12-02-2021 10:00,24 hrs.,pennystocks,GMPR,6,0,6,-6,1,1,0,1,OTC
4583,12-02-2021 10:00,24 hrs.,pennystocks,GNCP,10,10,0,10,1,1,4,1,OTC
4583,12-02-2021 10:00,24 hrs.,pennystocks,GPFT,35,22,13,9,3,7,9,3,OTC
4583,12-02-2021 10:00,24 hrs.,pennystocks,GRCU,6,6,0,6,1,1,0,1,OTC
4583,12-02-2021 10:00,24 hrs.,pennystocks,GRCV,6,0,6,-6,1,1,0,1,OTC
4583,12-02-2021 10:00,24 hrs.,pennystocks,GTCH,43,36,7,29,5,8,7,2,OTC
4583,12-02-2021 10:00,24 hrs.,pennystocks,GTEH,156,82,74,8,6,53,26,6,OTC
4583,12-02-2021 10:00,24 hrs.,pennystocks,GTLL,57,24,33,-9,2,18,13,2,OTC
4583,12-02-2021 10:00,24 hrs.,pennystocks,BBDA,7,0,7,-7,1,1,1,1,OTC
4583,12-02-2021 10:00,24 hrs.,pennystocks,BBRW,6,0,6,-6,1,1,0,1,OTC
4583,12-02-2021 10:00,24 hrs.,pennystocks,BCCI,7,7,0,7,1,1,1,1,OTC
4583,12-02-2021 10:00,24 hrs.,pennystocks,BDGR,19,0,19,-19,3,3,1,2,OTC
4583,12-02-2021 10:00,24 hrs.,pennystocks,BFCH,1691,0,1691,-1691,2,744,195,2,OTC
4583,12-02-2021 10:00,24 hrs.,pennystocks,BKMP,6,6,0,6,1,1,0,1,OTC
4583,12-02-2021 10:00,24 hrs.,pennystocks,BLDV,132,90,42,48,8,34,32,7,OTC
4583,12-02-2021 10:00,24 hrs.,pennystocks,BLLB,6,0,6,-6,1,1,0,1,OTC
4583,12-02-2021 10:00,24 hrs.,pennystocks,BLSP,92,7,85,-78,4,20,36,4,OTC
4583,12-02-2021 10:00,24 hrs.,pennystocks,BMIX,38,31,7,24,2,5,20,2,OTC
4583,12-02-2021 10:00,24 hrs.,pennystocks,BNGI,19,0,19,-19,3,3,1,1,OTC
4583,12-02-2021 10:00,24 hrs.,pennystocks,BOTY,122,116,6,110,6,32,34,5,OTC
4583,12-02-2021 10:00,24 hrs.,pennystocks,BRAV,6,0,6,-6,1,1,0,1,OTC
4583,12-02-2021 10:00,24 hrs.,pennystocks,BRGO,12,12,0,12,1,3,2,1,OTC
4583,12-02-2021 10:00,24 hrs.,pennystocks,NBVG,6,0,6,-6,1,1,0,1,OTC
4583,12-02-2021 10:00,24 hrs.,pennystocks,NPHC,52,0,52,-52,3,11,18,2,OTC
4583,12-02-2021 10:00,24 hrs.,pennystocks,NSAV,39,0,39,-39,2,6,19,2,OTC
4583,12-02-2021 10:00,24 hrs.,pennystocks,NSEO,6,6,0,6,1,1,0,1,OTC
4583,12-02-2021 10:00,24 hrs.,pennystocks,NSPX,14,0,14,-14,2,2,2,2,OTC
4583,12-02-2021 10:00,24 hrs.,pennystocks,NUKK,7,0,7,-7,1,1,1,1,OTC
4583,12-02-2021 10:00,24 hrs.,pennystocks,NVNT,5,0,5,-5,1,0,1,1,OTC
4583,12-02-2021 10:00,24 hrs.,pennystocks,NWPN,6,0,6,-6,1,1,0,1,OTC
4583,12-02-2021 10:00,24 hrs.,pennystocks,OPTI,41,0,41,-41,4,12,1,4,OTC
4583,12-02-2021 10:00,24 hrs.,pennystocks,OPVS,6,0,6,-6,1,1,0,1,OTC
4583,12-02-2021 10:00,24 hrs.,pennystocks,OWCP,7,0,7,-7,1,1,1,1,OTC
4583,12-02-2021 10:00,24 hrs.,pennystocks,OZSC,210,187,23,164,4,51,92,4,OTC
4583,12-02-2021 10:00,24 hrs.,pennystocks,PAOG,42,0,42,-42,2,14,6,2,OTC
4583,12-02-2021 10:00,24 hrs.,pennystocks,PASO,227,62,165,-103,5,70,67,5,OTC
4583,12-02-2021 10:00,24 hrs.,pennystocks,PHIL,6,0,6,-6,1,1,0,1,OTC
4583,12-02-2021 10:00,24 hrs.,pennystocks,PLSB,6,6,0,6,1,1,0,1,OTC
4583,12-02-2021 10:00,24 hrs.,pennystocks,PMCB,19,0,19,-19,3,3,1,1,OTC
4583,12-02-2021 10:00,24 hrs.,pennystocks,PMDP,6,0,6,-6,1,1,0,1,OTC
4583,12-02-2021 10:00,24 hrs.,pennystocks,PPJE,14,0,14,-14,2,2,2,2,OTC
4583,12-02-2021 10:00,24 hrs.,pennystocks,PRPM,6,0,6,-6,1,1,0,1,OTC
4583,12-02-2021 10:00,24 hrs.,pennystocks,PSYC,282,0,282,-282,6,103,52,3,OTC
4583,12-02-2021 10:00,24 hrs.,pennystocks,PUGE,94,6,88,-82,2,29,28,2,OTC
4583,12-02-2021 10:00,24 hrs.,pennystocks,PVDG,1682,0,1682,-1682,1,742,194,1,OTC
4583,12-02-2021 10:00,24 hrs.,pennystocks,PZOO,7,7,0,7,1,1,1,1,OTC
4583,12-02-2021 10:00,24 hrs.,pennystocks,QEBR,6,0,6,-6,1,1,0,1,OTC
4583,12-02-2021 10:00,24 hrs.,pennystocks,QMCI,6,0,6,-6,1,1,0,1,OTC
4583,12-02-2021 10:00,24 hrs.,pennystocks,QPRC,13,0,13,-13,2,2,1,1,OTC
4583,12-02-2021 10:00,24 hrs.,pennystocks,RELI,27,0,27,-27,1,6,11,1,OTC
4583,12-02-2021 10:00,24 hrs.,pennystocks,RITE,31,31,0,31,1,4,19,1,OTC
4583,12-02-2021 10:00,24 hrs.,pennystocks,HCMC,300,62,238,-176,43,56,16,35,OTC
4583,12-02-2021 10:00,24 hrs.,pennystocks,HCYT,12,0,12,-12,2,2,0,1,OTC
4583,12-02-2021 10:00,24 hrs.,pennystocks,HEMP,39,7,32,-25,6,6,3,6,OTC
4583,12-02-2021 10:00,24 hrs.,pennystocks,HIPH,1211,35,1176,-1141,6,532,123,4,OTC
4583,12-02-2021 10:00,24 hrs.,pennystocks,HMNY,1702,0,1702,-1702,4,745,196,4,OTC
4583,12-02-2021 10:00,24 hrs.,pennystocks,HPMM,17,0,17,-17,2,2,5,2,OTC
4583,12-02-2021 10:00,24 hrs.,pennystocks,HPTY,188,0,188,-188,2,63,54,2,OTC
4583,12-02-2021 10:00,24 hrs.,pennystocks,HQGE,19,6,13,-7,3,3,1,3,OTC
4583,12-02-2021 10:00,24 hrs.,pennystocks,HRTH,116,0,116,-116,1,40,32,1,OTC
4583,12-02-2021 10:00,24 hrs.,pennystocks,HYII,7,7,0,7,1,1,1,1,OTC
4583,12-02-2021 10:00,24 hrs.,pennystocks,HYSR,1810,122,1688,-1566,5,782,226,5,OTC
4583,12-02-2021 10:00,24 hrs.,pennystocks,IBRC,10,0,10,-10,1,2,2,1,OTC
4583,12-02-2021 10:00,24 hrs.,pennystocks,ICBU,7,0,7,-7,1,1,1,1,OTC
4583,12-02-2021 10:00,24 hrs.,pennystocks,ICLD,12,0,12,-12,2,2,0,1,OTC
4583,12-02-2021 10:00,24 hrs.,pennystocks,IDCN,6,0,6,-6,1,1,0,1,OTC
4583,12-02-2021 10:00,24 hrs.,pennystocks,IDGC,8,0,8,-8,1,1,2,1,OTC
4583,12-02-2021 10:00,24 hrs.,pennystocks,ILUS,6,0,6,-6,1,1,0,1,OTC
4583,12-02-2021 10:00,24 hrs.,pennystocks,IMJX,6,6,0,6,1,1,0,1,OTC
4583,12-02-2021 10:00,24 hrs.,pennystocks,IMTL,6,0,6,-6,1,1,0,1,OTC
4583,12-02-2021 10:00,24 hrs.,pennystocks,INCT,7,7,0,7,1,1,1,1,OTC
4583,12-02-2021 10:00,24 hrs.,pennystocks,INIS,23,0,23,-23,1,9,1,1,OTC
4583,12-02-2021 10:00,24 hrs.,pennystocks,INKW,60,6,54,-48,7,15,2,7,OTC
4583,12-02-2021 10:00,24 hrs.,pennystocks,INND,113,78,35,43,8,24,33,8,OTC
4583,12-02-2021 10:00,24 hrs.,pennystocks,INTV,7,0,7,-7,1,1,1,1,OTC
4583,12-02-2021 10:00,24 hrs.,pennystocks,INVU,6,6,0,6,1,1,0,1,OTC
4583,12-02-2021 10:00,24 hrs.,pennystocks,IONI,23,0,23,-23,1,9,1,1,OTC
4583,12-02-2021 10:00,24 hrs.,pennystocks,IPIX,54,54,0,54,1,9,32,1,OTC
4583,12-02-2021 10:00,24 hrs.,pennystocks,IPSI,6,6,0,6,1,1,0,1,OTC
4583,12-02-2021 10:00,24 hrs.,pennystocks,IQST,12,0,12,-12,2,2,0,2,OTC
4583,12-02-2021 10:00,24 hrs.,pennystocks,CLWD,43,0,43,-43,3,15,1,3,OTC
4583,12-02-2021 10:00,24 hrs.,pennystocks,CNNA,23,23,0,23,2,2,11,2,OTC
4583,12-02-2021 10:00,24 hrs.,pennystocks,CNXS,6,0,6,-6,1,1,0,1,OTC
4583,12-02-2021 10:00,24 hrs.,pennystocks,COMS,26,0,26,-26,1,4,14,1,OTC
4583,12-02-2021 10:00,24 hrs.,pennystocks,CORG,149,12,137,-125,8,29,59,4,OTC
4583,12-02-2021 10:00,24 hrs.,pennystocks,COUV,1682,0,1682,-1682,1,742,194,1,OTC
4583,12-02-2021 10:00,24 hrs.,wallstreetbets,TECH,7,0,7,-7,1,1,1,1,NASDAQ
4583,12-02-2021 10:00,24 hrs.,wallstreetbets,TELL,8612,8606,6,8600,3,4043,514,3,NASDAQ
4583,12-02-2021 10:00,24 hrs.,wallstreetbets,THBR,25,13,12,1,4,4,1,4,NASDAQ
4583,12-02-2021 10:00,24 hrs.,wallstreetbets,THCB,10,0,10,-10,2,1,0,2,NASDAQ
4583,12-02-2021 10:00,24 hrs.,wallstreetbets,THMO,18,0,18,-18,3,3,0,1,NASDAQ
4583,12-02-2021 10:00,24 hrs.,wallstreetbets,TIGR,13,7,6,1,2,2,1,2,NASDAQ
4583,12-02-2021 10:00,24 hrs.,wallstreetbets,TLGT,6,0,6,-6,1,1,0,1,NASDAQ
4583,12-02-2021 10:00,24 hrs.,wallstreetbets,TLRY,110261,45079,65182,-20103,226,50770,7817,188,NASDAQ
4583,12-02-2021 10:00,24 hrs.,wallstreetbets,TNDM,6,0,6,-6,1,1,0,1,NASDAQ
4583,12-02-2021 10:00,24 hrs.,wallstreetbets,TNXP,212,34,178,-144,33,35,10,29,NASDAQ
4583,12-02-2021 10:00,24 hrs.,wallstreetbets,TOPS,19,7,12,-5,3,3,1,3,NASDAQ
4583,12-02-2021 10:00,24 hrs.,wallstreetbets,TPCO,6,0,6,-6,1,1,0,1,NASDAQ
4583,12-02-2021 10:00,24 hrs.,wallstreetbets,TRCH,49,19,30,-11,8,8,1,6,NASDAQ
4583,12-02-2021 10:00,24 hrs.,wallstreetbets,TRIT,75,21,54,-33,12,12,3,7,NASDAQ
4583,12-02-2021 10:00,24 hrs.,wallstreetbets,TRVN,13,0,13,-13,2,2,1,2,NASDAQ
4583,12-02-2021 10:00,24 hrs.,wallstreetbets,TSLA,63343,300,63043,-62743,40,29497,4189,31,NASDAQ
4583,12-02-2021 10:00,24 hrs.,wallstreetbets,TTCF,7,7,0,7,1,1,1,1,NASDAQ
4583,12-02-2021 10:00,24 hrs.,wallstreetbets,TTWO,7,7,0,7,1,1,1,1,NASDAQ
4583,12-02-2021 10:00,24 hrs.,wallstreetbets,TURN,20,20,0,20,3,3,2,2,NASDAQ
4583,12-02-2021 10:00,24 hrs.,wallstreetbets,TWOU,12,0,12,-12,2,2,0,1,NASDAQ
4583,12-02-2021 10:00,24 hrs.,wallstreetbets,TXMD,125,28,97,-69,20,20,5,16,NASDAQ
4583,12-02-2021 10:00,24 hrs.,wallstreetbets,TYME,12,0,12,-12,2,2,0,2,NASDAQ
4583,12-02-2021 10:00,24 hrs.,wallstreetbets,UPST,6,0,6,-6,1,1,0,1,NASDAQ
4583,12-02-2021 10:00,24 hrs.,wallstreetbets,UPWK,18,0,18,-18,3,3,0,3,NASDAQ
4583,12-02-2021 10:00,24 hrs.,wallstreetbets,USWS,6,0,6,-6,1,1,0,1,NASDAQ
4583,12-02-2021 10:00,24 hrs.,wallstreetbets,UXIN,12,0,12,-12,2,2,0,1,NASDAQ
4583,12-02-2021 10:00,24 hrs.,wallstreetbets,VBLT,6,0,6,-6,1,1,0,1,NASDAQ
4583,12-02-2021 10:00,24 hrs.,wallstreetbets,VERU,6,0,6,-6,1,1,0,1,NASDAQ
4583,12-02-2021 10:00,24 hrs.,wallstreetbets,VIAC,72,0,72,-72,1,24,20,1,NASDAQ
4583,12-02-2021 10:00,24 hrs.,wallstreetbets,VISL,6,6,0,6,1,1,0,1,NASDAQ
4583,12-02-2021 10:00,24 hrs.,wallstreetbets,VIVE,6,0,6,-6,1,1,0,1,NASDAQ
4583,12-02-2021 10:00,24 hrs.,wallstreetbets,VKTX,6,0,6,-6,1,1,0,1,NASDAQ
4583,12-02-2021 10:00,24 hrs.,wallstreetbets,VNDA,36,36,0,36,5,5,6,1,NASDAQ
4583,12-02-2021 10:00,24 hrs.,pennystocks,ISWH,21,0,21,-21,1,8,1,1,OTC
4583,12-02-2021 10:00,24 hrs.,pennystocks,IWSY,23,0,23,-23,1,9,1,1,OTC
4583,12-02-2021 10:00,24 hrs.,pennystocks,JETR,6,6,0,6,1,1,0,1,OTC
4583,12-02-2021 10:00,24 hrs.,pennystocks,JKSM,6,0,6,-6,1,1,0,1,OTC
4583,12-02-2021 10:00,24 hrs.,pennystocks,KAVL,6,0,6,-6,1,1,0,1,OTC
4583,12-02-2021 10:00,24 hrs.,pennystocks,KGET,8,0,8,-8,1,1,2,1,OTC
4583,12-02-2021 10:00,24 hrs.,pennystocks,KGKG,43,25,18,7,5,8,7,3,OTC
4583,12-02-2021 10:00,24 hrs.,pennystocks,KSHB,26,0,26,-26,1,9,4,1,OTC
4583,12-02-2021 10:00,24 hrs.,pennystocks,KWBT,123,0,123,-123,2,41,33,2,OTC
4583,12-02-2021 10:00,24 hrs.,pennystocks,KYNC,38,31,7,24,6,6,2,2,OTC
4583,12-02-2021 10:00,24 hrs.,pennystocks,LBSR,7,0,7,-7,1,1,1,1,OTC
4583,12-02-2021 10:00,24 hrs.,pennystocks,LIVC,5,0,5,-5,1,0,1,1,OTC
4583,12-02-2021 10:00,24 hrs.,pennystocks,LOGQ,6,0,6,-6,1,1,0,1,OTC
4583,12-02-2021 10:00,24 hrs.,pennystocks,LQMT,66,66,0,66,1,21,20,1,OTC
4583,12-02-2021 10:00,24 hrs.,pennystocks,LTNC,13,6,7,-1,2,2,1,2,OTC
4583,12-02-2021 10:00,24 hrs.,pennystocks,LTUM,6,0,6,-6,1,1,0,1,OTC
4583,12-02-2021 10:00,24 hrs.,pennystocks,LUVU,136,0,136,-136,4,44,32,3,OTC
4583,12-02-2021 10:00,24 hrs.,pennystocks,LVVV,84,24,60,-36,6,13,34,4,OTC
4583,12-02-2021 10:00,24 hrs.,pennystocks,MAXD,20,0,20,-20,3,3,2,3,OTC
4583,12-02-2021 10:00,24 hrs.,pennystocks,MCOA,13,7,6,1,2,2,1,2,OTC
4583,12-02-2021 10:00,24 hrs.,pennystocks,MGLG,6,6,0,6,1,1,0,1,OTC
4583,12-02-2021 10:00,24 hrs.,pennystocks,MIKP,6,6,0,6,1,1,0,1,OTC
4583,12-02-2021 10:00,24 hrs.,pennystocks,MINE,2338,458,1880,-1422,6,1013,288,6,OTC
4583,12-02-2021 10:00,24 hrs.,pennystocks,MJNA,166,71,95,-24,10,43,40,8,OTC
4583,12-02-2021 10:00,24 hrs.,pennystocks,MLFB,37,6,31,-25,3,11,3,3,OTC
4583,12-02-2021 10:00,24 hrs.,pennystocks,MMEX,1731,23,1708,-1685,5,753,205,5,OTC
4583,12-02-2021 10:00,24 hrs.,pennystocks,MODC,6,6,0,6,1,1,0,1,OTC
4583,12-02-2021 10:00,24 hrs.,pennystocks,MOPN,7,0,7,-7,1,1,1,1,OTC
4583,12-02-2021 10:00,24 hrs.,pennystocks,MRMD,38,38,0,38,1,15,4,1,OTC
4583,12-02-2021 10:00,24 hrs.,pennystocks,MRNJ,13,13,0,13,2,2,1,1,OTC
4583,12-02-2021 10:00,24 hrs.,pennystocks,MRPI,7,0,7,-7,1,1,1,1,OTC
4583,12-02-2021 10:00,24 hrs.,RobinHoodPennyStocks,VRYYF,6,0,6,-6,1,1,0,1,OTC
4583,12-02-2021 10:00,24 hrs.,RobinHoodPennyStocks,AAU,91,91,0,91,1,33,21,1,AMEX
4583,12-02-2021 10:00,24 hrs.,RobinHoodPennyStocks,CEI,6,0,6,-6,1,1,0,1,AMEX
4583,12-02-2021 10:00,24 hrs.,RobinHoodPennyStocks,DNN,508,400,108,292,11,164,136,10,AMEX
4583,12-02-2021 10:00,24 hrs.,RobinHoodPennyStocks,DPW,91,91,0,91,1,33,21,1,AMEX
4583,12-02-2021 10:00,24 hrs.,RobinHoodPennyStocks,GSV,157,91,66,25,3,43,59,3,AMEX
4583,12-02-2021 10:00,24 hrs.,RobinHoodPennyStocks,GTE,769,212,557,-345,33,214,209,28,AMEX
4583,12-02-2021 10:00,24 hrs.,RobinHoodPennyStocks,IGC,6,0,6,-6,1,1,0,1,AMEX
4583,12-02-2021 10:00,24 hrs.,RobinHoodPennyStocks,ITP,7,0,7,-7,1,1,1,1,AMEX
4583,12-02-2021 10:00,24 hrs.,RobinHoodPennyStocks,KIQ,17,0,17,-17,1,0,13,1,AMEX
4583,12-02-2021 10:00,24 hrs.,RobinHoodPennyStocks,NAK,128,103,25,78,4,42,28,4,AMEX
4583,12-02-2021 10:00,24 hrs.,RobinHoodPennyStocks,PLM,37,37,0,37,1,14,5,1,AMEX
4583,12-02-2021 10:00,24 hrs.,RobinHoodPennyStocks,PTN,20,0,20,-20,2,3,6,2,AMEX
4583,12-02-2021 10:00,24 hrs.,RobinHoodPennyStocks,RHE,91,91,0,91,1,33,21,1,AMEX
4583,12-02-2021 10:00,24 hrs.,RobinHoodPennyStocks,SSY,6,0,6,-6,1,1,0,1,AMEX
4583,12-02-2021 10:00,24 hrs.,wallstreetbets,VRAY,6,0,6,-6,1,1,0,1,NASDAQ
4583,12-02-2021 10:00,24 hrs.,wallstreetbets,VTIQ,24,0,24,-24,4,4,0,1,NASDAQ
4583,12-02-2021 10:00,24 hrs.,wallstreetbets,VUZI,15,9,6,3,2,2,3,2,NASDAQ
4583,12-02-2021 10:00,24 hrs.,wallstreetbets,VXRT,12,6,6,0,2,2,0,2,NASDAQ
4583,12-02-2021 10:00,24 hrs.,wallstreetbets,VYNE,7,7,0,7,1,1,1,1,NASDAQ
4583,12-02-2021 10:00,24 hrs.,wallstreetbets,WATT,86,18,68,-50,12,13,12,5,NASDAQ
4583,12-02-2021 10:00,24 hrs.,wallstreetbets,WIMI,14,0,14,-14,2,2,2,1,NASDAQ
4583,12-02-2021 10:00,24 hrs.,wallstreetbets,WKHS,104,0,104,-104,4,28,32,3,NASDAQ
4583,12-02-2021 10:00,24 hrs.,wallstreetbets,WTER,7,7,0,7,1,1,1,1,NASDAQ
4583,12-02-2021 10:00,24 hrs.,wallstreetbets,XSPA,68,26,42,-16,11,11,2,11,NASDAQ
4583,12-02-2021 10:00,24 hrs.,wallstreetbets,YNDX,352,352,0,352,1,127,94,1,NASDAQ
4583,12-02-2021 10:00,24 hrs.,wallstreetbets,ZNGA,659,13,646,-633,7,249,133,7,NASDAQ
4583,12-02-2021 10:00,24 hrs.,wallstreetbets,ZSAN,6,0,6,-6,1,1,0,1,NASDAQ
4583,12-02-2021 10:00,24 hrs.,wallstreetbets,ZYNE,30,0,30,-30,5,5,0,5,NASDAQ
4583,12-02-2021 10:00,24 hrs.,RobinHoodPennyStocks,AHFD,6,6,0,6,1,1,0,1,OTC
4583,12-02-2021 10:00,24 hrs.,RobinHoodPennyStocks,AITX,13,0,13,-13,1,1,7,1,OTC
4583,12-02-2021 10:00,24 hrs.,RobinHoodPennyStocks,AZFL,6,6,0,6,1,0,2,1,OTC
4583,12-02-2021 10:00,24 hrs.,RobinHoodPennyStocks,BNGI,12,0,12,-12,2,2,0,2,OTC
4583,12-02-2021 10:00,24 hrs.,RobinHoodPennyStocks,CAPS,6,6,0,6,1,1,0,1,OTC
4583,12-02-2021 10:00,24 hrs.,RobinHoodPennyStocks,CBDD,6,0,6,-6,1,1,0,1,OTC
4583,12-02-2021 10:00,24 hrs.,RobinHoodPennyStocks,CBDL,6,0,6,-6,1,1,0,1,OTC
4583,12-02-2021 10:00,24 hrs.,RobinHoodPennyStocks,COMS,6,0,6,-6,1,1,0,1,OTC
4583,12-02-2021 10:00,24 hrs.,RobinHoodPennyStocks,CRWG,6,0,6,-6,1,1,0,1,OTC
4583,12-02-2021 10:00,24 hrs.,RobinHoodPennyStocks,CYTR,6,0,6,-6,1,1,0,1,OTC
4583,12-02-2021 10:00,24 hrs.,RobinHoodPennyStocks,DIGI,6,6,0,6,1,1,0,1,OTC
4583,12-02-2021 10:00,24 hrs.,RobinHoodPennyStocks,ETEK,6,0,6,-6,1,1,0,1,OTC
4583,12-02-2021 10:00,24 hrs.,RobinHoodPennyStocks,GTBP,20,0,20,-20,1,4,8,1,OTC
4583,12-02-2021 10:00,24 hrs.,RobinHoodPennyStocks,HCMC,48,6,42,-36,8,8,0,7,OTC
4583,12-02-2021 10:00,24 hrs.,RobinHoodPennyStocks,HQGE,6,0,6,-6,1,1,0,1,OTC
4583,12-02-2021 10:00,24 hrs.,wallstreetbets,SLRX,12,0,12,-12,2,2,0,2,NASDAQ
4583,12-02-2021 10:00,24 hrs.,wallstreetbets,SNCR,7,0,7,-7,1,1,1,1,NASDAQ
4583,12-02-2021 10:00,24 hrs.,wallstreetbets,SNDL,72728,4510,68218,-63708,851,31955,5414,677,NASDAQ
4583,12-02-2021 10:00,24 hrs.,wallstreetbets,SNGX,7,7,0,7,1,1,1,1,NASDAQ
4583,12-02-2021 10:00,24 hrs.,wallstreetbets,SOHU,6,0,6,-6,1,1,0,1,NASDAQ
4583,12-02-2021 10:00,24 hrs.,wallstreetbets,SOLO,6,0,6,-6,1,1,0,1,NASDAQ
4583,12-02-2021 10:00,24 hrs.,wallstreetbets,SONN,6,0,6,-6,1,1,0,1,NASDAQ
4583,12-02-2021 10:00,24 hrs.,wallstreetbets,SONO,767,0,767,-767,3,283,189,3,NASDAQ
4583,12-02-2021 10:00,24 hrs.,wallstreetbets,SPWR,6,0,6,-6,1,1,0,1,NASDAQ
4583,12-02-2021 10:00,24 hrs.,wallstreetbets,SQQQ,7,7,0,7,1,1,1,1,NASDAQ
4583,12-02-2021 10:00,24 hrs.,wallstreetbets,SRGA,6,0,6,-6,1,1,0,1,NASDAQ
4583,12-02-2021 10:00,24 hrs.,wallstreetbets,SRNE,22,22,0,22,2,5,4,2,NASDAQ
4583,12-02-2021 10:00,24 hrs.,wallstreetbets,SSPK,6,0,6,-6,1,1,0,1,NASDAQ
4583,12-02-2021 10:00,24 hrs.,wallstreetbets,STAF,7,7,0,7,1,1,1,1,NASDAQ
4583,12-02-2021 10:00,24 hrs.,wallstreetbets,STAY,24,6,18,-12,4,4,0,4,NASDAQ
4583,12-02-2021 10:00,24 hrs.,wallstreetbets,STCN,6,0,6,-6,1,1,0,1,NASDAQ
4583,12-02-2021 10:00,24 hrs.,wallstreetbets,SWBI,6,0,6,-6,1,1,0,1,NASDAQ
4583,12-02-2021 10:00,24 hrs.,wallstreetbets,SXTC,6,0,6,-6,1,1,0,1,NASDAQ
4583,12-02-2021 10:00,24 hrs.,wallstreetbets,TBLT,6,0,6,-6,1,1,0,1,NASDAQ
4583,12-02-2021 10:00,24 hrs.,wallstreetbets,TEAM,12,12,0,12,2,2,0,1,NASDAQ
4583,12-02-2021 10:00,24 hrs.,RobinHoodPennyStocks,SYN,6,6,0,6,1,1,0,1,AMEX
4583,12-02-2021 10:00,24 hrs.,RobinHoodPennyStocks,TGB,78,61,17,44,3,30,6,3,AMEX
4583,12-02-2021 10:00,24 hrs.,RobinHoodPennyStocks,TRT,91,91,0,91,1,33,21,1,AMEX
4583,12-02-2021 10:00,24 hrs.,RobinHoodPennyStocks,TRX,185,179,6,173,3,59,55,3,AMEX
4583,12-02-2021 10:00,24 hrs.,RobinHoodPennyStocks,XPL,91,91,0,91,1,33,21,1,AMEX
4583,12-02-2021 10:00,24 hrs.,RobinHoodPennyStocks,ZOM,965,443,522,-79,18,258,377,16,AMEX
4583,12-02-2021 10:00,24 hrs.,RobinHoodPennyStocks,AMBO,91,91,0,91,1,33,21,1,AMEX
4583,12-02-2021 10:00,24 hrs.,RobinHoodPennyStocks,AUMN,185,179,6,173,3,59,55,3,AMEX
4583,12-02-2021 10:00,24 hrs.,RobinHoodPennyStocks,GSAT,39,27,12,15,3,8,11,3,AMEX
4583,12-02-2021 10:00,24 hrs.,RobinHoodPennyStocks,NSPR,7,7,0,7,1,1,1,1,AMEX
4583,12-02-2021 10:00,24 hrs.,RobinHoodPennyStocks,OGEN,6,0,6,-6,1,1,0,1,AMEX
4583,12-02-2021 10:00,24 hrs.,RobinHoodPennyStocks,PLAG,91,91,0,91,1,33,21,1,AMEX
4583,12-02-2021 10:00,24 hrs.,RobinHoodPennyStocks,SENS,50,0,50,-50,1,20,6,1,AMEX
4583,12-02-2021 10:00,24 hrs.,RobinHoodPennyStocks,SMTS,6,6,0,6,1,1,0,1,AMEX
4583,12-02-2021 10:00,24 hrs.,RobinHoodPennyStocks,TKAT,91,91,0,91,1,33,21,1,AMEX
4583,12-02-2021 10:00,24 hrs.,RobinHoodPennyStocks,TRXC,151,151,0,151,2,58,27,2,AMEX
4583,12-02-2021 10:00,24 hrs.,RobinHoodPennyStocks,UUUU,36,0,36,-36,1,11,10,1,AMEX
4583,12-02-2021 10:00,24 hrs.,RobinHoodPennyStocks,YCBD,6,6,0,6,1,1,0,1,AMEX
4583,12-02-2021 10:00,24 hrs.,RobinHoodPennyStocks,ACB,18,0,18,-18,1,6,2,1,NYSE
4583,12-02-2021 10:00,24 hrs.,RobinHoodPennyStocks,AMC,3969,129,3840,-3711,11,1690,545,9,NYSE
4583,12-02-2021 10:00,24 hrs.,RobinHoodPennyStocks,ASX,6,0,6,-6,1,1,0,1,NYSE
4583,12-02-2021 10:00,24 hrs.,RobinHoodPennyStocks,AUY,88,88,0,88,1,25,34,1,NYSE
4583,12-02-2021 10:00,24 hrs.,RobinHoodPennyStocks,BBW,6,0,6,-6,1,1,0,1,NYSE
4583,12-02-2021 10:00,24 hrs.,RobinHoodPennyStocks,BTU,91,91,0,91,1,33,21,1,NYSE
4583,12-02-2021 10:00,24 hrs.,RobinHoodPennyStocks,CCM,91,91,0,91,1,33,21,1,NYSE
4583,12-02-2021 10:00,24 hrs.,RobinHoodPennyStocks,COO,88,88,0,88,1,25,34,1,NYSE
4583,12-02-2021 10:00,24 hrs.,RobinHoodPennyStocks,CTK,91,91,0,91,1,33,21,1,NYSE
4583,12-02-2021 10:00,24 hrs.,RobinHoodPennyStocks,DNK,6,0,6,-6,1,1,0,1,NYSE
4583,12-02-2021 10:00,24 hrs.,RobinHoodPennyStocks,FSD,6,0,6,-6,1,1,0,1,NYSE
4583,12-02-2021 10:00,24 hrs.,RobinHoodPennyStocks,FSR,91,91,0,91,1,33,21,1,NYSE
4583,12-02-2021 10:00,24 hrs.,RobinHoodPennyStocks,FTK,6,0,6,-6,1,1,0,1,NYSE
4583,12-02-2021 10:00,24 hrs.,RobinHoodPennyStocks,GME,3900,38,3862,-3824,9,1667,530,7,NYSE
4583,12-02-2021 10:00,24 hrs.,RobinHoodPennyStocks,GSX,91,91,0,91,1,33,21,1,NYSE
4583,12-02-2021 10:00,24 hrs.,RobinHoodPennyStocks,IRL,307,0,307,-307,1,145,13,1,NYSE
4583,12-02-2021 10:00,24 hrs.,RobinHoodPennyStocks,IVR,6,6,0,6,1,1,0,1,NYSE
4583,12-02-2021 10:00,24 hrs.,RobinHoodPennyStocks,LOW,6,6,0,6,1,1,0,1,NYSE
4583,12-02-2021 10:00,24 hrs.,RobinHoodPennyStocks,LYG,6,6,0,6,1,1,0,1,NYSE
4583,12-02-2021 10:00,24 hrs.,RobinHoodPennyStocks,NIO,91,91,0,91,1,33,21,1,NYSE
4583,12-02-2021 10:00,24 hrs.,RobinHoodPennyStocks,PDT,119,0,119,-119,2,39,33,2,NYSE
4583,12-02-2021 10:00,24 hrs.,RobinHoodPennyStocks,PSA,52,16,36,-20,2,14,16,2,NYSE
4583,12-02-2021 10:00,24 hrs.,RobinHoodPennyStocks,RFP,91,91,0,91,1,33,21,1,NYSE
4583,12-02-2021 10:00,24 hrs.,RobinHoodPennyStocks,INOH,6,0,6,-6,1,1,0,1,OTC
4583,12-02-2021 10:00,24 hrs.,RobinHoodPennyStocks,MCOA,6,0,6,-6,1,1,0,1,OTC
4583,12-02-2021 10:00,24 hrs.,RobinHoodPennyStocks,NUGS,6,0,6,-6,1,1,0,1,OTC
4583,12-02-2021 10:00,24 hrs.,RobinHoodPennyStocks,NWPN,8,0,8,-8,1,0,4,1,OTC
4583,12-02-2021 10:00,24 hrs.,RobinHoodPennyStocks,OPMZ,6,0,6,-6,1,1,0,1,OTC
4583,12-02-2021 10:00,24 hrs.,RobinHoodPennyStocks,OPTI,6,6,0,6,1,1,0,1,OTC
4583,12-02-2021 10:00,24 hrs.,RobinHoodPennyStocks,PAOG,6,0,6,-6,1,1,0,1,OTC
4583,12-02-2021 10:00,24 hrs.,RobinHoodPennyStocks,PHIL,6,0,6,-6,1,1,0,1,OTC
4583,12-02-2021 10:00,24 hrs.,RobinHoodPennyStocks,QTMM,6,0,6,-6,1,1,0,1,OTC
4583,12-02-2021 10:00,24 hrs.,RobinHoodPennyStocks,SGMD,20,0,20,-20,1,4,8,1,OTC
4583,12-02-2021 10:00,24 hrs.,RobinHoodPennyStocks,SRMX,12,0,12,-12,2,2,0,2,OTC
4583,12-02-2021 10:00,24 hrs.,RobinHoodPennyStocks,SUIC,6,0,6,-6,1,1,0,1,OTC
4583,12-02-2021 10:00,24 hrs.,RobinHoodPennyStocks,TLSS,6,0,6,-6,1,1,0,1,OTC
4583,12-02-2021 10:00,24 hrs.,RobinHoodPennyStocks,USMJ,6,0,6,-6,1,1,0,1,OTC
4583,12-02-2021 10:00,24 hrs.,RobinHoodPennyStocks,VPRB,6,0,6,-6,1,1,0,1,OTC
4583,12-02-2021 10:00,24 hrs.,RobinHoodPennyStocks,ABEPF,8,0,8,-8,1,0,4,1,OTC
4583,12-02-2021 10:00,24 hrs.,RobinHoodPennyStocks,BDRBF,245,24,221,-197,14,59,71,14,OTC
4583,12-02-2021 10:00,24 hrs.,RobinHoodPennyStocks,HITIF,32,0,32,-32,3,2,16,3,OTC
4583,12-02-2021 10:00,24 hrs.,RobinHoodPennyStocks,MZDAY,24,0,24,-24,1,5,10,1,OTC
4583,12-02-2021 10:00,24 hrs.,RobinHoodPennyStocks,PLNHF,6,0,6,-6,1,1,0,1,OTC
4583,12-02-2021 10:00,24 hrs.,RobinHoodPennyStocks,RLFTF,31,0,31,-31,5,5,1,1,OTC
4583,12-02-2021 10:00,24 hrs.,RobinHoodPennyStocks,RYCEY,6,0,6,-6,1,1,0,1,OTC
4583,12-02-2021 10:00,24 hrs.,RobinHoodPennyStocks,TLOFF,6,6,0,6,1,1,0,1,OTC
4583,12-02-2021 10:00,24 hrs.,RobinHoodPennyStocks,ADXS,12,0,12,-12,2,2,0,1,NASDAQ
4583,12-02-2021 10:00,24 hrs.,RobinHoodPennyStocks,AEHR,91,91,0,91,1,33,21,1,NASDAQ
4583,12-02-2021 10:00,24 hrs.,RobinHoodPennyStocks,AESE,6,0,6,-6,1,1,0,1,NASDAQ
4583,12-02-2021 10:00,24 hrs.,RobinHoodPennyStocks,AEZS,43,0,43,-43,2,6,23,2,NASDAQ
4583,12-02-2021 10:00,24 hrs.,RobinHoodPennyStocks,AGTC,5315,903,4412,-3509,47,2064,999,43,NASDAQ
4583,12-02-2021 10:00,24 hrs.,RobinHoodPennyStocks,AIHS,97,91,6,85,2,34,21,2,NASDAQ
4583,12-02-2021 10:00,24 hrs.,RobinHoodPennyStocks,ALAC,91,91,0,91,1,33,21,1,NASDAQ
4583,12-02-2021 10:00,24 hrs.,RobinHoodPennyStocks,AMTX,91,91,0,91,1,33,21,1,NASDAQ
4583,12-02-2021 10:00,24 hrs.,RobinHoodPennyStocks,APHA,24,6,18,-12,4,4,0,3,NASDAQ
4583,12-02-2021 10:00,24 hrs.,RobinHoodPennyStocks,ARTL,6,0,6,-6,1,1,0,1,NASDAQ
4583,12-02-2021 10:00,24 hrs.,RobinHoodPennyStocks,ASRT,204,6,198,-192,5,66,52,5,NASDAQ
4583,12-02-2021 10:00,24 hrs.,RobinHoodPennyStocks,ASYS,91,91,0,91,1,33,21,1,NASDAQ
4583,12-02-2021 10:00,24 hrs.,RobinHoodPennyStocks,ATIF,91,91,0,91,1,33,21,1,NASDAQ
4583,12-02-2021 10:00,24 hrs.,RobinHoodPennyStocks,ATNI,91,91,0,91,1,33,21,1,NASDAQ
4583,12-02-2021 10:00,24 hrs.,RobinHoodPennyStocks,ATOS,180,57,123,-66,7,54,44,7,NASDAQ
4583,12-02-2021 10:00,24 hrs.,RobinHoodPennyStocks,AVCO,91,91,0,91,1,33,21,1,NASDAQ
4583,12-02-2021 10:00,24 hrs.,RobinHoodPennyStocks,AYTU,15,0,15,-15,1,4,3,1,NASDAQ
4583,12-02-2021 10:00,24 hrs.,RobinHoodPennyStocks,BBIG,12,6,6,0,2,2,0,2,NASDAQ
4583,12-02-2021 10:00,24 hrs.,RobinHoodPennyStocks,BCLI,6,0,6,-6,1,1,0,1,NASDAQ
4583,12-02-2021 10:00,24 hrs.,RobinHoodPennyStocks,BCRX,42,42,0,42,1,8,22,1,NASDAQ
4583,12-02-2021 10:00,24 hrs.,RobinHoodPennyStocks,BFRA,91,91,0,91,1,33,21,1,NASDAQ
4583,12-02-2021 10:00,24 hrs.,RobinHoodPennyStocks,BHAT,91,91,0,91,1,33,21,1,NASDAQ
4583,12-02-2021 10:00,24 hrs.,RobinHoodPennyStocks,BIOL,25,0,25,-25,2,6,5,2,NASDAQ
4583,12-02-2021 10:00,24 hrs.,RobinHoodPennyStocks,BRQS,97,91,6,85,2,34,21,2,NASDAQ
4583,12-02-2021 10:00,24 hrs.,RobinHoodPennyStocks,BYFC,91,91,0,91,1,33,21,1,NASDAQ
4583,12-02-2021 10:00,24 hrs.,RobinHoodPennyStocks,CAAS,91,91,0,91,1,33,21,1,NASDAQ
4583,12-02-2021 10:00,24 hrs.,RobinHoodPennyStocks,CARV,91,91,0,91,1,33,21,1,NASDAQ
4583,12-02-2021 10:00,24 hrs.,RobinHoodPennyStocks,CBAT,91,91,0,91,1,33,21,1,NASDAQ
4583,12-02-2021 10:00,24 hrs.,RobinHoodPennyStocks,CCNC,91,91,0,91,1,33,21,1,NASDAQ
4583,12-02-2021 10:00,24 hrs.,RobinHoodPennyStocks,CHNR,91,91,0,91,1,33,21,1,NASDAQ
4583,12-02-2021 10:00,24 hrs.,RobinHoodPennyStocks,CIDM,6,6,0,6,1,1,0,1,NASDAQ
4583,12-02-2021 10:00,24 hrs.,RobinHoodPennyStocks,CKPT,259,259,0,259,1,49,157,1,NASDAQ
4583,12-02-2021 10:00,24 hrs.,RobinHoodPennyStocks,CLEU,91,91,0,91,1,33,21,1,NASDAQ
4583,12-02-2021 10:00,24 hrs.,RobinHoodPennyStocks,CLRB,19,0,19,-19,1,7,1,1,NASDAQ
4583,12-02-2021 10:00,24 hrs.,RobinHoodPennyStocks,CLSK,91,91,0,91,1,33,21,1,NASDAQ
4583,12-02-2021 10:00,24 hrs.,RobinHoodPennyStocks,CLSN,12,0,12,-12,2,2,0,2,NASDAQ
4583,12-02-2021 10:00,24 hrs.,RobinHoodPennyStocks,CMLF,91,91,0,91,1,33,21,1,NASDAQ
4583,12-02-2021 10:00,24 hrs.,RobinHoodPennyStocks,CRBP,10,0,10,-10,1,2,2,1,NASDAQ
4583,12-02-2021 10:00,24 hrs.,RobinHoodPennyStocks,CSCW,91,91,0,91,1,33,21,1,NASDAQ
4583,12-02-2021 10:00,24 hrs.,RobinHoodPennyStocks,CTRM,1106,463,643,-180,32,317,344,28,NASDAQ
4583,12-02-2021 10:00,24 hrs.,RobinHoodPennyStocks,DFFN,19,6,13,-7,2,3,5,2,NASDAQ
4583,12-02-2021 10:00,24 hrs.,RobinHoodPennyStocks,EAST,164,46,118,-72,5,51,42,5,NASDAQ
4583,12-02-2021 10:00,24 hrs.,RobinHoodPennyStocks,ENVB,72,0,72,-72,2,25,14,2,NASDAQ
4583,12-02-2021 10:00,24 hrs.,RobinHoodPennyStocks,EQOS,91,91,0,91,1,33,21,1,NASDAQ
4583,12-02-2021 10:00,24 hrs.,RobinHoodPennyStocks,FCEL,91,91,0,91,1,33,21,1,NASDAQ
4583,12-02-2021 10:00,24 hrs.,RobinHoodPennyStocks,GHSI,135,0,135,-135,3,51,21,3,NASDAQ
4583,12-02-2021 10:00,24 hrs.,RobinHoodPennyStocks,SOS,151,121,30,91,11,43,21,9,NYSE
4583,12-02-2021 10:00,24 hrs.,RobinHoodPennyStocks,SUZ,91,91,0,91,1,33,21,1,NYSE
4583,12-02-2021 10:00,24 hrs.,RobinHoodPennyStocks,TAL,91,91,0,91,1,33,21,1,NYSE
4583,12-02-2021 10:00,24 hrs.,RobinHoodPennyStocks,WEI,101,91,10,81,2,35,23,2,NYSE
4583,12-02-2021 10:00,24 hrs.,RobinHoodPennyStocks,BABA,91,91,0,91,1,33,21,1,NYSE
4583,12-02-2021 10:00,24 hrs.,RobinHoodPennyStocks,CEIX,91,91,0,91,1,33,21,1,NYSE
4583,12-02-2021 10:00,24 hrs.,RobinHoodPennyStocks,CMCM,91,91,0,91,1,33,21,1,NYSE
4583,12-02-2021 10:00,24 hrs.,RobinHoodPennyStocks,EXPR,6,0,6,-6,1,1,0,1,NYSE
4583,12-02-2021 10:00,24 hrs.,RobinHoodPennyStocks,FUBO,97,97,0,97,2,34,21,2,NYSE
4583,12-02-2021 10:00,24 hrs.,RobinHoodPennyStocks,LAIX,91,91,0,91,1,33,21,1,NYSE
4583,12-02-2021 10:00,24 hrs.,RobinHoodPennyStocks,RLGY,91,91,0,91,1,33,21,1,NYSE
4583,12-02-2021 10:00,24 hrs.,RobinHoodPennyStocks,XPEV,91,91,0,91,1,33,21,1,NYSE
4583,12-02-2021 10:00,24 hrs.,RobinHoodPennyStocks,AIH,91,91,0,91,1,33,21,1,NASDAQ
4583,12-02-2021 10:00,24 hrs.,RobinHoodPennyStocks,BBI,6,0,6,-6,1,1,0,1,NASDAQ
4583,12-02-2021 10:00,24 hrs.,RobinHoodPennyStocks,ENG,91,91,0,91,1,33,21,1,NASDAQ
4583,12-02-2021 10:00,24 hrs.,RobinHoodPennyStocks,EVK,91,91,0,91,1,33,21,1,NASDAQ
4583,12-02-2021 10:00,24 hrs.,RobinHoodPennyStocks,JFU,12,0,12,-12,2,2,0,2,NASDAQ
4583,12-02-2021 10:00,24 hrs.,RobinHoodPennyStocks,MGI,91,91,0,91,1,33,21,1,NASDAQ
4583,12-02-2021 10:00,24 hrs.,RobinHoodPennyStocks,JFIN,91,91,0,91,1,33,21,1,NASDAQ
4583,12-02-2021 10:00,24 hrs.,RobinHoodPennyStocks,JRJC,91,91,0,91,1,33,21,1,NASDAQ
4583,12-02-2021 10:00,24 hrs.,RobinHoodPennyStocks,KNDI,91,91,0,91,1,33,21,1,NASDAQ
4583,12-02-2021 10:00,24 hrs.,RobinHoodPennyStocks,KTRA,52,40,12,28,4,15,6,4,NASDAQ
4583,12-02-2021 10:00,24 hrs.,RobinHoodPennyStocks,KXIN,91,91,0,91,1,33,21,1,NASDAQ
4583,12-02-2021 10:00,24 hrs.,RobinHoodPennyStocks,LEDS,91,91,0,91,1,33,21,1,NASDAQ
4583,12-02-2021 10:00,24 hrs.,RobinHoodPennyStocks,LIVE,10,0,10,-10,1,0,6,1,NASDAQ
4583,12-02-2021 10:00,24 hrs.,RobinHoodPennyStocks,LKCO,42,6,36,-30,7,7,0,5,NASDAQ
4583,12-02-2021 10:00,24 hrs.,RobinHoodPennyStocks,LLNW,38,38,0,38,1,10,14,1,NASDAQ
4583,12-02-2021 10:00,24 hrs.,RobinHoodPennyStocks,LMFA,91,91,0,91,1,33,21,1,NASDAQ
4583,12-02-2021 10:00,24 hrs.,RobinHoodPennyStocks,LXEH,91,91,0,91,1,33,21,1,NASDAQ
4583,12-02-2021 10:00,24 hrs.,RobinHoodPennyStocks,MARA,91,91,0,91,1,33,21,1,NASDAQ
4583,12-02-2021 10:00,24 hrs.,RobinHoodPennyStocks,METX,91,91,0,91,1,33,21,1,NASDAQ
4583,12-02-2021 10:00,24 hrs.,RobinHoodPennyStocks,MOGO,91,91,0,91,1,33,21,1,NASDAQ
4583,12-02-2021 10:00,24 hrs.,RobinHoodPennyStocks,MOMO,91,91,0,91,1,33,21,1,NASDAQ
4583,12-02-2021 10:00,24 hrs.,RobinHoodPennyStocks,MOSY,91,91,0,91,1,33,21,1,NASDAQ
4583,12-02-2021 10:00,24 hrs.,RobinHoodPennyStocks,MOTS,7,0,7,-7,1,1,1,1,NASDAQ
4583,12-02-2021 10:00,24 hrs.,RobinHoodPennyStocks,MOXC,91,91,0,91,1,33,21,1,NASDAQ
4583,12-02-2021 10:00,24 hrs.,RobinHoodPennyStocks,MVIS,97,91,6,85,2,34,21,2,NASDAQ
4583,12-02-2021 10:00,24 hrs.,RobinHoodPennyStocks,NAKD,199,97,102,-5,6,50,75,6,NASDAQ
4583,12-02-2021 10:00,24 hrs.,RobinHoodPennyStocks,NCTY,91,91,0,91,1,33,21,1,NASDAQ
4583,12-02-2021 10:00,24 hrs.,RobinHoodPennyStocks,NDRA,6,0,6,-6,1,1,0,1,NASDAQ
4583,12-02-2021 10:00,24 hrs.,RobinHoodPennyStocks,NEOS,15,0,15,-15,1,4,3,1,NASDAQ
4583,12-02-2021 10:00,24 hrs.,RobinHoodPennyStocks,NOVN,178,112,66,46,6,52,50,4,NASDAQ
4583,12-02-2021 10:00,24 hrs.,RobinHoodPennyStocks,NVCN,121,6,115,-109,5,30,41,5,NASDAQ
4583,12-02-2021 10:00,24 hrs.,RobinHoodPennyStocks,NVIV,12,12,0,12,1,2,4,1,NASDAQ
4583,12-02-2021 10:00,24 hrs.,RobinHoodPennyStocks,NXTD,97,91,6,85,2,34,21,2,NASDAQ
4583,12-02-2021 10:00,24 hrs.,RobinHoodPennyStocks,OCGN,136,6,130,-124,7,23,62,7,NASDAQ
4583,12-02-2021 10:00,24 hrs.,RobinHoodPennyStocks,ONTX,34,6,28,-22,3,9,4,3,NASDAQ
4583,12-02-2021 10:00,24 hrs.,RobinHoodPennyStocks,OPGN,12,6,6,0,2,2,0,2,NASDAQ
4583,12-02-2021 10:00,24 hrs.,RobinHoodPennyStocks,OPTT,91,91,0,91,1,33,21,1,NASDAQ
4583,12-02-2021 10:00,24 hrs.,RobinHoodPennyStocks,PECK,91,91,0,91,1,33,21,1,NASDAQ
4583,12-02-2021 10:00,24 hrs.,RobinHoodPennyStocks,PEIX,91,91,0,91,1,33,21,1,NASDAQ
4583,12-02-2021 10:00,24 hrs.,RobinHoodPennyStocks,PETZ,91,91,0,91,1,33,21,1,NASDAQ
4583,12-02-2021 10:00,24 hrs.,RobinHoodPennyStocks,PHUN,91,91,0,91,1,33,21,1,NASDAQ
4583,12-02-2021 10:00,24 hrs.,RobinHoodPennyStocks,PIXY,91,91,0,91,1,33,21,1,NASDAQ
4583,12-02-2021 10:00,24 hrs.,RobinHoodPennyStocks,PLAY,6,0,6,-6,1,1,0,1,NASDAQ
4583,12-02-2021 10:00,24 hrs.,RobinHoodPennyStocks,PLIN,97,91,6,85,2,34,21,2,NASDAQ
4583,12-02-2021 10:00,24 hrs.,RobinHoodPennyStocks,PLUG,91,91,0,91,1,33,21,1,NASDAQ
4583,12-02-2021 10:00,24 hrs.,RobinHoodPennyStocks,PSEC,25,0,25,-25,4,4,1,2,NASDAQ
4583,12-02-2021 10:00,24 hrs.,RobinHoodPennyStocks,PSTV,6,0,6,-6,1,1,0,1,NASDAQ
4583,12-02-2021 10:00,24 hrs.,RobinHoodPennyStocks,PULM,255,0,255,-255,3,97,49,3,NASDAQ
4583,12-02-2021 10:00,24 hrs.,RobinHoodPennyStocks,PXLW,6,6,0,6,1,1,0,1,NASDAQ
4583,12-02-2021 10:00,24 hrs.,RobinHoodPennyStocks,QUIK,91,91,0,91,1,33,21,1,NASDAQ
4583,12-02-2021 10:00,24 hrs.,RobinHoodPennyStocks,RAVE,91,91,0,91,1,33,21,1,NASDAQ
4583,12-02-2021 10:00,24 hrs.,RobinHoodPennyStocks,RCMT,91,91,0,91,1,33,21,1,NASDAQ
4583,12-02-2021 10:00,24 hrs.,RobinHoodPennyStocks,REAL,51,51,0,51,1,15,17,1,NASDAQ
4583,12-02-2021 10:00,24 hrs.,RobinHoodPennyStocks,RETO,6,0,6,-6,1,1,0,1,NASDAQ
4583,12-02-2021 10:00,24 hrs.,RobinHoodPennyStocks,RIGL,7,0,7,-7,1,1,1,1,NASDAQ
4583,12-02-2021 10:00,24 hrs.,RobinHoodPennyStocks,RIOT,91,91,0,91,1,33,21,1,NASDAQ
4583,12-02-2021 10:00,24 hrs.,RobinHoodPennyStocks,RWLK,6,0,6,-6,1,1,0,1,NASDAQ
4583,12-02-2021 10:00,24 hrs.,RobinHoodPennyStocks,OCG,91,91,0,91,1,33,21,1,NASDAQ
4583,12-02-2021 10:00,24 hrs.,RobinHoodPennyStocks,OEG,91,91,0,91,1,33,21,1,NASDAQ
4583,12-02-2021 10:00,24 hrs.,RobinHoodPennyStocks,OGI,3728,0,3728,-3728,4,1624,464,4,NASDAQ
4583,12-02-2021 10:00,24 hrs.,RobinHoodPennyStocks,PTE,140,12,128,-116,6,53,10,4,NASDAQ
4583,12-02-2021 10:00,24 hrs.,RobinHoodPennyStocks,QTT,91,91,0,91,1,33,21,1,NASDAQ
4583,12-02-2021 10:00,24 hrs.,RobinHoodPennyStocks,SPI,91,91,0,91,1,33,21,1,NASDAQ
4583,12-02-2021 10:00,24 hrs.,RobinHoodPennyStocks,WNW,91,91,0,91,1,33,21,1,NASDAQ
4583,12-02-2021 10:00,24 hrs.,RobinHoodPennyStocks,WWR,91,91,0,91,1,33,21,1,NASDAQ
4583,12-02-2021 10:00,24 hrs.,RobinHoodPennyStocks,AAOI,91,91,0,91,1,33,21,1,NASDAQ
4583,12-02-2021 10:00,24 hrs.,RobinHoodPennyStocks,ABEO,141,0,141,-141,2,53,27,2,NASDAQ
4583,12-02-2021 10:00,24 hrs.,RobinHoodPennyStocks,ABIO,28,28,0,28,1,4,16,1,NASDAQ
4583,12-02-2021 10:00,24 hrs.,RobinHoodPennyStocks,ACOR,91,91,0,91,1,33,21,1,NASDAQ
4583,12-02-2021 10:00,24 hrs.,RobinHoodPennyStocks,ADMA,39,0,39,-39,1,13,9,1,NASDAQ
4583,12-02-2021 10:00,24 hrs.,wallstreetbets,PEP,622,0,622,-622,1,243,132,1,NASDAQ
4583,12-02-2021 10:00,24 hrs.,wallstreetbets,PTE,35,35,0,35,5,5,5,1,NASDAQ
4583,12-02-2021 10:00,24 hrs.,wallstreetbets,QQQ,901,0,901,-901,2,381,131,2,NASDAQ
4583,12-02-2021 10:00,24 hrs.,wallstreetbets,QTT,6,0,6,-6,1,1,0,1,NASDAQ
4583,12-02-2021 10:00,24 hrs.,wallstreetbets,RCM,6,0,6,-6,1,1,0,1,NASDAQ
4583,12-02-2021 10:00,24 hrs.,wallstreetbets,RUN,25,7,18,-11,4,4,1,4,NASDAQ
4583,12-02-2021 10:00,24 hrs.,wallstreetbets,SDC,6,0,6,-6,1,1,0,1,NASDAQ
4583,12-02-2021 10:00,24 hrs.,wallstreetbets,SLS,6,0,6,-6,1,1,0,1,NASDAQ
4583,12-02-2021 10:00,24 hrs.,wallstreetbets,SMH,12,0,12,-12,2,2,0,2,NASDAQ
4583,12-02-2021 10:00,24 hrs.,wallstreetbets,SND,7,7,0,7,1,1,1,1,NASDAQ
4583,12-02-2021 10:00,24 hrs.,wallstreetbets,TER,12,0,12,-12,2,2,0,1,NASDAQ
4583,12-02-2021 10:00,24 hrs.,wallstreetbets,TLS,6,0,6,-6,1,1,0,1,NASDAQ
4583,12-02-2021 10:00,24 hrs.,RobinHoodPennyStocks,TAOP,91,91,0,91,1,33,21,1,NASDAQ
4583,12-02-2021 10:00,24 hrs.,RobinHoodPennyStocks,TEDU,91,91,0,91,1,33,21,1,NASDAQ
4583,12-02-2021 10:00,24 hrs.,RobinHoodPennyStocks,TIGR,91,91,0,91,1,33,21,1,NASDAQ
4583,12-02-2021 10:00,24 hrs.,RobinHoodPennyStocks,TLRY,35,6,29,-23,4,8,3,2,NASDAQ
4583,12-02-2021 10:00,24 hrs.,RobinHoodPennyStocks,TNXP,567,209,358,-149,9,211,109,8,NASDAQ
4583,12-02-2021 10:00,24 hrs.,RobinHoodPennyStocks,TRCH,297,91,206,-115,6,92,89,5,NASDAQ
4583,12-02-2021 10:00,24 hrs.,RobinHoodPennyStocks,TRIL,6,0,6,-6,1,1,0,1,NASDAQ
4583,12-02-2021 10:00,24 hrs.,RobinHoodPennyStocks,TRVN,6,0,6,-6,1,1,0,1,NASDAQ
4583,12-02-2021 10:00,24 hrs.,RobinHoodPennyStocks,TTOO,23,0,23,-23,1,7,5,1,NASDAQ
4583,12-02-2021 10:00,24 hrs.,RobinHoodPennyStocks,TXMD,564,344,220,124,11,145,230,11,NASDAQ
4583,12-02-2021 10:00,24 hrs.,RobinHoodPennyStocks,TYME,10,10,0,10,1,0,6,1,NASDAQ
4583,12-02-2021 10:00,24 hrs.,RobinHoodPennyStocks,UONE,91,91,0,91,1,33,21,1,NASDAQ
4583,12-02-2021 10:00,24 hrs.,RobinHoodPennyStocks,USEG,91,91,0,91,1,33,21,1,NASDAQ
4583,12-02-2021 10:00,24 hrs.,RobinHoodPennyStocks,USWS,12,0,12,-12,2,2,0,2,NASDAQ
4583,12-02-2021 10:00,24 hrs.,RobinHoodPennyStocks,UXIN,91,91,0,91,1,33,21,1,NASDAQ
4583,12-02-2021 10:00,24 hrs.,RobinHoodPennyStocks,VYNE,6,0,6,-6,1,1,0,1,NASDAQ
4583,12-02-2021 10:00,24 hrs.,RobinHoodPennyStocks,WATT,91,91,0,91,1,33,21,1,NASDAQ
4583,12-02-2021 10:00,24 hrs.,RobinHoodPennyStocks,WIMI,91,91,0,91,1,33,21,1,NASDAQ
4583,12-02-2021 10:00,24 hrs.,RobinHoodPennyStocks,WKEY,91,91,0,91,1,33,21,1,NASDAQ
4583,12-02-2021 10:00,24 hrs.,RobinHoodPennyStocks,WRAP,91,91,0,91,1,33,21,1,NASDAQ
4583,12-02-2021 10:00,24 hrs.,RobinHoodPennyStocks,XCUR,67,0,67,-67,1,26,11,1,NASDAQ
4583,12-02-2021 10:00,24 hrs.,RobinHoodPennyStocks,XSPA,36,0,36,-36,1,12,8,1,NASDAQ
4583,12-02-2021 10:00,24 hrs.,RobinHoodPennyStocks,YGMZ,91,91,0,91,1,33,21,1,NASDAQ
4583,12-02-2021 10:00,24 hrs.,RobinHoodPennyStocks,ZSAN,311,46,265,-219,7,75,133,7,NASDAQ
4583,12-02-2021 10:00,24 hrs.,RobinHoodPennyStocks,ZYNE,59,0,59,-59,1,11,33,1,NASDAQ
4583,12-02-2021 10:00,24 hrs.,RobinHoodPennyStocks,UONEK,91,91,0,91,1,33,21,1,NASDAQ
4583,12-02-2021 10:00,24 hrs.,RobinHoodPennyStocks,SALM,91,91,0,91,1,33,21,1,NASDAQ
4583,12-02-2021 10:00,24 hrs.,RobinHoodPennyStocks,SAVA,91,91,0,91,1,33,21,1,NASDAQ
4583,12-02-2021 10:00,24 hrs.,RobinHoodPennyStocks,SEED,91,91,0,91,1,33,21,1,NASDAQ
4583,12-02-2021 10:00,24 hrs.,RobinHoodPennyStocks,SGOC,91,91,0,91,1,33,21,1,NASDAQ
4583,12-02-2021 10:00,24 hrs.,RobinHoodPennyStocks,SHIP,18,6,12,-6,3,3,0,2,NASDAQ
4583,12-02-2021 10:00,24 hrs.,RobinHoodPennyStocks,SNDL,6324,147,6177,-6030,79,2352,1304,65,NASDAQ
4583,12-02-2021 10:00,24 hrs.,RobinHoodPennyStocks,SNGX,99,18,81,-63,4,36,11,4,NASDAQ
4583,12-02-2021 10:00,24 hrs.,RobinHoodPennyStocks,SONM,55,0,55,-55,1,21,9,1,NASDAQ
4583,12-02-2021 10:00,24 hrs.,RobinHoodPennyStocks,SRGA,15,0,15,-15,1,4,3,1,NASDAQ
4583,12-02-2021 10:00,24 hrs.,RobinHoodPennyStocks,SUNW,91,91,0,91,1,33,21,1,NASDAQ
4583,12-02-2021 10:00,24 hrs.,RobinHoodPennyStocks,SXTC,91,91,0,91,1,33,21,1,NASDAQ
4583,12-02-2021 10:00,24 hrs.,RobinHoodPennyStocks,SYPR,91,91,0,91,1,33,21,1,NASDAQ
4583,12-02-2021 10:00,24 hrs.,RobinHoodPennyStocks,TAIT,91,91,0,91,1,33,21,1,NASDAQ
4583,12-02-2021 10:00,24 hrs.,RobinHoodPennyStocks,TANH,91,91,0,91,1,33,21,1,NASDAQ
4583,12-02-2021 10:00,24 hrs.,RobinHoodPennyStocks,GLMD,259,259,0,259,1,49,157,1,NASDAQ
4583,12-02-2021 10:00,24 hrs.,RobinHoodPennyStocks,GMDA,6,6,0,6,1,1,0,1,NASDAQ
4583,12-02-2021 10:00,24 hrs.,RobinHoodPennyStocks,GRIL,91,91,0,91,1,33,21,1,NASDAQ
4583,12-02-2021 10:00,24 hrs.,RobinHoodPennyStocks,GRWG,6,0,6,-6,1,1,0,1,NASDAQ
4583,12-02-2021 10:00,24 hrs.,RobinHoodPennyStocks,HCDI,91,91,0,91,1,33,21,1,NASDAQ
4583,12-02-2021 10:00,24 hrs.,RobinHoodPennyStocks,HGSH,91,91,0,91,1,33,21,1,NASDAQ
4583,12-02-2021 10:00,24 hrs.,RobinHoodPennyStocks,IDEX,91,91,0,91,1,33,21,1,NASDAQ
4583,12-02-2021 10:00,24 hrs.,RobinHoodPennyStocks,IFMK,91,91,0,91,1,33,21,1,NASDAQ
4583,12-02-2021 10:00,24 hrs.,RobinHoodPennyStocks,IMTE,91,91,0,91,1,33,21,1,NASDAQ
4583,12-02-2021 10:00,24 hrs.,RobinHoodPennyStocks,INPX,25,0,25,-25,4,4,1,4,NASDAQ
4583,12-02-2021 10:00,24 hrs.,RobinHoodPennyStocks,ITRM,28,0,28,-28,4,5,2,4,NASDAQ
4583,12-02-2021 10:00,24 hrs.,RobinHoodPennyStocks,IZEA,91,91,0,91,1,33,21,1,NASDAQ
4583,12-02-2021 10:00,24 hrs.,wallstreetbets,WVE,6,0,6,-6,1,1,0,1,NASDAQ
4583,12-02-2021 10:00,24 hrs.,wallstreetbets,AACG,6,0,6,-6,1,1,0,1,NASDAQ
4583,12-02-2021 10:00,24 hrs.,wallstreetbets,AAPL,1773,203,1570,-1367,12,695,335,12,NASDAQ
4583,12-02-2021 10:00,24 hrs.,wallstreetbets,ABEO,6,0,6,-6,1,1,0,1,NASDAQ
4583,12-02-2021 10:00,24 hrs.,wallstreetbets,ABIO,7,7,0,7,1,1,1,1,NASDAQ
4583,12-02-2021 10:00,24 hrs.,wallstreetbets,ABNB,14,14,0,14,2,2,2,2,NASDAQ
4583,12-02-2021 10:00,24 hrs.,wallstreetbets,ACEV,6,0,6,-6,1,1,0,1,NASDAQ
4583,12-02-2021 10:00,24 hrs.,wallstreetbets,ACIU,54,0,54,-54,9,9,0,6,NASDAQ
4583,12-02-2021 10:00,24 hrs.,wallstreetbets,ACRX,6,0,6,-6,1,1,0,1,NASDAQ
4583,12-02-2021 10:00,24 hrs.,wallstreetbets,ACST,6,0,6,-6,1,1,0,1,NASDAQ
4583,12-02-2021 10:00,24 hrs.,wallstreetbets,ADMA,6,0,6,-6,1,1,0,1,NASDAQ
4583,12-02-2021 10:00,24 hrs.,wallstreetbets,ADMP,12,0,12,-12,2,2,0,2,NASDAQ
4583,12-02-2021 10:00,24 hrs.,wallstreetbets,ADTX,7,0,7,-7,1,1,1,1,NASDAQ
4583,12-02-2021 10:00,24 hrs.,wallstreetbets,ADXS,6,0,6,-6,1,1,0,1,NASDAQ
4583,12-02-2021 10:00,24 hrs.,wallstreetbets,AESE,30,0,30,-30,5,5,0,2,NASDAQ
4583,12-02-2021 10:00,24 hrs.,wallstreetbets,AEZS,6,0,6,-6,1,1,0,1,NASDAQ
4583,12-02-2021 10:00,24 hrs.,wallstreetbets,AGRX,6,0,6,-6,1,1,0,1,NASDAQ
4583,12-02-2021 10:00,24 hrs.,wallstreetbets,AGTC,62,14,48,-34,10,10,2,10,NASDAQ
4583,12-02-2021 10:00,24 hrs.,wallstreetbets,AIKI,19,0,19,-19,3,3,1,1,NASDAQ
4583,12-02-2021 10:00,24 hrs.,wallstreetbets,AKAM,6,0,6,-6,1,1,0,1,NASDAQ
4583,12-02-2021 10:00,24 hrs.,wallstreetbets,AKBA,12,0,12,-12,2,2,0,1,NASDAQ
4583,12-02-2021 10:00,24 hrs.,wallstreetbets,AKER,12,0,12,-12,2,2,0,2,NASDAQ
4583,12-02-2021 10:00,24 hrs.,wallstreetbets,ALGM,6,6,0,6,1,1,0,1,NASDAQ
4583,12-02-2021 10:00,24 hrs.,wallstreetbets,ALJJ,7,7,0,7,1,1,1,1,NASDAQ
4583,12-02-2021 10:00,24 hrs.,wallstreetbets,ALOT,6,0,6,-6,1,1,0,1,NASDAQ
4583,12-02-2021 10:00,24 hrs.,wallstreetbets,AMAT,19,19,0,19,3,3,1,2,NASDAQ
4583,12-02-2021 10:00,24 hrs.,wallstreetbets,AMKR,405,0,405,-405,5,144,97,3,NASDAQ
4583,12-02-2021 10:00,24 hrs.,wallstreetbets,AMRK,6,0,6,-6,1,1,0,1,NASDAQ
4583,12-02-2021 10:00,24 hrs.,wallstreetbets,AMRN,6,0,6,-6,1,1,0,1,NASDAQ
4583,12-02-2021 10:00,24 hrs.,wallstreetbets,AMZN,2432,88,2344,-2256,9,1012,372,7,NASDAQ
4583,12-02-2021 10:00,24 hrs.,wallstreetbets,ANTE,6,0,6,-6,1,1,0,1,NASDAQ
4583,12-02-2021 10:00,24 hrs.,wallstreetbets,APHA,112582,43511,69071,-25560,160,51834,8274,122,NASDAQ
4583,12-02-2021 10:00,24 hrs.,wallstreetbets,APOP,6,0,6,-6,1,1,0,1,NASDAQ
4583,12-02-2021 10:00,24 hrs.,wallstreetbets,APPS,6,0,6,-6,1,1,0,1,NASDAQ
4583,12-02-2021 10:00,24 hrs.,wallstreetbets,APRE,12,0,12,-12,2,2,0,1,NASDAQ
4583,12-02-2021 10:00,24 hrs.,wallstreetbets,APXT,35,29,6,23,5,5,5,4,NASDAQ
4583,12-02-2021 10:00,24 hrs.,wallstreetbets,AQMS,7,7,0,7,1,1,1,1,NASDAQ
4583,12-02-2021 10:00,24 hrs.,wallstreetbets,AQST,6,6,0,6,1,1,0,1,NASDAQ
4583,12-02-2021 10:00,24 hrs.,wallstreetbets,ARAY,6,0,6,-6,1,1,0,1,NASDAQ
4583,12-02-2021 10:00,24 hrs.,wallstreetbets,ARCT,18,0,18,-18,3,3,0,1,NASDAQ
4583,12-02-2021 10:00,24 hrs.,wallstreetbets,ARTL,6,0,6,-6,1,1,0,1,NASDAQ
4583,12-02-2021 10:00,24 hrs.,wallstreetbets,ASML,21,12,9,3,3,3,3,2,NASDAQ
4583,12-02-2021 10:00,24 hrs.,wallstreetbets,ASRT,30,6,24,-18,5,5,0,5,NASDAQ
4583,12-02-2021 10:00,24 hrs.,wallstreetbets,ATEC,6,0,6,-6,1,1,0,1,NASDAQ
4583,12-02-2021 10:00,24 hrs.,wallstreetbets,ATHA,6,0,6,-6,1,1,0,1,NASDAQ
4583,12-02-2021 10:00,24 hrs.,wallstreetbets,ATHX,37,7,30,-23,6,6,1,3,NASDAQ
4583,12-02-2021 10:00,24 hrs.,wallstreetbets,ATNF,25,7,18,-11,4,4,1,4,NASDAQ
4583,12-02-2021 10:00,24 hrs.,wallstreetbets,ATOS,19,7,12,-5,3,3,1,2,NASDAQ
4583,12-02-2021 10:00,24 hrs.,wallstreetbets,AUTL,14,14,0,14,2,2,2,1,NASDAQ
4583,12-02-2021 10:00,24 hrs.,wallstreetbets,AUVI,6,0,6,-6,1,1,0,1,NASDAQ
4583,12-02-2021 10:00,24 hrs.,wallstreetbets,AVAV,6,0,6,-6,1,1,0,1,NASDAQ
4583,12-02-2021 10:00,24 hrs.,wallstreetbets,AVGR,30,0,30,-30,5,5,0,4,NASDAQ
4583,12-02-2021 10:00,24 hrs.,wallstreetbets,AVXL,6,0,6,-6,1,1,0,1,NASDAQ
4583,12-02-2021 10:00,24 hrs.,wallstreetbets,AXDX,27,21,6,15,4,4,3,2,NASDAQ
4583,12-02-2021 10:00,24 hrs.,wallstreetbets,JFU,18,0,18,-18,3,3,0,3,NASDAQ
4583,12-02-2021 10:00,24 hrs.,wallstreetbets,KHC,634,6,628,-622,3,245,132,3,NASDAQ
4583,12-02-2021 10:00,24 hrs.,wallstreetbets,MGI,9,9,0,9,1,1,3,1,NASDAQ
4583,12-02-2021 10:00,24 hrs.,wallstreetbets,MOR,56,0,56,-56,1,9,34,1,NASDAQ
4583,12-02-2021 10:00,24 hrs.,wallstreetbets,MWK,8,0,8,-8,1,2,0,1,NASDAQ
4583,12-02-2021 10:00,24 hrs.,wallstreetbets,NPA,7,7,0,7,1,1,1,1,NASDAQ
4583,12-02-2021 10:00,24 hrs.,wallstreetbets,OGI,586,70,516,-446,44,117,176,40,NASDAQ
4583,12-02-2021 10:00,24 hrs.,wallstreetbets,OLB,6,0,6,-6,1,1,0,1,NASDAQ
4583,12-02-2021 10:00,24 hrs.,wallstreetbets,OPK,6,0,6,-6,1,1,0,1,NASDAQ
4583,12-02-2021 10:00,24 hrs.,wallstreetbets,OPT,13,7,6,1,2,2,1,2,NASDAQ
4583,12-02-2021 10:00,24 hrs.,wallstreetbets,BILI,12,0,12,-12,2,2,0,1,NASDAQ
4583,12-02-2021 10:00,24 hrs.,wallstreetbets,BIOC,7,7,0,7,1,1,1,1,NASDAQ
4583,12-02-2021 10:00,24 hrs.,wallstreetbets,BLCM,6,0,6,-6,1,1,0,1,NASDAQ
4583,12-02-2021 10:00,24 hrs.,wallstreetbets,BLCT,6,0,6,-6,1,1,0,1,NASDAQ
4583,12-02-2021 10:00,24 hrs.,wallstreetbets,BLNK,6,0,6,-6,1,1,0,1,NASDAQ
4583,12-02-2021 10:00,24 hrs.,wallstreetbets,BLUE,18,0,18,-18,3,3,0,3,NASDAQ
4583,12-02-2021 10:00,24 hrs.,wallstreetbets,BNGO,31,7,24,-17,5,5,1,5,NASDAQ
4583,12-02-2021 10:00,24 hrs.,wallstreetbets,BPTH,25,0,25,-25,4,4,1,3,NASDAQ
4583,12-02-2021 10:00,24 hrs.,wallstreetbets,BRQS,31,7,24,-17,5,5,1,4,NASDAQ
4583,12-02-2021 10:00,24 hrs.,wallstreetbets,BWEN,6,0,6,-6,1,1,0,1,NASDAQ
4583,12-02-2021 10:00,24 hrs.,wallstreetbets,CAKE,6,0,6,-6,1,1,0,1,NASDAQ
4583,12-02-2021 10:00,24 hrs.,wallstreetbets,CALM,6,0,6,-6,1,1,0,1,NASDAQ
4583,12-02-2021 10:00,24 hrs.,wallstreetbets,CARV,13,7,6,1,2,2,1,2,NASDAQ
4583,12-02-2021 10:00,24 hrs.,wallstreetbets,CASA,6,0,6,-6,1,1,0,1,NASDAQ
4583,12-02-2021 10:00,24 hrs.,wallstreetbets,CASH,6,0,6,-6,1,1,0,1,NASDAQ
4583,12-02-2021 10:00,24 hrs.,wallstreetbets,CCNC,6,0,6,-6,1,1,0,1,NASDAQ
4583,12-02-2021 10:00,24 hrs.,wallstreetbets,CCRN,6,0,6,-6,1,1,0,1,NASDAQ
4583,12-02-2021 10:00,24 hrs.,wallstreetbets,CENT,6,0,6,-6,1,1,0,1,NASDAQ
4583,12-02-2021 10:00,24 hrs.,wallstreetbets,CFII,6,0,6,-6,1,1,0,1,NASDAQ
4583,12-02-2021 10:00,24 hrs.,wallstreetbets,CGIX,20,14,6,8,3,3,2,2,NASDAQ
4583,12-02-2021 10:00,24 hrs.,wallstreetbets,CGRO,12,0,12,-12,2,2,0,2,NASDAQ
4583,12-02-2021 10:00,24 hrs.,wallstreetbets,CHKP,6,0,6,-6,1,1,0,1,NASDAQ
4583,12-02-2021 10:00,24 hrs.,wallstreetbets,CIDM,6,0,6,-6,1,1,0,1,NASDAQ
4583,12-02-2021 10:00,24 hrs.,wallstreetbets,CKPT,18,0,18,-18,3,3,0,2,NASDAQ
4583,12-02-2021 10:00,24 hrs.,wallstreetbets,CLBS,12,0,12,-12,2,2,0,2,NASDAQ
4583,12-02-2021 10:00,24 hrs.,wallstreetbets,CLCT,6,6,0,6,1,1,0,1,NASDAQ
4583,12-02-2021 10:00,24 hrs.,wallstreetbets,CLNE,126,0,126,-126,2,38,42,2,NASDAQ
4583,12-02-2021 10:00,24 hrs.,wallstreetbets,CLSN,19,0,19,-19,3,3,1,3,NASDAQ
4583,12-02-2021 10:00,24 hrs.,wallstreetbets,CLVR,44,0,44,-44,8,6,0,7,NASDAQ
4583,12-02-2021 10:00,24 hrs.,wallstreetbets,CLVS,40,28,12,16,6,6,4,5,NASDAQ
4583,12-02-2021 10:00,24 hrs.,wallstreetbets,CMLF,7,7,0,7,1,1,1,1,NASDAQ
4583,12-02-2021 10:00,24 hrs.,wallstreetbets,CMPS,3367,15,3352,-3337,11,1363,597,6,NASDAQ
4583,12-02-2021 10:00,24 hrs.,wallstreetbets,CNDT,13,7,6,1,2,2,1,2,NASDAQ
4583,12-02-2021 10:00,24 hrs.,wallstreetbets,CNET,6,0,6,-6,1,1,0,1,NASDAQ
4583,12-02-2021 10:00,24 hrs.,wallstreetbets,CNSP,7,7,0,7,1,1,1,1,NASDAQ
4583,12-02-2021 10:00,24 hrs.,wallstreetbets,CODX,13,7,6,1,2,2,1,2,NASDAQ
4583,12-02-2021 10:00,24 hrs.,wallstreetbets,COST,18,0,18,-18,3,3,0,3,NASDAQ
4583,12-02-2021 10:00,24 hrs.,wallstreetbets,CPRX,6,0,6,-6,1,1,0,1,NASDAQ
4583,12-02-2021 10:00,24 hrs.,wallstreetbets,CPST,12,0,12,-12,2,2,0,1,NASDAQ
4583,12-02-2021 10:00,24 hrs.,wallstreetbets,CRBP,31,7,24,-17,5,5,1,5,NASDAQ
4583,12-02-2021 10:00,24 hrs.,wallstreetbets,CREE,6,0,6,-6,1,1,0,1,NASDAQ
4583,12-02-2021 10:00,24 hrs.,wallstreetbets,CREG,12,0,12,-12,2,2,0,2,NASDAQ
4583,12-02-2021 10:00,24 hrs.,wallstreetbets,CRIS,6,0,6,-6,1,1,0,1,NASDAQ
4583,12-02-2021 10:00,24 hrs.,wallstreetbets,CRNT,12,0,12,-12,2,2,0,2,NASDAQ
4583,12-02-2021 10:00,24 hrs.,wallstreetbets,CRON,182,0,182,-182,12,33,68,8,NASDAQ
4583,12-02-2021 10:00,24 hrs.,wallstreetbets,CROX,6,0,6,-6,1,1,0,1,NASDAQ
4583,12-02-2021 10:00,24 hrs.,wallstreetbets,CRSP,6,0,6,-6,1,1,0,1,NASDAQ
4583,12-02-2021 10:00,24 hrs.,wallstreetbets,CRSR,3785,3194,591,2603,4,1615,539,4,NASDAQ
4583,12-02-2021 10:00,24 hrs.,wallstreetbets,CSCW,12,0,12,-12,2,2,0,2,NASDAQ
4583,12-02-2021 10:00,24 hrs.,wallstreetbets,CTRM,770,152,618,-466,126,126,14,106,NASDAQ
4583,12-02-2021 10:00,24 hrs.,wallstreetbets,CTRN,6,0,6,-6,1,1,0,1,NASDAQ
4583,12-02-2021 10:00,24 hrs.,wallstreetbets,CVAC,6,0,6,-6,1,1,0,1,NASDAQ
4583,12-02-2021 10:00,24 hrs.,wallstreetbets,DBVT,14,14,0,14,2,2,2,1,NASDAQ
4583,12-02-2021 10:00,24 hrs.,wallstreetbets,DCRB,13,0,13,-13,2,2,1,2,NASDAQ
4583,12-02-2021 10:00,24 hrs.,wallstreetbets,DDOG,51,0,51,-51,3,16,7,3,NASDAQ
4583,12-02-2021 10:00,24 hrs.,wallstreetbets,DGLY,12,0,12,-12,2,2,0,1,NASDAQ
4583,12-02-2021 10:00,24 hrs.,wallstreetbets,DKNG,914,6,908,-902,4,383,132,3,NASDAQ
4583,12-02-2021 10:00,24 hrs.,wallstreetbets,TTD,6,0,6,-6,1,1,0,1,NASDAQ
4583,12-02-2021 10:00,24 hrs.,wallstreetbets,TXN,383,0,383,-383,1,136,107,1,NASDAQ
4583,12-02-2021 10:00,24 hrs.,wallstreetbets,UAL,7,7,0,7,1,1,1,1,NASDAQ
4583,12-02-2021 10:00,24 hrs.,wallstreetbets,UFO,6,6,0,6,1,1,0,1,NASDAQ
4583,12-02-2021 10:00,24 hrs.,wallstreetbets,VFF,225,8,217,-209,7,48,101,6,NASDAQ
4583,12-02-2021 10:00,24 hrs.,wallstreetbets,WDC,36,0,36,-36,2,11,6,1,NASDAQ
4583,12-02-2021 10:00,24 hrs.,wallstreetbets,WNW,12,0,12,-12,2,2,0,2,NASDAQ
4583,12-02-2021 10:00,24 hrs.,wallstreetbets,FLUX,12,0,12,-12,2,2,0,1,NASDAQ
4583,12-02-2021 10:00,24 hrs.,wallstreetbets,FLWR,18,0,18,-18,3,3,0,3,NASDAQ
4583,12-02-2021 10:00,24 hrs.,wallstreetbets,FNKO,12,6,6,0,2,2,0,2,NASDAQ
4583,12-02-2021 10:00,24 hrs.,wallstreetbets,FOLD,20,6,14,-8,3,3,2,2,NASDAQ
4583,12-02-2021 10:00,24 hrs.,wallstreetbets,FORD,20,0,20,-20,3,3,2,3,NASDAQ
4583,12-02-2021 10:00,24 hrs.,wallstreetbets,FROG,6,0,6,-6,1,1,0,1,NASDAQ
4583,12-02-2021 10:00,24 hrs.,wallstreetbets,FRSX,6,0,6,-6,1,1,0,1,NASDAQ
4583,12-02-2021 10:00,24 hrs.,wallstreetbets,FTOC,6,0,6,-6,1,1,0,1,NASDAQ
4583,12-02-2021 10:00,24 hrs.,wallstreetbets,FUTU,346,0,346,-346,1,102,138,1,NASDAQ
4583,12-02-2021 10:00,24 hrs.,wallstreetbets,GAIN,48,22,26,-4,7,7,6,7,NASDAQ
4583,12-02-2021 10:00,24 hrs.,wallstreetbets,GDRX,7,0,7,-7,1,1,1,1,NASDAQ
4583,12-02-2021 10:00,24 hrs.,wallstreetbets,GERN,7,7,0,7,1,1,1,1,NASDAQ
4583,12-02-2021 10:00,24 hrs.,wallstreetbets,GEVO,38,7,31,-24,6,6,2,5,NASDAQ
4583,12-02-2021 10:00,24 hrs.,wallstreetbets,GHIV,346,0,346,-346,1,102,138,1,NASDAQ
4583,12-02-2021 10:00,24 hrs.,wallstreetbets,GHSI,26,14,12,2,4,4,2,3,NASDAQ
4583,12-02-2021 10:00,24 hrs.,wallstreetbets,GILT,6,0,6,-6,1,1,0,1,NASDAQ
4583,12-02-2021 10:00,24 hrs.,wallstreetbets,GLBS,6,0,6,-6,1,1,0,1,NASDAQ
4583,12-02-2021 10:00,24 hrs.,wallstreetbets,GLSI,8,8,0,8,1,1,2,1,NASDAQ
4583,12-02-2021 10:00,24 hrs.,wallstreetbets,GLUU,6,0,6,-6,1,1,0,1,NASDAQ
4583,12-02-2021 10:00,24 hrs.,wallstreetbets,GMBL,6,0,6,-6,1,1,0,1,NASDAQ
4583,12-02-2021 10:00,24 hrs.,wallstreetbets,GNLN,12,0,12,-12,2,2,0,2,NASDAQ
4583,12-02-2021 10:00,24 hrs.,wallstreetbets,GNMK,6,0,6,-6,1,1,0,1,NASDAQ
4583,12-02-2021 10:00,24 hrs.,wallstreetbets,GNOG,19,13,6,7,3,3,1,3,NASDAQ
4583,12-02-2021 10:00,24 hrs.,wallstreetbets,GOEV,226,0,226,-226,11,68,46,4,NASDAQ
4583,12-02-2021 10:00,24 hrs.,wallstreetbets,GOGO,31,19,12,7,5,5,1,3,NASDAQ
4583,12-02-2021 10:00,24 hrs.,wallstreetbets,GOLD,259,16,243,-227,6,84,67,6,NASDAQ
4583,12-02-2021 10:00,24 hrs.,wallstreetbets,GOOG,1410,0,1410,-1410,1,608,190,1,NASDAQ
4583,12-02-2021 10:00,24 hrs.,wallstreetbets,GPRO,12,0,12,-12,2,2,0,2,NASDAQ
4583,12-02-2021 10:00,24 hrs.,wallstreetbets,GRID,12,0,12,-12,2,2,0,1,NASDAQ
4583,12-02-2021 10:00,24 hrs.,wallstreetbets,GRIL,25,19,6,13,4,4,1,4,NASDAQ
4583,12-02-2021 10:00,24 hrs.,wallstreetbets,GRMN,6,0,6,-6,1,1,0,1,NASDAQ
4583,12-02-2021 10:00,24 hrs.,wallstreetbets,GRTS,6,0,6,-6,1,1,0,1,NASDAQ
4583,12-02-2021 10:00,24 hrs.,wallstreetbets,GRWG,224,13,211,-198,7,48,100,7,NASDAQ
4583,12-02-2021 10:00,24 hrs.,wallstreetbets,GTEC,12,0,12,-12,2,2,0,1,NASDAQ
4583,12-02-2021 10:00,24 hrs.,wallstreetbets,GTHX,7,7,0,7,1,1,1,1,NASDAQ
4583,12-02-2021 10:00,24 hrs.,wallstreetbets,HALO,38,0,38,-38,6,7,0,4,NASDAQ
4583,12-02-2021 10:00,24 hrs.,wallstreetbets,HEAR,6,0,6,-6,1,1,0,1,NASDAQ
4583,12-02-2021 10:00,24 hrs.,wallstreetbets,HEPA,9,9,0,9,1,1,3,1,NASDAQ
4583,12-02-2021 10:00,24 hrs.,wallstreetbets,DLPN,12,0,12,-12,2,2,0,1,NASDAQ
4583,12-02-2021 10:00,24 hrs.,wallstreetbets,DMTK,12,0,12,-12,2,2,0,1,NASDAQ
4583,12-02-2021 10:00,24 hrs.,wallstreetbets,DTIL,6,0,6,-6,1,1,0,1,NASDAQ
4583,12-02-2021 10:00,24 hrs.,wallstreetbets,DXCM,6,0,6,-6,1,1,0,1,NASDAQ
4583,12-02-2021 10:00,24 hrs.,wallstreetbets,EBON,6,0,6,-6,1,1,0,1,NASDAQ
4583,12-02-2021 10:00,24 hrs.,wallstreetbets,EDIT,10812,932,9880,-8948,3,4918,964,3,NASDAQ
4583,12-02-2021 10:00,24 hrs.,wallstreetbets,EDSA,24,0,24,-24,4,4,0,2,NASDAQ
4583,12-02-2021 10:00,24 hrs.,wallstreetbets,ELSE,6,0,6,-6,1,1,0,1,NASDAQ
4583,12-02-2021 10:00,24 hrs.,wallstreetbets,ENLV,6,0,6,-6,1,1,0,1,NASDAQ
4583,12-02-2021 10:00,24 hrs.,wallstreetbets,ENPH,6,0,6,-6,1,1,0,1,NASDAQ
4583,12-02-2021 10:00,24 hrs.,wallstreetbets,ENVB,13,7,6,1,2,2,1,2,NASDAQ
4583,12-02-2021 10:00,24 hrs.,wallstreetbets,ERIC,7,7,0,7,1,1,1,1,NASDAQ
4583,12-02-2021 10:00,24 hrs.,wallstreetbets,ESPR,18,0,18,-18,3,3,0,3,NASDAQ
4583,12-02-2021 10:00,24 hrs.,wallstreetbets,ETSY,12,6,6,0,2,2,0,2,NASDAQ
4583,12-02-2021 10:00,24 hrs.,wallstreetbets,EVER,739,6,733,-727,2,297,137,2,NASDAQ
4583,12-02-2021 10:00,24 hrs.,wallstreetbets,EVFM,6,0,6,-6,1,1,0,1,NASDAQ
4583,12-02-2021 10:00,24 hrs.,wallstreetbets,EYES,26,26,0,26,4,4,2,1,NASDAQ
4583,12-02-2021 10:00,24 hrs.,wallstreetbets,FANG,7,7,0,7,1,1,1,1,NASDAQ
4583,12-02-2021 10:00,24 hrs.,wallstreetbets,FAST,12,0,12,-12,2,2,0,2,NASDAQ
4583,12-02-2021 10:00,24 hrs.,wallstreetbets,FCEL,19,7,12,-5,3,3,1,3,NASDAQ
4583,12-02-2021 10:00,24 hrs.,wallstreetbets,AYRO,12,0,12,-12,2,2,0,1,NASDAQ
4583,12-02-2021 10:00,24 hrs.,wallstreetbets,BBBY,36,0,36,-36,6,6,0,6,NASDAQ
4583,12-02-2021 10:00,24 hrs.,wallstreetbets,BCRX,6,0,6,-6,1,1,0,1,NASDAQ
4583,12-02-2021 10:00,24 hrs.,wallstreetbets,BEAT,12,6,6,0,2,2,0,2,NASDAQ
4583,12-02-2021 10:00,24 hrs.,wallstreetbets,BHAT,12,0,12,-12,2,2,0,2,NASDAQ
4583,12-02-2021 10:00,24 hrs.,wallstreetbets,BIGC,47,35,12,23,7,7,5,4,NASDAQ
4583,12-02-2021 10:00,24 hrs.,wallstreetbets,MGNI,35,7,28,-21,5,5,5,5,NASDAQ
4583,12-02-2021 10:00,24 hrs.,wallstreetbets,MITK,6,0,6,-6,1,1,0,1,NASDAQ
4583,12-02-2021 10:00,24 hrs.,wallstreetbets,MITO,6,0,6,-6,1,1,0,1,NASDAQ
4583,12-02-2021 10:00,24 hrs.,wallstreetbets,MNPR,6,6,0,6,1,1,0,1,NASDAQ
4583,12-02-2021 10:00,24 hrs.,wallstreetbets,MOGO,7,7,0,7,1,1,1,1,NASDAQ
4583,12-02-2021 10:00,24 hrs.,wallstreetbets,MOSY,7,7,0,7,1,1,1,1,NASDAQ
4583,12-02-2021 10:00,24 hrs.,wallstreetbets,MOTS,12,0,12,-12,2,2,0,1,NASDAQ
4583,12-02-2021 10:00,24 hrs.,wallstreetbets,MRAM,6,0,6,-6,1,1,0,1,NASDAQ
4583,12-02-2021 10:00,24 hrs.,wallstreetbets,MSFT,1524,7,1517,-1510,3,624,264,3,NASDAQ
4583,12-02-2021 10:00,24 hrs.,wallstreetbets,MSTR,45,33,12,21,7,7,3,4,NASDAQ
4583,12-02-2021 10:00,24 hrs.,wallstreetbets,MVIS,741,29,712,-683,20,237,187,15,NASDAQ
4583,12-02-2021 10:00,24 hrs.,wallstreetbets,NAKD,524,89,435,-346,85,86,12,71,NASDAQ
4583,12-02-2021 10:00,24 hrs.,wallstreetbets,NAOV,6,0,6,-6,1,1,0,1,NASDAQ
4583,12-02-2021 10:00,24 hrs.,wallstreetbets,NBEV,8,8,0,8,1,2,0,1,NASDAQ
4583,12-02-2021 10:00,24 hrs.,wallstreetbets,NCLH,7,0,7,-7,1,1,1,1,NASDAQ
4583,12-02-2021 10:00,24 hrs.,wallstreetbets,NDRA,13,7,6,1,2,2,1,2,NASDAQ
4583,12-02-2021 10:00,24 hrs.,wallstreetbets,NEOS,6,0,6,-6,1,1,0,1,NASDAQ
4583,12-02-2021 10:00,24 hrs.,wallstreetbets,NEPT,31,7,24,-17,5,5,1,4,NASDAQ
4583,12-02-2021 10:00,24 hrs.,wallstreetbets,NKLA,26,14,12,2,4,4,2,4,NASDAQ
4583,12-02-2021 10:00,24 hrs.,wallstreetbets,HGEN,12,0,12,-12,2,2,0,2,NASDAQ
4583,12-02-2021 10:00,24 hrs.,wallstreetbets,HIMX,7,7,0,7,1,1,1,1,NASDAQ
4583,12-02-2021 10:00,24 hrs.,wallstreetbets,HOFV,12,0,12,-12,2,2,0,1,NASDAQ
4583,12-02-2021 10:00,24 hrs.,wallstreetbets,HSTO,13,7,6,1,2,2,1,2,NASDAQ
4583,12-02-2021 10:00,24 hrs.,wallstreetbets,HTBX,6,6,0,6,1,1,0,1,NASDAQ
4583,12-02-2021 10:00,24 hrs.,wallstreetbets,IBKR,521,0,521,-521,6,162,173,5,NASDAQ
4583,12-02-2021 10:00,24 hrs.,wallstreetbets,ICLN,12,6,6,0,2,2,0,2,NASDAQ
4583,12-02-2021 10:00,24 hrs.,wallstreetbets,ICPT,12,0,12,-12,2,2,0,2,NASDAQ
4583,12-02-2021 10:00,24 hrs.,wallstreetbets,IDEX,65,35,30,5,10,10,5,6,NASDAQ
4583,12-02-2021 10:00,24 hrs.,wallstreetbets,IDXG,12,0,12,-12,2,2,0,1,NASDAQ
4583,12-02-2021 10:00,24 hrs.,wallstreetbets,IFMK,26,14,12,2,4,4,2,3,NASDAQ
4583,12-02-2021 10:00,24 hrs.,wallstreetbets,IMGN,78,78,0,78,1,24,26,1,NASDAQ
4583,12-02-2021 10:00,24 hrs.,wallstreetbets,IMMR,8,8,0,8,1,1,2,1,NASDAQ
4583,12-02-2021 10:00,24 hrs.,wallstreetbets,INFI,70,21,49,-28,11,11,4,3,NASDAQ
4583,12-02-2021 10:00,24 hrs.,wallstreetbets,INFO,8,8,0,8,1,1,2,1,NASDAQ
4583,12-02-2021 10:00,24 hrs.,wallstreetbets,INPX,67,19,48,-29,11,11,1,10,NASDAQ
4583,12-02-2021 10:00,24 hrs.,wallstreetbets,INTC,39,7,32,-25,6,7,1,4,NASDAQ
4583,12-02-2021 10:00,24 hrs.,wallstreetbets,IRBT,654,14,640,-626,6,248,134,6,NASDAQ
4583,12-02-2021 10:00,24 hrs.,wallstreetbets,IRDM,6,0,6,-6,1,1,0,1,NASDAQ
4583,12-02-2021 10:00,24 hrs.,wallstreetbets,ITRM,12,0,12,-12,2,2,0,2,NASDAQ
4583,12-02-2021 10:00,24 hrs.,wallstreetbets,JAGX,18,0,18,-18,3,3,0,2,NASDAQ
4583,12-02-2021 10:00,24 hrs.,wallstreetbets,JBLU,12,12,0,12,2,2,0,2,NASDAQ
4583,12-02-2021 10:00,24 hrs.,wallstreetbets,JNCE,6,6,0,6,1,1,0,1,NASDAQ
4583,12-02-2021 10:00,24 hrs.,wallstreetbets,KERN,19,13,6,7,3,3,1,3,NASDAQ
4583,12-02-2021 10:00,24 hrs.,wallstreetbets,KPTI,12,0,12,-12,2,2,0,1,NASDAQ
4583,12-02-2021 10:00,24 hrs.,wallstreetbets,KTRA,12,0,12,-12,2,2,0,1,NASDAQ
4583,12-02-2021 10:00,24 hrs.,wallstreetbets,KXIN,18,0,18,-18,3,3,0,2,NASDAQ
4583,12-02-2021 10:00,24 hrs.,wallstreetbets,LAKE,6,6,0,6,1,1,0,1,NASDAQ
4583,12-02-2021 10:00,24 hrs.,wallstreetbets,LAZR,7,7,0,7,1,1,1,1,NASDAQ
4583,12-02-2021 10:00,24 hrs.,wallstreetbets,LGHL,6,0,6,-6,1,1,0,1,NASDAQ
4583,12-02-2021 10:00,24 hrs.,wallstreetbets,LGND,6,6,0,6,1,1,0,1,NASDAQ
4583,12-02-2021 10:00,24 hrs.,wallstreetbets,LIFE,25,13,12,1,4,4,1,4,NASDAQ
4583,12-02-2021 10:00,24 hrs.,wallstreetbets,LIVE,1066,0,1066,-1066,4,413,224,4,NASDAQ
4583,12-02-2021 10:00,24 hrs.,wallstreetbets,LIVX,15,15,0,15,2,2,3,1,NASDAQ
4583,12-02-2021 10:00,24 hrs.,wallstreetbets,LKCO,67,6,61,-55,11,11,1,5,NASDAQ
4583,12-02-2021 10:00,24 hrs.,wallstreetbets,LLIT,6,0,6,-6,1,1,0,1,NASDAQ
4583,12-02-2021 10:00,24 hrs.,wallstreetbets,LLNW,28,22,6,16,4,4,4,4,NASDAQ
4583,12-02-2021 10:00,24 hrs.,wallstreetbets,LRCX,6,0,6,-6,1,1,0,1,NASDAQ
4583,12-02-2021 10:00,24 hrs.,wallstreetbets,MARA,78,38,40,-2,12,13,4,10,NASDAQ
4583,12-02-2021 10:00,24 hrs.,wallstreetbets,MARK,6,0,6,-6,1,1,0,1,NASDAQ
4583,12-02-2021 10:00,24 hrs.,wallstreetbets,MBRX,19,19,0,19,3,3,1,2,NASDAQ
4583,12-02-2021 10:00,24 hrs.,wallstreetbets,MCHP,383,0,383,-383,1,136,107,1,NASDAQ
4583,12-02-2021 10:00,24 hrs.,wallstreetbets,MESO,6,0,6,-6,1,1,0,1,NASDAQ
4583,12-02-2021 10:00,24 hrs.,wallstreetbets,METX,6,0,6,-6,1,1,0,1,NASDAQ
4583,12-02-2021 10:00,24 hrs.,wallstreetbets,FLDM,7,7,0,7,1,1,1,1,NASDAQ
4583,12-02-2021 10:00,24 hrs.,wallstreetbets,NLOK,13,0,13,-13,2,2,1,1,NASDAQ
4583,12-02-2021 10:00,24 hrs.,wallstreetbets,NNDM,33,7,26,-19,5,6,1,4,NASDAQ
4583,12-02-2021 10:00,24 hrs.,wallstreetbets,NNOX,6,0,6,-6,1,1,0,1,NASDAQ
4583,12-02-2021 10:00,24 hrs.,wallstreetbets,NOVN,7,7,0,7,1,1,1,1,NASDAQ
4583,12-02-2021 10:00,24 hrs.,wallstreetbets,NUAN,6,0,6,-6,1,1,0,1,NASDAQ
4583,12-02-2021 10:00,24 hrs.,wallstreetbets,NVAX,6,6,0,6,1,1,0,1,NASDAQ
4583,12-02-2021 10:00,24 hrs.,wallstreetbets,NVCN,32,20,12,8,5,5,2,5,NASDAQ
4583,12-02-2021 10:00,24 hrs.,wallstreetbets,NVDA,352,0,352,-352,6,136,56,3,NASDAQ
4583,12-02-2021 10:00,24 hrs.,wallstreetbets,NVIV,6,0,6,-6,1,1,0,1,NASDAQ
4583,12-02-2021 10:00,24 hrs.,wallstreetbets,NXPI,383,0,383,-383,1,136,107,1,NASDAQ
4583,12-02-2021 10:00,24 hrs.,wallstreetbets,NXTD,18,0,18,-18,3,3,0,2,NASDAQ
4583,12-02-2021 10:00,24 hrs.,wallstreetbets,OCGN,115,0,115,-115,19,19,1,16,NASDAQ
4583,12-02-2021 10:00,24 hrs.,wallstreetbets,ONTX,6,0,6,-6,1,1,0,1,NASDAQ
4583,12-02-2021 10:00,24 hrs.,wallstreetbets,ONVO,13,7,6,1,2,2,1,2,NASDAQ
4583,12-02-2021 10:00,24 hrs.,wallstreetbets,OPTT,18,0,18,-18,3,3,0,3,NASDAQ
4583,12-02-2021 10:00,24 hrs.,wallstreetbets,OSTK,9,9,0,9,1,1,3,1,NASDAQ
4583,12-02-2021 10:00,24 hrs.,wallstreetbets,OTLK,6,0,6,-6,1,1,0,1,NASDAQ
4583,12-02-2021 10:00,24 hrs.,wallstreetbets,PACB,14,14,0,14,2,2,2,1,NASDAQ
4583,12-02-2021 10:00,24 hrs.,wallstreetbets,PAVM,6,0,6,-6,1,1,0,1,NASDAQ
4583,12-02-2021 10:00,24 hrs.,wallstreetbets,PDSB,12,0,12,-12,2,2,0,1,NASDAQ
4583,12-02-2021 10:00,24 hrs.,wallstreetbets,PHIO,7,7,0,7,1,1,1,1,NASDAQ
4583,12-02-2021 10:00,24 hrs.,wallstreetbets,PLAY,405,13,392,-379,13,110,133,10,NASDAQ
4583,12-02-2021 10:00,24 hrs.,wallstreetbets,PLUG,18,0,18,-18,3,3,0,3,NASDAQ
4583,12-02-2021 10:00,24 hrs.,wallstreetbets,PODD,6,0,6,-6,1,1,0,1,NASDAQ
4583,12-02-2021 10:00,24 hrs.,wallstreetbets,POTX,12,0,12,-12,2,2,0,2,NASDAQ
4583,12-02-2021 10:00,24 hrs.,wallstreetbets,POWW,142,34,108,-74,23,23,4,17,NASDAQ
4583,12-02-2021 10:00,24 hrs.,wallstreetbets,PPBT,6,0,6,-6,1,1,0,1,NASDAQ
4583,12-02-2021 10:00,24 hrs.,wallstreetbets,PRCH,24,6,18,-12,4,4,0,3,NASDAQ
4583,12-02-2021 10:00,24 hrs.,wallstreetbets,PRPL,895,0,895,-895,1,380,131,1,NASDAQ
4583,12-02-2021 10:00,24 hrs.,wallstreetbets,PRQR,6,0,6,-6,1,1,0,1,NASDAQ
4583,12-02-2021 10:00,24 hrs.,wallstreetbets,PRTS,7,0,7,-7,1,1,1,1,NASDAQ
4583,12-02-2021 10:00,24 hrs.,wallstreetbets,PSEC,31,19,12,7,3,2,15,2,NASDAQ
4583,12-02-2021 10:00,24 hrs.,wallstreetbets,PSTV,19,7,12,-5,3,3,1,3,NASDAQ
4583,12-02-2021 10:00,24 hrs.,wallstreetbets,PTMN,18,0,18,-18,3,3,0,2,NASDAQ
4583,12-02-2021 10:00,24 hrs.,wallstreetbets,PTPI,6,0,6,-6,1,1,0,1,NASDAQ
4583,12-02-2021 10:00,24 hrs.,wallstreetbets,PUBM,12,0,12,-12,2,2,0,2,NASDAQ
4583,12-02-2021 10:00,24 hrs.,wallstreetbets,PYPL,20,7,13,-6,3,3,2,3,NASDAQ
4583,12-02-2021 10:00,24 hrs.,wallstreetbets,PZZA,7,7,0,7,1,1,1,1,NASDAQ
4583,12-02-2021 10:00,24 hrs.,wallstreetbets,QCOM,6,0,6,-6,1,1,0,1,NASDAQ
4583,12-02-2021 10:00,24 hrs.,wallstreetbets,QRVO,36,0,36,-36,2,11,6,1,NASDAQ
4583,12-02-2021 10:00,24 hrs.,wallstreetbets,QUIK,13,7,6,1,2,2,1,2,NASDAQ
4583,12-02-2021 10:00,24 hrs.,wallstreetbets,RBBN,12,0,12,-12,2,2,0,1,NASDAQ
4583,12-02-2021 10:00,24 hrs.,wallstreetbets,RCMT,50,14,36,-22,8,8,2,8,NASDAQ
4583,12-02-2021 10:00,24 hrs.,wallstreetbets,REAL,60,35,25,10,9,9,6,9,NASDAQ
4583,12-02-2021 10:00,24 hrs.,wallstreetbets,REGI,12,6,6,0,2,2,0,2,NASDAQ
4583,12-02-2021 10:00,24 hrs.,wallstreetbets,RIDE,24,6,18,-12,4,4,0,4,NASDAQ
4583,12-02-2021 10:00,24 hrs.,wallstreetbets,RIOT,59,13,46,-33,9,10,3,8,NASDAQ
4583,12-02-2021 10:00,24 hrs.,wallstreetbets,RKDA,6,0,6,-6,1,1,0,1,NASDAQ
4583,12-02-2021 10:00,24 hrs.,wallstreetbets,RMTI,38,20,18,2,6,6,2,4,NASDAQ
4583,12-02-2021 10:00,24 hrs.,wallstreetbets,ROCK,6,0,6,-6,1,1,0,1,NASDAQ
4583,12-02-2021 10:00,24 hrs.,wallstreetbets,ROLL,6,0,6,-6,1,1,0,1,NASDAQ
4583,12-02-2021 10:00,24 hrs.,wallstreetbets,ROOT,6,0,6,-6,1,1,0,1,NASDAQ
4583,12-02-2021 10:00,24 hrs.,wallstreetbets,SABR,7,7,0,7,1,1,1,1,NASDAQ
4583,12-02-2021 10:00,24 hrs.,wallstreetbets,SAGE,6,0,6,-6,1,1,0,1,NASDAQ
4583,12-02-2021 10:00,24 hrs.,wallstreetbets,SALM,6,0,6,-6,1,1,0,1,NASDAQ
4583,12-02-2021 10:00,24 hrs.,wallstreetbets,SAVA,18,6,12,-6,3,3,0,3,NASDAQ
4583,12-02-2021 10:00,24 hrs.,wallstreetbets,SAVE,33,21,12,9,5,5,3,3,NASDAQ
4583,12-02-2021 10:00,24 hrs.,wallstreetbets,SEEL,12,0,12,-12,2,2,0,2,NASDAQ
4583,12-02-2021 10:00,24 hrs.,wallstreetbets,SESN,6,0,6,-6,1,1,0,1,NASDAQ
4583,12-02-2021 10:00,24 hrs.,wallstreetbets,SFET,18,0,18,-18,3,3,0,2,NASDAQ
4583,12-02-2021 10:00,24 hrs.,wallstreetbets,SHIP,31,7,24,-17,5,5,1,5,NASDAQ
4583,12-02-2021 10:00,24 hrs.,wallstreetbets,SIEB,6,0,6,-6,1,1,0,1,NASDAQ
4583,12-02-2021 10:00,24 hrs.,wallstreetbets,SINT,18,6,12,-6,3,3,0,2,NASDAQ
4583,12-02-2021 10:00,24 hrs.,wallstreetbets,SKYY,6,0,6,-6,1,1,0,1,NASDAQ
4553,12-02-2021 04:00,24 hrs.,wallstreetbets,SPWR,6,6,0,6,1,1,0,1,NASDAQ
4553,12-02-2021 04:00,24 hrs.,wallstreetbets,SQQQ,7,7,0,7,1,1,1,1,NASDAQ
4553,12-02-2021 04:00,24 hrs.,wallstreetbets,SRAC,6,0,6,-6,1,1,0,1,NASDAQ
4553,12-02-2021 04:00,24 hrs.,wallstreetbets,SRGA,6,6,0,6,1,1,0,1,NASDAQ
4553,12-02-2021 04:00,24 hrs.,wallstreetbets,SRNE,20,14,6,8,2,5,2,2,NASDAQ
4553,12-02-2021 04:00,24 hrs.,wallstreetbets,TLRY,93450,60054,33396,26658,258,41724,8970,211,NASDAQ
4553,12-02-2021 04:00,24 hrs.,wallstreetbets,TNDM,6,0,6,-6,1,1,0,1,NASDAQ
4553,12-02-2021 04:00,24 hrs.,wallstreetbets,TNXP,204,156,48,108,32,33,10,28,NASDAQ
4553,12-02-2021 04:00,24 hrs.,wallstreetbets,TOPS,18,0,18,-18,3,3,0,3,NASDAQ
4553,12-02-2021 04:00,24 hrs.,wallstreetbets,TOUR,6,0,6,-6,1,1,0,1,NASDAQ
4553,12-02-2021 04:00,24 hrs.,wallstreetbets,OPTT,18,12,6,6,3,3,0,3,NASDAQ
4553,12-02-2021 04:00,24 hrs.,wallstreetbets,OSTK,9,9,0,9,1,1,3,1,NASDAQ
4553,12-02-2021 04:00,24 hrs.,wallstreetbets,OTLK,6,6,0,6,1,1,0,1,NASDAQ
4553,12-02-2021 04:00,24 hrs.,wallstreetbets,PACB,14,14,0,14,2,2,2,1,NASDAQ
4553,12-02-2021 04:00,24 hrs.,wallstreetbets,PAVM,6,0,6,-6,1,1,0,1,NASDAQ
4553,12-02-2021 04:00,24 hrs.,wallstreetbets,PDSB,30,12,18,-6,5,5,0,2,NASDAQ
4553,12-02-2021 04:00,24 hrs.,wallstreetbets,PHIO,7,7,0,7,1,1,1,1,NASDAQ
4553,12-02-2021 04:00,24 hrs.,wallstreetbets,PLAY,384,372,12,360,13,102,128,10,NASDAQ
4553,12-02-2021 04:00,24 hrs.,wallstreetbets,PLUG,18,12,6,6,3,3,0,3,NASDAQ
4553,12-02-2021 04:00,24 hrs.,wallstreetbets,PODD,6,0,6,-6,1,1,0,1,NASDAQ
4553,12-02-2021 04:00,24 hrs.,wallstreetbets,POTX,24,0,24,-24,4,4,0,4,NASDAQ
4553,12-02-2021 04:00,24 hrs.,wallstreetbets,POWW,142,112,30,82,23,23,4,18,NASDAQ
4553,12-02-2021 04:00,24 hrs.,wallstreetbets,PPBT,6,0,6,-6,1,1,0,1,NASDAQ
4553,12-02-2021 04:00,24 hrs.,wallstreetbets,PRCH,24,24,0,24,4,4,0,2,NASDAQ
4553,12-02-2021 04:00,24 hrs.,wallstreetbets,PRPL,797,797,0,797,1,338,117,1,NASDAQ
4553,12-02-2021 04:00,24 hrs.,wallstreetbets,PRQR,6,0,6,-6,1,1,0,1,NASDAQ
4553,12-02-2021 04:00,24 hrs.,wallstreetbets,PRTS,7,7,0,7,1,1,1,1,NASDAQ
4553,12-02-2021 04:00,24 hrs.,wallstreetbets,PSEC,29,29,0,29,3,2,13,2,NASDAQ
4553,12-02-2021 04:00,24 hrs.,wallstreetbets,PSTV,12,6,6,0,2,2,0,2,NASDAQ
4553,12-02-2021 04:00,24 hrs.,wallstreetbets,PTMN,18,0,18,-18,3,3,0,2,NASDAQ
4553,12-02-2021 04:00,24 hrs.,wallstreetbets,PTPI,6,0,6,-6,1,1,0,1,NASDAQ
4553,12-02-2021 04:00,24 hrs.,wallstreetbets,PUBM,12,6,6,0,2,2,0,2,NASDAQ
4553,12-02-2021 04:00,24 hrs.,wallstreetbets,PYPL,20,7,13,-6,3,3,2,3,NASDAQ
4553,12-02-2021 04:00,24 hrs.,wallstreetbets,PZZA,7,7,0,7,1,1,1,1,NASDAQ
4553,12-02-2021 04:00,24 hrs.,wallstreetbets,QCOM,6,0,6,-6,1,1,0,1,NASDAQ
4553,12-02-2021 04:00,24 hrs.,wallstreetbets,QRVO,34,34,0,34,2,10,6,1,NASDAQ
4553,12-02-2021 04:00,24 hrs.,wallstreetbets,QUIK,13,13,0,13,2,2,1,2,NASDAQ
4553,12-02-2021 04:00,24 hrs.,wallstreetbets,RBBN,12,12,0,12,2,2,0,1,NASDAQ
4553,12-02-2021 04:00,24 hrs.,wallstreetbets,RCMT,50,26,24,2,8,8,2,8,NASDAQ
4553,12-02-2021 04:00,24 hrs.,wallstreetbets,REAL,29333,32,29301,-29269,11,13093,3103,11,NASDAQ
4553,12-02-2021 04:00,24 hrs.,wallstreetbets,REGI,6,6,0,6,1,1,0,1,NASDAQ
4553,12-02-2021 04:00,24 hrs.,wallstreetbets,RESN,12,0,12,-12,2,2,0,1,NASDAQ
4553,12-02-2021 04:00,24 hrs.,wallstreetbets,RIDE,24,24,0,24,4,4,0,4,NASDAQ
4553,12-02-2021 04:00,24 hrs.,wallstreetbets,RIOT,59,37,22,15,9,10,3,8,NASDAQ
4553,12-02-2021 04:00,24 hrs.,wallstreetbets,RKDA,6,0,6,-6,1,1,0,1,NASDAQ
4553,12-02-2021 04:00,24 hrs.,wallstreetbets,RMTI,32,20,12,8,5,5,2,4,NASDAQ
4553,12-02-2021 04:00,24 hrs.,wallstreetbets,ROCK,6,6,0,6,1,1,0,1,NASDAQ
4553,12-02-2021 04:00,24 hrs.,wallstreetbets,ROLL,6,0,6,-6,1,1,0,1,NASDAQ
4553,12-02-2021 04:00,24 hrs.,wallstreetbets,ROOT,6,6,0,6,1,1,0,1,NASDAQ
4553,12-02-2021 04:00,24 hrs.,wallstreetbets,SAGE,6,6,0,6,1,1,0,1,NASDAQ
4553,12-02-2021 04:00,24 hrs.,wallstreetbets,SALM,6,0,6,-6,1,1,0,1,NASDAQ
4553,12-02-2021 04:00,24 hrs.,wallstreetbets,SAVA,18,18,0,18,3,3,0,3,NASDAQ
4553,12-02-2021 04:00,24 hrs.,wallstreetbets,SAVE,33,27,6,21,5,5,3,3,NASDAQ
4553,12-02-2021 04:00,24 hrs.,wallstreetbets,SEEL,12,12,0,12,2,2,0,2,NASDAQ
4553,12-02-2021 04:00,24 hrs.,wallstreetbets,SESN,6,0,6,-6,1,1,0,1,NASDAQ
4553,12-02-2021 04:00,24 hrs.,wallstreetbets,SFET,18,6,12,-6,3,3,0,2,NASDAQ
4553,12-02-2021 04:00,24 hrs.,wallstreetbets,SHIP,31,13,18,-5,5,5,1,5,NASDAQ
4553,12-02-2021 04:00,24 hrs.,wallstreetbets,SIEB,6,6,0,6,1,1,0,1,NASDAQ
4553,12-02-2021 04:00,24 hrs.,wallstreetbets,SINT,18,18,0,18,3,3,0,1,NASDAQ
4553,12-02-2021 04:00,24 hrs.,wallstreetbets,SKYY,6,0,6,-6,1,1,0,1,NASDAQ
4553,12-02-2021 04:00,24 hrs.,wallstreetbets,SLGG,6,0,6,-6,1,1,0,1,NASDAQ
4553,12-02-2021 04:00,24 hrs.,wallstreetbets,SLRX,19,0,19,-19,3,3,1,3,NASDAQ
4553,12-02-2021 04:00,24 hrs.,wallstreetbets,SNCR,7,7,0,7,1,1,1,1,NASDAQ
4553,12-02-2021 04:00,24 hrs.,wallstreetbets,SNDL,100798,52139,48659,3480,936,44129,8796,752,NASDAQ
4553,12-02-2021 04:00,24 hrs.,wallstreetbets,SOHU,6,6,0,6,1,1,0,1,NASDAQ
4553,12-02-2021 04:00,24 hrs.,wallstreetbets,SOLO,12,6,6,0,2,2,0,2,NASDAQ
4553,12-02-2021 04:00,24 hrs.,wallstreetbets,SONN,6,0,6,-6,1,1,0,1,NASDAQ
4553,12-02-2021 04:00,24 hrs.,wallstreetbets,SONO,756,136,620,-484,3,278,188,3,NASDAQ
4553,12-02-2021 04:00,24 hrs.,wallstreetbets,SPOK,12,0,12,-12,2,2,0,1,NASDAQ
4553,12-02-2021 04:00,24 hrs.,pennystocks,STEV,39,32,7,25,4,9,5,3,OTC
4553,12-02-2021 04:00,24 hrs.,pennystocks,SUGR,6,6,0,6,1,1,0,1,OTC
4553,12-02-2021 04:00,24 hrs.,pennystocks,SUIC,18,6,12,-6,3,3,0,2,OTC
4553,12-02-2021 04:00,24 hrs.,pennystocks,SURG,110,110,0,110,1,39,28,1,OTC
4553,12-02-2021 04:00,24 hrs.,pennystocks,TBEV,6,6,0,6,1,1,0,1,OTC
4553,12-02-2021 04:00,24 hrs.,pennystocks,TLSS,199,180,19,161,4,47,89,4,OTC
4553,12-02-2021 04:00,24 hrs.,pennystocks,TREP,6,6,0,6,1,1,0,1,OTC
4553,12-02-2021 04:00,24 hrs.,pennystocks,TRTC,15,15,0,15,1,0,11,1,OTC
4553,12-02-2021 04:00,24 hrs.,pennystocks,TSNP,244,18,226,-208,8,79,54,8,OTC
4553,12-02-2021 04:00,24 hrs.,pennystocks,TSOI,7,0,7,-7,1,1,1,1,OTC
4553,12-02-2021 04:00,24 hrs.,pennystocks,TXMC,6,0,6,-6,1,1,0,1,OTC
4553,12-02-2021 04:00,24 hrs.,pennystocks,UATG,12,12,0,12,2,2,0,2,OTC
4553,12-02-2021 04:00,24 hrs.,pennystocks,UNVC,6,0,6,-6,1,1,0,1,OTC
4553,12-02-2021 04:00,24 hrs.,pennystocks,USMJ,27,14,13,1,4,4,3,4,OTC
4553,12-02-2021 04:00,24 hrs.,pennystocks,UVSE,21,7,14,-7,3,2,5,3,OTC
4553,12-02-2021 04:00,24 hrs.,pennystocks,VNUE,19,0,19,-19,1,7,1,1,OTC
4553,12-02-2021 04:00,24 hrs.,pennystocks,VPER,6,6,0,6,1,1,0,1,OTC
4553,12-02-2021 04:00,24 hrs.,pennystocks,VSYM,18,0,18,-18,3,3,0,1,OTC
4553,12-02-2021 04:00,24 hrs.,pennystocks,VYST,12,0,12,-12,2,2,0,2,OTC
4553,12-02-2021 04:00,24 hrs.,pennystocks,WARM,138,138,0,138,2,48,34,2,OTC
4553,12-02-2021 04:00,24 hrs.,pennystocks,WDHR,14,14,0,14,2,2,2,1,OTC
4553,12-02-2021 04:00,24 hrs.,pennystocks,WDLF,158,148,10,138,6,29,76,6,OTC
4553,12-02-2021 04:00,24 hrs.,pennystocks,WHEN,7,7,0,7,1,1,1,1,OTC
4553,12-02-2021 04:00,24 hrs.,pennystocks,WSTL,110,110,0,110,1,39,28,1,OTC
4553,12-02-2021 04:00,24 hrs.,pennystocks,XDSL,8,0,8,-8,1,1,2,1,OTC
4553,12-02-2021 04:00,24 hrs.,pennystocks,XMET,201,0,201,-201,1,72,53,1,OTC
4553,12-02-2021 04:00,24 hrs.,pennystocks,XTRM,6,6,0,6,1,1,0,1,OTC
4553,12-02-2021 04:00,24 hrs.,pennystocks,ZAAG,6,6,0,6,1,1,0,1,OTC
4553,12-02-2021 04:00,24 hrs.,pennystocks,ZPAS,6,6,0,6,1,1,0,1,OTC
4553,12-02-2021 04:00,24 hrs.,pennystocks,MRMD,36,36,0,36,1,14,4,1,OTC
4553,12-02-2021 04:00,24 hrs.,pennystocks,MRNJ,13,13,0,13,2,2,1,1,OTC
4553,12-02-2021 04:00,24 hrs.,pennystocks,MRPI,7,7,0,7,1,1,1,1,OTC
4553,12-02-2021 04:00,24 hrs.,pennystocks,NBVG,6,0,6,-6,1,1,0,1,OTC
4553,12-02-2021 04:00,24 hrs.,pennystocks,NPHC,50,50,0,50,3,10,18,2,OTC
4553,12-02-2021 04:00,24 hrs.,pennystocks,NSAV,38,38,0,38,2,6,18,2,OTC
4553,12-02-2021 04:00,24 hrs.,pennystocks,NSMG,28,0,28,-28,1,5,14,1,OTC
4553,12-02-2021 04:00,24 hrs.,pennystocks,NSPX,14,7,7,0,2,2,2,2,OTC
4553,12-02-2021 04:00,24 hrs.,pennystocks,NUKK,7,0,7,-7,1,1,1,1,OTC
4553,12-02-2021 04:00,24 hrs.,pennystocks,NVNT,5,0,5,-5,1,0,1,1,OTC
4553,12-02-2021 04:00,24 hrs.,pennystocks,NWPN,6,6,0,6,1,1,0,1,OTC
4553,12-02-2021 04:00,24 hrs.,pennystocks,OPTI,37,12,25,-13,4,10,1,4,OTC
4553,12-02-2021 04:00,24 hrs.,pennystocks,OPVS,6,6,0,6,1,1,0,1,OTC
4553,12-02-2021 04:00,24 hrs.,pennystocks,OWCP,7,0,7,-7,1,1,1,1,OTC
4553,12-02-2021 04:00,24 hrs.,pennystocks,OZSC,177,158,19,139,4,40,81,4,OTC
4553,12-02-2021 04:00,24 hrs.,pennystocks,PAOG,44,0,44,-44,2,15,6,2,OTC
4553,12-02-2021 04:00,24 hrs.,pennystocks,PASO,215,215,0,215,5,66,63,5,OTC
4553,12-02-2021 04:00,24 hrs.,pennystocks,PHBI,7,0,7,-7,1,1,1,1,OTC
4553,12-02-2021 04:00,24 hrs.,pennystocks,PHIL,6,6,0,6,1,1,0,1,OTC
4553,12-02-2021 04:00,24 hrs.,pennystocks,PMCB,19,6,13,-7,3,3,1,2,OTC
4553,12-02-2021 04:00,24 hrs.,wallstreetbets,SSPK,6,6,0,6,1,1,0,1,NASDAQ
4553,12-02-2021 04:00,24 hrs.,wallstreetbets,STAF,7,7,0,7,1,1,1,1,NASDAQ
4553,12-02-2021 04:00,24 hrs.,wallstreetbets,STAY,36,18,18,0,6,6,0,6,NASDAQ
4553,12-02-2021 04:00,24 hrs.,wallstreetbets,STCN,6,6,0,6,1,1,0,1,NASDAQ
4553,12-02-2021 04:00,24 hrs.,wallstreetbets,SWBI,6,6,0,6,1,1,0,1,NASDAQ
4553,12-02-2021 04:00,24 hrs.,wallstreetbets,SXTC,6,0,6,-6,1,1,0,1,NASDAQ
4553,12-02-2021 04:00,24 hrs.,wallstreetbets,TBLT,6,0,6,-6,1,1,0,1,NASDAQ
4553,12-02-2021 04:00,24 hrs.,wallstreetbets,TEAM,12,12,0,12,2,2,0,1,NASDAQ
4553,12-02-2021 04:00,24 hrs.,wallstreetbets,TECH,7,0,7,-7,1,1,1,1,NASDAQ
4553,12-02-2021 04:00,24 hrs.,wallstreetbets,TELL,19,13,6,7,3,3,1,3,NASDAQ
4553,12-02-2021 04:00,24 hrs.,wallstreetbets,THBR,18,18,0,18,3,3,0,2,NASDAQ
4553,12-02-2021 04:00,24 hrs.,wallstreetbets,THCB,10,4,6,-2,2,1,0,2,NASDAQ
4553,12-02-2021 04:00,24 hrs.,wallstreetbets,THMO,18,12,6,6,3,3,0,2,NASDAQ
4553,12-02-2021 04:00,24 hrs.,wallstreetbets,TIGR,13,7,6,1,2,2,1,2,NASDAQ
4553,12-02-2021 04:00,24 hrs.,wallstreetbets,TLGT,12,0,12,-12,2,2,0,2,NASDAQ
4553,12-02-2021 04:00,24 hrs.,wallstreetbets,WKHS,590,92,498,-406,5,222,126,4,NASDAQ
4553,12-02-2021 04:00,24 hrs.,wallstreetbets,WTER,7,7,0,7,1,1,1,1,NASDAQ
4553,12-02-2021 04:00,24 hrs.,wallstreetbets,XSPA,85,43,42,1,14,14,1,14,NASDAQ
4553,12-02-2021 04:00,24 hrs.,wallstreetbets,YNDX,69,69,0,69,1,20,25,1,NASDAQ
4553,12-02-2021 04:00,24 hrs.,wallstreetbets,ZNGA,644,24,620,-596,6,244,132,5,NASDAQ
4553,12-02-2021 04:00,24 hrs.,wallstreetbets,ZSAN,6,6,0,6,1,1,0,1,NASDAQ
4553,12-02-2021 04:00,24 hrs.,wallstreetbets,ZYNE,54,12,42,-30,9,9,0,9,NASDAQ
4553,12-02-2021 04:00,24 hrs.,RobinHoodPennyStocks,AHFD,6,6,0,6,1,1,0,1,OTC
4553,12-02-2021 04:00,24 hrs.,RobinHoodPennyStocks,AITX,13,13,0,13,1,1,7,1,OTC
4553,12-02-2021 04:00,24 hrs.,RobinHoodPennyStocks,BNGI,12,12,0,12,2,2,0,2,OTC
4553,12-02-2021 04:00,24 hrs.,RobinHoodPennyStocks,BOTH,257,0,257,-257,1,101,51,1,OTC
4553,12-02-2021 04:00,24 hrs.,RobinHoodPennyStocks,CANN,6,0,6,-6,1,1,0,1,OTC
4553,12-02-2021 04:00,24 hrs.,RobinHoodPennyStocks,CBDD,6,0,6,-6,1,1,0,1,OTC
4553,12-02-2021 04:00,24 hrs.,RobinHoodPennyStocks,CBDL,6,6,0,6,1,1,0,1,OTC
4553,12-02-2021 04:00,24 hrs.,RobinHoodPennyStocks,COMS,6,6,0,6,1,1,0,1,OTC
4553,12-02-2021 04:00,24 hrs.,RobinHoodPennyStocks,CRWG,6,0,6,-6,1,1,0,1,OTC
4553,12-02-2021 04:00,24 hrs.,RobinHoodPennyStocks,CYTR,6,6,0,6,1,1,0,1,OTC
4553,12-02-2021 04:00,24 hrs.,RobinHoodPennyStocks,ENDV,6,0,6,-6,1,1,0,1,OTC
4553,12-02-2021 04:00,24 hrs.,RobinHoodPennyStocks,ETEK,6,6,0,6,1,1,0,1,OTC
4553,12-02-2021 04:00,24 hrs.,RobinHoodPennyStocks,GTBP,18,18,0,18,1,4,6,1,OTC
4553,12-02-2021 04:00,24 hrs.,RobinHoodPennyStocks,HCMC,48,48,0,48,8,8,0,7,OTC
4553,12-02-2021 04:00,24 hrs.,RobinHoodPennyStocks,HQGE,6,6,0,6,1,1,0,1,OTC
4553,12-02-2021 04:00,24 hrs.,RobinHoodPennyStocks,INOH,6,6,0,6,1,1,0,1,OTC
4553,12-02-2021 04:00,24 hrs.,RobinHoodPennyStocks,MCOA,6,6,0,6,1,1,0,1,OTC
4553,12-02-2021 04:00,24 hrs.,RobinHoodPennyStocks,NUGS,6,6,0,6,1,1,0,1,OTC
4553,12-02-2021 04:00,24 hrs.,RobinHoodPennyStocks,NWPN,8,8,0,8,1,0,4,1,OTC
4553,12-02-2021 04:00,24 hrs.,RobinHoodPennyStocks,OPMZ,6,0,6,-6,1,1,0,1,OTC
4553,12-02-2021 04:00,24 hrs.,RobinHoodPennyStocks,OPTI,6,6,0,6,1,1,0,1,OTC
4553,12-02-2021 04:00,24 hrs.,RobinHoodPennyStocks,PAOG,6,0,6,-6,1,1,0,1,OTC
4553,12-02-2021 04:00,24 hrs.,pennystocks,PMDP,6,6,0,6,1,1,0,1,OTC
4553,12-02-2021 04:00,24 hrs.,pennystocks,POTN,7,0,7,-7,1,1,1,1,OTC
4553,12-02-2021 04:00,24 hrs.,pennystocks,PPJE,14,14,0,14,2,2,2,2,OTC
4553,12-02-2021 04:00,24 hrs.,pennystocks,PRPM,6,6,0,6,1,1,0,1,OTC
4553,12-02-2021 04:00,24 hrs.,pennystocks,PSYC,256,245,11,234,6,93,46,4,OTC
4553,12-02-2021 04:00,24 hrs.,pennystocks,PTOP,5,0,5,-5,1,0,1,1,OTC
4553,12-02-2021 04:00,24 hrs.,pennystocks,PUGE,92,6,86,-80,2,28,28,2,OTC
4553,12-02-2021 04:00,24 hrs.,pennystocks,PVDG,1719,0,1719,-1719,2,753,205,2,OTC
4553,12-02-2021 04:00,24 hrs.,pennystocks,QEBR,6,0,6,-6,1,1,0,1,OTC
4553,12-02-2021 04:00,24 hrs.,pennystocks,QMCI,6,0,6,-6,1,1,0,1,OTC
4553,12-02-2021 04:00,24 hrs.,pennystocks,QPRC,13,13,0,13,2,2,1,1,OTC
4553,12-02-2021 04:00,24 hrs.,pennystocks,RELI,25,25,0,25,1,5,11,1,OTC
4553,12-02-2021 04:00,24 hrs.,pennystocks,RLTR,12,12,0,12,2,2,0,2,OTC
4553,12-02-2021 04:00,24 hrs.,pennystocks,RNVA,110,110,0,110,1,39,28,1,OTC
4553,12-02-2021 04:00,24 hrs.,pennystocks,ROTH,81,0,81,-81,2,30,13,2,OTC
4553,12-02-2021 04:00,24 hrs.,pennystocks,RRTS,110,110,0,110,1,39,28,1,OTC
4553,12-02-2021 04:00,24 hrs.,pennystocks,RSSV,12,6,6,0,2,2,0,2,OTC
4553,12-02-2021 04:00,24 hrs.,pennystocks,RTON,373,157,216,-59,9,114,109,8,OTC
4553,12-02-2021 04:00,24 hrs.,pennystocks,SCIE,191,191,0,191,1,76,35,1,OTC
4553,12-02-2021 04:00,24 hrs.,pennystocks,SEEK,7,7,0,7,1,1,1,1,OTC
4553,12-02-2021 04:00,24 hrs.,pennystocks,SENY,48,0,48,-48,1,17,10,1,OTC
4553,12-02-2021 04:00,24 hrs.,pennystocks,SFOR,6,6,0,6,1,1,0,1,OTC
4553,12-02-2021 04:00,24 hrs.,pennystocks,SGLN,79,79,0,79,1,12,51,1,OTC
4553,12-02-2021 04:00,24 hrs.,pennystocks,SGMD,293,197,96,101,12,82,81,12,OTC
4553,12-02-2021 04:00,24 hrs.,pennystocks,SGSI,142,135,7,128,5,45,32,4,OTC
4553,12-02-2021 04:00,24 hrs.,pennystocks,SHMP,23,23,0,23,2,1,13,2,OTC
4553,12-02-2021 04:00,24 hrs.,pennystocks,SHRG,7,7,0,7,1,1,1,1,OTC
4553,12-02-2021 04:00,24 hrs.,pennystocks,SILO,15,15,0,15,1,3,5,1,OTC
4553,12-02-2021 04:00,24 hrs.,pennystocks,SIML,302,0,302,-302,7,96,82,3,OTC
4553,12-02-2021 04:00,24 hrs.,pennystocks,SING,28,28,0,28,2,1,18,2,OTC
4553,12-02-2021 04:00,24 hrs.,pennystocks,SNPW,748,325,423,-98,5,281,166,5,OTC
4553,12-02-2021 04:00,24 hrs.,pennystocks,SNRS,201,0,201,-201,1,72,53,1,OTC
4553,12-02-2021 04:00,24 hrs.,pennystocks,SPRN,13,6,7,-1,2,2,1,2,OTC
4553,12-02-2021 04:00,24 hrs.,pennystocks,SRMX,197,84,113,-29,12,45,59,11,OTC
4553,12-02-2021 04:00,24 hrs.,pennystocks,SSFT,37,18,19,-1,4,10,1,2,OTC
4553,12-02-2021 04:00,24 hrs.,pennystocks,DIGAF,7,0,7,-7,1,1,1,1,OTC
4553,12-02-2021 04:00,24 hrs.,pennystocks,EFLVF,1619,0,1619,-1619,1,715,185,1,OTC
4553,12-02-2021 04:00,24 hrs.,pennystocks,EHVVF,170,170,0,170,1,72,22,1,OTC
4553,12-02-2021 04:00,24 hrs.,pennystocks,ENTBF,170,170,0,170,1,72,22,1,OTC
4553,12-02-2021 04:00,24 hrs.,pennystocks,EPWCF,6,0,6,-6,1,1,0,1,OTC
4553,12-02-2021 04:00,24 hrs.,pennystocks,FLWPF,13,7,6,1,2,2,1,2,OTC
4553,12-02-2021 04:00,24 hrs.,pennystocks,FTRPF,170,170,0,170,1,72,22,1,OTC
4553,12-02-2021 04:00,24 hrs.,RobinHoodPennyStocks,PHIL,6,6,0,6,1,1,0,1,OTC
4553,12-02-2021 04:00,24 hrs.,RobinHoodPennyStocks,QTMM,6,6,0,6,1,1,0,1,OTC
4553,12-02-2021 04:00,24 hrs.,RobinHoodPennyStocks,SGMD,26,20,6,14,2,5,8,2,OTC
4553,12-02-2021 04:00,24 hrs.,RobinHoodPennyStocks,SRMX,12,6,6,0,2,2,0,2,OTC
4553,12-02-2021 04:00,24 hrs.,RobinHoodPennyStocks,SUIC,6,6,0,6,1,1,0,1,OTC
4553,12-02-2021 04:00,24 hrs.,RobinHoodPennyStocks,TLSS,6,6,0,6,1,1,0,1,OTC
4553,12-02-2021 04:00,24 hrs.,RobinHoodPennyStocks,USMJ,12,0,12,-12,2,2,0,2,OTC
4553,12-02-2021 04:00,24 hrs.,RobinHoodPennyStocks,VPRB,6,6,0,6,1,1,0,1,OTC
4553,12-02-2021 04:00,24 hrs.,RobinHoodPennyStocks,ABEPF,26,8,18,-10,2,5,8,2,OTC
4553,12-02-2021 04:00,24 hrs.,RobinHoodPennyStocks,BBKCF,6,0,6,-6,1,0,2,1,OTC
4553,12-02-2021 04:00,24 hrs.,RobinHoodPennyStocks,BDRBF,325,173,152,21,16,75,111,16,OTC
4553,12-02-2021 04:00,24 hrs.,RobinHoodPennyStocks,HITIF,32,12,20,-8,3,2,16,3,OTC
4553,12-02-2021 04:00,24 hrs.,RobinHoodPennyStocks,MMNFF,12,0,12,-12,2,2,0,1,OTC
4553,12-02-2021 04:00,24 hrs.,RobinHoodPennyStocks,MZDAY,24,24,0,24,1,5,10,1,OTC
4553,12-02-2021 04:00,24 hrs.,RobinHoodPennyStocks,NMGRF,6,0,6,-6,1,1,0,1,OTC
4553,12-02-2021 04:00,24 hrs.,RobinHoodPennyStocks,PLNHF,6,6,0,6,1,1,0,1,OTC
4553,12-02-2021 04:00,24 hrs.,RobinHoodPennyStocks,RLFTF,31,0,31,-31,5,5,1,1,OTC
4553,12-02-2021 04:00,24 hrs.,RobinHoodPennyStocks,RYCEY,6,0,6,-6,1,1,0,1,OTC
4553,12-02-2021 04:00,24 hrs.,RobinHoodPennyStocks,TLOFF,6,6,0,6,1,1,0,1,OTC
4553,12-02-2021 04:00,24 hrs.,RobinHoodPennyStocks,VRYYF,6,6,0,6,1,1,0,1,OTC
4553,12-02-2021 04:00,24 hrs.,RobinHoodPennyStocks,AAU,34,34,0,34,1,11,8,1,AMEX
4553,12-02-2021 04:00,24 hrs.,RobinHoodPennyStocks,CEI,263,6,257,-251,2,102,51,2,AMEX
4553,12-02-2021 04:00,24 hrs.,pennystocks,ABEPF,1896,64,1832,-1768,14,790,260,13,OTC
4553,12-02-2021 04:00,24 hrs.,pennystocks,AQSZF,28,28,0,28,1,10,4,1,OTC
4553,12-02-2021 04:00,24 hrs.,pennystocks,ARBKF,34,34,0,34,1,7,16,1,OTC
4553,12-02-2021 04:00,24 hrs.,pennystocks,BDRBF,115,46,69,-23,2,31,45,2,OTC
4553,12-02-2021 04:00,24 hrs.,pennystocks,BLOZF,12,0,12,-12,2,2,0,1,OTC
4553,12-02-2021 04:00,24 hrs.,wallstreetbets,TPCO,6,6,0,6,1,1,0,1,NASDAQ
4553,12-02-2021 04:00,24 hrs.,wallstreetbets,TRCH,55,43,12,31,9,9,1,7,NASDAQ
4553,12-02-2021 04:00,24 hrs.,wallstreetbets,TRIT,74,50,24,26,12,12,2,8,NASDAQ
4553,12-02-2021 04:00,24 hrs.,wallstreetbets,TRVG,6,0,6,-6,1,1,0,1,NASDAQ
4553,12-02-2021 04:00,24 hrs.,wallstreetbets,TRVN,19,7,12,-5,3,3,1,3,NASDAQ
4553,12-02-2021 04:00,24 hrs.,wallstreetbets,TSLA,90451,55577,34874,20703,40,41441,7409,32,NASDAQ
4553,12-02-2021 04:00,24 hrs.,wallstreetbets,TTWO,7,7,0,7,1,1,1,1,NASDAQ
4553,12-02-2021 04:00,24 hrs.,wallstreetbets,TURN,20,20,0,20,3,3,2,2,NASDAQ
4553,12-02-2021 04:00,24 hrs.,wallstreetbets,TWOU,12,12,0,12,2,2,0,1,NASDAQ
4553,12-02-2021 04:00,24 hrs.,wallstreetbets,TXMD,111,69,42,27,18,18,3,15,NASDAQ
4553,12-02-2021 04:00,24 hrs.,wallstreetbets,TYME,18,12,6,6,3,3,0,3,NASDAQ
4553,12-02-2021 04:00,24 hrs.,wallstreetbets,UPST,10,6,4,2,2,1,0,2,NASDAQ
4553,12-02-2021 04:00,24 hrs.,wallstreetbets,UPWK,18,12,6,6,3,3,0,3,NASDAQ
4553,12-02-2021 04:00,24 hrs.,wallstreetbets,USWS,6,0,6,-6,1,1,0,1,NASDAQ
4553,12-02-2021 04:00,24 hrs.,wallstreetbets,UXIN,12,0,12,-12,2,2,0,1,NASDAQ
4553,12-02-2021 04:00,24 hrs.,wallstreetbets,VBLT,6,0,6,-6,1,1,0,1,NASDAQ
4553,12-02-2021 04:00,24 hrs.,wallstreetbets,VERU,18,0,18,-18,3,3,0,3,NASDAQ
4553,12-02-2021 04:00,24 hrs.,wallstreetbets,VIAC,70,70,0,70,1,23,20,1,NASDAQ
4553,12-02-2021 04:00,24 hrs.,wallstreetbets,VISL,12,6,6,0,2,2,0,2,NASDAQ
4553,12-02-2021 04:00,24 hrs.,wallstreetbets,VIVE,6,6,0,6,1,1,0,1,NASDAQ
4553,12-02-2021 04:00,24 hrs.,wallstreetbets,VKTX,6,6,0,6,1,1,0,1,NASDAQ
4553,12-02-2021 04:00,24 hrs.,wallstreetbets,VNDA,36,36,0,36,5,5,6,1,NASDAQ
4553,12-02-2021 04:00,24 hrs.,wallstreetbets,VRAY,6,6,0,6,1,1,0,1,NASDAQ
4553,12-02-2021 04:00,24 hrs.,wallstreetbets,VRNA,7,0,7,-7,1,1,1,1,NASDAQ
4553,12-02-2021 04:00,24 hrs.,wallstreetbets,VTIQ,24,0,24,-24,4,4,0,1,NASDAQ
4553,12-02-2021 04:00,24 hrs.,wallstreetbets,VUZI,15,15,0,15,2,2,3,2,NASDAQ
4553,12-02-2021 04:00,24 hrs.,wallstreetbets,VXRT,12,0,12,-12,2,2,0,2,NASDAQ
4553,12-02-2021 04:00,24 hrs.,wallstreetbets,VYNE,7,7,0,7,1,1,1,1,NASDAQ
4553,12-02-2021 04:00,24 hrs.,wallstreetbets,WATT,86,66,20,46,12,13,12,6,NASDAQ
4553,12-02-2021 04:00,24 hrs.,wallstreetbets,WIMI,14,0,14,-14,2,2,2,1,NASDAQ
4553,12-02-2021 04:00,24 hrs.,pennystocks,ISRJF,10,0,10,-10,1,0,6,1,OTC
4553,12-02-2021 04:00,24 hrs.,pennystocks,JETMF,1619,0,1619,-1619,1,715,185,1,OTC
4553,12-02-2021 04:00,24 hrs.,pennystocks,KONAQ,6,0,6,-6,1,1,0,1,OTC
4553,12-02-2021 04:00,24 hrs.,pennystocks,KWHIY,6,6,0,6,1,0,2,1,OTC
4553,12-02-2021 04:00,24 hrs.,pennystocks,LIACF,39,32,7,25,2,12,7,2,OTC
4553,12-02-2021 04:00,24 hrs.,pennystocks,LIBFF,170,170,0,170,1,72,22,1,OTC
4553,12-02-2021 04:00,24 hrs.,pennystocks,LKYSF,170,170,0,170,1,72,22,1,OTC
4553,12-02-2021 04:00,24 hrs.,pennystocks,LLKKF,31,6,25,-19,2,6,11,2,OTC
4553,12-02-2021 04:00,24 hrs.,pennystocks,LTMCF,321,155,166,-11,7,95,103,6,OTC
4553,12-02-2021 04:00,24 hrs.,pennystocks,MCURF,170,170,0,170,1,72,22,1,OTC
4553,12-02-2021 04:00,24 hrs.,pennystocks,MGCLF,32,0,32,-32,1,12,4,1,OTC
4553,12-02-2021 04:00,24 hrs.,pennystocks,MMEDF,382,170,212,-42,3,158,54,3,OTC
4553,12-02-2021 04:00,24 hrs.,pennystocks,MMNFF,55,49,6,43,3,20,3,3,OTC
4553,12-02-2021 04:00,24 hrs.,pennystocks,MNXXF,46,0,46,-46,2,14,10,2,OTC
4553,12-02-2021 04:00,24 hrs.,pennystocks,MSNVF,19,0,19,-19,1,7,1,1,OTC
4553,12-02-2021 04:00,24 hrs.,pennystocks,MYCOF,170,170,0,170,1,72,22,1,OTC
4553,12-02-2021 04:00,24 hrs.,pennystocks,NCNNF,12,0,12,-12,2,2,0,1,OTC
4553,12-02-2021 04:00,24 hrs.,pennystocks,NEBLQ,6,6,0,6,1,1,0,1,OTC
4553,12-02-2021 04:00,24 hrs.,pennystocks,NMGRF,112,94,18,76,6,28,32,6,OTC
4553,12-02-2021 04:00,24 hrs.,pennystocks,NMHLY,6,6,0,6,1,1,0,1,OTC
4553,12-02-2021 04:00,24 hrs.,pennystocks,NMTLF,1619,0,1619,-1619,1,715,185,1,OTC
4553,12-02-2021 04:00,24 hrs.,pennystocks,NRGOF,14,14,0,14,2,2,2,1,OTC
4553,12-02-2021 04:00,24 hrs.,pennystocks,NTDOY,13,13,0,13,2,2,1,2,OTC
4553,12-02-2021 04:00,24 hrs.,pennystocks,NTSFF,6,6,0,6,1,1,0,1,OTC
4553,12-02-2021 04:00,24 hrs.,pennystocks,NXTTF,25,6,19,-13,4,4,1,4,OTC
4553,12-02-2021 04:00,24 hrs.,pennystocks,ORVRF,22,0,22,-22,1,5,8,1,OTC
4553,12-02-2021 04:00,24 hrs.,pennystocks,PFWIQ,273,72,201,-129,2,92,81,2,OTC
4553,12-02-2021 04:00,24 hrs.,pennystocks,PLCKF,1676,0,1676,-1676,2,735,198,2,OTC
4553,12-02-2021 04:00,24 hrs.,pennystocks,PLNHF,21,21,0,21,1,4,9,1,OTC
4553,12-02-2021 04:00,24 hrs.,pennystocks,PLPRF,6,0,6,-6,1,1,0,1,OTC
4553,12-02-2021 04:00,24 hrs.,pennystocks,PLUUF,32,32,0,32,1,11,6,1,OTC
4553,12-02-2021 04:00,24 hrs.,pennystocks,PTOTF,6,0,6,-6,1,1,0,1,OTC
4553,12-02-2021 04:00,24 hrs.,pennystocks,RACMF,6,6,0,6,1,0,2,1,OTC
4553,12-02-2021 04:00,24 hrs.,pennystocks,RECAF,19,0,19,-19,1,7,1,1,OTC
4553,12-02-2021 04:00,24 hrs.,pennystocks,REGRF,40,0,40,-40,1,11,14,1,OTC
4553,12-02-2021 04:00,24 hrs.,pennystocks,REZZF,1717,0,1717,-1717,2,749,211,2,OTC
4553,12-02-2021 04:00,24 hrs.,pennystocks,RLFTF,19,6,13,-7,3,3,1,2,OTC
4553,12-02-2021 04:00,24 hrs.,pennystocks,RLLCF,7,7,0,7,1,1,1,1,OTC
4553,12-02-2021 04:00,24 hrs.,pennystocks,ROYTL,6,0,6,-6,1,1,0,1,OTC
4553,12-02-2021 04:00,24 hrs.,pennystocks,RQHTF,52,0,52,-52,1,19,10,1,OTC
4553,12-02-2021 04:00,24 hrs.,pennystocks,RVVTF,227,205,22,183,3,83,49,3,OTC
4553,12-02-2021 04:00,24 hrs.,pennystocks,RWBYF,7,7,0,7,1,1,1,1,OTC
4553,12-02-2021 04:00,24 hrs.,pennystocks,RYCEY,13,6,7,-1,2,2,1,2,OTC
4553,12-02-2021 04:00,24 hrs.,pennystocks,RYMDF,50,26,24,2,5,12,6,4,OTC
4553,12-02-2021 04:00,24 hrs.,pennystocks,SBSAA,5,5,0,5,1,0,1,1,OTC
4553,12-02-2021 04:00,24 hrs.,pennystocks,SHRMF,170,170,0,170,1,72,22,1,OTC
4553,12-02-2021 04:00,24 hrs.,pennystocks,SMRTQ,6,0,6,-6,1,1,0,1,OTC
4553,12-02-2021 04:00,24 hrs.,pennystocks,SORHF,8,8,0,8,1,1,2,1,OTC
4553,12-02-2021 04:00,24 hrs.,pennystocks,SPLIF,24,24,0,24,4,4,0,3,OTC
4553,12-02-2021 04:00,24 hrs.,pennystocks,SPMTF,8,0,8,-8,1,1,2,1,OTC
4553,12-02-2021 04:00,24 hrs.,pennystocks,SPRWF,1027,1021,6,1015,5,439,129,5,OTC
4553,12-02-2021 04:00,24 hrs.,pennystocks,TAKOF,412,360,52,308,5,151,90,3,OTC
4553,12-02-2021 04:00,24 hrs.,pennystocks,TFECF,6,6,0,6,1,1,0,1,OTC
4553,12-02-2021 04:00,24 hrs.,pennystocks,CBLAQ,7,0,7,-7,1,1,1,1,OTC
4553,12-02-2021 04:00,24 hrs.,pennystocks,CBWTF,19,6,13,-7,3,3,1,3,OTC
4553,12-02-2021 04:00,24 hrs.,pennystocks,CCIHY,99,99,0,99,1,40,15,1,OTC
4553,12-02-2021 04:00,24 hrs.,pennystocks,CINGF,40,0,40,-40,1,11,14,1,OTC
4553,12-02-2021 04:00,24 hrs.,pennystocks,CNIKF,62,62,0,62,1,15,28,1,OTC
4553,12-02-2021 04:00,24 hrs.,pennystocks,COCSF,6,6,0,6,1,1,0,1,OTC
4553,12-02-2021 04:00,24 hrs.,pennystocks,COPRF,4,0,4,-4,1,0,0,1,OTC
4553,12-02-2021 04:00,24 hrs.,pennystocks,CPHRF,35,35,0,35,1,10,11,1,OTC
4553,12-02-2021 04:00,24 hrs.,pennystocks,CWGYF,6,0,6,-6,1,1,0,1,OTC
4553,12-02-2021 04:00,24 hrs.,pennystocks,CXXIF,6,6,0,6,1,1,0,1,OTC
4553,12-02-2021 04:00,24 hrs.,pennystocks,DFLYF,32,32,0,32,1,10,8,1,OTC
4553,12-02-2021 04:00,24 hrs.,RobinHoodPennyStocks,KIQ,17,17,0,17,1,0,13,1,AMEX
4553,12-02-2021 04:00,24 hrs.,RobinHoodPennyStocks,NAK,71,71,0,71,4,20,15,4,AMEX
4553,12-02-2021 04:00,24 hrs.,RobinHoodPennyStocks,PLG,257,0,257,-257,1,101,51,1,AMEX
4553,12-02-2021 04:00,24 hrs.,RobinHoodPennyStocks,PLM,37,37,0,37,1,14,5,1,AMEX
4553,12-02-2021 04:00,24 hrs.,RobinHoodPennyStocks,PTN,24,12,12,0,3,3,6,3,AMEX
4553,12-02-2021 04:00,24 hrs.,RobinHoodPennyStocks,RHE,34,34,0,34,1,11,8,1,AMEX
4553,12-02-2021 04:00,24 hrs.,RobinHoodPennyStocks,SSY,6,6,0,6,1,1,0,1,AMEX
4553,12-02-2021 04:00,24 hrs.,RobinHoodPennyStocks,SYN,6,6,0,6,1,1,0,1,AMEX
4553,12-02-2021 04:00,24 hrs.,RobinHoodPennyStocks,TGB,13,13,0,13,1,4,1,1,AMEX
4553,12-02-2021 04:00,24 hrs.,RobinHoodPennyStocks,TGC,257,0,257,-257,1,101,51,1,AMEX
4553,12-02-2021 04:00,24 hrs.,RobinHoodPennyStocks,TRT,34,34,0,34,1,11,8,1,AMEX
4553,12-02-2021 04:00,24 hrs.,RobinHoodPennyStocks,TRX,112,106,6,100,3,30,40,3,AMEX
4553,12-02-2021 04:00,24 hrs.,RobinHoodPennyStocks,URG,257,0,257,-257,1,101,51,1,AMEX
4553,12-02-2021 04:00,24 hrs.,RobinHoodPennyStocks,XPL,34,34,0,34,1,11,8,1,AMEX
4553,12-02-2021 04:00,24 hrs.,RobinHoodPennyStocks,ZOM,1125,584,541,43,21,307,427,19,AMEX
4553,12-02-2021 04:00,24 hrs.,RobinHoodPennyStocks,AMBO,34,34,0,34,1,11,8,1,AMEX
4553,12-02-2021 04:00,24 hrs.,RobinHoodPennyStocks,ANVS,257,0,257,-257,1,101,51,1,AMEX
4553,12-02-2021 04:00,24 hrs.,RobinHoodPennyStocks,AUMN,369,112,257,-145,4,131,91,4,AMEX
4553,12-02-2021 04:00,24 hrs.,RobinHoodPennyStocks,CRMD,257,0,257,-257,1,101,51,1,AMEX
4553,12-02-2021 04:00,24 hrs.,RobinHoodPennyStocks,GSAT,71,21,50,-29,4,13,29,4,AMEX
4553,12-02-2021 04:00,24 hrs.,RobinHoodPennyStocks,NSPR,65,7,58,-51,2,17,23,2,AMEX
4553,12-02-2021 04:00,24 hrs.,RobinHoodPennyStocks,OGEN,68,0,68,-68,2,25,10,2,AMEX
4553,12-02-2021 04:00,24 hrs.,RobinHoodPennyStocks,PLAG,291,34,257,-223,2,112,59,2,AMEX
4553,12-02-2021 04:00,24 hrs.,RobinHoodPennyStocks,SENS,46,0,46,-46,1,18,6,1,AMEX
4553,12-02-2021 04:00,24 hrs.,RobinHoodPennyStocks,TKAT,291,34,257,-223,2,112,59,2,AMEX
4553,12-02-2021 04:00,24 hrs.,RobinHoodPennyStocks,TRXC,54,54,0,54,1,16,18,1,AMEX
4553,12-02-2021 04:00,24 hrs.,RobinHoodPennyStocks,UAMY,257,0,257,-257,1,101,51,1,AMEX
4553,12-02-2021 04:00,24 hrs.,RobinHoodPennyStocks,UUUU,295,38,257,-219,2,113,61,2,AMEX
4553,12-02-2021 04:00,24 hrs.,RobinHoodPennyStocks,YCBD,6,6,0,6,1,1,0,1,AMEX
4553,12-02-2021 04:00,24 hrs.,RobinHoodPennyStocks,ACB,273,0,273,-273,2,106,53,2,NYSE
4553,12-02-2021 04:00,24 hrs.,RobinHoodPennyStocks,AMC,3726,74,3652,-3578,11,1589,504,9,NYSE
4553,12-02-2021 04:00,24 hrs.,RobinHoodPennyStocks,ASX,6,6,0,6,1,1,0,1,NYSE
4553,12-02-2021 04:00,24 hrs.,RobinHoodPennyStocks,AUY,72,72,0,72,1,18,32,1,NYSE
4553,12-02-2021 04:00,24 hrs.,RobinHoodPennyStocks,BBW,6,6,0,6,1,1,0,1,NYSE
4553,12-02-2021 04:00,24 hrs.,RobinHoodPennyStocks,BTU,34,34,0,34,1,11,8,1,NYSE
4553,12-02-2021 04:00,24 hrs.,RobinHoodPennyStocks,CCJ,257,0,257,-257,1,101,51,1,NYSE
4553,12-02-2021 04:00,24 hrs.,RobinHoodPennyStocks,CCM,291,34,257,-223,2,112,59,2,NYSE
4553,12-02-2021 04:00,24 hrs.,RobinHoodPennyStocks,COO,72,72,0,72,1,18,32,1,NYSE
4553,12-02-2021 04:00,24 hrs.,RobinHoodPennyStocks,CTK,291,34,257,-223,2,112,59,2,NYSE
4553,12-02-2021 04:00,24 hrs.,RobinHoodPennyStocks,DNK,6,6,0,6,1,1,0,1,NYSE
4553,12-02-2021 04:00,24 hrs.,RobinHoodPennyStocks,FSD,6,0,6,-6,1,1,0,1,NYSE
4553,12-02-2021 04:00,24 hrs.,RobinHoodPennyStocks,FSR,34,34,0,34,1,11,8,1,NYSE
4553,12-02-2021 04:00,24 hrs.,RobinHoodPennyStocks,FTK,6,0,6,-6,1,1,0,1,NYSE
4553,12-02-2021 04:00,24 hrs.,RobinHoodPennyStocks,GME,3892,175,3717,-3542,11,1634,580,9,NYSE
4553,12-02-2021 04:00,24 hrs.,RobinHoodPennyStocks,GSX,291,34,257,-223,2,112,59,2,NYSE
4553,12-02-2021 04:00,24 hrs.,RobinHoodPennyStocks,HMI,257,0,257,-257,1,101,51,1,NYSE
4553,12-02-2021 04:00,24 hrs.,RobinHoodPennyStocks,IRL,284,284,0,284,1,134,12,1,NYSE
4553,12-02-2021 04:00,24 hrs.,RobinHoodPennyStocks,IVR,6,6,0,6,1,1,0,1,NYSE
4553,12-02-2021 04:00,24 hrs.,RobinHoodPennyStocks,LYG,6,6,0,6,1,1,0,1,NYSE
4553,12-02-2021 04:00,24 hrs.,RobinHoodPennyStocks,NIO,291,34,257,-223,2,112,59,2,NYSE
4553,12-02-2021 04:00,24 hrs.,RobinHoodPennyStocks,PDT,107,107,0,107,2,34,31,2,NYSE
4553,12-02-2021 04:00,24 hrs.,RobinHoodPennyStocks,PSA,54,54,0,54,2,15,16,2,NYSE
4553,12-02-2021 04:00,24 hrs.,RobinHoodPennyStocks,RFP,34,34,0,34,1,11,8,1,NYSE
4553,12-02-2021 04:00,24 hrs.,pennystocks,FUNFF,39,33,6,27,2,8,15,2,OTC
4553,12-02-2021 04:00,24 hrs.,pennystocks,GBOKF,170,170,0,170,1,72,22,1,OTC
4553,12-02-2021 04:00,24 hrs.,pennystocks,GCPEF,23,23,0,23,1,6,7,1,OTC
4553,12-02-2021 04:00,24 hrs.,pennystocks,GLDFF,1638,6,1632,-1626,4,718,186,4,OTC
4553,12-02-2021 04:00,24 hrs.,pennystocks,GNOLF,6,0,6,-6,1,1,0,1,OTC
4553,12-02-2021 04:00,24 hrs.,pennystocks,GUESF,7,7,0,7,1,1,1,1,OTC
4553,12-02-2021 04:00,24 hrs.,pennystocks,HAVLF,170,170,0,170,1,72,22,1,OTC
4553,12-02-2021 04:00,24 hrs.,pennystocks,HITIF,565,342,223,119,27,124,209,23,OTC
4553,12-02-2021 04:00,24 hrs.,pennystocks,HNLMF,170,170,0,170,1,72,22,1,OTC
4553,12-02-2021 04:00,24 hrs.,pennystocks,ICAGY,6,0,6,-6,1,1,0,1,OTC
4553,12-02-2021 04:00,24 hrs.,pennystocks,ISCNF,12,12,0,12,2,2,0,1,OTC
4553,12-02-2021 04:00,24 hrs.,pennystocks,AQUA,7,7,0,7,1,1,1,1,NYSE
4553,12-02-2021 04:00,24 hrs.,pennystocks,BORR,6,6,0,6,1,1,0,1,NYSE
4553,12-02-2021 04:00,24 hrs.,pennystocks,DASH,6,0,6,-6,1,1,0,1,NYSE
4553,12-02-2021 04:00,24 hrs.,pennystocks,FENG,6,0,6,-6,1,1,0,1,NYSE
4553,12-02-2021 04:00,24 hrs.,pennystocks,GLOP,6,0,6,-6,1,1,0,1,NYSE
4553,12-02-2021 04:00,24 hrs.,pennystocks,HYLN,19,19,0,19,3,3,1,2,NYSE
4553,12-02-2021 04:00,24 hrs.,pennystocks,LEAF,47,0,47,-47,1,16,11,1,NYSE
4553,12-02-2021 04:00,24 hrs.,pennystocks,NOVA,170,170,0,170,1,72,22,1,NYSE
4553,12-02-2021 04:00,24 hrs.,pennystocks,WELL,6,0,6,-6,1,1,0,1,NYSE
4553,12-02-2021 04:00,24 hrs.,pennystocks,AQB,31,6,25,-19,3,9,1,3,NASDAQ
4553,12-02-2021 04:00,24 hrs.,pennystocks,AZN,31,31,0,31,1,7,13,1,NASDAQ
4553,12-02-2021 04:00,24 hrs.,pennystocks,BBI,6,0,6,-6,1,1,0,1,NASDAQ
4553,12-02-2021 04:00,24 hrs.,pennystocks,CFO,26,26,0,26,1,7,8,1,NASDAQ
4553,12-02-2021 04:00,24 hrs.,pennystocks,TSKFF,32,32,0,32,1,12,4,1,OTC
4553,12-02-2021 04:00,24 hrs.,pennystocks,TTTSF,12,12,0,12,2,2,0,2,OTC
4553,12-02-2021 04:00,24 hrs.,pennystocks,VLNCF,16,0,16,-16,2,2,4,2,OTC
4553,12-02-2021 04:00,24 hrs.,pennystocks,VRNDF,6,0,6,-6,1,1,0,1,OTC
4553,12-02-2021 04:00,24 hrs.,pennystocks,ZBISF,12,6,6,0,2,2,0,2,OTC
4553,12-02-2021 04:00,24 hrs.,pennystocks,APT,12,12,0,12,2,2,0,1,AMEX
4553,12-02-2021 04:00,24 hrs.,pennystocks,CEI,6,0,6,-6,1,1,0,1,AMEX
4553,12-02-2021 04:00,24 hrs.,pennystocks,CTO,18,18,0,18,3,3,0,1,AMEX
4553,12-02-2021 04:00,24 hrs.,pennystocks,DNN,915,227,688,-461,11,316,239,8,AMEX
4553,12-02-2021 04:00,24 hrs.,pennystocks,DPW,6,6,0,6,1,1,0,1,AMEX
4553,12-02-2021 04:00,24 hrs.,pennystocks,DSS,18,11,7,4,2,1,8,2,AMEX
4553,12-02-2021 04:00,24 hrs.,pennystocks,GPL,22,22,0,22,1,7,4,1,AMEX
4553,12-02-2021 04:00,24 hrs.,pennystocks,GSV,112,24,88,-64,5,36,20,4,AMEX
4553,12-02-2021 04:00,24 hrs.,pennystocks,GTE,40,7,33,-26,4,9,6,4,AMEX
4553,12-02-2021 04:00,24 hrs.,pennystocks,ITP,106,0,106,-106,2,42,14,2,AMEX
4553,12-02-2021 04:00,24 hrs.,pennystocks,LNG,7,7,0,7,1,1,1,1,AMEX
4553,12-02-2021 04:00,24 hrs.,pennystocks,MCF,6,0,6,-6,1,1,0,1,AMEX
4553,12-02-2021 04:00,24 hrs.,pennystocks,MXC,32,0,32,-32,1,12,4,1,AMEX
4553,12-02-2021 04:00,24 hrs.,pennystocks,NAK,18,12,6,6,3,3,0,3,AMEX
4553,12-02-2021 04:00,24 hrs.,pennystocks,NBY,21,21,0,21,1,5,7,1,AMEX
4553,12-02-2021 04:00,24 hrs.,pennystocks,NHS,17,17,0,17,1,0,13,1,AMEX
4553,12-02-2021 04:00,24 hrs.,pennystocks,OCX,86,0,86,-86,1,37,8,1,AMEX
4553,12-02-2021 04:00,24 hrs.,RobinHoodPennyStocks,RSI,257,0,257,-257,1,101,51,1,NYSE
4553,12-02-2021 04:00,24 hrs.,RobinHoodPennyStocks,SOS,351,88,263,-175,12,122,59,10,NYSE
4553,12-02-2021 04:00,24 hrs.,RobinHoodPennyStocks,SUZ,34,34,0,34,1,11,8,1,NYSE
4553,12-02-2021 04:00,24 hrs.,RobinHoodPennyStocks,TAL,291,34,257,-223,2,112,59,2,NYSE
4553,12-02-2021 04:00,24 hrs.,RobinHoodPennyStocks,WEI,297,34,263,-229,3,112,61,3,NYSE
4553,12-02-2021 04:00,24 hrs.,RobinHoodPennyStocks,BABA,291,34,257,-223,2,112,59,2,NYSE
4553,12-02-2021 04:00,24 hrs.,RobinHoodPennyStocks,CEIX,34,34,0,34,1,11,8,1,NYSE
4553,12-02-2021 04:00,24 hrs.,RobinHoodPennyStocks,CMCM,291,34,257,-223,2,112,59,2,NYSE
4553,12-02-2021 04:00,24 hrs.,RobinHoodPennyStocks,EXPR,6,0,6,-6,1,1,0,1,NYSE
4553,12-02-2021 04:00,24 hrs.,RobinHoodPennyStocks,FUBO,297,40,257,-217,3,113,59,3,NYSE
4553,12-02-2021 04:00,24 hrs.,RobinHoodPennyStocks,HEXO,257,0,257,-257,1,101,51,1,NYSE
4553,12-02-2021 04:00,24 hrs.,RobinHoodPennyStocks,LAIX,291,34,257,-223,2,112,59,2,NYSE
4553,12-02-2021 04:00,24 hrs.,RobinHoodPennyStocks,MDLY,257,0,257,-257,1,101,51,1,NYSE
4553,12-02-2021 04:00,24 hrs.,RobinHoodPennyStocks,RLGY,34,34,0,34,1,11,8,1,NYSE
4553,12-02-2021 04:00,24 hrs.,RobinHoodPennyStocks,XPEV,291,34,257,-223,2,112,59,2,NYSE
4553,12-02-2021 04:00,24 hrs.,RobinHoodPennyStocks,AIH,291,34,257,-223,2,112,59,2,NASDAQ
4553,12-02-2021 04:00,24 hrs.,RobinHoodPennyStocks,BBI,6,0,6,-6,1,1,0,1,NASDAQ
4553,12-02-2021 04:00,24 hrs.,RobinHoodPennyStocks,CGC,257,0,257,-257,1,101,51,1,NASDAQ
4553,12-02-2021 04:00,24 hrs.,pennystocks,TFECY,6,6,0,6,1,1,0,1,OTC
4553,12-02-2021 04:00,24 hrs.,pennystocks,TLOFF,74,74,0,74,3,17,28,2,OTC
4553,12-02-2021 04:00,24 hrs.,pennystocks,TMASF,24,0,24,-24,4,4,0,2,OTC
4553,12-02-2021 04:00,24 hrs.,pennystocks,TRUFF,170,170,0,170,1,72,22,1,OTC
4553,12-02-2021 04:00,24 hrs.,pennystocks,TSCRF,25,25,0,25,1,8,5,1,OTC
4553,12-02-2021 04:00,24 hrs.,RobinHoodPennyStocks,DNN,591,328,263,65,12,196,151,11,AMEX
4553,12-02-2021 04:00,24 hrs.,RobinHoodPennyStocks,DPW,291,34,257,-223,2,112,59,2,AMEX
4553,12-02-2021 04:00,24 hrs.,RobinHoodPennyStocks,GSV,87,81,6,75,3,18,39,3,AMEX
4553,12-02-2021 04:00,24 hrs.,RobinHoodPennyStocks,GTE,751,397,354,43,36,198,211,33,AMEX
4553,12-02-2021 04:00,24 hrs.,RobinHoodPennyStocks,IGC,263,0,263,-263,2,102,51,2,AMEX
4553,12-02-2021 04:00,24 hrs.,RobinHoodPennyStocks,ITP,7,7,0,7,1,1,1,1,AMEX
4553,12-02-2021 04:00,24 hrs.,RobinHoodPennyStocks,BBIG,12,6,6,0,2,2,0,2,NASDAQ
4553,12-02-2021 04:00,24 hrs.,RobinHoodPennyStocks,BCLI,6,6,0,6,1,1,0,1,NASDAQ
4553,12-02-2021 04:00,24 hrs.,RobinHoodPennyStocks,BCRX,44,44,0,44,1,9,22,1,NASDAQ
4553,12-02-2021 04:00,24 hrs.,RobinHoodPennyStocks,BFRA,34,34,0,34,1,11,8,1,NASDAQ
4553,12-02-2021 04:00,24 hrs.,RobinHoodPennyStocks,BGCP,257,0,257,-257,1,101,51,1,NASDAQ
4553,12-02-2021 04:00,24 hrs.,RobinHoodPennyStocks,BHAT,291,34,257,-223,2,112,59,2,NASDAQ
4553,12-02-2021 04:00,24 hrs.,RobinHoodPennyStocks,BIOL,35,0,35,-35,3,8,7,3,NASDAQ
4553,12-02-2021 04:00,24 hrs.,RobinHoodPennyStocks,BRQS,297,40,257,-217,3,113,59,3,NASDAQ
4553,12-02-2021 04:00,24 hrs.,RobinHoodPennyStocks,BYFC,291,34,257,-223,2,112,59,2,NASDAQ
4553,12-02-2021 04:00,24 hrs.,RobinHoodPennyStocks,CAAS,291,34,257,-223,2,112,59,2,NASDAQ
4553,12-02-2021 04:00,24 hrs.,RobinHoodPennyStocks,CARV,291,34,257,-223,2,112,59,2,NASDAQ
4553,12-02-2021 04:00,24 hrs.,RobinHoodPennyStocks,CBAT,291,34,257,-223,2,112,59,2,NASDAQ
4553,12-02-2021 04:00,24 hrs.,RobinHoodPennyStocks,CCNC,291,34,257,-223,2,112,59,2,NASDAQ
4553,12-02-2021 04:00,24 hrs.,pennystocks,PTN,13,0,13,-13,1,3,3,1,AMEX
4553,12-02-2021 04:00,24 hrs.,pennystocks,SIM,6,6,0,6,1,1,0,1,AMEX
4553,12-02-2021 04:00,24 hrs.,pennystocks,TGC,43,43,0,43,1,18,3,1,AMEX
4553,12-02-2021 04:00,24 hrs.,pennystocks,TRX,13,13,0,13,2,2,1,2,AMEX
4553,12-02-2021 04:00,24 hrs.,pennystocks,URG,19,0,19,-19,1,7,1,1,AMEX
4553,12-02-2021 04:00,24 hrs.,pennystocks,WRN,6,6,0,6,1,1,0,1,AMEX
4553,12-02-2021 04:00,24 hrs.,pennystocks,ZOM,78,39,39,0,6,17,20,6,AMEX
4553,12-02-2021 04:00,24 hrs.,pennystocks,GSAT,12,6,6,0,2,2,0,2,AMEX
4553,12-02-2021 04:00,24 hrs.,pennystocks,IBIO,7,0,7,-7,1,1,1,1,AMEX
4553,12-02-2021 04:00,24 hrs.,pennystocks,INUV,22,0,22,-22,2,6,2,2,AMEX
4553,12-02-2021 04:00,24 hrs.,pennystocks,NSPR,104,0,104,-104,3,41,10,3,AMEX
4553,12-02-2021 04:00,24 hrs.,pennystocks,OGEN,1625,0,1625,-1625,2,716,185,2,AMEX
4553,12-02-2021 04:00,24 hrs.,pennystocks,SENS,56,25,31,-6,4,18,4,4,AMEX
4553,12-02-2021 04:00,24 hrs.,pennystocks,TMBR,43,43,0,43,1,18,3,1,AMEX
4553,12-02-2021 04:00,24 hrs.,pennystocks,TRXC,6,0,6,-6,1,1,0,1,AMEX
4553,12-02-2021 04:00,24 hrs.,pennystocks,UUUU,43,6,37,-31,2,12,11,2,AMEX
4553,12-02-2021 04:00,24 hrs.,pennystocks,XXII,48,0,48,-48,4,12,8,3,AMEX
4553,12-02-2021 04:00,24 hrs.,pennystocks,YCBD,6,0,6,-6,1,1,0,1,AMEX
4553,12-02-2021 04:00,24 hrs.,pennystocks,AMC,26,26,0,26,4,4,2,3,NYSE
4553,12-02-2021 04:00,24 hrs.,pennystocks,AMP,104,0,104,-104,3,34,24,2,NYSE
4553,12-02-2021 04:00,24 hrs.,pennystocks,ASX,6,6,0,6,1,1,0,1,NYSE
4553,12-02-2021 04:00,24 hrs.,pennystocks,AUY,6,6,0,6,1,1,0,1,NYSE
4553,12-02-2021 04:00,24 hrs.,pennystocks,BIO,136,0,136,-136,2,56,16,2,NYSE
4553,12-02-2021 04:00,24 hrs.,pennystocks,CBD,539,252,287,-35,15,184,111,12,NYSE
4553,12-02-2021 04:00,24 hrs.,pennystocks,CMO,26,26,0,26,1,7,8,1,NYSE
4553,12-02-2021 04:00,24 hrs.,pennystocks,CRL,6,6,0,6,1,1,0,1,NYSE
4553,12-02-2021 04:00,24 hrs.,pennystocks,CTK,43,43,0,43,1,18,3,1,NYSE
4553,12-02-2021 04:00,24 hrs.,pennystocks,CVE,12,12,0,12,2,1,2,2,NYSE
4553,12-02-2021 04:00,24 hrs.,pennystocks,DAC,6,0,6,-6,1,1,0,1,NYSE
4553,12-02-2021 04:00,24 hrs.,pennystocks,DDS,45,0,45,-45,1,15,11,1,NYSE
4553,12-02-2021 04:00,24 hrs.,pennystocks,ETH,6,0,6,-6,1,1,0,1,NYSE
4553,12-02-2021 04:00,24 hrs.,pennystocks,EXP,10,0,10,-10,1,2,2,1,NYSE
4553,12-02-2021 04:00,24 hrs.,pennystocks,FLT,26,13,13,0,4,4,2,4,NYSE
4553,12-02-2021 04:00,24 hrs.,pennystocks,GIK,9,0,9,-9,1,0,5,1,NYSE
4553,12-02-2021 04:00,24 hrs.,pennystocks,GME,49,49,0,49,8,8,1,7,NYSE
4553,12-02-2021 04:00,24 hrs.,pennystocks,HVT,6,0,6,-6,1,1,0,1,NYSE
4553,12-02-2021 04:00,24 hrs.,pennystocks,JKS,45,0,45,-45,1,15,11,1,NYSE
4553,12-02-2021 04:00,24 hrs.,pennystocks,LEE,108,108,0,108,2,17,66,2,NYSE
4553,12-02-2021 04:00,24 hrs.,pennystocks,MUX,6,6,0,6,1,1,0,1,NYSE
4553,12-02-2021 04:00,24 hrs.,pennystocks,NOK,73,54,19,35,6,15,19,5,NYSE
4553,12-02-2021 04:00,24 hrs.,pennystocks,NYC,722,0,722,-722,1,309,100,1,NYSE
4553,12-02-2021 04:00,24 hrs.,pennystocks,PHI,6,6,0,6,1,1,0,1,NYSE
4553,12-02-2021 04:00,24 hrs.,pennystocks,PSA,489,478,11,467,5,213,43,5,NYSE
4553,12-02-2021 04:00,24 hrs.,pennystocks,RSI,31,31,0,31,3,7,5,3,NYSE
4553,12-02-2021 04:00,24 hrs.,pennystocks,SAP,170,170,0,170,1,72,22,1,NYSE
4553,12-02-2021 04:00,24 hrs.,pennystocks,SOS,38,12,26,-14,3,8,10,3,NYSE
4553,12-02-2021 04:00,24 hrs.,pennystocks,TDA,23,23,0,23,1,3,13,1,NYSE
4553,12-02-2021 04:00,24 hrs.,pennystocks,THC,267,245,22,223,3,103,49,3,NYSE
4553,12-02-2021 04:00,24 hrs.,pennystocks,TKR,15,15,0,15,1,4,3,1,NYSE
4553,12-02-2021 04:00,24 hrs.,pennystocks,TTI,12,12,0,12,2,2,0,1,NYSE
4553,12-02-2021 04:00,24 hrs.,pennystocks,VET,9,9,0,9,1,2,1,1,NYSE
4553,12-02-2021 04:00,24 hrs.,RobinHoodPennyStocks,CHNR,34,34,0,34,1,11,8,1,NASDAQ
4553,12-02-2021 04:00,24 hrs.,RobinHoodPennyStocks,CIDM,6,6,0,6,1,1,0,1,NASDAQ
4553,12-02-2021 04:00,24 hrs.,RobinHoodPennyStocks,CKPT,201,201,0,201,1,31,135,1,NASDAQ
4553,12-02-2021 04:00,24 hrs.,RobinHoodPennyStocks,CLEU,291,34,257,-223,2,112,59,2,NASDAQ
4553,12-02-2021 04:00,24 hrs.,RobinHoodPennyStocks,CLRB,17,17,0,17,1,6,1,1,NASDAQ
4553,12-02-2021 04:00,24 hrs.,RobinHoodPennyStocks,CLSK,291,34,257,-223,2,112,59,2,NASDAQ
4553,12-02-2021 04:00,24 hrs.,RobinHoodPennyStocks,CLSN,12,6,6,0,2,2,0,2,NASDAQ
4553,12-02-2021 04:00,24 hrs.,RobinHoodPennyStocks,CMLF,34,34,0,34,1,11,8,1,NASDAQ
4553,12-02-2021 04:00,24 hrs.,RobinHoodPennyStocks,CNSP,257,0,257,-257,1,101,51,1,NASDAQ
4553,12-02-2021 04:00,24 hrs.,RobinHoodPennyStocks,CRBP,267,0,267,-267,2,103,53,2,NASDAQ
4553,12-02-2021 04:00,24 hrs.,RobinHoodPennyStocks,CRON,257,0,257,-257,1,101,51,1,NASDAQ
4553,12-02-2021 04:00,24 hrs.,RobinHoodPennyStocks,CSCW,34,34,0,34,1,11,8,1,NASDAQ
4553,12-02-2021 04:00,24 hrs.,RobinHoodPennyStocks,CTRM,1208,723,485,238,35,354,360,31,NASDAQ
4553,12-02-2021 04:00,24 hrs.,pennystocks,GBT,7,0,7,-7,1,1,1,1,NASDAQ
4553,12-02-2021 04:00,24 hrs.,pennystocks,III,108,0,108,-108,1,23,58,1,NASDAQ
4553,12-02-2021 04:00,24 hrs.,pennystocks,JAN,18,0,18,-18,1,0,14,1,NASDAQ
4553,12-02-2021 04:00,24 hrs.,RobinHoodPennyStocks,ENG,291,34,257,-223,2,112,59,2,NASDAQ
4553,12-02-2021 04:00,24 hrs.,RobinHoodPennyStocks,EVK,291,34,257,-223,2,112,59,2,NASDAQ
4553,12-02-2021 04:00,24 hrs.,RobinHoodPennyStocks,JFU,12,6,6,0,2,2,0,2,NASDAQ
4553,12-02-2021 04:00,24 hrs.,RobinHoodPennyStocks,MGI,291,34,257,-223,2,112,59,2,NASDAQ
4553,12-02-2021 04:00,24 hrs.,RobinHoodPennyStocks,OCG,291,34,257,-223,2,112,59,2,NASDAQ
4553,12-02-2021 04:00,24 hrs.,RobinHoodPennyStocks,OEG,291,34,257,-223,2,112,59,2,NASDAQ
4553,12-02-2021 04:00,24 hrs.,RobinHoodPennyStocks,OGI,3847,0,3847,-3847,6,1658,507,6,NASDAQ
4553,12-02-2021 04:00,24 hrs.,RobinHoodPennyStocks,PTE,138,39,99,-60,6,52,10,5,NASDAQ
4553,12-02-2021 04:00,24 hrs.,RobinHoodPennyStocks,QTT,291,34,257,-223,2,112,59,2,NASDAQ
4553,12-02-2021 04:00,24 hrs.,RobinHoodPennyStocks,RCM,257,0,257,-257,1,101,51,1,NASDAQ
4553,12-02-2021 04:00,24 hrs.,RobinHoodPennyStocks,SLS,257,0,257,-257,1,101,51,1,NASDAQ
4553,12-02-2021 04:00,24 hrs.,RobinHoodPennyStocks,SMH,6,0,6,-6,1,1,0,1,NASDAQ
4553,12-02-2021 04:00,24 hrs.,RobinHoodPennyStocks,SPI,291,34,257,-223,2,112,59,2,NASDAQ
4553,12-02-2021 04:00,24 hrs.,RobinHoodPennyStocks,WNW,34,34,0,34,1,11,8,1,NASDAQ
4553,12-02-2021 04:00,24 hrs.,RobinHoodPennyStocks,WWR,291,34,257,-223,2,112,59,2,NASDAQ
4553,12-02-2021 04:00,24 hrs.,RobinHoodPennyStocks,AAOI,34,34,0,34,1,11,8,1,NASDAQ
4553,12-02-2021 04:00,24 hrs.,RobinHoodPennyStocks,AAPL,257,0,257,-257,1,101,51,1,NASDAQ
4553,12-02-2021 04:00,24 hrs.,RobinHoodPennyStocks,ABEO,130,124,6,118,2,50,22,2,NASDAQ
4553,12-02-2021 04:00,24 hrs.,RobinHoodPennyStocks,ABIO,15,15,0,15,1,3,5,1,NASDAQ
4553,12-02-2021 04:00,24 hrs.,RobinHoodPennyStocks,ACOR,34,34,0,34,1,11,8,1,NASDAQ
4553,12-02-2021 04:00,24 hrs.,RobinHoodPennyStocks,ADMA,108,39,69,-30,3,38,20,3,NASDAQ
4553,12-02-2021 04:00,24 hrs.,RobinHoodPennyStocks,ADMP,6,0,6,-6,1,1,0,1,NASDAQ
4553,12-02-2021 04:00,24 hrs.,RobinHoodPennyStocks,ADMS,257,0,257,-257,1,101,51,1,NASDAQ
4553,12-02-2021 04:00,24 hrs.,RobinHoodPennyStocks,ADXS,12,6,6,0,2,2,0,2,NASDAQ
4553,12-02-2021 04:00,24 hrs.,RobinHoodPennyStocks,AEHR,34,34,0,34,1,11,8,1,NASDAQ
4553,12-02-2021 04:00,24 hrs.,RobinHoodPennyStocks,AESE,6,6,0,6,1,1,0,1,NASDAQ
4553,12-02-2021 04:00,24 hrs.,RobinHoodPennyStocks,AEZS,302,17,285,-268,3,108,74,3,NASDAQ
4553,12-02-2021 04:00,24 hrs.,RobinHoodPennyStocks,AGEN,257,0,257,-257,1,101,51,1,NASDAQ
4553,12-02-2021 04:00,24 hrs.,RobinHoodPennyStocks,AGTC,4959,1126,3833,-2707,48,1909,949,44,NASDAQ
4553,12-02-2021 04:00,24 hrs.,RobinHoodPennyStocks,AIHS,297,34,263,-229,3,113,59,3,NASDAQ
4553,12-02-2021 04:00,24 hrs.,RobinHoodPennyStocks,AKER,257,0,257,-257,1,101,51,1,NASDAQ
4553,12-02-2021 04:00,24 hrs.,RobinHoodPennyStocks,ALAC,291,34,257,-223,2,112,59,2,NASDAQ
4553,12-02-2021 04:00,24 hrs.,RobinHoodPennyStocks,ALVR,257,0,257,-257,1,101,51,1,NASDAQ
4553,12-02-2021 04:00,24 hrs.,RobinHoodPennyStocks,AMTX,291,34,257,-223,2,112,59,2,NASDAQ
4553,12-02-2021 04:00,24 hrs.,RobinHoodPennyStocks,ANCN,257,0,257,-257,1,101,51,1,NASDAQ
4553,12-02-2021 04:00,24 hrs.,RobinHoodPennyStocks,AOSL,10,0,10,-10,1,1,4,1,NASDAQ
4553,12-02-2021 04:00,24 hrs.,RobinHoodPennyStocks,APHA,281,6,275,-269,5,105,51,4,NASDAQ
4553,12-02-2021 04:00,24 hrs.,RobinHoodPennyStocks,ARTL,263,6,257,-251,2,102,51,2,NASDAQ
4553,12-02-2021 04:00,24 hrs.,RobinHoodPennyStocks,ASRT,205,39,166,-127,6,66,49,6,NASDAQ
4553,12-02-2021 04:00,24 hrs.,RobinHoodPennyStocks,ASYS,34,34,0,34,1,11,8,1,NASDAQ
4553,12-02-2021 04:00,24 hrs.,RobinHoodPennyStocks,ATIF,291,34,257,-223,2,112,59,2,NASDAQ
4553,12-02-2021 04:00,24 hrs.,RobinHoodPennyStocks,ATNI,34,34,0,34,1,11,8,1,NASDAQ
4553,12-02-2021 04:00,24 hrs.,RobinHoodPennyStocks,ATOS,427,53,374,-321,6,154,95,6,NASDAQ
4553,12-02-2021 04:00,24 hrs.,RobinHoodPennyStocks,AVCO,291,34,257,-223,2,112,59,2,NASDAQ
4553,12-02-2021 04:00,24 hrs.,RobinHoodPennyStocks,AVGR,257,0,257,-257,1,101,51,1,NASDAQ
4553,12-02-2021 04:00,24 hrs.,RobinHoodPennyStocks,AYRO,257,0,257,-257,1,101,51,1,NASDAQ
4553,12-02-2021 04:00,24 hrs.,RobinHoodPennyStocks,AYTU,17,0,17,-17,1,5,3,1,NASDAQ
4553,12-02-2021 04:00,24 hrs.,RobinHoodPennyStocks,AZRX,257,0,257,-257,1,101,51,1,NASDAQ
4553,12-02-2021 04:00,24 hrs.,pennystocks,EAST,1619,0,1619,-1619,1,715,185,1,NASDAQ
4553,12-02-2021 04:00,24 hrs.,pennystocks,EBON,6,6,0,6,1,1,0,1,NASDAQ
4553,12-02-2021 04:00,24 hrs.,pennystocks,EDIT,1405,121,1284,-1163,4,575,239,4,NASDAQ
4553,12-02-2021 04:00,24 hrs.,pennystocks,ENPH,25,25,0,25,1,3,15,1,NASDAQ
4553,12-02-2021 04:00,24 hrs.,pennystocks,EVFM,12,6,6,0,2,2,0,2,NASDAQ
4553,12-02-2021 04:00,24 hrs.,pennystocks,FCEL,25,25,0,25,1,3,15,1,NASDAQ
4553,12-02-2021 04:00,24 hrs.,pennystocks,GEVO,52,52,0,52,3,12,16,2,NASDAQ
4553,12-02-2021 04:00,24 hrs.,pennystocks,GHSI,81,81,0,81,1,29,19,1,NASDAQ
4553,12-02-2021 04:00,24 hrs.,pennystocks,GIII,108,0,108,-108,1,23,58,1,NASDAQ
4553,12-02-2021 04:00,24 hrs.,pennystocks,GLBS,18,18,0,18,1,0,14,1,NASDAQ
4553,12-02-2021 04:00,24 hrs.,pennystocks,GMBL,228,0,228,-228,1,88,48,1,NASDAQ
4553,12-02-2021 04:00,24 hrs.,pennystocks,GNLN,7,0,7,-7,1,1,1,1,NASDAQ
4553,12-02-2021 04:00,24 hrs.,pennystocks,GOLD,12,12,0,12,2,2,0,2,NASDAQ
4553,12-02-2021 04:00,24 hrs.,pennystocks,GRIL,13,13,0,13,2,2,1,2,NASDAQ
4553,12-02-2021 04:00,24 hrs.,pennystocks,GRNQ,43,43,0,43,1,18,3,1,NASDAQ
4553,12-02-2021 04:00,24 hrs.,pennystocks,GRWG,6,0,6,-6,1,1,0,1,NASDAQ
4553,12-02-2021 04:00,24 hrs.,pennystocks,HALO,18,6,12,-6,3,3,0,3,NASDAQ
4553,12-02-2021 04:00,24 hrs.,pennystocks,HJLI,11,0,11,-11,1,2,3,1,NASDAQ
4553,12-02-2021 04:00,24 hrs.,pennystocks,IDEX,6,0,6,-6,1,1,0,1,NASDAQ
4553,12-02-2021 04:00,24 hrs.,pennystocks,IFMK,50,50,0,50,2,19,4,2,NASDAQ
4553,12-02-2021 04:00,24 hrs.,pennystocks,IMMR,6,0,6,-6,1,1,0,1,NASDAQ
4553,12-02-2021 04:00,24 hrs.,pennystocks,INFI,43,43,0,43,1,18,3,1,NASDAQ
4553,12-02-2021 04:00,24 hrs.,pennystocks,INFO,6,6,0,6,1,0,2,1,NASDAQ
4553,12-02-2021 04:00,24 hrs.,pennystocks,INPX,83,83,0,83,7,24,7,6,NASDAQ
4553,12-02-2021 04:00,24 hrs.,pennystocks,ITRM,10,0,10,-10,1,2,2,1,NASDAQ
4553,12-02-2021 04:00,24 hrs.,pennystocks,JAGX,15,6,9,-3,2,3,1,2,NASDAQ
4553,12-02-2021 04:00,24 hrs.,pennystocks,KERN,6,0,6,-6,1,1,0,1,NASDAQ
4553,12-02-2021 04:00,24 hrs.,pennystocks,KTRA,1626,0,1626,-1626,2,716,186,2,NASDAQ
4553,12-02-2021 04:00,24 hrs.,pennystocks,KXIN,7,0,7,-7,1,1,1,1,NASDAQ
4553,12-02-2021 04:00,24 hrs.,RobinHoodPennyStocks,DFFN,12,12,0,12,1,2,4,1,NASDAQ
4553,12-02-2021 04:00,24 hrs.,RobinHoodPennyStocks,DMTK,257,0,257,-257,1,101,51,1,NASDAQ
4553,12-02-2021 04:00,24 hrs.,RobinHoodPennyStocks,DZSI,257,0,257,-257,1,101,51,1,NASDAQ
4553,12-02-2021 04:00,24 hrs.,RobinHoodPennyStocks,EAST,184,12,172,-160,5,63,38,5,NASDAQ
4553,12-02-2021 04:00,24 hrs.,RobinHoodPennyStocks,EBON,257,0,257,-257,1,101,51,1,NASDAQ
4553,12-02-2021 04:00,24 hrs.,RobinHoodPennyStocks,ENVB,72,6,66,-60,2,25,14,2,NASDAQ
4553,12-02-2021 04:00,24 hrs.,pennystocks,JFU,6,0,6,-6,1,1,0,1,NASDAQ
4553,12-02-2021 04:00,24 hrs.,pennystocks,MFH,43,43,0,43,1,18,3,1,NASDAQ
4553,12-02-2021 04:00,24 hrs.,pennystocks,NEO,337,170,167,3,2,143,43,2,NASDAQ
4553,12-02-2021 04:00,24 hrs.,pennystocks,OGI,13,7,6,1,2,2,1,2,NASDAQ
4553,12-02-2021 04:00,24 hrs.,pennystocks,PTE,20,0,20,-20,3,3,2,2,NASDAQ
4553,12-02-2021 04:00,24 hrs.,pennystocks,RUN,4,0,4,-4,1,0,0,1,NASDAQ
4553,12-02-2021 04:00,24 hrs.,pennystocks,ABEO,51,12,39,-27,8,8,3,4,NASDAQ
4553,12-02-2021 04:00,24 hrs.,pennystocks,ABIO,28,28,0,28,2,9,2,2,NASDAQ
4553,12-02-2021 04:00,24 hrs.,pennystocks,ACRX,19,0,19,-19,1,7,1,1,NASDAQ
4553,12-02-2021 04:00,24 hrs.,pennystocks,ADMA,1619,0,1619,-1619,1,715,185,1,NASDAQ
4553,12-02-2021 04:00,24 hrs.,pennystocks,ADTX,42,23,19,4,2,10,14,2,NASDAQ
4553,12-02-2021 04:00,24 hrs.,pennystocks,ADXS,26,13,13,0,4,4,2,4,NASDAQ
4553,12-02-2021 04:00,24 hrs.,pennystocks,AEMD,40,0,40,-40,1,15,6,1,NASDAQ
4553,12-02-2021 04:00,24 hrs.,pennystocks,AESE,228,0,228,-228,1,88,48,1,NASDAQ
4553,12-02-2021 04:00,24 hrs.,pennystocks,AGTC,544,532,12,520,7,221,74,7,NASDAQ
4553,12-02-2021 04:00,24 hrs.,pennystocks,AIHS,6,0,6,-6,1,1,0,1,NASDAQ
4553,12-02-2021 04:00,24 hrs.,pennystocks,AKBA,12,12,0,12,2,2,0,1,NASDAQ
4553,12-02-2021 04:00,24 hrs.,pennystocks,AKER,7,0,7,-7,1,1,1,1,NASDAQ
4553,12-02-2021 04:00,24 hrs.,pennystocks,ALRN,19,19,0,19,1,3,9,1,NASDAQ
4553,12-02-2021 04:00,24 hrs.,pennystocks,AMTX,19,0,19,-19,1,7,1,1,NASDAQ
4553,12-02-2021 04:00,24 hrs.,pennystocks,ANDA,17,17,0,17,1,0,13,1,NASDAQ
4553,12-02-2021 04:00,24 hrs.,pennystocks,APHA,12,0,12,-12,2,2,0,2,NASDAQ
4553,12-02-2021 04:00,24 hrs.,pennystocks,ARTL,130,0,130,-130,3,41,36,2,NASDAQ
4553,12-02-2021 04:00,24 hrs.,pennystocks,ASRT,268,6,262,-256,3,103,50,3,NASDAQ
4553,12-02-2021 04:00,24 hrs.,pennystocks,ATHE,19,0,19,-19,1,7,1,1,NASDAQ
4553,12-02-2021 04:00,24 hrs.,pennystocks,ATOM,6,0,6,-6,1,1,0,1,NASDAQ
4553,12-02-2021 04:00,24 hrs.,pennystocks,ATOS,321,182,139,43,8,107,75,8,NASDAQ
4553,12-02-2021 04:00,24 hrs.,pennystocks,AVXL,7,7,0,7,1,1,1,1,NASDAQ
4553,12-02-2021 04:00,24 hrs.,RobinHoodPennyStocks,CGIX,257,0,257,-257,1,101,51,1,NASDAQ
4553,12-02-2021 04:00,24 hrs.,RobinHoodPennyStocks,LKCO,48,30,18,12,8,8,0,5,NASDAQ
4553,12-02-2021 04:00,24 hrs.,RobinHoodPennyStocks,LLNW,38,38,0,38,1,11,12,1,NASDAQ
4553,12-02-2021 04:00,24 hrs.,RobinHoodPennyStocks,LMFA,291,34,257,-223,2,112,59,2,NASDAQ
4553,12-02-2021 04:00,24 hrs.,RobinHoodPennyStocks,LMNL,257,0,257,-257,1,101,51,1,NASDAQ
4553,12-02-2021 04:00,24 hrs.,RobinHoodPennyStocks,LPCN,18,0,18,-18,1,5,4,1,NASDAQ
4553,12-02-2021 04:00,24 hrs.,RobinHoodPennyStocks,LXEH,291,34,257,-223,2,112,59,2,NASDAQ
4553,12-02-2021 04:00,24 hrs.,RobinHoodPennyStocks,LYRA,257,0,257,-257,1,101,51,1,NASDAQ
4553,12-02-2021 04:00,24 hrs.,RobinHoodPennyStocks,MARA,291,34,257,-223,2,112,59,2,NASDAQ
4553,12-02-2021 04:00,24 hrs.,RobinHoodPennyStocks,MBRX,257,0,257,-257,1,101,51,1,NASDAQ
4553,12-02-2021 04:00,24 hrs.,RobinHoodPennyStocks,METX,34,34,0,34,1,11,8,1,NASDAQ
4553,12-02-2021 04:00,24 hrs.,RobinHoodPennyStocks,MOGO,291,34,257,-223,2,112,59,2,NASDAQ
4553,12-02-2021 04:00,24 hrs.,RobinHoodPennyStocks,MOMO,34,34,0,34,1,11,8,1,NASDAQ
4553,12-02-2021 04:00,24 hrs.,RobinHoodPennyStocks,MOSY,34,34,0,34,1,11,8,1,NASDAQ
4553,12-02-2021 04:00,24 hrs.,RobinHoodPennyStocks,MOTS,9,0,9,-9,1,2,1,1,NASDAQ
4553,12-02-2021 04:00,24 hrs.,RobinHoodPennyStocks,MOXC,291,34,257,-223,2,112,59,2,NASDAQ
4553,12-02-2021 04:00,24 hrs.,RobinHoodPennyStocks,MVIS,321,34,287,-253,4,118,69,4,NASDAQ
4553,12-02-2021 04:00,24 hrs.,RobinHoodPennyStocks,NAKD,383,114,269,-155,6,125,109,6,NASDAQ
4553,12-02-2021 04:00,24 hrs.,RobinHoodPennyStocks,NCTY,291,34,257,-223,2,112,59,2,NASDAQ
4553,12-02-2021 04:00,24 hrs.,RobinHoodPennyStocks,NDRA,6,0,6,-6,1,1,0,1,NASDAQ
4553,12-02-2021 04:00,24 hrs.,RobinHoodPennyStocks,NEOS,17,0,17,-17,1,5,3,1,NASDAQ
4553,12-02-2021 04:00,24 hrs.,RobinHoodPennyStocks,NKTX,257,0,257,-257,1,101,51,1,NASDAQ
4553,12-02-2021 04:00,24 hrs.,RobinHoodPennyStocks,NOVN,119,119,0,119,6,30,35,4,NASDAQ
4553,12-02-2021 04:00,24 hrs.,RobinHoodPennyStocks,NTEC,257,0,257,-257,1,101,51,1,NASDAQ
4553,12-02-2021 04:00,24 hrs.,RobinHoodPennyStocks,NVCN,179,52,127,-75,6,52,51,6,NASDAQ
4553,12-02-2021 04:00,24 hrs.,RobinHoodPennyStocks,NVIV,12,12,0,12,1,2,4,1,NASDAQ
4553,12-02-2021 04:00,24 hrs.,RobinHoodPennyStocks,NXTD,297,34,263,-229,3,113,59,3,NASDAQ
4553,12-02-2021 04:00,24 hrs.,RobinHoodPennyStocks,OCGN,391,18,373,-355,8,124,111,8,NASDAQ
4553,12-02-2021 04:00,24 hrs.,RobinHoodPennyStocks,ONTX,90,20,70,-50,6,25,16,5,NASDAQ
4553,12-02-2021 04:00,24 hrs.,RobinHoodPennyStocks,OPGN,337,12,325,-313,5,128,61,4,NASDAQ
4553,12-02-2021 04:00,24 hrs.,RobinHoodPennyStocks,OPTT,291,34,257,-223,2,112,59,2,NASDAQ
4553,12-02-2021 04:00,24 hrs.,RobinHoodPennyStocks,PECK,291,34,257,-223,2,112,59,2,NASDAQ
4553,12-02-2021 04:00,24 hrs.,RobinHoodPennyStocks,PEIX,291,34,257,-223,2,112,59,2,NASDAQ
4553,12-02-2021 04:00,24 hrs.,RobinHoodPennyStocks,PETZ,291,34,257,-223,2,112,59,2,NASDAQ
4553,12-02-2021 04:00,24 hrs.,RobinHoodPennyStocks,PHUN,291,34,257,-223,2,112,59,2,NASDAQ
4553,12-02-2021 04:00,24 hrs.,RobinHoodPennyStocks,PIXY,34,34,0,34,1,11,8,1,NASDAQ
4553,12-02-2021 04:00,24 hrs.,pennystocks,AYTU,6,0,6,-6,1,1,0,1,NASDAQ
4553,12-02-2021 04:00,24 hrs.,pennystocks,AZRX,9,9,0,9,1,1,3,1,NASDAQ
4553,12-02-2021 04:00,24 hrs.,pennystocks,BBIG,6,6,0,6,1,1,0,1,NASDAQ
4553,12-02-2021 04:00,24 hrs.,pennystocks,BEEM,45,0,45,-45,1,15,11,1,NASDAQ
4553,12-02-2021 04:00,24 hrs.,pennystocks,BHTG,19,7,12,-5,2,1,9,2,NASDAQ
4553,12-02-2021 04:00,24 hrs.,pennystocks,BKEP,11,11,0,11,1,2,3,1,NASDAQ
4553,12-02-2021 04:00,24 hrs.,pennystocks,BLCM,43,43,0,43,1,18,3,1,NASDAQ
4553,12-02-2021 04:00,24 hrs.,pennystocks,BLUE,6,0,6,-6,1,1,0,1,NASDAQ
4553,12-02-2021 04:00,24 hrs.,pennystocks,BNGO,43,0,43,-43,3,8,15,3,NASDAQ
4553,12-02-2021 04:00,24 hrs.,pennystocks,BOXL,19,0,19,-19,1,7,1,1,NASDAQ
4553,12-02-2021 04:00,24 hrs.,pennystocks,BPTH,33,0,33,-33,1,6,17,1,NASDAQ
4553,12-02-2021 04:00,24 hrs.,pennystocks,BRQS,53,53,0,53,1,18,13,1,NASDAQ
4553,12-02-2021 04:00,24 hrs.,pennystocks,BVXV,7,7,0,7,1,1,1,1,NASDAQ
4553,12-02-2021 04:00,24 hrs.,pennystocks,BXRX,92,0,92,-92,1,39,10,1,NASDAQ
4553,12-02-2021 04:00,24 hrs.,pennystocks,BYFC,6,0,6,-6,1,1,0,1,NASDAQ
4553,12-02-2021 04:00,24 hrs.,pennystocks,CAPR,6,6,0,6,1,1,0,1,NASDAQ
4553,12-02-2021 04:00,24 hrs.,pennystocks,CIDM,13,7,6,1,2,2,1,2,NASDAQ
4553,12-02-2021 04:00,24 hrs.,pennystocks,CJJD,43,43,0,43,1,18,3,1,NASDAQ
4553,12-02-2021 04:00,24 hrs.,pennystocks,CKPT,55,55,0,55,3,20,3,2,NASDAQ
4553,12-02-2021 04:00,24 hrs.,pennystocks,CLBS,7,7,0,7,1,1,1,1,NASDAQ
4553,12-02-2021 04:00,24 hrs.,pennystocks,CLRB,6,0,6,-6,1,1,0,1,NASDAQ
4553,12-02-2021 04:00,24 hrs.,pennystocks,CMPS,176,176,0,176,2,73,22,2,NASDAQ
4553,12-02-2021 04:00,24 hrs.,pennystocks,CNET,13,0,13,-13,1,3,3,1,NASDAQ
4553,12-02-2021 04:00,24 hrs.,pennystocks,CRBP,144,99,45,54,2,55,26,2,NASDAQ
4553,12-02-2021 04:00,24 hrs.,pennystocks,CRSR,42,42,0,42,1,10,18,1,NASDAQ
4553,12-02-2021 04:00,24 hrs.,pennystocks,CTRM,2381,338,2043,-1705,29,970,325,24,NASDAQ
4553,12-02-2021 04:00,24 hrs.,pennystocks,CTXR,6,6,0,6,1,1,0,1,NASDAQ
4553,12-02-2021 04:00,24 hrs.,pennystocks,DGLY,35,35,0,35,5,5,5,1,NASDAQ
4553,12-02-2021 04:00,24 hrs.,pennystocks,DYNT,43,43,0,43,1,18,3,1,NASDAQ
4553,12-02-2021 04:00,24 hrs.,pennystocks,MGNI,6,0,6,-6,1,1,0,1,NASDAQ
4553,12-02-2021 04:00,24 hrs.,pennystocks,MICT,7,0,7,-7,1,1,1,1,NASDAQ
4553,12-02-2021 04:00,24 hrs.,pennystocks,MNDO,6,0,6,-6,1,1,0,1,NASDAQ
4553,12-02-2021 04:00,24 hrs.,pennystocks,MOGO,28,28,0,28,3,2,12,1,NASDAQ
4553,12-02-2021 04:00,24 hrs.,pennystocks,MOSY,43,43,0,43,1,18,3,1,NASDAQ
4553,12-02-2021 04:00,24 hrs.,pennystocks,MOTS,26,7,19,-12,2,8,2,2,NASDAQ
4553,12-02-2021 04:00,24 hrs.,pennystocks,MTRX,6,6,0,6,1,0,2,1,NASDAQ
4553,12-02-2021 04:00,24 hrs.,pennystocks,MVIS,49,49,0,49,2,19,3,2,NASDAQ
4553,12-02-2021 04:00,24 hrs.,pennystocks,NAKD,268,13,255,-242,10,92,44,10,NASDAQ
4553,12-02-2021 04:00,24 hrs.,pennystocks,NEOS,6,0,6,-6,1,1,0,1,NASDAQ
4553,12-02-2021 04:00,24 hrs.,pennystocks,NOVN,54,28,26,2,4,14,10,4,NASDAQ
4553,12-02-2021 04:00,24 hrs.,pennystocks,NTEC,43,43,0,43,1,18,3,1,NASDAQ
4553,12-02-2021 04:00,24 hrs.,pennystocks,NVCN,1638,13,1625,-1612,4,718,186,4,NASDAQ
4553,12-02-2021 04:00,24 hrs.,pennystocks,NVIV,6,0,6,-6,1,1,0,1,NASDAQ
4553,12-02-2021 04:00,24 hrs.,pennystocks,NXTD,57,51,6,45,3,20,5,3,NASDAQ
4553,12-02-2021 04:00,24 hrs.,pennystocks,OCGN,1882,1803,79,1724,6,848,162,5,NASDAQ
4553,12-02-2021 04:00,24 hrs.,pennystocks,ONTX,12,6,6,0,2,2,0,2,NASDAQ
4553,12-02-2021 04:00,24 hrs.,pennystocks,OPGN,1626,0,1626,-1626,2,716,186,2,NASDAQ
4553,12-02-2021 04:00,24 hrs.,pennystocks,PHIO,43,43,0,43,1,18,3,1,NASDAQ
4553,12-02-2021 04:00,24 hrs.,pennystocks,PHUN,13,13,0,13,2,2,1,2,NASDAQ
4553,12-02-2021 04:00,24 hrs.,pennystocks,PLUG,76,25,51,-26,3,19,26,3,NASDAQ
4553,12-02-2021 04:00,24 hrs.,pennystocks,POAI,7,0,7,-7,1,0,3,1,NASDAQ
4553,12-02-2021 04:00,24 hrs.,pennystocks,POWW,12,0,12,-12,2,1,2,2,NASDAQ
4553,12-02-2021 04:00,24 hrs.,pennystocks,PPBT,10,10,0,10,1,2,2,1,NASDAQ
4553,12-02-2021 04:00,24 hrs.,pennystocks,PRCH,6,0,6,-6,1,1,0,1,NASDAQ
4553,12-02-2021 04:00,24 hrs.,pennystocks,PRQR,22,0,22,-22,2,3,8,1,NASDAQ
4553,12-02-2021 04:00,24 hrs.,pennystocks,PSTV,12,0,12,-12,2,2,0,2,NASDAQ
4553,12-02-2021 04:00,24 hrs.,pennystocks,PULM,819,278,541,-263,4,328,147,4,NASDAQ
4553,12-02-2021 04:00,24 hrs.,pennystocks,RAVE,7,7,0,7,1,1,1,1,NASDAQ
4553,12-02-2021 04:00,24 hrs.,pennystocks,RCMT,45,0,45,-45,2,9,19,2,NASDAQ
4553,12-02-2021 04:00,24 hrs.,pennystocks,RDHL,15,0,15,-15,1,4,3,1,NASDAQ
4553,12-02-2021 04:00,24 hrs.,RobinHoodPennyStocks,PLAY,6,0,6,-6,1,1,0,1,NASDAQ
4553,12-02-2021 04:00,24 hrs.,RobinHoodPennyStocks,PLIN,297,34,263,-229,3,113,59,3,NASDAQ
4553,12-02-2021 04:00,24 hrs.,RobinHoodPennyStocks,PLRX,257,0,257,-257,1,101,51,1,NASDAQ
4553,12-02-2021 04:00,24 hrs.,RobinHoodPennyStocks,PLUG,291,34,257,-223,2,112,59,2,NASDAQ
4553,12-02-2021 04:00,24 hrs.,RobinHoodPennyStocks,EQOS,291,34,257,-223,2,112,59,2,NASDAQ
4553,12-02-2021 04:00,24 hrs.,RobinHoodPennyStocks,FCEL,291,34,257,-223,2,112,59,2,NASDAQ
4553,12-02-2021 04:00,24 hrs.,RobinHoodPennyStocks,FRHC,257,0,257,-257,1,101,51,1,NASDAQ
4553,12-02-2021 04:00,24 hrs.,RobinHoodPennyStocks,GEVO,257,0,257,-257,1,101,51,1,NASDAQ
4553,12-02-2021 04:00,24 hrs.,RobinHoodPennyStocks,GHSI,386,84,302,-218,4,149,72,4,NASDAQ
4553,12-02-2021 04:00,24 hrs.,RobinHoodPennyStocks,GLMD,201,201,0,201,1,31,135,1,NASDAQ
4553,12-02-2021 04:00,24 hrs.,RobinHoodPennyStocks,GMDA,257,0,257,-257,1,101,51,1,NASDAQ
4553,12-02-2021 04:00,24 hrs.,RobinHoodPennyStocks,GPRE,257,0,257,-257,1,101,51,1,NASDAQ
4553,12-02-2021 04:00,24 hrs.,RobinHoodPennyStocks,GRIL,34,34,0,34,1,11,8,1,NASDAQ
4553,12-02-2021 04:00,24 hrs.,RobinHoodPennyStocks,GRWG,6,0,6,-6,1,1,0,1,NASDAQ
4553,12-02-2021 04:00,24 hrs.,RobinHoodPennyStocks,HCDI,34,34,0,34,1,11,8,1,NASDAQ
4553,12-02-2021 04:00,24 hrs.,RobinHoodPennyStocks,HGSH,291,34,257,-223,2,112,59,2,NASDAQ
4553,12-02-2021 04:00,24 hrs.,RobinHoodPennyStocks,IDEX,291,34,257,-223,2,112,59,2,NASDAQ
4553,12-02-2021 04:00,24 hrs.,RobinHoodPennyStocks,IFMK,34,34,0,34,1,11,8,1,NASDAQ
4553,12-02-2021 04:00,24 hrs.,RobinHoodPennyStocks,IMNM,257,0,257,-257,1,101,51,1,NASDAQ
4553,12-02-2021 04:00,24 hrs.,RobinHoodPennyStocks,IMTE,291,34,257,-223,2,112,59,2,NASDAQ
4553,12-02-2021 04:00,24 hrs.,RobinHoodPennyStocks,INPX,25,6,19,-13,4,4,1,4,NASDAQ
4553,12-02-2021 04:00,24 hrs.,RobinHoodPennyStocks,IPDN,257,0,257,-257,1,101,51,1,NASDAQ
4553,12-02-2021 04:00,24 hrs.,RobinHoodPennyStocks,ITRM,285,6,279,-273,5,106,53,5,NASDAQ
4553,12-02-2021 04:00,24 hrs.,RobinHoodPennyStocks,IZEA,291,34,257,-223,2,112,59,2,NASDAQ
4553,12-02-2021 04:00,24 hrs.,RobinHoodPennyStocks,JFIN,291,34,257,-223,2,112,59,2,NASDAQ
4553,12-02-2021 04:00,24 hrs.,RobinHoodPennyStocks,JRJC,291,34,257,-223,2,112,59,2,NASDAQ
4553,12-02-2021 04:00,24 hrs.,RobinHoodPennyStocks,KDMN,12,0,12,-12,2,2,0,2,NASDAQ
4553,12-02-2021 04:00,24 hrs.,RobinHoodPennyStocks,KERN,257,0,257,-257,1,101,51,1,NASDAQ
4553,12-02-2021 04:00,24 hrs.,RobinHoodPennyStocks,KNDI,291,34,257,-223,2,112,59,2,NASDAQ
4553,12-02-2021 04:00,24 hrs.,RobinHoodPennyStocks,KTRA,80,6,74,-68,4,27,10,4,NASDAQ
4553,12-02-2021 04:00,24 hrs.,RobinHoodPennyStocks,KXIN,291,34,257,-223,2,112,59,2,NASDAQ
4553,12-02-2021 04:00,24 hrs.,RobinHoodPennyStocks,LEDS,34,34,0,34,1,11,8,1,NASDAQ
4553,12-02-2021 04:00,24 hrs.,RobinHoodPennyStocks,LIVE,10,10,0,10,1,0,6,1,NASDAQ
4553,12-02-2021 04:00,24 hrs.,pennystocks,SLGG,228,0,228,-228,1,88,48,1,NASDAQ
4553,12-02-2021 04:00,24 hrs.,pennystocks,SLRX,7,0,7,-7,1,1,1,1,NASDAQ
4553,12-02-2021 04:00,24 hrs.,pennystocks,SNCA,6,6,0,6,1,1,0,1,NASDAQ
4553,12-02-2021 04:00,24 hrs.,pennystocks,SNDL,368,190,178,12,52,71,18,44,NASDAQ
4553,12-02-2021 04:00,24 hrs.,pennystocks,SNGX,3511,99,3412,-3313,4,1484,527,3,NASDAQ
4553,12-02-2021 04:00,24 hrs.,pennystocks,SRGA,1633,0,1633,-1633,2,719,187,2,NASDAQ
4553,12-02-2021 04:00,24 hrs.,pennystocks,SUNW,7,0,7,-7,1,1,1,1,NASDAQ
4553,12-02-2021 04:00,24 hrs.,pennystocks,SXTC,20,13,7,6,3,2,4,2,NASDAQ
4553,12-02-2021 04:00,24 hrs.,pennystocks,TBLT,6,0,6,-6,1,1,0,1,NASDAQ
4553,12-02-2021 04:00,24 hrs.,pennystocks,TELL,34,0,34,-34,2,9,8,2,NASDAQ
4553,12-02-2021 04:00,24 hrs.,pennystocks,TLRY,66,60,6,54,3,25,4,3,NASDAQ
4553,12-02-2021 04:00,24 hrs.,pennystocks,TMDI,19,0,19,-19,1,7,1,1,NASDAQ
4553,12-02-2021 04:00,24 hrs.,pennystocks,TNXP,1610,824,786,38,21,640,246,17,NASDAQ
4553,12-02-2021 04:00,24 hrs.,pennystocks,TRCH,130,24,106,-82,5,43,24,3,NASDAQ
4553,12-02-2021 04:00,24 hrs.,pennystocks,TRIP,170,170,0,170,1,72,22,1,NASDAQ
4553,12-02-2021 04:00,24 hrs.,pennystocks,TTOO,6,0,6,-6,1,1,0,1,NASDAQ
4553,12-02-2021 04:00,24 hrs.,pennystocks,TTWO,6,6,0,6,1,1,0,1,NASDAQ
4553,12-02-2021 04:00,24 hrs.,pennystocks,TXMD,55,48,7,41,3,12,19,3,NASDAQ
4553,12-02-2021 04:00,24 hrs.,pennystocks,TYME,42,42,0,42,1,10,18,1,NASDAQ
4553,12-02-2021 04:00,24 hrs.,pennystocks,USWS,24,12,12,0,4,4,0,4,NASDAQ
4553,12-02-2021 04:00,24 hrs.,pennystocks,VRME,19,19,0,19,1,5,5,1,NASDAQ
4553,12-02-2021 04:00,24 hrs.,pennystocks,VTVT,7,7,0,7,1,1,1,1,NASDAQ
4553,12-02-2021 04:00,24 hrs.,pennystocks,WTER,26,26,0,26,1,3,16,1,NASDAQ
4553,12-02-2021 04:00,24 hrs.,pennystocks,WTRH,36,36,0,36,2,10,8,2,NASDAQ
4553,12-02-2021 04:00,24 hrs.,pennystocks,XCUR,6,0,6,-6,1,1,0,1,NASDAQ
4553,12-02-2021 04:00,24 hrs.,pennystocks,XERS,6,6,0,6,1,1,0,1,NASDAQ
4553,12-02-2021 04:00,24 hrs.,pennystocks,XNET,6,0,6,-6,1,1,0,1,NASDAQ
4553,12-02-2021 04:00,24 hrs.,pennystocks,XSPA,14,0,14,-14,2,3,0,2,NASDAQ
4553,12-02-2021 04:00,24 hrs.,pennystocks,ZSAN,1861,96,1765,-1669,11,777,263,11,NASDAQ
4553,12-02-2021 04:00,24 hrs.,pennystocks,ZYNE,43,43,0,43,1,18,3,1,NASDAQ
4553,12-02-2021 04:00,24 hrs.,pennystocks,SGAMW,47,47,0,47,1,17,9,1,NASDAQ
4553,12-02-2021 04:00,24 hrs.,wallstreetbets,AABB,6,0,6,-6,1,1,0,1,OTC
4553,12-02-2021 04:00,24 hrs.,wallstreetbets,ABML,19,13,6,7,3,3,1,3,OTC
4553,12-02-2021 04:00,24 hrs.,wallstreetbets,ABWN,6,6,0,6,1,1,0,1,OTC
4553,12-02-2021 04:00,24 hrs.,wallstreetbets,ADTM,6,6,0,6,1,1,0,1,OTC
4553,12-02-2021 04:00,24 hrs.,wallstreetbets,AEGY,6,6,0,6,1,1,0,1,OTC
4553,12-02-2021 04:00,24 hrs.,wallstreetbets,AFTM,12,12,0,12,2,2,0,1,OTC
4553,12-02-2021 04:00,24 hrs.,wallstreetbets,AGYP,6,0,6,-6,1,1,0,1,OTC
4553,12-02-2021 04:00,24 hrs.,wallstreetbets,AHFD,7,7,0,7,1,1,1,1,OTC
4553,12-02-2021 04:00,24 hrs.,wallstreetbets,AITX,63,30,33,-3,10,10,3,7,OTC
4553,12-02-2021 04:00,24 hrs.,wallstreetbets,ALKM,18,6,12,-6,3,3,0,3,OTC
4553,12-02-2021 04:00,24 hrs.,RobinHoodPennyStocks,PRTA,257,0,257,-257,1,101,51,1,NASDAQ
4553,12-02-2021 04:00,24 hrs.,RobinHoodPennyStocks,PSEC,25,19,6,13,4,4,1,3,NASDAQ
4553,12-02-2021 04:00,24 hrs.,RobinHoodPennyStocks,PSTV,6,0,6,-6,1,1,0,1,NASDAQ
4553,12-02-2021 04:00,24 hrs.,RobinHoodPennyStocks,PULM,250,192,58,134,3,95,48,3,NASDAQ
4553,12-02-2021 04:00,24 hrs.,RobinHoodPennyStocks,PXLW,6,6,0,6,1,1,0,1,NASDAQ
4553,12-02-2021 04:00,24 hrs.,RobinHoodPennyStocks,QUIK,34,34,0,34,1,11,8,1,NASDAQ
4553,12-02-2021 04:00,24 hrs.,RobinHoodPennyStocks,RAVE,34,34,0,34,1,11,8,1,NASDAQ
4553,12-02-2021 04:00,24 hrs.,RobinHoodPennyStocks,RCMT,291,34,257,-223,2,112,59,2,NASDAQ
4553,12-02-2021 04:00,24 hrs.,RobinHoodPennyStocks,RETO,6,0,6,-6,1,1,0,1,NASDAQ
4553,12-02-2021 04:00,24 hrs.,RobinHoodPennyStocks,RIGL,7,0,7,-7,1,1,1,1,NASDAQ
4553,12-02-2021 04:00,24 hrs.,RobinHoodPennyStocks,RIOT,291,34,257,-223,2,112,59,2,NASDAQ
4553,12-02-2021 04:00,24 hrs.,RobinHoodPennyStocks,RKDA,257,0,257,-257,1,101,51,1,NASDAQ
4553,12-02-2021 04:00,24 hrs.,RobinHoodPennyStocks,RNWK,257,0,257,-257,1,101,51,1,NASDAQ
4553,12-02-2021 04:00,24 hrs.,RobinHoodPennyStocks,RWLK,6,6,0,6,1,1,0,1,NASDAQ
4553,12-02-2021 04:00,24 hrs.,RobinHoodPennyStocks,SALM,291,34,257,-223,2,112,59,2,NASDAQ
4553,12-02-2021 04:00,24 hrs.,RobinHoodPennyStocks,SAVA,291,34,257,-223,2,112,59,2,NASDAQ
4553,12-02-2021 04:00,24 hrs.,pennystocks,LGHL,1619,0,1619,-1619,1,715,185,1,NASDAQ
4553,12-02-2021 04:00,24 hrs.,pennystocks,LIFE,17,0,17,-17,2,4,1,2,NASDAQ
4553,12-02-2021 04:00,24 hrs.,pennystocks,LKCO,68,62,6,56,5,22,4,4,NASDAQ
4553,12-02-2021 04:00,24 hrs.,pennystocks,LMFA,45,0,45,-45,1,15,11,1,NASDAQ
4553,12-02-2021 04:00,24 hrs.,pennystocks,LPCN,19,0,19,-19,1,7,1,1,NASDAQ
4553,12-02-2021 04:00,24 hrs.,pennystocks,MARK,25,25,0,25,1,3,15,1,NASDAQ
4553,12-02-2021 04:00,24 hrs.,pennystocks,MBRX,92,0,92,-92,1,39,10,1,NASDAQ
4553,12-02-2021 04:00,24 hrs.,wallstreetbets,CATV,12,6,6,0,2,2,0,2,OTC
4553,12-02-2021 04:00,24 hrs.,wallstreetbets,CBBT,6,0,6,-6,1,1,0,1,OTC
4553,12-02-2021 04:00,24 hrs.,wallstreetbets,CBDD,24,12,12,0,4,4,0,4,OTC
4553,12-02-2021 04:00,24 hrs.,wallstreetbets,CBDL,50,32,18,14,8,8,2,7,OTC
4553,12-02-2021 04:00,24 hrs.,wallstreetbets,CBGI,12,12,0,12,2,2,0,1,OTC
4553,12-02-2021 04:00,24 hrs.,wallstreetbets,CBTC,6,6,0,6,1,1,0,1,OTC
4553,12-02-2021 04:00,24 hrs.,wallstreetbets,CCTL,18,12,6,6,3,3,0,3,OTC
4553,12-02-2021 04:00,24 hrs.,wallstreetbets,CHGI,18,0,18,-18,3,3,0,1,OTC
4553,12-02-2021 04:00,24 hrs.,wallstreetbets,CLIS,6,6,0,6,1,1,0,1,OTC
4553,12-02-2021 04:00,24 hrs.,wallstreetbets,CLSH,20,7,13,-6,3,3,2,3,OTC
4553,12-02-2021 04:00,24 hrs.,wallstreetbets,CNBX,6,0,6,-6,1,1,0,1,OTC
4553,12-02-2021 04:00,24 hrs.,wallstreetbets,CNNA,12,0,12,-12,2,2,0,1,OTC
4553,12-02-2021 04:00,24 hrs.,wallstreetbets,CNXS,6,6,0,6,1,1,0,1,OTC
4553,12-02-2021 04:00,24 hrs.,RobinHoodPennyStocks,SBBP,257,0,257,-257,1,101,51,1,NASDAQ
4553,12-02-2021 04:00,24 hrs.,RobinHoodPennyStocks,SEED,291,34,257,-223,2,112,59,2,NASDAQ
4553,12-02-2021 04:00,24 hrs.,RobinHoodPennyStocks,SGOC,34,34,0,34,1,11,8,1,NASDAQ
4553,12-02-2021 04:00,24 hrs.,RobinHoodPennyStocks,SHIP,18,6,12,-6,3,3,0,2,NASDAQ
4553,12-02-2021 04:00,24 hrs.,RobinHoodPennyStocks,SLRX,257,0,257,-257,1,101,51,1,NASDAQ
4553,12-02-2021 04:00,24 hrs.,RobinHoodPennyStocks,SNDL,7713,1200,6513,-5313,97,2865,1595,82,NASDAQ
4553,12-02-2021 04:00,24 hrs.,RobinHoodPennyStocks,SNGX,79,73,6,67,3,33,1,3,NASDAQ
4553,12-02-2021 04:00,24 hrs.,RobinHoodPennyStocks,SONM,51,51,0,51,1,19,9,1,NASDAQ
4553,12-02-2021 04:00,24 hrs.,RobinHoodPennyStocks,SRGA,79,17,62,-45,2,29,13,2,NASDAQ
4553,12-02-2021 04:00,24 hrs.,RobinHoodPennyStocks,SUNW,291,34,257,-223,2,112,59,2,NASDAQ
4553,12-02-2021 04:00,24 hrs.,RobinHoodPennyStocks,SXTC,291,34,257,-223,2,112,59,2,NASDAQ
4553,12-02-2021 04:00,24 hrs.,RobinHoodPennyStocks,SYPR,291,34,257,-223,2,112,59,2,NASDAQ
4553,12-02-2021 04:00,24 hrs.,RobinHoodPennyStocks,SYTA,257,0,257,-257,1,101,51,1,NASDAQ
4553,12-02-2021 04:00,24 hrs.,RobinHoodPennyStocks,TAIT,34,34,0,34,1,11,8,1,NASDAQ
4553,12-02-2021 04:00,24 hrs.,RobinHoodPennyStocks,TANH,291,34,257,-223,2,112,59,2,NASDAQ
4553,12-02-2021 04:00,24 hrs.,RobinHoodPennyStocks,TAOP,291,34,257,-223,2,112,59,2,NASDAQ
4553,12-02-2021 04:00,24 hrs.,RobinHoodPennyStocks,TEDU,291,34,257,-223,2,112,59,2,NASDAQ
4553,12-02-2021 04:00,24 hrs.,RobinHoodPennyStocks,TIGR,291,34,257,-223,2,112,59,2,NASDAQ
4553,12-02-2021 04:00,24 hrs.,RobinHoodPennyStocks,TLRY,292,23,269,-246,5,109,54,4,NASDAQ
4553,12-02-2021 04:00,24 hrs.,RobinHoodPennyStocks,TLSA,257,0,257,-257,1,101,51,1,NASDAQ
4553,12-02-2021 04:00,24 hrs.,RobinHoodPennyStocks,TNXP,735,402,333,69,10,279,137,9,NASDAQ
4553,12-02-2021 04:00,24 hrs.,RobinHoodPennyStocks,TRCH,487,230,257,-27,7,170,119,6,NASDAQ
4553,12-02-2021 04:00,24 hrs.,RobinHoodPennyStocks,TRIL,6,6,0,6,1,1,0,1,NASDAQ
4553,12-02-2021 04:00,24 hrs.,RobinHoodPennyStocks,TRVN,6,0,6,-6,1,1,0,1,NASDAQ
4553,12-02-2021 04:00,24 hrs.,RobinHoodPennyStocks,TTOO,280,23,257,-234,2,108,56,2,NASDAQ
4553,12-02-2021 04:00,24 hrs.,RobinHoodPennyStocks,TXMD,496,336,160,176,12,123,202,12,NASDAQ
4553,12-02-2021 04:00,24 hrs.,RobinHoodPennyStocks,UONE,291,34,257,-223,2,112,59,2,NASDAQ
4553,12-02-2021 04:00,24 hrs.,RobinHoodPennyStocks,USEG,34,34,0,34,1,11,8,1,NASDAQ
4553,12-02-2021 04:00,24 hrs.,RobinHoodPennyStocks,USWS,12,12,0,12,2,2,0,2,NASDAQ
4553,12-02-2021 04:00,24 hrs.,RobinHoodPennyStocks,UXIN,291,34,257,-223,2,112,59,2,NASDAQ
4553,12-02-2021 04:00,24 hrs.,RobinHoodPennyStocks,VRME,257,0,257,-257,1,101,51,1,NASDAQ
4553,12-02-2021 04:00,24 hrs.,RobinHoodPennyStocks,VTVT,257,0,257,-257,1,101,51,1,NASDAQ
4553,12-02-2021 04:00,24 hrs.,RobinHoodPennyStocks,VXRT,257,0,257,-257,1,101,51,1,NASDAQ
4553,12-02-2021 04:00,24 hrs.,RobinHoodPennyStocks,VYNE,6,6,0,6,1,1,0,1,NASDAQ
4553,12-02-2021 04:00,24 hrs.,RobinHoodPennyStocks,WATT,291,34,257,-223,2,112,59,2,NASDAQ
4553,12-02-2021 04:00,24 hrs.,RobinHoodPennyStocks,WIMI,291,34,257,-223,2,112,59,2,NASDAQ
4553,12-02-2021 04:00,24 hrs.,RobinHoodPennyStocks,WKEY,34,34,0,34,1,11,8,1,NASDAQ
4553,12-02-2021 04:00,24 hrs.,RobinHoodPennyStocks,WRAP,34,34,0,34,1,11,8,1,NASDAQ
4553,12-02-2021 04:00,24 hrs.,RobinHoodPennyStocks,XCUR,65,0,65,-65,1,25,11,1,NASDAQ
4553,12-02-2021 04:00,24 hrs.,RobinHoodPennyStocks,XSPA,32,0,32,-32,1,10,8,1,NASDAQ
4553,12-02-2021 04:00,24 hrs.,RobinHoodPennyStocks,YGMZ,291,34,257,-223,2,112,59,2,NASDAQ
4553,12-02-2021 04:00,24 hrs.,RobinHoodPennyStocks,ZSAN,372,152,220,-68,8,101,138,8,NASDAQ
4553,12-02-2021 04:00,24 hrs.,RobinHoodPennyStocks,ZYNE,60,60,0,60,1,12,32,1,NASDAQ
4553,12-02-2021 04:00,24 hrs.,RobinHoodPennyStocks,UONEK,291,34,257,-223,2,112,59,2,NASDAQ
4553,12-02-2021 04:00,24 hrs.,pennystocks,REAL,70,70,0,70,2,17,28,2,NASDAQ
4553,12-02-2021 04:00,24 hrs.,pennystocks,RIDE,47,0,47,-47,1,16,11,1,NASDAQ
4553,12-02-2021 04:00,24 hrs.,pennystocks,RIGL,37,12,25,-13,3,9,7,3,NASDAQ
4553,12-02-2021 04:00,24 hrs.,pennystocks,RMTI,48,48,0,48,2,11,18,2,NASDAQ
4553,12-02-2021 04:00,24 hrs.,pennystocks,SAVA,6,0,6,-6,1,1,0,1,NASDAQ
4553,12-02-2021 04:00,24 hrs.,pennystocks,SEEL,170,170,0,170,1,72,22,1,NASDAQ
4553,12-02-2021 04:00,24 hrs.,pennystocks,SHIP,16,0,16,-16,2,3,2,2,NASDAQ
4553,12-02-2021 04:00,24 hrs.,wallstreetbets,DWOG,7,7,0,7,1,1,1,1,OTC
4553,12-02-2021 04:00,24 hrs.,wallstreetbets,ECEZ,18,12,6,6,3,3,0,3,OTC
4553,12-02-2021 04:00,24 hrs.,wallstreetbets,EDXC,18,0,18,-18,3,3,0,2,OTC
4553,12-02-2021 04:00,24 hrs.,wallstreetbets,EFLN,6,6,0,6,1,1,0,1,OTC
4553,12-02-2021 04:00,24 hrs.,wallstreetbets,ELCR,25,19,6,13,4,4,1,4,OTC
4553,12-02-2021 04:00,24 hrs.,wallstreetbets,ENDO,6,0,6,-6,1,1,0,1,OTC
4553,12-02-2021 04:00,24 hrs.,wallstreetbets,ERBB,55,6,49,-43,9,9,1,7,OTC
4553,12-02-2021 04:00,24 hrs.,wallstreetbets,ETFM,6,6,0,6,1,1,0,1,OTC
4553,12-02-2021 04:00,24 hrs.,wallstreetbets,EWLL,12,6,6,0,2,2,0,2,OTC
4553,12-02-2021 04:00,24 hrs.,wallstreetbets,FBEC,6,0,6,-6,1,1,0,1,OTC
4553,12-02-2021 04:00,24 hrs.,wallstreetbets,FBSE,8,8,0,8,1,1,2,1,OTC
4553,12-02-2021 04:00,24 hrs.,wallstreetbets,FORW,6,6,0,6,1,1,0,1,OTC
4553,12-02-2021 04:00,24 hrs.,wallstreetbets,FPVD,6,0,6,-6,1,1,0,1,OTC
4553,12-02-2021 04:00,24 hrs.,wallstreetbets,FTEG,6,0,6,-6,1,1,0,1,OTC
4553,12-02-2021 04:00,24 hrs.,wallstreetbets,FTPM,6,6,0,6,1,1,0,1,OTC
4553,12-02-2021 04:00,24 hrs.,wallstreetbets,FUTL,6,6,0,6,1,1,0,1,OTC
4553,12-02-2021 04:00,24 hrs.,wallstreetbets,GAHC,6,0,6,-6,1,1,0,1,OTC
4553,12-02-2021 04:00,24 hrs.,wallstreetbets,GARB,7,0,7,-7,1,1,1,1,OTC
4553,12-02-2021 04:00,24 hrs.,wallstreetbets,GAXY,25,18,7,11,4,4,1,4,OTC
4553,12-02-2021 04:00,24 hrs.,wallstreetbets,GBLX,6,6,0,6,1,1,0,1,OTC
4553,12-02-2021 04:00,24 hrs.,wallstreetbets,GFCI,508,508,0,508,1,191,122,1,OTC
4553,12-02-2021 04:00,24 hrs.,wallstreetbets,GMER,12,12,0,12,2,2,0,1,OTC
4553,12-02-2021 04:00,24 hrs.,wallstreetbets,GPFT,8,0,8,-8,1,1,2,1,OTC
4553,12-02-2021 04:00,24 hrs.,wallstreetbets,GRCU,6,6,0,6,1,1,0,1,OTC
4553,12-02-2021 04:00,24 hrs.,wallstreetbets,GRNH,18,6,12,-6,3,3,0,3,OTC
4553,12-02-2021 04:00,24 hrs.,wallstreetbets,GTBP,6,6,0,6,1,1,0,1,OTC
4553,12-02-2021 04:00,24 hrs.,wallstreetbets,GTEH,24,18,6,12,3,5,2,3,OTC
4553,12-02-2021 04:00,24 hrs.,wallstreetbets,GTII,456,456,0,456,1,131,190,1,OTC
4553,12-02-2021 04:00,24 hrs.,wallstreetbets,GTXO,6,6,0,6,1,1,0,1,OTC
4553,12-02-2021 04:00,24 hrs.,wallstreetbets,GYOG,18,6,12,-6,3,3,0,2,OTC
4553,12-02-2021 04:00,24 hrs.,wallstreetbets,HCMC,543,332,211,121,88,89,13,81,OTC
4553,12-02-2021 04:00,24 hrs.,wallstreetbets,HEMP,49,12,37,-25,8,8,1,7,OTC
4553,12-02-2021 04:00,24 hrs.,wallstreetbets,HESG,6,6,0,6,1,1,0,1,OTC
4553,12-02-2021 04:00,24 hrs.,wallstreetbets,HGLC,12,0,12,-12,2,2,0,1,OTC
4553,12-02-2021 04:00,24 hrs.,wallstreetbets,ALPP,12,12,0,12,2,2,0,2,OTC
4553,12-02-2021 04:00,24 hrs.,wallstreetbets,ALYI,19,13,6,7,3,3,1,3,OTC
4553,12-02-2021 04:00,24 hrs.,wallstreetbets,AMMJ,12,0,12,-12,2,2,0,2,OTC
4553,12-02-2021 04:00,24 hrs.,wallstreetbets,AMNE,6,6,0,6,1,1,0,1,OTC
4553,12-02-2021 04:00,24 hrs.,wallstreetbets,ANDD,6,6,0,6,1,1,0,1,OTC
4553,12-02-2021 04:00,24 hrs.,wallstreetbets,ANTI,13,13,0,13,2,2,1,2,OTC
4553,12-02-2021 04:00,24 hrs.,wallstreetbets,APRU,19,19,0,19,3,3,1,1,OTC
4553,12-02-2021 04:00,24 hrs.,wallstreetbets,ARST,6,0,6,-6,1,1,0,1,OTC
4553,12-02-2021 04:00,24 hrs.,wallstreetbets,ASTI,44,30,14,16,7,7,2,5,OTC
4553,12-02-2021 04:00,24 hrs.,wallstreetbets,AWGI,12,0,12,-12,2,2,0,2,OTC
4553,12-02-2021 04:00,24 hrs.,wallstreetbets,AZFL,6,0,6,-6,1,1,0,1,OTC
4553,12-02-2021 04:00,24 hrs.,wallstreetbets,BBRW,12,0,12,-12,2,2,0,2,OTC
4553,12-02-2021 04:00,24 hrs.,wallstreetbets,BCAP,24,24,0,24,4,4,0,2,OTC
4553,12-02-2021 04:00,24 hrs.,wallstreetbets,BCCI,14,14,0,14,2,2,2,1,OTC
4553,12-02-2021 04:00,24 hrs.,wallstreetbets,BFCH,19,13,6,7,3,3,1,3,OTC
4553,12-02-2021 04:00,24 hrs.,wallstreetbets,BFRE,6,6,0,6,1,1,0,1,OTC
4553,12-02-2021 04:00,24 hrs.,wallstreetbets,BIEL,24,24,0,24,4,4,0,3,OTC
4553,12-02-2021 04:00,24 hrs.,wallstreetbets,BIGG,6,6,0,6,1,1,0,1,OTC
4553,12-02-2021 04:00,24 hrs.,wallstreetbets,BLDV,18,6,12,-6,3,3,0,2,OTC
4553,12-02-2021 04:00,24 hrs.,wallstreetbets,BLPG,7,7,0,7,1,1,1,1,OTC
4553,12-02-2021 04:00,24 hrs.,wallstreetbets,BLSP,20,14,6,8,3,3,2,2,OTC
4553,12-02-2021 04:00,24 hrs.,wallstreetbets,BOTH,6,0,6,-6,1,1,0,1,OTC
4553,12-02-2021 04:00,24 hrs.,wallstreetbets,BOTY,37,37,0,37,6,6,1,5,OTC
4553,12-02-2021 04:00,24 hrs.,wallstreetbets,BRLL,18,12,6,6,3,3,0,3,OTC
4553,12-02-2021 04:00,24 hrs.,wallstreetbets,BRTX,6,6,0,6,1,1,0,1,OTC
4553,12-02-2021 04:00,24 hrs.,wallstreetbets,BTCY,6,6,0,6,1,1,0,1,OTC
4553,12-02-2021 04:00,24 hrs.,wallstreetbets,BUDZ,12,6,6,0,2,2,0,2,OTC
4553,12-02-2021 04:00,24 hrs.,wallstreetbets,CALI,6,6,0,6,1,1,0,1,OTC
4553,12-02-2021 04:00,24 hrs.,wallstreetbets,CANN,6,0,6,-6,1,1,0,1,OTC
4553,12-02-2021 04:00,24 hrs.,wallstreetbets,CAPC,6,0,6,-6,1,1,0,1,OTC
4553,12-02-2021 04:00,24 hrs.,wallstreetbets,LQWC,6,6,0,6,1,1,0,1,OTC
4553,12-02-2021 04:00,24 hrs.,wallstreetbets,LSCG,7,7,0,7,1,1,1,1,OTC
4553,12-02-2021 04:00,24 hrs.,wallstreetbets,LTUM,6,6,0,6,1,1,0,1,OTC
4553,12-02-2021 04:00,24 hrs.,wallstreetbets,LUVU,6,6,0,6,1,1,0,1,OTC
4553,12-02-2021 04:00,24 hrs.,wallstreetbets,LVVV,12,0,12,-12,2,2,0,2,OTC
4553,12-02-2021 04:00,24 hrs.,wallstreetbets,MATN,6,6,0,6,1,1,0,1,OTC
4553,12-02-2021 04:00,24 hrs.,wallstreetbets,MCOA,36,0,36,-36,6,6,0,5,OTC
4553,12-02-2021 04:00,24 hrs.,wallstreetbets,MFST,6,0,6,-6,1,1,0,1,OTC
4553,12-02-2021 04:00,24 hrs.,wallstreetbets,MGLG,6,6,0,6,1,1,0,1,OTC
4553,12-02-2021 04:00,24 hrs.,wallstreetbets,MINE,70,50,20,30,11,11,4,9,OTC
4553,12-02-2021 04:00,24 hrs.,wallstreetbets,MITI,6,6,0,6,1,1,0,1,OTC
4553,12-02-2021 04:00,24 hrs.,wallstreetbets,MJLB,6,6,0,6,1,1,0,1,OTC
4553,12-02-2021 04:00,24 hrs.,wallstreetbets,MJNA,195,38,157,-119,32,32,3,28,OTC
4553,12-02-2021 04:00,24 hrs.,wallstreetbets,MMEX,38,20,18,2,6,6,2,5,OTC
4553,12-02-2021 04:00,24 hrs.,wallstreetbets,MMMM,6,6,0,6,1,1,0,1,OTC
4553,12-02-2021 04:00,24 hrs.,wallstreetbets,MOST,30,0,30,-30,5,5,0,5,OTC
4553,12-02-2021 04:00,24 hrs.,wallstreetbets,MRMD,12,6,6,0,2,2,0,2,OTC
4553,12-02-2021 04:00,24 hrs.,wallstreetbets,MSPC,6,0,6,-6,1,1,0,1,OTC
4553,12-02-2021 04:00,24 hrs.,wallstreetbets,MSRT,6,6,0,6,1,1,0,1,OTC
4553,12-02-2021 04:00,24 hrs.,SPACs,CAGR,49,49,0,49,1,13,19,1,OTC
4553,12-02-2021 04:00,24 hrs.,SPACs,MOST,7,0,7,-7,1,1,1,1,OTC
4553,12-02-2021 04:00,24 hrs.,SPACs,SENY,5,0,5,-5,1,0,1,1,OTC
4553,12-02-2021 04:00,24 hrs.,SPACs,SBVRF,37,0,37,-37,1,10,13,1,OTC
4553,12-02-2021 04:00,24 hrs.,SPACs,BGI,29,29,0,29,1,5,15,1,AMEX
4553,12-02-2021 04:00,24 hrs.,SPACs,CIK,23,23,0,23,1,3,13,1,AMEX
4553,12-02-2021 04:00,24 hrs.,SPACs,CTO,104,104,0,104,1,37,26,1,AMEX
4553,12-02-2021 04:00,24 hrs.,SPACs,CHAQ,2191,0,2191,-2191,1,46,2095,1,AMEX
4553,12-02-2021 04:00,24 hrs.,SPACs,BFT,2198,0,2198,-2198,2,47,2096,2,NYSE
4553,12-02-2021 04:00,24 hrs.,SPACs,CCX,7,7,0,7,1,1,1,1,NYSE
4553,12-02-2021 04:00,24 hrs.,SPACs,CLA,315,0,315,-315,2,116,75,2,NYSE
4553,12-02-2021 04:00,24 hrs.,SPACs,COO,32,0,32,-32,1,9,10,1,NYSE
4553,12-02-2021 04:00,24 hrs.,SPACs,GIK,19,0,19,-19,2,2,7,2,NYSE
4553,12-02-2021 04:00,24 hrs.,SPACs,GME,178,0,178,-178,1,53,68,1,NYSE
4553,12-02-2021 04:00,24 hrs.,SPACs,HLF,178,0,178,-178,1,53,68,1,NYSE
4553,12-02-2021 04:00,24 hrs.,SPACs,IPV,2191,0,2191,-2191,1,46,2095,1,NYSE
4553,12-02-2021 04:00,24 hrs.,SPACs,MLM,178,0,178,-178,1,53,68,1,NYSE
4553,12-02-2021 04:00,24 hrs.,SPACs,NAV,367,343,24,319,4,155,41,4,NYSE
4553,12-02-2021 04:00,24 hrs.,SPACs,NGA,22,0,22,-22,2,3,8,2,NYSE
4553,12-02-2021 04:00,24 hrs.,SPACs,NSH,2191,0,2191,-2191,1,46,2095,1,NYSE
4553,12-02-2021 04:00,24 hrs.,SPACs,RMO,7,7,0,7,1,1,1,1,NYSE
4553,12-02-2021 04:00,24 hrs.,SPACs,RSI,38,38,0,38,1,11,12,1,NYSE
4553,12-02-2021 04:00,24 hrs.,SPACs,RTP,390,390,0,390,10,94,162,9,NYSE
4553,12-02-2021 04:00,24 hrs.,SPACs,SBE,2669,203,2466,-2263,12,210,2201,10,NYSE
4553,12-02-2021 04:00,24 hrs.,SPACs,WPF,6,6,0,6,1,1,0,1,NYSE
4553,12-02-2021 04:00,24 hrs.,SPACs,ACIC,2210,7,2203,-2196,3,46,2106,3,NYSE
4553,12-02-2021 04:00,24 hrs.,SPACs,ALUS,2191,0,2191,-2191,1,46,2095,1,NYSE
4553,12-02-2021 04:00,24 hrs.,SPACs,AVAN,6,0,6,-6,1,1,0,1,NYSE
4553,12-02-2021 04:00,24 hrs.,SPACs,CCAC,58,0,58,-58,3,9,28,2,NYSE
4553,12-02-2021 04:00,24 hrs.,SPACs,CCIV,3161,970,2191,-1221,13,371,2367,12,NYSE
4553,12-02-2021 04:00,24 hrs.,SPACs,CLII,31,31,0,31,2,7,9,2,NYSE
4553,12-02-2021 04:00,24 hrs.,SPACs,FAII,2198,0,2198,-2198,2,47,2096,2,NYSE
4553,12-02-2021 04:00,24 hrs.,SPACs,FGNA,2191,0,2191,-2191,1,46,2095,1,NYSE
4553,12-02-2021 04:00,24 hrs.,SPACs,FUSE,107,107,0,107,1,38,27,1,NYSE
4553,12-02-2021 04:00,24 hrs.,SPACs,HYLN,19,6,13,-7,2,2,7,2,NYSE
4553,12-02-2021 04:00,24 hrs.,wallstreetbets,CVSI,6,6,0,6,1,1,0,1,OTC
4553,12-02-2021 04:00,24 hrs.,wallstreetbets,CYBL,6,0,6,-6,1,1,0,1,OTC
4553,12-02-2021 04:00,24 hrs.,wallstreetbets,CYDY,7,7,0,7,1,1,1,1,OTC
4553,12-02-2021 04:00,24 hrs.,wallstreetbets,CYLC,6,6,0,6,1,1,0,1,OTC
4553,12-02-2021 04:00,24 hrs.,wallstreetbets,DEQI,6,0,6,-6,1,1,0,1,OTC
4553,12-02-2021 04:00,24 hrs.,wallstreetbets,DKAM,6,0,6,-6,1,1,0,1,OTC
4553,12-02-2021 04:00,24 hrs.,wallstreetbets,DPWW,6,0,6,-6,1,1,0,1,OTC
4553,12-02-2021 04:00,24 hrs.,wallstreetbets,DROP,2025,2025,0,2025,1,633,755,1,OTC
4553,12-02-2021 04:00,24 hrs.,wallstreetbets,DSGT,6,0,6,-6,1,1,0,1,OTC
4553,12-02-2021 04:00,24 hrs.,wallstreetbets,DTST,12,12,0,12,2,2,0,1,OTC
4553,12-02-2021 04:00,24 hrs.,wallstreetbets,PGIE,6,6,0,6,1,1,0,1,OTC
4553,12-02-2021 04:00,24 hrs.,wallstreetbets,PHIL,6,0,6,-6,1,1,0,1,OTC
4553,12-02-2021 04:00,24 hrs.,wallstreetbets,PHOT,36,0,36,-36,6,6,0,4,OTC
4553,12-02-2021 04:00,24 hrs.,wallstreetbets,PNPL,6,0,6,-6,1,1,0,1,OTC
4553,12-02-2021 04:00,24 hrs.,wallstreetbets,POTN,6,0,6,-6,1,1,0,1,OTC
4553,12-02-2021 04:00,24 hrs.,wallstreetbets,PPJE,6,6,0,6,1,1,0,1,OTC
4553,12-02-2021 04:00,24 hrs.,wallstreetbets,PRDL,6,6,0,6,1,1,0,1,OTC
4553,12-02-2021 04:00,24 hrs.,wallstreetbets,PRED,7,7,0,7,1,1,1,1,OTC
4553,12-02-2021 04:00,24 hrs.,wallstreetbets,PSYC,30,18,12,6,5,5,0,3,OTC
4553,12-02-2021 04:00,24 hrs.,wallstreetbets,PTOI,12,12,0,12,2,2,0,1,OTC
4553,12-02-2021 04:00,24 hrs.,wallstreetbets,PURA,48,12,36,-24,8,8,0,6,OTC
4553,12-02-2021 04:00,24 hrs.,wallstreetbets,PURE,7,7,0,7,1,1,1,1,OTC
4553,12-02-2021 04:00,24 hrs.,wallstreetbets,PVDG,6,6,0,6,1,1,0,1,OTC
4553,12-02-2021 04:00,24 hrs.,wallstreetbets,PYYX,13,6,7,-1,2,2,1,2,OTC
4553,12-02-2021 04:00,24 hrs.,wallstreetbets,PZOO,6,0,6,-6,1,1,0,1,OTC
4553,12-02-2021 04:00,24 hrs.,wallstreetbets,QEDN,6,6,0,6,1,1,0,1,OTC
4553,12-02-2021 04:00,24 hrs.,wallstreetbets,QTMM,6,6,0,6,1,1,0,1,OTC
4553,12-02-2021 04:00,24 hrs.,wallstreetbets,RBNW,6,6,0,6,1,1,0,1,OTC
4553,12-02-2021 04:00,24 hrs.,wallstreetbets,REFG,12,0,12,-12,2,2,0,1,OTC
4553,12-02-2021 04:00,24 hrs.,SPACs,IPOC,166,0,166,-166,1,67,28,1,NYSE
4553,12-02-2021 04:00,24 hrs.,SPACs,IPOD,166,0,166,-166,1,67,28,1,NYSE
4553,12-02-2021 04:00,24 hrs.,SPACs,IPOE,3007,7,3000,-2993,5,349,2289,5,NYSE
4553,12-02-2021 04:00,24 hrs.,SPACs,IPOF,166,0,166,-166,1,67,28,1,NYSE
4553,12-02-2021 04:00,24 hrs.,SPACs,LGVW,7,7,0,7,1,1,1,1,NYSE
4553,12-02-2021 04:00,24 hrs.,SPACs,SCVX,110,104,6,98,2,38,26,2,NYSE
4553,12-02-2021 04:00,24 hrs.,SPACs,SKLZ,38,38,0,38,1,11,12,1,NYSE
4553,12-02-2021 04:00,24 hrs.,SPACs,SNPR,2232,28,2204,-2176,6,51,2106,5,NYSE
4553,12-02-2021 04:00,24 hrs.,SPACs,SPCE,166,0,166,-166,1,67,28,1,NYSE
4553,12-02-2021 04:00,24 hrs.,SPACs,SPNV,22,22,0,22,1,6,6,1,NYSE
4553,12-02-2021 04:00,24 hrs.,SPACs,TWND,13,13,0,13,2,2,1,1,NYSE
4553,12-02-2021 04:00,24 hrs.,SPACs,VYGG,2191,0,2191,-2191,1,46,2095,1,NYSE
4553,12-02-2021 04:00,24 hrs.,SPACs,ADV,2191,0,2191,-2191,1,46,2095,1,NASDAQ
4553,12-02-2021 04:00,24 hrs.,SPACs,HOL,2191,0,2191,-2191,1,46,2095,1,NASDAQ
4553,12-02-2021 04:00,24 hrs.,SPACs,NPA,185,89,96,-7,7,57,43,6,NASDAQ
4553,12-02-2021 04:00,24 hrs.,SPACs,ACAC,38,38,0,38,1,11,12,1,NASDAQ
4553,12-02-2021 04:00,24 hrs.,SPACs,ACEV,2341,150,2191,-2041,7,86,2141,4,NASDAQ
4553,12-02-2021 04:00,24 hrs.,wallstreetbets,HMNY,112,20,92,-72,18,18,4,15,OTC
4553,12-02-2021 04:00,24 hrs.,wallstreetbets,HMPQ,12,12,0,12,2,2,0,2,OTC
4553,12-02-2021 04:00,24 hrs.,wallstreetbets,HPST,6,0,6,-6,1,1,0,1,OTC
4553,12-02-2021 04:00,24 hrs.,wallstreetbets,HPTY,22,0,22,-22,2,6,2,1,OTC
4553,12-02-2021 04:00,24 hrs.,wallstreetbets,HQGE,17,7,10,-3,2,3,3,2,OTC
4553,12-02-2021 04:00,24 hrs.,wallstreetbets,HYSR,12,12,0,12,2,2,0,2,OTC
4553,12-02-2021 04:00,24 hrs.,wallstreetbets,ICCT,12,0,12,-12,2,2,0,1,OTC
4553,12-02-2021 04:00,24 hrs.,wallstreetbets,IDEA,7,0,7,-7,1,1,1,1,OTC
4553,12-02-2021 04:00,24 hrs.,wallstreetbets,IGXT,6,6,0,6,1,1,0,1,OTC
4553,12-02-2021 04:00,24 hrs.,wallstreetbets,IINX,12,12,0,12,2,2,0,1,OTC
4553,12-02-2021 04:00,24 hrs.,wallstreetbets,INCT,26,20,6,14,4,4,2,3,OTC
4553,12-02-2021 04:00,24 hrs.,wallstreetbets,INKW,6,6,0,6,1,1,0,1,OTC
4553,12-02-2021 04:00,24 hrs.,wallstreetbets,INND,11,7,4,3,2,1,1,2,OTC
4553,12-02-2021 04:00,24 hrs.,wallstreetbets,INQD,6,0,6,-6,1,1,0,1,OTC
4553,12-02-2021 04:00,24 hrs.,wallstreetbets,IPKL,6,0,6,-6,1,1,0,1,OTC
4553,12-02-2021 04:00,24 hrs.,wallstreetbets,IQST,18,18,0,18,3,3,0,3,OTC
4553,12-02-2021 04:00,24 hrs.,wallstreetbets,ISWH,6,6,0,6,1,1,0,1,OTC
4553,12-02-2021 04:00,24 hrs.,wallstreetbets,JRSS,6,0,6,-6,1,1,0,1,OTC
4553,12-02-2021 04:00,24 hrs.,wallstreetbets,KALY,6,0,6,-6,1,1,0,1,OTC
4553,12-02-2021 04:00,24 hrs.,wallstreetbets,KBLB,12,12,0,12,2,2,0,2,OTC
4553,12-02-2021 04:00,24 hrs.,wallstreetbets,KGET,6,0,6,-6,1,1,0,1,OTC
4553,12-02-2021 04:00,24 hrs.,wallstreetbets,KRFG,7,7,0,7,1,1,1,1,OTC
4553,12-02-2021 04:00,24 hrs.,wallstreetbets,KYNC,7,7,0,7,1,1,1,1,OTC
4553,12-02-2021 04:00,24 hrs.,wallstreetbets,LBSR,15,15,0,15,2,3,1,2,OTC
4553,12-02-2021 04:00,24 hrs.,wallstreetbets,LBUY,6,0,6,-6,1,1,0,1,OTC
4553,12-02-2021 04:00,24 hrs.,wallstreetbets,LGIQ,6,6,0,6,1,1,0,1,OTC
4553,12-02-2021 04:00,24 hrs.,wallstreetbets,LINK,614,0,614,-614,1,239,132,1,OTC
4553,12-02-2021 04:00,24 hrs.,wallstreetbets,LQMT,18,12,6,6,3,3,0,3,OTC
4553,12-02-2021 04:00,24 hrs.,stocks,TGIFF,6,0,6,-6,1,1,0,1,OTC
4553,12-02-2021 04:00,24 hrs.,wallstreetbets,RIGH,7,7,0,7,1,1,1,1,OTC
4553,12-02-2021 04:00,24 hrs.,wallstreetbets,RITE,6,0,6,-6,1,1,0,1,OTC
4553,12-02-2021 04:00,24 hrs.,wallstreetbets,RKLC,6,0,6,-6,1,1,0,1,OTC
4553,12-02-2021 04:00,24 hrs.,wallstreetbets,RLTR,18,12,6,6,3,3,0,3,OTC
4553,12-02-2021 04:00,24 hrs.,wallstreetbets,RSHN,7,7,0,7,1,1,1,1,OTC
4553,12-02-2021 04:00,24 hrs.,wallstreetbets,RSSV,6,0,6,-6,1,1,0,1,OTC
4553,12-02-2021 04:00,24 hrs.,SPACs,ACTC,166,0,166,-166,1,67,28,1,NASDAQ
4553,12-02-2021 04:00,24 hrs.,SPACs,ANDA,49,49,0,49,1,13,19,1,NASDAQ
4553,12-02-2021 04:00,24 hrs.,SPACs,ARYA,2191,0,2191,-2191,1,46,2095,1,NASDAQ
4553,12-02-2021 04:00,24 hrs.,SPACs,BRLI,2191,0,2191,-2191,1,46,2095,1,NASDAQ
4553,12-02-2021 04:00,24 hrs.,SPACs,BTWN,40,0,40,-40,1,12,12,1,NASDAQ
4553,12-02-2021 04:00,24 hrs.,SPACs,CELH,49,49,0,49,1,13,19,1,NASDAQ
4553,12-02-2021 04:00,24 hrs.,SPACs,CFII,7,0,7,-7,1,1,1,1,NASDAQ
4553,12-02-2021 04:00,24 hrs.,SPACs,CLVR,8,0,8,-8,1,0,4,1,NASDAQ
4553,12-02-2021 04:00,24 hrs.,SPACs,CMLF,2191,0,2191,-2191,1,46,2095,1,NASDAQ
4553,12-02-2021 04:00,24 hrs.,SPACs,CONX,46,0,46,-46,1,9,24,1,NASDAQ
4553,12-02-2021 04:00,24 hrs.,SPACs,DCRB,7,0,7,-7,1,1,1,1,NASDAQ
4553,12-02-2021 04:00,24 hrs.,SPACs,EDIT,178,0,178,-178,1,53,68,1,NASDAQ
4553,12-02-2021 04:00,24 hrs.,SPACs,FSRV,2191,0,2191,-2191,1,46,2095,1,NASDAQ
4553,12-02-2021 04:00,24 hrs.,SPACs,FTOC,246,238,8,230,3,93,48,3,NASDAQ
4553,12-02-2021 04:00,24 hrs.,SPACs,GOEV,21,0,21,-21,2,2,9,2,NASDAQ
4553,12-02-2021 04:00,24 hrs.,SPACs,GRNV,2191,0,2191,-2191,1,46,2095,1,NASDAQ
4553,12-02-2021 04:00,24 hrs.,SPACs,JYAC,233,233,0,233,1,111,7,1,NASDAQ
4553,12-02-2021 04:00,24 hrs.,SPACs,NBAC,20,0,20,-20,1,6,4,1,NASDAQ
4553,12-02-2021 04:00,24 hrs.,SPACs,NGAC,377,377,0,377,3,166,33,3,NASDAQ
4553,12-02-2021 04:00,24 hrs.,SPACs,QELL,81,81,0,81,2,10,53,2,NASDAQ
4553,12-02-2021 04:00,24 hrs.,SPACs,RACA,2191,0,2191,-2191,1,46,2095,1,NASDAQ
4553,12-02-2021 04:00,24 hrs.,SPACs,REAL,178,0,178,-178,1,53,68,1,NASDAQ
4553,12-02-2021 04:00,24 hrs.,SPACs,SGAM,112,0,112,-112,3,39,22,2,NASDAQ
4553,12-02-2021 04:00,24 hrs.,SPACs,SRAC,17,0,17,-17,1,5,3,1,NASDAQ
4553,12-02-2021 04:00,24 hrs.,SPACs,SSPK,42,0,42,-42,2,5,24,1,NASDAQ
4553,12-02-2021 04:00,24 hrs.,SPACs,STWO,6,0,6,-6,1,1,0,1,NASDAQ
4553,12-02-2021 04:00,24 hrs.,SPACs,THBR,2191,0,2191,-2191,1,46,2095,1,NASDAQ
4553,12-02-2021 04:00,24 hrs.,SPACs,THCB,2221,15,2206,-2191,5,50,2101,5,NASDAQ
4553,12-02-2021 04:00,24 hrs.,SPACs,TLRY,14,14,0,14,1,0,10,1,NASDAQ
4553,12-02-2021 04:00,24 hrs.,SPACs,TSIA,166,0,166,-166,1,67,28,1,NASDAQ
4553,12-02-2021 04:00,24 hrs.,SPACs,TTCF,49,49,0,49,1,13,19,1,NASDAQ
4553,12-02-2021 04:00,24 hrs.,SPACs,UNIT,23,23,0,23,1,3,13,1,NASDAQ
4553,12-02-2021 04:00,24 hrs.,SPACs,VMAC,7,7,0,7,1,1,1,1,NASDAQ
4553,12-02-2021 04:00,24 hrs.,SPACs,VSPR,12,12,0,12,1,3,2,1,NASDAQ
4553,12-02-2021 04:00,24 hrs.,SPACs,ACEVW,2191,0,2191,-2191,1,46,2095,1,NASDAQ
4553,12-02-2021 04:00,24 hrs.,SPACs,DSACW,2191,0,2191,-2191,1,46,2095,1,NASDAQ
4553,12-02-2021 04:00,24 hrs.,wallstreetbets,MTVX,9,9,0,9,1,2,1,1,OTC
4553,12-02-2021 04:00,24 hrs.,wallstreetbets,MYDX,12,0,12,-12,2,2,0,2,OTC
4553,12-02-2021 04:00,24 hrs.,wallstreetbets,NPHC,6,6,0,6,1,1,0,1,OTC
4553,12-02-2021 04:00,24 hrs.,wallstreetbets,NPTX,14,14,0,14,2,2,2,1,OTC
4553,12-02-2021 04:00,24 hrs.,wallstreetbets,NSPX,18,6,12,-6,3,3,0,2,OTC
4553,12-02-2021 04:00,24 hrs.,wallstreetbets,NTRR,6,0,6,-6,1,1,0,1,OTC
4553,12-02-2021 04:00,24 hrs.,wallstreetbets,NUGS,13,0,13,-13,1,4,1,1,OTC
4553,12-02-2021 04:00,24 hrs.,wallstreetbets,NUKK,12,6,6,0,2,2,0,2,OTC
4553,12-02-2021 04:00,24 hrs.,wallstreetbets,NWPN,19,19,0,19,3,3,1,2,OTC
4553,12-02-2021 04:00,24 hrs.,wallstreetbets,ODYY,12,0,12,-12,2,2,0,1,OTC
4553,12-02-2021 04:00,24 hrs.,wallstreetbets,OGNG,6,0,6,-6,1,1,0,1,OTC
4553,12-02-2021 04:00,24 hrs.,wallstreetbets,ONPH,6,0,6,-6,1,1,0,1,OTC
4553,12-02-2021 04:00,24 hrs.,wallstreetbets,OPMZ,6,0,6,-6,1,1,0,1,OTC
4553,12-02-2021 04:00,24 hrs.,wallstreetbets,OWCP,37,0,37,-37,6,6,1,2,OTC
4553,12-02-2021 04:00,24 hrs.,wallstreetbets,OZSC,12,6,6,0,2,2,0,2,OTC
4553,12-02-2021 04:00,24 hrs.,wallstreetbets,PAOG,12,12,0,12,2,2,0,2,OTC
4553,12-02-2021 04:00,24 hrs.,wallstreetbets,PAPA,12,6,6,0,2,2,0,2,OTC
4553,12-02-2021 04:00,24 hrs.,wallstreetbets,PASO,6,6,0,6,1,1,0,1,OTC
4553,12-02-2021 04:00,24 hrs.,wallstreetbets,PDMI,7,7,0,7,1,1,1,1,OTC
4553,12-02-2021 04:00,24 hrs.,wallstreetbets,PERL,6,6,0,6,1,1,0,1,OTC
4553,12-02-2021 04:00,24 hrs.,wallstreetbets,PFNO,6,6,0,6,1,1,0,1,OTC
4553,12-02-2021 04:00,24 hrs.,wallstreetbets,ALABF,6,0,6,-6,1,1,0,1,OTC
4553,12-02-2021 04:00,24 hrs.,wallstreetbets,ALEAF,37,0,37,-37,6,6,1,2,OTC
4553,12-02-2021 04:00,24 hrs.,wallstreetbets,ARBKF,7,7,0,7,1,1,1,1,OTC
4553,12-02-2021 04:00,24 hrs.,wallstreetbets,AYRWF,6,6,0,6,1,1,0,1,OTC
4553,12-02-2021 04:00,24 hrs.,wallstreetbets,AYTUW,6,0,6,-6,1,1,0,1,OTC
4553,12-02-2021 04:00,24 hrs.,wallstreetbets,AYTUZ,6,0,6,-6,1,1,0,1,OTC
4553,12-02-2021 04:00,24 hrs.,wallstreetbets,BBKCF,7,0,7,-7,1,1,1,1,OTC
4553,12-02-2021 04:00,24 hrs.,SPACs,ESSCW,2191,0,2191,-2191,1,46,2095,1,NASDAQ
4553,12-02-2021 04:00,24 hrs.,SPACs,GRNVW,2191,0,2191,-2191,1,46,2095,1,NASDAQ
4553,12-02-2021 04:00,24 hrs.,SPACs,JCICU,42,0,42,-42,1,11,16,1,NASDAQ
4553,12-02-2021 04:00,24 hrs.,SPACs,LACQW,2191,0,2191,-2191,1,46,2095,1,NASDAQ
4553,12-02-2021 04:00,24 hrs.,SPACs,VACQW,2191,0,2191,-2191,1,46,2095,1,NASDAQ
4553,12-02-2021 04:00,24 hrs.,SPACs,VSPRW,2191,0,2191,-2191,1,46,2095,1,NASDAQ
4553,12-02-2021 04:00,24 hrs.,stocks,AITX,6,6,0,6,1,1,0,1,OTC
4553,12-02-2021 04:00,24 hrs.,stocks,ALPP,6,6,0,6,1,1,0,1,OTC
4553,12-02-2021 04:00,24 hrs.,stocks,BIEL,6,6,0,6,1,1,0,1,OTC
4553,12-02-2021 04:00,24 hrs.,stocks,BUDZ,7,0,7,-7,1,1,1,1,OTC
4553,12-02-2021 04:00,24 hrs.,stocks,CAGR,20,20,0,20,1,2,12,1,OTC
4553,12-02-2021 04:00,24 hrs.,stocks,CBDD,6,0,6,-6,1,1,0,1,OTC
4553,12-02-2021 04:00,24 hrs.,stocks,CORG,6,6,0,6,1,1,0,1,OTC
4553,12-02-2021 04:00,24 hrs.,stocks,CYPW,12,0,12,-12,2,2,0,1,OTC
4553,12-02-2021 04:00,24 hrs.,stocks,ERBB,32,0,32,-32,1,10,8,1,OTC
4553,12-02-2021 04:00,24 hrs.,stocks,GRNH,32,0,32,-32,1,10,8,1,OTC
4553,12-02-2021 04:00,24 hrs.,stocks,HCMC,78,58,20,38,7,18,14,6,OTC
4553,12-02-2021 04:00,24 hrs.,stocks,HEMP,32,0,32,-32,1,10,8,1,OTC
4553,12-02-2021 04:00,24 hrs.,stocks,KGKG,6,6,0,6,1,1,0,1,OTC
4553,12-02-2021 04:00,24 hrs.,stocks,KYNC,18,18,0,18,3,3,0,1,OTC
4553,12-02-2021 04:00,24 hrs.,stocks,LINK,104,0,104,-104,1,44,12,1,OTC
4553,12-02-2021 04:00,24 hrs.,stocks,MCOA,6,0,6,-6,1,1,0,1,OTC
4553,12-02-2021 04:00,24 hrs.,stocks,MJNA,50,6,44,-38,4,13,8,4,OTC
4553,12-02-2021 04:00,24 hrs.,stocks,MOST,7,0,7,-7,1,1,1,1,OTC
4553,12-02-2021 04:00,24 hrs.,stocks,NTRR,6,0,6,-6,1,1,0,1,OTC
4553,12-02-2021 04:00,24 hrs.,stocks,NTWN,18,0,18,-18,1,7,0,1,OTC
4553,12-02-2021 04:00,24 hrs.,stocks,OPTI,6,0,6,-6,1,1,0,1,OTC
4553,12-02-2021 04:00,24 hrs.,stocks,PURA,6,6,0,6,1,1,0,1,OTC
4553,12-02-2021 04:00,24 hrs.,stocks,SGMD,42,36,6,30,7,7,0,3,OTC
4553,12-02-2021 04:00,24 hrs.,stocks,SUIC,6,6,0,6,1,1,0,1,OTC
4553,12-02-2021 04:00,24 hrs.,stocks,TSTS,6,6,0,6,1,1,0,1,OTC
4553,12-02-2021 04:00,24 hrs.,stocks,TXMC,6,0,6,-6,1,1,0,1,OTC
4553,12-02-2021 04:00,24 hrs.,stocks,TZPC,7,0,7,-7,1,1,1,1,OTC
4553,12-02-2021 04:00,24 hrs.,stocks,USMJ,6,0,6,-6,1,1,0,1,OTC
4553,12-02-2021 04:00,24 hrs.,stocks,USPS,68,56,12,44,3,23,10,2,OTC
4553,12-02-2021 04:00,24 hrs.,stocks,UVSE,12,0,12,-12,2,2,0,1,OTC
4553,12-02-2021 04:00,24 hrs.,stocks,VAPE,32,0,32,-32,1,10,8,1,OTC
4553,12-02-2021 04:00,24 hrs.,stocks,ZAAG,6,6,0,6,1,1,0,1,OTC
4553,12-02-2021 04:00,24 hrs.,stocks,BDRBF,6,0,6,-6,1,1,0,1,OTC
4553,12-02-2021 04:00,24 hrs.,stocks,CBWTF,12,12,0,12,2,2,0,2,OTC
4553,12-02-2021 04:00,24 hrs.,stocks,CURLF,12,0,12,-12,2,2,0,1,OTC
4553,12-02-2021 04:00,24 hrs.,stocks,FLWPF,6,6,0,6,1,1,0,1,OTC
4553,12-02-2021 04:00,24 hrs.,stocks,GGTTF,6,6,0,6,1,1,0,1,OTC
4553,12-02-2021 04:00,24 hrs.,stocks,GLDFF,6,0,6,-6,1,1,0,1,OTC
4553,12-02-2021 04:00,24 hrs.,stocks,GNZUF,28,0,28,-28,1,10,4,1,OTC
4553,12-02-2021 04:00,24 hrs.,stocks,GRUSF,6,0,6,-6,1,1,0,1,OTC
4553,12-02-2021 04:00,24 hrs.,stocks,HITIF,6,6,0,6,1,1,0,1,OTC
4553,12-02-2021 04:00,24 hrs.,stocks,ITHUF,6,0,6,-6,1,1,0,1,OTC
4553,12-02-2021 04:00,24 hrs.,stocks,KONAQ,12,0,12,-12,2,2,0,1,OTC
4553,12-02-2021 04:00,24 hrs.,stocks,LGORF,6,0,6,-6,1,1,0,1,OTC
4553,12-02-2021 04:00,24 hrs.,stocks,MMNFF,12,12,0,12,2,2,0,1,OTC
4553,12-02-2021 04:00,24 hrs.,stocks,NMGRF,6,0,6,-6,1,1,0,1,OTC
4553,12-02-2021 04:00,24 hrs.,stocks,NXGWF,8,0,8,-8,1,2,0,1,OTC
4553,12-02-2021 04:00,24 hrs.,stocks,PLNHF,69,0,69,-69,2,26,9,1,OTC
4553,12-02-2021 04:00,24 hrs.,stocks,RNECY,6,6,0,6,1,1,0,1,OTC
4553,12-02-2021 04:00,24 hrs.,stocks,SFTBY,22,22,0,22,1,7,4,1,OTC
4553,12-02-2021 04:00,24 hrs.,stocks,TAKOF,13,0,13,-13,1,3,3,1,OTC
4553,12-02-2021 04:00,24 hrs.,wallstreetbets,CHOOF,6,0,6,-6,1,1,0,1,OTC
4553,12-02-2021 04:00,24 hrs.,wallstreetbets,CNABQ,12,0,12,-12,2,2,0,2,OTC
4553,12-02-2021 04:00,24 hrs.,wallstreetbets,CNTTQ,18,6,12,-6,3,3,0,3,OTC
4553,12-02-2021 04:00,24 hrs.,wallstreetbets,CPXGF,6,6,0,6,1,1,0,1,OTC
4553,12-02-2021 04:00,24 hrs.,wallstreetbets,CRLBF,29288,7,29281,-29274,4,13086,3100,4,OTC
4553,12-02-2021 04:00,24 hrs.,wallstreetbets,CURLF,29914,639,29275,-28636,4,13286,3326,4,OTC
4553,12-02-2021 04:00,24 hrs.,wallstreetbets,CXXIF,121,0,121,-121,1,25,67,1,OTC
4553,12-02-2021 04:00,24 hrs.,wallstreetbets,RTON,26,20,6,14,4,4,2,4,OTC
4553,12-02-2021 04:00,24 hrs.,wallstreetbets,RWMI,6,0,6,-6,1,1,0,1,OTC
4553,12-02-2021 04:00,24 hrs.,wallstreetbets,SANP,18,12,6,6,3,3,0,3,OTC
4553,12-02-2021 04:00,24 hrs.,wallstreetbets,SCNA,20,14,6,8,3,4,0,3,OTC
4553,12-02-2021 04:00,24 hrs.,wallstreetbets,SFOR,14,14,0,14,2,2,2,1,OTC
4553,12-02-2021 04:00,24 hrs.,wallstreetbets,SGLN,6,6,0,6,1,1,0,1,OTC
4553,12-02-2021 04:00,24 hrs.,wallstreetbets,SGMD,103,43,60,-17,17,17,1,13,OTC
4553,12-02-2021 04:00,24 hrs.,wallstreetbets,SHMP,18,6,12,-6,3,3,0,2,OTC
4553,12-02-2021 04:00,24 hrs.,wallstreetbets,SHRG,6,6,0,6,1,1,0,1,OTC
4553,12-02-2021 04:00,24 hrs.,wallstreetbets,SHWZ,6,6,0,6,1,1,0,1,OTC
4553,12-02-2021 04:00,24 hrs.,wallstreetbets,SIGN,19,13,6,7,3,3,1,3,OTC
4553,12-02-2021 04:00,24 hrs.,wallstreetbets,SING,25,19,6,13,4,4,1,4,OTC
4553,12-02-2021 04:00,24 hrs.,wallstreetbets,SIRC,12,0,12,-12,2,2,0,2,OTC
4553,12-02-2021 04:00,24 hrs.,wallstreetbets,SMVI,12,12,0,12,2,2,0,1,OTC
4553,12-02-2021 04:00,24 hrs.,wallstreetbets,SNDD,6,0,6,-6,1,1,0,1,OTC
4553,12-02-2021 04:00,24 hrs.,wallstreetbets,SNPW,6,6,0,6,1,1,0,1,OTC
4553,12-02-2021 04:00,24 hrs.,wallstreetbets,SNRY,6,6,0,6,1,1,0,1,OTC
4553,12-02-2021 04:00,24 hrs.,wallstreetbets,SRMX,67,61,6,55,11,11,1,9,OTC
4553,12-02-2021 04:00,24 hrs.,wallstreetbets,SRUP,30,18,12,6,5,5,0,2,OTC
4553,12-02-2021 04:00,24 hrs.,wallstreetbets,SSOK,6,0,6,-6,1,1,0,1,OTC
4553,12-02-2021 04:00,24 hrs.,wallstreetbets,STWC,6,0,6,-6,1,1,0,1,OTC
4553,12-02-2021 04:00,24 hrs.,wallstreetbets,SUGR,8,0,8,-8,1,2,0,1,OTC
4553,12-02-2021 04:00,24 hrs.,wallstreetbets,SUIC,6,0,6,-6,1,1,0,1,OTC
4553,12-02-2021 04:00,24 hrs.,wallstreetbets,SUND,6,6,0,6,1,1,0,1,OTC
4553,12-02-2021 04:00,24 hrs.,wallstreetbets,SVTE,6,6,0,6,1,1,0,1,OTC
4553,12-02-2021 04:00,24 hrs.,wallstreetbets,TGGI,6,6,0,6,1,1,0,1,OTC
4553,12-02-2021 04:00,24 hrs.,wallstreetbets,TIDE,6,0,6,-6,1,1,0,1,OTC
4553,12-02-2021 04:00,24 hrs.,wallstreetbets,TMRC,6,0,6,-6,1,1,0,1,OTC
4553,12-02-2021 04:00,24 hrs.,wallstreetbets,TPTW,6,0,6,-6,1,1,0,1,OTC
4553,12-02-2021 04:00,24 hrs.,wallstreetbets,TRNX,13,13,0,13,2,2,1,2,OTC
4553,12-02-2021 04:00,24 hrs.,wallstreetbets,TRTC,24,6,18,-12,4,4,0,4,OTC
4553,12-02-2021 04:00,24 hrs.,wallstreetbets,TSNP,48,24,24,0,8,8,0,8,OTC
4553,12-02-2021 04:00,24 hrs.,wallstreetbets,TSTS,6,0,6,-6,1,1,0,1,OTC
4553,12-02-2021 04:00,24 hrs.,wallstreetbets,UATG,12,0,12,-12,2,2,0,1,OTC
4553,12-02-2021 04:00,24 hrs.,wallstreetbets,UNVC,12,6,6,0,2,2,0,2,OTC
4553,12-02-2021 04:00,24 hrs.,wallstreetbets,UOMO,6,6,0,6,1,1,0,1,OTC
4553,12-02-2021 04:00,24 hrs.,wallstreetbets,USMJ,24,12,12,0,4,4,0,4,OTC
4553,12-02-2021 04:00,24 hrs.,wallstreetbets,USPS,584,86,498,-412,4,221,126,3,OTC
4553,12-02-2021 04:00,24 hrs.,wallstreetbets,UVSE,18,12,6,6,3,3,0,3,OTC
4553,12-02-2021 04:00,24 hrs.,wallstreetbets,VBIO,6,6,0,6,1,1,0,1,OTC
4553,12-02-2021 04:00,24 hrs.,wallstreetbets,VIBI,12,0,12,-12,2,2,0,2,OTC
4553,12-02-2021 04:00,24 hrs.,wallstreetbets,VPER,6,0,6,-6,1,1,0,1,OTC
4553,12-02-2021 04:00,24 hrs.,wallstreetbets,VPOR,12,6,6,0,2,2,0,2,OTC
4553,12-02-2021 04:00,24 hrs.,wallstreetbets,VTLR,6,6,0,6,1,1,0,1,OTC
4553,12-02-2021 04:00,24 hrs.,wallstreetbets,VYST,6,6,0,6,1,1,0,1,OTC
4553,12-02-2021 04:00,24 hrs.,wallstreetbets,WARM,18,18,0,18,3,3,0,1,OTC
4553,12-02-2021 04:00,24 hrs.,wallstreetbets,WCVC,6,0,6,-6,1,1,0,1,OTC
4553,12-02-2021 04:00,24 hrs.,wallstreetbets,WDHR,6,0,6,-6,1,1,0,1,OTC
4553,12-02-2021 04:00,24 hrs.,wallstreetbets,WDLF,6,0,6,-6,1,1,0,1,OTC
4553,12-02-2021 04:00,24 hrs.,wallstreetbets,WHEN,42,6,36,-30,7,7,0,3,OTC
4553,12-02-2021 04:00,24 hrs.,wallstreetbets,WNDW,6,6,0,6,1,1,0,1,OTC
4553,12-02-2021 04:00,24 hrs.,wallstreetbets,WSGF,12,0,12,-12,2,2,0,1,OTC
4553,12-02-2021 04:00,24 hrs.,wallstreetbets,YAYO,12,0,12,-12,2,2,0,2,OTC
4553,12-02-2021 04:00,24 hrs.,wallstreetbets,ZNOG,12,6,6,0,2,2,0,2,OTC
4553,12-02-2021 04:00,24 hrs.,wallstreetbets,ABEPF,25,6,19,-13,4,4,1,4,OTC
4553,12-02-2021 04:00,24 hrs.,wallstreetbets,ACUIF,6,0,6,-6,1,1,0,1,OTC
4553,12-02-2021 04:00,24 hrs.,wallstreetbets,AGFAF,6,0,6,-6,1,1,0,1,OTC
4553,12-02-2021 04:00,24 hrs.,stocks,WYY,6,6,0,6,1,1,0,1,AMEX
4553,12-02-2021 04:00,24 hrs.,stocks,ZOM,19,19,0,19,3,3,1,3,AMEX
4553,12-02-2021 04:00,24 hrs.,stocks,GSAT,6,0,6,-6,1,1,0,1,AMEX
4553,12-02-2021 04:00,24 hrs.,stocks,NSPR,12,0,12,-12,2,2,0,2,AMEX
4553,12-02-2021 04:00,24 hrs.,stocks,SENS,6,0,6,-6,1,1,0,1,AMEX
4553,12-02-2021 04:00,24 hrs.,stocks,TRXC,6,0,6,-6,1,1,0,1,AMEX
4553,12-02-2021 04:00,24 hrs.,stocks,UAVS,6,6,0,6,1,1,0,1,AMEX
4553,12-02-2021 04:00,24 hrs.,stocks,ACB,48,42,6,36,2,11,18,2,NYSE
4553,12-02-2021 04:00,24 hrs.,stocks,AHT,7,7,0,7,1,1,1,1,NYSE
4553,12-02-2021 04:00,24 hrs.,stocks,AMC,115,72,43,29,11,23,25,9,NYSE
4553,12-02-2021 04:00,24 hrs.,stocks,ASX,12,6,6,0,2,2,0,2,NYSE
4553,12-02-2021 04:00,24 hrs.,stocks,ATH,14,14,0,14,1,3,4,1,NYSE
4553,12-02-2021 04:00,24 hrs.,stocks,AUY,6,6,0,6,1,1,0,1,NYSE
4553,12-02-2021 04:00,24 hrs.,stocks,BBD,6,0,6,-6,1,1,0,1,NYSE
4553,12-02-2021 04:00,24 hrs.,stocks,BBY,56,56,0,56,1,15,22,1,NYSE
4553,12-02-2021 04:00,24 hrs.,stocks,BLK,8,8,0,8,1,1,2,1,NYSE
4553,12-02-2021 04:00,24 hrs.,stocks,BNY,8,8,0,8,1,1,2,1,NYSE
4553,12-02-2021 04:00,24 hrs.,stocks,BTT,6,6,0,6,1,1,0,1,NYSE
4553,12-02-2021 04:00,24 hrs.,stocks,BUD,6,0,6,-6,1,1,0,1,NYSE
4553,12-02-2021 04:00,24 hrs.,stocks,BYD,13,0,13,-13,1,4,1,1,NYSE
4553,12-02-2021 04:00,24 hrs.,stocks,CCL,6,0,6,-6,1,1,0,1,NYSE
4553,12-02-2021 04:00,24 hrs.,stocks,CIA,382,382,0,382,1,168,42,1,NYSE
4553,12-02-2021 04:00,24 hrs.,stocks,CRM,506,0,506,-506,1,200,102,1,NYSE
4553,12-02-2021 04:00,24 hrs.,stocks,CVS,106,0,106,-106,1,34,34,1,NYSE
4553,12-02-2021 04:00,24 hrs.,stocks,DCF,506,0,506,-506,1,200,102,1,NYSE
4553,12-02-2021 04:00,24 hrs.,stocks,DDD,34,34,0,34,1,7,16,1,NYSE
4553,12-02-2021 04:00,24 hrs.,stocks,DIS,10962,10962,0,10962,2,5014,926,2,NYSE
4553,12-02-2021 04:00,24 hrs.,stocks,DTE,23,23,0,23,1,2,15,1,NYSE
4553,12-02-2021 04:00,24 hrs.,stocks,ENB,14,14,0,14,1,1,8,1,NYSE
4553,12-02-2021 04:00,24 hrs.,stocks,EOS,12,12,0,12,2,2,0,1,NYSE
4553,12-02-2021 04:00,24 hrs.,stocks,FAF,14,14,0,14,1,3,4,1,NYSE
4553,12-02-2021 04:00,24 hrs.,stocks,FCX,6,6,0,6,1,1,0,1,NYSE
4553,12-02-2021 04:00,24 hrs.,stocks,FLT,12,0,12,-12,1,3,2,1,NYSE
4553,12-02-2021 04:00,24 hrs.,stocks,FSR,10,10,0,10,1,3,0,1,NYSE
4553,12-02-2021 04:00,24 hrs.,stocks,GME,13630,13598,32,13566,20,6079,1392,17,NYSE
4553,12-02-2021 04:00,24 hrs.,stocks,HRL,104,0,104,-104,1,44,12,1,NYSE
4553,12-02-2021 04:00,24 hrs.,stocks,IBM,382,382,0,382,1,168,42,1,NYSE
4553,12-02-2021 04:00,24 hrs.,stocks,ICE,7,0,7,-7,1,1,1,1,NYSE
4553,12-02-2021 04:00,24 hrs.,stocks,IVR,6,6,0,6,1,1,0,1,NYSE
4553,12-02-2021 04:00,24 hrs.,stocks,JNJ,10951,10951,0,10951,2,5003,937,2,NYSE
4553,12-02-2021 04:00,24 hrs.,stocks,JPM,8,8,0,8,1,1,2,1,NYSE
4553,12-02-2021 04:00,24 hrs.,stocks,KNL,23,23,0,23,1,7,5,1,NYSE
4553,12-02-2021 04:00,24 hrs.,stocks,LMT,7,0,7,-7,1,1,1,1,NYSE
4553,12-02-2021 04:00,24 hrs.,stocks,MGM,19,19,0,19,1,4,7,1,NYSE
4553,12-02-2021 04:00,24 hrs.,stocks,MRK,104,0,104,-104,1,44,12,1,NYSE
4553,12-02-2021 04:00,24 hrs.,stocks,NAT,28,28,0,28,1,7,10,1,NYSE
4553,12-02-2021 04:00,24 hrs.,stocks,NAV,66,0,66,-66,1,27,8,1,NYSE
4553,12-02-2021 04:00,24 hrs.,stocks,NEE,106,0,106,-106,1,34,34,1,NYSE
4553,12-02-2021 04:00,24 hrs.,stocks,NET,269,269,0,269,1,97,71,1,NYSE
4553,12-02-2021 04:00,24 hrs.,stocks,NIO,46,33,13,20,3,5,24,3,NYSE
4553,12-02-2021 04:00,24 hrs.,stocks,NKE,10918,10918,0,10918,1,5000,914,1,NYSE
4553,12-02-2021 04:00,24 hrs.,stocks,NOK,9,9,0,9,1,2,1,1,NYSE
4553,12-02-2021 04:00,24 hrs.,stocks,NSA,382,382,0,382,1,168,42,1,NYSE
4553,12-02-2021 04:00,24 hrs.,stocks,NVS,18,18,0,18,3,3,0,1,NYSE
4553,12-02-2021 04:00,24 hrs.,stocks,PBI,21,0,21,-21,1,7,3,1,NYSE
4553,12-02-2021 04:00,24 hrs.,wallstreetbets,BDRBF,86,64,22,42,10,11,24,10,OTC
4553,12-02-2021 04:00,24 hrs.,wallstreetbets,BHNGF,12,0,12,-12,2,2,0,1,OTC
4553,12-02-2021 04:00,24 hrs.,wallstreetbets,BILZF,24,12,12,0,4,4,0,3,OTC
4553,12-02-2021 04:00,24 hrs.,wallstreetbets,BITCF,6,6,0,6,1,1,0,1,OTC
4553,12-02-2021 04:00,24 hrs.,wallstreetbets,BLOZF,6,6,0,6,1,1,0,1,OTC
4553,12-02-2021 04:00,24 hrs.,wallstreetbets,BUSXF,6,6,0,6,1,1,0,1,OTC
4553,12-02-2021 04:00,24 hrs.,wallstreetbets,BVNNF,7,7,0,7,1,1,1,1,OTC
4553,12-02-2021 04:00,24 hrs.,wallstreetbets,CBWTF,32,22,10,12,6,4,0,6,OTC
4553,12-02-2021 04:00,24 hrs.,wallstreetbets,CCHWF,6,0,6,-6,1,1,0,1,OTC
4553,12-02-2021 04:00,24 hrs.,stocks,SWN,12,0,12,-12,2,2,0,1,NYSE
4553,12-02-2021 04:00,24 hrs.,stocks,TAP,104,0,104,-104,1,44,12,1,NYSE
4553,12-02-2021 04:00,24 hrs.,stocks,TDA,7,7,0,7,1,1,1,1,NYSE
4553,12-02-2021 04:00,24 hrs.,stocks,TME,6,0,6,-6,1,1,0,1,NYSE
4553,12-02-2021 04:00,24 hrs.,stocks,TMO,7,7,0,7,1,1,1,1,NYSE
4553,12-02-2021 04:00,24 hrs.,stocks,TPX,104,0,104,-104,1,44,12,1,NYSE
4553,12-02-2021 04:00,24 hrs.,stocks,TSM,40,40,0,40,1,5,26,1,NYSE
4553,12-02-2021 04:00,24 hrs.,stocks,UMC,6,6,0,6,1,1,0,1,NYSE
4553,12-02-2021 04:00,24 hrs.,stocks,UPS,56,56,0,56,1,21,10,1,NYSE
4553,12-02-2021 04:00,24 hrs.,stocks,WMT,11079,10958,121,10837,5,5041,977,5,NYSE
4553,12-02-2021 04:00,24 hrs.,stocks,XPO,104,0,104,-104,1,44,12,1,NYSE
4553,12-02-2021 04:00,24 hrs.,stocks,ALSN,23,23,0,23,1,7,5,1,NYSE
4553,12-02-2021 04:00,24 hrs.,stocks,AQUA,7,7,0,7,1,1,1,1,NYSE
4553,12-02-2021 04:00,24 hrs.,stocks,BABA,57,57,0,57,3,9,27,3,NYSE
4553,12-02-2021 04:00,24 hrs.,stocks,BORR,6,0,6,-6,1,1,0,1,NYSE
4553,12-02-2021 04:00,24 hrs.,stocks,CACI,382,382,0,382,1,168,42,1,NYSE
4553,12-02-2021 04:00,24 hrs.,stocks,CCIV,24,12,12,0,4,4,0,4,NYSE
4553,12-02-2021 04:00,24 hrs.,stocks,GNRC,104,0,104,-104,1,44,12,1,NYSE
4553,12-02-2021 04:00,24 hrs.,stocks,HUYA,38,38,0,38,1,7,20,1,NYSE
4553,12-02-2021 04:00,24 hrs.,stocks,HYLN,12,12,0,12,2,2,0,2,NYSE
4553,12-02-2021 04:00,24 hrs.,stocks,IPOD,7,0,7,-7,1,1,1,1,NYSE
4553,12-02-2021 04:00,24 hrs.,stocks,IPOE,13,0,13,-13,2,2,1,2,NYSE
4553,12-02-2021 04:00,24 hrs.,stocks,IPOF,7,0,7,-7,1,1,1,1,NYSE
4553,12-02-2021 04:00,24 hrs.,stocks,MDLY,6,6,0,6,1,1,0,1,NYSE
4553,12-02-2021 04:00,24 hrs.,wallstreetbets,DFLYF,33,33,0,33,3,2,17,2,OTC
4553,12-02-2021 04:00,24 hrs.,wallstreetbets,EHVVF,12,6,6,0,2,2,0,2,OTC
4553,12-02-2021 04:00,24 hrs.,wallstreetbets,EPWCF,12,12,0,12,1,0,8,1,OTC
4553,12-02-2021 04:00,24 hrs.,wallstreetbets,FDVRF,6,6,0,6,1,1,0,1,OTC
4553,12-02-2021 04:00,24 hrs.,wallstreetbets,FGPHF,6,6,0,6,1,1,0,1,OTC
4553,12-02-2021 04:00,24 hrs.,wallstreetbets,FLOOF,24,6,18,-12,4,4,0,4,OTC
4553,12-02-2021 04:00,24 hrs.,wallstreetbets,FLWPF,13,13,0,13,2,2,1,2,OTC
4553,12-02-2021 04:00,24 hrs.,wallstreetbets,GAYMF,21,21,0,21,3,3,3,3,OTC
4553,12-02-2021 04:00,24 hrs.,wallstreetbets,GGTTF,12,12,0,12,2,2,0,1,OTC
4553,12-02-2021 04:00,24 hrs.,wallstreetbets,GLDFF,6,0,6,-6,1,1,0,1,OTC
4553,12-02-2021 04:00,24 hrs.,wallstreetbets,GPORQ,6,6,0,6,1,1,0,1,OTC
4553,12-02-2021 04:00,24 hrs.,wallstreetbets,GTBIF,646,640,6,634,3,203,228,3,OTC
4553,12-02-2021 04:00,24 hrs.,wallstreetbets,GUESF,6,6,0,6,1,1,0,1,OTC
4553,12-02-2021 04:00,24 hrs.,wallstreetbets,HITIF,129,18,111,-93,13,24,29,12,OTC
4553,12-02-2021 04:00,24 hrs.,wallstreetbets,HRVOF,6,0,6,-6,1,1,0,1,OTC
4553,12-02-2021 04:00,24 hrs.,wallstreetbets,HRVSF,18,0,18,-18,3,3,0,3,OTC
4553,12-02-2021 04:00,24 hrs.,wallstreetbets,HSTRF,6,0,6,-6,1,1,0,1,OTC
4553,12-02-2021 04:00,24 hrs.,wallstreetbets,HTZGQ,24,0,24,-24,4,4,0,2,OTC
4553,12-02-2021 04:00,24 hrs.,wallstreetbets,HVBTF,6,0,6,-6,1,1,0,1,OTC
4553,12-02-2021 04:00,24 hrs.,wallstreetbets,ITHUF,6,0,6,-6,1,1,0,1,OTC
4553,12-02-2021 04:00,24 hrs.,wallstreetbets,JUVAF,6,6,0,6,1,1,0,1,OTC
4553,12-02-2021 04:00,24 hrs.,wallstreetbets,KPIFF,6,6,0,6,1,1,0,1,OTC
4553,12-02-2021 04:00,24 hrs.,wallstreetbets,LHSIF,6,0,6,-6,1,1,0,1,OTC
4553,12-02-2021 04:00,24 hrs.,wallstreetbets,LIACF,12,0,12,-12,2,2,0,2,OTC
4553,12-02-2021 04:00,24 hrs.,wallstreetbets,LITOF,6,6,0,6,1,1,0,1,OTC
4553,12-02-2021 04:00,24 hrs.,wallstreetbets,LKNCY,6,0,6,-6,1,1,0,1,OTC
4553,12-02-2021 04:00,24 hrs.,wallstreetbets,LKYSF,7,7,0,7,1,1,1,1,OTC
4553,12-02-2021 04:00,24 hrs.,wallstreetbets,LLKKF,6,6,0,6,1,1,0,1,OTC
4553,12-02-2021 04:00,24 hrs.,wallstreetbets,LMLLF,6,6,0,6,1,1,0,1,OTC
4553,12-02-2021 04:00,24 hrs.,wallstreetbets,LTMAQ,6,0,6,-6,1,1,0,1,OTC
4553,12-02-2021 04:00,24 hrs.,wallstreetbets,LTMCF,12,12,0,12,2,2,0,2,OTC
4553,12-02-2021 04:00,24 hrs.,wallstreetbets,LXXGF,8,8,0,8,1,1,2,1,OTC
4553,12-02-2021 04:00,24 hrs.,stocks,VLNCF,6,6,0,6,1,1,0,1,OTC
4553,12-02-2021 04:00,24 hrs.,stocks,DNN,35,35,0,35,3,4,15,3,AMEX
4553,12-02-2021 04:00,24 hrs.,stocks,DPW,12,12,0,12,1,3,2,1,AMEX
4553,12-02-2021 04:00,24 hrs.,stocks,GDP,506,0,506,-506,1,200,102,1,AMEX
4553,12-02-2021 04:00,24 hrs.,stocks,GTE,7,0,7,-7,1,1,1,1,AMEX
4553,12-02-2021 04:00,24 hrs.,stocks,NAK,6,0,6,-6,1,1,0,1,AMEX
4553,12-02-2021 04:00,24 hrs.,stocks,NBA,506,0,506,-506,1,200,102,1,AMEX
4553,12-02-2021 04:00,24 hrs.,stocks,TRX,45,45,0,45,2,16,5,2,AMEX
4553,12-02-2021 04:00,24 hrs.,stocks,NPA,6,6,0,6,1,1,0,1,NASDAQ
4553,12-02-2021 04:00,24 hrs.,stocks,OGI,33,13,20,-7,5,5,3,5,NASDAQ
4553,12-02-2021 04:00,24 hrs.,wallstreetbets,MCURF,6,0,6,-6,1,1,0,1,OTC
4553,12-02-2021 04:00,24 hrs.,wallstreetbets,MEDIF,6,0,6,-6,1,1,0,1,OTC
4553,12-02-2021 04:00,24 hrs.,wallstreetbets,MMEDF,2184,2141,43,2098,12,861,414,11,OTC
4553,12-02-2021 04:00,24 hrs.,wallstreetbets,MMNFF,49,19,30,-11,8,8,1,7,OTC
4553,12-02-2021 04:00,24 hrs.,wallstreetbets,MNKKQ,14,14,0,14,2,2,2,1,OTC
4553,12-02-2021 04:00,24 hrs.,wallstreetbets,NMGRF,13,13,0,13,2,2,1,2,OTC
4553,12-02-2021 04:00,24 hrs.,wallstreetbets,NMHLY,6,0,6,-6,1,1,0,1,OTC
4553,12-02-2021 04:00,24 hrs.,wallstreetbets,NSANY,6,6,0,6,1,1,0,1,OTC
4553,12-02-2021 04:00,24 hrs.,wallstreetbets,NTSFF,6,6,0,6,1,1,0,1,OTC
4553,12-02-2021 04:00,24 hrs.,wallstreetbets,NWARF,12,0,12,-12,2,2,0,2,OTC
4553,12-02-2021 04:00,24 hrs.,wallstreetbets,NWVCF,6,6,0,6,1,1,0,1,OTC
4553,12-02-2021 04:00,24 hrs.,wallstreetbets,NXGWF,7,7,0,7,1,1,1,1,OTC
4553,12-02-2021 04:00,24 hrs.,wallstreetbets,NXTTF,12,0,12,-12,2,2,0,2,OTC
4553,12-02-2021 04:00,24 hrs.,wallstreetbets,ORZCF,6,6,0,6,1,1,0,1,OTC
4553,12-02-2021 04:00,24 hrs.,wallstreetbets,PFFOF,6,6,0,6,1,1,0,1,OTC
4553,12-02-2021 04:00,24 hrs.,wallstreetbets,PLNHF,169,18,151,-133,9,33,67,7,OTC
4553,12-02-2021 04:00,24 hrs.,wallstreetbets,PLPRF,6,0,6,-6,1,1,0,1,OTC
4553,12-02-2021 04:00,24 hrs.,wallstreetbets,RAZFF,7,7,0,7,1,1,1,1,OTC
4553,12-02-2021 04:00,24 hrs.,wallstreetbets,RLFTF,30,0,30,-30,5,5,0,3,OTC
4553,12-02-2021 04:00,24 hrs.,wallstreetbets,RLLCF,6,6,0,6,1,1,0,1,OTC
4553,12-02-2021 04:00,24 hrs.,wallstreetbets,RVVTF,6,0,6,-6,1,1,0,1,OTC
4553,12-02-2021 04:00,24 hrs.,wallstreetbets,RYCEY,87,69,18,51,14,14,3,10,OTC
4553,12-02-2021 04:00,24 hrs.,wallstreetbets,RYMDF,6,0,6,-6,1,1,0,1,OTC
4553,12-02-2021 04:00,24 hrs.,wallstreetbets,SEOVF,6,0,6,-6,1,1,0,1,OTC
4553,12-02-2021 04:00,24 hrs.,wallstreetbets,SFTBY,12,0,12,-12,2,2,0,2,OTC
4553,12-02-2021 04:00,24 hrs.,wallstreetbets,SHECY,75,75,0,75,1,24,23,1,OTC
4553,12-02-2021 04:00,24 hrs.,wallstreetbets,SHERF,6,6,0,6,1,1,0,1,OTC
4553,12-02-2021 04:00,24 hrs.,wallstreetbets,SHRMF,2135,2117,18,2099,4,853,413,2,OTC
4553,12-02-2021 04:00,24 hrs.,wallstreetbets,SLGWF,12,0,12,-12,2,2,0,1,OTC
4553,12-02-2021 04:00,24 hrs.,wallstreetbets,SMRTQ,36,0,36,-36,3,3,18,2,OTC
4553,12-02-2021 04:00,24 hrs.,wallstreetbets,SPLIF,6,6,0,6,1,1,0,1,OTC
4553,12-02-2021 04:00,24 hrs.,wallstreetbets,SPRWF,74,62,12,50,11,13,4,10,OTC
4553,12-02-2021 04:00,24 hrs.,wallstreetbets,TAKOF,264,264,0,264,3,100,52,3,OTC
4553,12-02-2021 04:00,24 hrs.,wallstreetbets,TBUIF,24,0,24,-24,4,4,0,1,OTC
4553,12-02-2021 04:00,24 hrs.,wallstreetbets,TCNNF,754,633,121,512,2,226,294,2,OTC
4553,12-02-2021 04:00,24 hrs.,wallstreetbets,TGODF,42,12,30,-18,7,7,0,5,OTC
4553,12-02-2021 04:00,24 hrs.,wallstreetbets,TLLTF,6,0,6,-6,1,1,0,1,OTC
4553,12-02-2021 04:00,24 hrs.,wallstreetbets,TLOFF,7,7,0,7,1,1,1,1,OTC
4553,12-02-2021 04:00,24 hrs.,wallstreetbets,TLVLF,6,0,6,-6,1,1,0,1,OTC
4553,12-02-2021 04:00,24 hrs.,wallstreetbets,TOSYY,6,0,6,-6,1,1,0,1,OTC
4553,12-02-2021 04:00,24 hrs.,wallstreetbets,TRUFF,7,7,0,7,1,1,1,1,OTC
4553,12-02-2021 04:00,24 hrs.,wallstreetbets,TSCRF,13,7,6,1,2,2,1,2,OTC
4553,12-02-2021 04:00,24 hrs.,wallstreetbets,VALPQ,13,7,6,1,2,2,1,2,OTC
4553,12-02-2021 04:00,24 hrs.,wallstreetbets,VEGGF,6,6,0,6,1,1,0,1,OTC
4553,12-02-2021 04:00,24 hrs.,wallstreetbets,VLNCF,257,233,24,209,6,66,101,6,OTC
4553,12-02-2021 04:00,24 hrs.,wallstreetbets,VRYYF,6,0,6,-6,1,1,0,1,OTC
4553,12-02-2021 04:00,24 hrs.,wallstreetbets,VVCIF,7,7,0,7,1,1,1,1,OTC
4553,12-02-2021 04:00,24 hrs.,wallstreetbets,VYGVF,12,12,0,12,1,2,4,1,OTC
4553,12-02-2021 04:00,24 hrs.,wallstreetbets,WDDMF,6,0,6,-6,1,1,0,1,OTC
4553,12-02-2021 04:00,24 hrs.,wallstreetbets,WPMLF,8,8,0,8,1,1,2,1,OTC
4553,12-02-2021 04:00,24 hrs.,wallstreetbets,XIACF,12,12,0,12,2,2,0,1,OTC
4553,12-02-2021 04:00,24 hrs.,wallstreetbets,XIACY,12,12,0,12,2,2,0,1,OTC
4553,12-02-2021 04:00,24 hrs.,wallstreetbets,AAU,6,0,6,-6,1,1,0,1,AMEX
4553,12-02-2021 04:00,24 hrs.,wallstreetbets,AGE,6,6,0,6,1,1,0,1,AMEX
4553,12-02-2021 04:00,24 hrs.,stocks,QSR,104,0,104,-104,1,44,12,1,NYSE
4553,12-02-2021 04:00,24 hrs.,stocks,RKT,8,8,0,8,1,2,0,1,NYSE
4553,12-02-2021 04:00,24 hrs.,stocks,RSI,23,23,0,23,1,7,5,1,NYSE
4553,12-02-2021 04:00,24 hrs.,stocks,SBE,70,64,6,58,6,22,2,4,NYSE
4553,12-02-2021 04:00,24 hrs.,stocks,SIX,10,0,10,-10,1,3,0,1,NYSE
4553,12-02-2021 04:00,24 hrs.,stocks,SKT,6,0,6,-6,1,1,0,1,NYSE
4553,12-02-2021 04:00,24 hrs.,stocks,SOI,7,0,7,-7,1,1,1,1,NYSE
4553,12-02-2021 04:00,24 hrs.,stocks,SOS,12,12,0,12,2,2,0,2,NYSE
4553,12-02-2021 04:00,24 hrs.,stocks,AXDX,6,6,0,6,1,1,0,1,NASDAQ
4553,12-02-2021 04:00,24 hrs.,stocks,AZRX,12,12,0,12,1,2,4,1,NASDAQ
4553,12-02-2021 04:00,24 hrs.,stocks,BBIG,6,0,6,-6,1,1,0,1,NASDAQ
4553,12-02-2021 04:00,24 hrs.,stocks,BLDP,6,6,0,6,1,1,0,1,NASDAQ
4553,12-02-2021 04:00,24 hrs.,stocks,BLNK,33,33,0,33,1,3,23,1,NASDAQ
4553,12-02-2021 04:00,24 hrs.,stocks,BOXL,7,7,0,7,1,1,1,1,NASDAQ
4553,12-02-2021 04:00,24 hrs.,stocks,CLSK,26,26,0,26,1,7,8,1,NASDAQ
4553,12-02-2021 04:00,24 hrs.,stocks,CLVS,6,6,0,6,1,1,0,1,NASDAQ
4553,12-02-2021 04:00,24 hrs.,stocks,COST,10965,10918,47,10871,3,5013,927,3,NASDAQ
4553,12-02-2021 04:00,24 hrs.,stocks,CREE,6,6,0,6,1,1,0,1,NASDAQ
4553,12-02-2021 04:00,24 hrs.,stocks,CRSP,10,0,10,-10,1,2,2,1,NASDAQ
4553,12-02-2021 04:00,24 hrs.,stocks,CRSR,45,40,5,35,2,12,13,2,NASDAQ
4553,12-02-2021 04:00,24 hrs.,stocks,CTRM,50,38,12,26,8,8,2,7,NASDAQ
4553,12-02-2021 04:00,24 hrs.,stocks,CXDC,6,6,0,6,1,1,0,1,NASDAQ
4553,12-02-2021 04:00,24 hrs.,stocks,DMTK,20,20,0,20,1,2,12,1,NASDAQ
4553,12-02-2021 04:00,24 hrs.,stocks,DOMO,21,0,21,-21,1,7,3,1,NASDAQ
4553,12-02-2021 04:00,24 hrs.,stocks,DOYU,7,7,0,7,1,1,1,1,NASDAQ
4553,12-02-2021 04:00,24 hrs.,stocks,EKSO,6,0,6,-6,1,1,0,1,NASDAQ
4553,12-02-2021 04:00,24 hrs.,stocks,EOLS,6,0,6,-6,1,1,0,1,NASDAQ
4553,12-02-2021 04:00,24 hrs.,stocks,EVFM,20,20,0,20,2,6,0,1,NASDAQ
4553,12-02-2021 04:00,24 hrs.,stocks,EXAS,20,20,0,20,1,2,12,1,NASDAQ
4553,12-02-2021 04:00,24 hrs.,stocks,EXPI,6,6,0,6,1,1,0,1,NASDAQ
4553,12-02-2021 04:00,24 hrs.,stocks,FLXN,23,23,0,23,1,7,5,1,NASDAQ
4553,12-02-2021 04:00,24 hrs.,stocks,FROG,6,6,0,6,1,1,0,1,NASDAQ
4553,12-02-2021 04:00,24 hrs.,stocks,FSRV,6,6,0,6,1,1,0,1,NASDAQ
4553,12-02-2021 04:00,24 hrs.,stocks,GAIN,32,0,32,-32,1,10,8,1,NASDAQ
4553,12-02-2021 04:00,24 hrs.,stocks,GEVO,12,0,12,-12,2,2,0,1,NASDAQ
4553,12-02-2021 04:00,24 hrs.,stocks,GILT,47,40,7,33,2,13,13,2,NASDAQ
4553,12-02-2021 04:00,24 hrs.,stocks,GLBS,6,6,0,6,1,1,0,1,NASDAQ
4553,12-02-2021 04:00,24 hrs.,stocks,GLUU,14,0,14,-14,1,3,4,1,NASDAQ
4553,12-02-2021 04:00,24 hrs.,stocks,GMBL,6,0,6,-6,1,1,0,1,NASDAQ
4553,12-02-2021 04:00,24 hrs.,stocks,GNLN,6,0,6,-6,1,1,0,1,NASDAQ
4553,12-02-2021 04:00,24 hrs.,stocks,GOEV,6,6,0,6,1,1,0,1,NASDAQ
4553,12-02-2021 04:00,24 hrs.,stocks,GOOG,15,0,15,-15,1,0,11,1,NASDAQ
4553,12-02-2021 04:00,24 hrs.,stocks,GRWG,6,0,6,-6,1,1,0,1,NASDAQ
4553,12-02-2021 04:00,24 hrs.,stocks,GTEC,6,6,0,6,1,1,0,1,NASDAQ
4553,12-02-2021 04:00,24 hrs.,stocks,GTHX,6,6,0,6,1,1,0,1,NASDAQ
4553,12-02-2021 04:00,24 hrs.,stocks,HTBX,12,0,12,-12,2,2,0,1,NASDAQ
4553,12-02-2021 04:00,24 hrs.,stocks,ICPT,17,17,0,17,1,4,5,1,NASDAQ
4553,12-02-2021 04:00,24 hrs.,stocks,IFMK,6,6,0,6,1,1,0,1,NASDAQ
4553,12-02-2021 04:00,24 hrs.,stocks,INTC,40,40,0,40,1,5,26,1,NASDAQ
4553,12-02-2021 04:00,24 hrs.,stocks,IRBT,104,0,104,-104,1,44,12,1,NASDAQ
4553,12-02-2021 04:00,24 hrs.,stocks,OTIS,23,23,0,23,1,7,5,1,NYSE
4553,12-02-2021 04:00,24 hrs.,stocks,PINS,211,40,171,-131,3,75,49,3,NYSE
4553,12-02-2021 04:00,24 hrs.,stocks,PLTR,10925,10925,0,10925,2,5001,915,2,NYSE
4553,12-02-2021 04:00,24 hrs.,stocks,PSTH,6,0,6,-6,1,1,0,1,NYSE
4553,12-02-2021 04:00,24 hrs.,stocks,SKLZ,40,40,0,40,1,12,12,1,NYSE
4553,12-02-2021 04:00,24 hrs.,stocks,SPCE,17,17,0,17,2,3,3,2,NYSE
4553,12-02-2021 04:00,24 hrs.,stocks,SPOT,6,6,0,6,1,1,0,1,NYSE
4553,12-02-2021 04:00,24 hrs.,stocks,TMHC,6,6,0,6,1,1,0,1,NYSE
4553,12-02-2021 04:00,24 hrs.,stocks,UBER,123,19,104,-85,2,51,13,2,NYSE
4553,12-02-2021 04:00,24 hrs.,stocks,VGAC,29,0,29,-29,1,10,5,1,NYSE
4553,12-02-2021 04:00,24 hrs.,stocks,VOYA,23,23,0,23,1,7,5,1,NYSE
4553,12-02-2021 04:00,24 hrs.,stocks,WORK,6,6,0,6,1,1,0,1,NYSE
4553,12-02-2021 04:00,24 hrs.,stocks,XPEV,382,382,0,382,1,168,42,1,NYSE
4553,12-02-2021 04:00,24 hrs.,stocks,AAL,26,26,0,26,1,3,16,1,NASDAQ
4553,12-02-2021 04:00,24 hrs.,stocks,AMD,68,54,14,40,4,6,40,3,NASDAQ
4553,12-02-2021 04:00,24 hrs.,stocks,AZN,6,0,6,-6,1,1,0,1,NASDAQ
4553,12-02-2021 04:00,24 hrs.,stocks,CGC,18,12,6,6,3,3,0,3,NASDAQ
4553,12-02-2021 04:00,24 hrs.,stocks,GSM,6,0,6,-6,1,1,0,1,NASDAQ
4553,12-02-2021 04:00,24 hrs.,stocks,III,506,0,506,-506,1,200,102,1,NASDAQ
4553,12-02-2021 04:00,24 hrs.,stocks,JFU,6,6,0,6,1,1,0,1,NASDAQ
4553,12-02-2021 04:00,24 hrs.,stocks,KHC,135,31,104,-73,3,51,21,3,NASDAQ
4553,12-02-2021 04:00,24 hrs.,stocks,LNT,23,23,0,23,1,7,5,1,NASDAQ
4553,12-02-2021 04:00,24 hrs.,wallstreetbets,NGD,15,15,0,15,2,2,3,1,AMEX
4553,12-02-2021 04:00,24 hrs.,wallstreetbets,NXE,6,6,0,6,1,1,0,1,AMEX
4553,12-02-2021 04:00,24 hrs.,wallstreetbets,PTK,6,0,6,-6,1,1,0,1,AMEX
4553,12-02-2021 04:00,24 hrs.,wallstreetbets,PTN,12,0,12,-12,2,2,0,1,AMEX
4553,12-02-2021 04:00,24 hrs.,wallstreetbets,REI,6,0,6,-6,1,1,0,1,AMEX
4553,12-02-2021 04:00,24 hrs.,wallstreetbets,SYN,12,12,0,12,2,2,0,2,AMEX
4553,12-02-2021 04:00,24 hrs.,wallstreetbets,TRX,79,43,36,7,13,13,1,11,AMEX
4553,12-02-2021 04:00,24 hrs.,wallstreetbets,URG,7,7,0,7,1,1,1,1,AMEX
4553,12-02-2021 04:00,24 hrs.,wallstreetbets,XPL,12,12,0,12,2,2,0,1,AMEX
4553,12-02-2021 04:00,24 hrs.,wallstreetbets,ZOM,276,179,97,82,45,45,6,35,AMEX
4553,12-02-2021 04:00,24 hrs.,wallstreetbets,AMPE,6,0,6,-6,1,1,0,1,AMEX
4553,12-02-2021 04:00,24 hrs.,wallstreetbets,CANF,6,0,6,-6,1,1,0,1,AMEX
4553,12-02-2021 04:00,24 hrs.,wallstreetbets,CRMD,12,12,0,12,2,2,0,2,AMEX
4553,12-02-2021 04:00,24 hrs.,wallstreetbets,GSAT,200,121,79,42,33,33,2,25,AMEX
4553,12-02-2021 04:00,24 hrs.,wallstreetbets,IBIO,18,18,0,18,3,3,0,1,AMEX
4553,12-02-2021 04:00,24 hrs.,wallstreetbets,INUV,6,0,6,-6,1,1,0,1,AMEX
4553,12-02-2021 04:00,24 hrs.,wallstreetbets,LODE,6,6,0,6,1,1,0,1,AMEX
4553,12-02-2021 04:00,24 hrs.,wallstreetbets,NSPR,49,19,30,-11,6,12,1,5,AMEX
4553,12-02-2021 04:00,24 hrs.,wallstreetbets,OGEN,42,12,30,-18,7,7,0,6,AMEX
4553,12-02-2021 04:00,24 hrs.,wallstreetbets,SENS,3685,90,3595,-3505,21,1469,663,18,AMEX
4553,12-02-2021 04:00,24 hrs.,wallstreetbets,TMBR,18,12,6,6,3,3,0,3,AMEX
4553,12-02-2021 04:00,24 hrs.,wallstreetbets,TRXC,55,7,48,-41,9,9,1,6,AMEX
4553,12-02-2021 04:00,24 hrs.,wallstreetbets,UAVS,25,19,6,13,4,4,1,4,AMEX
4553,12-02-2021 04:00,24 hrs.,wallstreetbets,UUUU,26,26,0,26,4,4,2,3,AMEX
4553,12-02-2021 04:00,24 hrs.,wallstreetbets,VOLT,6,0,6,-6,1,1,0,1,AMEX
4553,12-02-2021 04:00,24 hrs.,wallstreetbets,XXII,6,0,6,-6,1,1,0,1,AMEX
4553,12-02-2021 04:00,24 hrs.,wallstreetbets,YCBD,13,7,6,1,2,2,1,2,AMEX
4553,12-02-2021 04:00,24 hrs.,wallstreetbets,ABT,6,0,6,-6,1,1,0,1,NYSE
4553,12-02-2021 04:00,24 hrs.,wallstreetbets,ACB,29603,127,29476,-29349,56,13138,3103,40,NYSE
4553,12-02-2021 04:00,24 hrs.,wallstreetbets,ACI,6,6,0,6,1,1,0,1,NYSE
4553,12-02-2021 04:00,24 hrs.,wallstreetbets,ADT,18,18,0,18,3,3,0,2,NYSE
4553,12-02-2021 04:00,24 hrs.,wallstreetbets,ADX,12,12,0,12,2,2,0,1,NYSE
4553,12-02-2021 04:00,24 hrs.,wallstreetbets,AFC,12,12,0,12,2,2,0,1,NYSE
4553,12-02-2021 04:00,24 hrs.,wallstreetbets,AHT,14,14,0,14,2,2,2,2,NYSE
4553,12-02-2021 04:00,24 hrs.,wallstreetbets,AMC,59315,56089,3226,52863,314,26863,4333,261,NYSE
4553,12-02-2021 04:00,24 hrs.,wallstreetbets,AMP,33,27,6,21,5,5,3,5,NYSE
4553,12-02-2021 04:00,24 hrs.,wallstreetbets,ASX,38,14,24,-10,6,6,2,6,NYSE
4553,12-02-2021 04:00,24 hrs.,wallstreetbets,ATH,55295,6,55289,-55283,2,26086,3115,2,NYSE
4553,12-02-2021 04:00,24 hrs.,wallstreetbets,AUY,12,12,0,12,2,2,0,2,NYSE
4553,12-02-2021 04:00,24 hrs.,wallstreetbets,AYX,6,6,0,6,1,1,0,1,NYSE
4553,12-02-2021 04:00,24 hrs.,wallstreetbets,BBW,19,19,0,19,3,3,1,3,NYSE
4553,12-02-2021 04:00,24 hrs.,wallstreetbets,BBY,12,0,12,-12,2,2,0,2,NYSE
4553,12-02-2021 04:00,24 hrs.,stocks,PEP,110,6,104,-98,2,44,14,2,NASDAQ
4553,12-02-2021 04:00,24 hrs.,stocks,PTE,6,0,6,-6,1,1,0,1,NASDAQ
4553,12-02-2021 04:00,24 hrs.,stocks,QQQ,47,47,0,47,2,6,27,2,NASDAQ
4553,12-02-2021 04:00,24 hrs.,stocks,RXT,6,6,0,6,1,1,0,1,NASDAQ
4553,12-02-2021 04:00,24 hrs.,stocks,SMH,40,40,0,40,1,5,26,1,NASDAQ
4553,12-02-2021 04:00,24 hrs.,stocks,UFO,33,33,0,33,3,8,5,1,NASDAQ
4553,12-02-2021 04:00,24 hrs.,stocks,AAPL,10993,10976,17,10959,5,5008,957,4,NASDAQ
4553,12-02-2021 04:00,24 hrs.,stocks,ABIO,6,6,0,6,1,1,0,1,NASDAQ
4553,12-02-2021 04:00,24 hrs.,stocks,ABNB,29,29,0,29,1,9,7,1,NASDAQ
4553,12-02-2021 04:00,24 hrs.,stocks,AEZS,6,6,0,6,1,1,0,1,NASDAQ
4553,12-02-2021 04:00,24 hrs.,stocks,AGTC,245,6,239,-233,2,105,27,2,NASDAQ
4553,12-02-2021 04:00,24 hrs.,stocks,ALDX,6,0,6,-6,1,1,0,1,NASDAQ
4553,12-02-2021 04:00,24 hrs.,stocks,ALJJ,6,6,0,6,1,1,0,1,NASDAQ
4553,12-02-2021 04:00,24 hrs.,stocks,ALOT,107,107,0,107,1,25,53,1,NASDAQ
4553,12-02-2021 04:00,24 hrs.,stocks,AMCX,6,6,0,6,1,1,0,1,NASDAQ
4553,12-02-2021 04:00,24 hrs.,stocks,AMZN,10918,10918,0,10918,1,5000,914,1,NASDAQ
4553,12-02-2021 04:00,24 hrs.,stocks,AOSL,7,0,7,-7,1,1,1,1,NASDAQ
4553,12-02-2021 04:00,24 hrs.,stocks,APHA,11248,11172,76,11096,16,5062,1060,15,NASDAQ
4553,12-02-2021 04:00,24 hrs.,stocks,APXT,6,6,0,6,1,1,0,1,NASDAQ
4553,12-02-2021 04:00,24 hrs.,stocks,ASRT,22,6,16,-10,2,7,0,2,NASDAQ
4553,12-02-2021 04:00,24 hrs.,stocks,ATOM,6,6,0,6,1,1,0,1,NASDAQ
4553,12-02-2021 04:00,24 hrs.,stocks,AVXL,6,6,0,6,1,1,0,1,NASDAQ
4553,12-02-2021 04:00,24 hrs.,stocks,SSYS,34,34,0,34,1,7,16,1,NASDAQ
4553,12-02-2021 04:00,24 hrs.,stocks,SWAV,20,20,0,20,1,2,12,1,NASDAQ
4553,12-02-2021 04:00,24 hrs.,stocks,SWBI,7,7,0,7,1,1,1,1,NASDAQ
4553,12-02-2021 04:00,24 hrs.,stocks,TLRY,262,199,63,136,15,54,94,14,NASDAQ
4553,12-02-2021 04:00,24 hrs.,stocks,TMDX,20,20,0,20,1,2,12,1,NASDAQ
4553,12-02-2021 04:00,24 hrs.,stocks,TNXP,25,18,7,11,4,4,1,3,NASDAQ
4553,12-02-2021 04:00,24 hrs.,stocks,TOPS,7,7,0,7,1,1,1,1,NASDAQ
4553,12-02-2021 04:00,24 hrs.,stocks,TRVN,6,0,6,-6,1,1,0,1,NASDAQ
4553,12-02-2021 04:00,24 hrs.,stocks,TSLA,111,88,23,65,7,8,67,6,NASDAQ
4553,12-02-2021 04:00,24 hrs.,stocks,TTWO,6,6,0,6,1,1,0,1,NASDAQ
4553,12-02-2021 04:00,24 hrs.,stocks,TWOU,23,23,0,23,2,5,5,1,NASDAQ
4553,12-02-2021 04:00,24 hrs.,stocks,TXMD,12,12,0,12,2,2,0,2,NASDAQ
4553,12-02-2021 04:00,24 hrs.,stocks,VCEL,20,20,0,20,1,2,12,1,NASDAQ
4553,12-02-2021 04:00,24 hrs.,stocks,VECO,6,6,0,6,1,1,0,1,NASDAQ
4553,12-02-2021 04:00,24 hrs.,stocks,VERU,12,0,12,-12,2,2,0,1,NASDAQ
4553,12-02-2021 04:00,24 hrs.,wallstreetbets,BEP,6,6,0,6,1,1,0,1,NYSE
4553,12-02-2021 04:00,24 hrs.,wallstreetbets,BFT,14,14,0,14,2,2,2,2,NYSE
4553,12-02-2021 04:00,24 hrs.,wallstreetbets,BGS,12,12,0,12,2,2,0,1,NYSE
4553,12-02-2021 04:00,24 hrs.,wallstreetbets,BHC,21,21,0,21,3,3,3,1,NYSE
4553,12-02-2021 04:00,24 hrs.,wallstreetbets,BIO,69,12,57,-45,5,14,21,5,NYSE
4553,12-02-2021 04:00,24 hrs.,wallstreetbets,BIT,13,7,6,1,2,2,1,2,NYSE
4553,12-02-2021 04:00,24 hrs.,wallstreetbets,BNY,6,0,6,-6,1,1,0,1,NYSE
4553,12-02-2021 04:00,24 hrs.,wallstreetbets,BTT,74,38,36,2,12,12,2,12,NYSE
4553,12-02-2021 04:00,24 hrs.,wallstreetbets,BUD,25,7,18,-11,4,4,1,3,NYSE
4553,12-02-2021 04:00,24 hrs.,wallstreetbets,CBD,29325,38,29287,-29249,9,13093,3103,8,NYSE
4553,12-02-2021 04:00,24 hrs.,wallstreetbets,CCJ,6,6,0,6,1,1,0,1,NYSE
4553,12-02-2021 04:00,24 hrs.,wallstreetbets,CCL,36,18,18,0,6,6,0,6,NYSE
4553,12-02-2021 04:00,24 hrs.,wallstreetbets,CHS,6,0,6,-6,1,1,0,1,NYSE
4553,12-02-2021 04:00,24 hrs.,wallstreetbets,CMO,6,6,0,6,1,1,0,1,NYSE
4553,12-02-2021 04:00,24 hrs.,wallstreetbets,COO,6,6,0,6,1,1,0,1,NYSE
4553,12-02-2021 04:00,24 hrs.,wallstreetbets,COP,6,6,0,6,1,1,0,1,NYSE
4553,12-02-2021 04:00,24 hrs.,wallstreetbets,CRL,6,6,0,6,1,1,0,1,NYSE
4553,12-02-2021 04:00,24 hrs.,wallstreetbets,CRM,7,0,7,-7,1,1,1,1,NYSE
4553,12-02-2021 04:00,24 hrs.,wallstreetbets,CUB,37,37,0,37,6,6,1,1,NYSE
4553,12-02-2021 04:00,24 hrs.,wallstreetbets,CVA,13,13,0,13,2,2,1,2,NYSE
4553,12-02-2021 04:00,24 hrs.,wallstreetbets,CVE,6,0,6,-6,1,1,0,1,NYSE
4553,12-02-2021 04:00,24 hrs.,wallstreetbets,CVS,13,13,0,13,2,2,1,2,NYSE
4553,12-02-2021 04:00,24 hrs.,wallstreetbets,DAL,182,182,0,182,1,61,56,1,NYSE
4553,12-02-2021 04:00,24 hrs.,wallstreetbets,DCF,179,179,0,179,1,56,63,1,NYSE
4553,12-02-2021 04:00,24 hrs.,wallstreetbets,DDD,12,6,6,0,2,2,0,2,NYSE
4553,12-02-2021 04:00,24 hrs.,wallstreetbets,DIS,1461,1443,18,1425,17,541,311,15,NYSE
4553,12-02-2021 04:00,24 hrs.,wallstreetbets,DLB,135,0,135,-135,1,44,43,1,NYSE
4553,12-02-2021 04:00,24 hrs.,stocks,JNCE,6,0,6,-6,1,1,0,1,NASDAQ
4553,12-02-2021 04:00,24 hrs.,stocks,KLIC,6,6,0,6,1,1,0,1,NASDAQ
4553,12-02-2021 04:00,24 hrs.,stocks,KPTI,23,23,0,23,1,7,5,1,NASDAQ
4553,12-02-2021 04:00,24 hrs.,stocks,LIVE,118,0,118,-118,3,46,14,2,NASDAQ
4553,12-02-2021 04:00,24 hrs.,stocks,LPTH,6,6,0,6,1,1,0,1,NASDAQ
4553,12-02-2021 04:00,24 hrs.,wallstreetbets,AMS,6,6,0,6,1,1,0,1,AMEX
4553,12-02-2021 04:00,24 hrs.,wallstreetbets,CEI,18,18,0,18,3,3,0,2,AMEX
4553,12-02-2021 04:00,24 hrs.,wallstreetbets,DNN,177,141,36,105,28,29,7,26,AMEX
4553,12-02-2021 04:00,24 hrs.,wallstreetbets,DPW,19,19,0,19,3,3,1,3,AMEX
4553,12-02-2021 04:00,24 hrs.,wallstreetbets,GPL,12,6,6,0,2,2,0,2,AMEX
4553,12-02-2021 04:00,24 hrs.,wallstreetbets,GSV,38,32,6,26,6,6,2,6,AMEX
4553,12-02-2021 04:00,24 hrs.,wallstreetbets,GTE,158,116,42,74,26,26,2,23,AMEX
4553,12-02-2021 04:00,24 hrs.,wallstreetbets,IGC,91,13,78,-65,15,15,1,8,AMEX
4553,12-02-2021 04:00,24 hrs.,wallstreetbets,ISR,6,6,0,6,1,1,0,1,AMEX
4553,12-02-2021 04:00,24 hrs.,wallstreetbets,ITP,6,6,0,6,1,1,0,1,AMEX
4553,12-02-2021 04:00,24 hrs.,wallstreetbets,JOB,6,0,6,-6,1,1,0,1,AMEX
4553,12-02-2021 04:00,24 hrs.,wallstreetbets,KIQ,12,12,0,12,2,2,0,1,AMEX
4553,12-02-2021 04:00,24 hrs.,wallstreetbets,LNG,12,0,12,-12,2,2,0,2,AMEX
4553,12-02-2021 04:00,24 hrs.,wallstreetbets,LOV,18,0,18,-18,3,3,0,1,AMEX
4553,12-02-2021 04:00,24 hrs.,wallstreetbets,MMX,6,0,6,-6,1,1,0,1,AMEX
4553,12-02-2021 04:00,24 hrs.,wallstreetbets,MXC,13,7,6,1,2,2,1,2,AMEX
4553,12-02-2021 04:00,24 hrs.,wallstreetbets,NAK,265,112,153,-41,43,44,5,32,AMEX
4553,12-02-2021 04:00,24 hrs.,wallstreetbets,ELY,12,6,6,0,2,2,0,2,NYSE
4553,12-02-2021 04:00,24 hrs.,wallstreetbets,EMO,6,6,0,6,1,1,0,1,NYSE
4553,12-02-2021 04:00,24 hrs.,wallstreetbets,ENJ,6,6,0,6,1,1,0,1,NYSE
4553,12-02-2021 04:00,24 hrs.,wallstreetbets,EOS,13,13,0,13,2,2,1,2,NYSE
4553,12-02-2021 04:00,24 hrs.,wallstreetbets,FAF,18,6,12,-6,3,3,0,3,NYSE
4553,12-02-2021 04:00,24 hrs.,wallstreetbets,FCF,179,179,0,179,1,56,63,1,NYSE
4553,12-02-2021 04:00,24 hrs.,wallstreetbets,FCX,54,54,0,54,2,13,20,2,NYSE
4553,12-02-2021 04:00,24 hrs.,wallstreetbets,FLR,6,0,6,-6,1,1,0,1,NYSE
4553,12-02-2021 04:00,24 hrs.,wallstreetbets,FLT,30,24,6,18,5,5,0,4,NYSE
4553,12-02-2021 04:00,24 hrs.,wallstreetbets,FMS,13,13,0,13,2,2,1,2,NYSE
4553,12-02-2021 04:00,24 hrs.,wallstreetbets,FOF,6,6,0,6,1,1,0,1,NYSE
4553,12-02-2021 04:00,24 hrs.,wallstreetbets,FSD,24,12,12,0,4,4,0,3,NYSE
4553,12-02-2021 04:00,24 hrs.,wallstreetbets,FSR,265,216,49,167,8,73,87,6,NYSE
4553,12-02-2021 04:00,24 hrs.,wallstreetbets,FTI,7,7,0,7,1,1,1,1,NYSE
4553,12-02-2021 04:00,24 hrs.,wallstreetbets,GEL,6,0,6,-6,1,1,0,1,NYSE
4553,12-02-2021 04:00,24 hrs.,wallstreetbets,GEO,24,12,12,0,4,4,0,3,NYSE
4553,12-02-2021 04:00,24 hrs.,wallstreetbets,GME,158433,83689,74744,8945,567,65466,25233,447,NYSE
4553,12-02-2021 04:00,24 hrs.,wallstreetbets,GTT,6,6,0,6,1,1,0,1,NYSE
4553,12-02-2021 04:00,24 hrs.,wallstreetbets,GUT,6,6,0,6,1,1,0,1,NYSE
4553,12-02-2021 04:00,24 hrs.,wallstreetbets,HAL,6,6,0,6,1,1,0,1,NYSE
4553,12-02-2021 04:00,24 hrs.,wallstreetbets,HII,12,12,0,12,2,2,0,1,NYSE
4553,12-02-2021 04:00,24 hrs.,wallstreetbets,HON,6,6,0,6,1,1,0,1,NYSE
4553,12-02-2021 04:00,24 hrs.,wallstreetbets,HRB,98,98,0,98,1,22,50,1,NYSE
4553,12-02-2021 04:00,24 hrs.,stocks,MARA,6,0,6,-6,1,1,0,1,NASDAQ
4553,12-02-2021 04:00,24 hrs.,stocks,MBII,8,0,8,-8,1,2,0,1,NASDAQ
4553,12-02-2021 04:00,24 hrs.,stocks,MBRX,6,6,0,6,1,1,0,1,NASDAQ
4553,12-02-2021 04:00,24 hrs.,stocks,MELI,40,40,0,40,1,5,26,1,NASDAQ
4553,12-02-2021 04:00,24 hrs.,stocks,MGNI,46,46,0,46,1,6,30,1,NASDAQ
4553,12-02-2021 04:00,24 hrs.,stocks,MSFT,11068,10964,104,10860,3,5050,956,3,NASDAQ
4553,12-02-2021 04:00,24 hrs.,stocks,MSTR,6,6,0,6,1,1,0,1,NASDAQ
4553,12-02-2021 04:00,24 hrs.,stocks,MTCH,229,229,0,229,1,47,131,1,NASDAQ
4553,12-02-2021 04:00,24 hrs.,stocks,MVIS,12,12,0,12,2,2,0,2,NASDAQ
4553,12-02-2021 04:00,24 hrs.,stocks,NAKD,49,19,30,-11,7,7,7,7,NASDAQ
4553,12-02-2021 04:00,24 hrs.,stocks,NTLA,14,14,0,14,1,3,4,1,NASDAQ
4553,12-02-2021 04:00,24 hrs.,stocks,NTRS,8,8,0,8,1,1,2,1,NASDAQ
4553,12-02-2021 04:00,24 hrs.,stocks,NVCN,34,0,34,-34,1,10,10,1,NASDAQ
4553,12-02-2021 04:00,24 hrs.,stocks,NVDA,10997,10997,0,10997,3,5009,967,3,NASDAQ
4553,12-02-2021 04:00,24 hrs.,stocks,OCGN,6,6,0,6,1,1,0,1,NASDAQ
4553,12-02-2021 04:00,24 hrs.,stocks,OPRX,20,20,0,20,1,2,12,1,NASDAQ
4553,12-02-2021 04:00,24 hrs.,stocks,OPTT,7,0,7,-7,1,1,1,1,NASDAQ
4553,12-02-2021 04:00,24 hrs.,stocks,PAAS,6,0,6,-6,1,1,0,1,NASDAQ
4553,12-02-2021 04:00,24 hrs.,stocks,PENN,7,7,0,7,1,1,1,1,NASDAQ
4553,12-02-2021 04:00,24 hrs.,stocks,PGNY,20,20,0,20,1,2,12,1,NASDAQ
4553,12-02-2021 04:00,24 hrs.,stocks,PLAY,7,0,7,-7,1,1,1,1,NASDAQ
4553,12-02-2021 04:00,24 hrs.,stocks,POWW,180,174,6,168,2,63,46,2,NASDAQ
4553,12-02-2021 04:00,24 hrs.,stocks,PTGX,6,0,6,-6,1,1,0,1,NASDAQ
4553,12-02-2021 04:00,24 hrs.,stocks,PYPL,265,265,0,265,2,101,55,2,NASDAQ
4553,12-02-2021 04:00,24 hrs.,stocks,QCOM,21,14,7,7,3,3,3,2,NASDAQ
4553,12-02-2021 04:00,24 hrs.,stocks,QQQM,40,40,0,40,1,5,26,1,NASDAQ
4553,12-02-2021 04:00,24 hrs.,stocks,RDFN,17,17,0,17,1,5,3,1,NASDAQ
4553,12-02-2021 04:00,24 hrs.,stocks,RGEN,20,20,0,20,1,2,12,1,NASDAQ
4553,12-02-2021 04:00,24 hrs.,stocks,RIDE,63,63,0,63,1,22,15,1,NASDAQ
4553,12-02-2021 04:00,24 hrs.,stocks,RIOT,12,6,6,0,2,2,0,2,NASDAQ
4553,12-02-2021 04:00,24 hrs.,stocks,SAVA,6,0,6,-6,1,1,0,1,NASDAQ
4553,12-02-2021 04:00,24 hrs.,stocks,SEEL,6,6,0,6,1,1,0,1,NASDAQ
4553,12-02-2021 04:00,24 hrs.,stocks,SNDL,137,69,68,1,22,22,5,18,NASDAQ
4553,12-02-2021 04:00,24 hrs.,stocks,SONO,104,0,104,-104,1,44,12,1,NASDAQ
4553,12-02-2021 04:00,24 hrs.,stocks,SPOK,6,0,6,-6,1,1,0,1,NASDAQ
4553,12-02-2021 04:00,24 hrs.,stocks,SPRO,20,20,0,20,1,2,12,1,NASDAQ
4553,12-02-2021 04:00,24 hrs.,stocks,SQQQ,7,7,0,7,1,1,1,1,NASDAQ
4553,12-02-2021 04:00,24 hrs.,stocks,SRAC,8,8,0,8,1,2,0,1,NASDAQ
4553,12-02-2021 04:00,24 hrs.,stocks,SRAX,6,0,6,-6,1,1,0,1,NASDAQ
4553,12-02-2021 04:00,24 hrs.,stocks,SRNE,6,0,6,-6,1,1,0,1,NASDAQ
4553,12-02-2021 04:00,24 hrs.,stocks,SSPK,45,45,0,45,1,14,13,1,NASDAQ
4553,12-02-2021 04:00,24 hrs.,wallstreetbets,PCG,314,314,0,314,1,95,120,1,NYSE
4553,12-02-2021 04:00,24 hrs.,wallstreetbets,PDS,6,0,6,-6,1,1,0,1,NYSE
4553,12-02-2021 04:00,24 hrs.,wallstreetbets,PEG,179,179,0,179,1,56,63,1,NYSE
4553,12-02-2021 04:00,24 hrs.,wallstreetbets,PFE,18,12,6,6,3,3,0,3,NYSE
4553,12-02-2021 04:00,24 hrs.,wallstreetbets,PMO,12,0,12,-12,2,2,0,1,NYSE
4553,12-02-2021 04:00,24 hrs.,wallstreetbets,PPL,7,0,7,-7,1,1,1,1,NYSE
4553,12-02-2021 04:00,24 hrs.,wallstreetbets,PSA,1027,1015,12,1003,6,399,205,6,NYSE
4553,12-02-2021 04:00,24 hrs.,wallstreetbets,QSR,614,0,614,-614,1,239,132,1,NYSE
4553,12-02-2021 04:00,24 hrs.,wallstreetbets,RAD,72,72,0,72,1,24,20,1,NYSE
4553,12-02-2021 04:00,24 hrs.,wallstreetbets,RCL,182,182,0,182,1,61,56,1,NYSE
4553,12-02-2021 04:00,24 hrs.,wallstreetbets,RIG,6,6,0,6,1,1,0,1,NYSE
4553,12-02-2021 04:00,24 hrs.,wallstreetbets,RKT,1042,681,361,320,19,289,388,15,NYSE
4553,12-02-2021 04:00,24 hrs.,wallstreetbets,RMO,13,13,0,13,2,2,1,2,NYSE
4553,12-02-2021 04:00,24 hrs.,wallstreetbets,RSI,24,24,0,24,4,4,0,3,NYSE
4553,12-02-2021 04:00,24 hrs.,wallstreetbets,RTX,7,7,0,7,1,1,1,1,NYSE
4553,12-02-2021 04:00,24 hrs.,wallstreetbets,SBE,18,12,6,6,3,3,0,3,NYSE
4553,12-02-2021 04:00,24 hrs.,wallstreetbets,SBI,7,7,0,7,1,1,1,1,NYSE
4553,12-02-2021 04:00,24 hrs.,wallstreetbets,SCI,280,280,0,280,3,99,70,2,NYSE
4553,12-02-2021 04:00,24 hrs.,wallstreetbets,SCU,6,0,6,-6,1,1,0,1,NYSE
4553,12-02-2021 04:00,24 hrs.,wallstreetbets,SHW,6,0,6,-6,1,1,0,1,NYSE
4553,12-02-2021 04:00,24 hrs.,wallstreetbets,SKT,25,19,6,13,4,4,1,3,NYSE
4553,12-02-2021 04:00,24 hrs.,wallstreetbets,SKY,6,6,0,6,1,1,0,1,NYSE
4553,12-02-2021 04:00,24 hrs.,wallstreetbets,SMG,6,0,6,-6,1,1,0,1,NYSE
4553,12-02-2021 04:00,24 hrs.,stocks,VUZI,38,38,0,38,1,10,14,1,NASDAQ
4553,12-02-2021 04:00,24 hrs.,stocks,VXRT,12,12,0,12,2,2,0,2,NASDAQ
4553,12-02-2021 04:00,24 hrs.,stocks,VXUS,28,28,0,28,1,7,10,1,NASDAQ
4553,12-02-2021 04:00,24 hrs.,stocks,XCUR,6,6,0,6,1,1,0,1,NASDAQ
4553,12-02-2021 04:00,24 hrs.,stocks,XERS,18,0,18,-18,2,4,2,2,NASDAQ
4553,12-02-2021 04:00,24 hrs.,stocks,XSPA,6,6,0,6,1,1,0,1,NASDAQ
4553,12-02-2021 04:00,24 hrs.,stocks,ZNGA,104,0,104,-104,1,44,12,1,NASDAQ
4553,12-02-2021 04:00,24 hrs.,stocks,ZSAN,12,12,0,12,2,2,0,2,NASDAQ
4553,12-02-2021 04:00,24 hrs.,stocks,ZYXI,20,20,0,20,1,2,12,1,NASDAQ
4553,12-02-2021 04:00,24 hrs.,Daytrading,GAXY,14,0,14,-14,1,5,0,1,OTC
4553,12-02-2021 04:00,24 hrs.,Daytrading,HMNY,7,0,7,-7,1,1,1,1,OTC
4553,12-02-2021 04:00,24 hrs.,Daytrading,HMPQ,9,9,0,9,1,1,3,1,OTC
4553,12-02-2021 04:00,24 hrs.,Daytrading,INKW,7,7,0,7,1,1,1,1,OTC
4553,12-02-2021 04:00,24 hrs.,Daytrading,MJNA,6,0,6,-6,1,1,0,1,OTC
4553,12-02-2021 04:00,24 hrs.,Daytrading,OWCP,6,0,6,-6,1,1,0,1,OTC
4553,12-02-2021 04:00,24 hrs.,Daytrading,TSTS,6,6,0,6,1,1,0,1,OTC
4553,12-02-2021 04:00,24 hrs.,Daytrading,MNKKQ,6,6,0,6,1,1,0,1,OTC
4553,12-02-2021 04:00,24 hrs.,Daytrading,IGC,680,0,680,-680,1,274,128,1,AMEX
4553,12-02-2021 04:00,24 hrs.,Daytrading,ZOM,6,0,6,-6,1,1,0,1,AMEX
4553,12-02-2021 04:00,24 hrs.,Daytrading,TMBR,680,0,680,-680,1,274,128,1,AMEX
4553,12-02-2021 04:00,24 hrs.,Daytrading,TRXC,6,6,0,6,1,1,0,1,AMEX
4553,12-02-2021 04:00,24 hrs.,Daytrading,AMC,6,6,0,6,1,1,0,1,NYSE
4553,12-02-2021 04:00,24 hrs.,Daytrading,ATH,741,0,741,-741,2,299,135,2,NYSE
4553,12-02-2021 04:00,24 hrs.,Daytrading,BFT,12,12,0,12,1,3,2,1,NYSE
4553,12-02-2021 04:00,24 hrs.,Daytrading,FSD,6,0,6,-6,1,1,0,1,NYSE
4553,12-02-2021 04:00,24 hrs.,Daytrading,FSR,61,0,61,-61,1,25,7,1,NYSE
4553,12-02-2021 04:00,24 hrs.,Daytrading,MSM,19,19,0,19,1,5,5,1,NYSE
4553,12-02-2021 04:00,24 hrs.,Daytrading,PDT,9,0,9,-9,1,2,1,1,NYSE
4553,12-02-2021 04:00,24 hrs.,Daytrading,SCI,6,6,0,6,1,1,0,1,NYSE
4553,12-02-2021 04:00,24 hrs.,Daytrading,TDA,7,7,0,7,1,1,1,1,NYSE
4553,12-02-2021 04:00,24 hrs.,Daytrading,TSM,61,0,61,-61,1,25,7,1,NYSE
4553,12-02-2021 04:00,24 hrs.,Daytrading,WMT,6,0,6,-6,1,1,0,1,NYSE
4553,12-02-2021 04:00,24 hrs.,Daytrading,AMD,61,0,61,-61,1,25,7,1,NASDAQ
4553,12-02-2021 04:00,24 hrs.,Daytrading,CGC,680,0,680,-680,1,274,128,1,NASDAQ
4553,12-02-2021 04:00,24 hrs.,Daytrading,RCM,100,0,100,-100,1,44,8,1,NASDAQ
4553,12-02-2021 04:00,24 hrs.,Daytrading,RUN,7,0,7,-7,1,1,1,1,NASDAQ
4553,12-02-2021 04:00,24 hrs.,wallstreetbets,DMS,6,0,6,-6,1,1,0,1,NYSE
4553,12-02-2021 04:00,24 hrs.,wallstreetbets,DNB,7,7,0,7,1,1,1,1,NYSE
4553,12-02-2021 04:00,24 hrs.,wallstreetbets,DTE,797,797,0,797,1,338,117,1,NYSE
4553,12-02-2021 04:00,24 hrs.,wallstreetbets,EAT,26,20,6,14,4,4,2,4,NYSE
4553,12-02-2021 04:00,24 hrs.,wallstreetbets,EHC,6,0,6,-6,1,1,0,1,NYSE
4553,12-02-2021 04:00,24 hrs.,trakstocks,ELYS,54,0,54,-54,1,17,16,1,NASDAQ
4553,12-02-2021 04:00,24 hrs.,trakstocks,EXPC,31,13,18,-5,2,10,3,2,NASDAQ
4553,12-02-2021 04:00,24 hrs.,trakstocks,FUTU,39,39,0,39,1,12,11,1,NASDAQ
4553,12-02-2021 04:00,24 hrs.,trakstocks,GEVO,63,63,0,63,1,27,5,1,NASDAQ
4553,12-02-2021 04:00,24 hrs.,trakstocks,GHIV,39,39,0,39,1,12,11,1,NASDAQ
4553,12-02-2021 04:00,24 hrs.,trakstocks,GHSI,6,0,6,-6,1,1,0,1,NASDAQ
4553,12-02-2021 04:00,24 hrs.,Daytrading,ACIU,780,0,780,-780,2,318,136,2,NASDAQ
4553,12-02-2021 04:00,24 hrs.,Daytrading,AKER,680,0,680,-680,1,274,128,1,NASDAQ
4553,12-02-2021 04:00,24 hrs.,Daytrading,AMGN,8,8,0,8,1,1,2,1,NASDAQ
4553,12-02-2021 04:00,24 hrs.,Daytrading,APHA,833,42,791,-749,5,319,175,4,NASDAQ
4553,12-02-2021 04:00,24 hrs.,Daytrading,ATOS,18,0,18,-18,1,0,14,1,NASDAQ
4553,12-02-2021 04:00,24 hrs.,Daytrading,AYRO,61,0,61,-61,1,25,7,1,NASDAQ
4553,12-02-2021 04:00,24 hrs.,Daytrading,AZRX,5,5,0,5,1,0,1,1,NASDAQ
4553,12-02-2021 04:00,24 hrs.,Daytrading,CIIC,61,0,61,-61,1,25,7,1,NASDAQ
4553,12-02-2021 04:00,24 hrs.,Daytrading,CLSN,100,0,100,-100,1,44,8,1,NASDAQ
4553,12-02-2021 04:00,24 hrs.,Daytrading,CLVR,680,0,680,-680,1,274,128,1,NASDAQ
4553,12-02-2021 04:00,24 hrs.,Daytrading,COST,6,0,6,-6,1,1,0,1,NASDAQ
4553,12-02-2021 04:00,24 hrs.,Daytrading,CRBP,680,0,680,-680,1,274,128,1,NASDAQ
4553,12-02-2021 04:00,24 hrs.,Daytrading,CRWD,61,0,61,-61,1,25,7,1,NASDAQ
4553,12-02-2021 04:00,24 hrs.,Daytrading,CTRM,100,0,100,-100,1,44,8,1,NASDAQ
4553,12-02-2021 04:00,24 hrs.,Daytrading,DMTK,680,0,680,-680,1,274,128,1,NASDAQ
4553,12-02-2021 04:00,24 hrs.,Daytrading,ENVB,680,0,680,-680,1,274,128,1,NASDAQ
4553,12-02-2021 04:00,24 hrs.,Daytrading,EVFM,12,0,12,-12,2,2,0,1,NASDAQ
4553,12-02-2021 04:00,24 hrs.,Daytrading,GEVO,791,0,791,-791,2,310,163,2,NASDAQ
4553,12-02-2021 04:00,24 hrs.,Daytrading,GNLN,6,0,6,-6,1,1,0,1,NASDAQ
4553,12-02-2021 04:00,24 hrs.,Daytrading,GOEV,61,0,61,-61,1,25,7,1,NASDAQ
4553,12-02-2021 04:00,24 hrs.,Daytrading,GRNQ,680,0,680,-680,1,274,128,1,NASDAQ
4553,12-02-2021 04:00,24 hrs.,Daytrading,IBKR,12,0,12,-12,1,0,8,1,NASDAQ
4553,12-02-2021 04:00,24 hrs.,Daytrading,ITRM,6,6,0,6,1,1,0,1,NASDAQ
4553,12-02-2021 04:00,24 hrs.,wallstreetbets,HRL,614,0,614,-614,1,239,132,1,NYSE
4553,12-02-2021 04:00,24 hrs.,wallstreetbets,HVT,73,55,18,37,12,12,1,5,NYSE
4553,12-02-2021 04:00,24 hrs.,wallstreetbets,IAG,30,0,30,-30,5,5,0,3,NYSE
4553,12-02-2021 04:00,24 hrs.,wallstreetbets,IBM,18,12,6,6,3,3,0,3,NYSE
4553,12-02-2021 04:00,24 hrs.,wallstreetbets,INN,6,6,0,6,1,1,0,1,NYSE
4553,12-02-2021 04:00,24 hrs.,wallstreetbets,IRL,29269,0,29269,-29269,1,13083,3099,1,NYSE
4553,12-02-2021 04:00,24 hrs.,wallstreetbets,ITT,691,0,691,-691,1,215,257,1,NYSE
4553,12-02-2021 04:00,24 hrs.,wallstreetbets,IVC,6,6,0,6,1,1,0,1,NYSE
4553,12-02-2021 04:00,24 hrs.,wallstreetbets,IVR,180,174,6,168,2,61,50,2,NYSE
4553,12-02-2021 04:00,24 hrs.,wallstreetbets,JEF,6,0,6,-6,1,1,0,1,NYSE
4553,12-02-2021 04:00,24 hrs.,wallstreetbets,JKS,6,0,6,-6,1,1,0,1,NYSE
4553,12-02-2021 04:00,24 hrs.,wallstreetbets,JOE,6,6,0,6,1,1,0,1,NYSE
4553,12-02-2021 04:00,24 hrs.,wallstreetbets,KGC,18,18,0,18,3,3,0,2,NYSE
4553,12-02-2021 04:00,24 hrs.,wallstreetbets,LAC,7,7,0,7,1,1,1,1,NYSE
4553,12-02-2021 04:00,24 hrs.,wallstreetbets,LEG,6,6,0,6,1,1,0,1,NYSE
4553,12-02-2021 04:00,24 hrs.,wallstreetbets,LMT,13,13,0,13,2,2,1,2,NYSE
4553,12-02-2021 04:00,24 hrs.,wallstreetbets,LOW,833,827,6,821,7,344,117,7,NYSE
4553,12-02-2021 04:00,24 hrs.,wallstreetbets,LTC,13,7,6,1,2,2,1,2,NYSE
4553,12-02-2021 04:00,24 hrs.,wallstreetbets,LYV,24,0,24,-24,4,4,0,1,NYSE
4553,12-02-2021 04:00,24 hrs.,wallstreetbets,MCD,13,0,13,-13,2,2,1,2,NYSE
4553,12-02-2021 04:00,24 hrs.,wallstreetbets,MEN,6,6,0,6,1,1,0,1,NYSE
4553,12-02-2021 04:00,24 hrs.,wallstreetbets,MIN,7,0,7,-7,1,1,1,1,NYSE
4553,12-02-2021 04:00,24 hrs.,wallstreetbets,MRK,614,0,614,-614,1,239,132,1,NYSE
4553,12-02-2021 04:00,24 hrs.,wallstreetbets,MRO,12,12,0,12,2,2,0,2,NYSE
4553,12-02-2021 04:00,24 hrs.,wallstreetbets,NAT,25,25,0,25,4,4,1,2,NYSE
4553,12-02-2021 04:00,24 hrs.,wallstreetbets,NAV,314,314,0,314,1,95,120,1,NYSE
4553,12-02-2021 04:00,24 hrs.,wallstreetbets,NET,18,18,0,18,3,3,0,2,NYSE
4553,12-02-2021 04:00,24 hrs.,wallstreetbets,NHI,6,0,6,-6,1,1,0,1,NYSE
4553,12-02-2021 04:00,24 hrs.,wallstreetbets,NIO,111,69,42,27,18,18,3,14,NYSE
4553,12-02-2021 04:00,24 hrs.,wallstreetbets,NOC,7,7,0,7,1,1,1,1,NYSE
4553,12-02-2021 04:00,24 hrs.,wallstreetbets,NOK,711,222,489,-267,59,177,121,46,NYSE
4553,12-02-2021 04:00,24 hrs.,wallstreetbets,NVO,66,30,36,-6,7,6,26,4,NYSE
4553,12-02-2021 04:00,24 hrs.,wallstreetbets,OPY,6,6,0,6,1,1,0,1,NYSE
4553,12-02-2021 04:00,24 hrs.,wallstreetbets,OXY,19,13,6,7,3,3,1,3,NYSE
4553,12-02-2021 04:00,24 hrs.,wallstreetbets,PBF,6,0,6,-6,1,1,0,1,NYSE
4553,12-02-2021 04:00,24 hrs.,wallstreetbets,GRUB,6,6,0,6,1,1,0,1,NYSE
4553,12-02-2021 04:00,24 hrs.,wallstreetbets,HEXO,49,12,37,-25,8,8,1,8,NYSE
4553,12-02-2021 04:00,24 hrs.,wallstreetbets,HUYA,172,160,12,148,7,61,22,7,NYSE
4553,12-02-2021 04:00,24 hrs.,wallstreetbets,HYLN,1970,1970,0,1970,59,677,380,50,NYSE
4553,12-02-2021 04:00,24 hrs.,wallstreetbets,IIPR,192,4,188,-184,2,43,98,2,NYSE
4553,12-02-2021 04:00,24 hrs.,wallstreetbets,IPOD,18,0,18,-18,3,3,0,1,NYSE
4553,12-02-2021 04:00,24 hrs.,Daytrading,MARA,680,0,680,-680,1,274,128,1,NASDAQ
4553,12-02-2021 04:00,24 hrs.,Daytrading,MESA,6,0,6,-6,1,1,0,1,NASDAQ
4553,12-02-2021 04:00,24 hrs.,Daytrading,MESO,680,0,680,-680,1,274,128,1,NASDAQ
4553,12-02-2021 04:00,24 hrs.,Daytrading,MNPR,780,0,780,-780,2,318,136,2,NASDAQ
4553,12-02-2021 04:00,24 hrs.,Daytrading,MOGO,680,0,680,-680,1,274,128,1,NASDAQ
4553,12-02-2021 04:00,24 hrs.,Daytrading,MOMO,61,0,61,-61,1,25,7,1,NASDAQ
4553,12-02-2021 04:00,24 hrs.,Daytrading,MTEM,111,0,111,-111,1,36,35,1,NASDAQ
4553,12-02-2021 04:00,24 hrs.,Daytrading,MVIS,680,0,680,-680,1,274,128,1,NASDAQ
4553,12-02-2021 04:00,24 hrs.,Daytrading,NNOX,680,0,680,-680,1,274,128,1,NASDAQ
4553,12-02-2021 04:00,24 hrs.,Daytrading,OCGN,6,6,0,6,1,1,0,1,NASDAQ
4553,12-02-2021 04:00,24 hrs.,Daytrading,PLUS,6,6,0,6,1,1,0,1,NASDAQ
4553,12-02-2021 04:00,24 hrs.,Daytrading,RCMT,780,0,780,-780,2,318,136,2,NASDAQ
4553,12-02-2021 04:00,24 hrs.,Daytrading,RIOT,891,0,891,-891,3,354,171,3,NASDAQ
4553,12-02-2021 04:00,24 hrs.,Daytrading,SNDL,1053,19,1034,-1015,7,404,217,7,NASDAQ
4553,12-02-2021 04:00,24 hrs.,Daytrading,TLRY,828,37,791,-754,4,319,174,4,NASDAQ
4553,12-02-2021 04:00,24 hrs.,Daytrading,ZYNE,111,0,111,-111,1,36,35,1,NASDAQ
4553,12-02-2021 04:00,24 hrs.,trakstocks,BRGO,6,6,0,6,1,1,0,1,OTC
4553,12-02-2021 04:00,24 hrs.,trakstocks,BRLL,6,6,0,6,1,1,0,1,OTC
4553,12-02-2021 04:00,24 hrs.,trakstocks,SGSI,10,10,0,10,1,3,0,1,OTC
4553,12-02-2021 04:00,24 hrs.,trakstocks,SMVI,6,6,0,6,1,1,0,1,OTC
4553,12-02-2021 04:00,24 hrs.,trakstocks,SNPW,12,0,12,-12,1,2,4,1,OTC
4553,12-02-2021 04:00,24 hrs.,trakstocks,DFLYF,60,0,60,-60,1,19,18,1,OTC
4553,12-02-2021 04:00,24 hrs.,trakstocks,HUTMF,16,16,0,16,1,3,6,1,OTC
4553,12-02-2021 04:00,24 hrs.,trakstocks,VVCIF,16,16,0,16,1,4,4,1,OTC
4553,12-02-2021 04:00,24 hrs.,trakstocks,ZOM,60,60,0,60,1,23,10,1,AMEX
4553,12-02-2021 04:00,24 hrs.,trakstocks,TRXC,46,39,7,32,2,18,2,2,AMEX
4553,12-02-2021 04:00,24 hrs.,trakstocks,UAVS,15,0,15,-15,1,4,3,1,AMEX
4553,12-02-2021 04:00,24 hrs.,trakstocks,UUUU,35,35,0,35,1,7,17,1,AMEX
4553,12-02-2021 04:00,24 hrs.,trakstocks,AMC,39,39,0,39,1,12,11,1,NYSE
4553,12-02-2021 04:00,24 hrs.,trakstocks,BFT,39,39,0,39,1,11,13,1,NYSE
4553,12-02-2021 04:00,24 hrs.,trakstocks,GIK,59,0,59,-59,2,19,13,1,NYSE
4553,12-02-2021 04:00,24 hrs.,trakstocks,GME,39,39,0,39,1,12,11,1,NYSE
4553,12-02-2021 04:00,24 hrs.,trakstocks,NAV,39,39,0,39,1,12,11,1,NYSE
4553,12-02-2021 04:00,24 hrs.,trakstocks,PCG,39,39,0,39,1,12,11,1,NYSE
4553,12-02-2021 04:00,24 hrs.,trakstocks,RKT,39,39,0,39,1,12,11,1,NYSE
4553,12-02-2021 04:00,24 hrs.,trakstocks,SOS,41,41,0,41,1,18,1,1,NYSE
4553,12-02-2021 04:00,24 hrs.,trakstocks,SPH,6,6,0,6,1,1,0,1,NYSE
4553,12-02-2021 04:00,24 hrs.,trakstocks,WPF,6,6,0,6,1,1,0,1,NYSE
4553,12-02-2021 04:00,24 hrs.,trakstocks,BEKE,39,39,0,39,1,12,11,1,NYSE
4553,12-02-2021 04:00,24 hrs.,trakstocks,CCIV,29,29,0,29,3,7,3,3,NYSE
4553,12-02-2021 04:00,24 hrs.,trakstocks,FUSE,6,6,0,6,1,1,0,1,NYSE
4553,12-02-2021 04:00,24 hrs.,trakstocks,IIPR,14,14,0,14,1,5,0,1,NYSE
4553,12-02-2021 04:00,24 hrs.,trakstocks,MDLY,6,6,0,6,1,1,0,1,NYSE
4553,12-02-2021 04:00,24 hrs.,trakstocks,STIC,6,6,0,6,1,1,0,1,NYSE
4553,12-02-2021 04:00,24 hrs.,trakstocks,STPK,69,69,0,69,3,22,13,3,NYSE
4553,12-02-2021 04:00,24 hrs.,trakstocks,CFO,217,217,0,217,1,97,19,1,NASDAQ
4553,12-02-2021 04:00,24 hrs.,trakstocks,HOL,39,39,0,39,1,11,13,1,NASDAQ
4553,12-02-2021 04:00,24 hrs.,trakstocks,PTE,15,0,15,-15,1,3,5,1,NASDAQ
4553,12-02-2021 04:00,24 hrs.,trakstocks,ABEO,21,21,0,21,1,7,3,1,NASDAQ
4553,12-02-2021 04:00,24 hrs.,trakstocks,AESE,18,18,0,18,1,5,4,1,NASDAQ
4553,12-02-2021 04:00,24 hrs.,trakstocks,APHA,29,0,29,-29,1,9,7,1,NASDAQ
4553,12-02-2021 04:00,24 hrs.,trakstocks,AYRO,501,227,274,-47,4,191,103,4,NASDAQ
4553,12-02-2021 04:00,24 hrs.,trakstocks,BTBT,13,13,0,13,1,3,3,1,NASDAQ
4553,12-02-2021 04:00,24 hrs.,trakstocks,CHEF,20,20,0,20,1,6,4,1,NASDAQ
4553,12-02-2021 04:00,24 hrs.,trakstocks,CPSH,447,6,441,-435,3,107,221,3,NASDAQ
4553,12-02-2021 04:00,24 hrs.,trakstocks,CRNT,41,0,41,-41,2,11,11,2,NASDAQ
4553,12-02-2021 04:00,24 hrs.,trakstocks,CTRM,128,128,0,128,3,50,16,2,NASDAQ
4553,12-02-2021 04:00,24 hrs.,trakstocks,DARE,6,6,0,6,1,1,0,1,NASDAQ
4553,12-02-2021 04:00,24 hrs.,wallstreetbets,NVTA,12,12,0,12,2,2,0,1,NYSE
4553,12-02-2021 04:00,24 hrs.,wallstreetbets,ORAN,6,0,6,-6,1,1,0,1,NYSE
4553,12-02-2021 04:00,24 hrs.,wallstreetbets,PGRE,6,6,0,6,1,1,0,1,NYSE
4553,12-02-2021 04:00,24 hrs.,wallstreetbets,PINS,634,20,614,-594,4,242,134,4,NYSE
4553,12-02-2021 04:00,24 hrs.,wallstreetbets,PLNT,6,6,0,6,1,1,0,1,NYSE
4553,12-02-2021 04:00,24 hrs.,wallstreetbets,PLTR,1070,1003,67,936,48,316,246,31,NYSE
4553,12-02-2021 04:00,24 hrs.,trakstocks,GMBL,18,18,0,18,1,5,4,1,NASDAQ
4553,12-02-2021 04:00,24 hrs.,wallstreetbets,SNP,6,6,0,6,1,1,0,1,NYSE
4553,12-02-2021 04:00,24 hrs.,wallstreetbets,SOS,271,223,48,175,43,43,13,29,NYSE
4553,12-02-2021 04:00,24 hrs.,wallstreetbets,SPG,52,52,0,52,2,1,42,2,NYSE
4553,12-02-2021 04:00,24 hrs.,wallstreetbets,STM,347,347,0,347,1,121,101,1,NYSE
4553,12-02-2021 04:00,24 hrs.,wallstreetbets,SUN,19,6,13,-7,3,3,1,3,NYSE
4553,12-02-2021 04:00,24 hrs.,wallstreetbets,TAP,626,12,614,-602,3,241,132,3,NYSE
4553,12-02-2021 04:00,24 hrs.,wallstreetbets,TDA,469,469,0,469,3,189,79,3,NYSE
4553,12-02-2021 04:00,24 hrs.,wallstreetbets,TDC,18,6,12,-6,3,3,0,3,NYSE
4553,12-02-2021 04:00,24 hrs.,wallstreetbets,TGT,7,7,0,7,1,1,1,1,NYSE
4553,12-02-2021 04:00,24 hrs.,wallstreetbets,THC,100,82,18,64,4,26,32,4,NYSE
4553,12-02-2021 04:00,24 hrs.,wallstreetbets,THR,14,14,0,14,2,2,2,2,NYSE
4553,12-02-2021 04:00,24 hrs.,wallstreetbets,TPB,6,6,0,6,1,1,0,1,NYSE
4553,12-02-2021 04:00,24 hrs.,wallstreetbets,TPR,6,0,6,-6,1,1,0,1,NYSE
4553,12-02-2021 04:00,24 hrs.,wallstreetbets,TPX,614,0,614,-614,1,239,132,1,NYSE
4553,12-02-2021 04:00,24 hrs.,wallstreetbets,TSE,200,12,188,-176,3,45,98,3,NYSE
4553,12-02-2021 04:00,24 hrs.,wallstreetbets,TSM,1705,1705,0,1705,8,625,423,6,NYSE
4553,12-02-2021 04:00,24 hrs.,wallstreetbets,UBS,1940,186,1754,-1568,8,775,358,6,NYSE
4553,12-02-2021 04:00,24 hrs.,wallstreetbets,UMC,24,18,6,12,4,4,0,4,NYSE
4553,12-02-2021 04:00,24 hrs.,wallstreetbets,USB,508,508,0,508,1,191,122,1,NYSE
4553,12-02-2021 04:00,24 hrs.,wallstreetbets,UTZ,13,0,13,-13,2,2,1,1,NYSE
4553,12-02-2021 04:00,24 hrs.,wallstreetbets,VET,25,13,12,1,4,4,1,4,NYSE
4553,12-02-2021 04:00,24 hrs.,wallstreetbets,VHC,6,6,0,6,1,1,0,1,NYSE
4553,12-02-2021 04:00,24 hrs.,wallstreetbets,VST,18,6,12,-6,3,3,0,3,NYSE
4553,12-02-2021 04:00,24 hrs.,wallstreetbets,WFC,6,6,0,6,1,1,0,1,NYSE
4553,12-02-2021 04:00,24 hrs.,wallstreetbets,WMT,12,12,0,12,2,2,0,2,NYSE
4553,12-02-2021 04:00,24 hrs.,wallstreetbets,WWE,12,0,12,-12,2,2,0,2,NYSE
4553,12-02-2021 04:00,24 hrs.,wallstreetbets,XOM,12,6,6,0,2,2,0,2,NYSE
4553,12-02-2021 04:00,24 hrs.,wallstreetbets,XPO,614,0,614,-614,1,239,132,1,NYSE
4553,12-02-2021 04:00,24 hrs.,wallstreetbets,ABBV,6,6,0,6,1,1,0,1,NYSE
4553,12-02-2021 04:00,24 hrs.,wallstreetbets,ACIC,36,30,6,24,6,6,0,4,NYSE
4553,12-02-2021 04:00,24 hrs.,wallstreetbets,ALUS,6,0,6,-6,1,1,0,1,NYSE
4553,12-02-2021 04:00,24 hrs.,wallstreetbets,AQUA,6,6,0,6,1,1,0,1,NYSE
4553,12-02-2021 04:00,24 hrs.,wallstreetbets,ATUS,6,0,6,-6,1,1,0,1,NYSE
4553,12-02-2021 04:00,24 hrs.,wallstreetbets,BABA,6,6,0,6,1,1,0,1,NYSE
4553,12-02-2021 04:00,24 hrs.,wallstreetbets,BEKE,314,314,0,314,1,95,120,1,NYSE
4553,12-02-2021 04:00,24 hrs.,wallstreetbets,BORR,6,0,6,-6,1,1,0,1,NYSE
4553,12-02-2021 04:00,24 hrs.,wallstreetbets,CCIV,142,130,12,118,21,21,16,18,NYSE
4553,12-02-2021 04:00,24 hrs.,wallstreetbets,CLII,24,12,12,0,4,4,0,4,NYSE
4553,12-02-2021 04:00,24 hrs.,wallstreetbets,CMCM,12,0,12,-12,2,2,0,1,NYSE
4553,12-02-2021 04:00,24 hrs.,wallstreetbets,CODI,6,0,6,-6,1,1,0,1,NYSE
4553,12-02-2021 04:00,24 hrs.,wallstreetbets,CORR,6,6,0,6,1,1,0,1,NYSE
4553,12-02-2021 04:00,24 hrs.,wallstreetbets,COTY,24,6,18,-12,4,4,0,2,NYSE
4553,12-02-2021 04:00,24 hrs.,wallstreetbets,CSPR,6,6,0,6,1,1,0,1,NYSE
4553,12-02-2021 04:00,24 hrs.,wallstreetbets,CURO,13,6,7,-1,2,2,1,2,NYSE
4553,12-02-2021 04:00,24 hrs.,wallstreetbets,DASH,396,396,0,396,1,128,136,1,NYSE
4553,12-02-2021 04:00,24 hrs.,wallstreetbets,DECK,7,7,0,7,1,1,1,1,NYSE
4553,12-02-2021 04:00,24 hrs.,wallstreetbets,DMYD,6,6,0,6,1,1,0,1,NYSE
4553,12-02-2021 04:00,24 hrs.,wallstreetbets,DNMR,19,7,12,-5,3,3,1,2,NYSE
4553,12-02-2021 04:00,24 hrs.,wallstreetbets,DOOR,6,6,0,6,1,1,0,1,NYSE
4553,12-02-2021 04:00,24 hrs.,wallstreetbets,ENLC,6,6,0,6,1,1,0,1,NYSE
4553,12-02-2021 04:00,24 hrs.,wallstreetbets,EXPR,8,0,8,-8,1,2,0,1,NYSE
4553,12-02-2021 04:00,24 hrs.,wallstreetbets,FENG,6,6,0,6,1,1,0,1,NYSE
4553,12-02-2021 04:00,24 hrs.,wallstreetbets,FINV,14,14,0,14,2,2,2,1,NYSE
4553,12-02-2021 04:00,24 hrs.,wallstreetbets,FUBO,20,20,0,20,3,3,2,3,NYSE
4553,12-02-2021 04:00,24 hrs.,wallstreetbets,FUSE,6,0,6,-6,1,1,0,1,NYSE
4553,12-02-2021 04:00,24 hrs.,wallstreetbets,FVRR,14,14,0,14,2,2,2,2,NYSE
4553,12-02-2021 04:00,24 hrs.,wallstreetbets,GNRC,614,0,614,-614,1,239,132,1,NYSE
4553,12-02-2021 04:00,24 hrs.,StockMarket,MNKKQ,12,12,0,12,2,2,0,1,OTC
4553,12-02-2021 04:00,24 hrs.,StockMarket,NXGWF,15,0,15,-15,1,5,1,1,OTC
4553,12-02-2021 04:00,24 hrs.,StockMarket,OILFF,4,0,4,-4,1,0,0,1,OTC
4553,12-02-2021 04:00,24 hrs.,StockMarket,RYCEY,14,6,8,-2,2,1,4,2,OTC
4553,12-02-2021 04:00,24 hrs.,StockMarket,DNN,16,16,0,16,1,3,6,1,AMEX
4553,12-02-2021 04:00,24 hrs.,StockMarket,GSV,24,24,0,24,1,6,8,1,AMEX
4553,12-02-2021 04:00,24 hrs.,StockMarket,IGC,11,11,0,11,1,3,1,1,AMEX
4553,12-02-2021 04:00,24 hrs.,StockMarket,ITP,10,10,0,10,1,2,2,1,AMEX
4553,12-02-2021 04:00,24 hrs.,StockMarket,MCF,6,0,6,-6,1,1,0,1,AMEX
4553,12-02-2021 04:00,24 hrs.,StockMarket,NAK,6,0,6,-6,1,1,0,1,AMEX
4553,12-02-2021 04:00,24 hrs.,StockMarket,REI,10,10,0,10,1,3,0,1,AMEX
4553,12-02-2021 04:00,24 hrs.,StockMarket,URG,16,16,0,16,1,3,6,1,AMEX
4553,12-02-2021 04:00,24 hrs.,StockMarket,ZOM,173,54,119,-65,5,38,77,5,AMEX
4553,12-02-2021 04:00,24 hrs.,StockMarket,GSAT,6,0,6,-6,1,1,0,1,AMEX
4553,12-02-2021 04:00,24 hrs.,StockMarket,NSPR,27,27,0,27,1,8,7,1,AMEX
4553,12-02-2021 04:00,24 hrs.,StockMarket,UUUU,16,16,0,16,1,3,6,1,AMEX
4553,12-02-2021 04:00,24 hrs.,StockMarket,ACB,166,0,166,-166,4,55,40,3,NYSE
4553,12-02-2021 04:00,24 hrs.,StockMarket,ACI,6,6,0,6,1,1,0,1,NYSE
4553,12-02-2021 04:00,24 hrs.,StockMarket,AHC,15,15,0,15,1,3,5,1,NYSE
4553,12-02-2021 04:00,24 hrs.,StockMarket,AMC,209,22,187,-165,9,78,17,8,NYSE
4553,12-02-2021 04:00,24 hrs.,StockMarket,BEP,25,0,25,-25,1,3,15,1,NYSE
4553,12-02-2021 04:00,24 hrs.,StockMarket,CHL,6,6,0,6,1,1,0,1,NYSE
4553,12-02-2021 04:00,24 hrs.,StockMarket,CIA,119,119,0,119,1,51,13,1,NYSE
4553,12-02-2021 04:00,24 hrs.,StockMarket,CMI,47,47,0,47,1,15,13,1,NYSE
4553,12-02-2021 04:00,24 hrs.,StockMarket,DAC,4,0,4,-4,1,0,0,1,NYSE
4553,12-02-2021 04:00,24 hrs.,StockMarket,FAF,144,6,138,-132,3,47,38,2,NYSE
4553,12-02-2021 04:00,24 hrs.,StockMarket,GME,312,107,205,-98,13,106,48,12,NYSE
4553,12-02-2021 04:00,24 hrs.,StockMarket,HRL,22,0,22,-22,1,8,2,1,NYSE
4553,12-02-2021 04:00,24 hrs.,StockMarket,HVT,4,0,4,-4,1,0,0,1,NYSE
4553,12-02-2021 04:00,24 hrs.,StockMarket,IBM,119,119,0,119,1,51,13,1,NYSE
4553,12-02-2021 04:00,24 hrs.,StockMarket,KGC,6,6,0,6,1,1,0,1,NYSE
4553,12-02-2021 04:00,24 hrs.,trakstocks,GMDA,12,12,0,12,1,1,6,1,NASDAQ
4553,12-02-2021 04:00,24 hrs.,trakstocks,IBKR,39,39,0,39,1,12,11,1,NASDAQ
4553,12-02-2021 04:00,24 hrs.,trakstocks,INMD,8,8,0,8,1,2,0,1,NASDAQ
4553,12-02-2021 04:00,24 hrs.,trakstocks,INPX,18,18,0,18,1,7,0,1,NASDAQ
4553,12-02-2021 04:00,24 hrs.,trakstocks,IRBT,25,25,0,25,1,7,7,1,NASDAQ
4553,12-02-2021 04:00,24 hrs.,trakstocks,LKCO,16,16,0,16,1,5,2,1,NASDAQ
4553,12-02-2021 04:00,24 hrs.,trakstocks,MARA,29,29,0,29,2,6,9,2,NASDAQ
4553,12-02-2021 04:00,24 hrs.,trakstocks,MSTR,4,4,0,4,1,0,0,1,NASDAQ
4553,12-02-2021 04:00,24 hrs.,trakstocks,OBSV,12,0,12,-12,1,4,0,1,NASDAQ
4553,12-02-2021 04:00,24 hrs.,trakstocks,RIOT,35,35,0,35,3,7,9,3,NASDAQ
4553,12-02-2021 04:00,24 hrs.,trakstocks,SNGX,22,22,0,22,1,7,4,1,NASDAQ
4553,12-02-2021 04:00,24 hrs.,trakstocks,THCB,186,0,186,-186,1,76,30,1,NASDAQ
4553,12-02-2021 04:00,24 hrs.,trakstocks,TRCH,6,0,6,-6,1,1,0,1,NASDAQ
4553,12-02-2021 04:00,24 hrs.,trakstocks,TTCF,20,20,0,20,1,6,4,1,NASDAQ
4553,12-02-2021 04:00,24 hrs.,trakstocks,USWS,54,54,0,54,2,21,4,2,NASDAQ
4553,12-02-2021 04:00,24 hrs.,trakstocks,VRME,6,6,0,6,1,1,0,1,NASDAQ
4553,12-02-2021 04:00,24 hrs.,trakstocks,VTRS,7,7,0,7,1,1,1,1,NASDAQ
4553,12-02-2021 04:00,24 hrs.,wallstreetbets,IPOE,66,12,54,-42,11,11,0,9,NYSE
4553,12-02-2021 04:00,24 hrs.,wallstreetbets,IPOF,18,0,18,-18,3,3,0,1,NYSE
4553,12-02-2021 04:00,24 hrs.,wallstreetbets,JMIA,12,0,12,-12,2,2,0,2,NYSE
4553,12-02-2021 04:00,24 hrs.,wallstreetbets,JNPR,6,0,6,-6,1,1,0,1,NYSE
4553,12-02-2021 04:00,24 hrs.,wallstreetbets,KODK,38,6,32,-26,6,6,2,5,NYSE
4553,12-02-2021 04:00,24 hrs.,wallstreetbets,LAIX,13,0,13,-13,2,2,1,2,NYSE
4553,12-02-2021 04:00,24 hrs.,wallstreetbets,LDOS,6,6,0,6,1,1,0,1,NYSE
4553,12-02-2021 04:00,24 hrs.,wallstreetbets,LEAP,12,6,6,0,2,2,0,2,NYSE
4553,12-02-2021 04:00,24 hrs.,wallstreetbets,LGVW,54,34,20,14,8,8,6,6,NYSE
4553,12-02-2021 04:00,24 hrs.,wallstreetbets,LMND,12,12,0,12,2,2,0,1,NYSE
4553,12-02-2021 04:00,24 hrs.,wallstreetbets,LSPD,7,7,0,7,1,1,1,1,NYSE
4553,12-02-2021 04:00,24 hrs.,wallstreetbets,LUMN,45,45,0,45,4,3,23,4,NYSE
4553,12-02-2021 04:00,24 hrs.,wallstreetbets,MAIN,14,14,0,14,2,2,2,2,NYSE
4553,12-02-2021 04:00,24 hrs.,wallstreetbets,MAXR,6,6,0,6,1,1,0,1,NYSE
4553,12-02-2021 04:00,24 hrs.,wallstreetbets,MDLY,19,19,0,19,3,3,1,1,NYSE
4553,12-02-2021 04:00,24 hrs.,wallstreetbets,NRGX,6,0,6,-6,1,1,0,1,NYSE
4553,12-02-2021 04:00,24 hrs.,wallstreetbets,YETI,12,0,12,-12,2,2,0,1,NYSE
4553,12-02-2021 04:00,24 hrs.,wallstreetbets,AAL,81,27,54,-27,13,13,3,6,NASDAQ
4553,12-02-2021 04:00,24 hrs.,wallstreetbets,ADI,347,347,0,347,1,121,101,1,NASDAQ
4553,12-02-2021 04:00,24 hrs.,wallstreetbets,ADV,6,6,0,6,1,1,0,1,NASDAQ
4553,12-02-2021 04:00,24 hrs.,wallstreetbets,AMD,1674,1643,31,1612,23,570,442,22,NASDAQ
4553,12-02-2021 04:00,24 hrs.,wallstreetbets,AQB,12,6,6,0,2,2,0,2,NASDAQ
4553,12-02-2021 04:00,24 hrs.,wallstreetbets,ASO,24,12,12,0,4,4,0,3,NASDAQ
4553,12-02-2021 04:00,24 hrs.,wallstreetbets,AWH,13,13,0,13,2,2,1,1,NASDAQ
4553,12-02-2021 04:00,24 hrs.,wallstreetbets,AZN,24,18,6,12,4,4,0,4,NASDAQ
4553,12-02-2021 04:00,24 hrs.,wallstreetbets,BBC,12,6,6,0,2,2,0,2,NASDAQ
4553,12-02-2021 04:00,24 hrs.,wallstreetbets,BFI,25,25,0,25,4,4,1,2,NASDAQ
4553,12-02-2021 04:00,24 hrs.,wallstreetbets,CGC,29969,646,29323,-28677,20,13285,3319,18,NASDAQ
4553,12-02-2021 04:00,24 hrs.,wallstreetbets,CME,325,0,325,-325,3,131,51,2,NASDAQ
4553,12-02-2021 04:00,24 hrs.,wallstreetbets,DYN,6,6,0,6,1,1,0,1,NASDAQ
4553,12-02-2021 04:00,24 hrs.,wallstreetbets,ESG,8,8,0,8,1,1,2,1,NASDAQ
4553,12-02-2021 04:00,24 hrs.,wallstreetbets,FLL,18,18,0,18,3,3,0,2,NASDAQ
4553,12-02-2021 04:00,24 hrs.,wallstreetbets,FWP,6,6,0,6,1,1,0,1,NASDAQ
4553,12-02-2021 04:00,24 hrs.,wallstreetbets,GBT,6,6,0,6,1,1,0,1,NASDAQ
4553,12-02-2021 04:00,24 hrs.,wallstreetbets,GSM,12,6,6,0,2,2,0,2,NASDAQ
4553,12-02-2021 04:00,24 hrs.,wallstreetbets,HAS,87,57,30,27,14,14,3,12,NASDAQ
4553,12-02-2021 04:00,24 hrs.,wallstreetbets,HPK,12,0,12,-12,2,2,0,2,NASDAQ
4553,12-02-2021 04:00,24 hrs.,wallstreetbets,III,6,0,6,-6,1,1,0,1,NASDAQ
4553,12-02-2021 04:00,24 hrs.,wallstreetbets,INO,81,69,12,57,12,12,9,10,NASDAQ
4553,12-02-2021 04:00,24 hrs.,wallstreetbets,IPA,13,7,6,1,2,2,1,2,NASDAQ
4553,12-02-2021 04:00,24 hrs.,wallstreetbets,JFU,18,6,12,-6,3,3,0,3,NASDAQ
4553,12-02-2021 04:00,24 hrs.,wallstreetbets,KHC,626,12,614,-602,3,241,132,3,NASDAQ
4553,12-02-2021 04:00,24 hrs.,wallstreetbets,MOR,61,0,61,-61,1,12,33,1,NASDAQ
4553,12-02-2021 04:00,24 hrs.,wallstreetbets,MWK,8,8,0,8,1,2,0,1,NASDAQ
4553,12-02-2021 04:00,24 hrs.,wallstreetbets,NPA,7,7,0,7,1,1,1,1,NASDAQ
4553,12-02-2021 04:00,24 hrs.,wallstreetbets,OGI,628,373,255,118,51,125,174,45,NASDAQ
4553,12-02-2021 04:00,24 hrs.,wallstreetbets,OLB,24,0,24,-24,4,4,0,2,NASDAQ
4553,12-02-2021 04:00,24 hrs.,trakstocks,HOLUW,7,0,7,-7,1,1,1,1,NASDAQ
4553,12-02-2021 04:00,24 hrs.,StockMarket,BIIO,6,0,6,-6,1,1,0,1,OTC
4553,12-02-2021 04:00,24 hrs.,StockMarket,BLDV,15,0,15,-15,1,3,5,1,OTC
4553,12-02-2021 04:00,24 hrs.,StockMarket,BOTY,35,31,4,27,3,3,17,2,OTC
4553,12-02-2021 04:00,24 hrs.,StockMarket,CAPC,6,0,6,-6,1,1,0,1,OTC
4553,12-02-2021 04:00,24 hrs.,StockMarket,FMCC,38,38,0,38,1,8,18,1,OTC
4553,12-02-2021 04:00,24 hrs.,StockMarket,FNMA,38,38,0,38,1,8,18,1,OTC
4553,12-02-2021 04:00,24 hrs.,StockMarket,GAXY,50,22,28,-6,2,13,16,2,OTC
4553,12-02-2021 04:00,24 hrs.,StockMarket,GDMK,6,0,6,-6,1,1,0,1,OTC
4553,12-02-2021 04:00,24 hrs.,StockMarket,GTSO,11,11,0,11,1,3,1,1,OTC
4553,12-02-2021 04:00,24 hrs.,StockMarket,HEMP,6,0,6,-6,1,1,0,1,OTC
4553,12-02-2021 04:00,24 hrs.,StockMarket,HMNY,19,0,19,-19,1,6,3,1,OTC
4553,12-02-2021 04:00,24 hrs.,StockMarket,ISWH,6,0,6,-6,1,1,0,1,OTC
4553,12-02-2021 04:00,24 hrs.,StockMarket,LINK,28,0,28,-28,2,9,2,2,OTC
4553,12-02-2021 04:00,24 hrs.,StockMarket,MINE,138,0,138,-138,2,46,38,1,OTC
4553,12-02-2021 04:00,24 hrs.,StockMarket,MJNA,6,0,6,-6,1,1,0,1,OTC
4553,12-02-2021 04:00,24 hrs.,StockMarket,MOST,22,0,22,-22,1,8,2,1,OTC
4553,12-02-2021 04:00,24 hrs.,StockMarket,NSPX,6,0,6,-6,1,1,0,1,OTC
4553,12-02-2021 04:00,24 hrs.,StockMarket,OPMZ,6,0,6,-6,1,1,0,1,OTC
4553,12-02-2021 04:00,24 hrs.,StockMarket,PURA,6,0,6,-6,1,1,0,1,OTC
4553,12-02-2021 04:00,24 hrs.,StockMarket,ROTH,58,0,58,-58,1,26,2,1,OTC
4553,12-02-2021 04:00,24 hrs.,StockMarket,RTON,12,6,6,0,2,2,0,2,OTC
4553,12-02-2021 04:00,24 hrs.,StockMarket,SGMD,18,12,6,6,2,3,4,2,OTC
4553,12-02-2021 04:00,24 hrs.,StockMarket,SIRC,6,0,6,-6,1,1,0,1,OTC
4553,12-02-2021 04:00,24 hrs.,StockMarket,SRMX,6,0,6,-6,1,1,0,1,OTC
4553,12-02-2021 04:00,24 hrs.,StockMarket,SUIC,6,6,0,6,1,1,0,1,OTC
4553,12-02-2021 04:00,24 hrs.,StockMarket,VIBI,13,0,13,-13,1,0,9,1,OTC
4553,12-02-2021 04:00,24 hrs.,StockMarket,XALL,6,0,6,-6,1,1,0,1,OTC
4553,12-02-2021 04:00,24 hrs.,StockMarket,ABEPF,6,0,6,-6,1,1,0,1,OTC
4553,12-02-2021 04:00,24 hrs.,StockMarket,CLUBQ,21,9,12,-3,2,2,9,2,OTC
4553,12-02-2021 04:00,24 hrs.,StockMarket,CWGYF,27,0,27,-27,1,0,23,1,OTC
4553,12-02-2021 04:00,24 hrs.,StockMarket,HITIF,64,64,0,64,1,14,32,1,OTC
4553,12-02-2021 04:00,24 hrs.,StockMarket,HRVOF,6,0,6,-6,1,1,0,1,OTC
4553,12-02-2021 04:00,24 hrs.,StockMarket,AVLR,47,47,0,47,1,15,13,1,NYSE
4553,12-02-2021 04:00,24 hrs.,StockMarket,CACI,119,119,0,119,1,51,13,1,NYSE
4553,12-02-2021 04:00,24 hrs.,wallstreetbets,OPK,6,0,6,-6,1,1,0,1,NASDAQ
4553,12-02-2021 04:00,24 hrs.,wallstreetbets,OPT,13,13,0,13,2,2,1,2,NASDAQ
4553,12-02-2021 04:00,24 hrs.,wallstreetbets,PEP,614,0,614,-614,1,239,132,1,NASDAQ
4553,12-02-2021 04:00,24 hrs.,wallstreetbets,QQQ,803,803,0,803,2,339,117,2,NASDAQ
4553,12-02-2021 04:00,24 hrs.,wallstreetbets,QTT,6,0,6,-6,1,1,0,1,NASDAQ
4553,12-02-2021 04:00,24 hrs.,wallstreetbets,RCM,6,6,0,6,1,1,0,1,NASDAQ
4553,12-02-2021 04:00,24 hrs.,wallstreetbets,RUN,25,19,6,13,4,4,1,4,NASDAQ
4553,12-02-2021 04:00,24 hrs.,wallstreetbets,SDC,6,6,0,6,1,1,0,1,NASDAQ
4553,12-02-2021 04:00,24 hrs.,wallstreetbets,SLP,6,0,6,-6,1,1,0,1,NASDAQ
4553,12-02-2021 04:00,24 hrs.,wallstreetbets,SLS,6,6,0,6,1,1,0,1,NASDAQ
4553,12-02-2021 04:00,24 hrs.,wallstreetbets,SMH,12,12,0,12,2,2,0,2,NASDAQ
4553,12-02-2021 04:00,24 hrs.,wallstreetbets,TER,12,6,6,0,2,2,0,2,NASDAQ
4553,12-02-2021 04:00,24 hrs.,wallstreetbets,TLS,6,0,6,-6,1,1,0,1,NASDAQ
4553,12-02-2021 04:00,24 hrs.,wallstreetbets,TTD,6,0,6,-6,1,1,0,1,NASDAQ
4553,12-02-2021 04:00,24 hrs.,wallstreetbets,TXN,347,347,0,347,1,121,101,1,NASDAQ
4553,12-02-2021 04:00,24 hrs.,wallstreetbets,UAL,7,7,0,7,1,1,1,1,NASDAQ
4553,12-02-2021 04:00,24 hrs.,wallstreetbets,VFF,232,20,212,-192,8,50,100,7,NASDAQ
4553,12-02-2021 04:00,24 hrs.,wallstreetbets,WBA,6,0,6,-6,1,1,0,1,NASDAQ
4553,12-02-2021 04:00,24 hrs.,wallstreetbets,WDC,34,34,0,34,2,10,6,1,NASDAQ
4553,12-02-2021 04:00,24 hrs.,wallstreetbets,WNW,12,6,6,0,2,2,0,2,NASDAQ
4553,12-02-2021 04:00,24 hrs.,wallstreetbets,WVE,6,6,0,6,1,1,0,1,NASDAQ
4553,12-02-2021 04:00,24 hrs.,wallstreetbets,AACG,6,0,6,-6,1,1,0,1,NASDAQ
4553,12-02-2021 04:00,24 hrs.,wallstreetbets,AAPL,1660,1527,133,1394,11,651,314,11,NASDAQ
4553,12-02-2021 04:00,24 hrs.,wallstreetbets,ABEO,6,6,0,6,1,1,0,1,NASDAQ
4553,12-02-2021 04:00,24 hrs.,wallstreetbets,ABIO,7,7,0,7,1,1,1,1,NASDAQ
4553,12-02-2021 04:00,24 hrs.,wallstreetbets,ABNB,7,7,0,7,1,1,1,1,NASDAQ
4553,12-02-2021 04:00,24 hrs.,wallstreetbets,ACEV,6,0,6,-6,1,1,0,1,NASDAQ
4553,12-02-2021 04:00,24 hrs.,wallstreetbets,ACIU,54,12,42,-30,9,9,0,6,NASDAQ
4553,12-02-2021 04:00,24 hrs.,wallstreetbets,ACRX,6,6,0,6,1,1,0,1,NASDAQ
4553,12-02-2021 04:00,24 hrs.,StockMarket,LAC,6,0,6,-6,1,1,0,1,NYSE
4553,12-02-2021 04:00,24 hrs.,StockMarket,MRK,22,0,22,-22,1,8,2,1,NYSE
4553,12-02-2021 04:00,24 hrs.,StockMarket,NIO,73,0,73,-73,3,26,9,3,NYSE
4553,12-02-2021 04:00,24 hrs.,StockMarket,NOK,26,0,26,-26,2,5,8,2,NYSE
4553,12-02-2021 04:00,24 hrs.,StockMarket,NSA,119,119,0,119,1,51,13,1,NYSE
4553,12-02-2021 04:00,24 hrs.,StockMarket,PFE,6,0,6,-6,1,1,0,1,NYSE
4553,12-02-2021 04:00,24 hrs.,StockMarket,QSR,22,0,22,-22,1,8,2,1,NYSE
4553,12-02-2021 04:00,24 hrs.,StockMarket,RMO,7,0,7,-7,1,0,3,1,NYSE
4553,12-02-2021 04:00,24 hrs.,StockMarket,RSI,6,6,0,6,1,1,0,1,NYSE
4553,12-02-2021 04:00,24 hrs.,wallstreetbets,PRTY,6,0,6,-6,1,1,0,1,NYSE
4553,12-02-2021 04:00,24 hrs.,wallstreetbets,PSXP,12,12,0,12,2,2,0,2,NYSE
4553,12-02-2021 04:00,24 hrs.,wallstreetbets,PUMP,6,6,0,6,1,1,0,1,NYSE
4553,12-02-2021 04:00,24 hrs.,wallstreetbets,QUAD,8,8,0,8,1,1,2,1,NYSE
4553,12-02-2021 04:00,24 hrs.,wallstreetbets,SCVX,6,6,0,6,1,1,0,1,NYSE
4553,12-02-2021 04:00,24 hrs.,wallstreetbets,SHAK,18,18,0,18,3,3,0,1,NYSE
4553,12-02-2021 04:00,24 hrs.,wallstreetbets,SHOP,822,804,18,786,5,342,118,3,NYSE
4553,12-02-2021 04:00,24 hrs.,wallstreetbets,SKLZ,6,0,6,-6,1,1,0,1,NYSE
4553,12-02-2021 04:00,24 hrs.,wallstreetbets,SLCA,6,6,0,6,1,1,0,1,NYSE
4553,12-02-2021 04:00,24 hrs.,wallstreetbets,SNOW,6,0,6,-6,1,1,0,1,NYSE
4553,12-02-2021 04:00,24 hrs.,wallstreetbets,SNPR,6,6,0,6,1,1,0,1,NYSE
4553,12-02-2021 04:00,24 hrs.,wallstreetbets,SPCE,2352,579,1773,-1194,29,924,388,26,NYSE
4553,12-02-2021 04:00,24 hrs.,wallstreetbets,SPOT,7,7,0,7,1,1,1,1,NYSE
4553,12-02-2021 04:00,24 hrs.,wallstreetbets,STNG,6,6,0,6,1,1,0,1,NYSE
4553,12-02-2021 04:00,24 hrs.,wallstreetbets,STPK,12,12,0,12,2,2,0,2,NYSE
4553,12-02-2021 04:00,24 hrs.,wallstreetbets,TEVA,30,6,24,-18,5,5,0,4,NYSE
4553,12-02-2021 04:00,24 hrs.,wallstreetbets,TWTR,6,6,0,6,1,1,0,1,NYSE
4553,12-02-2021 04:00,24 hrs.,wallstreetbets,UBER,633,13,620,-607,4,242,133,4,NYSE
4553,12-02-2021 04:00,24 hrs.,wallstreetbets,UNVR,6,6,0,6,1,1,0,1,NYSE
4553,12-02-2021 04:00,24 hrs.,wallstreetbets,VSTO,8,8,0,8,1,1,2,1,NYSE
4553,12-02-2021 04:00,24 hrs.,wallstreetbets,WELL,264,264,0,264,1,101,58,1,NYSE
4553,12-02-2021 04:00,24 hrs.,wallstreetbets,WORK,14,14,0,14,2,2,2,2,NYSE
4553,12-02-2021 04:00,24 hrs.,wallstreetbets,XPEV,6,6,0,6,1,1,0,1,NYSE
4553,12-02-2021 04:00,24 hrs.,wallstreetbets,YALA,6,0,6,-6,1,1,0,1,NYSE
4553,12-02-2021 04:00,24 hrs.,StockMarket,UBER,83,47,36,11,3,24,23,3,NYSE
4553,12-02-2021 04:00,24 hrs.,StockMarket,WELL,6,0,6,-6,1,1,0,1,NYSE
4553,12-02-2021 04:00,24 hrs.,StockMarket,XPEV,119,119,0,119,1,51,13,1,NYSE
4553,12-02-2021 04:00,24 hrs.,StockMarket,AMD,6,6,0,6,1,1,0,1,NASDAQ
4553,12-02-2021 04:00,24 hrs.,StockMarket,API,21,0,21,-21,3,4,1,1,NASDAQ
4553,12-02-2021 04:00,24 hrs.,StockMarket,AQB,4,0,4,-4,1,0,0,1,NASDAQ
4553,12-02-2021 04:00,24 hrs.,StockMarket,AZN,22,0,22,-22,1,8,2,1,NASDAQ
4553,12-02-2021 04:00,24 hrs.,StockMarket,CGC,144,0,144,-144,3,47,38,2,NASDAQ
4553,12-02-2021 04:00,24 hrs.,StockMarket,KHC,22,0,22,-22,1,8,2,1,NASDAQ
4553,12-02-2021 04:00,24 hrs.,StockMarket,OGI,34,0,34,-34,3,10,2,3,NASDAQ
4553,12-02-2021 04:00,24 hrs.,StockMarket,PEP,22,0,22,-22,1,8,2,1,NASDAQ
4553,12-02-2021 04:00,24 hrs.,StockMarket,QQQ,23,0,23,-23,1,9,1,1,NASDAQ
4553,12-02-2021 04:00,24 hrs.,StockMarket,RCM,192,6,186,-180,2,67,50,2,NASDAQ
4553,12-02-2021 04:00,24 hrs.,StockMarket,SDC,15,15,0,15,1,3,5,1,NASDAQ
4553,12-02-2021 04:00,24 hrs.,StockMarket,SND,10,10,0,10,1,3,0,1,NASDAQ
4553,12-02-2021 04:00,24 hrs.,StockMarket,VFF,86,18,68,-50,5,29,8,3,NASDAQ
4553,12-02-2021 04:00,24 hrs.,StockMarket,AAOI,6,0,6,-6,1,1,0,1,NASDAQ
4553,12-02-2021 04:00,24 hrs.,StockMarket,AAPL,64,47,17,30,3,16,20,3,NASDAQ
4553,12-02-2021 04:00,24 hrs.,StockMarket,ABIO,6,6,0,6,1,1,0,1,NASDAQ
4553,12-02-2021 04:00,24 hrs.,StockMarket,ACIU,186,0,186,-186,1,66,50,1,NASDAQ
4553,12-02-2021 04:00,24 hrs.,StockMarket,AGTC,73,51,22,29,2,20,25,2,NASDAQ
4553,12-02-2021 04:00,24 hrs.,StockMarket,APHA,909,591,318,273,14,292,269,12,NASDAQ
4553,12-02-2021 04:00,24 hrs.,StockMarket,ASYS,4,4,0,4,1,0,0,1,NASDAQ
4553,12-02-2021 04:00,24 hrs.,StockMarket,ATOM,24,24,0,24,1,9,2,1,NASDAQ
4553,12-02-2021 04:00,24 hrs.,StockMarket,AVXL,6,6,0,6,1,1,0,1,NASDAQ
4553,12-02-2021 04:00,24 hrs.,StockMarket,BBBY,6,0,6,-6,1,1,0,1,NASDAQ
4553,12-02-2021 04:00,24 hrs.,StockMarket,BSQR,13,13,0,13,1,0,9,1,NASDAQ
4553,12-02-2021 04:00,24 hrs.,StockMarket,CECE,12,12,0,12,1,4,0,1,NASDAQ
4553,12-02-2021 04:00,24 hrs.,StockMarket,CLNE,47,47,0,47,1,15,13,1,NASDAQ
4553,12-02-2021 04:00,24 hrs.,StockMarket,CLSN,192,6,186,-180,2,67,50,2,NASDAQ
4553,12-02-2021 04:00,24 hrs.,StockMarket,CTHR,15,15,0,15,1,5,1,1,NASDAQ
4553,12-02-2021 04:00,24 hrs.,StockMarket,CTRM,249,57,192,-135,7,80,61,7,NASDAQ
4553,12-02-2021 04:00,24 hrs.,StockMarket,EDIT,71,0,71,-71,2,21,21,2,NASDAQ
4553,12-02-2021 04:00,24 hrs.,StockMarket,FANG,65,0,65,-65,1,26,9,1,NASDAQ
4553,12-02-2021 04:00,24 hrs.,StockMarket,FNKO,17,17,0,17,1,6,1,1,NASDAQ
4553,12-02-2021 04:00,24 hrs.,StockMarket,GHSI,8,0,8,-8,1,2,0,1,NASDAQ
4553,12-02-2021 04:00,24 hrs.,StockMarket,GNLN,6,0,6,-6,1,1,0,1,NASDAQ
4553,12-02-2021 04:00,24 hrs.,StockMarket,GOLD,138,0,138,-138,2,46,38,1,NASDAQ
4553,12-02-2021 04:00,24 hrs.,StockMarket,GRWG,10,0,10,-10,2,1,0,2,NASDAQ
4553,12-02-2021 04:00,24 hrs.,StockMarket,HTBX,12,0,12,-12,2,2,0,1,NASDAQ
4553,12-02-2021 04:00,24 hrs.,StockMarket,IBKR,6,6,0,6,1,1,0,1,NASDAQ
4553,12-02-2021 04:00,24 hrs.,StockMarket,IMMR,4,0,4,-4,1,0,0,1,NASDAQ
4553,12-02-2021 04:00,24 hrs.,StockMarket,INMD,47,47,0,47,1,15,13,1,NASDAQ
4553,12-02-2021 04:00,24 hrs.,StockMarket,IRBT,22,0,22,-22,1,8,2,1,NASDAQ
4553,12-02-2021 04:00,24 hrs.,StockMarket,LIVE,22,0,22,-22,1,8,2,1,NASDAQ
4553,12-02-2021 04:00,24 hrs.,StockMarket,LYFT,47,47,0,47,1,15,13,1,NASDAQ
4553,12-02-2021 04:00,24 hrs.,StockMarket,MGNI,4,0,4,-4,1,0,0,1,NASDAQ
4553,12-02-2021 04:00,24 hrs.,StockMarket,MNPR,186,0,186,-186,1,66,50,1,NASDAQ
4553,12-02-2021 04:00,24 hrs.,StockMarket,MSFT,45,0,45,-45,2,17,3,2,NASDAQ
4553,12-02-2021 04:00,24 hrs.,StockMarket,MVIS,33,0,33,-33,2,8,9,2,NASDAQ
4553,12-02-2021 04:00,24 hrs.,StockMarket,NAKD,6,0,6,-6,1,1,0,1,NASDAQ
4553,12-02-2021 04:00,24 hrs.,StockMarket,OCGN,12,0,12,-12,2,2,0,1,NASDAQ
4553,12-02-2021 04:00,24 hrs.,StockMarket,OPTT,28,28,0,28,1,8,8,1,NASDAQ
4553,12-02-2021 04:00,24 hrs.,StockMarket,PLAY,46,0,46,-46,1,18,6,1,NASDAQ
4553,12-02-2021 04:00,24 hrs.,StockMarket,SBE,6,0,6,-6,1,1,0,1,NYSE
4553,12-02-2021 04:00,24 hrs.,StockMarket,SKY,26,26,0,26,1,6,10,1,NYSE
4553,12-02-2021 04:00,24 hrs.,StockMarket,SOS,12,12,0,12,2,2,0,1,NYSE
4553,12-02-2021 04:00,24 hrs.,StockMarket,TAP,22,0,22,-22,1,8,2,1,NYSE
4553,12-02-2021 04:00,24 hrs.,StockMarket,TMX,4,0,4,-4,1,0,0,1,NYSE
4553,12-02-2021 04:00,24 hrs.,StockMarket,TPX,22,0,22,-22,1,8,2,1,NYSE
4553,12-02-2021 04:00,24 hrs.,StockMarket,TSE,26,26,0,26,2,9,0,2,NYSE
4553,12-02-2021 04:00,24 hrs.,StockMarket,UBS,47,47,0,47,1,15,13,1,NYSE
4553,12-02-2021 04:00,24 hrs.,StockMarket,XPO,22,0,22,-22,1,8,2,1,NYSE
4553,12-02-2021 04:00,24 hrs.,StockMarket,ACIC,4,4,0,4,1,0,0,1,NYSE
4553,12-02-2021 04:00,24 hrs.,StockMarket,SONO,69,47,22,25,2,23,15,2,NASDAQ
4553,12-02-2021 04:00,24 hrs.,wallstreetbets,ACST,6,6,0,6,1,1,0,1,NASDAQ
4553,12-02-2021 04:00,24 hrs.,wallstreetbets,ADMA,6,0,6,-6,1,1,0,1,NASDAQ
4553,12-02-2021 04:00,24 hrs.,wallstreetbets,ADMP,12,6,6,0,2,2,0,2,NASDAQ
4553,12-02-2021 04:00,24 hrs.,wallstreetbets,ADTX,7,0,7,-7,1,1,1,1,NASDAQ
4553,12-02-2021 04:00,24 hrs.,wallstreetbets,ADXS,12,6,6,0,2,2,0,2,NASDAQ
4553,12-02-2021 04:00,24 hrs.,wallstreetbets,AESE,30,30,0,30,5,5,0,2,NASDAQ
4553,12-02-2021 04:00,24 hrs.,wallstreetbets,AEZS,6,6,0,6,1,1,0,1,NASDAQ
4553,12-02-2021 04:00,24 hrs.,wallstreetbets,AGRX,6,6,0,6,1,1,0,1,NASDAQ
4553,12-02-2021 04:00,24 hrs.,wallstreetbets,AGTC,80,38,42,-4,13,13,2,12,NASDAQ
4553,12-02-2021 04:00,24 hrs.,wallstreetbets,AIKI,19,13,6,7,3,3,1,2,NASDAQ
4553,12-02-2021 04:00,24 hrs.,wallstreetbets,AKAM,6,6,0,6,1,1,0,1,NASDAQ
4553,12-02-2021 04:00,24 hrs.,wallstreetbets,AKBA,12,0,12,-12,2,2,0,1,NASDAQ
4553,12-02-2021 04:00,24 hrs.,wallstreetbets,AKER,12,6,6,0,2,2,0,2,NASDAQ
4553,12-02-2021 04:00,24 hrs.,wallstreetbets,ALDX,6,0,6,-6,1,1,0,1,NASDAQ
4553,12-02-2021 04:00,24 hrs.,wallstreetbets,ALGM,6,6,0,6,1,1,0,1,NASDAQ
4553,12-02-2021 04:00,24 hrs.,wallstreetbets,ALJJ,7,7,0,7,1,1,1,1,NASDAQ
4553,12-02-2021 04:00,24 hrs.,wallstreetbets,ALOT,6,6,0,6,1,1,0,1,NASDAQ
4553,12-02-2021 04:00,24 hrs.,wallstreetbets,AMKR,313,313,0,313,5,104,85,3,NASDAQ
4553,12-02-2021 04:00,24 hrs.,wallstreetbets,AMRK,6,6,0,6,1,1,0,1,NASDAQ
4553,12-02-2021 04:00,24 hrs.,wallstreetbets,AMRN,6,6,0,6,1,1,0,1,NASDAQ
4553,12-02-2021 04:00,24 hrs.,wallstreetbets,AMTX,6,0,6,-6,1,1,0,1,NASDAQ
4553,12-02-2021 04:00,24 hrs.,wallstreetbets,AMZN,2069,1930,139,1791,8,847,343,6,NASDAQ
4553,12-02-2021 04:00,24 hrs.,wallstreetbets,ANTE,6,6,0,6,1,1,0,1,NASDAQ
4553,12-02-2021 04:00,24 hrs.,wallstreetbets,APHA,94911,58419,36492,21927,176,42545,9117,135,NASDAQ
4553,12-02-2021 04:00,24 hrs.,wallstreetbets,APOP,6,6,0,6,1,1,0,1,NASDAQ
4553,12-02-2021 04:00,24 hrs.,wallstreetbets,APPS,6,0,6,-6,1,1,0,1,NASDAQ
4553,12-02-2021 04:00,24 hrs.,wallstreetbets,APRE,18,0,18,-18,3,3,0,2,NASDAQ
4553,12-02-2021 04:00,24 hrs.,wallstreetbets,APXT,20,20,0,20,3,3,2,3,NASDAQ
4553,12-02-2021 04:00,24 hrs.,wallstreetbets,AQMS,7,7,0,7,1,1,1,1,NASDAQ
4553,12-02-2021 04:00,24 hrs.,wallstreetbets,ARAY,6,0,6,-6,1,1,0,1,NASDAQ
4553,12-02-2021 04:00,24 hrs.,wallstreetbets,ARCT,18,18,0,18,3,3,0,1,NASDAQ
4553,12-02-2021 04:00,24 hrs.,wallstreetbets,AREC,6,0,6,-6,1,1,0,1,NASDAQ
4553,12-02-2021 04:00,24 hrs.,wallstreetbets,ARTL,6,0,6,-6,1,1,0,1,NASDAQ
4553,12-02-2021 04:00,24 hrs.,wallstreetbets,ASML,9,9,0,9,1,1,3,1,NASDAQ
4553,12-02-2021 04:00,24 hrs.,wallstreetbets,ASRT,30,24,6,18,5,5,0,5,NASDAQ
4553,12-02-2021 04:00,24 hrs.,wallstreetbets,ATEC,6,6,0,6,1,1,0,1,NASDAQ
4553,12-02-2021 04:00,24 hrs.,wallstreetbets,ATHA,6,0,6,-6,1,1,0,1,NASDAQ
4553,12-02-2021 04:00,24 hrs.,wallstreetbets,ATHX,37,37,0,37,6,6,1,3,NASDAQ
4553,12-02-2021 04:00,24 hrs.,wallstreetbets,ATNF,25,13,12,1,4,4,1,4,NASDAQ
4553,12-02-2021 04:00,24 hrs.,wallstreetbets,ATOS,19,7,12,-5,3,3,1,2,NASDAQ
4553,12-02-2021 04:00,24 hrs.,wallstreetbets,AUVI,12,6,6,0,2,2,0,2,NASDAQ
4553,12-02-2021 04:00,24 hrs.,wallstreetbets,AVAV,6,6,0,6,1,1,0,1,NASDAQ
4553,12-02-2021 04:00,24 hrs.,wallstreetbets,AVGR,30,18,12,6,5,5,0,4,NASDAQ
4553,12-02-2021 04:00,24 hrs.,wallstreetbets,AVXL,6,6,0,6,1,1,0,1,NASDAQ
4553,12-02-2021 04:00,24 hrs.,wallstreetbets,AXDX,27,27,0,27,4,4,3,2,NASDAQ
4553,12-02-2021 04:00,24 hrs.,wallstreetbets,AYRO,12,0,12,-12,2,2,0,1,NASDAQ
4553,12-02-2021 04:00,24 hrs.,wallstreetbets,BBBY,36,12,24,-12,6,6,0,6,NASDAQ
4553,12-02-2021 04:00,24 hrs.,wallstreetbets,BCRX,6,6,0,6,1,1,0,1,NASDAQ
4553,12-02-2021 04:00,24 hrs.,wallstreetbets,BEAT,12,6,6,0,2,2,0,2,NASDAQ
4553,12-02-2021 04:00,24 hrs.,wallstreetbets,BHAT,12,6,6,0,2,2,0,2,NASDAQ
4553,12-02-2021 04:00,24 hrs.,wallstreetbets,BIGC,47,47,0,47,7,7,5,4,NASDAQ
4553,12-02-2021 04:00,24 hrs.,wallstreetbets,BILI,36,0,36,-36,6,6,0,4,NASDAQ
4553,12-02-2021 04:00,24 hrs.,wallstreetbets,BIOC,7,7,0,7,1,1,1,1,NASDAQ
4553,12-02-2021 04:00,24 hrs.,StockMarket,CCIV,39,39,0,39,1,12,11,1,NYSE
4553,12-02-2021 04:00,24 hrs.,StockMarket,COTY,6,0,6,-6,1,1,0,1,NYSE
4553,12-02-2021 04:00,24 hrs.,StockMarket,GLOP,4,0,4,-4,1,0,0,1,NYSE
4553,12-02-2021 04:00,24 hrs.,StockMarket,GNRC,22,0,22,-22,1,8,2,1,NYSE
4553,12-02-2021 04:00,24 hrs.,StockMarket,MDLY,6,6,0,6,1,0,2,1,NYSE
4553,12-02-2021 04:00,24 hrs.,StockMarket,PAYC,47,47,0,47,1,15,13,1,NYSE
4553,12-02-2021 04:00,24 hrs.,StockMarket,PINS,28,0,28,-28,2,9,2,2,NYSE
4553,12-02-2021 04:00,24 hrs.,StockMarket,RLGY,6,6,0,6,1,1,0,1,NYSE
4553,12-02-2021 04:00,24 hrs.,StockMarket,SPCE,12,6,6,0,2,2,0,2,NYSE
4553,12-02-2021 04:00,24 hrs.,StockMarket,TEVA,6,6,0,6,1,1,0,1,NYSE
4553,12-02-2021 04:00,24 hrs.,pennystocks,CBDS,6,6,0,6,1,1,0,1,OTC
4553,12-02-2021 04:00,24 hrs.,pennystocks,CBGI,6,6,0,6,1,1,0,1,OTC
4553,12-02-2021 04:00,24 hrs.,pennystocks,CBTC,7,7,0,7,1,1,1,1,OTC
4553,12-02-2021 04:00,24 hrs.,pennystocks,CCAN,7,0,7,-7,1,1,1,1,OTC
4553,12-02-2021 04:00,24 hrs.,pennystocks,CCTL,6,6,0,6,1,1,0,1,OTC
4553,12-02-2021 04:00,24 hrs.,pennystocks,CETY,25,6,19,-13,2,8,1,2,OTC
4553,12-02-2021 04:00,24 hrs.,pennystocks,CHUC,6,0,6,-6,1,1,0,1,OTC
4553,12-02-2021 04:00,24 hrs.,pennystocks,CLHI,19,0,19,-19,1,5,5,1,OTC
4553,12-02-2021 04:00,24 hrs.,pennystocks,CLIS,6,6,0,6,1,1,0,1,OTC
4553,12-02-2021 04:00,24 hrs.,pennystocks,CLWD,35,16,19,-3,3,11,1,3,OTC
4553,12-02-2021 04:00,24 hrs.,pennystocks,CNXS,6,6,0,6,1,1,0,1,OTC
4553,12-02-2021 04:00,24 hrs.,pennystocks,COMS,26,26,0,26,1,4,14,1,OTC
4553,12-02-2021 04:00,24 hrs.,pennystocks,CORG,155,21,134,-113,9,30,59,5,OTC
4553,12-02-2021 04:00,24 hrs.,pennystocks,COUV,1619,0,1619,-1619,1,715,185,1,OTC
4553,12-02-2021 04:00,24 hrs.,pennystocks,CVAT,6,6,0,6,1,1,0,1,OTC
4553,12-02-2021 04:00,24 hrs.,StockMarket,SRNE,18,12,6,6,3,3,0,3,NASDAQ
4553,12-02-2021 04:00,24 hrs.,StockMarket,TELL,6,6,0,6,1,1,0,1,NASDAQ
4553,12-02-2021 04:00,24 hrs.,StockMarket,TLRY,1098,610,488,122,20,355,308,18,NASDAQ
4553,12-02-2021 04:00,24 hrs.,StockMarket,TNXP,54,0,54,-54,1,22,6,1,NASDAQ
4553,12-02-2021 04:00,24 hrs.,StockMarket,TSLA,36,6,30,-24,3,10,4,3,NASDAQ
4553,12-02-2021 04:00,24 hrs.,StockMarket,TXMD,6,6,0,6,1,1,0,1,NASDAQ
4553,12-02-2021 04:00,24 hrs.,StockMarket,USWS,6,0,6,-6,1,1,0,1,NASDAQ
4553,12-02-2021 04:00,24 hrs.,StockMarket,VIVO,4,0,4,-4,1,0,0,1,NASDAQ
4553,12-02-2021 04:00,24 hrs.,wallstreetbets,BLCM,6,0,6,-6,1,1,0,1,NASDAQ
4553,12-02-2021 04:00,24 hrs.,wallstreetbets,BLCT,6,6,0,6,1,1,0,1,NASDAQ
4553,12-02-2021 04:00,24 hrs.,wallstreetbets,BLNK,6,0,6,-6,1,1,0,1,NASDAQ
4553,12-02-2021 04:00,24 hrs.,wallstreetbets,BLUE,18,12,6,6,3,3,0,3,NASDAQ
4553,12-02-2021 04:00,24 hrs.,wallstreetbets,BNGO,30,12,18,-6,5,5,0,5,NASDAQ
4553,12-02-2021 04:00,24 hrs.,wallstreetbets,BPTH,25,6,19,-13,4,4,1,3,NASDAQ
4553,12-02-2021 04:00,24 hrs.,wallstreetbets,BRQS,31,31,0,31,5,5,1,4,NASDAQ
4553,12-02-2021 04:00,24 hrs.,wallstreetbets,BSGM,6,6,0,6,1,1,0,1,NASDAQ
4553,12-02-2021 04:00,24 hrs.,wallstreetbets,BWEN,6,0,6,-6,1,1,0,1,NASDAQ
4553,12-02-2021 04:00,24 hrs.,wallstreetbets,BYND,6,0,6,-6,1,1,0,1,NASDAQ
4553,12-02-2021 04:00,24 hrs.,wallstreetbets,CAKE,6,0,6,-6,1,1,0,1,NASDAQ
4553,12-02-2021 04:00,24 hrs.,wallstreetbets,CALM,6,6,0,6,1,1,0,1,NASDAQ
4553,12-02-2021 04:00,24 hrs.,wallstreetbets,CARE,12,0,12,-12,2,2,0,2,NASDAQ
4553,12-02-2021 04:00,24 hrs.,wallstreetbets,CARV,6,6,0,6,1,1,0,1,NASDAQ
4553,12-02-2021 04:00,24 hrs.,wallstreetbets,CASA,6,6,0,6,1,1,0,1,NASDAQ
4553,12-02-2021 04:00,24 hrs.,wallstreetbets,CASH,29275,6,29269,-29263,2,13084,3099,2,NASDAQ
4553,12-02-2021 04:00,24 hrs.,wallstreetbets,CCNC,6,6,0,6,1,1,0,1,NASDAQ
4553,12-02-2021 04:00,24 hrs.,wallstreetbets,CCRN,6,0,6,-6,1,1,0,1,NASDAQ
4553,12-02-2021 04:00,24 hrs.,wallstreetbets,CENT,6,0,6,-6,1,1,0,1,NASDAQ
4553,12-02-2021 04:00,24 hrs.,wallstreetbets,CFII,6,6,0,6,1,1,0,1,NASDAQ
4553,12-02-2021 04:00,24 hrs.,wallstreetbets,CGIX,38,20,18,2,6,6,2,3,NASDAQ
4553,12-02-2021 04:00,24 hrs.,wallstreetbets,CGRO,12,6,6,0,2,2,0,2,NASDAQ
4553,12-02-2021 04:00,24 hrs.,wallstreetbets,CHKP,6,6,0,6,1,1,0,1,NASDAQ
4553,12-02-2021 04:00,24 hrs.,wallstreetbets,CIDM,6,6,0,6,1,1,0,1,NASDAQ
4553,12-02-2021 04:00,24 hrs.,wallstreetbets,CKPT,18,18,0,18,3,3,0,2,NASDAQ
4553,12-02-2021 04:00,24 hrs.,wallstreetbets,CLBS,12,12,0,12,2,2,0,2,NASDAQ
4553,12-02-2021 04:00,24 hrs.,wallstreetbets,CLCT,6,6,0,6,1,1,0,1,NASDAQ
4553,12-02-2021 04:00,24 hrs.,wallstreetbets,CLNE,122,122,0,122,2,37,40,2,NASDAQ
4553,12-02-2021 04:00,24 hrs.,wallstreetbets,CLSN,19,6,13,-7,3,3,1,3,NASDAQ
4553,12-02-2021 04:00,24 hrs.,wallstreetbets,CLVR,50,6,44,-38,9,7,0,8,NASDAQ
4553,12-02-2021 04:00,24 hrs.,wallstreetbets,CLVS,40,40,0,40,6,6,4,5,NASDAQ
4553,12-02-2021 04:00,24 hrs.,StockMarket,PLUG,21,0,21,-21,3,1,7,3,NASDAQ
4553,12-02-2021 04:00,24 hrs.,StockMarket,PRCH,4,0,4,-4,1,0,0,1,NASDAQ
4553,12-02-2021 04:00,24 hrs.,StockMarket,PTGX,12,6,6,0,2,2,0,2,NASDAQ
4553,12-02-2021 04:00,24 hrs.,StockMarket,QELL,22,0,22,-22,1,8,2,1,NASDAQ
4553,12-02-2021 04:00,24 hrs.,StockMarket,RCMT,186,0,186,-186,1,66,50,1,NASDAQ
4553,12-02-2021 04:00,24 hrs.,StockMarket,RIGL,8,8,0,8,1,2,0,1,NASDAQ
4553,12-02-2021 04:00,24 hrs.,StockMarket,RIOT,186,0,186,-186,1,66,50,1,NASDAQ
4553,12-02-2021 04:00,24 hrs.,StockMarket,SLRX,6,0,6,-6,1,1,0,1,NASDAQ
4553,12-02-2021 04:00,24 hrs.,StockMarket,SNDL,11539,799,10740,-9941,33,5202,1003,31,NASDAQ
4553,12-02-2021 04:00,24 hrs.,StockMarket,SOLO,6,0,6,-6,1,1,0,1,NASDAQ
4553,12-02-2021 04:00,24 hrs.,wallstreetbets,EDIT,6600,6600,0,6600,3,2949,690,3,NASDAQ
4553,12-02-2021 04:00,24 hrs.,wallstreetbets,EDSA,24,0,24,-24,4,4,0,2,NASDAQ
4553,12-02-2021 04:00,24 hrs.,wallstreetbets,ELSE,6,0,6,-6,1,1,0,1,NASDAQ
4553,12-02-2021 04:00,24 hrs.,wallstreetbets,ENLV,6,6,0,6,1,1,0,1,NASDAQ
4553,12-02-2021 04:00,24 hrs.,wallstreetbets,ENPH,6,0,6,-6,1,1,0,1,NASDAQ
4553,12-02-2021 04:00,24 hrs.,wallstreetbets,ENVB,6,0,6,-6,1,1,0,1,NASDAQ
4553,12-02-2021 04:00,24 hrs.,wallstreetbets,ESPR,18,12,6,6,3,3,0,3,NASDAQ
4553,12-02-2021 04:00,24 hrs.,wallstreetbets,ETSY,6,6,0,6,1,1,0,1,NASDAQ
4553,12-02-2021 04:00,24 hrs.,wallstreetbets,EVER,749,743,6,737,3,300,137,3,NASDAQ
4553,12-02-2021 04:00,24 hrs.,wallstreetbets,EVFM,6,6,0,6,1,1,0,1,NASDAQ
4553,12-02-2021 04:00,24 hrs.,wallstreetbets,FAST,12,6,6,0,2,2,0,2,NASDAQ
4553,12-02-2021 04:00,24 hrs.,wallstreetbets,FCEL,26,13,13,0,4,4,2,4,NASDAQ
4553,12-02-2021 04:00,24 hrs.,wallstreetbets,FLUX,12,0,12,-12,2,2,0,1,NASDAQ
4553,12-02-2021 04:00,24 hrs.,wallstreetbets,FLWR,24,6,18,-12,4,4,0,4,NASDAQ
4553,12-02-2021 04:00,24 hrs.,wallstreetbets,FLXN,6,0,6,-6,1,1,0,1,NASDAQ
4553,12-02-2021 04:00,24 hrs.,StockMarket,VRAY,20,20,0,20,3,3,2,2,NASDAQ
4553,12-02-2021 04:00,24 hrs.,StockMarket,VXRT,6,6,0,6,1,1,0,1,NASDAQ
4553,12-02-2021 04:00,24 hrs.,StockMarket,ZNGA,53,31,22,9,4,15,7,3,NASDAQ
4553,12-02-2021 04:00,24 hrs.,StockMarket,UONEK,6,6,0,6,1,1,0,1,NASDAQ
4553,12-02-2021 04:00,24 hrs.,pennystocks,AABB,6,6,0,6,1,1,0,1,OTC
4553,12-02-2021 04:00,24 hrs.,pennystocks,ABML,82,82,0,82,1,31,16,1,OTC
4553,12-02-2021 04:00,24 hrs.,pennystocks,ABQQ,25,6,19,-13,2,8,1,2,OTC
4553,12-02-2021 04:00,24 hrs.,pennystocks,ABVG,7,0,7,-7,1,1,1,1,OTC
4553,12-02-2021 04:00,24 hrs.,pennystocks,ACRL,45,45,0,45,2,14,9,2,OTC
4553,12-02-2021 04:00,24 hrs.,pennystocks,ADGO,16,16,0,16,1,3,6,1,OTC
4553,12-02-2021 04:00,24 hrs.,pennystocks,ADTM,292,91,201,-110,5,95,82,5,OTC
4553,12-02-2021 04:00,24 hrs.,pennystocks,AGTK,7,0,7,-7,1,1,1,1,OTC
4553,12-02-2021 04:00,24 hrs.,pennystocks,AHFD,6,6,0,6,1,1,0,1,OTC
4553,12-02-2021 04:00,24 hrs.,pennystocks,AITX,176,140,36,104,5,39,78,5,OTC
4553,12-02-2021 04:00,24 hrs.,pennystocks,ALKM,19,19,0,19,3,3,1,1,OTC
4553,12-02-2021 04:00,24 hrs.,pennystocks,ALLM,6,0,6,-6,1,1,0,1,OTC
4553,12-02-2021 04:00,24 hrs.,pennystocks,ALPP,34,23,11,12,4,4,10,4,OTC
4553,12-02-2021 04:00,24 hrs.,pennystocks,ALYI,88,0,88,-88,4,21,30,4,OTC
4553,12-02-2021 04:00,24 hrs.,pennystocks,AMNE,6,0,6,-6,1,1,0,1,OTC
4553,12-02-2021 04:00,24 hrs.,pennystocks,AMNL,1619,0,1619,-1619,1,715,185,1,OTC
4553,12-02-2021 04:00,24 hrs.,pennystocks,APEX,110,110,0,110,1,39,28,1,OTC
4553,12-02-2021 04:00,24 hrs.,pennystocks,ASTI,58,18,40,-22,7,11,8,6,OTC
4553,12-02-2021 04:00,24 hrs.,pennystocks,ATVK,19,0,19,-19,1,7,1,1,OTC
4553,12-02-2021 04:00,24 hrs.,pennystocks,AXXA,12,12,0,12,2,2,0,2,OTC
4553,12-02-2021 04:00,24 hrs.,pennystocks,AZFL,6,0,6,-6,1,1,0,1,OTC
4553,12-02-2021 04:00,24 hrs.,pennystocks,BANT,8,8,0,8,1,0,4,1,OTC
4553,12-02-2021 04:00,24 hrs.,pennystocks,BBDA,7,7,0,7,1,1,1,1,OTC
4553,12-02-2021 04:00,24 hrs.,pennystocks,BBRW,6,6,0,6,1,1,0,1,OTC
4553,12-02-2021 04:00,24 hrs.,pennystocks,BCCI,7,7,0,7,1,1,1,1,OTC
4553,12-02-2021 04:00,24 hrs.,pennystocks,BDGR,19,7,12,-5,3,3,1,2,OTC
4553,12-02-2021 04:00,24 hrs.,pennystocks,BFCH,1628,0,1628,-1628,2,717,186,2,OTC
4553,12-02-2021 04:00,24 hrs.,pennystocks,BLDV,315,84,231,-147,9,99,81,9,OTC
4553,12-02-2021 04:00,24 hrs.,pennystocks,BLLB,6,6,0,6,1,1,0,1,OTC
4553,12-02-2021 04:00,24 hrs.,pennystocks,BLSP,88,82,6,76,4,20,32,4,OTC
4553,12-02-2021 04:00,24 hrs.,pennystocks,BMIX,7,7,0,7,1,1,1,1,OTC
4553,12-02-2021 04:00,24 hrs.,pennystocks,BNGI,19,12,7,5,3,3,1,2,OTC
4553,12-02-2021 04:00,24 hrs.,pennystocks,BOTY,291,90,201,-111,5,95,81,5,OTC
4553,12-02-2021 04:00,24 hrs.,pennystocks,BRAV,6,0,6,-6,1,1,0,1,OTC
4553,12-02-2021 04:00,24 hrs.,pennystocks,BRLL,34,12,22,-10,4,3,12,3,OTC
4553,12-02-2021 04:00,24 hrs.,pennystocks,BRRN,1619,0,1619,-1619,1,715,185,1,OTC
4553,12-02-2021 04:00,24 hrs.,pennystocks,BTCS,7,7,0,7,1,1,1,1,OTC
4553,12-02-2021 04:00,24 hrs.,pennystocks,BTSC,13,13,0,13,2,2,1,1,OTC
4553,12-02-2021 04:00,24 hrs.,pennystocks,BWMG,10,10,0,10,1,2,2,1,OTC
4553,12-02-2021 04:00,24 hrs.,pennystocks,BXNG,20,20,0,20,1,2,12,1,OTC
4553,12-02-2021 04:00,24 hrs.,pennystocks,CAPC,284,0,284,-284,1,117,46,1,OTC
4553,12-02-2021 04:00,24 hrs.,pennystocks,CATV,6,6,0,6,1,1,0,1,OTC
4553,12-02-2021 04:00,24 hrs.,pennystocks,CBBT,300,281,19,262,11,85,86,10,OTC
4553,12-02-2021 04:00,24 hrs.,pennystocks,CBDD,105,101,4,97,5,34,17,5,OTC
4553,12-02-2021 04:00,24 hrs.,pennystocks,CBDL,148,135,13,122,5,26,76,5,OTC
4553,12-02-2021 04:00,24 hrs.,wallstreetbets,GOEV,232,56,176,-120,12,69,46,5,NASDAQ
4553,12-02-2021 04:00,24 hrs.,wallstreetbets,GOGO,31,19,12,7,5,5,1,3,NASDAQ
4553,12-02-2021 04:00,24 hrs.,wallstreetbets,GOLD,206,200,6,194,5,60,66,5,NASDAQ
4553,12-02-2021 04:00,24 hrs.,wallstreetbets,GOOG,1336,1336,0,1336,1,574,184,1,NASDAQ
4553,12-02-2021 04:00,24 hrs.,wallstreetbets,GPRO,12,12,0,12,2,2,0,2,NASDAQ
4553,12-02-2021 04:00,24 hrs.,wallstreetbets,GRID,12,12,0,12,2,2,0,1,NASDAQ
4553,12-02-2021 04:00,24 hrs.,wallstreetbets,GRIL,25,25,0,25,4,4,1,3,NASDAQ
4553,12-02-2021 04:00,24 hrs.,wallstreetbets,GRMN,6,6,0,6,1,1,0,1,NASDAQ
4553,12-02-2021 04:00,24 hrs.,wallstreetbets,GRTS,6,6,0,6,1,1,0,1,NASDAQ
4553,12-02-2021 04:00,24 hrs.,wallstreetbets,GRWG,225,19,206,-187,7,49,99,7,NASDAQ
4553,12-02-2021 04:00,24 hrs.,wallstreetbets,GTEC,12,12,0,12,2,2,0,1,NASDAQ
4553,12-02-2021 04:00,24 hrs.,wallstreetbets,GTHX,7,7,0,7,1,1,1,1,NASDAQ
4553,12-02-2021 04:00,24 hrs.,wallstreetbets,HALO,56,0,56,-56,9,10,0,7,NASDAQ
4553,12-02-2021 04:00,24 hrs.,wallstreetbets,HEAR,6,0,6,-6,1,1,0,1,NASDAQ
4553,12-02-2021 04:00,24 hrs.,wallstreetbets,HEPA,9,9,0,9,1,1,3,1,NASDAQ
4553,12-02-2021 04:00,24 hrs.,pennystocks,CYBL,7,0,7,-7,1,1,1,1,OTC
4553,12-02-2021 04:00,24 hrs.,pennystocks,DGTW,6,0,6,-6,1,1,0,1,OTC
4553,12-02-2021 04:00,24 hrs.,pennystocks,DPLS,182,176,6,170,5,40,82,4,OTC
4553,12-02-2021 04:00,24 hrs.,pennystocks,DRWN,7,0,7,-7,1,1,1,1,OTC
4553,12-02-2021 04:00,24 hrs.,pennystocks,DSGT,7,0,7,-7,1,1,1,1,OTC
4553,12-02-2021 04:00,24 hrs.,pennystocks,DTST,67,60,7,53,3,12,31,3,OTC
4553,12-02-2021 04:00,24 hrs.,pennystocks,ECEZ,174,147,27,120,8,49,44,6,OTC
4553,12-02-2021 04:00,24 hrs.,pennystocks,EDXC,14,7,7,0,2,2,2,2,OTC
4553,12-02-2021 04:00,24 hrs.,pennystocks,EHOS,7,0,7,-7,1,1,1,1,OTC
4553,12-02-2021 04:00,24 hrs.,pennystocks,ELCR,13,0,13,-13,2,2,1,2,OTC
4553,12-02-2021 04:00,24 hrs.,pennystocks,ELRA,6,0,6,-6,1,1,0,1,OTC
4553,12-02-2021 04:00,24 hrs.,pennystocks,ENCS,201,0,201,-201,1,72,53,1,OTC
4553,12-02-2021 04:00,24 hrs.,pennystocks,ENDO,201,0,201,-201,1,72,53,1,OTC
4553,12-02-2021 04:00,24 hrs.,pennystocks,ENDV,6,6,0,6,1,1,0,1,OTC
4553,12-02-2021 04:00,24 hrs.,pennystocks,ENTI,13,13,0,13,2,2,1,1,OTC
4553,12-02-2021 04:00,24 hrs.,pennystocks,ENZC,13,13,0,13,2,2,1,1,OTC
4553,12-02-2021 04:00,24 hrs.,wallstreetbets,CMLF,7,7,0,7,1,1,1,1,NASDAQ
4553,12-02-2021 04:00,24 hrs.,wallstreetbets,CMPS,2193,2172,21,2151,12,862,421,8,NASDAQ
4553,12-02-2021 04:00,24 hrs.,wallstreetbets,CNDT,13,13,0,13,2,2,1,2,NASDAQ
4553,12-02-2021 04:00,24 hrs.,wallstreetbets,CNET,6,0,6,-6,1,1,0,1,NASDAQ
4553,12-02-2021 04:00,24 hrs.,wallstreetbets,CODX,6,6,0,6,1,1,0,1,NASDAQ
4553,12-02-2021 04:00,24 hrs.,wallstreetbets,COST,18,12,6,6,3,3,0,3,NASDAQ
4553,12-02-2021 04:00,24 hrs.,wallstreetbets,CPRX,6,0,6,-6,1,1,0,1,NASDAQ
4553,12-02-2021 04:00,24 hrs.,wallstreetbets,CPST,12,12,0,12,2,2,0,1,NASDAQ
4553,12-02-2021 04:00,24 hrs.,wallstreetbets,CRBP,24,0,24,-24,4,4,0,4,NASDAQ
4553,12-02-2021 04:00,24 hrs.,wallstreetbets,CREE,6,0,6,-6,1,1,0,1,NASDAQ
4553,12-02-2021 04:00,24 hrs.,wallstreetbets,CREG,12,0,12,-12,2,2,0,2,NASDAQ
4553,12-02-2021 04:00,24 hrs.,wallstreetbets,CRIS,6,0,6,-6,1,1,0,1,NASDAQ
4553,12-02-2021 04:00,24 hrs.,wallstreetbets,CRNT,12,6,6,0,2,2,0,2,NASDAQ
4553,12-02-2021 04:00,24 hrs.,wallstreetbets,CRON,29466,42,29424,-29382,15,13120,3166,12,NASDAQ
4553,12-02-2021 04:00,24 hrs.,wallstreetbets,CROX,6,0,6,-6,1,1,0,1,NASDAQ
4553,12-02-2021 04:00,24 hrs.,wallstreetbets,CRSP,6,0,6,-6,1,1,0,1,NASDAQ
4553,12-02-2021 04:00,24 hrs.,wallstreetbets,CRSR,2944,1561,1383,178,5,1205,514,4,NASDAQ
4553,12-02-2021 04:00,24 hrs.,wallstreetbets,CSCW,12,12,0,12,2,2,0,2,NASDAQ
4553,12-02-2021 04:00,24 hrs.,wallstreetbets,CTHR,6,0,6,-6,1,1,0,1,NASDAQ
4553,12-02-2021 04:00,24 hrs.,wallstreetbets,CTRM,753,535,218,317,124,124,9,107,NASDAQ
4553,12-02-2021 04:00,24 hrs.,wallstreetbets,CTRN,6,6,0,6,1,1,0,1,NASDAQ
4553,12-02-2021 04:00,24 hrs.,wallstreetbets,CVAC,6,0,6,-6,1,1,0,1,NASDAQ
4553,12-02-2021 04:00,24 hrs.,wallstreetbets,DBVT,6,6,0,6,1,1,0,1,NASDAQ
4553,12-02-2021 04:00,24 hrs.,wallstreetbets,DCRB,13,7,6,1,2,2,1,2,NASDAQ
4553,12-02-2021 04:00,24 hrs.,wallstreetbets,DDOG,41,41,0,41,3,11,7,3,NASDAQ
4553,12-02-2021 04:00,24 hrs.,wallstreetbets,DGLY,12,12,0,12,2,2,0,1,NASDAQ
4553,12-02-2021 04:00,24 hrs.,wallstreetbets,DKNG,816,803,13,790,4,341,118,3,NASDAQ
4553,12-02-2021 04:00,24 hrs.,wallstreetbets,DLPN,12,12,0,12,2,2,0,1,NASDAQ
4553,12-02-2021 04:00,24 hrs.,wallstreetbets,DMTK,12,12,0,12,2,2,0,1,NASDAQ
4553,12-02-2021 04:00,24 hrs.,wallstreetbets,DOYU,6,0,6,-6,1,1,0,1,NASDAQ
4553,12-02-2021 04:00,24 hrs.,wallstreetbets,DTIL,6,6,0,6,1,1,0,1,NASDAQ
4553,12-02-2021 04:00,24 hrs.,wallstreetbets,DXCM,6,0,6,-6,1,1,0,1,NASDAQ
4553,12-02-2021 04:00,24 hrs.,wallstreetbets,EBON,6,0,6,-6,1,1,0,1,NASDAQ
4553,12-02-2021 04:00,24 hrs.,pennystocks,GRCV,6,6,0,6,1,1,0,1,OTC
4553,12-02-2021 04:00,24 hrs.,pennystocks,GTCH,25,18,7,11,4,4,1,2,OTC
4553,12-02-2021 04:00,24 hrs.,pennystocks,GTEH,128,115,13,102,6,44,16,6,OTC
4553,12-02-2021 04:00,24 hrs.,pennystocks,GTLL,36,0,36,-36,1,12,8,1,OTC
4553,12-02-2021 04:00,24 hrs.,pennystocks,HCMC,287,166,121,45,41,53,17,35,OTC
4553,12-02-2021 04:00,24 hrs.,pennystocks,HCYT,12,0,12,-12,2,2,0,1,OTC
4553,12-02-2021 04:00,24 hrs.,pennystocks,HEMP,32,6,26,-20,5,5,2,5,OTC
4553,12-02-2021 04:00,24 hrs.,pennystocks,HIPH,967,967,0,967,5,421,105,3,OTC
4553,12-02-2021 04:00,24 hrs.,pennystocks,HMNY,1700,14,1686,-1672,8,732,204,8,OTC
4553,12-02-2021 04:00,24 hrs.,pennystocks,HPMM,17,17,0,17,2,2,5,2,OTC
4553,12-02-2021 04:00,24 hrs.,pennystocks,HPTY,179,179,0,179,2,59,53,2,OTC
4553,12-02-2021 04:00,24 hrs.,pennystocks,HQGE,19,13,6,7,3,3,1,3,OTC
4553,12-02-2021 04:00,24 hrs.,pennystocks,HRTH,110,110,0,110,1,39,28,1,OTC
4553,12-02-2021 04:00,24 hrs.,pennystocks,HYII,7,7,0,7,1,1,1,1,OTC
4553,12-02-2021 04:00,24 hrs.,pennystocks,HYSR,1643,18,1625,-1607,5,719,185,5,OTC
4553,12-02-2021 04:00,24 hrs.,pennystocks,IBRC,10,10,0,10,1,2,2,1,OTC
4553,12-02-2021 04:00,24 hrs.,pennystocks,ICBU,7,7,0,7,1,1,1,1,OTC
4553,12-02-2021 04:00,24 hrs.,pennystocks,ICLD,12,12,0,12,2,2,0,1,OTC
4553,12-02-2021 04:00,24 hrs.,pennystocks,ICNM,201,0,201,-201,1,72,53,1,OTC
4553,12-02-2021 04:00,24 hrs.,pennystocks,IDCN,6,6,0,6,1,1,0,1,OTC
4553,12-02-2021 04:00,24 hrs.,pennystocks,IDGC,8,8,0,8,1,1,2,1,OTC
4553,12-02-2021 04:00,24 hrs.,pennystocks,ILUS,6,6,0,6,1,1,0,1,OTC
4553,12-02-2021 04:00,24 hrs.,pennystocks,IMJX,201,0,201,-201,1,72,53,1,OTC
4553,12-02-2021 04:00,24 hrs.,pennystocks,IMTL,6,0,6,-6,1,1,0,1,OTC
4553,12-02-2021 04:00,24 hrs.,pennystocks,INCT,7,7,0,7,1,1,1,1,OTC
4553,12-02-2021 04:00,24 hrs.,pennystocks,INIS,19,0,19,-19,1,7,1,1,OTC
4553,12-02-2021 04:00,24 hrs.,pennystocks,INKW,50,25,25,0,6,12,2,6,OTC
4553,12-02-2021 04:00,24 hrs.,pennystocks,INND,99,68,31,37,7,23,25,7,OTC
4553,12-02-2021 04:00,24 hrs.,pennystocks,INTV,7,0,7,-7,1,1,1,1,OTC
4553,12-02-2021 04:00,24 hrs.,pennystocks,INVU,6,6,0,6,1,1,0,1,OTC
4553,12-02-2021 04:00,24 hrs.,pennystocks,IONI,19,0,19,-19,1,7,1,1,OTC
4553,12-02-2021 04:00,24 hrs.,pennystocks,IPIX,44,44,0,44,1,4,32,1,OTC
4553,12-02-2021 04:00,24 hrs.,pennystocks,IPSI,6,6,0,6,1,1,0,1,OTC
4553,12-02-2021 04:00,24 hrs.,pennystocks,IQST,12,6,6,0,2,2,0,2,OTC
4553,12-02-2021 04:00,24 hrs.,pennystocks,ISWH,17,0,17,-17,1,6,1,1,OTC
4553,12-02-2021 04:00,24 hrs.,pennystocks,IWSY,19,0,19,-19,1,7,1,1,OTC
4553,12-02-2021 04:00,24 hrs.,pennystocks,JETR,6,6,0,6,1,1,0,1,OTC
4553,12-02-2021 04:00,24 hrs.,pennystocks,JKSM,6,6,0,6,1,1,0,1,OTC
4553,12-02-2021 04:00,24 hrs.,pennystocks,KAVL,6,6,0,6,1,1,0,1,OTC
4553,12-02-2021 04:00,24 hrs.,pennystocks,KGET,8,0,8,-8,1,1,2,1,OTC
4553,12-02-2021 04:00,24 hrs.,pennystocks,EPAZ,129,99,30,69,3,44,29,2,OTC
4553,12-02-2021 04:00,24 hrs.,pennystocks,ERBB,13,0,13,-13,2,2,1,2,OTC
4553,12-02-2021 04:00,24 hrs.,pennystocks,ETFM,1915,95,1820,-1725,5,808,279,5,OTC
4553,12-02-2021 04:00,24 hrs.,pennystocks,EUOT,7,7,0,7,1,1,1,1,OTC
4553,12-02-2021 04:00,24 hrs.,wallstreetbets,FNKO,12,12,0,12,2,2,0,2,NASDAQ
4553,12-02-2021 04:00,24 hrs.,wallstreetbets,FOLD,20,6,14,-8,3,3,2,2,NASDAQ
4553,12-02-2021 04:00,24 hrs.,wallstreetbets,FORD,20,14,6,8,3,3,2,3,NASDAQ
4553,12-02-2021 04:00,24 hrs.,wallstreetbets,FROG,6,6,0,6,1,1,0,1,NASDAQ
4553,12-02-2021 04:00,24 hrs.,wallstreetbets,FRSX,6,6,0,6,1,1,0,1,NASDAQ
4553,12-02-2021 04:00,24 hrs.,wallstreetbets,FTOC,6,6,0,6,1,1,0,1,NASDAQ
4553,12-02-2021 04:00,24 hrs.,wallstreetbets,FUTU,320,314,6,308,2,96,120,2,NASDAQ
4553,12-02-2021 04:00,24 hrs.,wallstreetbets,GAIN,33,27,6,21,5,5,3,5,NASDAQ
4553,12-02-2021 04:00,24 hrs.,wallstreetbets,GDRX,7,7,0,7,1,1,1,1,NASDAQ
4553,12-02-2021 04:00,24 hrs.,wallstreetbets,GEVO,37,6,31,-25,6,6,1,5,NASDAQ
4553,12-02-2021 04:00,24 hrs.,wallstreetbets,GHIV,314,314,0,314,1,95,120,1,NASDAQ
4553,12-02-2021 04:00,24 hrs.,wallstreetbets,GHSI,26,20,6,14,4,4,2,3,NASDAQ
4553,12-02-2021 04:00,24 hrs.,wallstreetbets,GILT,6,0,6,-6,1,1,0,1,NASDAQ
4553,12-02-2021 04:00,24 hrs.,wallstreetbets,GLBS,6,6,0,6,1,1,0,1,NASDAQ
4553,12-02-2021 04:00,24 hrs.,wallstreetbets,GLSI,8,8,0,8,1,1,2,1,NASDAQ
4553,12-02-2021 04:00,24 hrs.,wallstreetbets,GLUU,6,6,0,6,1,1,0,1,NASDAQ
4553,12-02-2021 04:00,24 hrs.,wallstreetbets,GMBL,24,0,24,-24,4,4,0,3,NASDAQ
4553,12-02-2021 04:00,24 hrs.,wallstreetbets,GNLN,12,6,6,0,2,2,0,2,NASDAQ
4553,12-02-2021 04:00,24 hrs.,wallstreetbets,GNMK,6,6,0,6,1,1,0,1,NASDAQ
4553,12-02-2021 04:00,24 hrs.,wallstreetbets,GNOG,12,12,0,12,2,2,0,2,NASDAQ
4553,12-02-2021 04:00,24 hrs.,wallstreetbets,HSTO,6,0,6,-6,1,1,0,1,NASDAQ
4553,12-02-2021 04:00,24 hrs.,wallstreetbets,HTBX,6,0,6,-6,1,1,0,1,NASDAQ
4553,12-02-2021 04:00,24 hrs.,wallstreetbets,IBKR,465,447,18,429,6,144,153,5,NASDAQ
4553,12-02-2021 04:00,24 hrs.,wallstreetbets,ICLN,12,6,6,0,2,2,0,2,NASDAQ
4553,12-02-2021 04:00,24 hrs.,wallstreetbets,ICPT,12,12,0,12,2,2,0,2,NASDAQ
4553,12-02-2021 04:00,24 hrs.,wallstreetbets,IDEX,83,47,36,11,13,13,5,8,NASDAQ
4553,12-02-2021 04:00,24 hrs.,wallstreetbets,IDXG,12,0,12,-12,2,2,0,1,NASDAQ
4553,12-02-2021 04:00,24 hrs.,wallstreetbets,IFMK,26,26,0,26,4,4,2,3,NASDAQ
4553,12-02-2021 04:00,24 hrs.,wallstreetbets,ILMN,6,0,6,-6,1,1,0,1,NASDAQ
4553,12-02-2021 04:00,24 hrs.,wallstreetbets,IMGN,72,72,0,72,1,21,26,1,NASDAQ
4553,12-02-2021 04:00,24 hrs.,wallstreetbets,IMMR,8,8,0,8,1,1,2,1,NASDAQ
4553,12-02-2021 04:00,24 hrs.,wallstreetbets,INFI,49,0,49,-49,8,8,1,2,NASDAQ
4553,12-02-2021 04:00,24 hrs.,wallstreetbets,INPX,54,30,24,6,9,9,0,9,NASDAQ
4553,12-02-2021 04:00,24 hrs.,wallstreetbets,INTC,39,33,6,27,6,7,1,4,NASDAQ
4553,12-02-2021 04:00,24 hrs.,wallstreetbets,INVE,6,0,6,-6,1,1,0,1,NASDAQ
4553,12-02-2021 04:00,24 hrs.,wallstreetbets,IRBT,646,14,632,-618,6,244,134,6,NASDAQ
4553,12-02-2021 04:00,24 hrs.,wallstreetbets,IRDM,6,6,0,6,1,1,0,1,NASDAQ
4553,12-02-2021 04:00,24 hrs.,wallstreetbets,ITRM,36,6,30,-24,6,6,0,4,NASDAQ
4553,12-02-2021 04:00,24 hrs.,wallstreetbets,JAGX,36,12,24,-12,6,6,0,4,NASDAQ
4553,12-02-2021 04:00,24 hrs.,wallstreetbets,JBLU,6,6,0,6,1,1,0,1,NASDAQ
4553,12-02-2021 04:00,24 hrs.,wallstreetbets,JNCE,12,6,6,0,2,2,0,2,NASDAQ
4553,12-02-2021 04:00,24 hrs.,wallstreetbets,KDMN,6,0,6,-6,1,1,0,1,NASDAQ
4553,12-02-2021 04:00,24 hrs.,wallstreetbets,KERN,19,13,6,7,3,3,1,3,NASDAQ
4553,12-02-2021 04:00,24 hrs.,wallstreetbets,KIDS,12,0,12,-12,2,2,0,2,NASDAQ
4553,12-02-2021 04:00,24 hrs.,wallstreetbets,KLIC,373,0,373,-373,1,150,69,1,NASDAQ
4553,12-02-2021 04:00,24 hrs.,wallstreetbets,KOPN,18,0,18,-18,3,3,0,2,NASDAQ
4553,12-02-2021 04:00,24 hrs.,wallstreetbets,KOSS,6,0,6,-6,1,1,0,1,NASDAQ
4553,12-02-2021 04:00,24 hrs.,wallstreetbets,KPTI,12,0,12,-12,2,2,0,1,NASDAQ
4553,12-02-2021 04:00,24 hrs.,wallstreetbets,KTRA,12,6,6,0,2,2,0,2,NASDAQ
4553,12-02-2021 04:00,24 hrs.,wallstreetbets,KXIN,18,0,18,-18,3,3,0,2,NASDAQ
4553,12-02-2021 04:00,24 hrs.,wallstreetbets,LAKE,6,6,0,6,1,1,0,1,NASDAQ
4553,12-02-2021 04:00,24 hrs.,wallstreetbets,LGHL,6,6,0,6,1,1,0,1,NASDAQ
4553,12-02-2021 04:00,24 hrs.,wallstreetbets,LIFE,12,0,12,-12,2,2,0,2,NASDAQ
4553,12-02-2021 04:00,24 hrs.,wallstreetbets,LIVE,1016,395,621,-226,4,396,208,4,NASDAQ
4553,12-02-2021 04:00,24 hrs.,wallstreetbets,LKCO,67,43,24,19,11,11,1,4,NASDAQ
4553,12-02-2021 04:00,24 hrs.,wallstreetbets,LLIT,6,6,0,6,1,1,0,1,NASDAQ
4553,12-02-2021 04:00,24 hrs.,wallstreetbets,LLNW,21,21,0,21,3,3,3,3,NASDAQ
4553,12-02-2021 04:00,24 hrs.,wallstreetbets,LMNL,6,0,6,-6,1,1,0,1,NASDAQ
4553,12-02-2021 04:00,24 hrs.,wallstreetbets,LRCX,6,6,0,6,1,1,0,1,NASDAQ
4553,12-02-2021 04:00,24 hrs.,wallstreetbets,LUNA,6,0,6,-6,1,1,0,1,NASDAQ
4553,12-02-2021 04:00,24 hrs.,pennystocks,EVSV,6,6,0,6,1,1,0,1,OTC
4553,12-02-2021 04:00,24 hrs.,pennystocks,EWLL,12,0,12,-12,2,2,0,1,OTC
4553,12-02-2021 04:00,24 hrs.,pennystocks,EXMT,19,0,19,-19,2,4,3,2,OTC
4553,12-02-2021 04:00,24 hrs.,pennystocks,FMCC,110,110,0,110,1,39,28,1,OTC
4553,12-02-2021 04:00,24 hrs.,pennystocks,FNMA,110,110,0,110,1,39,28,1,OTC
4553,12-02-2021 04:00,24 hrs.,pennystocks,FOYJ,6,0,6,-6,1,1,0,1,OTC
4553,12-02-2021 04:00,24 hrs.,pennystocks,FPVD,15,15,0,15,2,3,1,2,OTC
4553,12-02-2021 04:00,24 hrs.,pennystocks,FTFY,6,6,0,6,1,1,0,1,OTC
4553,12-02-2021 04:00,24 hrs.,pennystocks,FUTL,7,7,0,7,1,1,1,1,OTC
4553,12-02-2021 04:00,24 hrs.,pennystocks,FWAV,6,0,6,-6,1,1,0,1,OTC
4553,12-02-2021 04:00,24 hrs.,pennystocks,FWDG,6,0,6,-6,1,1,0,1,OTC
4553,12-02-2021 04:00,24 hrs.,pennystocks,GAHC,40,0,40,-40,1,11,14,1,OTC
4553,12-02-2021 04:00,24 hrs.,pennystocks,GARB,12,0,12,-12,2,2,0,2,OTC
4553,12-02-2021 04:00,24 hrs.,pennystocks,GAXY,114,108,6,102,3,29,44,3,OTC
4553,12-02-2021 04:00,24 hrs.,pennystocks,GDET,13,13,0,13,2,2,1,2,OTC
4553,12-02-2021 04:00,24 hrs.,pennystocks,GEGI,6,0,6,-6,1,1,0,1,OTC
4553,12-02-2021 04:00,24 hrs.,pennystocks,GLGI,110,110,0,110,1,39,28,1,OTC
4553,12-02-2021 04:00,24 hrs.,pennystocks,GMER,6,6,0,6,1,1,0,1,OTC
4553,12-02-2021 04:00,24 hrs.,pennystocks,GMEV,354,348,6,342,2,136,74,2,OTC
4553,12-02-2021 04:00,24 hrs.,pennystocks,GMPR,6,0,6,-6,1,1,0,1,OTC
4553,12-02-2021 04:00,24 hrs.,pennystocks,GNCP,10,10,0,10,1,1,4,1,OTC
4553,12-02-2021 04:00,24 hrs.,pennystocks,GNPT,28,0,28,-28,1,5,14,1,OTC
4553,12-02-2021 04:00,24 hrs.,pennystocks,GPFT,13,13,0,13,2,2,1,2,OTC
4553,12-02-2021 04:00,24 hrs.,pennystocks,GRCU,6,6,0,6,1,1,0,1,OTC
4553,12-02-2021 04:00,24 hrs.,wallstreetbets,MARA,78,50,28,22,12,13,4,10,NASDAQ
4553,12-02-2021 04:00,24 hrs.,wallstreetbets,MARK,6,6,0,6,1,1,0,1,NASDAQ
4553,12-02-2021 04:00,24 hrs.,wallstreetbets,MBRX,19,19,0,19,3,3,1,2,NASDAQ
4553,12-02-2021 04:00,24 hrs.,wallstreetbets,MCHP,347,347,0,347,1,121,101,1,NASDAQ
4553,12-02-2021 04:00,24 hrs.,wallstreetbets,MESO,6,0,6,-6,1,1,0,1,NASDAQ
4553,12-02-2021 04:00,24 hrs.,wallstreetbets,METX,6,6,0,6,1,1,0,1,NASDAQ
4553,12-02-2021 04:00,24 hrs.,wallstreetbets,MGNI,35,20,15,5,5,5,5,5,NASDAQ
4553,12-02-2021 04:00,24 hrs.,wallstreetbets,MITK,6,0,6,-6,1,1,0,1,NASDAQ
4553,12-02-2021 04:00,24 hrs.,wallstreetbets,MITO,6,6,0,6,1,1,0,1,NASDAQ
4553,12-02-2021 04:00,24 hrs.,wallstreetbets,MOGO,7,7,0,7,1,1,1,1,NASDAQ
4553,12-02-2021 04:00,24 hrs.,wallstreetbets,MOSY,7,7,0,7,1,1,1,1,NASDAQ
4553,12-02-2021 04:00,24 hrs.,wallstreetbets,MOTS,12,12,0,12,2,2,0,1,NASDAQ
4553,12-02-2021 04:00,24 hrs.,wallstreetbets,MSFT,1411,797,614,183,2,577,249,2,NASDAQ
4553,12-02-2021 04:00,24 hrs.,wallstreetbets,MSTR,36,12,24,-12,6,6,0,4,NASDAQ
4553,12-02-2021 04:00,24 hrs.,wallstreetbets,MVIS,735,59,676,-617,27,227,173,21,NASDAQ
4553,12-02-2021 04:00,24 hrs.,wallstreetbets,NAKD,563,218,345,-127,92,92,11,76,NASDAQ
4553,12-02-2021 04:00,24 hrs.,wallstreetbets,NAOV,6,6,0,6,1,1,0,1,NASDAQ
4553,12-02-2021 04:00,24 hrs.,wallstreetbets,NBEV,6,6,0,6,1,1,0,1,NASDAQ
4553,12-02-2021 04:00,24 hrs.,wallstreetbets,NCLH,7,7,0,7,1,1,1,1,NASDAQ
4553,12-02-2021 04:00,24 hrs.,wallstreetbets,NCTY,6,0,6,-6,1,1,0,1,NASDAQ
4553,12-02-2021 04:00,24 hrs.,wallstreetbets,NDRA,13,13,0,13,2,2,1,2,NASDAQ
4553,12-02-2021 04:00,24 hrs.,wallstreetbets,NEOS,6,0,6,-6,1,1,0,1,NASDAQ
4553,12-02-2021 04:00,24 hrs.,wallstreetbets,NEPT,37,25,12,13,6,6,1,5,NASDAQ
4553,12-02-2021 04:00,24 hrs.,wallstreetbets,NETE,6,0,6,-6,1,1,0,1,NASDAQ
4553,12-02-2021 04:00,24 hrs.,wallstreetbets,NKLA,26,20,6,14,4,4,2,4,NASDAQ
4553,12-02-2021 04:00,24 hrs.,wallstreetbets,NLOK,13,13,0,13,2,2,1,1,NASDAQ
4553,12-02-2021 04:00,24 hrs.,wallstreetbets,NNDM,26,20,6,14,4,5,0,3,NASDAQ
4553,12-02-2021 04:00,24 hrs.,wallstreetbets,NNOX,6,6,0,6,1,1,0,1,NASDAQ
4553,12-02-2021 04:00,24 hrs.,wallstreetbets,NOVN,7,7,0,7,1,1,1,1,NASDAQ
4553,12-02-2021 04:00,24 hrs.,wallstreetbets,NUAN,6,6,0,6,1,1,0,1,NASDAQ
4553,12-02-2021 04:00,24 hrs.,wallstreetbets,NVAX,13,6,7,-1,2,2,1,2,NASDAQ
4553,12-02-2021 04:00,24 hrs.,wallstreetbets,NVCN,32,32,0,32,5,5,2,5,NASDAQ
4553,12-02-2021 04:00,24 hrs.,wallstreetbets,NVDA,344,139,205,-66,8,128,56,6,NASDAQ
4553,12-02-2021 04:00,24 hrs.,wallstreetbets,NVIV,6,0,6,-6,1,1,0,1,NASDAQ
4553,12-02-2021 04:00,24 hrs.,wallstreetbets,NXPI,347,347,0,347,1,121,101,1,NASDAQ
4553,12-02-2021 04:00,24 hrs.,wallstreetbets,NXTD,18,18,0,18,3,3,0,2,NASDAQ
4553,12-02-2021 04:00,24 hrs.,wallstreetbets,OCGN,127,79,48,31,21,21,1,18,NASDAQ
4553,12-02-2021 04:00,24 hrs.,wallstreetbets,ONEM,6,0,6,-6,1,1,0,1,NASDAQ
4553,12-02-2021 04:00,24 hrs.,wallstreetbets,ONTX,12,6,6,0,2,2,0,2,NASDAQ
4553,12-02-2021 04:00,24 hrs.,wallstreetbets,ONVO,6,6,0,6,1,1,0,1,NASDAQ
4553,12-02-2021 04:00,24 hrs.,pennystocks,KGKG,37,19,18,1,4,7,7,2,OTC
4553,12-02-2021 04:00,24 hrs.,pennystocks,KSHB,26,0,26,-26,1,9,4,1,OTC
4553,12-02-2021 04:00,24 hrs.,pennystocks,KWBT,117,110,7,103,2,40,29,2,OTC
4553,12-02-2021 04:00,24 hrs.,pennystocks,KYNC,38,38,0,38,6,6,2,2,OTC
4553,12-02-2021 04:00,24 hrs.,pennystocks,LBSR,7,7,0,7,1,1,1,1,OTC
4553,12-02-2021 04:00,24 hrs.,pennystocks,LBUY,70,0,70,-70,1,31,4,1,OTC
4553,12-02-2021 04:00,24 hrs.,pennystocks,LIVC,5,0,5,-5,1,0,1,1,OTC
4553,12-02-2021 04:00,24 hrs.,pennystocks,LOGQ,6,6,0,6,1,1,0,1,OTC
4553,12-02-2021 04:00,24 hrs.,pennystocks,LQMT,53,53,0,53,1,18,13,1,OTC
4553,12-02-2021 04:00,24 hrs.,pennystocks,LTNC,13,6,7,-1,2,2,1,2,OTC
4553,12-02-2021 04:00,24 hrs.,pennystocks,LTUM,6,6,0,6,1,1,0,1,OTC
4553,12-02-2021 04:00,24 hrs.,pennystocks,LUVU,130,130,0,130,4,43,28,3,OTC
4553,12-02-2021 04:00,24 hrs.,pennystocks,LVVV,69,12,57,-45,4,10,33,3,OTC
4553,12-02-2021 04:00,24 hrs.,pennystocks,MAXD,20,0,20,-20,3,3,2,3,OTC
4553,12-02-2021 04:00,24 hrs.,pennystocks,MCOA,26,13,13,0,4,4,2,4,OTC
4553,12-02-2021 04:00,24 hrs.,pennystocks,MGTI,6,0,6,-6,1,1,0,1,OTC
4553,12-02-2021 04:00,24 hrs.,pennystocks,MINE,2407,396,2011,-1615,6,1038,307,6,OTC
4553,12-02-2021 04:00,24 hrs.,pennystocks,MJNA,161,134,27,107,11,41,35,9,OTC
4553,12-02-2021 04:00,24 hrs.,pennystocks,MLFB,33,6,27,-21,3,9,3,3,OTC
4553,12-02-2021 04:00,24 hrs.,pennystocks,MMEX,1681,37,1644,-1607,6,730,197,6,OTC
4553,12-02-2021 04:00,24 hrs.,pennystocks,MOPN,7,7,0,7,1,1,1,1,OTC
4553,12-02-2021 04:00,24 hrs.,wallstreetbets,HGEN,12,12,0,12,2,2,0,2,NASDAQ
4553,12-02-2021 04:00,24 hrs.,wallstreetbets,HIMX,13,7,6,1,2,2,1,2,NASDAQ
4553,12-02-2021 04:00,24 hrs.,wallstreetbets,HOFV,12,12,0,12,2,2,0,1,NASDAQ
4473,11-02-2021 12:00,24 hrs.,StockMarket,TEAM,6,6,0,6,1,1,0,1,NASDAQ
4473,11-02-2021 12:00,24 hrs.,StockMarket,TLRY,477,258,219,39,15,162,93,14,NASDAQ
4473,11-02-2021 12:00,24 hrs.,StockMarket,TOPS,6,6,0,6,1,1,0,1,NASDAQ
4473,11-02-2021 12:00,24 hrs.,StockMarket,TSLA,49,0,49,-49,1,15,15,1,NASDAQ
4473,11-02-2021 12:00,24 hrs.,StockMarket,USWS,6,6,0,6,1,1,0,1,NASDAQ
4473,11-02-2021 12:00,24 hrs.,StockMarket,VBIV,25,0,25,-25,2,6,5,1,NASDAQ
4473,11-02-2021 12:00,24 hrs.,StockMarket,VIVO,8,8,0,8,1,2,0,1,NASDAQ
4473,11-02-2021 12:00,24 hrs.,StockMarket,WKHS,10,0,10,-10,1,1,4,1,NASDAQ
4473,11-02-2021 12:00,24 hrs.,StockMarket,ZSAN,48,6,42,-36,5,8,12,3,NASDAQ
4473,11-02-2021 12:00,24 hrs.,pennystocks,AABB,42,0,42,-42,1,11,16,1,OTC
4473,11-02-2021 12:00,24 hrs.,pennystocks,ABML,224,84,140,-56,5,71,62,5,OTC
4473,11-02-2021 12:00,24 hrs.,pennystocks,ABVG,116,110,6,104,2,29,50,2,OTC
4473,11-02-2021 12:00,24 hrs.,pennystocks,ADTM,712,118,594,-476,3,266,168,3,OTC
4473,11-02-2021 12:00,24 hrs.,StockMarket,CGC,151,89,62,27,4,59,17,3,NASDAQ
4473,11-02-2021 12:00,24 hrs.,StockMarket,JFU,7,0,7,-7,1,1,1,1,NASDAQ
4473,11-02-2021 12:00,24 hrs.,StockMarket,MAT,16,0,16,-16,1,6,0,1,NASDAQ
4473,11-02-2021 12:00,24 hrs.,StockMarket,OGI,18,6,12,-6,3,3,0,3,NASDAQ
4473,11-02-2021 12:00,24 hrs.,StockMarket,OLB,297,0,297,-297,4,84,113,3,NASDAQ
4473,11-02-2021 12:00,24 hrs.,StockMarket,OPK,15,0,15,-15,1,4,3,1,NASDAQ
4473,11-02-2021 12:00,24 hrs.,StockMarket,QQQ,62,0,62,-62,1,28,2,1,NASDAQ
4473,11-02-2021 12:00,24 hrs.,StockMarket,UAL,50,0,50,-50,1,20,6,1,NASDAQ
4473,11-02-2021 12:00,24 hrs.,StockMarket,VFF,35,35,0,35,1,14,3,1,NASDAQ
4473,11-02-2021 12:00,24 hrs.,StockMarket,AAOI,12,6,6,0,2,2,0,2,NASDAQ
4473,11-02-2021 12:00,24 hrs.,StockMarket,AAPL,11,11,0,11,1,0,7,1,NASDAQ
4473,11-02-2021 12:00,24 hrs.,StockMarket,AGTC,45,0,45,-45,3,13,7,2,NASDAQ
4473,11-02-2021 12:00,24 hrs.,StockMarket,AKAM,16,0,16,-16,1,6,0,1,NASDAQ
4473,11-02-2021 12:00,24 hrs.,StockMarket,APHA,311,202,109,93,13,104,51,10,NASDAQ
4473,11-02-2021 12:00,24 hrs.,StockMarket,ARTL,6,0,6,-6,1,1,0,1,NASDAQ
4473,11-02-2021 12:00,24 hrs.,StockMarket,ATNF,6,6,0,6,1,1,0,1,NASDAQ
4473,11-02-2021 12:00,24 hrs.,StockMarket,AUVI,16,0,16,-16,1,6,0,1,NASDAQ
4473,11-02-2021 12:00,24 hrs.,StockMarket,AYRO,6,0,6,-6,1,1,0,1,NASDAQ
4473,11-02-2021 12:00,24 hrs.,StockMarket,BCRX,16,0,16,-16,1,6,0,1,NASDAQ
4473,11-02-2021 12:00,24 hrs.,StockMarket,BHTG,279,0,279,-279,1,81,113,1,NASDAQ
4473,11-02-2021 12:00,24 hrs.,StockMarket,BIDU,62,0,62,-62,1,28,2,1,NASDAQ
4473,11-02-2021 12:00,24 hrs.,StockMarket,BILI,6,0,6,-6,1,1,0,1,NASDAQ
4473,11-02-2021 12:00,24 hrs.,StockMarket,BNGO,13,13,0,13,1,0,9,1,NASDAQ
4473,11-02-2021 12:00,24 hrs.,StockMarket,BPTH,295,0,295,-295,2,87,113,2,NASDAQ
4473,11-02-2021 12:00,24 hrs.,StockMarket,CGIX,279,0,279,-279,1,81,113,1,NASDAQ
4473,11-02-2021 12:00,24 hrs.,StockMarket,CLEU,6,0,6,-6,1,1,0,1,NASDAQ
4473,11-02-2021 12:00,24 hrs.,StockMarket,CLVR,6,6,0,6,1,1,0,1,NASDAQ
4473,11-02-2021 12:00,24 hrs.,StockMarket,CMLF,279,0,279,-279,1,81,113,1,NASDAQ
4473,11-02-2021 12:00,24 hrs.,StockMarket,CMPS,6,0,6,-6,1,1,0,1,NASDAQ
4473,11-02-2021 12:00,24 hrs.,StockMarket,CNET,14,6,8,-2,2,3,0,2,NASDAQ
4473,11-02-2021 12:00,24 hrs.,StockMarket,CRSR,74,0,74,-74,3,30,2,3,NASDAQ
4473,11-02-2021 12:00,24 hrs.,StockMarket,CSCO,16,0,16,-16,1,6,0,1,NASDAQ
4473,11-02-2021 12:00,24 hrs.,StockMarket,CTRM,6,6,0,6,1,1,0,1,NASDAQ
4473,11-02-2021 12:00,24 hrs.,StockMarket,CXDO,8,0,8,-8,1,2,0,1,NASDAQ
4473,11-02-2021 12:00,24 hrs.,StockMarket,DCRB,12,12,0,12,2,2,0,1,NASDAQ
4473,11-02-2021 12:00,24 hrs.,StockMarket,EDIT,58,58,0,58,2,17,16,2,NASDAQ
4473,11-02-2021 12:00,24 hrs.,StockMarket,ENPH,16,0,16,-16,1,6,0,1,NASDAQ
4473,11-02-2021 12:00,24 hrs.,StockMarket,EXPI,12,12,0,12,1,2,4,1,NASDAQ
4473,11-02-2021 12:00,24 hrs.,StockMarket,FSLR,62,0,62,-62,1,28,2,1,NASDAQ
4473,11-02-2021 12:00,24 hrs.,StockMarket,GHSI,10,10,0,10,1,3,0,1,NASDAQ
4473,11-02-2021 12:00,24 hrs.,StockMarket,GNLN,35,6,29,-23,2,10,7,2,NASDAQ
4473,11-02-2021 12:00,24 hrs.,StockMarket,GOLD,83,83,0,83,2,30,15,1,NASDAQ
4473,11-02-2021 12:00,24 hrs.,StockMarket,HTBX,34,12,22,-10,4,9,0,3,NASDAQ
4473,11-02-2021 12:00,24 hrs.,StockMarket,KALV,6,0,6,-6,1,1,0,1,NASDAQ
4473,11-02-2021 12:00,24 hrs.,StockMarket,KOSS,13,13,0,13,2,2,1,2,NASDAQ
4473,11-02-2021 12:00,24 hrs.,StockMarket,LIVE,16,0,16,-16,1,6,0,1,NASDAQ
4473,11-02-2021 12:00,24 hrs.,StockMarket,LSTR,6,0,6,-6,1,1,0,1,NASDAQ
4473,11-02-2021 12:00,24 hrs.,StockMarket,LYFT,78,0,78,-78,2,34,2,2,NASDAQ
4473,11-02-2021 12:00,24 hrs.,StockMarket,MOGO,6,0,6,-6,1,1,0,1,NASDAQ
4473,11-02-2021 12:00,24 hrs.,StockMarket,MRNA,18,0,18,-18,3,3,0,1,NASDAQ
4473,11-02-2021 12:00,24 hrs.,StockMarket,MTCH,16,0,16,-16,1,6,0,1,NASDAQ
4473,11-02-2021 12:00,24 hrs.,StockMarket,MVIS,212,11,201,-190,2,87,30,2,NASDAQ
4473,11-02-2021 12:00,24 hrs.,StockMarket,NAKD,12,6,6,0,2,2,0,2,NASDAQ
4473,11-02-2021 12:00,24 hrs.,StockMarket,OSUR,10,10,0,10,1,1,4,1,NASDAQ
4473,11-02-2021 12:00,24 hrs.,StockMarket,PACB,16,0,16,-16,1,6,0,1,NASDAQ
4473,11-02-2021 12:00,24 hrs.,StockMarket,PLAY,35,35,0,35,1,14,3,1,NASDAQ
4473,11-02-2021 12:00,24 hrs.,StockMarket,PLUG,17,17,0,17,2,1,7,2,NASDAQ
4473,11-02-2021 12:00,24 hrs.,StockMarket,PSTV,6,0,6,-6,1,1,0,1,NASDAQ
4473,11-02-2021 12:00,24 hrs.,StockMarket,PTGX,6,6,0,6,1,1,0,1,NASDAQ
4473,11-02-2021 12:00,24 hrs.,StockMarket,SLRX,6,6,0,6,1,1,0,1,NASDAQ
4473,11-02-2021 12:00,24 hrs.,StockMarket,SNCA,20,0,20,-20,1,8,0,1,NASDAQ
4473,11-02-2021 12:00,24 hrs.,StockMarket,SNDL,1737,759,978,-219,37,647,295,34,NASDAQ
4473,11-02-2021 12:00,24 hrs.,StockMarket,SOLO,25,25,0,25,2,1,15,2,NASDAQ
4473,11-02-2021 12:00,24 hrs.,StockMarket,SRNE,13,6,7,-1,2,2,1,2,NASDAQ
4473,11-02-2021 12:00,24 hrs.,StockMarket,UBQU,6,6,0,6,1,1,0,1,OTC
4473,11-02-2021 12:00,24 hrs.,StockMarket,VMSI,4,0,4,-4,1,0,0,1,OTC
4473,11-02-2021 12:00,24 hrs.,StockMarket,WDLF,4,0,4,-4,1,0,0,1,OTC
4473,11-02-2021 12:00,24 hrs.,StockMarket,ZAAG,6,0,6,-6,1,1,0,1,OTC
4473,11-02-2021 12:00,24 hrs.,StockMarket,HITIF,25,19,6,13,2,8,1,2,OTC
4473,11-02-2021 12:00,24 hrs.,StockMarket,ISOLF,6,6,0,6,1,1,0,1,OTC
4473,11-02-2021 12:00,24 hrs.,StockMarket,JETMF,4,0,4,-4,1,0,0,1,OTC
4473,11-02-2021 12:00,24 hrs.,StockMarket,LKYSF,28,0,28,-28,1,10,4,1,OTC
4473,11-02-2021 12:00,24 hrs.,StockMarket,MMEDF,6,0,6,-6,1,1,0,1,OTC
4473,11-02-2021 12:00,24 hrs.,StockMarket,NXGWF,17,17,0,17,1,6,1,1,OTC
4473,11-02-2021 12:00,24 hrs.,StockMarket,NXTTF,1026,0,1026,-1026,1,387,248,1,OTC
4473,11-02-2021 12:00,24 hrs.,StockMarket,TRUFF,6,0,6,-6,1,1,0,1,OTC
4473,11-02-2021 12:00,24 hrs.,StockMarket,VLNCF,9,0,9,-9,1,2,1,1,OTC
4473,11-02-2021 12:00,24 hrs.,StockMarket,WDDMF,6,6,0,6,1,1,0,1,OTC
4473,11-02-2021 12:00,24 hrs.,StockMarket,WHGOF,13,0,13,-13,2,2,1,1,OTC
4473,11-02-2021 12:00,24 hrs.,StockMarket,CIK,27,27,0,27,1,6,11,1,AMEX
4473,11-02-2021 12:00,24 hrs.,StockMarket,GDP,62,0,62,-62,1,28,2,1,AMEX
4473,11-02-2021 12:00,24 hrs.,StockMarket,GTE,91,0,91,-91,1,39,9,1,AMEX
4473,11-02-2021 12:00,24 hrs.,StockMarket,ITP,6,0,6,-6,1,1,0,1,AMEX
4473,11-02-2021 12:00,24 hrs.,StockMarket,NAK,11,6,5,1,2,1,1,2,AMEX
4473,11-02-2021 12:00,24 hrs.,StockMarket,ZOM,96,88,8,80,2,22,44,2,AMEX
4473,11-02-2021 12:00,24 hrs.,StockMarket,NSPR,6,0,6,-6,1,1,0,1,AMEX
4473,11-02-2021 12:00,24 hrs.,StockMarket,ACB,125,95,30,65,7,39,19,5,NYSE
4473,11-02-2021 12:00,24 hrs.,StockMarket,AMC,157,78,79,-1,10,47,23,10,NYSE
4473,11-02-2021 12:00,24 hrs.,StockMarket,ATH,8,0,8,-8,1,2,0,1,NYSE
4473,11-02-2021 12:00,24 hrs.,StockMarket,BEP,23,23,0,23,1,3,13,1,NYSE
4473,11-02-2021 12:00,24 hrs.,StockMarket,CBD,6,6,0,6,1,1,0,1,NYSE
4473,11-02-2021 12:00,24 hrs.,StockMarket,FAF,83,83,0,83,2,30,15,1,NYSE
4473,11-02-2021 12:00,24 hrs.,StockMarket,FLT,93,0,93,-93,1,31,27,1,NYSE
4473,11-02-2021 12:00,24 hrs.,StockMarket,FSR,16,0,16,-16,1,6,0,1,NYSE
4473,11-02-2021 12:00,24 hrs.,StockMarket,GME,357,131,226,-95,18,90,105,15,NYSE
4473,11-02-2021 12:00,24 hrs.,StockMarket,HAE,42,0,42,-42,1,16,6,1,NYSE
4473,11-02-2021 12:00,24 hrs.,StockMarket,HVT,8,8,0,8,1,2,0,1,NYSE
4473,11-02-2021 12:00,24 hrs.,StockMarket,IRS,15,0,15,-15,1,1,9,1,NYSE
4473,11-02-2021 12:00,24 hrs.,StockMarket,JMP,62,0,62,-62,1,28,2,1,NYSE
4473,11-02-2021 12:00,24 hrs.,StockMarket,LLY,16,0,16,-16,1,6,0,1,NYSE
4473,11-02-2021 12:00,24 hrs.,StockMarket,LOW,8,0,8,-8,1,0,4,1,NYSE
4473,11-02-2021 12:00,24 hrs.,StockMarket,NET,8,0,8,-8,1,1,2,1,NYSE
4473,11-02-2021 12:00,24 hrs.,StockMarket,NIO,44,34,10,24,3,14,4,3,NYSE
4473,11-02-2021 12:00,24 hrs.,StockMarket,NOK,21,21,0,21,1,5,7,1,NYSE
4473,11-02-2021 12:00,24 hrs.,StockMarket,OMF,62,0,62,-62,1,28,2,1,NYSE
4473,11-02-2021 12:00,24 hrs.,StockMarket,SLF,6,6,0,6,1,1,0,1,NYSE
4473,11-02-2021 12:00,24 hrs.,StockMarket,SOS,4,0,4,-4,1,0,0,1,NYSE
4473,11-02-2021 12:00,24 hrs.,StockMarket,TSM,6,0,6,-6,1,1,0,1,NYSE
4473,11-02-2021 12:00,24 hrs.,StockMarket,UAA,22,0,22,-22,2,7,0,2,NYSE
4473,11-02-2021 12:00,24 hrs.,StockMarket,USB,9,0,9,-9,1,2,1,1,NYSE
4473,11-02-2021 12:00,24 hrs.,StockMarket,WGO,13,0,13,-13,2,2,1,1,NYSE
4473,11-02-2021 12:00,24 hrs.,StockMarket,WMT,62,0,62,-62,1,28,2,1,NYSE
4473,11-02-2021 12:00,24 hrs.,StockMarket,XPO,6,0,6,-6,1,1,0,1,NYSE
4473,11-02-2021 12:00,24 hrs.,StockMarket,YPF,6,0,6,-6,1,1,0,1,NYSE
4473,11-02-2021 12:00,24 hrs.,StockMarket,ACIC,88,0,88,-88,2,28,24,2,NYSE
4473,11-02-2021 12:00,24 hrs.,StockMarket,ADNT,62,0,62,-62,1,28,2,1,NYSE
4473,11-02-2021 12:00,24 hrs.,StockMarket,ATEN,6,0,6,-6,1,1,0,1,NYSE
4473,11-02-2021 12:00,24 hrs.,StockMarket,CHGG,62,0,62,-62,1,28,2,1,NYSE
4473,11-02-2021 12:00,24 hrs.,StockMarket,COTY,12,12,0,12,2,2,0,1,NYSE
4473,11-02-2021 12:00,24 hrs.,StockMarket,FUBO,24,0,24,-24,4,4,0,1,NYSE
4473,11-02-2021 12:00,24 hrs.,StockMarket,ORCL,62,0,62,-62,1,28,2,1,NYSE
4473,11-02-2021 12:00,24 hrs.,StockMarket,PLTR,10,0,10,-10,1,1,4,1,NYSE
4473,11-02-2021 12:00,24 hrs.,StockMarket,SPCE,67,0,67,-67,1,25,13,1,NYSE
4473,11-02-2021 12:00,24 hrs.,StockMarket,TWLO,62,0,62,-62,1,28,2,1,NYSE
4473,11-02-2021 12:00,24 hrs.,StockMarket,TWTR,78,0,78,-78,2,34,2,2,NYSE
4473,11-02-2021 12:00,24 hrs.,StockMarket,UBER,14,14,0,14,1,2,6,1,NYSE
4473,11-02-2021 12:00,24 hrs.,StockMarket,WELL,6,6,0,6,1,1,0,1,NYSE
4473,11-02-2021 12:00,24 hrs.,StockMarket,YELP,16,0,16,-16,1,6,0,1,NYSE
4473,11-02-2021 12:00,24 hrs.,Daytrading,TRCH,6,6,0,6,1,1,0,1,NASDAQ
4473,11-02-2021 12:00,24 hrs.,Daytrading,TXMD,7,0,7,-7,1,1,1,1,NASDAQ
4473,11-02-2021 12:00,24 hrs.,Daytrading,TYME,6,0,6,-6,1,1,0,1,NASDAQ
4473,11-02-2021 12:00,24 hrs.,StockMarket,ACGX,6,0,6,-6,1,1,0,1,OTC
4473,11-02-2021 12:00,24 hrs.,StockMarket,BLSP,19,19,0,19,1,7,1,1,OTC
4473,11-02-2021 12:00,24 hrs.,StockMarket,BNGI,15,15,0,15,1,3,5,1,OTC
4473,11-02-2021 12:00,24 hrs.,StockMarket,BTZI,5,5,0,5,1,0,1,1,OTC
4473,11-02-2021 12:00,24 hrs.,StockMarket,CWRK,10,0,10,-10,2,1,0,1,OTC
4473,11-02-2021 12:00,24 hrs.,StockMarket,DEWM,6,0,6,-6,1,1,0,1,OTC
4473,11-02-2021 12:00,24 hrs.,StockMarket,DKMR,6,0,6,-6,1,1,0,1,OTC
4473,11-02-2021 12:00,24 hrs.,StockMarket,ERBB,6,0,6,-6,1,1,0,1,OTC
4473,11-02-2021 12:00,24 hrs.,StockMarket,GAXY,26,26,0,26,1,3,16,1,OTC
4473,11-02-2021 12:00,24 hrs.,StockMarket,GDMK,6,0,6,-6,1,1,0,1,OTC
4473,11-02-2021 12:00,24 hrs.,StockMarket,GDSI,6,0,6,-6,1,1,0,1,OTC
4473,11-02-2021 12:00,24 hrs.,StockMarket,GMPR,6,0,6,-6,1,1,0,1,OTC
4473,11-02-2021 12:00,24 hrs.,StockMarket,GTSO,6,0,6,-6,1,1,0,1,OTC
4473,11-02-2021 12:00,24 hrs.,StockMarket,HCMC,7,0,7,-7,1,1,1,1,OTC
4473,11-02-2021 12:00,24 hrs.,StockMarket,HEMP,36,6,30,-24,3,6,12,3,OTC
4473,11-02-2021 12:00,24 hrs.,StockMarket,HMNY,7,7,0,7,1,1,1,1,OTC
4473,11-02-2021 12:00,24 hrs.,StockMarket,ISWH,6,0,6,-6,1,1,0,1,OTC
4473,11-02-2021 12:00,24 hrs.,StockMarket,LINK,22,6,16,-10,2,7,0,2,OTC
4473,11-02-2021 12:00,24 hrs.,StockMarket,LVVV,24,0,24,-24,1,10,0,1,OTC
4473,11-02-2021 12:00,24 hrs.,StockMarket,MINE,83,83,0,83,2,30,15,1,OTC
4473,11-02-2021 12:00,24 hrs.,StockMarket,MJLB,6,0,6,-6,1,1,0,1,OTC
4473,11-02-2021 12:00,24 hrs.,StockMarket,MJNA,6,0,6,-6,1,1,0,1,OTC
4473,11-02-2021 12:00,24 hrs.,StockMarket,MOST,16,0,16,-16,1,6,0,1,OTC
4473,11-02-2021 12:00,24 hrs.,StockMarket,OTTV,6,0,6,-6,1,1,0,1,OTC
4473,11-02-2021 12:00,24 hrs.,StockMarket,PSYC,6,6,0,6,1,1,0,1,OTC
4473,11-02-2021 12:00,24 hrs.,StockMarket,PURA,12,6,6,0,2,2,0,2,OTC
4473,11-02-2021 12:00,24 hrs.,StockMarket,PVDG,38,38,0,38,1,17,0,1,OTC
4473,11-02-2021 12:00,24 hrs.,StockMarket,QMCI,6,0,6,-6,1,1,0,1,OTC
4473,11-02-2021 12:00,24 hrs.,StockMarket,ROTH,10,10,0,10,1,3,0,1,OTC
4473,11-02-2021 12:00,24 hrs.,StockMarket,RTON,24,0,24,-24,2,8,0,1,OTC
4473,11-02-2021 12:00,24 hrs.,StockMarket,SGMD,24,12,12,0,4,4,0,4,OTC
4473,11-02-2021 12:00,24 hrs.,StockMarket,TRTC,26,26,0,26,1,9,4,1,OTC
4473,11-02-2021 12:00,24 hrs.,Daytrading,RIOT,1773,0,1773,-1773,1,786,197,1,NASDAQ
4473,11-02-2021 12:00,24 hrs.,Daytrading,SAVA,1773,0,1773,-1773,1,786,197,1,NASDAQ
4473,11-02-2021 12:00,24 hrs.,Daytrading,SESN,6,6,0,6,1,1,0,1,NASDAQ
4473,11-02-2021 12:00,24 hrs.,Daytrading,SNDL,535,357,178,179,9,164,171,9,NASDAQ
4473,11-02-2021 12:00,24 hrs.,Daytrading,TLGT,7,0,7,-7,1,1,1,1,NASDAQ
4473,11-02-2021 12:00,24 hrs.,Daytrading,TLRY,2078,241,1837,-1596,6,874,306,6,NASDAQ
4473,11-02-2021 12:00,24 hrs.,Daytrading,ADTM,6,0,6,-6,1,1,0,1,OTC
4473,11-02-2021 12:00,24 hrs.,Daytrading,BBRW,12,0,12,-12,2,2,0,1,OTC
4473,11-02-2021 12:00,24 hrs.,Daytrading,GAXY,16,16,0,16,1,6,0,1,OTC
4473,11-02-2021 12:00,24 hrs.,Daytrading,HMNY,13,7,6,1,2,2,1,2,OTC
4473,11-02-2021 12:00,24 hrs.,Daytrading,INKW,6,0,6,-6,1,1,0,1,OTC
4473,11-02-2021 12:00,24 hrs.,Daytrading,KWBT,13,0,13,-13,2,2,1,1,OTC
4473,11-02-2021 12:00,24 hrs.,Daytrading,MJNA,12,6,6,0,2,2,0,2,OTC
4473,11-02-2021 12:00,24 hrs.,Daytrading,PMDP,6,0,6,-6,1,1,0,1,OTC
4473,11-02-2021 12:00,24 hrs.,Daytrading,SIRC,6,6,0,6,1,1,0,1,OTC
4473,11-02-2021 12:00,24 hrs.,Daytrading,LXXGF,58,0,58,-58,2,10,30,1,OTC
4473,11-02-2021 12:00,24 hrs.,Daytrading,NXTTF,13,0,13,-13,1,4,1,1,OTC
4473,11-02-2021 12:00,24 hrs.,Daytrading,ITP,1773,0,1773,-1773,1,786,197,1,AMEX
4473,11-02-2021 12:00,24 hrs.,Daytrading,GSAT,7,0,7,-7,1,1,1,1,AMEX
4473,11-02-2021 12:00,24 hrs.,Daytrading,NSPR,1773,0,1773,-1773,1,786,197,1,AMEX
4473,11-02-2021 12:00,24 hrs.,Daytrading,ACB,1773,0,1773,-1773,1,786,197,1,NYSE
4473,11-02-2021 12:00,24 hrs.,Daytrading,AMC,6,6,0,6,1,1,0,1,NYSE
4473,11-02-2021 12:00,24 hrs.,Daytrading,ATH,1773,0,1773,-1773,1,786,197,1,NYSE
4473,11-02-2021 12:00,24 hrs.,Daytrading,GME,15,0,15,-15,2,2,3,2,NYSE
4473,11-02-2021 12:00,24 hrs.,Daytrading,MSM,7,0,7,-7,1,1,1,1,NYSE
4473,11-02-2021 12:00,24 hrs.,Daytrading,MUX,6,6,0,6,1,1,0,1,NYSE
4473,11-02-2021 12:00,24 hrs.,Daytrading,PDT,25,0,25,-25,3,3,7,3,NYSE
4473,11-02-2021 12:00,24 hrs.,Daytrading,RSI,9,0,9,-9,1,1,3,1,NYSE
4473,11-02-2021 12:00,24 hrs.,Daytrading,ACIC,1773,0,1773,-1773,1,786,197,1,NYSE
4473,11-02-2021 12:00,24 hrs.,Daytrading,BABA,1773,0,1773,-1773,1,786,197,1,NYSE
4473,11-02-2021 12:00,24 hrs.,Daytrading,VCRA,4,0,4,-4,1,0,0,1,NYSE
4473,11-02-2021 12:00,24 hrs.,Daytrading,CFA,7,0,7,-7,1,1,1,1,NASDAQ
4473,11-02-2021 12:00,24 hrs.,Daytrading,CGC,1773,0,1773,-1773,1,786,197,1,NASDAQ
4473,11-02-2021 12:00,24 hrs.,Daytrading,OLB,1897,0,1897,-1897,3,837,211,3,NASDAQ
4473,11-02-2021 12:00,24 hrs.,Daytrading,AAPL,17,0,17,-17,1,2,9,1,NASDAQ
4473,11-02-2021 12:00,24 hrs.,Daytrading,ADMA,6,0,6,-6,1,1,0,1,NASDAQ
4473,11-02-2021 12:00,24 hrs.,Daytrading,APHA,2032,241,1791,-1550,4,858,300,4,NASDAQ
4473,11-02-2021 12:00,24 hrs.,Daytrading,ATOS,20,14,6,8,2,1,10,2,NASDAQ
4473,11-02-2021 12:00,24 hrs.,Daytrading,AUVI,39,0,39,-39,1,15,5,1,NASDAQ
4473,11-02-2021 12:00,24 hrs.,Daytrading,BGCP,6,0,6,-6,1,1,0,1,NASDAQ
4473,11-02-2021 12:00,24 hrs.,Daytrading,BHTG,1890,0,1890,-1890,2,836,210,2,NASDAQ
4473,11-02-2021 12:00,24 hrs.,Daytrading,BPTH,1925,15,1910,-1895,6,840,221,4,NASDAQ
4473,11-02-2021 12:00,24 hrs.,Daytrading,BSQR,1784,0,1784,-1784,3,787,198,3,NASDAQ
4473,11-02-2021 12:00,24 hrs.,Daytrading,CGIX,1936,0,1936,-1936,4,852,216,4,NASDAQ
4473,11-02-2021 12:00,24 hrs.,Daytrading,CLVR,12,0,12,-12,1,2,4,1,NASDAQ
4473,11-02-2021 12:00,24 hrs.,Daytrading,CMLF,1890,0,1890,-1890,2,836,210,2,NASDAQ
4473,11-02-2021 12:00,24 hrs.,Daytrading,CNET,1781,0,1781,-1781,2,788,197,2,NASDAQ
4473,11-02-2021 12:00,24 hrs.,Daytrading,CPST,4,0,4,-4,1,0,0,1,NASDAQ
4473,11-02-2021 12:00,24 hrs.,Daytrading,ENLV,1773,0,1773,-1773,1,786,197,1,NASDAQ
4473,11-02-2021 12:00,24 hrs.,Daytrading,EVFM,12,12,0,12,2,2,0,1,NASDAQ
4473,11-02-2021 12:00,24 hrs.,Daytrading,FCEL,6,6,0,6,1,1,0,1,NASDAQ
4473,11-02-2021 12:00,24 hrs.,Daytrading,GMDA,1773,0,1773,-1773,1,786,197,1,NASDAQ
4473,11-02-2021 12:00,24 hrs.,Daytrading,GNFT,1773,0,1773,-1773,1,786,197,1,NASDAQ
4473,11-02-2021 12:00,24 hrs.,Daytrading,GRWG,1773,0,1773,-1773,1,786,197,1,NASDAQ
4473,11-02-2021 12:00,24 hrs.,Daytrading,ITRM,37,7,30,-23,3,11,3,3,NASDAQ
4473,11-02-2021 12:00,24 hrs.,Daytrading,KERN,6,6,0,6,1,1,0,1,NASDAQ
4473,11-02-2021 12:00,24 hrs.,Daytrading,MARA,1773,0,1773,-1773,1,786,197,1,NASDAQ
4473,11-02-2021 12:00,24 hrs.,Daytrading,NEPT,1773,0,1773,-1773,1,786,197,1,NASDAQ
4473,11-02-2021 12:00,24 hrs.,Daytrading,OCGN,1773,0,1773,-1773,1,786,197,1,NASDAQ
4473,11-02-2021 12:00,24 hrs.,Daytrading,PACB,1773,0,1773,-1773,1,786,197,1,NASDAQ
4473,11-02-2021 12:00,24 hrs.,Daytrading,PTON,6,6,0,6,1,1,0,1,NASDAQ
4473,11-02-2021 12:00,24 hrs.,pennystocks,RWBYF,28,28,0,28,1,6,12,1,OTC
4473,11-02-2021 12:00,24 hrs.,pennystocks,RYCEY,6,0,6,-6,1,1,0,1,OTC
4473,11-02-2021 12:00,24 hrs.,pennystocks,RYMDF,6,6,0,6,1,1,0,1,OTC
4473,11-02-2021 12:00,24 hrs.,pennystocks,SHRMF,7,0,7,-7,1,1,1,1,OTC
4473,11-02-2021 12:00,24 hrs.,pennystocks,SPRWF,765,6,759,-753,9,286,157,8,OTC
4473,11-02-2021 12:00,24 hrs.,pennystocks,TAKOF,382,52,330,-278,5,127,108,5,OTC
4473,11-02-2021 12:00,24 hrs.,pennystocks,TGIFF,105,0,105,-105,3,35,23,3,OTC
4473,11-02-2021 12:00,24 hrs.,pennystocks,TGODF,97,83,14,69,3,18,49,3,OTC
4473,11-02-2021 12:00,24 hrs.,pennystocks,TLOFF,42,23,19,4,4,6,14,4,OTC
4473,11-02-2021 12:00,24 hrs.,pennystocks,TOBAF,60,0,60,-60,3,23,2,1,OTC
4473,11-02-2021 12:00,24 hrs.,pennystocks,TSCRF,40,0,40,-40,1,13,10,1,OTC
4473,11-02-2021 12:00,24 hrs.,pennystocks,UCCPF,20,0,20,-20,1,7,2,1,OTC
4473,11-02-2021 12:00,24 hrs.,pennystocks,VRNDF,6,6,0,6,1,1,0,1,OTC
4473,11-02-2021 12:00,24 hrs.,pennystocks,VULNF,6,6,0,6,1,1,0,1,OTC
4473,11-02-2021 12:00,24 hrs.,pennystocks,WDDMF,45,0,45,-45,2,13,11,2,OTC
4473,11-02-2021 12:00,24 hrs.,pennystocks,WHGOF,6,0,6,-6,1,1,0,1,OTC
4473,11-02-2021 12:00,24 hrs.,pennystocks,ZBISF,12,6,6,0,2,2,0,2,OTC
4473,11-02-2021 12:00,24 hrs.,pennystocks,ZOEIF,6,0,6,-6,1,1,0,1,OTC
4473,11-02-2021 12:00,24 hrs.,pennystocks,AIM,19,0,19,-19,3,3,1,2,AMEX
4473,11-02-2021 12:00,24 hrs.,pennystocks,BGI,47,0,47,-47,1,18,7,1,AMEX
4473,11-02-2021 12:00,24 hrs.,pennystocks,DNN,63,63,0,63,1,15,29,1,AMEX
4473,11-02-2021 12:00,24 hrs.,pennystocks,DPW,58,0,58,-58,1,21,12,1,AMEX
4473,11-02-2021 12:00,24 hrs.,pennystocks,GPL,6,0,6,-6,1,1,0,1,AMEX
4473,11-02-2021 12:00,24 hrs.,pennystocks,GTE,495,134,361,-227,12,171,105,12,AMEX
4473,11-02-2021 12:00,24 hrs.,pennystocks,ITP,184,81,103,-22,4,74,20,4,AMEX
4473,11-02-2021 12:00,24 hrs.,pennystocks,MCF,8,0,8,-8,1,1,2,1,AMEX
4473,11-02-2021 12:00,24 hrs.,pennystocks,NAK,41,8,33,-25,6,6,5,6,AMEX
4473,11-02-2021 12:00,24 hrs.,pennystocks,NHS,6,0,6,-6,1,1,0,1,AMEX
4473,11-02-2021 12:00,24 hrs.,pennystocks,OCX,58,58,0,58,1,25,4,1,AMEX
4473,11-02-2021 12:00,24 hrs.,pennystocks,PLG,7,0,7,-7,1,0,3,1,AMEX
4473,11-02-2021 12:00,24 hrs.,pennystocks,PLX,7,0,7,-7,1,1,1,1,AMEX
4473,11-02-2021 12:00,24 hrs.,pennystocks,REI,42,34,8,26,2,11,12,2,AMEX
4473,11-02-2021 12:00,24 hrs.,pennystocks,RHE,47,0,47,-47,1,18,7,1,AMEX
4473,11-02-2021 12:00,24 hrs.,pennystocks,SYN,6,6,0,6,1,1,0,1,AMEX
4473,11-02-2021 12:00,24 hrs.,pennystocks,TGC,47,0,47,-47,1,18,7,1,AMEX
4473,11-02-2021 12:00,24 hrs.,pennystocks,TRX,13,0,13,-13,2,2,1,2,AMEX
4473,11-02-2021 12:00,24 hrs.,pennystocks,WTT,173,0,173,-173,1,61,47,1,AMEX
4473,11-02-2021 12:00,24 hrs.,pennystocks,ZOM,81,36,45,-9,4,21,23,4,AMEX
4473,11-02-2021 12:00,24 hrs.,pennystocks,ARMP,82,0,82,-82,1,29,20,1,AMEX
4473,11-02-2021 12:00,24 hrs.,pennystocks,ENSV,47,0,47,-47,1,18,7,1,AMEX
4473,11-02-2021 12:00,24 hrs.,pennystocks,GSAT,179,33,146,-113,5,53,53,4,AMEX
4473,11-02-2021 12:00,24 hrs.,pennystocks,INUV,28,22,6,16,3,7,2,3,AMEX
4473,11-02-2021 12:00,24 hrs.,pennystocks,NSPR,165,77,88,-11,6,55,31,5,AMEX
4473,11-02-2021 12:00,24 hrs.,pennystocks,OGEN,121,121,0,121,2,47,19,2,AMEX
4473,11-02-2021 12:00,24 hrs.,pennystocks,AMYZF,8,0,8,-8,1,1,2,1,OTC
4473,11-02-2021 12:00,24 hrs.,pennystocks,ARBKF,46,6,40,-34,2,10,18,2,OTC
4473,11-02-2021 12:00,24 hrs.,pennystocks,ARSMF,8,0,8,-8,1,1,2,1,OTC
4473,11-02-2021 12:00,24 hrs.,pennystocks,ATIXF,6,0,6,-6,1,1,0,1,OTC
4473,11-02-2021 12:00,24 hrs.,pennystocks,ATTBF,6,6,0,6,1,1,0,1,OTC
4473,11-02-2021 12:00,24 hrs.,pennystocks,BBKCF,39,33,6,27,2,14,3,2,OTC
4473,11-02-2021 12:00,24 hrs.,pennystocks,BDRBF,72,53,19,34,4,17,22,3,OTC
4473,11-02-2021 12:00,24 hrs.,pennystocks,CBULF,14,14,0,14,1,3,4,1,OTC
4473,11-02-2021 12:00,24 hrs.,pennystocks,CBWTF,12,0,12,-12,2,2,0,1,OTC
4473,11-02-2021 12:00,24 hrs.,pennystocks,CDTAF,6,0,6,-6,1,1,0,1,OTC
4473,11-02-2021 12:00,24 hrs.,pennystocks,CNIKF,23,23,0,23,1,3,13,1,OTC
4473,11-02-2021 12:00,24 hrs.,pennystocks,CNTTQ,6,0,6,-6,1,1,0,1,OTC
4473,11-02-2021 12:00,24 hrs.,pennystocks,CREQF,6,0,6,-6,1,1,0,1,OTC
4473,11-02-2021 12:00,24 hrs.,pennystocks,DIGAF,13,0,13,-13,2,2,1,2,OTC
4473,11-02-2021 12:00,24 hrs.,pennystocks,DMNXF,83,0,83,-83,1,25,29,1,OTC
4473,11-02-2021 12:00,24 hrs.,pennystocks,EFLVF,230,149,81,68,5,80,50,3,OTC
4473,11-02-2021 12:00,24 hrs.,pennystocks,EPWCF,13,13,0,13,2,2,1,1,OTC
4473,11-02-2021 12:00,24 hrs.,pennystocks,FIORF,13,6,7,-1,2,2,1,2,OTC
4473,11-02-2021 12:00,24 hrs.,pennystocks,FLOOF,7,0,7,-7,1,1,1,1,OTC
4473,11-02-2021 12:00,24 hrs.,pennystocks,FUNFF,6,6,0,6,1,1,0,1,OTC
4473,11-02-2021 12:00,24 hrs.,pennystocks,GCPEF,15,0,15,-15,1,2,7,1,OTC
4473,11-02-2021 12:00,24 hrs.,pennystocks,GGBXF,7,0,7,-7,1,1,1,1,OTC
4473,11-02-2021 12:00,24 hrs.,pennystocks,GLDFF,156,129,27,102,8,52,20,8,OTC
4473,11-02-2021 12:00,24 hrs.,pennystocks,HITIF,825,187,638,-451,23,244,245,22,OTC
4473,11-02-2021 12:00,24 hrs.,pennystocks,HLLPF,39,0,39,-39,1,16,3,1,OTC
4473,11-02-2021 12:00,24 hrs.,pennystocks,HRVOF,79,79,0,79,1,23,29,1,OTC
4473,11-02-2021 12:00,24 hrs.,pennystocks,HSTRF,6,6,0,6,1,1,0,1,OTC
4473,11-02-2021 12:00,24 hrs.,pennystocks,ICOTF,40,0,40,-40,1,9,18,1,OTC
4473,11-02-2021 12:00,24 hrs.,pennystocks,INTEQ,6,6,0,6,1,1,0,1,OTC
4473,11-02-2021 12:00,24 hrs.,pennystocks,JETMF,110,110,0,110,1,45,16,1,OTC
4473,11-02-2021 12:00,24 hrs.,pennystocks,JRVMF,6,0,6,-6,1,1,0,1,OTC
4473,11-02-2021 12:00,24 hrs.,pennystocks,KHRIF,51,0,51,-51,1,18,11,1,OTC
4473,11-02-2021 12:00,24 hrs.,pennystocks,KHRNF,6,0,6,-6,1,1,0,1,OTC
4473,11-02-2021 12:00,24 hrs.,pennystocks,LITOF,48,0,48,-48,1,18,8,1,OTC
4473,11-02-2021 12:00,24 hrs.,pennystocks,LKYSF,67,0,67,-67,1,25,13,1,OTC
4473,11-02-2021 12:00,24 hrs.,pennystocks,LLKKF,14,7,7,0,2,2,2,2,OTC
4473,11-02-2021 12:00,24 hrs.,pennystocks,LMNGF,6,0,6,-6,1,1,0,1,OTC
4473,11-02-2021 12:00,24 hrs.,pennystocks,LTMCF,76,76,0,76,2,19,30,2,OTC
4473,11-02-2021 12:00,24 hrs.,pennystocks,LXXGF,44,0,44,-44,2,15,6,2,OTC
4473,11-02-2021 12:00,24 hrs.,pennystocks,MBXBF,28,0,28,-28,1,11,2,1,OTC
4473,11-02-2021 12:00,24 hrs.,pennystocks,MMNFF,123,117,6,111,3,32,47,3,OTC
4473,11-02-2021 12:00,24 hrs.,pennystocks,MNKKQ,6,0,6,-6,1,1,0,1,OTC
4473,11-02-2021 12:00,24 hrs.,pennystocks,MNXXF,26,20,6,14,2,6,6,2,OTC
4473,11-02-2021 12:00,24 hrs.,pennystocks,NMGRF,12,6,6,0,2,2,0,2,OTC
4473,11-02-2021 12:00,24 hrs.,pennystocks,NMTLF,1087,133,954,-821,3,421,233,3,OTC
4473,11-02-2021 12:00,24 hrs.,pennystocks,NSRCF,86,0,86,-86,2,27,24,2,OTC
4473,11-02-2021 12:00,24 hrs.,pennystocks,NXGWF,19,19,0,19,1,3,9,1,OTC
4473,11-02-2021 12:00,24 hrs.,pennystocks,NXTFF,4,0,4,-4,1,0,0,1,OTC
4473,11-02-2021 12:00,24 hrs.,pennystocks,NXTTF,125,7,118,-111,21,20,1,2,OTC
4473,11-02-2021 12:00,24 hrs.,pennystocks,OTIVF,7,0,7,-7,1,1,1,1,OTC
4473,11-02-2021 12:00,24 hrs.,pennystocks,PFFOF,80,0,80,-80,1,26,24,1,OTC
4473,11-02-2021 12:00,24 hrs.,pennystocks,PFWIQ,118,118,0,118,1,42,30,1,OTC
4473,11-02-2021 12:00,24 hrs.,pennystocks,PLCKF,185,144,41,103,3,69,35,3,OTC
4473,11-02-2021 12:00,24 hrs.,pennystocks,PLPRF,6,6,0,6,1,1,0,1,OTC
4473,11-02-2021 12:00,24 hrs.,pennystocks,PTNYF,6,0,6,-6,1,1,0,1,OTC
4473,11-02-2021 12:00,24 hrs.,pennystocks,PTOTF,26,6,20,-14,2,6,6,2,OTC
4473,11-02-2021 12:00,24 hrs.,pennystocks,PWRMF,7,0,7,-7,1,1,1,1,OTC
4473,11-02-2021 12:00,24 hrs.,pennystocks,QNCCF,7,7,0,7,1,1,1,1,OTC
4473,11-02-2021 12:00,24 hrs.,pennystocks,QYOUF,6,6,0,6,1,1,0,1,OTC
4473,11-02-2021 12:00,24 hrs.,pennystocks,RAZFF,82,0,82,-82,2,23,28,2,OTC
4473,11-02-2021 12:00,24 hrs.,pennystocks,RCPIQ,8,0,8,-8,1,1,2,1,OTC
4473,11-02-2021 12:00,24 hrs.,pennystocks,REZZF,291,211,80,131,4,105,65,4,OTC
4473,11-02-2021 12:00,24 hrs.,pennystocks,RHCCF,6,6,0,6,1,1,0,1,OTC
4473,11-02-2021 12:00,24 hrs.,pennystocks,RLFTF,19,13,6,7,3,3,1,2,OTC
4473,11-02-2021 12:00,24 hrs.,pennystocks,PTOP,5,5,0,5,1,0,1,1,OTC
4473,11-02-2021 12:00,24 hrs.,pennystocks,PUGE,39,39,0,39,1,13,9,1,OTC
4473,11-02-2021 12:00,24 hrs.,pennystocks,PURA,6,6,0,6,1,1,0,1,OTC
4473,11-02-2021 12:00,24 hrs.,pennystocks,PVDG,758,217,541,-324,8,283,160,8,OTC
4473,11-02-2021 12:00,24 hrs.,pennystocks,QMCI,6,0,6,-6,1,1,0,1,OTC
4473,11-02-2021 12:00,24 hrs.,pennystocks,RBDC,7,7,0,7,1,1,1,1,OTC
4473,11-02-2021 12:00,24 hrs.,pennystocks,RBNW,36,0,36,-36,3,5,14,2,OTC
4473,11-02-2021 12:00,24 hrs.,pennystocks,RDGL,54,0,54,-54,2,19,8,2,OTC
4473,11-02-2021 12:00,24 hrs.,pennystocks,RKLC,6,6,0,6,1,1,0,1,OTC
4473,11-02-2021 12:00,24 hrs.,pennystocks,ROTH,37,37,0,37,1,13,7,1,OTC
4473,11-02-2021 12:00,24 hrs.,pennystocks,RSSV,64,0,64,-64,1,21,18,1,OTC
4473,11-02-2021 12:00,24 hrs.,pennystocks,RTON,312,124,188,-64,14,90,76,13,OTC
4473,11-02-2021 12:00,24 hrs.,pennystocks,SANP,6,0,6,-6,1,1,0,1,OTC
4473,11-02-2021 12:00,24 hrs.,pennystocks,SBFM,35,0,35,-35,2,10,7,2,OTC
4473,11-02-2021 12:00,24 hrs.,pennystocks,SEEK,6,0,6,-6,1,1,0,1,OTC
4473,11-02-2021 12:00,24 hrs.,pennystocks,SENY,41,41,0,41,1,15,7,1,OTC
4473,11-02-2021 12:00,24 hrs.,pennystocks,SGMD,1169,823,346,477,12,429,263,10,OTC
4473,11-02-2021 12:00,24 hrs.,pennystocks,SGSI,76,7,69,-62,8,15,14,4,OTC
4473,11-02-2021 12:00,24 hrs.,pennystocks,SHMP,6,6,0,6,1,1,0,1,OTC
4473,11-02-2021 12:00,24 hrs.,pennystocks,SIML,131,118,13,105,3,44,31,3,OTC
4473,11-02-2021 12:00,24 hrs.,pennystocks,SING,7,0,7,-7,1,1,1,1,OTC
4473,11-02-2021 12:00,24 hrs.,pennystocks,SIRC,34,0,34,-34,1,10,10,1,OTC
4473,11-02-2021 12:00,24 hrs.,pennystocks,SKDI,24,0,24,-24,3,4,4,2,OTC
4473,11-02-2021 12:00,24 hrs.,pennystocks,SNDD,6,0,6,-6,1,1,0,1,OTC
4473,11-02-2021 12:00,24 hrs.,pennystocks,SNPW,101,88,13,75,3,40,9,3,OTC
4473,11-02-2021 12:00,24 hrs.,pennystocks,SNRS,124,118,6,112,2,43,30,2,OTC
4473,11-02-2021 12:00,24 hrs.,pennystocks,SPRN,7,7,0,7,1,1,1,1,OTC
4473,11-02-2021 12:00,24 hrs.,pennystocks,SRMX,63,0,63,-63,3,19,13,3,OTC
4473,11-02-2021 12:00,24 hrs.,pennystocks,SSFT,6,0,6,-6,1,1,0,1,OTC
4473,11-02-2021 12:00,24 hrs.,pennystocks,STHI,69,0,69,-69,1,27,11,1,OTC
4473,11-02-2021 12:00,24 hrs.,pennystocks,STMH,31,0,31,-31,2,8,7,2,OTC
4473,11-02-2021 12:00,24 hrs.,pennystocks,STWC,16,0,16,-16,2,2,4,2,OTC
4473,11-02-2021 12:00,24 hrs.,pennystocks,SUGR,48,0,48,-48,3,13,10,3,OTC
4473,11-02-2021 12:00,24 hrs.,pennystocks,SUIC,12,0,12,-12,2,2,0,1,OTC
4473,11-02-2021 12:00,24 hrs.,pennystocks,SWRM,6,0,6,-6,1,1,0,1,OTC
4473,11-02-2021 12:00,24 hrs.,pennystocks,TBEV,110,110,0,110,1,28,50,1,OTC
4473,11-02-2021 12:00,24 hrs.,pennystocks,TEUM,7,0,7,-7,1,1,1,1,OTC
4473,11-02-2021 12:00,24 hrs.,pennystocks,TLSS,190,7,183,-176,4,43,88,4,OTC
4473,11-02-2021 12:00,24 hrs.,pennystocks,TONR,195,195,0,195,2,58,71,2,OTC
4473,11-02-2021 12:00,24 hrs.,pennystocks,TPAC,6,0,6,-6,1,1,0,1,OTC
4473,11-02-2021 12:00,24 hrs.,pennystocks,TRTC,17,0,17,-17,2,3,3,2,OTC
4473,11-02-2021 12:00,24 hrs.,pennystocks,TSNP,208,155,53,102,8,58,60,8,OTC
4473,11-02-2021 12:00,24 hrs.,pennystocks,TTCM,6,6,0,6,1,1,0,1,OTC
4473,11-02-2021 12:00,24 hrs.,pennystocks,UATG,69,6,63,-57,8,13,11,7,OTC
4473,11-02-2021 12:00,24 hrs.,pennystocks,UBQU,185,0,185,-185,3,63,47,3,OTC
4473,11-02-2021 12:00,24 hrs.,pennystocks,UITA,8,0,8,-8,1,1,2,1,OTC
4473,11-02-2021 12:00,24 hrs.,pennystocks,UPCO,20,0,20,-20,1,7,2,1,OTC
4473,11-02-2021 12:00,24 hrs.,pennystocks,USMJ,176,0,176,-176,7,51,46,7,OTC
4473,11-02-2021 12:00,24 hrs.,pennystocks,UVSE,49,40,9,31,3,12,13,2,OTC
4473,11-02-2021 12:00,24 hrs.,pennystocks,VIBI,7,0,7,-7,1,1,1,1,OTC
4473,11-02-2021 12:00,24 hrs.,pennystocks,VITX,6,0,6,-6,1,1,0,1,OTC
4473,11-02-2021 12:00,24 hrs.,pennystocks,VMHG,207,207,0,207,4,60,71,2,OTC
4473,11-02-2021 12:00,24 hrs.,pennystocks,VPER,12,0,12,-12,2,2,0,2,OTC
4473,11-02-2021 12:00,24 hrs.,pennystocks,VYST,6,6,0,6,1,1,0,1,OTC
4473,11-02-2021 12:00,24 hrs.,pennystocks,WDLF,6,0,6,-6,1,1,0,1,OTC
4473,11-02-2021 12:00,24 hrs.,pennystocks,WHEN,7,7,0,7,1,1,1,1,OTC
4473,11-02-2021 12:00,24 hrs.,pennystocks,WNCP,7,0,7,-7,1,1,1,1,OTC
4473,11-02-2021 12:00,24 hrs.,pennystocks,WSTL,7,0,7,-7,1,1,1,1,OTC
4473,11-02-2021 12:00,24 hrs.,pennystocks,XFLS,6,0,6,-6,1,1,0,1,OTC
4473,11-02-2021 12:00,24 hrs.,pennystocks,XMET,138,118,20,98,2,46,38,2,OTC
4473,11-02-2021 12:00,24 hrs.,pennystocks,ABEPF,1204,236,968,-732,11,453,254,10,OTC
4473,11-02-2021 12:00,24 hrs.,pennystocks,ACRHF,6,0,6,-6,1,1,0,1,OTC
4473,11-02-2021 12:00,24 hrs.,pennystocks,AGFAF,24,6,18,-12,4,4,0,4,OTC
4473,11-02-2021 12:00,24 hrs.,pennystocks,AGNPF,45,0,45,-45,1,17,7,1,OTC
4473,11-02-2021 12:00,24 hrs.,pennystocks,INIS,34,0,34,-34,1,12,6,1,OTC
4473,11-02-2021 12:00,24 hrs.,pennystocks,INKW,38,0,38,-38,6,6,2,6,OTC
4473,11-02-2021 12:00,24 hrs.,pennystocks,INND,160,13,147,-134,9,48,28,7,OTC
4473,11-02-2021 12:00,24 hrs.,pennystocks,INQD,83,0,83,-83,2,27,21,2,OTC
4473,11-02-2021 12:00,24 hrs.,pennystocks,IPIX,64,0,64,-64,4,16,16,3,OTC
4473,11-02-2021 12:00,24 hrs.,pennystocks,IQST,14,0,14,-14,2,2,2,1,OTC
4473,11-02-2021 12:00,24 hrs.,pennystocks,JADA,19,0,19,-19,3,3,1,2,OTC
4473,11-02-2021 12:00,24 hrs.,pennystocks,JAMN,195,195,0,195,2,58,71,2,OTC
4473,11-02-2021 12:00,24 hrs.,pennystocks,JRSS,23,9,14,-5,3,4,3,3,OTC
4473,11-02-2021 12:00,24 hrs.,pennystocks,KBLB,7,0,7,-7,1,1,1,1,OTC
4473,11-02-2021 12:00,24 hrs.,pennystocks,KGET,34,34,0,34,1,8,14,1,OTC
4473,11-02-2021 12:00,24 hrs.,pennystocks,KGKG,6,0,6,-6,1,1,0,1,OTC
4473,11-02-2021 12:00,24 hrs.,pennystocks,KKUR,6,0,6,-6,1,1,0,1,OTC
4473,11-02-2021 12:00,24 hrs.,pennystocks,KRFG,7,0,7,-7,1,1,1,1,OTC
4473,11-02-2021 12:00,24 hrs.,pennystocks,KSHB,55,0,55,-55,1,22,7,1,OTC
4473,11-02-2021 12:00,24 hrs.,pennystocks,KULR,13,0,13,-13,2,2,1,1,OTC
4473,11-02-2021 12:00,24 hrs.,pennystocks,KWBT,7,0,7,-7,1,1,1,1,OTC
4473,11-02-2021 12:00,24 hrs.,pennystocks,LAAB,6,0,6,-6,1,1,0,1,OTC
4473,11-02-2021 12:00,24 hrs.,pennystocks,LBSR,25,0,25,-25,4,4,1,2,OTC
4473,11-02-2021 12:00,24 hrs.,pennystocks,LBUY,56,56,0,56,1,24,4,1,OTC
4473,11-02-2021 12:00,24 hrs.,pennystocks,LTNC,49,0,49,-49,1,19,7,1,OTC
4473,11-02-2021 12:00,24 hrs.,pennystocks,LVVV,41,19,22,-3,3,4,21,3,OTC
4473,11-02-2021 12:00,24 hrs.,pennystocks,MAXD,6,6,0,6,1,1,0,1,OTC
4473,11-02-2021 12:00,24 hrs.,pennystocks,MBAY,20,0,20,-20,1,1,14,1,OTC
4473,11-02-2021 12:00,24 hrs.,pennystocks,MCOA,46,13,33,-20,7,7,4,5,OTC
4473,11-02-2021 12:00,24 hrs.,pennystocks,MEGH,195,195,0,195,2,58,71,2,OTC
4473,11-02-2021 12:00,24 hrs.,pennystocks,MFST,13,13,0,13,2,2,1,1,OTC
4473,11-02-2021 12:00,24 hrs.,pennystocks,MGLG,6,0,6,-6,1,1,0,1,OTC
4473,11-02-2021 12:00,24 hrs.,pennystocks,MGTI,27,6,21,-15,4,4,3,2,OTC
4473,11-02-2021 12:00,24 hrs.,pennystocks,MINE,475,355,120,235,10,175,85,9,OTC
4473,11-02-2021 12:00,24 hrs.,pennystocks,MJLB,18,0,18,-18,3,3,0,2,OTC
4473,11-02-2021 12:00,24 hrs.,pennystocks,MJNA,79,13,66,-53,11,15,5,10,OTC
4473,11-02-2021 12:00,24 hrs.,pennystocks,MLFB,133,0,133,-133,1,38,53,1,OTC
4473,11-02-2021 12:00,24 hrs.,pennystocks,MMEX,334,135,199,-64,14,112,54,13,OTC
4473,11-02-2021 12:00,24 hrs.,pennystocks,MOST,298,0,298,-298,2,74,142,2,OTC
4473,11-02-2021 12:00,24 hrs.,pennystocks,MRMD,6,0,6,-6,1,1,0,1,OTC
4473,11-02-2021 12:00,24 hrs.,pennystocks,MSPC,20,0,20,-20,3,3,2,2,OTC
4473,11-02-2021 12:00,24 hrs.,pennystocks,MSRT,6,0,6,-6,1,1,0,1,OTC
4473,11-02-2021 12:00,24 hrs.,pennystocks,MTVX,13,0,13,-13,2,2,1,2,OTC
4473,11-02-2021 12:00,24 hrs.,pennystocks,MYDX,7,0,7,-7,1,1,1,1,OTC
4473,11-02-2021 12:00,24 hrs.,pennystocks,NLST,7,0,7,-7,1,1,1,1,OTC
4473,11-02-2021 12:00,24 hrs.,pennystocks,NOHO,110,110,0,110,1,28,50,1,OTC
4473,11-02-2021 12:00,24 hrs.,pennystocks,NOVC,40,40,0,40,1,15,6,1,OTC
4473,11-02-2021 12:00,24 hrs.,pennystocks,NSAV,14,0,14,-14,2,2,2,1,OTC
4473,11-02-2021 12:00,24 hrs.,pennystocks,NSMG,25,25,0,25,1,5,11,1,OTC
4473,11-02-2021 12:00,24 hrs.,pennystocks,NSPT,195,195,0,195,2,58,71,2,OTC
4473,11-02-2021 12:00,24 hrs.,pennystocks,NSPX,7,0,7,-7,1,1,1,1,OTC
4473,11-02-2021 12:00,24 hrs.,pennystocks,NUKK,14,0,14,-14,2,2,2,2,OTC
4473,11-02-2021 12:00,24 hrs.,pennystocks,NVGT,195,195,0,195,2,58,71,2,OTC
4473,11-02-2021 12:00,24 hrs.,pennystocks,OPTI,13,6,7,-1,2,2,1,2,OTC
4473,11-02-2021 12:00,24 hrs.,pennystocks,OSKA,195,195,0,195,2,58,71,2,OTC
4473,11-02-2021 12:00,24 hrs.,pennystocks,OZSC,56,7,49,-42,2,17,14,2,OTC
4473,11-02-2021 12:00,24 hrs.,pennystocks,PAOG,23,23,0,23,1,6,7,1,OTC
4473,11-02-2021 12:00,24 hrs.,pennystocks,PCTL,6,0,6,-6,1,1,0,1,OTC
4473,11-02-2021 12:00,24 hrs.,pennystocks,PHBI,7,7,0,7,1,1,1,1,OTC
4473,11-02-2021 12:00,24 hrs.,pennystocks,PHIL,20,0,20,-20,3,3,2,2,OTC
4473,11-02-2021 12:00,24 hrs.,pennystocks,PHMB,7,0,7,-7,1,1,1,1,OTC
4473,11-02-2021 12:00,24 hrs.,pennystocks,PLYZ,7,0,7,-7,1,1,1,1,OTC
4473,11-02-2021 12:00,24 hrs.,pennystocks,PMCB,40,0,40,-40,1,9,18,1,OTC
4473,11-02-2021 12:00,24 hrs.,pennystocks,PNAT,6,6,0,6,1,1,0,1,OTC
4473,11-02-2021 12:00,24 hrs.,pennystocks,POTN,13,13,0,13,2,2,1,2,OTC
4473,11-02-2021 12:00,24 hrs.,pennystocks,PPJE,15,0,15,-15,2,2,3,2,OTC
4473,11-02-2021 12:00,24 hrs.,pennystocks,PRED,6,0,6,-6,1,1,0,1,OTC
4473,11-02-2021 12:00,24 hrs.,pennystocks,PSYC,7,0,7,-7,1,1,1,1,OTC
4473,11-02-2021 12:00,24 hrs.,pennystocks,DROP,8,0,8,-8,1,1,2,1,OTC
4473,11-02-2021 12:00,24 hrs.,pennystocks,DRWN,7,7,0,7,1,1,1,1,OTC
4473,11-02-2021 12:00,24 hrs.,pennystocks,DSCR,13,13,0,13,2,2,1,1,OTC
4473,11-02-2021 12:00,24 hrs.,pennystocks,ECGI,195,195,0,195,2,58,71,2,OTC
4473,11-02-2021 12:00,24 hrs.,pennystocks,ECIA,6,0,6,-6,1,1,0,1,OTC
4473,11-02-2021 12:00,24 hrs.,pennystocks,EDXC,14,0,14,-14,2,2,2,1,OTC
4473,11-02-2021 12:00,24 hrs.,pennystocks,EHOS,201,201,0,201,3,59,71,3,OTC
4473,11-02-2021 12:00,24 hrs.,pennystocks,ENCS,118,118,0,118,1,42,30,1,OTC
4473,11-02-2021 12:00,24 hrs.,pennystocks,ENDO,118,118,0,118,1,42,30,1,OTC
4473,11-02-2021 12:00,24 hrs.,pennystocks,ENZC,268,110,158,-48,8,74,88,8,OTC
4473,11-02-2021 12:00,24 hrs.,pennystocks,ERBB,25,7,18,-11,4,4,1,4,OTC
4473,11-02-2021 12:00,24 hrs.,pennystocks,ETFM,461,228,233,-5,8,152,125,6,OTC
4473,11-02-2021 12:00,24 hrs.,pennystocks,ETST,13,0,13,-13,2,2,1,1,OTC
4473,11-02-2021 12:00,24 hrs.,pennystocks,EVTI,9,0,9,-9,1,1,3,1,OTC
4473,11-02-2021 12:00,24 hrs.,pennystocks,EWLL,27,6,21,-15,4,5,1,4,OTC
4473,11-02-2021 12:00,24 hrs.,pennystocks,FBEC,21,0,21,-21,3,3,3,3,OTC
4473,11-02-2021 12:00,24 hrs.,pennystocks,FOYJ,6,6,0,6,1,1,0,1,OTC
4473,11-02-2021 12:00,24 hrs.,pennystocks,FPFI,6,6,0,6,1,1,0,1,OTC
4473,11-02-2021 12:00,24 hrs.,pennystocks,FPVD,6,0,6,-6,1,1,0,1,OTC
4473,11-02-2021 12:00,24 hrs.,pennystocks,FTEG,6,0,6,-6,1,1,0,1,OTC
4473,11-02-2021 12:00,24 hrs.,pennystocks,FTXP,195,195,0,195,2,58,71,2,OTC
4473,11-02-2021 12:00,24 hrs.,pennystocks,FWDG,20,6,14,-8,3,3,2,3,OTC
4473,11-02-2021 12:00,24 hrs.,pennystocks,GACR,7,0,7,-7,1,1,1,1,OTC
4473,11-02-2021 12:00,24 hrs.,pennystocks,GAXY,81,6,75,-69,4,22,21,4,OTC
4473,11-02-2021 12:00,24 hrs.,pennystocks,GBLX,6,0,6,-6,1,1,0,1,OTC
4473,11-02-2021 12:00,24 hrs.,pennystocks,GCEH,6,0,6,-6,1,1,0,1,OTC
4473,11-02-2021 12:00,24 hrs.,pennystocks,GDET,1137,0,1137,-1137,1,539,55,1,OTC
4473,11-02-2021 12:00,24 hrs.,pennystocks,GHTI,7,0,7,-7,1,1,1,1,OTC
4473,11-02-2021 12:00,24 hrs.,pennystocks,GMEV,42,0,42,-42,7,7,0,4,OTC
4473,11-02-2021 12:00,24 hrs.,pennystocks,GMPR,6,6,0,6,1,1,0,1,OTC
4473,11-02-2021 12:00,24 hrs.,pennystocks,GNCC,7,0,7,-7,1,1,1,1,OTC
4473,11-02-2021 12:00,24 hrs.,pennystocks,GNPT,25,25,0,25,1,5,11,1,OTC
4473,11-02-2021 12:00,24 hrs.,pennystocks,GPFT,6,0,6,-6,1,1,0,1,OTC
4473,11-02-2021 12:00,24 hrs.,pennystocks,GRCU,15,0,15,-15,2,1,5,2,OTC
4473,11-02-2021 12:00,24 hrs.,pennystocks,GRCV,7,0,7,-7,1,1,1,1,OTC
4473,11-02-2021 12:00,24 hrs.,pennystocks,GRLF,6,6,0,6,1,1,0,1,OTC
4473,11-02-2021 12:00,24 hrs.,pennystocks,GRLT,6,0,6,-6,1,1,0,1,OTC
4473,11-02-2021 12:00,24 hrs.,pennystocks,GRNH,19,7,12,-5,2,3,5,2,OTC
4473,11-02-2021 12:00,24 hrs.,pennystocks,GRSO,12,6,6,0,2,2,0,2,OTC
4473,11-02-2021 12:00,24 hrs.,pennystocks,GTEH,117,0,117,-117,8,31,23,6,OTC
4473,11-02-2021 12:00,24 hrs.,pennystocks,GTLL,7,0,7,-7,1,1,1,1,OTC
4473,11-02-2021 12:00,24 hrs.,pennystocks,HBRM,53,53,0,53,1,19,11,1,OTC
4473,11-02-2021 12:00,24 hrs.,pennystocks,HCMC,200,56,144,-88,32,32,8,26,OTC
4473,11-02-2021 12:00,24 hrs.,pennystocks,HEMP,44,13,31,-18,7,7,2,6,OTC
4473,11-02-2021 12:00,24 hrs.,pennystocks,HESG,207,195,12,183,4,60,71,3,OTC
4473,11-02-2021 12:00,24 hrs.,pennystocks,HIPH,6,6,0,6,1,1,0,1,OTC
4473,11-02-2021 12:00,24 hrs.,pennystocks,HMNY,591,341,250,91,18,198,123,16,OTC
4473,11-02-2021 12:00,24 hrs.,pennystocks,HPNN,61,0,61,-61,1,20,17,1,OTC
4473,11-02-2021 12:00,24 hrs.,pennystocks,HQGE,91,0,91,-91,1,29,29,1,OTC
4473,11-02-2021 12:00,24 hrs.,pennystocks,HVCW,20,0,20,-20,1,5,6,1,OTC
4473,11-02-2021 12:00,24 hrs.,pennystocks,HYII,6,0,6,-6,1,1,0,1,OTC
4473,11-02-2021 12:00,24 hrs.,pennystocks,HYSR,344,116,228,-112,5,139,46,5,OTC
4473,11-02-2021 12:00,24 hrs.,pennystocks,IBRC,15,0,15,-15,2,2,3,1,OTC
4473,11-02-2021 12:00,24 hrs.,pennystocks,ICNM,118,118,0,118,1,42,30,1,OTC
4473,11-02-2021 12:00,24 hrs.,pennystocks,ICTY,14,0,14,-14,2,2,2,2,OTC
4473,11-02-2021 12:00,24 hrs.,pennystocks,IDEA,6,0,6,-6,1,1,0,1,OTC
4473,11-02-2021 12:00,24 hrs.,pennystocks,IFBC,7,0,7,-7,1,1,1,1,OTC
4473,11-02-2021 12:00,24 hrs.,pennystocks,IGEN,16,0,16,-16,2,2,4,1,OTC
4473,11-02-2021 12:00,24 hrs.,pennystocks,IGPK,6,6,0,6,1,1,0,1,OTC
4473,11-02-2021 12:00,24 hrs.,pennystocks,IGXT,6,0,6,-6,1,1,0,1,OTC
4473,11-02-2021 12:00,24 hrs.,pennystocks,ILAL,12,0,12,-12,2,2,0,2,OTC
4473,11-02-2021 12:00,24 hrs.,pennystocks,ILUS,23,0,23,-23,2,5,5,2,OTC
4473,11-02-2021 12:00,24 hrs.,pennystocks,IMJX,125,125,0,125,2,43,31,2,OTC
4473,11-02-2021 12:00,24 hrs.,pennystocks,IMTL,195,195,0,195,2,58,71,2,OTC
4473,11-02-2021 12:00,24 hrs.,RobinHoodPennyStocks,VXRT,201,201,0,201,1,80,37,1,NASDAQ
4473,11-02-2021 12:00,24 hrs.,RobinHoodPennyStocks,WATT,201,201,0,201,1,80,37,1,NASDAQ
4473,11-02-2021 12:00,24 hrs.,RobinHoodPennyStocks,WIMI,201,201,0,201,1,80,37,1,NASDAQ
4473,11-02-2021 12:00,24 hrs.,RobinHoodPennyStocks,XCUR,6,0,6,-6,1,1,0,1,NASDAQ
4473,11-02-2021 12:00,24 hrs.,RobinHoodPennyStocks,XONE,6,0,6,-6,1,1,0,1,NASDAQ
4473,11-02-2021 12:00,24 hrs.,RobinHoodPennyStocks,XSPA,105,0,105,-105,4,36,17,3,NASDAQ
4473,11-02-2021 12:00,24 hrs.,RobinHoodPennyStocks,YGMZ,201,201,0,201,1,80,37,1,NASDAQ
4473,11-02-2021 12:00,24 hrs.,RobinHoodPennyStocks,ZSAN,246,63,183,-120,8,73,68,8,NASDAQ
4473,11-02-2021 12:00,24 hrs.,RobinHoodPennyStocks,UONEK,201,201,0,201,1,80,37,1,NASDAQ
4473,11-02-2021 12:00,24 hrs.,pennystocks,AFOM,6,0,6,-6,1,1,0,1,OTC
4473,11-02-2021 12:00,24 hrs.,pennystocks,AGIN,17,0,17,-17,1,2,9,1,OTC
4473,11-02-2021 12:00,24 hrs.,pennystocks,AGYP,27,0,27,-27,3,6,3,3,OTC
4473,11-02-2021 12:00,24 hrs.,pennystocks,AITX,33,0,33,-33,3,2,17,3,OTC
4473,11-02-2021 12:00,24 hrs.,pennystocks,ALKM,23,0,23,-23,2,3,9,2,OTC
4473,11-02-2021 12:00,24 hrs.,pennystocks,ALPP,124,0,124,-124,3,40,32,3,OTC
4473,11-02-2021 12:00,24 hrs.,pennystocks,ALST,37,0,37,-37,2,12,5,2,OTC
4473,11-02-2021 12:00,24 hrs.,pennystocks,ALYI,132,126,6,120,4,31,54,4,OTC
4473,11-02-2021 12:00,24 hrs.,pennystocks,AMMJ,7,0,7,-7,1,1,1,1,OTC
4473,11-02-2021 12:00,24 hrs.,pennystocks,AMNE,12,6,6,0,2,2,0,2,OTC
4473,11-02-2021 12:00,24 hrs.,pennystocks,AMNL,120,110,10,100,2,46,20,2,OTC
4473,11-02-2021 12:00,24 hrs.,pennystocks,APYP,6,0,6,-6,1,1,0,1,OTC
4473,11-02-2021 12:00,24 hrs.,pennystocks,ASKE,7,0,7,-7,1,1,1,1,OTC
4473,11-02-2021 12:00,24 hrs.,pennystocks,ASTI,5586,5565,21,5544,6,2612,338,6,OTC
4473,11-02-2021 12:00,24 hrs.,pennystocks,BANT,7,0,7,-7,1,1,1,1,OTC
4473,11-02-2021 12:00,24 hrs.,pennystocks,BBDA,10,0,10,-10,1,2,2,1,OTC
4473,11-02-2021 12:00,24 hrs.,pennystocks,BBRW,173,0,173,-173,1,61,47,1,OTC
4473,11-02-2021 12:00,24 hrs.,pennystocks,BDGR,19,19,0,19,3,3,1,2,OTC
4473,11-02-2021 12:00,24 hrs.,pennystocks,BFCH,190,110,80,30,5,62,46,5,OTC
4473,11-02-2021 12:00,24 hrs.,pennystocks,BIGG,39,33,6,27,2,14,3,2,OTC
4473,11-02-2021 12:00,24 hrs.,pennystocks,BLDV,131,118,13,105,3,44,31,3,OTC
4473,11-02-2021 12:00,24 hrs.,pennystocks,BLSP,70,12,58,-46,4,20,14,4,OTC
4473,11-02-2021 12:00,24 hrs.,pennystocks,BNGI,43,12,31,-19,6,5,9,5,OTC
4473,11-02-2021 12:00,24 hrs.,pennystocks,BOTY,161,124,37,87,8,48,33,8,OTC
4473,11-02-2021 12:00,24 hrs.,pennystocks,BRAV,89,0,89,-89,3,27,23,3,OTC
4473,11-02-2021 12:00,24 hrs.,pennystocks,BRLL,129,53,76,-23,5,32,45,5,OTC
4473,11-02-2021 12:00,24 hrs.,pennystocks,BRRN,119,110,9,101,2,47,17,2,OTC
4473,11-02-2021 12:00,24 hrs.,pennystocks,BSSP,6,0,6,-6,1,1,0,1,OTC
4473,11-02-2021 12:00,24 hrs.,pennystocks,BTZI,7,7,0,7,1,1,1,1,OTC
4473,11-02-2021 12:00,24 hrs.,pennystocks,BUNM,195,195,0,195,2,58,71,2,OTC
4473,11-02-2021 12:00,24 hrs.,pennystocks,CAPC,7,0,7,-7,1,1,1,1,OTC
4473,11-02-2021 12:00,24 hrs.,pennystocks,CBBT,241,71,170,-99,4,53,119,4,OTC
4473,11-02-2021 12:00,24 hrs.,pennystocks,CBDD,273,7,266,-259,2,103,59,2,OTC
4473,11-02-2021 12:00,24 hrs.,pennystocks,CBDL,663,7,656,-649,10,224,175,10,OTC
4473,11-02-2021 12:00,24 hrs.,pennystocks,CBDX,6,0,6,-6,1,1,0,1,OTC
4473,11-02-2021 12:00,24 hrs.,pennystocks,CCAN,7,7,0,7,1,1,1,1,OTC
4473,11-02-2021 12:00,24 hrs.,pennystocks,CCTL,7,7,0,7,1,1,1,1,OTC
4473,11-02-2021 12:00,24 hrs.,pennystocks,CELZ,32,0,32,-32,2,8,8,2,OTC
4473,11-02-2021 12:00,24 hrs.,pennystocks,CEOS,20,0,20,-20,3,3,2,1,OTC
4473,11-02-2021 12:00,24 hrs.,pennystocks,CETY,6,0,6,-6,1,1,0,1,OTC
4473,11-02-2021 12:00,24 hrs.,pennystocks,CHUC,27,0,27,-27,3,5,5,2,OTC
4473,11-02-2021 12:00,24 hrs.,pennystocks,CLWD,40,0,40,-40,4,8,8,4,OTC
4473,11-02-2021 12:00,24 hrs.,pennystocks,CNNA,180,0,180,-180,3,66,36,2,OTC
4473,11-02-2021 12:00,24 hrs.,pennystocks,CNXS,21,0,21,-21,1,0,17,1,OTC
4473,11-02-2021 12:00,24 hrs.,pennystocks,CORG,67,48,19,29,6,10,23,3,OTC
4473,11-02-2021 12:00,24 hrs.,pennystocks,COUV,118,110,8,102,2,46,18,2,OTC
4473,11-02-2021 12:00,24 hrs.,pennystocks,COWI,27,27,0,27,1,7,9,1,OTC
4473,11-02-2021 12:00,24 hrs.,pennystocks,CVAT,69,0,69,-69,1,27,11,1,OTC
4473,11-02-2021 12:00,24 hrs.,pennystocks,CYBL,7,7,0,7,1,1,1,1,OTC
4473,11-02-2021 12:00,24 hrs.,pennystocks,DGTW,33,0,33,-33,3,6,9,3,OTC
4473,11-02-2021 12:00,24 hrs.,pennystocks,DKAM,41,0,41,-41,6,6,5,1,OTC
4473,11-02-2021 12:00,24 hrs.,pennystocks,DKMR,6,0,6,-6,1,1,0,1,OTC
4473,11-02-2021 12:00,24 hrs.,pennystocks,DLAD,40,34,6,28,2,9,14,2,OTC
4473,11-02-2021 12:00,24 hrs.,pennystocks,DPLS,12,0,12,-12,2,2,0,2,OTC
4473,11-02-2021 12:00,24 hrs.,pennystocks,DPWW,4,0,4,-4,1,0,0,1,OTC
4473,11-02-2021 12:00,24 hrs.,RobinHoodPennyStocks,NMTR,59,0,59,-59,2,18,15,2,NASDAQ
4473,11-02-2021 12:00,24 hrs.,RobinHoodPennyStocks,NOVN,100,88,12,76,3,24,40,3,NASDAQ
4473,11-02-2021 12:00,24 hrs.,RobinHoodPennyStocks,NTEC,201,201,0,201,1,80,37,1,NASDAQ
4473,11-02-2021 12:00,24 hrs.,RobinHoodPennyStocks,NVCN,213,33,180,-147,7,49,87,7,NASDAQ
4473,11-02-2021 12:00,24 hrs.,RobinHoodPennyStocks,NXTD,207,207,0,207,2,81,37,2,NASDAQ
4473,11-02-2021 12:00,24 hrs.,RobinHoodPennyStocks,OCGN,262,207,55,152,11,90,38,10,NASDAQ
4473,11-02-2021 12:00,24 hrs.,RobinHoodPennyStocks,ONTX,66,42,24,18,7,14,10,6,NASDAQ
4473,11-02-2021 12:00,24 hrs.,RobinHoodPennyStocks,OPGN,252,240,12,228,5,94,44,4,NASDAQ
4473,11-02-2021 12:00,24 hrs.,RobinHoodPennyStocks,OPTT,201,201,0,201,1,80,37,1,NASDAQ
4473,11-02-2021 12:00,24 hrs.,RobinHoodPennyStocks,PECK,201,201,0,201,1,80,37,1,NASDAQ
4473,11-02-2021 12:00,24 hrs.,RobinHoodPennyStocks,PEIX,201,201,0,201,1,80,37,1,NASDAQ
4473,11-02-2021 12:00,24 hrs.,RobinHoodPennyStocks,PETZ,201,201,0,201,1,80,37,1,NASDAQ
4473,11-02-2021 12:00,24 hrs.,RobinHoodPennyStocks,PHUN,201,201,0,201,1,80,37,1,NASDAQ
4473,11-02-2021 12:00,24 hrs.,RobinHoodPennyStocks,PLAY,12,6,6,0,2,2,0,2,NASDAQ
4473,11-02-2021 12:00,24 hrs.,RobinHoodPennyStocks,PLIN,201,201,0,201,1,80,37,1,NASDAQ
4473,11-02-2021 12:00,24 hrs.,RobinHoodPennyStocks,PLRX,201,201,0,201,1,80,37,1,NASDAQ
4473,11-02-2021 12:00,24 hrs.,RobinHoodPennyStocks,PLUG,201,201,0,201,1,80,37,1,NASDAQ
4473,11-02-2021 12:00,24 hrs.,RobinHoodPennyStocks,PLUS,904,0,904,-904,1,377,146,1,NASDAQ
4473,11-02-2021 12:00,24 hrs.,RobinHoodPennyStocks,PRQR,53,0,53,-53,1,17,15,1,NASDAQ
4473,11-02-2021 12:00,24 hrs.,RobinHoodPennyStocks,PRTA,201,201,0,201,1,80,37,1,NASDAQ
4473,11-02-2021 12:00,24 hrs.,RobinHoodPennyStocks,PSTV,1294,0,1294,-1294,4,441,396,4,NASDAQ
4473,11-02-2021 12:00,24 hrs.,RobinHoodPennyStocks,PULM,110,27,83,-56,3,36,26,2,NASDAQ
4473,11-02-2021 12:00,24 hrs.,RobinHoodPennyStocks,RCMT,201,201,0,201,1,80,37,1,NASDAQ
4473,11-02-2021 12:00,24 hrs.,RobinHoodPennyStocks,REAL,6,0,6,-6,1,1,0,1,NASDAQ
4473,11-02-2021 12:00,24 hrs.,RobinHoodPennyStocks,RIGL,8,8,0,8,1,2,0,1,NASDAQ
4473,11-02-2021 12:00,24 hrs.,RobinHoodPennyStocks,RIOT,207,201,6,195,2,81,37,2,NASDAQ
4473,11-02-2021 12:00,24 hrs.,RobinHoodPennyStocks,RKDA,201,201,0,201,1,80,37,1,NASDAQ
4473,11-02-2021 12:00,24 hrs.,RobinHoodPennyStocks,RNWK,201,201,0,201,1,80,37,1,NASDAQ
4473,11-02-2021 12:00,24 hrs.,RobinHoodPennyStocks,SALM,201,201,0,201,1,80,37,1,NASDAQ
4473,11-02-2021 12:00,24 hrs.,RobinHoodPennyStocks,SAVA,201,201,0,201,1,80,37,1,NASDAQ
4473,11-02-2021 12:00,24 hrs.,RobinHoodPennyStocks,SBBP,201,201,0,201,1,80,37,1,NASDAQ
4473,11-02-2021 12:00,24 hrs.,RobinHoodPennyStocks,SEED,201,201,0,201,1,80,37,1,NASDAQ
4473,11-02-2021 12:00,24 hrs.,RobinHoodPennyStocks,SELB,14,14,0,14,1,3,4,1,NASDAQ
4473,11-02-2021 12:00,24 hrs.,RobinHoodPennyStocks,SHIP,6,6,0,6,1,1,0,1,NASDAQ
4473,11-02-2021 12:00,24 hrs.,RobinHoodPennyStocks,SLRX,201,201,0,201,1,80,37,1,NASDAQ
4473,11-02-2021 12:00,24 hrs.,RobinHoodPennyStocks,SNCA,20,0,20,-20,1,7,2,1,NASDAQ
4473,11-02-2021 12:00,24 hrs.,RobinHoodPennyStocks,SNDL,4791,1789,3002,-1213,111,1532,1283,96,NASDAQ
4473,11-02-2021 12:00,24 hrs.,RobinHoodPennyStocks,SRGA,33,33,0,33,1,11,7,1,NASDAQ
4473,11-02-2021 12:00,24 hrs.,RobinHoodPennyStocks,SUNW,201,201,0,201,1,80,37,1,NASDAQ
4473,11-02-2021 12:00,24 hrs.,RobinHoodPennyStocks,SXTC,201,201,0,201,1,80,37,1,NASDAQ
4473,11-02-2021 12:00,24 hrs.,RobinHoodPennyStocks,SYPR,201,201,0,201,1,80,37,1,NASDAQ
4473,11-02-2021 12:00,24 hrs.,RobinHoodPennyStocks,SYTA,201,201,0,201,1,80,37,1,NASDAQ
4473,11-02-2021 12:00,24 hrs.,RobinHoodPennyStocks,TANH,201,201,0,201,1,80,37,1,NASDAQ
4473,11-02-2021 12:00,24 hrs.,RobinHoodPennyStocks,TAOP,201,201,0,201,1,80,37,1,NASDAQ
4473,11-02-2021 12:00,24 hrs.,RobinHoodPennyStocks,TBLT,6,0,6,-6,1,1,0,1,NASDAQ
4473,11-02-2021 12:00,24 hrs.,RobinHoodPennyStocks,TEAM,6,6,0,6,1,1,0,1,NASDAQ
4473,11-02-2021 12:00,24 hrs.,RobinHoodPennyStocks,TEDU,201,201,0,201,1,80,37,1,NASDAQ
4473,11-02-2021 12:00,24 hrs.,RobinHoodPennyStocks,TIGR,207,201,6,195,2,81,37,2,NASDAQ
4473,11-02-2021 12:00,24 hrs.,RobinHoodPennyStocks,TLGT,12,0,12,-12,1,3,2,1,NASDAQ
4473,11-02-2021 12:00,24 hrs.,RobinHoodPennyStocks,TLRY,344,311,33,278,5,117,90,5,NASDAQ
4473,11-02-2021 12:00,24 hrs.,RobinHoodPennyStocks,TLSA,201,201,0,201,1,80,37,1,NASDAQ
4473,11-02-2021 12:00,24 hrs.,RobinHoodPennyStocks,TNXP,332,289,43,246,7,111,82,7,NASDAQ
4473,11-02-2021 12:00,24 hrs.,RobinHoodPennyStocks,TRCH,456,201,255,-54,8,158,108,8,NASDAQ
4473,11-02-2021 12:00,24 hrs.,RobinHoodPennyStocks,TRIP,22,0,22,-22,1,3,12,1,NASDAQ
4473,11-02-2021 12:00,24 hrs.,RobinHoodPennyStocks,TTOO,201,201,0,201,1,80,37,1,NASDAQ
4473,11-02-2021 12:00,24 hrs.,RobinHoodPennyStocks,TXMD,89,6,83,-77,7,23,15,6,NASDAQ
4473,11-02-2021 12:00,24 hrs.,RobinHoodPennyStocks,TYME,6,0,6,-6,1,1,0,1,NASDAQ
4473,11-02-2021 12:00,24 hrs.,RobinHoodPennyStocks,UNFI,8,0,8,-8,1,2,0,1,NASDAQ
4473,11-02-2021 12:00,24 hrs.,RobinHoodPennyStocks,UONE,201,201,0,201,1,80,37,1,NASDAQ
4473,11-02-2021 12:00,24 hrs.,RobinHoodPennyStocks,UXIN,201,201,0,201,1,80,37,1,NASDAQ
4473,11-02-2021 12:00,24 hrs.,RobinHoodPennyStocks,VBIV,30,0,30,-30,1,8,10,1,NASDAQ
4473,11-02-2021 12:00,24 hrs.,RobinHoodPennyStocks,VISL,32,0,32,-32,2,5,14,2,NASDAQ
4473,11-02-2021 12:00,24 hrs.,RobinHoodPennyStocks,VRME,201,201,0,201,1,80,37,1,NASDAQ
4473,11-02-2021 12:00,24 hrs.,RobinHoodPennyStocks,VTVT,201,201,0,201,1,80,37,1,NASDAQ
4473,11-02-2021 12:00,24 hrs.,RobinHoodPennyStocks,CDEV,6,0,6,-6,1,1,0,1,NASDAQ
4473,11-02-2021 12:00,24 hrs.,RobinHoodPennyStocks,CGIX,244,201,43,158,3,89,54,3,NASDAQ
4473,11-02-2021 12:00,24 hrs.,RobinHoodPennyStocks,CIDM,14,0,14,-14,2,2,2,2,NASDAQ
4473,11-02-2021 12:00,24 hrs.,RobinHoodPennyStocks,CLEU,201,201,0,201,1,80,37,1,NASDAQ
4473,11-02-2021 12:00,24 hrs.,RobinHoodPennyStocks,CLSK,201,201,0,201,1,80,37,1,NASDAQ
4473,11-02-2021 12:00,24 hrs.,RobinHoodPennyStocks,CNSP,201,201,0,201,1,80,37,1,NASDAQ
4473,11-02-2021 12:00,24 hrs.,RobinHoodPennyStocks,CPRX,132,0,132,-132,1,55,18,1,NASDAQ
4473,11-02-2021 12:00,24 hrs.,RobinHoodPennyStocks,CRBP,236,201,35,166,3,87,50,3,NASDAQ
4473,11-02-2021 12:00,24 hrs.,RobinHoodPennyStocks,CRON,201,201,0,201,1,80,37,1,NASDAQ
4473,11-02-2021 12:00,24 hrs.,RobinHoodPennyStocks,CTRM,435,243,192,51,18,132,99,18,NASDAQ
4473,11-02-2021 12:00,24 hrs.,RobinHoodPennyStocks,CYCN,18,0,18,-18,3,3,0,2,NASDAQ
4473,11-02-2021 12:00,24 hrs.,RobinHoodPennyStocks,DMTK,201,201,0,201,1,80,37,1,NASDAQ
4473,11-02-2021 12:00,24 hrs.,RobinHoodPennyStocks,DTEA,49,0,49,-49,2,16,9,1,NASDAQ
4473,11-02-2021 12:00,24 hrs.,RobinHoodPennyStocks,DZSI,201,201,0,201,1,80,37,1,NASDAQ
4473,11-02-2021 12:00,24 hrs.,RobinHoodPennyStocks,EAST,273,33,240,-207,6,84,81,6,NASDAQ
4473,11-02-2021 12:00,24 hrs.,RobinHoodPennyStocks,EBON,201,201,0,201,1,80,37,1,NASDAQ
4473,11-02-2021 12:00,24 hrs.,RobinHoodPennyStocks,EDIT,125,0,125,-125,2,22,73,2,NASDAQ
4473,11-02-2021 12:00,24 hrs.,RobinHoodPennyStocks,ENVB,69,0,69,-69,2,16,29,2,NASDAQ
4473,11-02-2021 12:00,24 hrs.,RobinHoodPennyStocks,EQOS,201,201,0,201,1,80,37,1,NASDAQ
4473,11-02-2021 12:00,24 hrs.,RobinHoodPennyStocks,EVFM,53,0,53,-53,1,17,15,1,NASDAQ
4473,11-02-2021 12:00,24 hrs.,RobinHoodPennyStocks,FCEL,201,201,0,201,1,80,37,1,NASDAQ
4473,11-02-2021 12:00,24 hrs.,RobinHoodPennyStocks,FRHC,201,201,0,201,1,80,37,1,NASDAQ
4473,11-02-2021 12:00,24 hrs.,RobinHoodPennyStocks,GAIN,6,0,6,-6,1,1,0,1,NASDAQ
4473,11-02-2021 12:00,24 hrs.,RobinHoodPennyStocks,GEVO,201,201,0,201,1,80,37,1,NASDAQ
4473,11-02-2021 12:00,24 hrs.,RobinHoodPennyStocks,GHSI,273,207,66,141,5,105,43,5,NASDAQ
4473,11-02-2021 12:00,24 hrs.,RobinHoodPennyStocks,GMDA,201,201,0,201,1,80,37,1,NASDAQ
4473,11-02-2021 12:00,24 hrs.,RobinHoodPennyStocks,GPRE,201,201,0,201,1,80,37,1,NASDAQ
4473,11-02-2021 12:00,24 hrs.,RobinHoodPennyStocks,HEPA,6,0,6,-6,1,1,0,1,NASDAQ
4473,11-02-2021 12:00,24 hrs.,RobinHoodPennyStocks,HGSH,201,201,0,201,1,80,37,1,NASDAQ
4473,11-02-2021 12:00,24 hrs.,RobinHoodPennyStocks,HUSN,6,0,6,-6,1,1,0,1,NASDAQ
4473,11-02-2021 12:00,24 hrs.,RobinHoodPennyStocks,IDEX,201,201,0,201,1,80,37,1,NASDAQ
4473,11-02-2021 12:00,24 hrs.,RobinHoodPennyStocks,IMNM,201,201,0,201,1,80,37,1,NASDAQ
4473,11-02-2021 12:00,24 hrs.,RobinHoodPennyStocks,IMTE,201,201,0,201,1,80,37,1,NASDAQ
4473,11-02-2021 12:00,24 hrs.,RobinHoodPennyStocks,IPDN,201,201,0,201,1,80,37,1,NASDAQ
4473,11-02-2021 12:00,24 hrs.,RobinHoodPennyStocks,ITRM,254,207,47,160,8,89,44,6,NASDAQ
4473,11-02-2021 12:00,24 hrs.,RobinHoodPennyStocks,IZEA,201,201,0,201,1,80,37,1,NASDAQ
4473,11-02-2021 12:00,24 hrs.,RobinHoodPennyStocks,JFIN,201,201,0,201,1,80,37,1,NASDAQ
4473,11-02-2021 12:00,24 hrs.,RobinHoodPennyStocks,JRJC,201,201,0,201,1,80,37,1,NASDAQ
4473,11-02-2021 12:00,24 hrs.,RobinHoodPennyStocks,KALV,94,0,94,-94,1,17,56,1,NASDAQ
4473,11-02-2021 12:00,24 hrs.,RobinHoodPennyStocks,KDMN,12,12,0,12,2,2,0,2,NASDAQ
4473,11-02-2021 12:00,24 hrs.,RobinHoodPennyStocks,KERN,201,201,0,201,1,80,37,1,NASDAQ
4473,11-02-2021 12:00,24 hrs.,RobinHoodPennyStocks,KNDI,201,201,0,201,1,80,37,1,NASDAQ
4473,11-02-2021 12:00,24 hrs.,RobinHoodPennyStocks,KTRA,95,33,62,-29,5,24,27,5,NASDAQ
4473,11-02-2021 12:00,24 hrs.,RobinHoodPennyStocks,KXIN,201,201,0,201,1,80,37,1,NASDAQ
4473,11-02-2021 12:00,24 hrs.,RobinHoodPennyStocks,LIFE,6,6,0,6,1,1,0,1,NASDAQ
4473,11-02-2021 12:00,24 hrs.,RobinHoodPennyStocks,LKCO,20,6,14,-8,3,3,2,3,NASDAQ
4473,11-02-2021 12:00,24 hrs.,RobinHoodPennyStocks,LLNW,6,6,0,6,1,1,0,1,NASDAQ
4473,11-02-2021 12:00,24 hrs.,RobinHoodPennyStocks,LMFA,201,201,0,201,1,80,37,1,NASDAQ
4473,11-02-2021 12:00,24 hrs.,RobinHoodPennyStocks,LMNL,201,201,0,201,1,80,37,1,NASDAQ
4473,11-02-2021 12:00,24 hrs.,RobinHoodPennyStocks,LPCN,15,15,0,15,1,5,1,1,NASDAQ
4473,11-02-2021 12:00,24 hrs.,RobinHoodPennyStocks,LXEH,201,201,0,201,1,80,37,1,NASDAQ
4473,11-02-2021 12:00,24 hrs.,RobinHoodPennyStocks,LYRA,201,201,0,201,1,80,37,1,NASDAQ
4473,11-02-2021 12:00,24 hrs.,RobinHoodPennyStocks,MARA,201,201,0,201,1,80,37,1,NASDAQ
4473,11-02-2021 12:00,24 hrs.,RobinHoodPennyStocks,MBRX,201,201,0,201,1,80,37,1,NASDAQ
4473,11-02-2021 12:00,24 hrs.,RobinHoodPennyStocks,MITO,6,0,6,-6,1,1,0,1,NASDAQ
4473,11-02-2021 12:00,24 hrs.,RobinHoodPennyStocks,MOGO,201,201,0,201,1,80,37,1,NASDAQ
4473,11-02-2021 12:00,24 hrs.,RobinHoodPennyStocks,MOTS,7,0,7,-7,1,1,1,1,NASDAQ
4473,11-02-2021 12:00,24 hrs.,RobinHoodPennyStocks,MOXC,201,201,0,201,1,80,37,1,NASDAQ
4473,11-02-2021 12:00,24 hrs.,RobinHoodPennyStocks,MVIS,221,221,0,221,2,84,45,2,NASDAQ
4473,11-02-2021 12:00,24 hrs.,RobinHoodPennyStocks,NAKD,207,201,6,195,2,81,37,2,NASDAQ
4473,11-02-2021 12:00,24 hrs.,RobinHoodPennyStocks,NAOV,12,0,12,-12,1,4,0,1,NASDAQ
4473,11-02-2021 12:00,24 hrs.,RobinHoodPennyStocks,NCTY,201,201,0,201,1,80,37,1,NASDAQ
4473,11-02-2021 12:00,24 hrs.,RobinHoodPennyStocks,NEOS,30,0,30,-30,1,9,8,1,NASDAQ
4473,11-02-2021 12:00,24 hrs.,RobinHoodPennyStocks,NKTX,201,201,0,201,1,80,37,1,NASDAQ
4473,11-02-2021 12:00,24 hrs.,RobinHoodPennyStocks,BORR,6,0,6,-6,1,1,0,1,NYSE
4473,11-02-2021 12:00,24 hrs.,RobinHoodPennyStocks,CMCM,201,201,0,201,1,80,37,1,NYSE
4473,11-02-2021 12:00,24 hrs.,RobinHoodPennyStocks,FUBO,201,201,0,201,1,80,37,1,NYSE
4473,11-02-2021 12:00,24 hrs.,RobinHoodPennyStocks,HEXO,207,201,6,195,2,81,37,2,NYSE
4473,11-02-2021 12:00,24 hrs.,RobinHoodPennyStocks,LAIX,201,201,0,201,1,80,37,1,NYSE
4473,11-02-2021 12:00,24 hrs.,RobinHoodPennyStocks,MDLY,201,201,0,201,1,80,37,1,NYSE
4473,11-02-2021 12:00,24 hrs.,RobinHoodPennyStocks,SNPR,6,0,6,-6,1,1,0,1,NYSE
4473,11-02-2021 12:00,24 hrs.,RobinHoodPennyStocks,WELL,6,0,6,-6,1,1,0,1,NYSE
4473,11-02-2021 12:00,24 hrs.,RobinHoodPennyStocks,XPEV,201,201,0,201,1,80,37,1,NYSE
4473,11-02-2021 12:00,24 hrs.,RobinHoodPennyStocks,AIH,201,201,0,201,1,80,37,1,NASDAQ
4473,11-02-2021 12:00,24 hrs.,RobinHoodPennyStocks,BBI,53,0,53,-53,1,17,15,1,NASDAQ
4473,11-02-2021 12:00,24 hrs.,RobinHoodPennyStocks,CGC,201,201,0,201,1,80,37,1,NASDAQ
4473,11-02-2021 12:00,24 hrs.,RobinHoodPennyStocks,ENG,201,201,0,201,1,80,37,1,NASDAQ
4473,11-02-2021 12:00,24 hrs.,RobinHoodPennyStocks,EVK,201,201,0,201,1,80,37,1,NASDAQ
4473,11-02-2021 12:00,24 hrs.,RobinHoodPennyStocks,JFU,46,0,46,-46,5,12,2,3,NASDAQ
4473,11-02-2021 12:00,24 hrs.,RobinHoodPennyStocks,MGI,201,201,0,201,1,80,37,1,NASDAQ
4473,11-02-2021 12:00,24 hrs.,RobinHoodPennyStocks,OCG,201,201,0,201,1,80,37,1,NASDAQ
4473,11-02-2021 12:00,24 hrs.,RobinHoodPennyStocks,OEG,201,201,0,201,1,80,37,1,NASDAQ
4473,11-02-2021 12:00,24 hrs.,RobinHoodPennyStocks,OGI,269,257,12,245,5,93,63,5,NASDAQ
4473,11-02-2021 12:00,24 hrs.,RobinHoodPennyStocks,OLB,6,0,6,-6,1,1,0,1,NASDAQ
4473,11-02-2021 12:00,24 hrs.,RobinHoodPennyStocks,QTT,201,201,0,201,1,80,37,1,NASDAQ
4473,11-02-2021 12:00,24 hrs.,RobinHoodPennyStocks,RCM,201,201,0,201,1,80,37,1,NASDAQ
4473,11-02-2021 12:00,24 hrs.,RobinHoodPennyStocks,SLS,201,201,0,201,1,80,37,1,NASDAQ
4473,11-02-2021 12:00,24 hrs.,RobinHoodPennyStocks,SMH,6,6,0,6,1,1,0,1,NASDAQ
4473,11-02-2021 12:00,24 hrs.,RobinHoodPennyStocks,SPI,201,201,0,201,1,80,37,1,NASDAQ
4473,11-02-2021 12:00,24 hrs.,RobinHoodPennyStocks,WWR,201,201,0,201,1,80,37,1,NASDAQ
4473,11-02-2021 12:00,24 hrs.,RobinHoodPennyStocks,AAPL,201,201,0,201,1,80,37,1,NASDAQ
4473,11-02-2021 12:00,24 hrs.,RobinHoodPennyStocks,ACRX,71,0,71,-71,4,20,15,4,NASDAQ
4473,11-02-2021 12:00,24 hrs.,RobinHoodPennyStocks,ACST,6,0,6,-6,1,1,0,1,NASDAQ
4473,11-02-2021 12:00,24 hrs.,RobinHoodPennyStocks,ADMA,166,40,126,-86,5,56,34,5,NASDAQ
4473,11-02-2021 12:00,24 hrs.,RobinHoodPennyStocks,ADMP,6,6,0,6,1,1,0,1,NASDAQ
4473,11-02-2021 12:00,24 hrs.,RobinHoodPennyStocks,ADMS,201,201,0,201,1,80,37,1,NASDAQ
4473,11-02-2021 12:00,24 hrs.,RobinHoodPennyStocks,ADXS,18,0,18,-18,3,3,0,1,NASDAQ
4473,11-02-2021 12:00,24 hrs.,RobinHoodPennyStocks,AEZS,251,227,24,203,6,90,47,6,NASDAQ
4473,11-02-2021 12:00,24 hrs.,RobinHoodPennyStocks,AGEN,201,201,0,201,1,80,37,1,NASDAQ
4473,11-02-2021 12:00,24 hrs.,RobinHoodPennyStocks,AGTC,2819,449,2370,-1921,28,1004,699,27,NASDAQ
4473,11-02-2021 12:00,24 hrs.,RobinHoodPennyStocks,AIHS,201,201,0,201,1,80,37,1,NASDAQ
4473,11-02-2021 12:00,24 hrs.,RobinHoodPennyStocks,AKER,201,201,0,201,1,80,37,1,NASDAQ
4473,11-02-2021 12:00,24 hrs.,RobinHoodPennyStocks,ALAC,201,201,0,201,1,80,37,1,NASDAQ
4473,11-02-2021 12:00,24 hrs.,RobinHoodPennyStocks,ALVR,201,201,0,201,1,80,37,1,NASDAQ
4473,11-02-2021 12:00,24 hrs.,RobinHoodPennyStocks,AMTX,201,201,0,201,1,80,37,1,NASDAQ
4473,11-02-2021 12:00,24 hrs.,RobinHoodPennyStocks,ANCN,201,201,0,201,1,80,37,1,NASDAQ
4473,11-02-2021 12:00,24 hrs.,RobinHoodPennyStocks,AOSL,10,10,0,10,1,1,4,1,NASDAQ
4473,11-02-2021 12:00,24 hrs.,RobinHoodPennyStocks,APHA,349,311,38,273,6,118,89,6,NASDAQ
4473,11-02-2021 12:00,24 hrs.,RobinHoodPennyStocks,APRE,10,0,10,-10,1,0,6,1,NASDAQ
4473,11-02-2021 12:00,24 hrs.,RobinHoodPennyStocks,ARTL,201,201,0,201,1,80,37,1,NASDAQ
4473,11-02-2021 12:00,24 hrs.,RobinHoodPennyStocks,ASRT,140,6,134,-128,4,41,42,4,NASDAQ
4473,11-02-2021 12:00,24 hrs.,RobinHoodPennyStocks,ATIF,201,201,0,201,1,80,37,1,NASDAQ
4473,11-02-2021 12:00,24 hrs.,RobinHoodPennyStocks,ATNF,6,6,0,6,1,1,0,1,NASDAQ
4473,11-02-2021 12:00,24 hrs.,RobinHoodPennyStocks,ATOS,492,201,291,-90,11,185,78,10,NASDAQ
4473,11-02-2021 12:00,24 hrs.,RobinHoodPennyStocks,AVCO,201,201,0,201,1,80,37,1,NASDAQ
4473,11-02-2021 12:00,24 hrs.,RobinHoodPennyStocks,AVGR,201,201,0,201,1,80,37,1,NASDAQ
4473,11-02-2021 12:00,24 hrs.,RobinHoodPennyStocks,AYRO,201,201,0,201,1,80,37,1,NASDAQ
4473,11-02-2021 12:00,24 hrs.,RobinHoodPennyStocks,AZRX,201,201,0,201,1,80,37,1,NASDAQ
4473,11-02-2021 12:00,24 hrs.,RobinHoodPennyStocks,BGCP,201,201,0,201,1,80,37,1,NASDAQ
4473,11-02-2021 12:00,24 hrs.,RobinHoodPennyStocks,BHAT,201,201,0,201,1,80,37,1,NASDAQ
4473,11-02-2021 12:00,24 hrs.,RobinHoodPennyStocks,BIOL,80,68,12,56,4,13,38,4,NASDAQ
4473,11-02-2021 12:00,24 hrs.,RobinHoodPennyStocks,BOXL,7,0,7,-7,1,1,1,1,NASDAQ
4473,11-02-2021 12:00,24 hrs.,RobinHoodPennyStocks,BRQS,201,201,0,201,1,80,37,1,NASDAQ
4473,11-02-2021 12:00,24 hrs.,RobinHoodPennyStocks,BYFC,201,201,0,201,1,80,37,1,NASDAQ
4473,11-02-2021 12:00,24 hrs.,RobinHoodPennyStocks,CAAS,201,201,0,201,1,80,37,1,NASDAQ
4473,11-02-2021 12:00,24 hrs.,RobinHoodPennyStocks,CARV,201,201,0,201,1,80,37,1,NASDAQ
4473,11-02-2021 12:00,24 hrs.,RobinHoodPennyStocks,CBAT,209,201,8,193,2,80,41,2,NASDAQ
4473,11-02-2021 12:00,24 hrs.,RobinHoodPennyStocks,CCNC,201,201,0,201,1,80,37,1,NASDAQ
4473,11-02-2021 12:00,24 hrs.,RobinHoodPennyStocks,TAKOF,6,0,6,-6,1,1,0,1,OTC
4473,11-02-2021 12:00,24 hrs.,RobinHoodPennyStocks,VRNDF,6,0,6,-6,1,1,0,1,OTC
4473,11-02-2021 12:00,24 hrs.,RobinHoodPennyStocks,CEI,201,201,0,201,1,80,37,1,AMEX
4473,11-02-2021 12:00,24 hrs.,RobinHoodPennyStocks,DNN,305,201,104,97,3,113,67,3,AMEX
4473,11-02-2021 12:00,24 hrs.,RobinHoodPennyStocks,DPW,201,201,0,201,1,80,37,1,AMEX
4473,11-02-2021 12:00,24 hrs.,RobinHoodPennyStocks,GPL,6,0,6,-6,1,1,0,1,AMEX
4473,11-02-2021 12:00,24 hrs.,RobinHoodPennyStocks,GSV,121,0,121,-121,3,37,35,3,AMEX
4473,11-02-2021 12:00,24 hrs.,RobinHoodPennyStocks,GTE,1823,927,896,31,32,616,463,28,AMEX
4473,11-02-2021 12:00,24 hrs.,RobinHoodPennyStocks,IGC,201,201,0,201,1,80,37,1,AMEX
4473,11-02-2021 12:00,24 hrs.,RobinHoodPennyStocks,ITP,31,0,31,-31,1,9,9,1,AMEX
4473,11-02-2021 12:00,24 hrs.,RobinHoodPennyStocks,NAK,234,30,204,-174,16,62,46,14,AMEX
4473,11-02-2021 12:00,24 hrs.,RobinHoodPennyStocks,NBY,6,0,6,-6,1,1,0,1,AMEX
4473,11-02-2021 12:00,24 hrs.,RobinHoodPennyStocks,PLG,201,201,0,201,1,80,37,1,AMEX
4473,11-02-2021 12:00,24 hrs.,RobinHoodPennyStocks,PTN,23,6,17,-11,2,6,3,2,AMEX
4473,11-02-2021 12:00,24 hrs.,RobinHoodPennyStocks,REI,5,5,0,5,1,0,1,1,AMEX
4473,11-02-2021 12:00,24 hrs.,RobinHoodPennyStocks,TGC,201,201,0,201,1,80,37,1,AMEX
4473,11-02-2021 12:00,24 hrs.,RobinHoodPennyStocks,TRX,104,6,98,-92,2,33,30,2,AMEX
4473,11-02-2021 12:00,24 hrs.,RobinHoodPennyStocks,URG,201,201,0,201,1,80,37,1,AMEX
4473,11-02-2021 12:00,24 hrs.,RobinHoodPennyStocks,ZOM,1090,431,659,-228,25,326,338,22,AMEX
4473,11-02-2021 12:00,24 hrs.,RobinHoodPennyStocks,AIRI,6,0,6,-6,1,1,0,1,AMEX
4473,11-02-2021 12:00,24 hrs.,RobinHoodPennyStocks,ANVS,201,201,0,201,1,80,37,1,AMEX
4473,11-02-2021 12:00,24 hrs.,RobinHoodPennyStocks,AUMN,299,201,98,103,2,112,67,2,AMEX
4473,11-02-2021 12:00,24 hrs.,RobinHoodPennyStocks,CANF,30,0,30,-30,1,10,6,1,AMEX
4473,11-02-2021 12:00,24 hrs.,RobinHoodPennyStocks,CRMD,201,201,0,201,1,80,37,1,AMEX
4473,11-02-2021 12:00,24 hrs.,RobinHoodPennyStocks,GSAT,463,45,418,-373,12,143,129,11,AMEX
4473,11-02-2021 12:00,24 hrs.,RobinHoodPennyStocks,INUV,14,0,14,-14,1,4,2,1,AMEX
4473,11-02-2021 12:00,24 hrs.,RobinHoodPennyStocks,LCTX,19,0,19,-19,1,0,15,1,AMEX
4473,11-02-2021 12:00,24 hrs.,RobinHoodPennyStocks,NSPR,224,48,176,-128,6,64,72,6,AMEX
4473,11-02-2021 12:00,24 hrs.,RobinHoodPennyStocks,OGEN,125,125,0,125,2,41,35,2,AMEX
4473,11-02-2021 12:00,24 hrs.,RobinHoodPennyStocks,PLAG,201,201,0,201,1,80,37,1,AMEX
4473,11-02-2021 12:00,24 hrs.,RobinHoodPennyStocks,SENS,128,0,128,-128,2,41,38,2,AMEX
4473,11-02-2021 12:00,24 hrs.,RobinHoodPennyStocks,TKAT,201,201,0,201,1,80,37,1,AMEX
4473,11-02-2021 12:00,24 hrs.,RobinHoodPennyStocks,TRXC,39,0,39,-39,1,13,9,1,AMEX
4473,11-02-2021 12:00,24 hrs.,RobinHoodPennyStocks,UAMY,273,201,72,129,5,100,53,4,AMEX
4473,11-02-2021 12:00,24 hrs.,RobinHoodPennyStocks,UUUU,201,201,0,201,1,80,37,1,AMEX
4473,11-02-2021 12:00,24 hrs.,RobinHoodPennyStocks,XXII,30,0,30,-30,1,10,6,1,AMEX
4473,11-02-2021 12:00,24 hrs.,RobinHoodPennyStocks,ACB,201,201,0,201,1,80,37,1,NYSE
4473,11-02-2021 12:00,24 hrs.,RobinHoodPennyStocks,AMC,388,0,388,-388,2,169,42,2,NYSE
4473,11-02-2021 12:00,24 hrs.,RobinHoodPennyStocks,CBD,28,0,28,-28,2,4,12,2,NYSE
4473,11-02-2021 12:00,24 hrs.,RobinHoodPennyStocks,CCJ,201,201,0,201,1,80,37,1,NYSE
4473,11-02-2021 12:00,24 hrs.,RobinHoodPennyStocks,CCM,201,201,0,201,1,80,37,1,NYSE
4473,11-02-2021 12:00,24 hrs.,RobinHoodPennyStocks,CNS,6,0,6,-6,1,1,0,1,NYSE
4473,11-02-2021 12:00,24 hrs.,RobinHoodPennyStocks,CNX,22,0,22,-22,1,3,12,1,NYSE
4473,11-02-2021 12:00,24 hrs.,RobinHoodPennyStocks,CTK,201,201,0,201,1,80,37,1,NYSE
4473,11-02-2021 12:00,24 hrs.,RobinHoodPennyStocks,DCF,22,0,22,-22,1,3,12,1,NYSE
4473,11-02-2021 12:00,24 hrs.,RobinHoodPennyStocks,ETH,22,0,22,-22,1,3,12,1,NYSE
4473,11-02-2021 12:00,24 hrs.,RobinHoodPennyStocks,FSD,6,6,0,6,1,1,0,1,NYSE
4473,11-02-2021 12:00,24 hrs.,RobinHoodPennyStocks,GME,643,241,402,-161,5,272,79,5,NYSE
4473,11-02-2021 12:00,24 hrs.,RobinHoodPennyStocks,GSX,201,201,0,201,1,80,37,1,NYSE
4473,11-02-2021 12:00,24 hrs.,RobinHoodPennyStocks,HMI,201,201,0,201,1,80,37,1,NYSE
4473,11-02-2021 12:00,24 hrs.,RobinHoodPennyStocks,IVR,12,6,6,0,2,2,0,2,NYSE
4473,11-02-2021 12:00,24 hrs.,RobinHoodPennyStocks,MUX,6,6,0,6,1,1,0,1,NYSE
4473,11-02-2021 12:00,24 hrs.,RobinHoodPennyStocks,NBB,6,0,6,-6,1,1,0,1,NYSE
4473,11-02-2021 12:00,24 hrs.,RobinHoodPennyStocks,NGL,59,59,0,59,1,23,9,1,NYSE
4473,11-02-2021 12:00,24 hrs.,RobinHoodPennyStocks,NIO,201,201,0,201,1,80,37,1,NYSE
4473,11-02-2021 12:00,24 hrs.,RobinHoodPennyStocks,PDT,6,0,6,-6,1,1,0,1,NYSE
4473,11-02-2021 12:00,24 hrs.,RobinHoodPennyStocks,PEI,79,0,79,-79,1,27,21,1,NYSE
4473,11-02-2021 12:00,24 hrs.,RobinHoodPennyStocks,RSI,201,201,0,201,1,80,37,1,NYSE
4473,11-02-2021 12:00,24 hrs.,RobinHoodPennyStocks,SNE,14,14,0,14,1,3,4,1,NYSE
4473,11-02-2021 12:00,24 hrs.,RobinHoodPennyStocks,SOS,387,201,186,15,5,153,61,5,NYSE
4473,11-02-2021 12:00,24 hrs.,RobinHoodPennyStocks,STG,6,0,6,-6,1,1,0,1,NYSE
4473,11-02-2021 12:00,24 hrs.,RobinHoodPennyStocks,TAL,201,201,0,201,1,80,37,1,NYSE
4473,11-02-2021 12:00,24 hrs.,RobinHoodPennyStocks,WEI,201,201,0,201,1,80,37,1,NYSE
4473,11-02-2021 12:00,24 hrs.,RobinHoodPennyStocks,BABA,201,201,0,201,1,80,37,1,NYSE
4473,11-02-2021 12:00,24 hrs.,pennystocks,TLRY,65,12,53,-41,4,21,7,4,NASDAQ
4473,11-02-2021 12:00,24 hrs.,pennystocks,TNXP,855,822,33,789,10,373,69,9,NASDAQ
4473,11-02-2021 12:00,24 hrs.,pennystocks,TRCH,211,72,139,-67,10,61,49,9,NASDAQ
4473,11-02-2021 12:00,24 hrs.,pennystocks,TTOO,6,6,0,6,1,1,0,1,NASDAQ
4473,11-02-2021 12:00,24 hrs.,pennystocks,TXMD,13,7,6,1,2,2,1,2,NASDAQ
4473,11-02-2021 12:00,24 hrs.,pennystocks,TYME,247,0,247,-247,2,100,39,2,NASDAQ
4473,11-02-2021 12:00,24 hrs.,pennystocks,USWS,19,12,7,5,3,3,1,3,NASDAQ
4473,11-02-2021 12:00,24 hrs.,pennystocks,VBIV,6,0,6,-6,1,1,0,1,NASDAQ
4473,11-02-2021 12:00,24 hrs.,pennystocks,VIVE,6,0,6,-6,1,1,0,1,NASDAQ
4473,11-02-2021 12:00,24 hrs.,pennystocks,VXRT,7,0,7,-7,1,1,1,1,NASDAQ
4473,11-02-2021 12:00,24 hrs.,pennystocks,WIRE,58,0,58,-58,1,21,12,1,NASDAQ
4473,11-02-2021 12:00,24 hrs.,pennystocks,XBIO,47,0,47,-47,1,18,7,1,NASDAQ
4473,11-02-2021 12:00,24 hrs.,pennystocks,XNET,6,6,0,6,1,1,0,1,NASDAQ
4473,11-02-2021 12:00,24 hrs.,pennystocks,XONE,6,0,6,-6,1,1,0,1,NASDAQ
4473,11-02-2021 12:00,24 hrs.,pennystocks,XSPA,135,123,12,111,4,54,11,4,NASDAQ
4473,11-02-2021 12:00,24 hrs.,pennystocks,ZKIN,51,0,51,-51,1,19,9,1,NASDAQ
4473,11-02-2021 12:00,24 hrs.,pennystocks,ZSAN,347,222,125,97,16,91,101,12,NASDAQ
4473,11-02-2021 12:00,24 hrs.,RobinHoodPennyStocks,AFOM,6,0,6,-6,1,1,0,1,OTC
4473,11-02-2021 12:00,24 hrs.,RobinHoodPennyStocks,AGYP,6,0,6,-6,1,1,0,1,OTC
4473,11-02-2021 12:00,24 hrs.,RobinHoodPennyStocks,ALPP,6,6,0,6,1,1,0,1,OTC
4473,11-02-2021 12:00,24 hrs.,RobinHoodPennyStocks,AMNE,6,0,6,-6,1,1,0,1,OTC
4473,11-02-2021 12:00,24 hrs.,RobinHoodPennyStocks,BIEL,6,0,6,-6,1,1,0,1,OTC
4473,11-02-2021 12:00,24 hrs.,RobinHoodPennyStocks,BIGG,6,0,6,-6,1,1,0,1,OTC
4473,11-02-2021 12:00,24 hrs.,RobinHoodPennyStocks,BNGI,12,12,0,12,2,2,0,1,OTC
4473,11-02-2021 12:00,24 hrs.,RobinHoodPennyStocks,BOTH,201,201,0,201,1,80,37,1,OTC
4473,11-02-2021 12:00,24 hrs.,RobinHoodPennyStocks,BOTY,6,0,6,-6,1,1,0,1,OTC
4473,11-02-2021 12:00,24 hrs.,RobinHoodPennyStocks,CAGR,22,0,22,-22,1,3,12,1,OTC
4473,11-02-2021 12:00,24 hrs.,RobinHoodPennyStocks,CANN,6,6,0,6,1,1,0,1,OTC
4473,11-02-2021 12:00,24 hrs.,RobinHoodPennyStocks,CBDX,6,0,6,-6,1,1,0,1,OTC
4473,11-02-2021 12:00,24 hrs.,RobinHoodPennyStocks,CRWG,6,6,0,6,1,1,0,1,OTC
4473,11-02-2021 12:00,24 hrs.,RobinHoodPennyStocks,ECEZ,6,0,6,-6,1,1,0,1,OTC
4473,11-02-2021 12:00,24 hrs.,RobinHoodPennyStocks,EDXC,6,0,6,-6,1,1,0,1,OTC
4473,11-02-2021 12:00,24 hrs.,RobinHoodPennyStocks,ENDV,6,6,0,6,1,1,0,1,OTC
4473,11-02-2021 12:00,24 hrs.,RobinHoodPennyStocks,GDSI,6,0,6,-6,1,1,0,1,OTC
4473,11-02-2021 12:00,24 hrs.,RobinHoodPennyStocks,GRPS,4,4,0,4,1,0,0,1,OTC
4473,11-02-2021 12:00,24 hrs.,RobinHoodPennyStocks,HCMC,91,6,85,-79,3,29,21,3,OTC
4473,11-02-2021 12:00,24 hrs.,RobinHoodPennyStocks,HEMP,18,0,18,-18,3,3,0,3,OTC
4473,11-02-2021 12:00,24 hrs.,RobinHoodPennyStocks,HMNY,18,6,12,-6,3,3,0,2,OTC
4473,11-02-2021 12:00,24 hrs.,RobinHoodPennyStocks,INKW,22,0,22,-22,1,3,12,1,OTC
4473,11-02-2021 12:00,24 hrs.,RobinHoodPennyStocks,KPAY,6,0,6,-6,1,1,0,1,OTC
4473,11-02-2021 12:00,24 hrs.,RobinHoodPennyStocks,MINE,34,0,34,-34,3,5,12,3,OTC
4473,11-02-2021 12:00,24 hrs.,RobinHoodPennyStocks,MJNA,12,12,0,12,2,2,0,2,OTC
4473,11-02-2021 12:00,24 hrs.,RobinHoodPennyStocks,MMEX,6,0,6,-6,1,1,0,1,OTC
4473,11-02-2021 12:00,24 hrs.,RobinHoodPennyStocks,NUUU,24,6,18,-12,4,4,0,2,OTC
4473,11-02-2021 12:00,24 hrs.,RobinHoodPennyStocks,RTON,14,0,14,-14,2,2,2,2,OTC
4473,11-02-2021 12:00,24 hrs.,RobinHoodPennyStocks,SANP,6,0,6,-6,1,1,0,1,OTC
4473,11-02-2021 12:00,24 hrs.,RobinHoodPennyStocks,SGMD,12,6,6,0,2,2,0,2,OTC
4473,11-02-2021 12:00,24 hrs.,RobinHoodPennyStocks,SRMX,6,0,6,-6,1,1,0,1,OTC
4473,11-02-2021 12:00,24 hrs.,RobinHoodPennyStocks,SUIC,6,0,6,-6,1,1,0,1,OTC
4473,11-02-2021 12:00,24 hrs.,RobinHoodPennyStocks,TLSS,6,0,6,-6,1,1,0,1,OTC
4473,11-02-2021 12:00,24 hrs.,RobinHoodPennyStocks,TSNP,6,6,0,6,1,1,0,1,OTC
4473,11-02-2021 12:00,24 hrs.,RobinHoodPennyStocks,USMJ,12,6,6,0,2,2,0,2,OTC
4473,11-02-2021 12:00,24 hrs.,RobinHoodPennyStocks,ABEPF,18,18,0,18,1,5,4,1,OTC
4473,11-02-2021 12:00,24 hrs.,RobinHoodPennyStocks,BBKCF,6,6,0,6,1,0,2,1,OTC
4473,11-02-2021 12:00,24 hrs.,RobinHoodPennyStocks,BDRBF,606,249,357,-108,15,184,178,14,OTC
4473,11-02-2021 12:00,24 hrs.,RobinHoodPennyStocks,FGPHF,6,0,6,-6,1,0,2,1,OTC
4473,11-02-2021 12:00,24 hrs.,RobinHoodPennyStocks,FLWPF,6,0,6,-6,1,1,0,1,OTC
4473,11-02-2021 12:00,24 hrs.,RobinHoodPennyStocks,IGCIW,6,6,0,6,1,1,0,1,OTC
4473,11-02-2021 12:00,24 hrs.,RobinHoodPennyStocks,JUVAF,6,0,6,-6,1,1,0,1,OTC
4473,11-02-2021 12:00,24 hrs.,RobinHoodPennyStocks,MMNFF,18,12,6,6,3,3,0,2,OTC
4473,11-02-2021 12:00,24 hrs.,RobinHoodPennyStocks,NMGRF,6,6,0,6,1,1,0,1,OTC
4473,11-02-2021 12:00,24 hrs.,RobinHoodPennyStocks,NXTTF,14,0,14,-14,1,0,10,1,OTC
4473,11-02-2021 12:00,24 hrs.,RobinHoodPennyStocks,RLFTF,31,31,0,31,5,5,1,1,OTC
4473,11-02-2021 12:00,24 hrs.,RobinHoodPennyStocks,RYCEY,24,0,24,-24,4,4,0,3,OTC
4473,11-02-2021 12:00,24 hrs.,pennystocks,IMAC,7,0,7,-7,1,1,1,1,NASDAQ
4473,11-02-2021 12:00,24 hrs.,pennystocks,IMMR,12,6,6,0,2,2,0,2,NASDAQ
4473,11-02-2021 12:00,24 hrs.,pennystocks,INFI,26,0,26,-26,1,8,6,1,NASDAQ
4473,11-02-2021 12:00,24 hrs.,pennystocks,ITRM,16,8,8,0,2,2,4,2,NASDAQ
4473,11-02-2021 12:00,24 hrs.,pennystocks,JAGX,12,0,12,-12,2,2,0,2,NASDAQ
4473,11-02-2021 12:00,24 hrs.,pennystocks,KERN,6,6,0,6,1,1,0,1,NASDAQ
4473,11-02-2021 12:00,24 hrs.,pennystocks,KOPN,6,0,6,-6,1,1,0,1,NASDAQ
4473,11-02-2021 12:00,24 hrs.,pennystocks,KTRA,4233,110,4123,-4013,5,1928,357,5,NASDAQ
4473,11-02-2021 12:00,24 hrs.,pennystocks,LGHL,110,110,0,110,1,45,16,1,NASDAQ
4473,11-02-2021 12:00,24 hrs.,pennystocks,LKCO,18,6,12,-6,3,3,0,3,NASDAQ
4473,11-02-2021 12:00,24 hrs.,pennystocks,LPTH,6,0,6,-6,1,1,0,1,NASDAQ
4473,11-02-2021 12:00,24 hrs.,pennystocks,LSTR,12,0,12,-12,2,2,0,2,NASDAQ
4473,11-02-2021 12:00,24 hrs.,pennystocks,MBII,11,11,0,11,1,3,1,1,NASDAQ
4473,11-02-2021 12:00,24 hrs.,pennystocks,MBRX,71,71,0,71,2,28,7,2,NASDAQ
4473,11-02-2021 12:00,24 hrs.,pennystocks,MESA,14,0,14,-14,2,2,2,2,NASDAQ
4473,11-02-2021 12:00,24 hrs.,pennystocks,MGNI,6,6,0,6,1,1,0,1,NASDAQ
4473,11-02-2021 12:00,24 hrs.,pennystocks,MMLP,6,0,6,-6,1,1,0,1,NASDAQ
4473,11-02-2021 12:00,24 hrs.,pennystocks,MOTS,16,0,16,-16,1,3,6,1,NASDAQ
4473,11-02-2021 12:00,24 hrs.,pennystocks,MVIS,6,6,0,6,1,1,0,1,NASDAQ
4473,11-02-2021 12:00,24 hrs.,pennystocks,NAKD,359,123,236,-113,18,96,95,15,NASDAQ
4473,11-02-2021 12:00,24 hrs.,pennystocks,NAOV,6,0,6,-6,1,1,0,1,NASDAQ
4473,11-02-2021 12:00,24 hrs.,pennystocks,NCTY,47,0,47,-47,1,18,7,1,NASDAQ
4473,11-02-2021 12:00,24 hrs.,pennystocks,NEOS,47,0,47,-47,1,18,7,1,NASDAQ
4473,11-02-2021 12:00,24 hrs.,pennystocks,NMTR,20,15,5,10,2,5,2,2,NASDAQ
4473,11-02-2021 12:00,24 hrs.,pennystocks,NVCN,903,116,787,-671,14,323,201,11,NASDAQ
4473,11-02-2021 12:00,24 hrs.,pennystocks,NXTD,6,6,0,6,1,1,0,1,NASDAQ
4473,11-02-2021 12:00,24 hrs.,pennystocks,OCGN,97,26,71,-45,8,13,39,8,NASDAQ
4473,11-02-2021 12:00,24 hrs.,pennystocks,ONTX,12,0,12,-12,2,2,0,2,NASDAQ
4473,11-02-2021 12:00,24 hrs.,pennystocks,OPGN,117,117,0,117,2,46,17,2,NASDAQ
4473,11-02-2021 12:00,24 hrs.,pennystocks,OXSQ,6,0,6,-6,1,1,0,1,NASDAQ
4473,11-02-2021 12:00,24 hrs.,pennystocks,PDSB,47,0,47,-47,1,18,7,1,NASDAQ
4473,11-02-2021 12:00,24 hrs.,pennystocks,PLAY,49,0,49,-49,1,18,9,1,NASDAQ
4473,11-02-2021 12:00,24 hrs.,pennystocks,PLUG,6,6,0,6,1,1,0,1,NASDAQ
4473,11-02-2021 12:00,24 hrs.,pennystocks,PLUS,165,0,165,-165,3,70,13,2,NASDAQ
4473,11-02-2021 12:00,24 hrs.,pennystocks,POAI,27,0,27,-27,1,10,3,1,NASDAQ
4473,11-02-2021 12:00,24 hrs.,pennystocks,PPBT,17,0,17,-17,1,6,1,1,NASDAQ
4473,11-02-2021 12:00,24 hrs.,pennystocks,PRCH,6,6,0,6,1,1,0,1,NASDAQ
4473,11-02-2021 12:00,24 hrs.,pennystocks,PSTV,1563,7,1556,-1549,7,614,307,4,NASDAQ
4473,11-02-2021 12:00,24 hrs.,pennystocks,PULM,18,0,18,-18,3,2,2,2,NASDAQ
4473,11-02-2021 12:00,24 hrs.,pennystocks,RCMT,12,12,0,12,1,3,2,1,NASDAQ
4473,11-02-2021 12:00,24 hrs.,pennystocks,RESN,95,0,95,-95,1,33,25,1,NASDAQ
4473,11-02-2021 12:00,24 hrs.,pennystocks,RIGL,37,25,12,13,4,8,5,3,NASDAQ
4473,11-02-2021 12:00,24 hrs.,pennystocks,RIOT,6,0,6,-6,1,1,0,1,NASDAQ
4473,11-02-2021 12:00,24 hrs.,pennystocks,RKDA,47,0,47,-47,1,18,7,1,NASDAQ
4473,11-02-2021 12:00,24 hrs.,pennystocks,ROCK,6,0,6,-6,1,1,0,1,NASDAQ
4473,11-02-2021 12:00,24 hrs.,pennystocks,SAVA,6,6,0,6,1,1,0,1,NASDAQ
4473,11-02-2021 12:00,24 hrs.,pennystocks,SAVE,7,0,7,-7,1,1,1,1,NASDAQ
4473,11-02-2021 12:00,24 hrs.,pennystocks,SELF,6,0,6,-6,1,1,0,1,NASDAQ
4473,11-02-2021 12:00,24 hrs.,pennystocks,SHIP,13,0,13,-13,2,2,1,1,NASDAQ
4473,11-02-2021 12:00,24 hrs.,pennystocks,SLGG,168,168,0,168,1,66,32,1,NASDAQ
4473,11-02-2021 12:00,24 hrs.,pennystocks,SLRX,23,13,10,3,3,4,3,3,NASDAQ
4473,11-02-2021 12:00,24 hrs.,pennystocks,SNCA,47,0,47,-47,1,18,7,1,NASDAQ
4473,11-02-2021 12:00,24 hrs.,pennystocks,SNDL,546,142,404,-262,79,98,34,64,NASDAQ
4473,11-02-2021 12:00,24 hrs.,pennystocks,SRGA,110,110,0,110,1,45,16,1,NASDAQ
4473,11-02-2021 12:00,24 hrs.,pennystocks,STAF,68,0,68,-68,3,19,18,3,NASDAQ
4473,11-02-2021 12:00,24 hrs.,pennystocks,STAY,6,0,6,-6,1,1,0,1,NASDAQ
4473,11-02-2021 12:00,24 hrs.,pennystocks,SUNW,7,7,0,7,1,1,1,1,NASDAQ
4473,11-02-2021 12:00,24 hrs.,pennystocks,SWBI,58,0,58,-58,1,21,12,1,NASDAQ
4473,11-02-2021 12:00,24 hrs.,pennystocks,SXTC,6,0,6,-6,1,1,0,1,NASDAQ
4473,11-02-2021 12:00,24 hrs.,pennystocks,TBLT,65,0,65,-65,1,25,11,1,NASDAQ
4473,11-02-2021 12:00,24 hrs.,pennystocks,TEAM,6,0,6,-6,1,1,0,1,NASDAQ
4473,11-02-2021 12:00,24 hrs.,pennystocks,TELL,19,12,7,5,3,3,1,3,NASDAQ
4473,11-02-2021 12:00,24 hrs.,pennystocks,THMO,58,0,58,-58,1,21,12,1,NASDAQ
4473,11-02-2021 12:00,24 hrs.,pennystocks,TIGR,6,0,6,-6,1,1,0,1,NASDAQ
4473,11-02-2021 12:00,24 hrs.,pennystocks,PTE,181,8,173,-165,2,62,49,2,NASDAQ
4473,11-02-2021 12:00,24 hrs.,pennystocks,VIR,6,0,6,-6,1,1,0,1,NASDAQ
4473,11-02-2021 12:00,24 hrs.,pennystocks,ACRX,760,754,6,748,2,335,82,2,NASDAQ
4473,11-02-2021 12:00,24 hrs.,pennystocks,ACST,6,0,6,-6,1,1,0,1,NASDAQ
4473,11-02-2021 12:00,24 hrs.,pennystocks,ADMA,166,110,56,54,4,64,22,3,NASDAQ
4473,11-02-2021 12:00,24 hrs.,pennystocks,ADMP,23,0,23,-23,2,5,5,2,NASDAQ
4473,11-02-2021 12:00,24 hrs.,pennystocks,AESE,168,168,0,168,1,66,32,1,NASDAQ
4473,11-02-2021 12:00,24 hrs.,pennystocks,AEZS,110,0,110,-110,3,35,28,3,NASDAQ
4473,11-02-2021 12:00,24 hrs.,pennystocks,AGTC,73,6,67,-61,5,18,17,4,NASDAQ
4473,11-02-2021 12:00,24 hrs.,pennystocks,AIHS,6,0,6,-6,1,1,0,1,NASDAQ
4473,11-02-2021 12:00,24 hrs.,pennystocks,AKBA,6,0,6,-6,1,1,0,1,NASDAQ
4473,11-02-2021 12:00,24 hrs.,pennystocks,AKER,47,0,47,-47,1,18,7,1,NASDAQ
4473,11-02-2021 12:00,24 hrs.,pennystocks,AMTX,7,0,7,-7,1,1,1,1,NASDAQ
4473,11-02-2021 12:00,24 hrs.,pennystocks,AMZN,151,0,151,-151,1,33,81,1,NASDAQ
4473,11-02-2021 12:00,24 hrs.,pennystocks,ANCN,8,0,8,-8,1,1,2,1,NASDAQ
4473,11-02-2021 12:00,24 hrs.,pennystocks,APDN,47,0,47,-47,1,18,7,1,NASDAQ
4473,11-02-2021 12:00,24 hrs.,pennystocks,APHA,18,12,6,6,3,3,0,3,NASDAQ
4473,11-02-2021 12:00,24 hrs.,pennystocks,APPS,7,0,7,-7,1,1,1,1,NASDAQ
4473,11-02-2021 12:00,24 hrs.,pennystocks,ARTL,14,14,0,14,2,2,2,1,NASDAQ
4473,11-02-2021 12:00,24 hrs.,pennystocks,ASRT,95,15,80,-65,9,21,17,7,NASDAQ
4473,11-02-2021 12:00,24 hrs.,pennystocks,ATNF,6,0,6,-6,1,1,0,1,NASDAQ
4473,11-02-2021 12:00,24 hrs.,pennystocks,ATOS,934,825,109,716,8,392,118,8,NASDAQ
4473,11-02-2021 12:00,24 hrs.,pennystocks,AVXL,41,0,41,-41,1,15,7,1,NASDAQ
4473,11-02-2021 12:00,24 hrs.,pennystocks,BHTG,47,0,47,-47,1,18,7,1,NASDAQ
4473,11-02-2021 12:00,24 hrs.,pennystocks,BLUE,6,0,6,-6,1,1,0,1,NASDAQ
4473,11-02-2021 12:00,24 hrs.,pennystocks,BNGO,121,121,0,121,3,43,23,3,NASDAQ
4473,11-02-2021 12:00,24 hrs.,pennystocks,BPTH,80,0,80,-80,5,23,14,4,NASDAQ
4473,11-02-2021 12:00,24 hrs.,pennystocks,BSQR,6,0,6,-6,1,1,0,1,NASDAQ
4473,11-02-2021 12:00,24 hrs.,pennystocks,BXRX,77,65,12,53,3,29,7,3,NASDAQ
4473,11-02-2021 12:00,24 hrs.,pennystocks,BYFC,14,6,8,-2,2,2,2,2,NASDAQ
4473,11-02-2021 12:00,24 hrs.,pennystocks,CBAT,6,0,6,-6,1,1,0,1,NASDAQ
4473,11-02-2021 12:00,24 hrs.,pennystocks,CGIX,107,0,107,-107,7,33,13,6,NASDAQ
4473,11-02-2021 12:00,24 hrs.,pennystocks,CHEK,6,6,0,6,1,1,0,1,NASDAQ
4473,11-02-2021 12:00,24 hrs.,pennystocks,CIDM,6,0,6,-6,1,1,0,1,NASDAQ
4473,11-02-2021 12:00,24 hrs.,pennystocks,CLNE,7,0,7,-7,1,1,1,1,NASDAQ
4473,11-02-2021 12:00,24 hrs.,pennystocks,CNET,7,7,0,7,1,1,1,1,NASDAQ
4473,11-02-2021 12:00,24 hrs.,pennystocks,CRBP,132,0,132,-132,2,49,26,2,NASDAQ
4473,11-02-2021 12:00,24 hrs.,pennystocks,CRNT,12,0,12,-12,2,2,0,1,NASDAQ
4473,11-02-2021 12:00,24 hrs.,pennystocks,CSTR,49,0,49,-49,1,18,9,1,NASDAQ
4473,11-02-2021 12:00,24 hrs.,pennystocks,CTRM,235,159,76,83,9,76,47,9,NASDAQ
4473,11-02-2021 12:00,24 hrs.,pennystocks,DKNG,6,0,6,-6,1,1,0,1,NASDAQ
4473,11-02-2021 12:00,24 hrs.,pennystocks,DTEA,13,0,13,-13,2,2,1,1,NASDAQ
4473,11-02-2021 12:00,24 hrs.,pennystocks,DXYN,7,0,7,-7,1,1,1,1,NASDAQ
4473,11-02-2021 12:00,24 hrs.,pennystocks,EAST,116,110,6,104,2,46,16,2,NASDAQ
4473,11-02-2021 12:00,24 hrs.,pennystocks,EDIT,107,27,80,-53,2,33,33,2,NASDAQ
4473,11-02-2021 12:00,24 hrs.,pennystocks,ENVB,12,0,12,-12,2,2,0,1,NASDAQ
4473,11-02-2021 12:00,24 hrs.,pennystocks,EVER,6,0,6,-6,1,1,0,1,NASDAQ
4473,11-02-2021 12:00,24 hrs.,pennystocks,FAMI,53,0,53,-53,2,19,7,2,NASDAQ
4473,11-02-2021 12:00,24 hrs.,pennystocks,FAST,40,0,40,-40,1,9,18,1,NASDAQ
4473,11-02-2021 12:00,24 hrs.,pennystocks,FUTU,47,0,47,-47,1,18,7,1,NASDAQ
4473,11-02-2021 12:00,24 hrs.,pennystocks,GAIN,21,0,21,-21,1,6,5,1,NASDAQ
4473,11-02-2021 12:00,24 hrs.,pennystocks,GEVO,7,0,7,-7,1,0,3,1,NASDAQ
4473,11-02-2021 12:00,24 hrs.,pennystocks,GHSI,242,0,242,-242,3,93,44,3,NASDAQ
4473,11-02-2021 12:00,24 hrs.,pennystocks,GIII,96,96,0,96,1,22,48,1,NASDAQ
4473,11-02-2021 12:00,24 hrs.,pennystocks,GLBS,37,37,0,37,1,12,9,1,NASDAQ
4473,11-02-2021 12:00,24 hrs.,pennystocks,GMBL,168,168,0,168,1,66,32,1,NASDAQ
4473,11-02-2021 12:00,24 hrs.,pennystocks,GNUS,240,0,240,-240,1,99,38,1,NASDAQ
4473,11-02-2021 12:00,24 hrs.,pennystocks,GOLD,6,0,6,-6,1,1,0,1,NASDAQ
4473,11-02-2021 12:00,24 hrs.,pennystocks,GRWG,6,6,0,6,1,1,0,1,NASDAQ
4473,11-02-2021 12:00,24 hrs.,pennystocks,GTEC,7,0,7,-7,1,1,1,1,NASDAQ
4473,11-02-2021 12:00,24 hrs.,pennystocks,HALO,12,6,6,0,2,2,0,2,NASDAQ
4473,11-02-2021 12:00,24 hrs.,pennystocks,HTBX,6,0,6,-6,1,1,0,1,NASDAQ
4473,11-02-2021 12:00,24 hrs.,pennystocks,IBKR,21,0,21,-21,1,4,9,1,NASDAQ
4473,11-02-2021 12:00,24 hrs.,pennystocks,IDEX,6,6,0,6,1,1,0,1,NASDAQ
4473,11-02-2021 12:00,24 hrs.,pennystocks,SENS,274,107,167,-60,3,115,32,3,AMEX
4473,11-02-2021 12:00,24 hrs.,pennystocks,TMBR,12,0,12,-12,2,2,0,1,AMEX
4473,11-02-2021 12:00,24 hrs.,pennystocks,TRXC,6,6,0,6,1,1,0,1,AMEX
4473,11-02-2021 12:00,24 hrs.,pennystocks,UAMY,33,33,0,33,1,7,15,1,AMEX
4473,11-02-2021 12:00,24 hrs.,pennystocks,UAVS,47,0,47,-47,1,18,7,1,AMEX
4473,11-02-2021 12:00,24 hrs.,pennystocks,XXII,21,15,6,9,3,3,3,3,AMEX
4473,11-02-2021 12:00,24 hrs.,pennystocks,YCBD,64,0,64,-64,1,25,10,1,AMEX
4473,11-02-2021 12:00,24 hrs.,pennystocks,ACH,50,50,0,50,1,10,26,1,NYSE
4473,11-02-2021 12:00,24 hrs.,pennystocks,AFI,7,0,7,-7,1,1,1,1,NYSE
4473,11-02-2021 12:00,24 hrs.,pennystocks,AHT,7,0,7,-7,1,1,1,1,NYSE
4473,11-02-2021 12:00,24 hrs.,pennystocks,AMC,208,157,51,106,8,60,56,8,NYSE
4473,11-02-2021 12:00,24 hrs.,pennystocks,AMP,6,6,0,6,1,1,0,1,NYSE
4473,11-02-2021 12:00,24 hrs.,pennystocks,ATH,110,110,0,110,1,28,50,1,NYSE
4473,11-02-2021 12:00,24 hrs.,pennystocks,BHP,80,0,80,-80,1,26,24,1,NYSE
4473,11-02-2021 12:00,24 hrs.,pennystocks,BIO,12,6,6,0,2,2,0,2,NYSE
4473,11-02-2021 12:00,24 hrs.,pennystocks,CBD,902,124,778,-654,14,308,230,14,NYSE
4473,11-02-2021 12:00,24 hrs.,pennystocks,CBT,49,0,49,-49,1,18,9,1,NYSE
4473,11-02-2021 12:00,24 hrs.,pennystocks,CNC,23,23,0,23,1,3,13,1,NYSE
4473,11-02-2021 12:00,24 hrs.,pennystocks,CTK,47,0,47,-47,1,18,7,1,NYSE
4473,11-02-2021 12:00,24 hrs.,pennystocks,DAC,6,6,0,6,1,1,0,1,NYSE
4473,11-02-2021 12:00,24 hrs.,pennystocks,EFT,87,0,87,-87,1,16,51,1,NYSE
4473,11-02-2021 12:00,24 hrs.,pennystocks,EXP,12,12,0,12,2,2,0,2,NYSE
4473,11-02-2021 12:00,24 hrs.,pennystocks,FLT,2325,46,2279,-2233,9,1053,183,8,NYSE
4473,11-02-2021 12:00,24 hrs.,pennystocks,FUN,40,0,40,-40,1,9,18,1,NYSE
4473,11-02-2021 12:00,24 hrs.,pennystocks,GME,2542,754,1788,-1034,10,1069,364,9,NYSE
4473,11-02-2021 12:00,24 hrs.,pennystocks,HGV,26,0,26,-26,1,8,6,1,NYSE
4473,11-02-2021 12:00,24 hrs.,pennystocks,HVT,6,6,0,6,1,1,0,1,NYSE
4473,11-02-2021 12:00,24 hrs.,pennystocks,IFF,6,0,6,-6,1,1,0,1,NYSE
4473,11-02-2021 12:00,24 hrs.,pennystocks,LEA,34,0,34,-34,1,12,6,1,NYSE
4473,11-02-2021 12:00,24 hrs.,pennystocks,MTL,17,0,17,-17,2,2,5,1,NYSE
4473,11-02-2021 12:00,24 hrs.,pennystocks,NGL,7,0,7,-7,1,1,1,1,NYSE
4473,11-02-2021 12:00,24 hrs.,pennystocks,NOK,19,19,0,19,3,3,1,3,NYSE
4473,11-02-2021 12:00,24 hrs.,pennystocks,PDT,42,0,42,-42,2,12,10,2,NYSE
4473,11-02-2021 12:00,24 hrs.,pennystocks,PEI,32,0,32,-32,2,5,14,2,NYSE
4473,11-02-2021 12:00,24 hrs.,pennystocks,PSA,6,0,6,-6,1,1,0,1,NYSE
4473,11-02-2021 12:00,24 hrs.,pennystocks,PVL,27,0,27,-27,1,7,9,1,NYSE
4473,11-02-2021 12:00,24 hrs.,pennystocks,RTP,13,0,13,-13,1,0,9,1,NYSE
4473,11-02-2021 12:00,24 hrs.,pennystocks,SOS,628,0,628,-628,4,255,102,4,NYSE
4473,11-02-2021 12:00,24 hrs.,pennystocks,TDA,33,0,33,-33,1,6,17,1,NYSE
4473,11-02-2021 12:00,24 hrs.,pennystocks,THC,102,29,73,-44,3,26,38,3,NYSE
4473,11-02-2021 12:00,24 hrs.,pennystocks,UTF,64,0,64,-64,1,25,10,1,NYSE
4473,11-02-2021 12:00,24 hrs.,pennystocks,WGO,6,0,6,-6,1,1,0,1,NYSE
4473,11-02-2021 12:00,24 hrs.,pennystocks,XPO,12,0,12,-12,2,2,0,2,NYSE
4473,11-02-2021 12:00,24 hrs.,pennystocks,ALUS,10,0,10,-10,1,0,6,1,NYSE
4473,11-02-2021 12:00,24 hrs.,pennystocks,BORR,6,0,6,-6,1,1,0,1,NYSE
4473,11-02-2021 12:00,24 hrs.,pennystocks,GLOP,6,6,0,6,1,1,0,1,NYSE
4473,11-02-2021 12:00,24 hrs.,pennystocks,HEXO,12,0,12,-12,2,2,0,2,NYSE
4473,11-02-2021 12:00,24 hrs.,pennystocks,LMND,58,0,58,-58,1,21,12,1,NYSE
4473,11-02-2021 12:00,24 hrs.,pennystocks,PLTR,58,0,58,-58,1,21,12,1,NYSE
4473,11-02-2021 12:00,24 hrs.,pennystocks,PROS,6,0,6,-6,1,1,0,1,NYSE
4473,11-02-2021 12:00,24 hrs.,pennystocks,SAFE,6,0,6,-6,1,1,0,1,NYSE
4473,11-02-2021 12:00,24 hrs.,pennystocks,SNPR,6,0,6,-6,1,1,0,1,NYSE
4473,11-02-2021 12:00,24 hrs.,pennystocks,WELL,6,6,0,6,1,1,0,1,NYSE
4473,11-02-2021 12:00,24 hrs.,pennystocks,WORK,49,0,49,-49,1,18,9,1,NYSE
4473,11-02-2021 12:00,24 hrs.,pennystocks,AQB,6,6,0,6,1,1,0,1,NASDAQ
4473,11-02-2021 12:00,24 hrs.,pennystocks,AZN,39,0,39,-39,2,10,11,2,NASDAQ
4473,11-02-2021 12:00,24 hrs.,pennystocks,CFO,29,0,29,-29,1,9,7,1,NASDAQ
4473,11-02-2021 12:00,24 hrs.,pennystocks,ESG,6,0,6,-6,1,1,0,1,NASDAQ
4473,11-02-2021 12:00,24 hrs.,pennystocks,HAS,13,0,13,-13,2,2,1,2,NASDAQ
4473,11-02-2021 12:00,24 hrs.,pennystocks,III,154,96,58,38,2,43,60,2,NASDAQ
4473,11-02-2021 12:00,24 hrs.,pennystocks,JAN,14,14,0,14,1,0,10,1,NASDAQ
4473,11-02-2021 12:00,24 hrs.,pennystocks,OGI,103,13,90,-77,6,19,41,6,NASDAQ
4473,11-02-2021 12:00,24 hrs.,pennystocks,OPK,7,0,7,-7,1,1,1,1,NASDAQ
4473,11-02-2021 12:00,24 hrs.,pennystocks,OSS,26,0,26,-26,1,5,12,1,NASDAQ
4432,11-02-2021 04:00,24 hrs.,pennystocks,BLUU,7,0,7,-7,1,1,1,1,OTC
4432,11-02-2021 04:00,24 hrs.,pennystocks,BMIX,6,0,6,-6,1,1,0,1,OTC
4432,11-02-2021 04:00,24 hrs.,pennystocks,BNGI,43,36,7,29,6,5,9,5,OTC
4432,11-02-2021 04:00,24 hrs.,pennystocks,BOTY,37,19,18,1,6,5,3,6,OTC
4432,11-02-2021 04:00,24 hrs.,pennystocks,BRAV,80,74,6,68,3,23,22,3,OTC
4432,11-02-2021 04:00,24 hrs.,pennystocks,BRLL,94,31,63,-32,5,22,30,5,OTC
4432,11-02-2021 04:00,24 hrs.,pennystocks,BRRN,9,0,9,-9,1,2,1,1,OTC
4432,11-02-2021 04:00,24 hrs.,pennystocks,BSSP,6,6,0,6,1,1,0,1,OTC
4432,11-02-2021 04:00,24 hrs.,pennystocks,BTSC,6,0,6,-6,1,1,0,1,OTC
4432,11-02-2021 04:00,24 hrs.,pennystocks,BTZI,7,7,0,7,1,1,1,1,OTC
4432,11-02-2021 04:00,24 hrs.,pennystocks,BUNM,57,57,0,57,2,13,23,2,OTC
4432,11-02-2021 04:00,24 hrs.,pennystocks,CANN,6,0,6,-6,1,1,0,1,OTC
4432,11-02-2021 04:00,24 hrs.,pennystocks,CAPC,7,7,0,7,1,1,1,1,OTC
4432,11-02-2021 04:00,24 hrs.,pennystocks,CBBT,230,230,0,230,4,49,116,4,OTC
4432,11-02-2021 04:00,24 hrs.,pennystocks,CBDD,189,189,0,189,2,69,43,2,OTC
4432,11-02-2021 04:00,24 hrs.,pennystocks,CBDL,624,251,373,-122,10,208,168,10,OTC
4432,11-02-2021 04:00,24 hrs.,pennystocks,CBDX,6,6,0,6,1,1,0,1,OTC
4432,11-02-2021 04:00,24 hrs.,pennystocks,CBTC,6,0,6,-6,1,1,0,1,OTC
4432,11-02-2021 04:00,24 hrs.,pennystocks,CCTL,13,7,6,1,2,2,1,2,OTC
4432,11-02-2021 04:00,24 hrs.,pennystocks,CELZ,30,0,30,-30,2,7,8,2,OTC
4432,11-02-2021 04:00,24 hrs.,pennystocks,CEOS,20,7,13,-6,3,3,2,2,OTC
4432,11-02-2021 04:00,24 hrs.,pennystocks,CETY,6,6,0,6,1,1,0,1,OTC
4432,11-02-2021 04:00,24 hrs.,pennystocks,CHUC,23,11,12,-1,3,3,5,2,OTC
4432,11-02-2021 04:00,24 hrs.,pennystocks,CLWD,40,10,30,-20,4,8,8,4,OTC
4432,11-02-2021 04:00,24 hrs.,pennystocks,CNNA,170,110,60,50,3,61,36,2,OTC
4432,11-02-2021 04:00,24 hrs.,pennystocks,CNXS,21,21,0,21,1,0,17,1,OTC
4432,11-02-2021 04:00,24 hrs.,pennystocks,CORG,53,53,0,53,4,7,23,3,OTC
4432,11-02-2021 04:00,24 hrs.,pennystocks,COUV,8,8,0,8,1,1,2,1,OTC
4432,11-02-2021 04:00,24 hrs.,pennystocks,COWI,25,25,0,25,1,6,9,1,OTC
4432,11-02-2021 04:00,24 hrs.,Daytrading,ADTM,6,6,0,6,1,1,0,1,OTC
4432,11-02-2021 04:00,24 hrs.,Daytrading,HMNY,6,6,0,6,1,1,0,1,OTC
4432,11-02-2021 04:00,24 hrs.,Daytrading,KWBT,7,7,0,7,1,1,1,1,OTC
4432,11-02-2021 04:00,24 hrs.,Daytrading,MJNA,12,12,0,12,2,2,0,2,OTC
4432,11-02-2021 04:00,24 hrs.,Daytrading,PMDP,6,6,0,6,1,1,0,1,OTC
4432,11-02-2021 04:00,24 hrs.,Daytrading,SIRC,6,6,0,6,1,1,0,1,OTC
4432,11-02-2021 04:00,24 hrs.,Daytrading,NXTTF,13,13,0,13,1,4,1,1,OTC
4432,11-02-2021 04:00,24 hrs.,Daytrading,AMC,6,6,0,6,1,1,0,1,NYSE
4432,11-02-2021 04:00,24 hrs.,Daytrading,GME,9,9,0,9,1,1,3,1,NYSE
4432,11-02-2021 04:00,24 hrs.,Daytrading,MSM,7,7,0,7,1,1,1,1,NYSE
4432,11-02-2021 04:00,24 hrs.,Daytrading,MUX,6,6,0,6,1,1,0,1,NYSE
4432,11-02-2021 04:00,24 hrs.,Daytrading,PDT,21,21,0,21,3,3,3,3,NYSE
4432,11-02-2021 04:00,24 hrs.,Daytrading,RSI,9,9,0,9,1,1,3,1,NYSE
4432,11-02-2021 04:00,24 hrs.,Daytrading,VCRA,4,4,0,4,1,0,0,1,NYSE
4432,11-02-2021 04:00,24 hrs.,Daytrading,ADMA,6,6,0,6,1,1,0,1,NASDAQ
4432,11-02-2021 04:00,24 hrs.,Daytrading,APHA,163,163,0,163,2,48,59,2,NASDAQ
4432,11-02-2021 04:00,24 hrs.,Daytrading,BPTH,21,21,0,21,2,3,7,2,NASDAQ
4432,11-02-2021 04:00,24 hrs.,Daytrading,BSQR,7,7,0,7,1,1,1,1,NASDAQ
4432,11-02-2021 04:00,24 hrs.,Daytrading,CPST,4,4,0,4,1,0,0,1,NASDAQ
4432,11-02-2021 04:00,24 hrs.,Daytrading,FCEL,6,6,0,6,1,1,0,1,NASDAQ
4432,11-02-2021 04:00,24 hrs.,pennystocks,GMEV,42,42,0,42,7,7,0,4,OTC
4432,11-02-2021 04:00,24 hrs.,pennystocks,GNCC,7,0,7,-7,1,1,1,1,OTC
4432,11-02-2021 04:00,24 hrs.,pennystocks,GPFT,6,6,0,6,1,1,0,1,OTC
4432,11-02-2021 04:00,24 hrs.,pennystocks,GRCU,15,6,9,-3,2,1,5,2,OTC
4432,11-02-2021 04:00,24 hrs.,pennystocks,GRCV,7,7,0,7,1,1,1,1,OTC
4432,11-02-2021 04:00,24 hrs.,pennystocks,GRLF,6,6,0,6,1,1,0,1,OTC
4432,11-02-2021 04:00,24 hrs.,pennystocks,GRLT,6,6,0,6,1,1,0,1,OTC
4432,11-02-2021 04:00,24 hrs.,pennystocks,GRNH,19,7,12,-5,2,3,5,2,OTC
4432,11-02-2021 04:00,24 hrs.,pennystocks,GRSO,12,12,0,12,2,2,0,2,OTC
4432,11-02-2021 04:00,24 hrs.,pennystocks,GTEH,112,33,79,-46,8,29,22,6,OTC
4432,11-02-2021 04:00,24 hrs.,pennystocks,GTLL,7,7,0,7,1,1,1,1,OTC
4432,11-02-2021 04:00,24 hrs.,pennystocks,HBRM,38,38,0,38,1,12,10,1,OTC
4432,11-02-2021 04:00,24 hrs.,pennystocks,HCMC,194,154,40,114,31,31,8,25,OTC
4432,11-02-2021 04:00,24 hrs.,pennystocks,HEMP,44,37,7,30,7,7,2,6,OTC
4432,11-02-2021 04:00,24 hrs.,pennystocks,HESG,69,69,0,69,4,15,23,3,OTC
4432,11-02-2021 04:00,24 hrs.,pennystocks,HIPH,6,6,0,6,1,1,0,1,OTC
4432,11-02-2021 04:00,24 hrs.,pennystocks,HMNY,321,315,6,309,13,99,71,11,OTC
4432,11-02-2021 04:00,24 hrs.,pennystocks,HPIL,12,0,12,-12,2,2,0,1,OTC
4432,11-02-2021 04:00,24 hrs.,pennystocks,HPNN,56,56,0,56,1,18,16,1,OTC
4432,11-02-2021 04:00,24 hrs.,pennystocks,HQGE,84,84,0,84,1,26,28,1,OTC
4432,11-02-2021 04:00,24 hrs.,pennystocks,HVCW,20,0,20,-20,1,5,6,1,OTC
4432,11-02-2021 04:00,24 hrs.,pennystocks,HYII,6,0,6,-6,1,1,0,1,OTC
4432,11-02-2021 04:00,24 hrs.,pennystocks,HYSR,190,190,0,190,3,75,28,3,OTC
4432,11-02-2021 04:00,24 hrs.,pennystocks,IBRC,15,15,0,15,2,2,3,1,OTC
4432,11-02-2021 04:00,24 hrs.,pennystocks,ICTY,14,7,7,0,2,2,2,2,OTC
4432,11-02-2021 04:00,24 hrs.,pennystocks,IDEA,6,6,0,6,1,1,0,1,OTC
4432,11-02-2021 04:00,24 hrs.,pennystocks,IFBC,7,0,7,-7,1,1,1,1,OTC
4432,11-02-2021 04:00,24 hrs.,pennystocks,IGEN,16,16,0,16,2,2,4,1,OTC
4432,11-02-2021 04:00,24 hrs.,pennystocks,IGPK,12,6,6,0,2,2,0,2,OTC
4432,11-02-2021 04:00,24 hrs.,Daytrading,ITRM,33,33,0,33,3,9,3,3,NASDAQ
4432,11-02-2021 04:00,24 hrs.,Daytrading,KERN,6,6,0,6,1,1,0,1,NASDAQ
4432,11-02-2021 04:00,24 hrs.,Daytrading,PTON,6,6,0,6,1,1,0,1,NASDAQ
4432,11-02-2021 04:00,24 hrs.,Daytrading,SESN,6,6,0,6,1,1,0,1,NASDAQ
4432,11-02-2021 04:00,24 hrs.,Daytrading,SNDL,213,213,0,213,5,58,77,5,NASDAQ
4432,11-02-2021 04:00,24 hrs.,Daytrading,TLGT,7,7,0,7,1,1,1,1,NASDAQ
4432,11-02-2021 04:00,24 hrs.,Daytrading,TLRY,163,163,0,163,2,48,59,2,NASDAQ
4432,11-02-2021 04:00,24 hrs.,Daytrading,TRCH,6,6,0,6,1,1,0,1,NASDAQ
4432,11-02-2021 04:00,24 hrs.,Daytrading,TXMD,7,7,0,7,1,1,1,1,NASDAQ
4432,11-02-2021 04:00,24 hrs.,pennystocks,AABB,42,42,0,42,1,11,16,1,OTC
4432,11-02-2021 04:00,24 hrs.,pennystocks,ABML,161,109,52,57,5,47,47,5,OTC
4432,11-02-2021 04:00,24 hrs.,pennystocks,ABVG,90,90,0,90,2,20,42,2,OTC
4432,11-02-2021 04:00,24 hrs.,pennystocks,ADTM,576,0,576,-576,2,215,138,2,OTC
4432,11-02-2021 04:00,24 hrs.,pennystocks,AFOM,6,0,6,-6,1,1,0,1,OTC
4432,11-02-2021 04:00,24 hrs.,pennystocks,AGIN,17,17,0,17,1,2,9,1,OTC
4432,11-02-2021 04:00,24 hrs.,pennystocks,AGYP,23,23,0,23,3,4,3,3,OTC
4432,11-02-2021 04:00,24 hrs.,pennystocks,AITX,33,33,0,33,3,2,17,3,OTC
4432,11-02-2021 04:00,24 hrs.,pennystocks,ALKM,21,0,21,-21,2,2,9,2,OTC
4432,11-02-2021 04:00,24 hrs.,pennystocks,ALPP,114,24,90,-66,3,35,32,3,OTC
4432,11-02-2021 04:00,24 hrs.,pennystocks,ALST,37,19,18,1,2,12,5,2,OTC
4432,11-02-2021 04:00,24 hrs.,pennystocks,ALYI,35,29,6,23,3,9,5,3,OTC
4432,11-02-2021 04:00,24 hrs.,pennystocks,AMMJ,7,7,0,7,1,1,1,1,OTC
4432,11-02-2021 04:00,24 hrs.,pennystocks,AMNE,6,6,0,6,1,1,0,1,OTC
4432,11-02-2021 04:00,24 hrs.,pennystocks,AMNL,10,10,0,10,1,1,4,1,OTC
4432,11-02-2021 04:00,24 hrs.,pennystocks,APYP,6,6,0,6,1,1,0,1,OTC
4432,11-02-2021 04:00,24 hrs.,pennystocks,ASKE,7,0,7,-7,1,1,1,1,OTC
4432,11-02-2021 04:00,24 hrs.,pennystocks,ASTI,39,14,25,-11,6,6,3,6,OTC
4432,11-02-2021 04:00,24 hrs.,pennystocks,BANT,7,7,0,7,1,1,1,1,OTC
4432,11-02-2021 04:00,24 hrs.,pennystocks,BBDA,10,10,0,10,1,2,2,1,OTC
4432,11-02-2021 04:00,24 hrs.,pennystocks,BBRW,178,0,178,-178,2,65,40,2,OTC
4432,11-02-2021 04:00,24 hrs.,pennystocks,BDGR,12,12,0,12,2,2,0,1,OTC
4432,11-02-2021 04:00,24 hrs.,pennystocks,BFCH,76,51,25,26,5,13,30,5,OTC
4432,11-02-2021 04:00,24 hrs.,pennystocks,BIGG,25,19,6,13,2,8,1,2,OTC
4432,11-02-2021 04:00,24 hrs.,pennystocks,BLDV,237,13,224,-211,3,97,31,3,OTC
4432,11-02-2021 04:00,24 hrs.,pennystocks,BLSP,62,6,56,-50,3,18,14,3,OTC
4432,11-02-2021 04:00,24 hrs.,pennystocks,MINE,138,19,119,-100,10,34,30,9,OTC
4432,11-02-2021 04:00,24 hrs.,pennystocks,MJLB,18,0,18,-18,3,3,0,2,OTC
4432,11-02-2021 04:00,24 hrs.,pennystocks,MJNA,68,56,12,44,9,14,4,8,OTC
4432,11-02-2021 04:00,24 hrs.,pennystocks,MLFB,129,129,0,129,1,36,53,1,OTC
4432,11-02-2021 04:00,24 hrs.,pennystocks,MMEX,209,84,125,-41,12,62,37,11,OTC
4432,11-02-2021 04:00,24 hrs.,pennystocks,MOST,6,6,0,6,1,1,0,1,OTC
4432,11-02-2021 04:00,24 hrs.,pennystocks,MRMD,6,0,6,-6,1,1,0,1,OTC
4432,11-02-2021 04:00,24 hrs.,pennystocks,MSPC,20,0,20,-20,3,3,2,2,OTC
4432,11-02-2021 04:00,24 hrs.,pennystocks,MSRT,6,6,0,6,1,1,0,1,OTC
4432,11-02-2021 04:00,24 hrs.,pennystocks,MTVX,13,7,6,1,2,2,1,2,OTC
4432,11-02-2021 04:00,24 hrs.,pennystocks,MYDX,7,0,7,-7,1,1,1,1,OTC
4432,11-02-2021 04:00,24 hrs.,pennystocks,NLST,7,0,7,-7,1,1,1,1,OTC
4432,11-02-2021 04:00,24 hrs.,pennystocks,NOHO,84,84,0,84,1,19,42,1,OTC
4432,11-02-2021 04:00,24 hrs.,pennystocks,NOVC,38,38,0,38,1,14,6,1,OTC
4432,11-02-2021 04:00,24 hrs.,pennystocks,NSAV,14,14,0,14,2,2,2,1,OTC
4432,11-02-2021 04:00,24 hrs.,pennystocks,NSPT,57,57,0,57,2,13,23,2,OTC
4432,11-02-2021 04:00,24 hrs.,pennystocks,NSPX,7,0,7,-7,1,1,1,1,OTC
4432,11-02-2021 04:00,24 hrs.,pennystocks,NUKK,14,14,0,14,2,2,2,2,OTC
4432,11-02-2021 04:00,24 hrs.,pennystocks,NVGT,57,57,0,57,2,13,23,2,OTC
4432,11-02-2021 04:00,24 hrs.,pennystocks,OPTI,13,13,0,13,2,2,1,2,OTC
4432,11-02-2021 04:00,24 hrs.,pennystocks,OSKA,57,57,0,57,2,13,23,2,OTC
4432,11-02-2021 04:00,24 hrs.,pennystocks,OZSC,56,56,0,56,2,17,14,2,OTC
4432,11-02-2021 04:00,24 hrs.,pennystocks,PAOG,23,23,0,23,1,6,7,1,OTC
4432,11-02-2021 04:00,24 hrs.,pennystocks,PCTL,6,0,6,-6,1,1,0,1,OTC
4432,11-02-2021 04:00,24 hrs.,pennystocks,PHIL,20,13,7,6,3,3,2,2,OTC
4432,11-02-2021 04:00,24 hrs.,pennystocks,PHMB,7,0,7,-7,1,1,1,1,OTC
4432,11-02-2021 04:00,24 hrs.,pennystocks,PLYZ,7,0,7,-7,1,1,1,1,OTC
4432,11-02-2021 04:00,24 hrs.,pennystocks,PMCB,42,42,0,42,1,10,18,1,OTC
4432,11-02-2021 04:00,24 hrs.,pennystocks,PNAT,4,4,0,4,1,0,0,1,OTC
4432,11-02-2021 04:00,24 hrs.,pennystocks,CVAT,73,0,73,-73,1,29,11,1,OTC
4432,11-02-2021 04:00,24 hrs.,pennystocks,DGTW,33,33,0,33,3,6,9,3,OTC
4432,11-02-2021 04:00,24 hrs.,pennystocks,DKAM,41,41,0,41,6,6,5,1,OTC
4432,11-02-2021 04:00,24 hrs.,pennystocks,DKMR,6,6,0,6,1,1,0,1,OTC
4432,11-02-2021 04:00,24 hrs.,pennystocks,DLAD,33,27,6,21,2,7,11,2,OTC
4432,11-02-2021 04:00,24 hrs.,pennystocks,DPLS,19,12,7,5,3,3,1,3,OTC
4432,11-02-2021 04:00,24 hrs.,pennystocks,DPWW,4,0,4,-4,1,0,0,1,OTC
4432,11-02-2021 04:00,24 hrs.,pennystocks,DROP,8,8,0,8,1,1,2,1,OTC
4432,11-02-2021 04:00,24 hrs.,pennystocks,DSCR,13,13,0,13,2,2,1,1,OTC
4432,11-02-2021 04:00,24 hrs.,pennystocks,DSGT,6,0,6,-6,1,1,0,1,OTC
4432,11-02-2021 04:00,24 hrs.,pennystocks,ECCE,14,0,14,-14,1,4,2,1,OTC
4432,11-02-2021 04:00,24 hrs.,pennystocks,ECGI,57,57,0,57,2,13,23,2,OTC
4432,11-02-2021 04:00,24 hrs.,pennystocks,ECIA,6,6,0,6,1,1,0,1,OTC
4432,11-02-2021 04:00,24 hrs.,pennystocks,ECOS,6,0,6,-6,1,1,0,1,OTC
4432,11-02-2021 04:00,24 hrs.,pennystocks,EDXC,14,14,0,14,2,2,2,1,OTC
4432,11-02-2021 04:00,24 hrs.,pennystocks,EHOS,63,63,0,63,3,14,23,3,OTC
4432,11-02-2021 04:00,24 hrs.,pennystocks,EKWX,11,0,11,-11,1,1,5,1,OTC
4432,11-02-2021 04:00,24 hrs.,pennystocks,ENZC,236,230,6,224,8,62,80,8,OTC
4432,11-02-2021 04:00,24 hrs.,pennystocks,ERBB,18,12,6,6,3,3,0,3,OTC
4432,11-02-2021 04:00,24 hrs.,pennystocks,ETFM,214,6,208,-202,6,57,76,5,OTC
4432,11-02-2021 04:00,24 hrs.,pennystocks,ETST,13,13,0,13,2,2,1,1,OTC
4432,11-02-2021 04:00,24 hrs.,pennystocks,EVTI,9,9,0,9,1,1,3,1,OTC
4432,11-02-2021 04:00,24 hrs.,pennystocks,EWLL,27,27,0,27,4,5,1,4,OTC
4432,11-02-2021 04:00,24 hrs.,pennystocks,FBEC,21,15,6,9,3,3,3,3,OTC
4432,11-02-2021 04:00,24 hrs.,pennystocks,FPFI,6,6,0,6,1,1,0,1,OTC
4432,11-02-2021 04:00,24 hrs.,pennystocks,FPVD,6,0,6,-6,1,1,0,1,OTC
4432,11-02-2021 04:00,24 hrs.,pennystocks,FTEG,6,6,0,6,1,1,0,1,OTC
4432,11-02-2021 04:00,24 hrs.,pennystocks,FTXP,57,57,0,57,2,13,23,2,OTC
4432,11-02-2021 04:00,24 hrs.,pennystocks,FWDG,14,14,0,14,2,2,2,2,OTC
4432,11-02-2021 04:00,24 hrs.,pennystocks,GACR,7,7,0,7,1,1,1,1,OTC
4432,11-02-2021 04:00,24 hrs.,pennystocks,GAXY,71,0,71,-71,3,19,21,3,OTC
4432,11-02-2021 04:00,24 hrs.,pennystocks,GBLX,6,6,0,6,1,1,0,1,OTC
4432,11-02-2021 04:00,24 hrs.,pennystocks,GCEH,13,6,7,-1,2,2,1,2,OTC
4432,11-02-2021 04:00,24 hrs.,pennystocks,GDET,987,987,0,987,1,468,47,1,OTC
4432,11-02-2021 04:00,24 hrs.,pennystocks,GHTI,7,7,0,7,1,1,1,1,OTC
4432,11-02-2021 04:00,24 hrs.,pennystocks,TCHH,7,0,7,-7,1,1,1,1,OTC
4432,11-02-2021 04:00,24 hrs.,pennystocks,TEUM,7,7,0,7,1,1,1,1,OTC
4432,11-02-2021 04:00,24 hrs.,pennystocks,TLSS,185,178,7,171,4,41,87,4,OTC
4432,11-02-2021 04:00,24 hrs.,pennystocks,TMRC,23,0,23,-23,1,6,7,1,OTC
4432,11-02-2021 04:00,24 hrs.,pennystocks,TONR,57,57,0,57,2,13,23,2,OTC
4432,11-02-2021 04:00,24 hrs.,pennystocks,TPAC,6,6,0,6,1,1,0,1,OTC
4432,11-02-2021 04:00,24 hrs.,pennystocks,TRTC,17,17,0,17,2,3,3,2,OTC
4432,11-02-2021 04:00,24 hrs.,pennystocks,TSNP,78,72,6,66,6,16,22,6,OTC
4432,11-02-2021 04:00,24 hrs.,pennystocks,TTCM,6,6,0,6,1,1,0,1,OTC
4432,11-02-2021 04:00,24 hrs.,pennystocks,UATG,71,53,18,35,8,14,11,6,OTC
4432,11-02-2021 04:00,24 hrs.,pennystocks,UBQU,184,12,172,-160,3,66,40,3,OTC
4432,11-02-2021 04:00,24 hrs.,pennystocks,UITA,8,8,0,8,1,1,2,1,OTC
4432,11-02-2021 04:00,24 hrs.,pennystocks,UPCO,18,18,0,18,1,6,2,1,OTC
4432,11-02-2021 04:00,24 hrs.,pennystocks,USMJ,162,18,144,-126,7,45,44,7,OTC
4432,11-02-2021 04:00,24 hrs.,pennystocks,UVSE,47,47,0,47,3,11,13,1,OTC
4432,11-02-2021 04:00,24 hrs.,pennystocks,VIBI,7,7,0,7,1,1,1,1,OTC
4432,11-02-2021 04:00,24 hrs.,pennystocks,VITX,6,6,0,6,1,1,0,1,OTC
4432,11-02-2021 04:00,24 hrs.,pennystocks,VMHG,69,69,0,69,4,15,23,2,OTC
4432,11-02-2021 04:00,24 hrs.,pennystocks,VPER,12,6,6,0,2,2,0,2,OTC
4432,11-02-2021 04:00,24 hrs.,pennystocks,VPOR,7,0,7,-7,1,1,1,1,OTC
4432,11-02-2021 04:00,24 hrs.,pennystocks,VSYM,16,0,16,-16,1,3,6,1,OTC
4432,11-02-2021 04:00,24 hrs.,pennystocks,WCVC,7,0,7,-7,1,1,1,1,OTC
4432,11-02-2021 04:00,24 hrs.,pennystocks,WDLF,13,6,7,-1,2,2,1,2,OTC
4432,11-02-2021 04:00,24 hrs.,pennystocks,WHEN,2190,7,2183,-2176,2,1006,170,2,OTC
4432,11-02-2021 04:00,24 hrs.,pennystocks,WNCP,13,7,6,1,2,2,1,2,OTC
4432,11-02-2021 04:00,24 hrs.,pennystocks,WSTL,7,0,7,-7,1,1,1,1,OTC
4432,11-02-2021 04:00,24 hrs.,pennystocks,XFLS,6,6,0,6,1,1,0,1,OTC
4432,11-02-2021 04:00,24 hrs.,pennystocks,XMET,20,20,0,20,1,4,8,1,OTC
4432,11-02-2021 04:00,24 hrs.,pennystocks,ABEPF,922,0,922,-922,6,349,200,4,OTC
4432,11-02-2021 04:00,24 hrs.,pennystocks,IGXT,6,6,0,6,1,1,0,1,OTC
4432,11-02-2021 04:00,24 hrs.,pennystocks,ILAL,12,12,0,12,2,2,0,2,OTC
4432,11-02-2021 04:00,24 hrs.,pennystocks,ILUS,25,19,6,13,2,6,5,2,OTC
4432,11-02-2021 04:00,24 hrs.,pennystocks,IMJX,7,7,0,7,1,1,1,1,OTC
4432,11-02-2021 04:00,24 hrs.,pennystocks,IMTL,57,57,0,57,2,13,23,2,OTC
4432,11-02-2021 04:00,24 hrs.,pennystocks,INIS,30,0,30,-30,1,10,6,1,OTC
4432,11-02-2021 04:00,24 hrs.,pennystocks,INKW,38,19,19,0,6,6,2,6,OTC
4432,11-02-2021 04:00,24 hrs.,pennystocks,INND,150,33,117,-84,8,45,28,6,OTC
4432,11-02-2021 04:00,24 hrs.,pennystocks,INQD,79,0,79,-79,2,25,21,2,OTC
4432,11-02-2021 04:00,24 hrs.,pennystocks,INTV,6,0,6,-6,1,1,0,1,OTC
4432,11-02-2021 04:00,24 hrs.,pennystocks,IPIX,60,7,53,-46,4,14,16,3,OTC
4432,11-02-2021 04:00,24 hrs.,pennystocks,IPKL,6,0,6,-6,1,1,0,1,OTC
4432,11-02-2021 04:00,24 hrs.,pennystocks,IQST,14,0,14,-14,2,2,2,1,OTC
4432,11-02-2021 04:00,24 hrs.,pennystocks,JADA,19,0,19,-19,3,3,1,2,OTC
4432,11-02-2021 04:00,24 hrs.,pennystocks,JAMN,57,57,0,57,2,13,23,2,OTC
4432,11-02-2021 04:00,24 hrs.,pennystocks,JRSS,23,23,0,23,3,4,3,3,OTC
4432,11-02-2021 04:00,24 hrs.,pennystocks,KBLB,7,7,0,7,1,1,1,1,OTC
4432,11-02-2021 04:00,24 hrs.,pennystocks,KGET,27,27,0,27,1,6,11,1,OTC
4432,11-02-2021 04:00,24 hrs.,pennystocks,KGKG,12,0,12,-12,2,2,0,2,OTC
4432,11-02-2021 04:00,24 hrs.,pennystocks,KKUR,6,6,0,6,1,1,0,1,OTC
4432,11-02-2021 04:00,24 hrs.,pennystocks,KRFG,7,7,0,7,1,1,1,1,OTC
4432,11-02-2021 04:00,24 hrs.,pennystocks,KSHB,61,43,18,25,2,22,9,2,OTC
4432,11-02-2021 04:00,24 hrs.,pennystocks,KULR,13,13,0,13,2,2,1,1,OTC
4432,11-02-2021 04:00,24 hrs.,pennystocks,KWBT,7,0,7,-7,1,1,1,1,OTC
4432,11-02-2021 04:00,24 hrs.,pennystocks,LAAB,6,0,6,-6,1,1,0,1,OTC
4432,11-02-2021 04:00,24 hrs.,pennystocks,LBSR,25,25,0,25,4,4,1,2,OTC
4432,11-02-2021 04:00,24 hrs.,pennystocks,LTNC,38,38,0,38,1,14,6,1,OTC
4432,11-02-2021 04:00,24 hrs.,pennystocks,LVVV,20,20,0,20,2,2,8,2,OTC
4432,11-02-2021 04:00,24 hrs.,pennystocks,MAXD,6,6,0,6,1,1,0,1,OTC
4432,11-02-2021 04:00,24 hrs.,pennystocks,MBAY,20,20,0,20,1,1,14,1,OTC
4432,11-02-2021 04:00,24 hrs.,pennystocks,MCOA,79,19,60,-41,6,23,9,4,OTC
4432,11-02-2021 04:00,24 hrs.,pennystocks,MEGH,57,57,0,57,2,13,23,2,OTC
4432,11-02-2021 04:00,24 hrs.,pennystocks,MFST,13,13,0,13,2,2,1,1,OTC
4432,11-02-2021 04:00,24 hrs.,pennystocks,MGLG,6,6,0,6,1,1,0,1,OTC
4432,11-02-2021 04:00,24 hrs.,pennystocks,MGTI,27,21,6,15,4,4,3,2,OTC
4432,11-02-2021 04:00,24 hrs.,pennystocks,XBIO,45,45,0,45,1,17,7,1,NASDAQ
4432,11-02-2021 04:00,24 hrs.,pennystocks,XONE,6,0,6,-6,1,1,0,1,NASDAQ
4432,11-02-2021 04:00,24 hrs.,pennystocks,XSPA,98,75,23,52,7,31,8,6,NASDAQ
4432,11-02-2021 04:00,24 hrs.,pennystocks,ZKIN,44,0,44,-44,1,16,8,1,NASDAQ
4432,11-02-2021 04:00,24 hrs.,pennystocks,ZSAN,173,129,44,85,16,33,43,13,NASDAQ
4432,11-02-2021 04:00,24 hrs.,RobinHoodPennyStocks,AFOM,6,6,0,6,1,1,0,1,OTC
4432,11-02-2021 04:00,24 hrs.,RobinHoodPennyStocks,AGYP,6,6,0,6,1,1,0,1,OTC
4432,11-02-2021 04:00,24 hrs.,RobinHoodPennyStocks,ALPP,6,6,0,6,1,1,0,1,OTC
4432,11-02-2021 04:00,24 hrs.,RobinHoodPennyStocks,AMNE,6,6,0,6,1,1,0,1,OTC
4432,11-02-2021 04:00,24 hrs.,RobinHoodPennyStocks,BIEL,6,6,0,6,1,1,0,1,OTC
4432,11-02-2021 04:00,24 hrs.,RobinHoodPennyStocks,BIGG,6,0,6,-6,1,1,0,1,OTC
4432,11-02-2021 04:00,24 hrs.,RobinHoodPennyStocks,BNGI,12,12,0,12,2,2,0,1,OTC
4432,11-02-2021 04:00,24 hrs.,RobinHoodPennyStocks,BOTY,18,0,18,-18,3,3,0,2,OTC
4432,11-02-2021 04:00,24 hrs.,RobinHoodPennyStocks,CAGR,26,26,0,26,1,5,12,1,OTC
4432,11-02-2021 04:00,24 hrs.,RobinHoodPennyStocks,CBDX,6,6,0,6,1,1,0,1,OTC
4432,11-02-2021 04:00,24 hrs.,RobinHoodPennyStocks,DSGT,9,0,9,-9,1,0,5,1,OTC
4432,11-02-2021 04:00,24 hrs.,RobinHoodPennyStocks,ECEZ,6,6,0,6,1,1,0,1,OTC
4432,11-02-2021 04:00,24 hrs.,RobinHoodPennyStocks,EDXC,6,0,6,-6,1,1,0,1,OTC
4432,11-02-2021 04:00,24 hrs.,RobinHoodPennyStocks,GDSI,6,6,0,6,1,1,0,1,OTC
4432,11-02-2021 04:00,24 hrs.,RobinHoodPennyStocks,GRPS,6,6,0,6,1,1,0,1,OTC
4432,11-02-2021 04:00,24 hrs.,RobinHoodPennyStocks,HCMC,89,12,77,-65,3,28,21,3,OTC
4432,11-02-2021 04:00,24 hrs.,RobinHoodPennyStocks,HEMP,18,6,12,-6,3,3,0,3,OTC
4432,11-02-2021 04:00,24 hrs.,RobinHoodPennyStocks,HMNY,18,18,0,18,3,3,0,2,OTC
4432,11-02-2021 04:00,24 hrs.,RobinHoodPennyStocks,INKW,26,26,0,26,1,5,12,1,OTC
4432,11-02-2021 04:00,24 hrs.,RobinHoodPennyStocks,IPIX,71,0,71,-71,1,27,13,1,OTC
4432,11-02-2021 04:00,24 hrs.,RobinHoodPennyStocks,KPAY,6,6,0,6,1,1,0,1,OTC
4432,11-02-2021 04:00,24 hrs.,RobinHoodPennyStocks,MINE,44,32,12,20,4,8,12,3,OTC
4432,11-02-2021 04:00,24 hrs.,RobinHoodPennyStocks,MJNA,12,12,0,12,2,2,0,2,OTC
4432,11-02-2021 04:00,24 hrs.,RobinHoodPennyStocks,MMEX,6,6,0,6,1,1,0,1,OTC
4432,11-02-2021 04:00,24 hrs.,pennystocks,PPJE,15,15,0,15,2,2,3,2,OTC
4432,11-02-2021 04:00,24 hrs.,pennystocks,PRED,6,6,0,6,1,1,0,1,OTC
4432,11-02-2021 04:00,24 hrs.,pennystocks,PSYC,7,0,7,-7,1,1,1,1,OTC
4432,11-02-2021 04:00,24 hrs.,pennystocks,PURA,6,6,0,6,1,1,0,1,OTC
4432,11-02-2021 04:00,24 hrs.,pennystocks,PVDG,490,205,285,-80,6,180,106,6,OTC
4432,11-02-2021 04:00,24 hrs.,pennystocks,QMCI,675,6,669,-663,2,290,87,2,OTC
4432,11-02-2021 04:00,24 hrs.,pennystocks,RBNW,36,36,0,36,3,5,14,2,OTC
4432,11-02-2021 04:00,24 hrs.,pennystocks,RDGL,52,45,7,38,2,18,8,2,OTC
4432,11-02-2021 04:00,24 hrs.,pennystocks,RELI,33,0,33,-33,1,6,17,1,OTC
4432,11-02-2021 04:00,24 hrs.,pennystocks,RKLC,6,6,0,6,1,1,0,1,OTC
4432,11-02-2021 04:00,24 hrs.,pennystocks,RSSV,62,62,0,62,1,21,16,1,OTC
4432,11-02-2021 04:00,24 hrs.,pennystocks,RTON,193,65,128,-63,13,48,45,12,OTC
4432,11-02-2021 04:00,24 hrs.,pennystocks,SANP,6,6,0,6,1,1,0,1,OTC
4432,11-02-2021 04:00,24 hrs.,pennystocks,SBFM,33,33,0,33,2,9,7,2,OTC
4432,11-02-2021 04:00,24 hrs.,pennystocks,SEEK,6,6,0,6,1,1,0,1,OTC
4432,11-02-2021 04:00,24 hrs.,pennystocks,SGMD,506,432,74,358,9,175,120,7,OTC
4432,11-02-2021 04:00,24 hrs.,pennystocks,SGSI,83,71,12,59,9,17,13,4,OTC
4432,11-02-2021 04:00,24 hrs.,pennystocks,SHMP,36,6,30,-24,2,10,8,2,OTC
4432,11-02-2021 04:00,24 hrs.,pennystocks,SHWZ,6,0,6,-6,1,1,0,1,OTC
4432,11-02-2021 04:00,24 hrs.,pennystocks,SIML,13,7,6,1,2,2,1,2,OTC
4432,11-02-2021 04:00,24 hrs.,pennystocks,SING,7,0,7,-7,1,1,1,1,OTC
4432,11-02-2021 04:00,24 hrs.,pennystocks,SIRC,31,31,0,31,1,9,9,1,OTC
4432,11-02-2021 04:00,24 hrs.,pennystocks,SKDI,24,24,0,24,3,4,4,2,OTC
4432,11-02-2021 04:00,24 hrs.,pennystocks,SNDD,6,0,6,-6,1,1,0,1,OTC
4432,11-02-2021 04:00,24 hrs.,pennystocks,SNPW,20,6,14,-8,3,3,2,2,OTC
4432,11-02-2021 04:00,24 hrs.,pennystocks,SNRS,6,6,0,6,1,1,0,1,OTC
4432,11-02-2021 04:00,24 hrs.,pennystocks,SRMX,63,7,56,-49,3,19,13,3,OTC
4432,11-02-2021 04:00,24 hrs.,pennystocks,SSFT,6,6,0,6,1,1,0,1,OTC
4432,11-02-2021 04:00,24 hrs.,pennystocks,STHI,73,0,73,-73,1,29,11,1,OTC
4432,11-02-2021 04:00,24 hrs.,pennystocks,STMH,31,31,0,31,2,8,7,2,OTC
4432,11-02-2021 04:00,24 hrs.,pennystocks,STWC,16,9,7,2,2,2,4,2,OTC
4432,11-02-2021 04:00,24 hrs.,pennystocks,SUGR,50,12,38,-26,3,14,10,3,OTC
4432,11-02-2021 04:00,24 hrs.,pennystocks,SUIC,12,12,0,12,2,2,0,1,OTC
4432,11-02-2021 04:00,24 hrs.,pennystocks,SWRM,6,0,6,-6,1,1,0,1,OTC
4432,11-02-2021 04:00,24 hrs.,pennystocks,TBEV,84,84,0,84,1,19,42,1,OTC
4432,11-02-2021 04:00,24 hrs.,RobinHoodPennyStocks,INUV,12,12,0,12,1,3,2,1,AMEX
4432,11-02-2021 04:00,24 hrs.,RobinHoodPennyStocks,LCTX,19,19,0,19,1,0,15,1,AMEX
4432,11-02-2021 04:00,24 hrs.,RobinHoodPennyStocks,NSPR,172,82,90,-8,5,50,52,5,AMEX
4432,11-02-2021 04:00,24 hrs.,RobinHoodPennyStocks,OGEN,67,67,0,67,1,18,27,1,AMEX
4432,11-02-2021 04:00,24 hrs.,RobinHoodPennyStocks,SENS,124,71,53,18,2,39,38,2,AMEX
4432,11-02-2021 04:00,24 hrs.,RobinHoodPennyStocks,TRXC,41,41,0,41,1,14,9,1,AMEX
4432,11-02-2021 04:00,24 hrs.,RobinHoodPennyStocks,UAMY,65,65,0,65,4,17,15,4,AMEX
4432,11-02-2021 04:00,24 hrs.,RobinHoodPennyStocks,XXII,30,30,0,30,1,10,6,1,AMEX
4432,11-02-2021 04:00,24 hrs.,RobinHoodPennyStocks,AMC,342,0,342,-342,2,150,34,2,NYSE
4432,11-02-2021 04:00,24 hrs.,RobinHoodPennyStocks,CBD,32,26,6,20,2,6,12,2,NYSE
4432,11-02-2021 04:00,24 hrs.,RobinHoodPennyStocks,CNS,6,6,0,6,1,1,0,1,NYSE
4432,11-02-2021 04:00,24 hrs.,RobinHoodPennyStocks,CNX,26,26,0,26,1,5,12,1,NYSE
4432,11-02-2021 04:00,24 hrs.,RobinHoodPennyStocks,DCF,26,26,0,26,1,5,12,1,NYSE
4432,11-02-2021 04:00,24 hrs.,RobinHoodPennyStocks,ETH,26,26,0,26,1,5,12,1,NYSE
4432,11-02-2021 04:00,24 hrs.,RobinHoodPennyStocks,GME,461,125,336,-211,5,191,59,5,NYSE
4432,11-02-2021 04:00,24 hrs.,RobinHoodPennyStocks,IVR,12,12,0,12,2,2,0,1,NYSE
4432,11-02-2021 04:00,24 hrs.,RobinHoodPennyStocks,REAL,6,6,0,6,1,1,0,1,NASDAQ
4432,11-02-2021 04:00,24 hrs.,RobinHoodPennyStocks,RIOT,6,0,6,-6,1,1,0,1,NASDAQ
4432,11-02-2021 04:00,24 hrs.,RobinHoodPennyStocks,SELB,14,14,0,14,1,3,4,1,NASDAQ
4432,11-02-2021 04:00,24 hrs.,RobinHoodPennyStocks,SNCA,20,20,0,20,1,7,2,1,NASDAQ
4432,11-02-2021 04:00,24 hrs.,RobinHoodPennyStocks,SNDL,3862,2818,1044,1774,91,1206,1086,83,NASDAQ
4432,11-02-2021 04:00,24 hrs.,RobinHoodPennyStocks,TBLT,6,0,6,-6,1,1,0,1,NASDAQ
4432,11-02-2021 04:00,24 hrs.,RobinHoodPennyStocks,TEAM,6,6,0,6,1,1,0,1,NASDAQ
4432,11-02-2021 04:00,24 hrs.,RobinHoodPennyStocks,TIGR,6,0,6,-6,1,1,0,1,NASDAQ
4432,11-02-2021 04:00,24 hrs.,RobinHoodPennyStocks,TLGT,12,12,0,12,1,3,2,1,NASDAQ
4432,11-02-2021 04:00,24 hrs.,RobinHoodPennyStocks,TLRY,131,125,6,119,5,33,45,5,NASDAQ
4432,11-02-2021 04:00,24 hrs.,RobinHoodPennyStocks,TNXP,95,57,38,19,8,20,23,8,NASDAQ
4432,11-02-2021 04:00,24 hrs.,RobinHoodPennyStocks,TRCH,257,127,130,-3,7,79,71,7,NASDAQ
4432,11-02-2021 04:00,24 hrs.,RobinHoodPennyStocks,TRIP,26,26,0,26,1,5,12,1,NASDAQ
4432,11-02-2021 04:00,24 hrs.,pennystocks,ACRHF,6,0,6,-6,1,1,0,1,OTC
4432,11-02-2021 04:00,24 hrs.,pennystocks,AGEEF,6,0,6,-6,1,1,0,1,OTC
4432,11-02-2021 04:00,24 hrs.,pennystocks,AGFAF,24,18,6,12,4,4,0,4,OTC
4432,11-02-2021 04:00,24 hrs.,pennystocks,AGNPF,50,50,0,50,1,20,6,1,OTC
4432,11-02-2021 04:00,24 hrs.,pennystocks,AMYZF,8,0,8,-8,1,1,2,1,OTC
4432,11-02-2021 04:00,24 hrs.,pennystocks,ARBKF,48,48,0,48,2,11,18,2,OTC
4432,11-02-2021 04:00,24 hrs.,pennystocks,ARSMF,8,8,0,8,1,1,2,1,OTC
4432,11-02-2021 04:00,24 hrs.,pennystocks,ATIXF,6,6,0,6,1,1,0,1,OTC
4432,11-02-2021 04:00,24 hrs.,pennystocks,ATTBF,6,6,0,6,1,1,0,1,OTC
4432,11-02-2021 04:00,24 hrs.,pennystocks,ATURF,21,0,21,-21,2,4,5,1,OTC
4432,11-02-2021 04:00,24 hrs.,pennystocks,BBKCF,25,19,6,13,2,8,1,2,OTC
4432,11-02-2021 04:00,24 hrs.,pennystocks,BDRBF,19,19,0,19,3,3,1,2,OTC
4432,11-02-2021 04:00,24 hrs.,pennystocks,CBULF,10,10,0,10,1,1,4,1,OTC
4432,11-02-2021 04:00,24 hrs.,pennystocks,CBWTF,12,12,0,12,2,2,0,1,OTC
4432,11-02-2021 04:00,24 hrs.,pennystocks,CDTAF,6,6,0,6,1,1,0,1,OTC
4432,11-02-2021 04:00,24 hrs.,pennystocks,CNIKF,21,21,0,21,1,3,11,1,OTC
4432,11-02-2021 04:00,24 hrs.,pennystocks,CNTTQ,6,6,0,6,1,1,0,1,OTC
4432,11-02-2021 04:00,24 hrs.,pennystocks,CREQF,6,0,6,-6,1,1,0,1,OTC
4432,11-02-2021 04:00,24 hrs.,pennystocks,DIGAF,25,0,25,-25,4,4,1,4,OTC
4432,11-02-2021 04:00,24 hrs.,pennystocks,DMNXF,87,87,0,87,1,27,29,1,OTC
4432,11-02-2021 04:00,24 hrs.,pennystocks,EFLVF,105,105,0,105,4,30,29,2,OTC
4432,11-02-2021 04:00,24 hrs.,pennystocks,FFLWF,6,0,6,-6,1,1,0,1,OTC
4432,11-02-2021 04:00,24 hrs.,pennystocks,FIORF,13,13,0,13,2,2,1,2,OTC
4432,11-02-2021 04:00,24 hrs.,pennystocks,FLOOF,14,7,7,0,2,2,2,2,OTC
4432,11-02-2021 04:00,24 hrs.,pennystocks,GCPEF,15,0,15,-15,1,2,7,1,OTC
4432,11-02-2021 04:00,24 hrs.,pennystocks,GGBXF,7,7,0,7,1,1,1,1,OTC
4432,11-02-2021 04:00,24 hrs.,pennystocks,GLDFF,33,27,6,21,5,5,3,5,OTC
4432,11-02-2021 04:00,24 hrs.,pennystocks,HITIF,1200,637,563,74,18,411,306,18,OTC
4432,11-02-2021 04:00,24 hrs.,pennystocks,HLLPF,41,41,0,41,1,17,3,1,OTC
4432,11-02-2021 04:00,24 hrs.,pennystocks,HRVOF,54,54,0,54,1,18,14,1,OTC
4432,11-02-2021 04:00,24 hrs.,pennystocks,HSTRF,6,6,0,6,1,1,0,1,OTC
4432,11-02-2021 04:00,24 hrs.,pennystocks,ICOTF,42,42,0,42,1,10,18,1,OTC
4432,11-02-2021 04:00,24 hrs.,pennystocks,INTEQ,6,6,0,6,1,1,0,1,OTC
4432,11-02-2021 04:00,24 hrs.,pennystocks,JRVMF,6,6,0,6,1,1,0,1,OTC
4432,11-02-2021 04:00,24 hrs.,pennystocks,WIRE,54,0,54,-54,1,19,12,1,NASDAQ
4432,11-02-2021 04:00,24 hrs.,pennystocks,AZN,33,33,0,33,2,7,11,2,NASDAQ
4432,11-02-2021 04:00,24 hrs.,pennystocks,CFO,31,31,0,31,1,10,7,1,NASDAQ
4432,11-02-2021 04:00,24 hrs.,pennystocks,ESG,12,0,12,-12,2,2,0,1,NASDAQ
4432,11-02-2021 04:00,24 hrs.,pennystocks,HAS,19,13,6,7,3,3,1,3,NASDAQ
4432,11-02-2021 04:00,24 hrs.,pennystocks,III,54,0,54,-54,1,19,12,1,NASDAQ
4432,11-02-2021 04:00,24 hrs.,pennystocks,OGI,84,70,14,56,5,14,36,5,NASDAQ
4432,11-02-2021 04:00,24 hrs.,pennystocks,OPK,7,7,0,7,1,1,1,1,NASDAQ
4432,11-02-2021 04:00,24 hrs.,pennystocks,OSS,26,0,26,-26,1,5,12,1,NASDAQ
4432,11-02-2021 04:00,24 hrs.,pennystocks,PTE,180,8,172,-164,2,65,42,2,NASDAQ
4432,11-02-2021 04:00,24 hrs.,pennystocks,VIR,6,6,0,6,1,1,0,1,NASDAQ
4432,11-02-2021 04:00,24 hrs.,pennystocks,ACRX,235,229,6,223,2,103,21,2,NASDAQ
4432,11-02-2021 04:00,24 hrs.,pennystocks,ACST,6,0,6,-6,1,1,0,1,NASDAQ
4432,11-02-2021 04:00,24 hrs.,pennystocks,ADMA,53,53,0,53,3,18,5,2,NASDAQ
4432,11-02-2021 04:00,24 hrs.,pennystocks,ADMP,21,21,0,21,2,4,5,2,NASDAQ
4432,11-02-2021 04:00,24 hrs.,pennystocks,AEZS,114,101,13,88,4,35,28,4,NASDAQ
4432,11-02-2021 04:00,24 hrs.,pennystocks,AGTC,63,57,6,51,4,15,17,3,NASDAQ
4432,11-02-2021 04:00,24 hrs.,pennystocks,AIHS,6,6,0,6,1,1,0,1,NASDAQ
4432,11-02-2021 04:00,24 hrs.,pennystocks,AKBA,6,6,0,6,1,1,0,1,NASDAQ
4432,11-02-2021 04:00,24 hrs.,pennystocks,AKER,45,45,0,45,1,17,7,1,NASDAQ
4432,11-02-2021 04:00,24 hrs.,pennystocks,AMTX,14,7,7,0,2,2,2,2,NASDAQ
4432,11-02-2021 04:00,24 hrs.,RobinHoodPennyStocks,TXMD,154,18,136,-118,7,45,36,7,NASDAQ
4432,11-02-2021 04:00,24 hrs.,RobinHoodPennyStocks,TYME,12,6,6,0,2,2,0,2,NASDAQ
4432,11-02-2021 04:00,24 hrs.,RobinHoodPennyStocks,UNFI,8,8,0,8,1,2,0,1,NASDAQ
4432,11-02-2021 04:00,24 hrs.,RobinHoodPennyStocks,VBIV,28,0,28,-28,1,7,10,1,NASDAQ
4432,11-02-2021 04:00,24 hrs.,RobinHoodPennyStocks,VISL,32,6,26,-20,2,5,14,2,NASDAQ
4432,11-02-2021 04:00,24 hrs.,RobinHoodPennyStocks,XCUR,6,0,6,-6,1,1,0,1,NASDAQ
4432,11-02-2021 04:00,24 hrs.,RobinHoodPennyStocks,XONE,6,0,6,-6,1,1,0,1,NASDAQ
4432,11-02-2021 04:00,24 hrs.,RobinHoodPennyStocks,XSPA,107,57,50,7,4,37,17,4,NASDAQ
4432,11-02-2021 04:00,24 hrs.,RobinHoodPennyStocks,ZSAN,237,165,72,93,8,71,63,8,NASDAQ
4432,11-02-2021 04:00,24 hrs.,RobinHoodPennyStocks,NUUU,24,6,18,-12,4,4,0,2,OTC
4432,11-02-2021 04:00,24 hrs.,RobinHoodPennyStocks,RTON,14,0,14,-14,2,2,2,2,OTC
4432,11-02-2021 04:00,24 hrs.,RobinHoodPennyStocks,SANP,6,6,0,6,1,1,0,1,OTC
4432,11-02-2021 04:00,24 hrs.,RobinHoodPennyStocks,SGMD,6,6,0,6,1,1,0,1,OTC
4432,11-02-2021 04:00,24 hrs.,RobinHoodPennyStocks,SRMX,6,6,0,6,1,1,0,1,OTC
4432,11-02-2021 04:00,24 hrs.,RobinHoodPennyStocks,SUIC,6,6,0,6,1,1,0,1,OTC
4432,11-02-2021 04:00,24 hrs.,RobinHoodPennyStocks,TLSS,6,0,6,-6,1,1,0,1,OTC
4432,11-02-2021 04:00,24 hrs.,RobinHoodPennyStocks,TSNP,6,6,0,6,1,1,0,1,OTC
4432,11-02-2021 04:00,24 hrs.,RobinHoodPennyStocks,USMJ,6,6,0,6,1,1,0,1,OTC
4432,11-02-2021 04:00,24 hrs.,RobinHoodPennyStocks,BDRBF,398,386,12,374,11,119,116,11,OTC
4432,11-02-2021 04:00,24 hrs.,RobinHoodPennyStocks,FGPHF,6,6,0,6,1,0,2,1,OTC
4432,11-02-2021 04:00,24 hrs.,RobinHoodPennyStocks,FLWPF,6,6,0,6,1,1,0,1,OTC
4432,11-02-2021 04:00,24 hrs.,RobinHoodPennyStocks,IGCIW,6,6,0,6,1,1,0,1,OTC
4432,11-02-2021 04:00,24 hrs.,RobinHoodPennyStocks,JUVAF,6,6,0,6,1,1,0,1,OTC
4432,11-02-2021 04:00,24 hrs.,RobinHoodPennyStocks,MMNFF,6,6,0,6,1,1,0,1,OTC
4432,11-02-2021 04:00,24 hrs.,RobinHoodPennyStocks,NXTTF,14,0,14,-14,1,0,10,1,OTC
4432,11-02-2021 04:00,24 hrs.,RobinHoodPennyStocks,RYCEY,24,24,0,24,4,4,0,3,OTC
4432,11-02-2021 04:00,24 hrs.,RobinHoodPennyStocks,TAKOF,6,6,0,6,1,1,0,1,OTC
4432,11-02-2021 04:00,24 hrs.,RobinHoodPennyStocks,VRNDF,12,12,0,12,2,2,0,1,OTC
4432,11-02-2021 04:00,24 hrs.,RobinHoodPennyStocks,DNN,93,87,6,81,2,28,29,2,AMEX
4432,11-02-2021 04:00,24 hrs.,RobinHoodPennyStocks,GPL,6,6,0,6,1,1,0,1,AMEX
4432,11-02-2021 04:00,24 hrs.,RobinHoodPennyStocks,GSV,108,108,0,108,3,31,34,3,AMEX
4432,11-02-2021 04:00,24 hrs.,RobinHoodPennyStocks,GTE,1303,760,543,217,28,426,339,23,AMEX
4432,11-02-2021 04:00,24 hrs.,RobinHoodPennyStocks,ITP,37,0,37,-37,2,10,9,2,AMEX
4432,11-02-2021 04:00,24 hrs.,RobinHoodPennyStocks,NAK,209,179,30,149,16,52,41,13,AMEX
4432,11-02-2021 04:00,24 hrs.,RobinHoodPennyStocks,NBY,6,6,0,6,1,1,0,1,AMEX
4432,11-02-2021 04:00,24 hrs.,RobinHoodPennyStocks,PTN,15,15,0,15,1,4,3,1,AMEX
4432,11-02-2021 04:00,24 hrs.,RobinHoodPennyStocks,REI,5,5,0,5,1,0,1,1,AMEX
4432,11-02-2021 04:00,24 hrs.,RobinHoodPennyStocks,TRX,87,87,0,87,1,27,29,1,AMEX
4432,11-02-2021 04:00,24 hrs.,RobinHoodPennyStocks,ZOM,940,515,425,90,24,268,308,22,AMEX
4432,11-02-2021 04:00,24 hrs.,RobinHoodPennyStocks,AIRI,6,6,0,6,1,1,0,1,AMEX
4432,11-02-2021 04:00,24 hrs.,RobinHoodPennyStocks,AUMN,93,87,6,81,2,28,29,2,AMEX
4432,11-02-2021 04:00,24 hrs.,RobinHoodPennyStocks,CANF,31,31,0,31,1,11,5,1,AMEX
4432,11-02-2021 04:00,24 hrs.,RobinHoodPennyStocks,ENSV,6,0,6,-6,1,1,0,1,AMEX
4432,11-02-2021 04:00,24 hrs.,RobinHoodPennyStocks,GSAT,441,239,202,37,14,134,117,13,AMEX
4432,11-02-2021 04:00,24 hrs.,pennystocks,APHA,13,0,13,-13,2,2,1,2,NASDAQ
4432,11-02-2021 04:00,24 hrs.,pennystocks,APPS,7,7,0,7,1,1,1,1,NASDAQ
4432,11-02-2021 04:00,24 hrs.,pennystocks,ASRT,86,73,13,60,8,19,16,6,NASDAQ
4432,11-02-2021 04:00,24 hrs.,pennystocks,ASTC,58,0,58,-58,1,23,8,1,NASDAQ
4432,11-02-2021 04:00,24 hrs.,pennystocks,ATNF,6,6,0,6,1,1,0,1,NASDAQ
4432,11-02-2021 04:00,24 hrs.,pennystocks,ATOS,339,326,13,313,8,129,49,7,NASDAQ
4432,11-02-2021 04:00,24 hrs.,pennystocks,AVXL,36,36,0,36,1,13,6,1,NASDAQ
4432,11-02-2021 04:00,24 hrs.,pennystocks,BHTG,45,45,0,45,1,17,7,1,NASDAQ
4432,11-02-2021 04:00,24 hrs.,pennystocks,BLUE,6,6,0,6,1,1,0,1,NASDAQ
4432,11-02-2021 04:00,24 hrs.,pennystocks,BNGO,71,71,0,71,1,29,9,1,NASDAQ
4432,11-02-2021 04:00,24 hrs.,pennystocks,BPTH,78,71,7,64,5,22,14,4,NASDAQ
4432,11-02-2021 04:00,24 hrs.,pennystocks,BRQS,12,0,12,-12,1,2,4,1,NASDAQ
4432,11-02-2021 04:00,24 hrs.,pennystocks,BSQR,6,0,6,-6,1,1,0,1,NASDAQ
4432,11-02-2021 04:00,24 hrs.,pennystocks,BXRX,12,12,0,12,2,2,0,2,NASDAQ
4432,11-02-2021 04:00,24 hrs.,pennystocks,BYFC,8,8,0,8,1,1,2,1,NASDAQ
4432,11-02-2021 04:00,24 hrs.,pennystocks,CBAT,6,6,0,6,1,1,0,1,NASDAQ
4432,11-02-2021 04:00,24 hrs.,pennystocks,CGIX,107,57,50,7,7,33,13,6,NASDAQ
4432,11-02-2021 04:00,24 hrs.,pennystocks,CHEK,6,6,0,6,1,1,0,1,NASDAQ
4432,11-02-2021 04:00,24 hrs.,pennystocks,CIDM,6,6,0,6,1,1,0,1,NASDAQ
4432,11-02-2021 04:00,24 hrs.,pennystocks,CLNE,7,7,0,7,1,1,1,1,NASDAQ
4432,11-02-2021 04:00,24 hrs.,pennystocks,CNET,7,7,0,7,1,1,1,1,NASDAQ
4432,11-02-2021 04:00,24 hrs.,pennystocks,CRBP,119,0,119,-119,2,43,25,2,NASDAQ
4432,11-02-2021 04:00,24 hrs.,pennystocks,CRNT,12,12,0,12,2,2,0,1,NASDAQ
4432,11-02-2021 04:00,24 hrs.,pennystocks,CSTR,46,46,0,46,1,17,8,1,NASDAQ
4432,11-02-2021 04:00,24 hrs.,pennystocks,CTRM,122,44,78,-34,10,26,30,10,NASDAQ
4432,11-02-2021 04:00,24 hrs.,pennystocks,DKNG,6,6,0,6,1,1,0,1,NASDAQ
4432,11-02-2021 04:00,24 hrs.,pennystocks,BIO,6,6,0,6,1,1,0,1,NYSE
4432,11-02-2021 04:00,24 hrs.,pennystocks,CBD,733,310,423,-113,12,246,193,12,NYSE
4432,11-02-2021 04:00,24 hrs.,pennystocks,CBT,46,46,0,46,1,17,8,1,NYSE
4432,11-02-2021 04:00,24 hrs.,pennystocks,CNC,21,21,0,21,1,3,11,1,NYSE
4432,11-02-2021 04:00,24 hrs.,pennystocks,CTK,45,45,0,45,1,17,7,1,NYSE
4432,11-02-2021 04:00,24 hrs.,pennystocks,EFT,85,85,0,85,1,16,49,1,NYSE
4432,11-02-2021 04:00,24 hrs.,pennystocks,EXP,12,12,0,12,2,2,0,2,NYSE
4432,11-02-2021 04:00,24 hrs.,pennystocks,FLT,1863,1645,218,1427,7,843,149,6,NYSE
4432,11-02-2021 04:00,24 hrs.,pennystocks,FSR,7,0,7,-7,1,1,1,1,NYSE
4432,11-02-2021 04:00,24 hrs.,pennystocks,FUN,42,42,0,42,1,10,18,1,NYSE
4432,11-02-2021 04:00,24 hrs.,pennystocks,GME,1601,1589,12,1577,11,657,243,10,NYSE
4432,11-02-2021 04:00,24 hrs.,pennystocks,HGV,26,0,26,-26,1,8,6,1,NYSE
4432,11-02-2021 04:00,24 hrs.,pennystocks,IFF,6,6,0,6,1,1,0,1,NYSE
4432,11-02-2021 04:00,24 hrs.,pennystocks,LEA,30,0,30,-30,1,10,6,1,NYSE
4432,11-02-2021 04:00,24 hrs.,pennystocks,MTL,15,15,0,15,2,2,3,1,NYSE
4432,11-02-2021 04:00,24 hrs.,pennystocks,NGL,7,7,0,7,1,1,1,1,NYSE
4432,11-02-2021 04:00,24 hrs.,pennystocks,PDT,61,11,50,-39,3,14,21,3,NYSE
4432,11-02-2021 04:00,24 hrs.,pennystocks,PEI,31,31,0,31,2,5,13,2,NYSE
4432,11-02-2021 04:00,24 hrs.,pennystocks,PSA,187,6,181,-175,2,74,31,2,NYSE
4432,11-02-2021 04:00,24 hrs.,pennystocks,PVL,26,26,0,26,1,7,8,1,NYSE
4432,11-02-2021 04:00,24 hrs.,pennystocks,RTP,13,13,0,13,1,0,9,1,NYSE
4432,11-02-2021 04:00,24 hrs.,pennystocks,SOS,513,66,447,-381,4,213,71,4,NYSE
4432,11-02-2021 04:00,24 hrs.,pennystocks,TDA,44,29,15,14,2,4,28,2,NYSE
4432,11-02-2021 04:00,24 hrs.,pennystocks,THC,107,29,78,-49,3,29,37,3,NYSE
4432,11-02-2021 04:00,24 hrs.,pennystocks,UTF,58,58,0,58,1,22,10,1,NYSE
4432,11-02-2021 04:00,24 hrs.,pennystocks,WGO,6,6,0,6,1,1,0,1,NYSE
4432,11-02-2021 04:00,24 hrs.,pennystocks,XPO,12,0,12,-12,2,2,0,2,NYSE
4432,11-02-2021 04:00,24 hrs.,pennystocks,ALUS,10,0,10,-10,1,0,6,1,NYSE
4432,11-02-2021 04:00,24 hrs.,pennystocks,BORR,6,0,6,-6,1,1,0,1,NYSE
4432,11-02-2021 04:00,24 hrs.,pennystocks,FENG,6,0,6,-6,1,1,0,1,NYSE
4432,11-02-2021 04:00,24 hrs.,pennystocks,HEXO,12,12,0,12,2,2,0,2,NYSE
4432,11-02-2021 04:00,24 hrs.,pennystocks,LMND,54,0,54,-54,1,19,12,1,NYSE
4432,11-02-2021 04:00,24 hrs.,pennystocks,PLTR,54,0,54,-54,1,19,12,1,NYSE
4432,11-02-2021 04:00,24 hrs.,pennystocks,PROS,6,6,0,6,1,1,0,1,NYSE
4432,11-02-2021 04:00,24 hrs.,pennystocks,SAFE,6,6,0,6,1,1,0,1,NYSE
4432,11-02-2021 04:00,24 hrs.,pennystocks,SNPR,6,6,0,6,1,1,0,1,NYSE
4432,11-02-2021 04:00,24 hrs.,pennystocks,UBER,7,0,7,-7,1,1,1,1,NYSE
4432,11-02-2021 04:00,24 hrs.,pennystocks,WORK,46,46,0,46,1,17,8,1,NYSE
4432,11-02-2021 04:00,24 hrs.,RobinHoodPennyStocks,ADMA,120,120,0,120,3,41,26,3,NASDAQ
4432,11-02-2021 04:00,24 hrs.,RobinHoodPennyStocks,ADXS,24,18,6,12,4,4,0,2,NASDAQ
4432,11-02-2021 04:00,24 hrs.,RobinHoodPennyStocks,AEZS,57,45,12,33,6,11,11,6,NASDAQ
4432,11-02-2021 04:00,24 hrs.,RobinHoodPennyStocks,AGTC,2656,785,1871,-1086,22,963,642,21,NASDAQ
4432,11-02-2021 04:00,24 hrs.,RobinHoodPennyStocks,AKBA,66,0,66,-66,1,24,14,1,NASDAQ
4432,11-02-2021 04:00,24 hrs.,RobinHoodPennyStocks,APHA,130,104,26,78,5,33,44,5,NASDAQ
4432,11-02-2021 04:00,24 hrs.,RobinHoodPennyStocks,APRE,10,10,0,10,1,0,6,1,NASDAQ
4432,11-02-2021 04:00,24 hrs.,RobinHoodPennyStocks,ASRT,134,128,6,122,3,40,42,3,NASDAQ
4432,11-02-2021 04:00,24 hrs.,RobinHoodPennyStocks,ATNF,6,6,0,6,1,1,0,1,NASDAQ
4432,11-02-2021 04:00,24 hrs.,RobinHoodPennyStocks,ATOS,280,192,88,104,12,97,38,10,NASDAQ
4432,11-02-2021 04:00,24 hrs.,pennystocks,DTEA,13,13,0,13,2,2,1,1,NASDAQ
4432,11-02-2021 04:00,24 hrs.,pennystocks,DXYN,7,7,0,7,1,1,1,1,NASDAQ
4432,11-02-2021 04:00,24 hrs.,pennystocks,EAST,6,6,0,6,1,1,0,1,NASDAQ
4432,11-02-2021 04:00,24 hrs.,pennystocks,EDIT,76,76,0,76,1,24,24,1,NASDAQ
4432,11-02-2021 04:00,24 hrs.,pennystocks,ENVB,12,12,0,12,2,2,0,1,NASDAQ
4432,11-02-2021 04:00,24 hrs.,pennystocks,EVER,6,6,0,6,1,1,0,1,NASDAQ
4432,11-02-2021 04:00,24 hrs.,pennystocks,FAMI,51,51,0,51,2,18,7,2,NASDAQ
4432,11-02-2021 04:00,24 hrs.,pennystocks,FAST,42,42,0,42,1,10,18,1,NASDAQ
4432,11-02-2021 04:00,24 hrs.,pennystocks,FCEL,6,0,6,-6,1,1,0,1,NASDAQ
4432,11-02-2021 04:00,24 hrs.,pennystocks,FUTU,45,45,0,45,1,17,7,1,NASDAQ
4432,11-02-2021 04:00,24 hrs.,pennystocks,GAIN,21,21,0,21,1,6,5,1,NASDAQ
4432,11-02-2021 04:00,24 hrs.,pennystocks,GEVO,7,0,7,-7,1,0,3,1,NASDAQ
4432,11-02-2021 04:00,24 hrs.,pennystocks,GHSI,202,163,39,124,3,75,40,3,NASDAQ
4432,11-02-2021 04:00,24 hrs.,pennystocks,GLBS,12,12,0,12,1,3,2,1,NASDAQ
4432,11-02-2021 04:00,24 hrs.,pennystocks,GNUS,237,230,7,223,2,95,39,2,NASDAQ
4432,11-02-2021 04:00,24 hrs.,pennystocks,GOLD,6,6,0,6,1,1,0,1,NASDAQ
4432,11-02-2021 04:00,24 hrs.,pennystocks,GTEC,7,7,0,7,1,1,1,1,NASDAQ
4432,11-02-2021 04:00,24 hrs.,pennystocks,HALO,19,6,13,-7,3,3,1,3,NASDAQ
4432,11-02-2021 04:00,24 hrs.,pennystocks,HTBX,13,0,13,-13,2,2,1,2,NASDAQ
4432,11-02-2021 04:00,24 hrs.,pennystocks,IBKR,21,21,0,21,1,4,9,1,NASDAQ
4432,11-02-2021 04:00,24 hrs.,pennystocks,IMAC,7,7,0,7,1,1,1,1,NASDAQ
4432,11-02-2021 04:00,24 hrs.,pennystocks,IMMR,6,0,6,-6,1,1,0,1,NASDAQ
4432,11-02-2021 04:00,24 hrs.,pennystocks,INFI,25,25,0,25,1,8,5,1,NASDAQ
4432,11-02-2021 04:00,24 hrs.,pennystocks,ITRM,16,16,0,16,2,2,4,2,NASDAQ
4432,11-02-2021 04:00,24 hrs.,pennystocks,JAGX,12,6,6,0,2,2,0,2,NASDAQ
4432,11-02-2021 04:00,24 hrs.,pennystocks,KOPN,6,0,6,-6,1,1,0,1,NASDAQ
4432,11-02-2021 04:00,24 hrs.,pennystocks,KTRA,3772,196,3576,-3380,4,1716,324,4,NASDAQ
4432,11-02-2021 04:00,24 hrs.,pennystocks,LIVE,7,0,7,-7,1,1,1,1,NASDAQ
4432,11-02-2021 04:00,24 hrs.,pennystocks,LKCO,12,6,6,0,2,2,0,2,NASDAQ
4432,11-02-2021 04:00,24 hrs.,pennystocks,LPTH,6,6,0,6,1,1,0,1,NASDAQ
4432,11-02-2021 04:00,24 hrs.,pennystocks,LSTR,12,0,12,-12,2,2,0,2,NASDAQ
4432,11-02-2021 04:00,24 hrs.,pennystocks,MARK,7,0,7,-7,1,1,1,1,NASDAQ
4432,11-02-2021 04:00,24 hrs.,pennystocks,MBII,7,7,0,7,1,1,1,1,NASDAQ
4432,11-02-2021 04:00,24 hrs.,pennystocks,MBRX,6,6,0,6,1,1,0,1,NASDAQ
4432,11-02-2021 04:00,24 hrs.,pennystocks,MESA,14,0,14,-14,2,2,2,2,NASDAQ
4432,11-02-2021 04:00,24 hrs.,pennystocks,MMLP,6,6,0,6,1,1,0,1,NASDAQ
4432,11-02-2021 04:00,24 hrs.,pennystocks,MOTS,16,0,16,-16,1,3,6,1,NASDAQ
4432,11-02-2021 04:00,24 hrs.,pennystocks,MVIS,6,6,0,6,1,1,0,1,NASDAQ
4432,11-02-2021 04:00,24 hrs.,pennystocks,NAKD,249,186,63,123,15,60,69,14,NASDAQ
4432,11-02-2021 04:00,24 hrs.,pennystocks,NAOV,6,6,0,6,1,1,0,1,NASDAQ
4432,11-02-2021 04:00,24 hrs.,pennystocks,NCTY,45,45,0,45,1,17,7,1,NASDAQ
4432,11-02-2021 04:00,24 hrs.,pennystocks,NDRA,6,0,6,-6,1,1,0,1,NASDAQ
4432,11-02-2021 04:00,24 hrs.,pennystocks,NEOS,45,45,0,45,1,17,7,1,NASDAQ
4432,11-02-2021 04:00,24 hrs.,pennystocks,NMTR,22,22,0,22,2,6,2,2,NASDAQ
4432,11-02-2021 04:00,24 hrs.,pennystocks,NVCN,772,470,302,168,13,272,176,12,NASDAQ
4432,11-02-2021 04:00,24 hrs.,pennystocks,OCGN,75,26,49,-23,6,11,29,6,NASDAQ
4432,11-02-2021 04:00,24 hrs.,pennystocks,ONTX,18,6,12,-6,3,3,0,3,NASDAQ
4432,11-02-2021 04:00,24 hrs.,pennystocks,OPTT,37,0,37,-37,1,8,17,1,NASDAQ
4432,11-02-2021 04:00,24 hrs.,pennystocks,OXSQ,6,0,6,-6,1,1,0,1,NASDAQ
4432,11-02-2021 04:00,24 hrs.,pennystocks,PAVM,6,0,6,-6,1,1,0,1,NASDAQ
4432,11-02-2021 04:00,24 hrs.,pennystocks,PDSB,45,45,0,45,1,17,7,1,NASDAQ
4432,11-02-2021 04:00,24 hrs.,pennystocks,AMZN,152,152,0,152,1,35,78,1,NASDAQ
4432,11-02-2021 04:00,24 hrs.,pennystocks,ANCN,8,8,0,8,1,1,2,1,NASDAQ
4432,11-02-2021 04:00,24 hrs.,pennystocks,APDN,45,45,0,45,1,17,7,1,NASDAQ
4432,11-02-2021 04:00,24 hrs.,pennystocks,LLKKF,7,7,0,7,1,1,1,1,OTC
4432,11-02-2021 04:00,24 hrs.,pennystocks,LMNGF,6,6,0,6,1,1,0,1,OTC
4432,11-02-2021 04:00,24 hrs.,pennystocks,LTMCF,27,27,0,27,1,7,9,1,OTC
4432,11-02-2021 04:00,24 hrs.,pennystocks,LXXGF,31,25,6,19,2,9,5,2,OTC
4432,11-02-2021 04:00,24 hrs.,pennystocks,MBXBF,23,23,0,23,1,9,1,1,OTC
4432,11-02-2021 04:00,24 hrs.,pennystocks,MLLOF,6,0,6,-6,1,1,0,1,OTC
4432,11-02-2021 04:00,24 hrs.,pennystocks,MMNFF,73,61,12,49,3,14,33,3,OTC
4432,11-02-2021 04:00,24 hrs.,pennystocks,MNKKQ,6,6,0,6,1,1,0,1,OTC
4432,11-02-2021 04:00,24 hrs.,pennystocks,MNXXF,6,6,0,6,1,1,0,1,OTC
4432,11-02-2021 04:00,24 hrs.,pennystocks,NMGRF,3217,0,3217,-3217,2,1383,443,2,OTC
4432,11-02-2021 04:00,24 hrs.,pennystocks,PLAY,46,46,0,46,1,17,8,1,NASDAQ
4432,11-02-2021 04:00,24 hrs.,pennystocks,PLUS,151,151,0,151,3,63,13,2,NASDAQ
4432,11-02-2021 04:00,24 hrs.,pennystocks,POAI,23,23,0,23,1,8,3,1,NASDAQ
4432,11-02-2021 04:00,24 hrs.,pennystocks,PPBT,17,0,17,-17,1,6,1,1,NASDAQ
4432,11-02-2021 04:00,24 hrs.,pennystocks,PSTV,1549,1549,0,1549,7,607,307,3,NASDAQ
4432,11-02-2021 04:00,24 hrs.,pennystocks,PULM,18,18,0,18,3,2,2,2,NASDAQ
4432,11-02-2021 04:00,24 hrs.,pennystocks,RESN,86,86,0,86,1,30,22,1,NASDAQ
4432,11-02-2021 04:00,24 hrs.,pennystocks,RIGL,24,6,18,-12,4,4,0,2,NASDAQ
4432,11-02-2021 04:00,24 hrs.,pennystocks,RIOT,6,0,6,-6,1,1,0,1,NASDAQ
4432,11-02-2021 04:00,24 hrs.,pennystocks,RKDA,45,45,0,45,1,17,7,1,NASDAQ
4432,11-02-2021 04:00,24 hrs.,pennystocks,ROCK,6,6,0,6,1,1,0,1,NASDAQ
4432,11-02-2021 04:00,24 hrs.,pennystocks,SAVE,7,7,0,7,1,1,1,1,NASDAQ
4432,11-02-2021 04:00,24 hrs.,pennystocks,SELF,6,6,0,6,1,1,0,1,NASDAQ
4432,11-02-2021 04:00,24 hrs.,pennystocks,SHIP,13,13,0,13,2,2,1,1,NASDAQ
4432,11-02-2021 04:00,24 hrs.,pennystocks,SLRX,16,6,10,-4,2,3,2,2,NASDAQ
4432,11-02-2021 04:00,24 hrs.,pennystocks,SNCA,45,45,0,45,1,17,7,1,NASDAQ
4432,11-02-2021 04:00,24 hrs.,pennystocks,SNDL,515,400,115,285,75,91,33,61,NASDAQ
4432,11-02-2021 04:00,24 hrs.,pennystocks,STAF,66,48,18,30,3,18,18,3,NASDAQ
4432,11-02-2021 04:00,24 hrs.,pennystocks,STAY,6,6,0,6,1,1,0,1,NASDAQ
4432,11-02-2021 04:00,24 hrs.,pennystocks,SWBI,54,0,54,-54,1,19,12,1,NASDAQ
4432,11-02-2021 04:00,24 hrs.,pennystocks,SXTC,6,0,6,-6,1,1,0,1,NASDAQ
4432,11-02-2021 04:00,24 hrs.,pennystocks,TBLT,54,54,0,54,1,20,10,1,NASDAQ
4432,11-02-2021 04:00,24 hrs.,pennystocks,TEAM,6,6,0,6,1,1,0,1,NASDAQ
4432,11-02-2021 04:00,24 hrs.,pennystocks,TELL,19,13,6,7,3,3,1,3,NASDAQ
4432,11-02-2021 04:00,24 hrs.,pennystocks,THMO,54,0,54,-54,1,19,12,1,NASDAQ
4432,11-02-2021 04:00,24 hrs.,pennystocks,TIGR,6,0,6,-6,1,1,0,1,NASDAQ
4432,11-02-2021 04:00,24 hrs.,pennystocks,TLRY,70,51,19,32,5,21,8,5,NASDAQ
4432,11-02-2021 04:00,24 hrs.,pennystocks,TNXP,431,411,20,391,6,182,43,6,NASDAQ
4432,11-02-2021 04:00,24 hrs.,pennystocks,TRCH,135,128,7,121,9,33,33,9,NASDAQ
4432,11-02-2021 04:00,24 hrs.,pennystocks,TXMD,6,6,0,6,1,1,0,1,NASDAQ
4432,11-02-2021 04:00,24 hrs.,pennystocks,TYME,243,230,13,217,3,96,39,3,NASDAQ
4432,11-02-2021 04:00,24 hrs.,pennystocks,USWS,7,7,0,7,1,1,1,1,NASDAQ
4432,11-02-2021 04:00,24 hrs.,pennystocks,VBIV,6,0,6,-6,1,1,0,1,NASDAQ
4432,11-02-2021 04:00,24 hrs.,pennystocks,VIVE,6,6,0,6,1,1,0,1,NASDAQ
4432,11-02-2021 04:00,24 hrs.,pennystocks,VXRT,7,7,0,7,1,1,1,1,NASDAQ
4432,11-02-2021 04:00,24 hrs.,RobinHoodPennyStocks,MUX,6,6,0,6,1,1,0,1,NYSE
4432,11-02-2021 04:00,24 hrs.,RobinHoodPennyStocks,NBB,6,0,6,-6,1,1,0,1,NYSE
4432,11-02-2021 04:00,24 hrs.,RobinHoodPennyStocks,NGL,52,52,0,52,1,20,8,1,NYSE
4432,11-02-2021 04:00,24 hrs.,RobinHoodPennyStocks,PDT,6,0,6,-6,1,1,0,1,NYSE
4432,11-02-2021 04:00,24 hrs.,RobinHoodPennyStocks,PEI,77,0,77,-77,1,26,21,1,NYSE
4432,11-02-2021 04:00,24 hrs.,RobinHoodPennyStocks,SNE,14,14,0,14,1,3,4,1,NYSE
4432,11-02-2021 04:00,24 hrs.,RobinHoodPennyStocks,SOS,163,66,97,-31,4,62,23,4,NYSE
4432,11-02-2021 04:00,24 hrs.,RobinHoodPennyStocks,STG,6,6,0,6,1,1,0,1,NYSE
4432,11-02-2021 04:00,24 hrs.,RobinHoodPennyStocks,TWO,6,0,6,-6,1,1,0,1,NYSE
4432,11-02-2021 04:00,24 hrs.,RobinHoodPennyStocks,BORR,6,6,0,6,1,1,0,1,NYSE
4432,11-02-2021 04:00,24 hrs.,RobinHoodPennyStocks,HEXO,6,6,0,6,1,1,0,1,NYSE
4432,11-02-2021 04:00,24 hrs.,RobinHoodPennyStocks,SNPR,6,6,0,6,1,1,0,1,NYSE
4432,11-02-2021 04:00,24 hrs.,RobinHoodPennyStocks,WELL,6,6,0,6,1,1,0,1,NYSE
4432,11-02-2021 04:00,24 hrs.,RobinHoodPennyStocks,BBI,53,0,53,-53,1,17,15,1,NASDAQ
4432,11-02-2021 04:00,24 hrs.,RobinHoodPennyStocks,JFU,46,40,6,34,5,12,2,4,NASDAQ
4432,11-02-2021 04:00,24 hrs.,RobinHoodPennyStocks,OGI,26,20,6,14,3,5,4,3,NASDAQ
4432,11-02-2021 04:00,24 hrs.,RobinHoodPennyStocks,OLB,6,0,6,-6,1,1,0,1,NASDAQ
4432,11-02-2021 04:00,24 hrs.,RobinHoodPennyStocks,ACRX,71,18,53,-35,4,20,15,4,NASDAQ
4432,11-02-2021 04:00,24 hrs.,RobinHoodPennyStocks,ACST,12,6,6,0,2,2,0,2,NASDAQ
4432,11-02-2021 04:00,24 hrs.,pennystocks,ARMP,78,0,78,-78,1,27,20,1,AMEX
4432,11-02-2021 04:00,24 hrs.,pennystocks,ENSV,58,45,13,32,3,19,8,2,AMEX
4432,11-02-2021 04:00,24 hrs.,pennystocks,GSAT,157,139,18,121,8,44,37,7,AMEX
4432,11-02-2021 04:00,24 hrs.,pennystocks,INUV,6,0,6,-6,1,1,0,1,AMEX
4432,11-02-2021 04:00,24 hrs.,pennystocks,NSPR,74,40,34,6,3,19,24,3,AMEX
4432,11-02-2021 04:00,24 hrs.,pennystocks,OGEN,14,7,7,0,2,1,4,2,AMEX
4432,11-02-2021 04:00,24 hrs.,pennystocks,SENS,259,71,188,-117,3,104,39,3,AMEX
4432,11-02-2021 04:00,24 hrs.,pennystocks,TMBR,12,0,12,-12,2,2,0,1,AMEX
4432,11-02-2021 04:00,24 hrs.,pennystocks,UAMY,8,8,0,8,1,1,2,1,AMEX
4432,11-02-2021 04:00,24 hrs.,pennystocks,UAVS,45,45,0,45,1,17,7,1,AMEX
4432,11-02-2021 04:00,24 hrs.,RobinHoodPennyStocks,BIOL,44,32,12,20,3,5,22,3,NASDAQ
4432,11-02-2021 04:00,24 hrs.,RobinHoodPennyStocks,BOXL,7,0,7,-7,1,1,1,1,NASDAQ
4432,11-02-2021 04:00,24 hrs.,RobinHoodPennyStocks,BRQS,37,0,37,-37,1,12,9,1,NASDAQ
4432,11-02-2021 04:00,24 hrs.,RobinHoodPennyStocks,CBAT,8,8,0,8,1,0,4,1,NASDAQ
4432,11-02-2021 04:00,24 hrs.,RobinHoodPennyStocks,CDEV,6,6,0,6,1,1,0,1,NASDAQ
4432,11-02-2021 04:00,24 hrs.,RobinHoodPennyStocks,CGIX,39,33,6,27,2,7,17,2,NASDAQ
4432,11-02-2021 04:00,24 hrs.,RobinHoodPennyStocks,CIDM,116,6,110,-104,3,18,68,3,NASDAQ
4432,11-02-2021 04:00,24 hrs.,RobinHoodPennyStocks,CPRX,137,137,0,137,1,59,15,1,NASDAQ
4432,11-02-2021 04:00,24 hrs.,RobinHoodPennyStocks,CRBP,101,35,66,-31,3,31,27,3,NASDAQ
4432,11-02-2021 04:00,24 hrs.,RobinHoodPennyStocks,CTRM,198,130,68,62,14,52,38,14,NASDAQ
4432,11-02-2021 04:00,24 hrs.,RobinHoodPennyStocks,CYCN,18,18,0,18,3,3,0,2,NASDAQ
4432,11-02-2021 04:00,24 hrs.,RobinHoodPennyStocks,DTEA,42,42,0,42,2,14,6,1,NASDAQ
4432,11-02-2021 04:00,24 hrs.,RobinHoodPennyStocks,EAST,237,93,144,-51,6,71,71,6,NASDAQ
4432,11-02-2021 04:00,24 hrs.,RobinHoodPennyStocks,EDIT,120,87,33,54,2,21,70,2,NASDAQ
4432,11-02-2021 04:00,24 hrs.,RobinHoodPennyStocks,ENLV,6,0,6,-6,1,1,0,1,NASDAQ
4432,11-02-2021 04:00,24 hrs.,RobinHoodPennyStocks,ENVB,63,63,0,63,2,13,29,2,NASDAQ
4432,11-02-2021 04:00,24 hrs.,RobinHoodPennyStocks,EVFM,53,0,53,-53,1,17,15,1,NASDAQ
4432,11-02-2021 04:00,24 hrs.,RobinHoodPennyStocks,GAIN,6,6,0,6,1,1,0,1,NASDAQ
4432,11-02-2021 04:00,24 hrs.,RobinHoodPennyStocks,GHSI,66,66,0,66,4,22,6,4,NASDAQ
4432,11-02-2021 04:00,24 hrs.,RobinHoodPennyStocks,HEPA,6,6,0,6,1,1,0,1,NASDAQ
4432,11-02-2021 04:00,24 hrs.,RobinHoodPennyStocks,HTBX,6,0,6,-6,1,1,0,1,NASDAQ
4432,11-02-2021 04:00,24 hrs.,RobinHoodPennyStocks,HUSN,6,6,0,6,1,1,0,1,NASDAQ
4432,11-02-2021 04:00,24 hrs.,RobinHoodPennyStocks,ITRM,47,35,12,23,6,8,7,5,NASDAQ
4432,11-02-2021 04:00,24 hrs.,RobinHoodPennyStocks,KALV,87,87,0,87,1,15,53,1,NASDAQ
4432,11-02-2021 04:00,24 hrs.,RobinHoodPennyStocks,KIDS,71,0,71,-71,1,27,13,1,NASDAQ
4432,11-02-2021 04:00,24 hrs.,RobinHoodPennyStocks,KTRA,68,6,62,-56,5,14,20,5,NASDAQ
4432,11-02-2021 04:00,24 hrs.,RobinHoodPennyStocks,LAND,6,0,6,-6,1,1,0,1,NASDAQ
4432,11-02-2021 04:00,24 hrs.,RobinHoodPennyStocks,LIFE,6,6,0,6,1,1,0,1,NASDAQ
4432,11-02-2021 04:00,24 hrs.,RobinHoodPennyStocks,LKCO,14,8,6,2,2,2,2,2,NASDAQ
4432,11-02-2021 04:00,24 hrs.,RobinHoodPennyStocks,LLNW,6,6,0,6,1,1,0,1,NASDAQ
4432,11-02-2021 04:00,24 hrs.,RobinHoodPennyStocks,MITO,6,0,6,-6,1,1,0,1,NASDAQ
4432,11-02-2021 04:00,24 hrs.,RobinHoodPennyStocks,MOTS,7,7,0,7,1,1,1,1,NASDAQ
4432,11-02-2021 04:00,24 hrs.,RobinHoodPennyStocks,NAKD,6,6,0,6,1,1,0,1,NASDAQ
4432,11-02-2021 04:00,24 hrs.,RobinHoodPennyStocks,NAOV,14,14,0,14,1,5,0,1,NASDAQ
4432,11-02-2021 04:00,24 hrs.,RobinHoodPennyStocks,NEOS,33,27,6,21,2,9,7,2,NASDAQ
4432,11-02-2021 04:00,24 hrs.,RobinHoodPennyStocks,NMTR,59,0,59,-59,2,18,15,2,NASDAQ
4432,11-02-2021 04:00,24 hrs.,RobinHoodPennyStocks,NOVN,52,52,0,52,3,11,18,3,NASDAQ
4432,11-02-2021 04:00,24 hrs.,RobinHoodPennyStocks,NVCN,180,61,119,-58,6,38,80,6,NASDAQ
4432,11-02-2021 04:00,24 hrs.,RobinHoodPennyStocks,NXTD,6,6,0,6,1,1,0,1,NASDAQ
4432,11-02-2021 04:00,24 hrs.,RobinHoodPennyStocks,OCGN,61,30,31,-1,10,10,1,9,NASDAQ
4432,11-02-2021 04:00,24 hrs.,RobinHoodPennyStocks,ONTX,132,24,108,-84,6,21,66,6,NASDAQ
4432,11-02-2021 04:00,24 hrs.,RobinHoodPennyStocks,OPGN,12,6,6,0,2,2,0,2,NASDAQ
4432,11-02-2021 04:00,24 hrs.,RobinHoodPennyStocks,OTLK,45,0,45,-45,1,14,13,1,NASDAQ
4432,11-02-2021 04:00,24 hrs.,RobinHoodPennyStocks,PLAY,6,6,0,6,1,1,0,1,NASDAQ
4432,11-02-2021 04:00,24 hrs.,RobinHoodPennyStocks,PLUS,873,873,0,873,1,362,145,1,NASDAQ
4432,11-02-2021 04:00,24 hrs.,RobinHoodPennyStocks,PRQR,53,0,53,-53,1,17,15,1,NASDAQ
4432,11-02-2021 04:00,24 hrs.,RobinHoodPennyStocks,PSTV,1233,1233,0,1233,4,419,379,4,NASDAQ
4432,11-02-2021 04:00,24 hrs.,RobinHoodPennyStocks,PULM,96,18,78,-60,3,32,20,2,NASDAQ
4432,11-02-2021 04:00,24 hrs.,RobinHoodPennyStocks,QCOM,6,0,6,-6,1,1,0,1,NASDAQ
4432,11-02-2021 04:00,24 hrs.,pennystocks,KHRIF,47,0,47,-47,1,16,11,1,OTC
4432,11-02-2021 04:00,24 hrs.,pennystocks,KHRNF,6,0,6,-6,1,1,0,1,OTC
4432,11-02-2021 04:00,24 hrs.,pennystocks,LIACF,12,0,12,-12,2,2,0,2,OTC
4432,11-02-2021 04:00,24 hrs.,pennystocks,LITOF,47,0,47,-47,1,18,7,1,OTC
4432,11-02-2021 04:00,24 hrs.,pennystocks,LKYSF,65,65,0,65,1,24,13,1,OTC
4432,11-02-2021 04:00,24 hrs.,pennystocks,XXII,6,6,0,6,1,1,0,1,AMEX
4432,11-02-2021 04:00,24 hrs.,pennystocks,YCBD,58,58,0,58,1,22,10,1,AMEX
4432,11-02-2021 04:00,24 hrs.,pennystocks,ACB,7,0,7,-7,1,1,1,1,NYSE
4432,11-02-2021 04:00,24 hrs.,pennystocks,ACH,32,32,0,32,1,7,14,1,NYSE
4432,11-02-2021 04:00,24 hrs.,pennystocks,AFI,7,7,0,7,1,1,1,1,NYSE
4432,11-02-2021 04:00,24 hrs.,pennystocks,AHT,7,0,7,-7,1,1,1,1,NYSE
4432,11-02-2021 04:00,24 hrs.,pennystocks,AMC,113,113,0,113,8,25,31,8,NYSE
4432,11-02-2021 04:00,24 hrs.,pennystocks,ASA,6,0,6,-6,1,1,0,1,NYSE
4432,11-02-2021 04:00,24 hrs.,pennystocks,ATH,84,84,0,84,1,19,42,1,NYSE
4432,11-02-2021 04:00,24 hrs.,pennystocks,BHP,76,76,0,76,1,24,24,1,NYSE
4432,11-02-2021 04:00,24 hrs.,pennystocks,NMTLF,893,0,893,-893,1,345,199,1,OTC
4432,11-02-2021 04:00,24 hrs.,pennystocks,NSRCF,82,82,0,82,2,25,24,2,OTC
4432,11-02-2021 04:00,24 hrs.,pennystocks,NXGWF,12,12,0,12,1,2,4,1,OTC
4432,11-02-2021 04:00,24 hrs.,pennystocks,NXTFF,4,4,0,4,1,0,0,1,OTC
4432,11-02-2021 04:00,24 hrs.,pennystocks,NXTTF,125,53,72,-19,21,20,1,3,OTC
4432,11-02-2021 04:00,24 hrs.,pennystocks,OTIVF,7,0,7,-7,1,1,1,1,OTC
4432,11-02-2021 04:00,24 hrs.,pennystocks,PFFOF,76,76,0,76,1,24,24,1,OTC
4432,11-02-2021 04:00,24 hrs.,pennystocks,PLCKF,45,0,45,-45,1,15,11,1,OTC
4432,11-02-2021 04:00,24 hrs.,pennystocks,PLUUF,6,0,6,-6,1,1,0,1,OTC
4432,11-02-2021 04:00,24 hrs.,pennystocks,PTNYF,6,6,0,6,1,1,0,1,OTC
4432,11-02-2021 04:00,24 hrs.,pennystocks,PTOTF,22,0,22,-22,1,6,6,1,OTC
4432,11-02-2021 04:00,24 hrs.,pennystocks,PWRMF,7,7,0,7,1,1,1,1,OTC
4432,11-02-2021 04:00,24 hrs.,pennystocks,QNCCF,7,7,0,7,1,1,1,1,OTC
4432,11-02-2021 04:00,24 hrs.,pennystocks,QYOUF,6,6,0,6,1,1,0,1,OTC
4432,11-02-2021 04:00,24 hrs.,pennystocks,RAZFF,76,0,76,-76,2,20,28,2,OTC
4432,11-02-2021 04:00,24 hrs.,pennystocks,RCPIQ,8,8,0,8,1,1,2,1,OTC
4432,11-02-2021 04:00,24 hrs.,pennystocks,REZZF,76,76,0,76,1,24,24,1,OTC
4432,11-02-2021 04:00,24 hrs.,pennystocks,RHCCF,6,6,0,6,1,1,0,1,OTC
4432,11-02-2021 04:00,24 hrs.,pennystocks,RLFTF,6,0,6,-6,1,1,0,1,OTC
4432,11-02-2021 04:00,24 hrs.,pennystocks,RWBYF,14,14,0,14,1,2,6,1,OTC
4432,11-02-2021 04:00,24 hrs.,pennystocks,RYCEY,6,6,0,6,1,1,0,1,OTC
4432,11-02-2021 04:00,24 hrs.,pennystocks,SHRMF,7,0,7,-7,1,1,1,1,OTC
4432,11-02-2021 04:00,24 hrs.,pennystocks,SPRWF,755,742,13,729,8,283,157,7,OTC
4432,11-02-2021 04:00,24 hrs.,pennystocks,TAKOF,326,67,259,-192,4,111,88,4,OTC
4432,11-02-2021 04:00,24 hrs.,pennystocks,TGIFF,98,91,7,84,3,32,22,3,OTC
4432,11-02-2021 04:00,24 hrs.,pennystocks,TGODF,71,71,0,71,3,14,31,3,OTC
4432,11-02-2021 04:00,24 hrs.,pennystocks,TLOFF,40,33,7,26,4,6,12,4,OTC
4432,11-02-2021 04:00,24 hrs.,pennystocks,TOBAF,54,0,54,-54,3,20,2,1,OTC
4432,11-02-2021 04:00,24 hrs.,pennystocks,TSCRF,42,42,0,42,1,14,10,1,OTC
4432,11-02-2021 04:00,24 hrs.,pennystocks,UCCPF,18,18,0,18,1,6,2,1,OTC
4432,11-02-2021 04:00,24 hrs.,pennystocks,VRNDF,6,6,0,6,1,1,0,1,OTC
4432,11-02-2021 04:00,24 hrs.,pennystocks,VULNF,6,6,0,6,1,1,0,1,OTC
4432,11-02-2021 04:00,24 hrs.,pennystocks,WDDMF,43,0,43,-43,2,12,11,2,OTC
4432,11-02-2021 04:00,24 hrs.,pennystocks,WHGOF,6,6,0,6,1,1,0,1,OTC
4432,11-02-2021 04:00,24 hrs.,pennystocks,ZBISF,12,12,0,12,2,2,0,2,OTC
4432,11-02-2021 04:00,24 hrs.,pennystocks,ZOEIF,6,6,0,6,1,1,0,1,OTC
4432,11-02-2021 04:00,24 hrs.,pennystocks,AIM,19,0,19,-19,3,3,1,2,AMEX
4432,11-02-2021 04:00,24 hrs.,pennystocks,BGI,45,45,0,45,1,17,7,1,AMEX
4432,11-02-2021 04:00,24 hrs.,pennystocks,DPW,54,0,54,-54,1,19,12,1,AMEX
4432,11-02-2021 04:00,24 hrs.,pennystocks,GPL,6,6,0,6,1,1,0,1,AMEX
4432,11-02-2021 04:00,24 hrs.,pennystocks,GTE,493,415,78,337,12,172,101,12,AMEX
4432,11-02-2021 04:00,24 hrs.,pennystocks,ITP,213,0,213,-213,3,74,53,3,AMEX
4432,11-02-2021 04:00,24 hrs.,pennystocks,LNG,6,0,6,-6,1,1,0,1,AMEX
4432,11-02-2021 04:00,24 hrs.,pennystocks,MCF,8,0,8,-8,1,1,2,1,AMEX
4432,11-02-2021 04:00,24 hrs.,pennystocks,NAK,41,34,7,27,6,6,5,6,AMEX
4432,11-02-2021 04:00,24 hrs.,pennystocks,NHS,6,6,0,6,1,1,0,1,AMEX
4432,11-02-2021 04:00,24 hrs.,pennystocks,PLG,7,7,0,7,1,0,3,1,AMEX
4432,11-02-2021 04:00,24 hrs.,pennystocks,PLX,7,0,7,-7,1,1,1,1,AMEX
4432,11-02-2021 04:00,24 hrs.,pennystocks,REI,22,14,8,6,2,5,4,2,AMEX
4432,11-02-2021 04:00,24 hrs.,pennystocks,RHE,45,45,0,45,1,17,7,1,AMEX
4432,11-02-2021 04:00,24 hrs.,pennystocks,TGC,45,45,0,45,1,17,7,1,AMEX
4432,11-02-2021 04:00,24 hrs.,pennystocks,TRX,13,0,13,-13,2,2,1,2,AMEX
4432,11-02-2021 04:00,24 hrs.,pennystocks,WTT,172,0,172,-172,1,64,40,1,AMEX
4432,11-02-2021 04:00,24 hrs.,pennystocks,ZOM,73,61,12,49,4,17,23,3,AMEX
4390,10-02-2021 20:00,24 hrs.,pennystocks,HCMC,571,27,544,-517,7,192,159,6,OTC
4390,10-02-2021 20:00,24 hrs.,pennystocks,HPIL,12,12,0,12,2,2,0,1,OTC
4390,10-02-2021 20:00,24 hrs.,pennystocks,HYII,6,6,0,6,1,1,0,1,OTC
4390,10-02-2021 20:00,24 hrs.,pennystocks,RIOT,6,6,0,6,1,1,0,1,NASDAQ
4390,10-02-2021 20:00,24 hrs.,pennystocks,SLRX,10,10,0,10,1,2,2,1,NASDAQ
4390,10-02-2021 20:00,24 hrs.,pennystocks,SNDL,69,51,18,33,11,11,3,8,NASDAQ
4390,10-02-2021 20:00,24 hrs.,pennystocks,SWBI,50,50,0,50,1,17,12,1,NASDAQ
4390,10-02-2021 20:00,24 hrs.,pennystocks,TELL,6,0,6,-6,1,1,0,1,NASDAQ
4390,10-02-2021 20:00,24 hrs.,pennystocks,THMO,50,50,0,50,1,17,12,1,NASDAQ
4390,10-02-2021 20:00,24 hrs.,pennystocks,TIGR,6,6,0,6,1,1,0,1,NASDAQ
4390,10-02-2021 20:00,24 hrs.,pennystocks,TLRY,13,13,0,13,2,2,1,2,NASDAQ
4390,10-02-2021 20:00,24 hrs.,pennystocks,TNXP,13,13,0,13,2,2,1,2,NASDAQ
4390,10-02-2021 20:00,24 hrs.,pennystocks,TYME,6,0,6,-6,1,1,0,1,NASDAQ
4390,10-02-2021 20:00,24 hrs.,pennystocks,VBIV,6,6,0,6,1,1,0,1,NASDAQ
4390,10-02-2021 20:00,24 hrs.,pennystocks,WIRE,50,50,0,50,1,17,12,1,NASDAQ
4390,10-02-2021 20:00,24 hrs.,pennystocks,XONE,6,6,0,6,1,1,0,1,NASDAQ
4390,10-02-2021 20:00,24 hrs.,pennystocks,XSPA,23,17,6,11,4,3,1,3,NASDAQ
4390,10-02-2021 20:00,24 hrs.,pennystocks,ZSAN,37,31,6,25,6,6,1,5,NASDAQ
4390,10-02-2021 20:00,24 hrs.,pennystocks,AGTC,6,6,0,6,1,1,0,1,NASDAQ
4390,10-02-2021 20:00,24 hrs.,pennystocks,AKBA,182,0,182,-182,2,79,16,2,NASDAQ
4390,10-02-2021 20:00,24 hrs.,pennystocks,AMTX,7,0,7,-7,1,1,1,1,NASDAQ
4390,10-02-2021 20:00,24 hrs.,pennystocks,APHA,7,7,0,7,1,1,1,1,NASDAQ
4390,10-02-2021 20:00,24 hrs.,pennystocks,ASRT,13,13,0,13,2,2,1,2,NASDAQ
4390,10-02-2021 20:00,24 hrs.,pennystocks,ASTC,58,58,0,58,1,23,8,1,NASDAQ
4390,10-02-2021 20:00,24 hrs.,pennystocks,ATOS,13,13,0,13,2,2,1,1,NASDAQ
4390,10-02-2021 20:00,24 hrs.,pennystocks,BOXL,7,0,7,-7,1,1,1,1,NASDAQ
4390,10-02-2021 20:00,24 hrs.,pennystocks,BRPA,4,0,4,-4,1,0,0,1,NASDAQ
4390,10-02-2021 20:00,24 hrs.,pennystocks,BRQS,10,10,0,10,1,1,4,1,NASDAQ
4390,10-02-2021 20:00,24 hrs.,pennystocks,CIDM,7,0,7,-7,1,1,1,1,NASDAQ
4390,10-02-2021 20:00,24 hrs.,pennystocks,CRBP,50,50,0,50,1,17,12,1,NASDAQ
4390,10-02-2021 20:00,24 hrs.,pennystocks,CTRM,26,0,26,-26,2,6,6,2,NASDAQ
4390,10-02-2021 20:00,24 hrs.,pennystocks,FCEL,6,0,6,-6,1,1,0,1,NASDAQ
4390,10-02-2021 20:00,24 hrs.,pennystocks,GHSI,7,7,0,7,1,1,1,1,NASDAQ
4390,10-02-2021 20:00,24 hrs.,pennystocks,GNUS,7,7,0,7,1,1,1,1,NASDAQ
4390,10-02-2021 20:00,24 hrs.,pennystocks,HALO,13,13,0,13,2,2,1,2,NASDAQ
4390,10-02-2021 20:00,24 hrs.,pennystocks,HTBX,7,7,0,7,1,1,1,1,NASDAQ
4390,10-02-2021 20:00,24 hrs.,pennystocks,KTRA,21,7,14,-7,2,1,11,2,NASDAQ
4390,10-02-2021 20:00,24 hrs.,pennystocks,LIVE,7,7,0,7,1,1,1,1,NASDAQ
4390,10-02-2021 20:00,24 hrs.,pennystocks,MARK,7,0,7,-7,1,1,1,1,NASDAQ
4390,10-02-2021 20:00,24 hrs.,pennystocks,MOTS,18,18,0,18,1,4,6,1,NASDAQ
4390,10-02-2021 20:00,24 hrs.,pennystocks,NAKD,59,59,0,59,1,20,15,1,NASDAQ
4390,10-02-2021 20:00,24 hrs.,pennystocks,NBRV,6,0,6,-6,1,1,0,1,NASDAQ
4390,10-02-2021 20:00,24 hrs.,pennystocks,NDRA,6,6,0,6,1,1,0,1,NASDAQ
4390,10-02-2021 20:00,24 hrs.,pennystocks,NOVN,7,0,7,-7,1,1,1,1,NASDAQ
4390,10-02-2021 20:00,24 hrs.,pennystocks,NVCN,16,6,10,-4,2,2,4,2,NASDAQ
4390,10-02-2021 20:00,24 hrs.,pennystocks,OCGN,12,12,0,12,2,2,0,2,NASDAQ
4390,10-02-2021 20:00,24 hrs.,pennystocks,ONTX,6,6,0,6,1,1,0,1,NASDAQ
4390,10-02-2021 20:00,24 hrs.,pennystocks,OPTT,35,0,35,-35,1,7,17,1,NASDAQ
4390,10-02-2021 20:00,24 hrs.,pennystocks,PAVM,6,0,6,-6,1,1,0,1,NASDAQ
4390,10-02-2021 20:00,24 hrs.,pennystocks,QIWI,7,0,7,-7,1,1,1,1,NASDAQ
4390,10-02-2021 20:00,24 hrs.,pennystocks,RIGL,6,6,0,6,1,1,0,1,NASDAQ
4390,10-02-2021 20:00,24 hrs.,pennystocks,WDLF,7,7,0,7,1,1,1,1,OTC
4390,10-02-2021 20:00,24 hrs.,pennystocks,WHEN,1909,0,1909,-1909,1,878,149,1,OTC
4390,10-02-2021 20:00,24 hrs.,pennystocks,WNCP,6,6,0,6,1,1,0,1,OTC
4390,10-02-2021 20:00,24 hrs.,pennystocks,WSTL,7,7,0,7,1,1,1,1,OTC
4390,10-02-2021 20:00,24 hrs.,pennystocks,ABEPF,25,25,0,25,4,4,1,3,OTC
4390,10-02-2021 20:00,24 hrs.,pennystocks,ACRHF,6,6,0,6,1,1,0,1,OTC
4390,10-02-2021 20:00,24 hrs.,pennystocks,AGEEF,6,6,0,6,1,1,0,1,OTC
4390,10-02-2021 20:00,24 hrs.,pennystocks,AMYZF,8,8,0,8,1,1,2,1,OTC
4390,10-02-2021 20:00,24 hrs.,pennystocks,ATURF,20,20,0,20,2,4,4,1,OTC
4390,10-02-2021 20:00,24 hrs.,pennystocks,BBKCF,6,6,0,6,1,1,0,1,OTC
4390,10-02-2021 20:00,24 hrs.,pennystocks,BUROF,6,0,6,-6,1,1,0,1,OTC
4390,10-02-2021 20:00,24 hrs.,pennystocks,DIGAF,18,12,6,6,3,3,0,3,OTC
4390,10-02-2021 20:00,24 hrs.,pennystocks,FFLWF,6,0,6,-6,1,1,0,1,OTC
4390,10-02-2021 20:00,24 hrs.,pennystocks,FLOOF,7,0,7,-7,1,1,1,1,OTC
4390,10-02-2021 20:00,24 hrs.,pennystocks,GCPEF,15,15,0,15,1,2,7,1,OTC
4390,10-02-2021 20:00,24 hrs.,pennystocks,HITIF,522,20,502,-482,5,204,94,5,OTC
4390,10-02-2021 20:00,24 hrs.,pennystocks,ICNAF,6,0,6,-6,1,1,0,1,OTC
4390,10-02-2021 20:00,24 hrs.,pennystocks,LIACF,12,0,12,-12,2,2,0,2,OTC
4390,10-02-2021 20:00,24 hrs.,pennystocks,LXXGF,6,6,0,6,1,1,0,1,OTC
4390,10-02-2021 20:00,24 hrs.,pennystocks,MLLOF,6,0,6,-6,1,1,0,1,OTC
4390,10-02-2021 20:00,24 hrs.,pennystocks,MMNFF,12,6,6,0,2,2,0,2,OTC
4390,10-02-2021 20:00,24 hrs.,pennystocks,NMGRF,2560,2560,0,2560,2,1104,344,2,OTC
4390,10-02-2021 20:00,24 hrs.,pennystocks,OTIVF,7,7,0,7,1,1,1,1,OTC
4390,10-02-2021 20:00,24 hrs.,pennystocks,PLUUF,6,0,6,-6,1,1,0,1,OTC
4390,10-02-2021 20:00,24 hrs.,pennystocks,RLFTF,10,6,4,2,2,1,0,2,OTC
4390,10-02-2021 20:00,24 hrs.,pennystocks,SPRWF,6,6,0,6,1,1,0,1,OTC
4390,10-02-2021 20:00,24 hrs.,pennystocks,TAKOF,208,208,0,208,1,77,50,1,OTC
4390,10-02-2021 20:00,24 hrs.,pennystocks,TLOFF,7,7,0,7,1,1,1,1,OTC
4390,10-02-2021 20:00,24 hrs.,pennystocks,TNYBF,14,0,14,-14,1,4,2,1,OTC
4390,10-02-2021 20:00,24 hrs.,pennystocks,WDDMF,6,6,0,6,1,1,0,1,OTC
4390,10-02-2021 20:00,24 hrs.,pennystocks,AIM,7,7,0,7,1,1,1,1,AMEX
4390,10-02-2021 20:00,24 hrs.,pennystocks,ABML,6,0,6,-6,1,1,0,1,OTC
4390,10-02-2021 20:00,24 hrs.,pennystocks,AFOM,6,6,0,6,1,1,0,1,OTC
4390,10-02-2021 20:00,24 hrs.,pennystocks,ALKM,6,6,0,6,1,1,0,1,OTC
4390,10-02-2021 20:00,24 hrs.,pennystocks,ALYI,6,0,6,-6,1,1,0,1,OTC
4390,10-02-2021 20:00,24 hrs.,pennystocks,ASTI,12,6,6,0,2,2,0,2,OTC
4390,10-02-2021 20:00,24 hrs.,pennystocks,BBRW,6,6,0,6,1,1,0,1,OTC
4390,10-02-2021 20:00,24 hrs.,pennystocks,BFCH,6,6,0,6,1,1,0,1,OTC
4390,10-02-2021 20:00,24 hrs.,pennystocks,BIGG,6,6,0,6,1,1,0,1,OTC
4390,10-02-2021 20:00,24 hrs.,pennystocks,BLDV,209,0,209,-209,1,90,25,1,OTC
4390,10-02-2021 20:00,24 hrs.,pennystocks,BLUU,7,7,0,7,1,1,1,1,OTC
4390,10-02-2021 20:00,24 hrs.,pennystocks,BMIX,6,0,6,-6,1,1,0,1,OTC
4390,10-02-2021 20:00,24 hrs.,pennystocks,BOTY,6,6,0,6,1,0,2,1,OTC
4390,10-02-2021 20:00,24 hrs.,pennystocks,BRAV,6,6,0,6,1,1,0,1,OTC
4390,10-02-2021 20:00,24 hrs.,pennystocks,BTSC,6,6,0,6,1,1,0,1,OTC
4390,10-02-2021 20:00,24 hrs.,pennystocks,CANN,6,0,6,-6,1,1,0,1,OTC
4390,10-02-2021 20:00,24 hrs.,pennystocks,CBDL,328,321,7,314,3,107,102,3,OTC
4390,10-02-2021 20:00,24 hrs.,pennystocks,CBTC,6,6,0,6,1,1,0,1,OTC
4390,10-02-2021 20:00,24 hrs.,pennystocks,CCTL,6,6,0,6,1,1,0,1,OTC
4390,10-02-2021 20:00,24 hrs.,pennystocks,CHUC,12,12,0,12,2,2,0,1,OTC
4390,10-02-2021 20:00,24 hrs.,pennystocks,CLWD,7,7,0,7,1,1,1,1,OTC
4390,10-02-2021 20:00,24 hrs.,pennystocks,CVAT,70,70,0,70,1,28,10,1,OTC
4390,10-02-2021 20:00,24 hrs.,pennystocks,DPLS,7,7,0,7,1,1,1,1,OTC
4390,10-02-2021 20:00,24 hrs.,pennystocks,DSGT,6,6,0,6,1,1,0,1,OTC
4390,10-02-2021 20:00,24 hrs.,pennystocks,ECCE,14,0,14,-14,1,4,2,1,OTC
4390,10-02-2021 20:00,24 hrs.,pennystocks,ECCI,10,0,10,-10,1,2,2,1,OTC
4390,10-02-2021 20:00,24 hrs.,pennystocks,ECOS,6,0,6,-6,1,1,0,1,OTC
4390,10-02-2021 20:00,24 hrs.,pennystocks,EKWX,10,0,10,-10,1,1,4,1,OTC
4390,10-02-2021 20:00,24 hrs.,pennystocks,ETFM,357,140,217,-77,2,111,127,2,OTC
4390,10-02-2021 20:00,24 hrs.,pennystocks,FHBC,6,0,6,-6,1,1,0,1,OTC
4390,10-02-2021 20:00,24 hrs.,pennystocks,GAXY,25,13,12,1,3,5,3,2,OTC
4390,10-02-2021 20:00,24 hrs.,pennystocks,GCEH,7,0,7,-7,1,1,1,1,OTC
4390,10-02-2021 20:00,24 hrs.,pennystocks,GRNH,12,12,0,12,1,2,4,1,OTC
4390,10-02-2021 20:00,24 hrs.,pennystocks,GTEH,18,18,0,18,3,3,0,2,OTC
4390,10-02-2021 20:00,24 hrs.,pennystocks,DPW,50,50,0,50,1,17,12,1,AMEX
4390,10-02-2021 20:00,24 hrs.,pennystocks,GTE,6,6,0,6,1,1,0,1,AMEX
4390,10-02-2021 20:00,24 hrs.,pennystocks,ITP,123,123,0,123,2,35,45,2,AMEX
4390,10-02-2021 20:00,24 hrs.,pennystocks,LNG,6,0,6,-6,1,1,0,1,AMEX
4390,10-02-2021 20:00,24 hrs.,pennystocks,TRX,7,7,0,7,1,1,1,1,AMEX
4390,10-02-2021 20:00,24 hrs.,pennystocks,ZOM,12,6,6,0,2,2,0,2,AMEX
4390,10-02-2021 20:00,24 hrs.,pennystocks,ENSV,13,0,13,-13,2,2,1,1,AMEX
4390,10-02-2021 20:00,24 hrs.,pennystocks,GSAT,18,6,12,-6,3,3,0,3,AMEX
4390,10-02-2021 20:00,24 hrs.,pennystocks,OGEN,7,7,0,7,1,1,1,1,AMEX
4390,10-02-2021 20:00,24 hrs.,pennystocks,SENS,173,153,20,133,2,68,29,2,AMEX
4390,10-02-2021 20:00,24 hrs.,pennystocks,ACB,7,7,0,7,1,1,1,1,NYSE
4390,10-02-2021 20:00,24 hrs.,pennystocks,ASA,6,0,6,-6,1,1,0,1,NYSE
4390,10-02-2021 20:00,24 hrs.,pennystocks,CBD,327,327,0,327,3,107,101,3,NYSE
4390,10-02-2021 20:00,24 hrs.,pennystocks,FSR,7,7,0,7,1,1,1,1,NYSE
4390,10-02-2021 20:00,24 hrs.,pennystocks,GME,6,0,6,-6,1,1,0,1,NYSE
4390,10-02-2021 20:00,24 hrs.,pennystocks,PDT,46,31,15,16,2,9,20,2,NYSE
4390,10-02-2021 20:00,24 hrs.,pennystocks,PEI,6,0,6,-6,1,1,0,1,NYSE
4390,10-02-2021 20:00,24 hrs.,pennystocks,PPR,17,0,17,-17,1,6,1,1,NYSE
4390,10-02-2021 20:00,24 hrs.,pennystocks,PSA,181,181,0,181,1,73,31,1,NYSE
4390,10-02-2021 20:00,24 hrs.,pennystocks,TDA,15,0,15,-15,1,0,11,1,NYSE
4390,10-02-2021 20:00,24 hrs.,pennystocks,FENG,6,6,0,6,1,1,0,1,NYSE
4390,10-02-2021 20:00,24 hrs.,pennystocks,LMND,50,50,0,50,1,17,12,1,NYSE
4390,10-02-2021 20:00,24 hrs.,pennystocks,PLTR,50,50,0,50,1,17,12,1,NYSE
4390,10-02-2021 20:00,24 hrs.,pennystocks,UBER,7,7,0,7,1,1,1,1,NYSE
4390,10-02-2021 20:00,24 hrs.,pennystocks,ESG,12,6,6,0,2,2,0,2,NASDAQ
4390,10-02-2021 20:00,24 hrs.,pennystocks,HAS,6,0,6,-6,1,1,0,1,NASDAQ
4390,10-02-2021 20:00,24 hrs.,pennystocks,III,50,50,0,50,1,17,12,1,NASDAQ
4390,10-02-2021 20:00,24 hrs.,pennystocks,OGI,14,14,0,14,2,2,2,2,NASDAQ
4390,10-02-2021 20:00,24 hrs.,pennystocks,OSS,24,24,0,24,1,5,10,1,NASDAQ
4390,10-02-2021 20:00,24 hrs.,pennystocks,ACST,6,0,6,-6,1,1,0,1,NASDAQ
4390,10-02-2021 20:00,24 hrs.,pennystocks,AEZS,7,0,7,-7,1,1,1,1,NASDAQ
4390,10-02-2021 20:00,24 hrs.,pennystocks,IGPK,6,0,6,-6,1,1,0,1,OTC
4390,10-02-2021 20:00,24 hrs.,pennystocks,ILUS,6,6,0,6,1,1,0,1,OTC
4390,10-02-2021 20:00,24 hrs.,pennystocks,INTV,6,6,0,6,1,1,0,1,OTC
4390,10-02-2021 20:00,24 hrs.,pennystocks,IPIX,18,18,0,18,2,4,2,1,OTC
4390,10-02-2021 20:00,24 hrs.,pennystocks,IPKL,6,6,0,6,1,1,0,1,OTC
4390,10-02-2021 20:00,24 hrs.,pennystocks,IQST,14,14,0,14,2,2,2,1,OTC
4390,10-02-2021 20:00,24 hrs.,pennystocks,KGKG,12,6,6,0,2,2,0,2,OTC
4390,10-02-2021 20:00,24 hrs.,pennystocks,KSHB,20,0,20,-20,1,6,4,1,OTC
4390,10-02-2021 20:00,24 hrs.,pennystocks,KWBT,7,7,0,7,1,1,1,1,OTC
4390,10-02-2021 20:00,24 hrs.,pennystocks,MCOA,40,40,0,40,1,15,6,1,OTC
4390,10-02-2021 20:00,24 hrs.,pennystocks,MGTI,6,6,0,6,1,1,0,1,OTC
4390,10-02-2021 20:00,24 hrs.,pennystocks,MINE,32,18,14,4,5,6,0,5,OTC
4390,10-02-2021 20:00,24 hrs.,pennystocks,MSPC,20,20,0,20,3,3,2,2,OTC
4390,10-02-2021 20:00,24 hrs.,pennystocks,NLST,7,7,0,7,1,1,1,1,OTC
4390,10-02-2021 20:00,24 hrs.,pennystocks,NUUU,6,0,6,-6,1,1,0,1,OTC
4390,10-02-2021 20:00,24 hrs.,pennystocks,QMCI,574,574,0,574,1,248,74,1,OTC
4390,10-02-2021 20:00,24 hrs.,pennystocks,RDGL,7,7,0,7,1,1,1,1,OTC
4390,10-02-2021 20:00,24 hrs.,pennystocks,RELI,30,0,30,-30,1,5,16,1,OTC
4390,10-02-2021 20:00,24 hrs.,pennystocks,SGSI,12,12,0,12,2,2,0,1,OTC
4390,10-02-2021 20:00,24 hrs.,pennystocks,SHMP,24,0,24,-24,1,6,8,1,OTC
4390,10-02-2021 20:00,24 hrs.,pennystocks,SHWZ,6,0,6,-6,1,1,0,1,OTC
4390,10-02-2021 20:00,24 hrs.,pennystocks,SNPW,14,14,0,14,2,2,2,1,OTC
4390,10-02-2021 20:00,24 hrs.,pennystocks,SNRY,7,0,7,-7,1,1,1,1,OTC
4390,10-02-2021 20:00,24 hrs.,pennystocks,STHI,70,70,0,70,1,28,10,1,OTC
4390,10-02-2021 20:00,24 hrs.,pennystocks,TCHH,7,0,7,-7,1,1,1,1,OTC
4390,10-02-2021 20:00,24 hrs.,pennystocks,TGGI,7,0,7,-7,1,1,1,1,OTC
4390,10-02-2021 20:00,24 hrs.,pennystocks,TLSS,7,7,0,7,1,1,1,1,OTC
4390,10-02-2021 20:00,24 hrs.,pennystocks,TMRC,23,0,23,-23,1,6,7,1,OTC
4390,10-02-2021 20:00,24 hrs.,pennystocks,TSNP,6,0,6,-6,1,1,0,1,OTC
4390,10-02-2021 20:00,24 hrs.,pennystocks,USMJ,13,13,0,13,2,2,1,2,OTC
4390,10-02-2021 20:00,24 hrs.,pennystocks,VPOR,7,0,7,-7,1,1,1,1,OTC
4390,10-02-2021 20:00,24 hrs.,pennystocks,VSYM,16,0,16,-16,1,3,6,1,OTC
4390,10-02-2021 20:00,24 hrs.,pennystocks,WCVC,7,7,0,7,1,1,1,1,OTC
4288,10-02-2021 00:00,24 hrs.,SPACs,SLM,84,0,84,-84,1,29,22,1,NASDAQ
4288,10-02-2021 00:00,24 hrs.,SPACs,ACTC,6,6,0,6,1,1,0,1,NASDAQ
4288,10-02-2021 00:00,24 hrs.,SPACs,ANDA,13,13,0,13,1,0,9,1,NASDAQ
4288,10-02-2021 00:00,24 hrs.,SPACs,CFII,202,202,0,202,1,80,38,1,NASDAQ
4288,10-02-2021 00:00,24 hrs.,SPACs,CHTR,21,21,0,21,1,7,3,1,NASDAQ
4288,10-02-2021 00:00,24 hrs.,SPACs,DISH,21,21,0,21,1,7,3,1,NASDAQ
4288,10-02-2021 00:00,24 hrs.,SPACs,FTOC,343,0,343,-343,1,137,65,1,NASDAQ
4288,10-02-2021 00:00,24 hrs.,SPACs,GRNV,20,6,14,-8,3,2,4,3,NASDAQ
4288,10-02-2021 00:00,24 hrs.,SPACs,IPIX,12,0,12,-12,1,0,8,1,OTC
4288,10-02-2021 00:00,24 hrs.,SPACs,NTWN,7,7,0,7,1,1,1,1,OTC
4288,10-02-2021 00:00,24 hrs.,SPACs,TSNP,7,0,7,-7,1,1,1,1,OTC
4288,10-02-2021 00:00,24 hrs.,SPACs,BFT,43,43,0,43,1,8,23,1,NYSE
4288,10-02-2021 00:00,24 hrs.,SPACs,CFR,55,0,55,-55,1,17,17,1,NYSE
4288,10-02-2021 00:00,24 hrs.,SPACs,COO,34,21,13,8,2,8,10,2,NYSE
4288,10-02-2021 00:00,24 hrs.,SPACs,CSL,84,0,84,-84,1,29,22,1,NYSE
4288,10-02-2021 00:00,24 hrs.,SPACs,GGG,84,0,84,-84,1,29,22,1,NYSE
4288,10-02-2021 00:00,24 hrs.,SPACs,GIK,178,178,0,178,1,49,76,1,NYSE
4288,10-02-2021 00:00,24 hrs.,SPACs,IPV,38,0,38,-38,2,8,14,2,NYSE
4288,10-02-2021 00:00,24 hrs.,SPACs,MTW,84,0,84,-84,1,29,22,1,NYSE
4288,10-02-2021 00:00,24 hrs.,SPACs,NAV,84,0,84,-84,1,29,22,1,NYSE
4288,10-02-2021 00:00,24 hrs.,SPACs,NKE,13,13,0,13,1,0,9,1,NYSE
4288,10-02-2021 00:00,24 hrs.,SPACs,OSK,84,0,84,-84,1,29,22,1,NYSE
4288,10-02-2021 00:00,24 hrs.,SPACs,AGCO,84,0,84,-84,1,29,22,1,NYSE
4288,10-02-2021 00:00,24 hrs.,SPACs,AJAX,8,0,8,-8,1,1,2,1,NYSE
4288,10-02-2021 00:00,24 hrs.,SPACs,APSG,251,244,7,237,2,100,43,2,NYSE
4288,10-02-2021 00:00,24 hrs.,SPACs,ATAC,208,202,6,196,2,81,38,2,NYSE
4288,10-02-2021 00:00,24 hrs.,SPACs,CCIV,7,0,7,-7,1,1,1,1,NYSE
4288,10-02-2021 00:00,24 hrs.,SPACs,CNHI,84,0,84,-84,1,29,22,1,NYSE
4288,10-02-2021 00:00,24 hrs.,SPACs,DMYD,240,202,38,164,3,88,52,3,NYSE
4288,10-02-2021 00:00,24 hrs.,SPACs,FMAC,742,742,0,742,1,297,144,1,NYSE
4288,10-02-2021 00:00,24 hrs.,SPACs,PLTR,18,18,0,18,1,0,14,1,NYSE
4288,10-02-2021 00:00,24 hrs.,SPACs,RPLA,15,0,15,-15,1,3,5,1,NYSE
4288,10-02-2021 00:00,24 hrs.,SPACs,SCVX,20,20,0,20,1,6,4,1,NYSE
4288,10-02-2021 00:00,24 hrs.,SPACs,SNPR,17,17,0,17,2,3,3,1,NYSE
4288,10-02-2021 00:00,24 hrs.,SPACs,SOAC,7,0,7,-7,1,1,1,1,NYSE
4288,10-02-2021 00:00,24 hrs.,SPACs,STIC,275,275,0,275,2,105,57,2,NYSE
4288,10-02-2021 00:00,24 hrs.,SPACs,STPK,41,0,41,-41,1,0,37,1,NYSE
4288,10-02-2021 00:00,24 hrs.,SPACs,TPGY,209,202,7,195,2,81,39,2,NYSE
4288,10-02-2021 00:00,24 hrs.,SPACs,VYGG,7,0,7,-7,1,1,1,1,NYSE
4288,10-02-2021 00:00,24 hrs.,SPACs,CFO,21,21,0,21,1,7,3,1,NASDAQ
4288,10-02-2021 00:00,24 hrs.,SPACs,NPA,381,381,0,381,2,115,143,2,NASDAQ
4288,10-02-2021 00:00,24 hrs.,RobinHoodPennyStocks,MARA,6,6,0,6,1,1,0,1,NASDAQ
4288,10-02-2021 00:00,24 hrs.,RobinHoodPennyStocks,MYSZ,6,6,0,6,1,1,0,1,NASDAQ
4288,10-02-2021 00:00,24 hrs.,RobinHoodPennyStocks,NAKD,3049,0,3049,-3049,3,1406,225,3,NASDAQ
4288,10-02-2021 00:00,24 hrs.,RobinHoodPennyStocks,NBRV,6,6,0,6,1,1,0,1,NASDAQ
4288,10-02-2021 00:00,24 hrs.,RobinHoodPennyStocks,NOVN,42,42,0,42,1,13,12,1,NASDAQ
4288,10-02-2021 00:00,24 hrs.,RobinHoodPennyStocks,NVCN,207,207,0,207,2,70,59,2,NASDAQ
4288,10-02-2021 00:00,24 hrs.,RobinHoodPennyStocks,NXTD,6,6,0,6,1,1,0,1,NASDAQ
4288,10-02-2021 00:00,24 hrs.,RobinHoodPennyStocks,OCGN,36,30,6,24,2,9,10,2,NASDAQ
4288,10-02-2021 00:00,24 hrs.,RobinHoodPennyStocks,ONTX,12,6,6,0,2,2,0,2,NASDAQ
4288,10-02-2021 00:00,24 hrs.,RobinHoodPennyStocks,OPGN,27,27,0,27,3,7,1,2,NASDAQ
4288,10-02-2021 00:00,24 hrs.,RobinHoodPennyStocks,OTLK,6,6,0,6,1,1,0,1,NASDAQ
4288,10-02-2021 00:00,24 hrs.,RobinHoodPennyStocks,PBTS,3017,0,3017,-3017,1,1397,219,1,NASDAQ
4288,10-02-2021 00:00,24 hrs.,RobinHoodPennyStocks,PLAY,3017,0,3017,-3017,1,1397,219,1,NASDAQ
4288,10-02-2021 00:00,24 hrs.,RobinHoodPennyStocks,RIOT,6,6,0,6,1,1,0,1,NASDAQ
4288,10-02-2021 00:00,24 hrs.,RobinHoodPennyStocks,RMTI,12,12,0,12,2,2,0,1,NASDAQ
4288,10-02-2021 00:00,24 hrs.,RobinHoodPennyStocks,SELB,6,0,6,-6,1,1,0,1,NASDAQ
4288,10-02-2021 00:00,24 hrs.,RobinHoodPennyStocks,SHIP,6,6,0,6,1,1,0,1,NASDAQ
4288,10-02-2021 00:00,24 hrs.,RobinHoodPennyStocks,SNDL,183,165,18,147,24,37,13,20,NASDAQ
4288,10-02-2021 00:00,24 hrs.,RobinHoodPennyStocks,SRGA,3023,6,3017,-3011,2,1398,219,2,NASDAQ
4288,10-02-2021 00:00,24 hrs.,RobinHoodPennyStocks,TNXP,3029,6,3023,-3017,3,1399,219,3,NASDAQ
4288,10-02-2021 00:00,24 hrs.,RobinHoodPennyStocks,TOPS,6,6,0,6,1,1,0,1,NASDAQ
4288,10-02-2021 00:00,24 hrs.,RobinHoodPennyStocks,TSLA,6,6,0,6,1,1,0,1,NASDAQ
4288,10-02-2021 00:00,24 hrs.,RobinHoodPennyStocks,TXMD,47,40,7,33,5,11,5,4,NASDAQ
4288,10-02-2021 00:00,24 hrs.,RobinHoodPennyStocks,TYME,12,12,0,12,2,2,0,2,NASDAQ
4288,10-02-2021 00:00,24 hrs.,RobinHoodPennyStocks,USWS,28,28,0,28,1,7,10,1,NASDAQ
4288,10-02-2021 00:00,24 hrs.,RobinHoodPennyStocks,VERU,15,0,15,-15,1,1,9,1,NASDAQ
4288,10-02-2021 00:00,24 hrs.,RobinHoodPennyStocks,VYNE,6,6,0,6,1,1,0,1,NASDAQ
4288,10-02-2021 00:00,24 hrs.,RobinHoodPennyStocks,ZSAN,3479,75,3404,-3329,6,1556,343,6,NASDAQ
4288,10-02-2021 00:00,24 hrs.,RobinHoodPennyStocks,SGMD,3017,0,3017,-3017,1,1397,219,1,OTC
4288,10-02-2021 00:00,24 hrs.,RobinHoodPennyStocks,USMJ,6,6,0,6,1,1,0,1,OTC
4288,10-02-2021 00:00,24 hrs.,RobinHoodPennyStocks,ERPNF,3017,0,3017,-3017,1,1397,219,1,OTC
4288,10-02-2021 00:00,24 hrs.,RobinHoodPennyStocks,HVBTF,6,6,0,6,1,1,0,1,OTC
4288,10-02-2021 00:00,24 hrs.,RobinHoodPennyStocks,PTNYF,3017,0,3017,-3017,1,1397,219,1,OTC
4288,10-02-2021 00:00,24 hrs.,RobinHoodPennyStocks,REZZF,6,0,6,-6,1,1,0,1,OTC
4288,10-02-2021 00:00,24 hrs.,RobinHoodPennyStocks,DNN,6,6,0,6,1,1,0,1,AMEX
4288,10-02-2021 00:00,24 hrs.,RobinHoodPennyStocks,GTE,18,6,12,-6,3,3,0,2,AMEX
4288,10-02-2021 00:00,24 hrs.,RobinHoodPennyStocks,ISR,90,90,0,90,1,33,20,1,AMEX
4288,10-02-2021 00:00,24 hrs.,RobinHoodPennyStocks,NAK,6,6,0,6,1,1,0,1,AMEX
4288,10-02-2021 00:00,24 hrs.,RobinHoodPennyStocks,REI,3023,0,3023,-3023,2,1398,219,2,AMEX
4288,10-02-2021 00:00,24 hrs.,RobinHoodPennyStocks,SYN,6,6,0,6,1,1,0,1,AMEX
4288,10-02-2021 00:00,24 hrs.,RobinHoodPennyStocks,ZOM,344,157,187,-30,7,130,56,7,AMEX
4288,10-02-2021 00:00,24 hrs.,RobinHoodPennyStocks,AUMN,13,7,6,1,2,2,1,2,AMEX
4288,10-02-2021 00:00,24 hrs.,RobinHoodPennyStocks,LCTX,6,0,6,-6,1,1,0,1,AMEX
4288,10-02-2021 00:00,24 hrs.,RobinHoodPennyStocks,OGEN,6,0,6,-6,1,1,0,1,AMEX
4288,10-02-2021 00:00,24 hrs.,RobinHoodPennyStocks,ACB,22,22,0,22,1,7,4,1,NYSE
4288,10-02-2021 00:00,24 hrs.,RobinHoodPennyStocks,AMC,135,135,0,135,3,45,33,3,NYSE
4288,10-02-2021 00:00,24 hrs.,RobinHoodPennyStocks,CBD,6,6,0,6,1,1,0,1,NYSE
4288,10-02-2021 00:00,24 hrs.,RobinHoodPennyStocks,CVS,3017,0,3017,-3017,1,1397,219,1,NYSE
4288,10-02-2021 00:00,24 hrs.,RobinHoodPennyStocks,GME,26,26,0,26,1,4,14,1,NYSE
4288,10-02-2021 00:00,24 hrs.,RobinHoodPennyStocks,IPV,6,0,6,-6,1,1,0,1,NYSE
4288,10-02-2021 00:00,24 hrs.,RobinHoodPennyStocks,NIO,6,6,0,6,1,1,0,1,NYSE
4288,10-02-2021 00:00,24 hrs.,RobinHoodPennyStocks,NOK,44,0,44,-44,1,15,10,1,NYSE
4288,10-02-2021 00:00,24 hrs.,RobinHoodPennyStocks,PKG,3017,0,3017,-3017,1,1397,219,1,NYSE
4288,10-02-2021 00:00,24 hrs.,RobinHoodPennyStocks,SOS,18,0,18,-18,3,3,0,3,NYSE
4288,10-02-2021 00:00,24 hrs.,RobinHoodPennyStocks,XOM,3017,0,3017,-3017,1,1397,219,1,NYSE
4288,10-02-2021 00:00,24 hrs.,RobinHoodPennyStocks,PUMP,6,6,0,6,1,1,0,1,NYSE
4288,10-02-2021 00:00,24 hrs.,RobinHoodPennyStocks,JFU,6,0,6,-6,1,1,0,1,NASDAQ
4288,10-02-2021 00:00,24 hrs.,RobinHoodPennyStocks,OGI,22,22,0,22,1,7,4,1,NASDAQ
4288,10-02-2021 00:00,24 hrs.,RobinHoodPennyStocks,OPK,22,22,0,22,1,7,4,1,NASDAQ
4288,10-02-2021 00:00,24 hrs.,RobinHoodPennyStocks,PTE,27,27,0,27,1,8,7,1,NASDAQ
4288,10-02-2021 00:00,24 hrs.,RobinHoodPennyStocks,ABEO,6,6,0,6,1,1,0,1,NASDAQ
4288,10-02-2021 00:00,24 hrs.,RobinHoodPennyStocks,ABUS,6,6,0,6,1,1,0,1,NASDAQ
4288,10-02-2021 00:00,24 hrs.,RobinHoodPennyStocks,ACST,6,6,0,6,1,1,0,1,NASDAQ
4288,10-02-2021 00:00,24 hrs.,RobinHoodPennyStocks,ACTG,6,0,6,-6,1,1,0,1,NASDAQ
4288,10-02-2021 00:00,24 hrs.,RobinHoodPennyStocks,ADMP,6,6,0,6,1,1,0,1,NASDAQ
4288,10-02-2021 00:00,24 hrs.,RobinHoodPennyStocks,ADXS,18,18,0,18,3,3,0,2,NASDAQ
4288,10-02-2021 00:00,24 hrs.,RobinHoodPennyStocks,AEZS,250,204,46,158,9,71,72,9,NASDAQ
4288,10-02-2021 00:00,24 hrs.,RobinHoodPennyStocks,AGTC,3272,171,3101,-2930,6,1477,294,6,NASDAQ
4288,10-02-2021 00:00,24 hrs.,RobinHoodPennyStocks,AKBA,3017,0,3017,-3017,1,1397,219,1,NASDAQ
4288,10-02-2021 00:00,24 hrs.,RobinHoodPennyStocks,ARTL,6,6,0,6,1,1,0,1,NASDAQ
4288,10-02-2021 00:00,24 hrs.,RobinHoodPennyStocks,ASRT,74,68,6,62,2,21,24,2,NASDAQ
4288,10-02-2021 00:00,24 hrs.,RobinHoodPennyStocks,ATOS,167,167,0,167,1,77,9,1,NASDAQ
4288,10-02-2021 00:00,24 hrs.,RobinHoodPennyStocks,BIOL,3023,0,3023,-3023,2,1398,219,2,NASDAQ
4288,10-02-2021 00:00,24 hrs.,RobinHoodPennyStocks,CHCI,21,0,21,-21,1,6,5,1,NASDAQ
4288,10-02-2021 00:00,24 hrs.,RobinHoodPennyStocks,CHEK,6,0,6,-6,1,1,0,1,NASDAQ
4288,10-02-2021 00:00,24 hrs.,RobinHoodPennyStocks,CIDM,55,55,0,55,1,20,11,1,NASDAQ
4288,10-02-2021 00:00,24 hrs.,RobinHoodPennyStocks,CLVS,6,6,0,6,1,1,0,1,NASDAQ
4288,10-02-2021 00:00,24 hrs.,RobinHoodPennyStocks,CNSP,21,21,0,21,1,8,1,1,NASDAQ
4288,10-02-2021 00:00,24 hrs.,RobinHoodPennyStocks,CTRM,379,313,66,247,15,98,123,14,NASDAQ
4288,10-02-2021 00:00,24 hrs.,RobinHoodPennyStocks,EAST,3023,6,3017,-3011,2,1398,219,2,NASDAQ
4288,10-02-2021 00:00,24 hrs.,RobinHoodPennyStocks,EDIT,810,810,0,810,2,336,130,2,NASDAQ
4288,10-02-2021 00:00,24 hrs.,RobinHoodPennyStocks,ENVB,6,0,6,-6,1,1,0,1,NASDAQ
4288,10-02-2021 00:00,24 hrs.,RobinHoodPennyStocks,EVOK,7,7,0,7,1,1,1,1,NASDAQ
4288,10-02-2021 00:00,24 hrs.,RobinHoodPennyStocks,GEVO,6,0,6,-6,1,1,0,1,NASDAQ
4288,10-02-2021 00:00,24 hrs.,RobinHoodPennyStocks,GHSI,43,37,6,31,2,14,7,2,NASDAQ
4288,10-02-2021 00:00,24 hrs.,RobinHoodPennyStocks,GNPX,6,0,6,-6,1,1,0,1,NASDAQ
4288,10-02-2021 00:00,24 hrs.,RobinHoodPennyStocks,IDEX,22,22,0,22,1,7,4,1,NASDAQ
4288,10-02-2021 00:00,24 hrs.,RobinHoodPennyStocks,ITRM,12,6,6,0,2,2,0,2,NASDAQ
4288,10-02-2021 00:00,24 hrs.,RobinHoodPennyStocks,KALV,7,7,0,7,1,1,1,1,NASDAQ
4288,10-02-2021 00:00,24 hrs.,RobinHoodPennyStocks,KTRA,217,217,0,217,1,83,47,1,NASDAQ
4288,10-02-2021 00:00,24 hrs.,RobinHoodPennyStocks,LIVE,6,0,6,-6,1,1,0,1,NASDAQ
4288,10-02-2021 00:00,24 hrs.,RobinHoodPennyStocks,LKCO,12,12,0,12,2,2,0,2,NASDAQ
4288,10-02-2021 00:00,24 hrs.,wallstreetbets,PLUG,20,7,13,-6,3,3,2,3,NASDAQ
4288,10-02-2021 00:00,24 hrs.,wallstreetbets,POWW,18,6,12,-6,3,3,0,2,NASDAQ
4288,10-02-2021 00:00,24 hrs.,wallstreetbets,PRPO,6,6,0,6,1,1,0,1,NASDAQ
4288,10-02-2021 00:00,24 hrs.,wallstreetbets,PSAC,6,6,0,6,1,1,0,1,NASDAQ
4288,10-02-2021 00:00,24 hrs.,wallstreetbets,PTON,6,6,0,6,1,1,0,1,NASDAQ
4288,10-02-2021 00:00,24 hrs.,wallstreetbets,QDEL,222,222,0,222,1,102,14,1,NASDAQ
4288,10-02-2021 00:00,24 hrs.,wallstreetbets,QGEN,222,222,0,222,1,102,14,1,NASDAQ
4288,10-02-2021 00:00,24 hrs.,wallstreetbets,RAVE,6,6,0,6,1,1,0,1,NASDAQ
4288,10-02-2021 00:00,24 hrs.,wallstreetbets,RBCN,12,0,12,-12,2,2,0,2,NASDAQ
4288,10-02-2021 00:00,24 hrs.,wallstreetbets,REAL,12,0,12,-12,2,2,0,2,NASDAQ
4288,10-02-2021 00:00,24 hrs.,wallstreetbets,REED,6,6,0,6,1,1,0,1,NASDAQ
4288,10-02-2021 00:00,24 hrs.,wallstreetbets,RING,12,0,12,-12,2,2,0,1,NASDAQ
4288,10-02-2021 00:00,24 hrs.,wallstreetbets,RIOT,55,24,31,-7,9,9,1,9,NASDAQ
4288,10-02-2021 00:00,24 hrs.,wallstreetbets,ROKU,12,12,0,12,2,2,0,1,NASDAQ
4288,10-02-2021 00:00,24 hrs.,wallstreetbets,SAVA,30,24,6,18,5,5,0,5,NASDAQ
4288,10-02-2021 00:00,24 hrs.,wallstreetbets,SAVE,6,0,6,-6,1,1,0,1,NASDAQ
4288,10-02-2021 00:00,24 hrs.,wallstreetbets,SELB,6,6,0,6,1,1,0,1,NASDAQ
4288,10-02-2021 00:00,24 hrs.,wallstreetbets,SIRI,18,6,12,-6,3,3,0,3,NASDAQ
4288,10-02-2021 00:00,24 hrs.,wallstreetbets,SLRX,6,6,0,6,1,1,0,1,NASDAQ
4288,10-02-2021 00:00,24 hrs.,wallstreetbets,SMCI,6,6,0,6,1,1,0,1,NASDAQ
4288,10-02-2021 00:00,24 hrs.,wallstreetbets,SNDL,423,387,36,351,70,70,3,59,NASDAQ
4288,10-02-2021 00:00,24 hrs.,wallstreetbets,SRNE,24,12,12,0,4,4,0,3,NASDAQ
4288,10-02-2021 00:00,24 hrs.,wallstreetbets,SSPK,6,6,0,6,1,1,0,1,NASDAQ
4288,10-02-2021 00:00,24 hrs.,wallstreetbets,STAY,6,6,0,6,1,1,0,1,NASDAQ
4288,10-02-2021 00:00,24 hrs.,wallstreetbets,STCN,6,0,6,-6,1,1,0,1,NASDAQ
4288,10-02-2021 00:00,24 hrs.,wallstreetbets,TBLT,12,12,0,12,2,2,0,2,NASDAQ
4288,10-02-2021 00:00,24 hrs.,wallstreetbets,TECH,6,6,0,6,1,1,0,1,NASDAQ
4288,10-02-2021 00:00,24 hrs.,wallstreetbets,TELL,6,6,0,6,1,1,0,1,NASDAQ
4288,10-02-2021 00:00,24 hrs.,wallstreetbets,TIGR,12,12,0,12,2,2,0,1,NASDAQ
4288,10-02-2021 00:00,24 hrs.,wallstreetbets,TLRY,5816,5761,55,5706,87,2344,780,70,NASDAQ
4288,10-02-2021 00:00,24 hrs.,wallstreetbets,TNXP,6,0,6,-6,1,1,0,1,NASDAQ
4288,10-02-2021 00:00,24 hrs.,wallstreetbets,TOPS,12,6,6,0,2,2,0,2,NASDAQ
4288,10-02-2021 00:00,24 hrs.,wallstreetbets,TRIT,12,0,12,-12,2,2,0,2,NASDAQ
4288,10-02-2021 00:00,24 hrs.,wallstreetbets,TSLA,36,24,12,12,6,6,0,6,NASDAQ
4288,10-02-2021 00:00,24 hrs.,wallstreetbets,TTWO,222,222,0,222,1,102,14,1,NASDAQ
4288,10-02-2021 00:00,24 hrs.,wallstreetbets,TXMD,36,24,12,12,6,6,0,6,NASDAQ
4288,10-02-2021 00:00,24 hrs.,wallstreetbets,TYME,18,12,6,6,3,3,0,3,NASDAQ
4288,10-02-2021 00:00,24 hrs.,wallstreetbets,UNFI,7,7,0,7,1,1,1,1,NASDAQ
4288,10-02-2021 00:00,24 hrs.,wallstreetbets,UONE,6,0,6,-6,1,1,0,1,NASDAQ
4288,10-02-2021 00:00,24 hrs.,wallstreetbets,USWS,6,6,0,6,1,1,0,1,NASDAQ
4288,10-02-2021 00:00,24 hrs.,wallstreetbets,VERU,30,30,0,30,5,5,0,3,NASDAQ
4288,10-02-2021 00:00,24 hrs.,wallstreetbets,VIAC,6,6,0,6,1,1,0,1,NASDAQ
4288,10-02-2021 00:00,24 hrs.,wallstreetbets,VISL,6,0,6,-6,1,1,0,1,NASDAQ
4288,10-02-2021 00:00,24 hrs.,wallstreetbets,VIVE,6,0,6,-6,1,1,0,1,NASDAQ
4288,10-02-2021 00:00,24 hrs.,wallstreetbets,VXRT,6,6,0,6,1,1,0,1,NASDAQ
4288,10-02-2021 00:00,24 hrs.,wallstreetbets,VYNE,12,12,0,12,2,2,0,1,NASDAQ
4288,10-02-2021 00:00,24 hrs.,wallstreetbets,WISH,7,7,0,7,1,1,1,1,NASDAQ
4288,10-02-2021 00:00,24 hrs.,wallstreetbets,WTRH,18,0,18,-18,3,3,0,2,NASDAQ
4288,10-02-2021 00:00,24 hrs.,wallstreetbets,XSPA,12,12,0,12,2,2,0,2,NASDAQ
4288,10-02-2021 00:00,24 hrs.,wallstreetbets,ZNGA,12,6,6,0,2,2,0,2,NASDAQ
4288,10-02-2021 00:00,24 hrs.,wallstreetbets,ZSAN,36,30,6,24,6,6,0,6,NASDAQ
4288,10-02-2021 00:00,24 hrs.,wallstreetbets,BFIIW,6,6,0,6,1,1,0,1,NASDAQ
4288,10-02-2021 00:00,24 hrs.,RobinHoodPennyStocks,AITX,3017,0,3017,-3017,1,1397,219,1,OTC
4288,10-02-2021 00:00,24 hrs.,RobinHoodPennyStocks,BOTY,7,7,0,7,1,1,1,1,OTC
4288,10-02-2021 00:00,24 hrs.,RobinHoodPennyStocks,CATV,6,0,6,-6,1,1,0,1,OTC
4288,10-02-2021 00:00,24 hrs.,RobinHoodPennyStocks,INND,3023,0,3023,-3023,2,1398,219,2,OTC
4288,10-02-2021 00:00,24 hrs.,RobinHoodPennyStocks,ISWH,6,6,0,6,1,1,0,1,OTC
4288,10-02-2021 00:00,24 hrs.,RobinHoodPennyStocks,MCOA,6,0,6,-6,1,1,0,1,OTC
4288,10-02-2021 00:00,24 hrs.,RobinHoodPennyStocks,MITI,3017,0,3017,-3017,1,1397,219,1,OTC
4288,10-02-2021 00:00,24 hrs.,RobinHoodPennyStocks,MJLB,3023,6,3017,-3011,2,1398,219,2,OTC
4288,10-02-2021 00:00,24 hrs.,RobinHoodPennyStocks,NUUU,12,12,0,12,2,2,0,2,OTC
4288,10-02-2021 00:00,24 hrs.,RobinHoodPennyStocks,OZSC,3023,6,3017,-3011,2,1398,219,2,OTC
4288,10-02-2021 00:00,24 hrs.,RobinHoodPennyStocks,PAOG,6,6,0,6,1,1,0,1,OTC
4288,10-02-2021 00:00,24 hrs.,RobinHoodPennyStocks,PURA,6,0,6,-6,1,1,0,1,OTC
4288,10-02-2021 00:00,24 hrs.,wallstreetbets,FTFT,12,6,6,0,2,2,0,2,NASDAQ
4288,10-02-2021 00:00,24 hrs.,wallstreetbets,GAIN,6,6,0,6,1,1,0,1,NASDAQ
4288,10-02-2021 00:00,24 hrs.,wallstreetbets,GEVO,538,18,520,-502,5,213,92,4,NASDAQ
4288,10-02-2021 00:00,24 hrs.,wallstreetbets,GLUU,41,28,13,15,5,7,7,5,NASDAQ
4288,10-02-2021 00:00,24 hrs.,wallstreetbets,GMDA,6,6,0,6,1,1,0,1,NASDAQ
4288,10-02-2021 00:00,24 hrs.,wallstreetbets,GNLN,12,12,0,12,2,2,0,2,NASDAQ
4288,10-02-2021 00:00,24 hrs.,wallstreetbets,GNOG,6,6,0,6,1,1,0,1,NASDAQ
4288,10-02-2021 00:00,24 hrs.,wallstreetbets,GNUS,24,12,12,0,4,4,0,4,NASDAQ
4288,10-02-2021 00:00,24 hrs.,wallstreetbets,GOLD,30,24,6,18,5,5,0,4,NASDAQ
4288,10-02-2021 00:00,24 hrs.,wallstreetbets,GRTS,6,0,6,-6,1,1,0,1,NASDAQ
4288,10-02-2021 00:00,24 hrs.,wallstreetbets,GRWG,6,6,0,6,1,1,0,1,NASDAQ
4288,10-02-2021 00:00,24 hrs.,wallstreetbets,GTIM,7,0,7,-7,1,1,1,1,NASDAQ
4288,10-02-2021 00:00,24 hrs.,wallstreetbets,GURE,6,6,0,6,1,1,0,1,NASDAQ
4288,10-02-2021 00:00,24 hrs.,wallstreetbets,HAIN,222,222,0,222,1,102,14,1,NASDAQ
4288,10-02-2021 00:00,24 hrs.,wallstreetbets,HALO,12,12,0,12,2,2,0,1,NASDAQ
4288,10-02-2021 00:00,24 hrs.,wallstreetbets,HCDI,6,6,0,6,1,1,0,1,NASDAQ
4288,10-02-2021 00:00,24 hrs.,wallstreetbets,HEAR,26,14,12,2,4,4,2,3,NASDAQ
4288,10-02-2021 00:00,24 hrs.,wallstreetbets,HIMX,13,13,0,13,2,2,1,2,NASDAQ
4288,10-02-2021 00:00,24 hrs.,wallstreetbets,HTBX,24,24,0,24,4,4,0,4,NASDAQ
4288,10-02-2021 00:00,24 hrs.,wallstreetbets,IBEX,6,6,0,6,1,1,0,1,NASDAQ
4288,10-02-2021 00:00,24 hrs.,wallstreetbets,IBKR,6,0,6,-6,1,1,0,1,NASDAQ
4288,10-02-2021 00:00,24 hrs.,wallstreetbets,IDEX,6,6,0,6,1,1,0,1,NASDAQ
4288,10-02-2021 00:00,24 hrs.,wallstreetbets,IMMP,6,0,6,-6,1,1,0,1,NASDAQ
4288,10-02-2021 00:00,24 hrs.,wallstreetbets,INPX,19,19,0,19,3,3,1,3,NASDAQ
4288,10-02-2021 00:00,24 hrs.,wallstreetbets,ITRM,18,18,0,18,3,3,0,3,NASDAQ
4288,10-02-2021 00:00,24 hrs.,wallstreetbets,JAGX,7,0,7,-7,1,1,1,1,NASDAQ
4288,10-02-2021 00:00,24 hrs.,wallstreetbets,KALV,6,6,0,6,1,1,0,1,NASDAQ
4288,10-02-2021 00:00,24 hrs.,wallstreetbets,KOSS,42,24,18,6,7,7,0,5,NASDAQ
4288,10-02-2021 00:00,24 hrs.,wallstreetbets,KTRA,6,6,0,6,1,1,0,1,NASDAQ
4288,10-02-2021 00:00,24 hrs.,wallstreetbets,LGND,18,18,0,18,3,3,0,3,NASDAQ
4288,10-02-2021 00:00,24 hrs.,wallstreetbets,LIFE,18,0,18,-18,3,3,0,3,NASDAQ
4288,10-02-2021 00:00,24 hrs.,wallstreetbets,LIVE,228,222,6,216,2,103,14,2,NASDAQ
4288,10-02-2021 00:00,24 hrs.,wallstreetbets,LUNA,6,6,0,6,1,1,0,1,NASDAQ
4288,10-02-2021 00:00,24 hrs.,wallstreetbets,MARA,591,578,13,565,6,250,67,6,NASDAQ
4288,10-02-2021 00:00,24 hrs.,wallstreetbets,MICT,6,6,0,6,1,1,0,1,NASDAQ
4288,10-02-2021 00:00,24 hrs.,wallstreetbets,MMLP,6,6,0,6,1,1,0,1,NASDAQ
4288,10-02-2021 00:00,24 hrs.,wallstreetbets,MNKD,6,6,0,6,1,1,0,1,NASDAQ
4288,10-02-2021 00:00,24 hrs.,wallstreetbets,MOSY,6,0,6,-6,1,1,0,1,NASDAQ
4288,10-02-2021 00:00,24 hrs.,wallstreetbets,MRKR,6,6,0,6,1,1,0,1,NASDAQ
4288,10-02-2021 00:00,24 hrs.,wallstreetbets,MRNA,6,0,6,-6,1,1,0,1,NASDAQ
4288,10-02-2021 00:00,24 hrs.,wallstreetbets,MSFT,6,6,0,6,1,1,0,1,NASDAQ
4288,10-02-2021 00:00,24 hrs.,wallstreetbets,MSTR,50,44,6,38,7,10,2,6,NASDAQ
4288,10-02-2021 00:00,24 hrs.,wallstreetbets,MVIS,12,6,6,0,2,2,0,2,NASDAQ
4288,10-02-2021 00:00,24 hrs.,wallstreetbets,NAKD,64,48,16,32,11,10,0,10,NASDAQ
4288,10-02-2021 00:00,24 hrs.,wallstreetbets,NBRV,6,6,0,6,1,1,0,1,NASDAQ
4288,10-02-2021 00:00,24 hrs.,wallstreetbets,NKTR,7,7,0,7,1,1,1,1,NASDAQ
4288,10-02-2021 00:00,24 hrs.,wallstreetbets,NOVN,6,6,0,6,1,1,0,1,NASDAQ
4288,10-02-2021 00:00,24 hrs.,wallstreetbets,NVAX,6,0,6,-6,1,1,0,1,NASDAQ
4288,10-02-2021 00:00,24 hrs.,wallstreetbets,NVCN,6,0,6,-6,1,1,0,1,NASDAQ
4288,10-02-2021 00:00,24 hrs.,wallstreetbets,NVDA,7,0,7,-7,1,1,1,1,NASDAQ
4288,10-02-2021 00:00,24 hrs.,wallstreetbets,OBLN,6,0,6,-6,1,1,0,1,NASDAQ
4288,10-02-2021 00:00,24 hrs.,wallstreetbets,OCGN,155,90,65,25,26,25,1,25,NASDAQ
4288,10-02-2021 00:00,24 hrs.,wallstreetbets,OESX,6,6,0,6,1,1,0,1,NASDAQ
4288,10-02-2021 00:00,24 hrs.,wallstreetbets,ONTX,24,6,18,-12,4,4,0,4,NASDAQ
4288,10-02-2021 00:00,24 hrs.,wallstreetbets,OPGN,12,12,0,12,2,2,0,2,NASDAQ
4288,10-02-2021 00:00,24 hrs.,wallstreetbets,OPTT,6,6,0,6,1,1,0,1,NASDAQ
4288,10-02-2021 00:00,24 hrs.,wallstreetbets,OSTK,6,6,0,6,1,1,0,1,NASDAQ
4288,10-02-2021 00:00,24 hrs.,wallstreetbets,OTLK,25,18,7,11,4,4,1,4,NASDAQ
4288,10-02-2021 00:00,24 hrs.,wallstreetbets,OVID,6,0,6,-6,1,1,0,1,NASDAQ
4288,10-02-2021 00:00,24 hrs.,wallstreetbets,PACB,6,0,6,-6,1,1,0,1,NASDAQ
4288,10-02-2021 00:00,24 hrs.,wallstreetbets,PAGP,6,6,0,6,1,1,0,1,NASDAQ
4288,10-02-2021 00:00,24 hrs.,wallstreetbets,PAYA,6,6,0,6,1,1,0,1,NASDAQ
4288,10-02-2021 00:00,24 hrs.,wallstreetbets,PBPB,6,0,6,-6,1,1,0,1,NASDAQ
4288,10-02-2021 00:00,24 hrs.,wallstreetbets,PLAY,6,6,0,6,1,1,0,1,NASDAQ
4288,10-02-2021 00:00,24 hrs.,wallstreetbets,ABIO,6,6,0,6,1,1,0,1,NASDAQ
4288,10-02-2021 00:00,24 hrs.,wallstreetbets,ABUS,6,6,0,6,1,1,0,1,NASDAQ
4288,10-02-2021 00:00,24 hrs.,wallstreetbets,ACIA,6,6,0,6,1,1,0,1,NASDAQ
4288,10-02-2021 00:00,24 hrs.,wallstreetbets,ACST,6,6,0,6,1,1,0,1,NASDAQ
4288,10-02-2021 00:00,24 hrs.,wallstreetbets,ADMA,6,0,6,-6,1,1,0,1,NASDAQ
4288,10-02-2021 00:00,24 hrs.,wallstreetbets,ADMP,25,6,19,-13,4,4,1,4,NASDAQ
4288,10-02-2021 00:00,24 hrs.,wallstreetbets,ADTX,24,24,0,24,4,4,0,2,NASDAQ
4288,10-02-2021 00:00,24 hrs.,wallstreetbets,AEZS,72,36,36,0,12,12,0,12,NASDAQ
4288,10-02-2021 00:00,24 hrs.,wallstreetbets,AGEN,6,6,0,6,1,1,0,1,NASDAQ
4288,10-02-2021 00:00,24 hrs.,wallstreetbets,AGTC,12,0,12,-12,2,2,0,2,NASDAQ
4288,10-02-2021 00:00,24 hrs.,wallstreetbets,ALNA,6,6,0,6,1,1,0,1,NASDAQ
4288,10-02-2021 00:00,24 hrs.,wallstreetbets,AMRN,6,6,0,6,1,1,0,1,NASDAQ
4288,10-02-2021 00:00,24 hrs.,wallstreetbets,AMTX,6,0,6,-6,1,1,0,1,NASDAQ
4288,10-02-2021 00:00,24 hrs.,wallstreetbets,AMZN,18,6,12,-6,3,3,0,3,NASDAQ
4288,10-02-2021 00:00,24 hrs.,wallstreetbets,APHA,1691,1691,0,1691,25,674,243,19,NASDAQ
4288,10-02-2021 00:00,24 hrs.,wallstreetbets,APWC,6,0,6,-6,1,1,0,1,NASDAQ
4288,10-02-2021 00:00,24 hrs.,wallstreetbets,ARCT,6,6,0,6,1,1,0,1,NASDAQ
4288,10-02-2021 00:00,24 hrs.,wallstreetbets,AREC,6,0,6,-6,1,1,0,1,NASDAQ
4288,10-02-2021 00:00,24 hrs.,wallstreetbets,ASRT,12,12,0,12,2,2,0,2,NASDAQ
4288,10-02-2021 00:00,24 hrs.,wallstreetbets,ATOS,6,6,0,6,1,1,0,1,NASDAQ
4288,10-02-2021 00:00,24 hrs.,wallstreetbets,AUPH,6,0,6,-6,1,1,0,1,NASDAQ
4288,10-02-2021 00:00,24 hrs.,wallstreetbets,AUTO,6,6,0,6,1,1,0,1,NASDAQ
4288,10-02-2021 00:00,24 hrs.,wallstreetbets,AUVI,24,24,0,24,4,4,0,4,NASDAQ
4288,10-02-2021 00:00,24 hrs.,wallstreetbets,AVGR,6,6,0,6,1,1,0,1,NASDAQ
4288,10-02-2021 00:00,24 hrs.,wallstreetbets,AVXL,6,6,0,6,1,1,0,1,NASDAQ
4288,10-02-2021 00:00,24 hrs.,wallstreetbets,BBBY,12,12,0,12,2,2,0,2,NASDAQ
4288,10-02-2021 00:00,24 hrs.,wallstreetbets,BBIG,6,0,6,-6,1,1,0,1,NASDAQ
4288,10-02-2021 00:00,24 hrs.,wallstreetbets,BCRX,12,12,0,12,2,2,0,2,NASDAQ
4288,10-02-2021 00:00,24 hrs.,wallstreetbets,BIOC,6,6,0,6,1,1,0,1,NASDAQ
4288,10-02-2021 00:00,24 hrs.,wallstreetbets,BIOL,18,6,12,-6,3,3,0,3,NASDAQ
4288,10-02-2021 00:00,24 hrs.,wallstreetbets,BSQR,24,18,6,12,4,4,0,4,NASDAQ
4288,10-02-2021 00:00,24 hrs.,wallstreetbets,BTAQ,6,6,0,6,1,1,0,1,NASDAQ
4288,10-02-2021 00:00,24 hrs.,wallstreetbets,BTBT,12,0,12,-12,2,2,0,2,NASDAQ
4288,10-02-2021 00:00,24 hrs.,wallstreetbets,CBAY,6,6,0,6,1,1,0,1,NASDAQ
4288,10-02-2021 00:00,24 hrs.,wallstreetbets,CHCI,24,24,0,24,4,4,0,2,NASDAQ
4288,10-02-2021 00:00,24 hrs.,wallstreetbets,CHEK,6,0,6,-6,1,1,0,1,NASDAQ
4288,10-02-2021 00:00,24 hrs.,wallstreetbets,CIDM,12,12,0,12,2,2,0,2,NASDAQ
4288,10-02-2021 00:00,24 hrs.,wallstreetbets,CLNE,12,6,6,0,2,2,0,2,NASDAQ
4288,10-02-2021 00:00,24 hrs.,wallstreetbets,CLSK,6,0,6,-6,1,1,0,1,NASDAQ
4288,10-02-2021 00:00,24 hrs.,wallstreetbets,CLVS,24,24,0,24,4,4,0,3,NASDAQ
4288,10-02-2021 00:00,24 hrs.,wallstreetbets,CODX,6,6,0,6,1,1,0,1,NASDAQ
4288,10-02-2021 00:00,24 hrs.,wallstreetbets,CRBP,12,12,0,12,2,2,0,2,NASDAQ
4288,10-02-2021 00:00,24 hrs.,wallstreetbets,CRON,19,19,0,19,3,3,1,3,NASDAQ
4288,10-02-2021 00:00,24 hrs.,wallstreetbets,CRSR,2133,2120,13,2107,11,928,233,11,NASDAQ
4288,10-02-2021 00:00,24 hrs.,wallstreetbets,CSTR,6,6,0,6,1,1,0,1,NASDAQ
4288,10-02-2021 00:00,24 hrs.,wallstreetbets,CTHR,6,6,0,6,1,1,0,1,NASDAQ
4288,10-02-2021 00:00,24 hrs.,wallstreetbets,CTRM,151,115,36,79,25,25,1,23,NASDAQ
4288,10-02-2021 00:00,24 hrs.,wallstreetbets,CVLB,6,6,0,6,1,1,0,1,NASDAQ
4288,10-02-2021 00:00,24 hrs.,wallstreetbets,CYTH,12,6,6,0,2,2,0,2,NASDAQ
4288,10-02-2021 00:00,24 hrs.,wallstreetbets,DARE,6,0,6,-6,1,1,0,1,NASDAQ
4288,10-02-2021 00:00,24 hrs.,wallstreetbets,DCRB,6,6,0,6,1,1,0,1,NASDAQ
4288,10-02-2021 00:00,24 hrs.,wallstreetbets,DGLY,6,0,6,-6,1,1,0,1,NASDAQ
4288,10-02-2021 00:00,24 hrs.,wallstreetbets,DKNG,12,0,12,-12,2,2,0,2,NASDAQ
4288,10-02-2021 00:00,24 hrs.,wallstreetbets,DLTR,6,6,0,6,1,1,0,1,NASDAQ
4288,10-02-2021 00:00,24 hrs.,wallstreetbets,DTEA,6,6,0,6,1,1,0,1,NASDAQ
4288,10-02-2021 00:00,24 hrs.,wallstreetbets,EAST,18,12,6,6,3,3,0,2,NASDAQ
4288,10-02-2021 00:00,24 hrs.,wallstreetbets,EDIT,925,925,0,925,1,373,175,1,NASDAQ
4288,10-02-2021 00:00,24 hrs.,wallstreetbets,EHTH,6,6,0,6,1,1,0,1,NASDAQ
4288,10-02-2021 00:00,24 hrs.,wallstreetbets,ELSE,6,6,0,6,1,1,0,1,NASDAQ
4288,10-02-2021 00:00,24 hrs.,wallstreetbets,ENLV,24,12,12,0,4,4,0,4,NASDAQ
4288,10-02-2021 00:00,24 hrs.,wallstreetbets,FAST,6,6,0,6,1,1,0,1,NASDAQ
4288,10-02-2021 00:00,24 hrs.,wallstreetbets,FCEL,13,6,7,-1,2,2,1,2,NASDAQ
4288,10-02-2021 00:00,24 hrs.,wallstreetbets,FLGT,6,6,0,6,1,1,0,1,NASDAQ
4288,10-02-2021 00:00,24 hrs.,wallstreetbets,FPRX,6,6,0,6,1,1,0,1,NASDAQ
4288,10-02-2021 00:00,24 hrs.,wallstreetbets,TMO,222,222,0,222,1,102,14,1,NYSE
4288,10-02-2021 00:00,24 hrs.,wallstreetbets,TNK,6,6,0,6,1,1,0,1,NYSE
4288,10-02-2021 00:00,24 hrs.,wallstreetbets,UMC,6,6,0,6,1,1,0,1,NYSE
4288,10-02-2021 00:00,24 hrs.,wallstreetbets,UPS,12,6,6,0,2,2,0,2,NYSE
4288,10-02-2021 00:00,24 hrs.,wallstreetbets,VET,6,0,6,-6,1,1,0,1,NYSE
4288,10-02-2021 00:00,24 hrs.,wallstreetbets,VHC,8,8,0,8,1,2,0,1,NYSE
4288,10-02-2021 00:00,24 hrs.,wallstreetbets,WCC,6,6,0,6,1,1,0,1,NYSE
4288,10-02-2021 00:00,24 hrs.,wallstreetbets,WWE,6,6,0,6,1,1,0,1,NYSE
4288,10-02-2021 00:00,24 hrs.,wallstreetbets,BABA,6,6,0,6,1,1,0,1,NYSE
4288,10-02-2021 00:00,24 hrs.,wallstreetbets,BALY,6,0,6,-6,1,1,0,1,NYSE
4288,10-02-2021 00:00,24 hrs.,wallstreetbets,BEPC,6,0,6,-6,1,1,0,1,NYSE
4288,10-02-2021 00:00,24 hrs.,wallstreetbets,BORR,12,6,6,0,2,2,0,2,NYSE
4288,10-02-2021 00:00,24 hrs.,wallstreetbets,CANG,6,0,6,-6,1,1,0,1,NYSE
4288,10-02-2021 00:00,24 hrs.,wallstreetbets,CARR,228,228,0,228,2,103,14,2,NYSE
4288,10-02-2021 00:00,24 hrs.,wallstreetbets,CCIV,24,6,18,-12,4,4,0,4,NYSE
4288,10-02-2021 00:00,24 hrs.,wallstreetbets,CHGG,222,222,0,222,1,102,14,1,NYSE
4288,10-02-2021 00:00,24 hrs.,wallstreetbets,CLDR,9,9,0,9,1,2,1,1,NYSE
4288,10-02-2021 00:00,24 hrs.,wallstreetbets,COTY,235,235,0,235,3,104,15,3,NYSE
4288,10-02-2021 00:00,24 hrs.,wallstreetbets,DASH,12,0,12,-12,2,2,0,1,NYSE
4288,10-02-2021 00:00,24 hrs.,wallstreetbets,EXPR,24,18,6,12,4,4,0,3,NYSE
4288,10-02-2021 00:00,24 hrs.,wallstreetbets,FUBO,12,6,6,0,2,2,0,2,NYSE
4288,10-02-2021 00:00,24 hrs.,wallstreetbets,IPOF,6,0,6,-6,1,1,0,1,NYSE
4288,10-02-2021 00:00,24 hrs.,wallstreetbets,JMIA,6,6,0,6,1,1,0,1,NYSE
4288,10-02-2021 00:00,24 hrs.,wallstreetbets,LUMN,6,6,0,6,1,1,0,1,NYSE
4288,10-02-2021 00:00,24 hrs.,wallstreetbets,MDLY,6,0,6,-6,1,1,0,1,NYSE
4288,10-02-2021 00:00,24 hrs.,wallstreetbets,NVTA,110,110,0,110,1,44,18,1,NYSE
4288,10-02-2021 00:00,24 hrs.,wallstreetbets,PLAN,6,0,6,-6,1,1,0,1,NYSE
4288,10-02-2021 00:00,24 hrs.,wallstreetbets,PLTR,49,37,12,25,8,8,1,8,NYSE
4288,10-02-2021 00:00,24 hrs.,wallstreetbets,PRTY,6,6,0,6,1,1,0,1,NYSE
4288,10-02-2021 00:00,24 hrs.,wallstreetbets,PSTH,34,0,34,-34,2,12,2,1,NYSE
4288,10-02-2021 00:00,24 hrs.,wallstreetbets,SNAP,6,6,0,6,1,1,0,1,NYSE
4288,10-02-2021 00:00,24 hrs.,wallstreetbets,SNOW,12,12,0,12,2,2,0,1,NYSE
4288,10-02-2021 00:00,24 hrs.,wallstreetbets,SPCE,36,18,18,0,6,6,0,5,NYSE
4288,10-02-2021 00:00,24 hrs.,wallstreetbets,STPK,6,0,6,-6,1,1,0,1,NYSE
4288,10-02-2021 00:00,24 hrs.,wallstreetbets,TWTR,6,0,6,-6,1,1,0,1,NYSE
4288,10-02-2021 00:00,24 hrs.,wallstreetbets,UBER,12,12,0,12,2,2,0,1,NYSE
4288,10-02-2021 00:00,24 hrs.,wallstreetbets,VSTO,13,13,0,13,2,2,1,2,NYSE
4288,10-02-2021 00:00,24 hrs.,wallstreetbets,WORK,1415,1415,0,1415,1,664,83,1,NYSE
4288,10-02-2021 00:00,24 hrs.,wallstreetbets,YETI,6,6,0,6,1,1,0,1,NYSE
4288,10-02-2021 00:00,24 hrs.,wallstreetbets,AAL,6,6,0,6,1,1,0,1,NASDAQ
4288,10-02-2021 00:00,24 hrs.,wallstreetbets,AGC,6,6,0,6,1,1,0,1,NASDAQ
4288,10-02-2021 00:00,24 hrs.,wallstreetbets,ALT,6,6,0,6,1,1,0,1,NASDAQ
4288,10-02-2021 00:00,24 hrs.,wallstreetbets,AMD,271,38,233,-195,7,94,55,5,NASDAQ
4288,10-02-2021 00:00,24 hrs.,wallstreetbets,BFI,6,6,0,6,1,1,0,1,NASDAQ
4288,10-02-2021 00:00,24 hrs.,wallstreetbets,CFA,18,18,0,18,3,3,0,1,NASDAQ
4288,10-02-2021 00:00,24 hrs.,wallstreetbets,CGC,240,240,0,240,4,105,14,4,NASDAQ
4288,10-02-2021 00:00,24 hrs.,wallstreetbets,DYN,6,0,6,-6,1,1,0,1,NASDAQ
4288,10-02-2021 00:00,24 hrs.,wallstreetbets,FUV,6,6,0,6,1,1,0,1,NASDAQ
4288,10-02-2021 00:00,24 hrs.,wallstreetbets,HAS,38,26,12,14,6,6,2,6,NASDAQ
4288,10-02-2021 00:00,24 hrs.,wallstreetbets,IDN,6,6,0,6,1,1,0,1,NASDAQ
4288,10-02-2021 00:00,24 hrs.,wallstreetbets,III,1036,0,1036,-1036,1,426,180,1,NASDAQ
4288,10-02-2021 00:00,24 hrs.,wallstreetbets,INO,13,13,0,13,2,2,1,2,NASDAQ
4288,10-02-2021 00:00,24 hrs.,wallstreetbets,JFU,6,0,6,-6,1,1,0,1,NASDAQ
4288,10-02-2021 00:00,24 hrs.,wallstreetbets,MGI,12,12,0,12,2,2,0,1,NASDAQ
4288,10-02-2021 00:00,24 hrs.,wallstreetbets,NPA,12,12,0,12,2,2,0,2,NASDAQ
4288,10-02-2021 00:00,24 hrs.,wallstreetbets,OGI,108,108,0,108,18,18,0,16,NASDAQ
4288,10-02-2021 00:00,24 hrs.,wallstreetbets,OPK,6,6,0,6,1,1,0,1,NASDAQ
4288,10-02-2021 00:00,24 hrs.,wallstreetbets,PTE,6,6,0,6,1,1,0,1,NASDAQ
4288,10-02-2021 00:00,24 hrs.,wallstreetbets,RUN,18,12,6,6,3,3,0,3,NASDAQ
4288,10-02-2021 00:00,24 hrs.,wallstreetbets,SFT,6,6,0,6,1,1,0,1,NASDAQ
4288,10-02-2021 00:00,24 hrs.,wallstreetbets,UAE,7,7,0,7,1,1,1,1,NASDAQ
4288,10-02-2021 00:00,24 hrs.,wallstreetbets,UBX,12,12,0,12,2,2,0,2,NASDAQ
4288,10-02-2021 00:00,24 hrs.,wallstreetbets,VFF,44,44,0,44,2,14,8,2,NASDAQ
4288,10-02-2021 00:00,24 hrs.,wallstreetbets,AAOI,6,6,0,6,1,1,0,1,NASDAQ
4288,10-02-2021 00:00,24 hrs.,wallstreetbets,BBY,6,0,6,-6,1,1,0,1,NYSE
4288,10-02-2021 00:00,24 hrs.,wallstreetbets,BCH,6,0,6,-6,1,1,0,1,NYSE
4288,10-02-2021 00:00,24 hrs.,wallstreetbets,BFT,6,0,6,-6,1,1,0,1,NYSE
4288,10-02-2021 00:00,24 hrs.,wallstreetbets,BTT,189,72,117,-45,31,31,3,19,NYSE
4288,10-02-2021 00:00,24 hrs.,wallstreetbets,CBD,12,12,0,12,2,2,0,2,NYSE
4288,10-02-2021 00:00,24 hrs.,wallstreetbets,CBO,222,222,0,222,1,102,14,1,NYSE
4288,10-02-2021 00:00,24 hrs.,wallstreetbets,CDR,6,6,0,6,1,1,0,1,NYSE
4288,10-02-2021 00:00,24 hrs.,wallstreetbets,CIG,6,0,6,-6,1,1,0,1,NYSE
4288,10-02-2021 00:00,24 hrs.,wallstreetbets,CNC,222,222,0,222,1,102,14,1,NYSE
4288,10-02-2021 00:00,24 hrs.,wallstreetbets,COR,4,0,4,-4,1,0,0,1,NYSE
4288,10-02-2021 00:00,24 hrs.,wallstreetbets,CTT,6,6,0,6,1,1,0,1,NYSE
4288,10-02-2021 00:00,24 hrs.,wallstreetbets,CVE,6,6,0,6,1,1,0,1,NYSE
4288,10-02-2021 00:00,24 hrs.,wallstreetbets,CVS,2903,0,2903,-2903,1,1297,305,1,NYSE
4288,10-02-2021 00:00,24 hrs.,wallstreetbets,CXW,6,6,0,6,1,1,0,1,NYSE
4288,10-02-2021 00:00,24 hrs.,wallstreetbets,DDD,6,6,0,6,1,1,0,1,NYSE
4288,10-02-2021 00:00,24 hrs.,wallstreetbets,DIS,628,628,0,628,1,236,152,1,NYSE
4288,10-02-2021 00:00,24 hrs.,wallstreetbets,EGO,6,6,0,6,1,1,0,1,NYSE
4288,10-02-2021 00:00,24 hrs.,wallstreetbets,EMO,6,0,6,-6,1,1,0,1,NYSE
4288,10-02-2021 00:00,24 hrs.,wallstreetbets,EPC,222,222,0,222,1,102,14,1,NYSE
4288,10-02-2021 00:00,24 hrs.,wallstreetbets,EPR,6,6,0,6,1,1,0,1,NYSE
4288,10-02-2021 00:00,24 hrs.,wallstreetbets,ERJ,6,6,0,6,1,1,0,1,NYSE
4288,10-02-2021 00:00,24 hrs.,wallstreetbets,FIT,6,6,0,6,1,1,0,1,NYSE
4288,10-02-2021 00:00,24 hrs.,wallstreetbets,FLT,18,18,0,18,3,3,0,3,NYSE
4288,10-02-2021 00:00,24 hrs.,wallstreetbets,FSM,12,12,0,12,2,2,0,2,NYSE
4288,10-02-2021 00:00,24 hrs.,wallstreetbets,GEO,7,7,0,7,1,1,1,1,NYSE
4288,10-02-2021 00:00,24 hrs.,wallstreetbets,GME,182881,91494,91387,107,450,68801,43479,358,NYSE
4288,10-02-2021 00:00,24 hrs.,wallstreetbets,GNE,6,6,0,6,1,1,0,1,NYSE
4288,10-02-2021 00:00,24 hrs.,wallstreetbets,GPK,5177,5177,0,5177,2,2505,159,1,NYSE
4288,10-02-2021 00:00,24 hrs.,wallstreetbets,HBI,222,222,0,222,1,102,14,1,NYSE
4288,10-02-2021 00:00,24 hrs.,wallstreetbets,ICD,6,6,0,6,1,1,0,1,NYSE
4288,10-02-2021 00:00,24 hrs.,wallstreetbets,IVR,6,0,6,-6,1,1,0,1,NYSE
4288,10-02-2021 00:00,24 hrs.,wallstreetbets,KEY,6,0,6,-6,1,1,0,1,NYSE
4288,10-02-2021 00:00,24 hrs.,wallstreetbets,KGC,6,6,0,6,1,1,0,1,NYSE
4288,10-02-2021 00:00,24 hrs.,wallstreetbets,LLY,222,222,0,222,1,102,14,1,NYSE
4288,10-02-2021 00:00,24 hrs.,wallstreetbets,LMT,6,0,6,-6,1,1,0,1,NYSE
4288,10-02-2021 00:00,24 hrs.,wallstreetbets,LOW,539,6,533,-527,2,194,143,2,NYSE
4288,10-02-2021 00:00,24 hrs.,wallstreetbets,LUV,6,0,6,-6,1,1,0,1,NYSE
4288,10-02-2021 00:00,24 hrs.,wallstreetbets,MAC,6,6,0,6,1,1,0,1,NYSE
4288,10-02-2021 00:00,24 hrs.,wallstreetbets,MPX,6,6,0,6,1,1,0,1,NYSE
4288,10-02-2021 00:00,24 hrs.,wallstreetbets,MRO,6,6,0,6,1,1,0,1,NYSE
4288,10-02-2021 00:00,24 hrs.,wallstreetbets,MSM,4,4,0,4,1,0,0,1,NYSE
4288,10-02-2021 00:00,24 hrs.,wallstreetbets,NET,6,6,0,6,1,1,0,1,NYSE
4288,10-02-2021 00:00,24 hrs.,wallstreetbets,NIO,37,37,0,37,6,6,1,5,NYSE
4288,10-02-2021 00:00,24 hrs.,wallstreetbets,NLS,6,6,0,6,1,1,0,1,NYSE
4288,10-02-2021 00:00,24 hrs.,wallstreetbets,NOK,5453,5398,55,5343,27,2473,399,25,NYSE
4288,10-02-2021 00:00,24 hrs.,wallstreetbets,NRZ,6,6,0,6,1,1,0,1,NYSE
4288,10-02-2021 00:00,24 hrs.,wallstreetbets,ORC,6,0,6,-6,1,1,0,1,NYSE
4288,10-02-2021 00:00,24 hrs.,wallstreetbets,PEI,6,0,6,-6,1,1,0,1,NYSE
4288,10-02-2021 00:00,24 hrs.,wallstreetbets,PFE,6,6,0,6,1,1,0,1,NYSE
4288,10-02-2021 00:00,24 hrs.,wallstreetbets,PSA,5617,6,5611,-5605,3,2546,513,3,NYSE
4288,10-02-2021 00:00,24 hrs.,wallstreetbets,PSX,6,6,0,6,1,1,0,1,NYSE
4288,10-02-2021 00:00,24 hrs.,wallstreetbets,RIG,6,0,6,-6,1,1,0,1,NYSE
4288,10-02-2021 00:00,24 hrs.,wallstreetbets,RKT,1074,24,1050,-1026,7,432,182,7,NYSE
4288,10-02-2021 00:00,24 hrs.,wallstreetbets,RSI,12,6,6,0,2,2,0,2,NYSE
4288,10-02-2021 00:00,24 hrs.,wallstreetbets,RTX,6,6,0,6,1,1,0,1,NYSE
4288,10-02-2021 00:00,24 hrs.,wallstreetbets,SKY,12,6,6,0,2,2,0,2,NYSE
4288,10-02-2021 00:00,24 hrs.,wallstreetbets,SNE,12,12,0,12,2,2,0,1,NYSE
4288,10-02-2021 00:00,24 hrs.,wallstreetbets,SOS,19,13,6,7,3,3,1,3,NYSE
4288,10-02-2021 00:00,24 hrs.,wallstreetbets,SPG,228,228,0,228,2,103,14,2,NYSE
4288,10-02-2021 00:00,24 hrs.,wallstreetbets,SPH,6,6,0,6,1,1,0,1,NYSE
4288,10-02-2021 00:00,24 hrs.,wallstreetbets,SUN,6,0,6,-6,1,1,0,1,NYSE
4288,10-02-2021 00:00,24 hrs.,wallstreetbets,SWX,6,6,0,6,1,1,0,1,NYSE
4288,10-02-2021 00:00,24 hrs.,wallstreetbets,TDC,384,44,340,-296,9,144,60,5,NYSE
4288,10-02-2021 00:00,24 hrs.,wallstreetbets,THC,6,6,0,6,1,1,0,1,NYSE
4288,10-02-2021 00:00,24 hrs.,wallstreetbets,BLOZF,6,6,0,6,1,1,0,1,OTC
4288,10-02-2021 00:00,24 hrs.,wallstreetbets,CRLBF,6,6,0,6,1,1,0,1,OTC
4288,10-02-2021 00:00,24 hrs.,wallstreetbets,EDTXF,6,6,0,6,1,1,0,1,OTC
4288,10-02-2021 00:00,24 hrs.,wallstreetbets,FDVRF,6,6,0,6,1,1,0,1,OTC
4288,10-02-2021 00:00,24 hrs.,wallstreetbets,FFNTF,6,0,6,-6,1,1,0,1,OTC
4288,10-02-2021 00:00,24 hrs.,wallstreetbets,FNMAT,6,6,0,6,1,1,0,1,OTC
4288,10-02-2021 00:00,24 hrs.,wallstreetbets,GAYMF,13,7,6,1,2,2,1,2,OTC
4288,10-02-2021 00:00,24 hrs.,wallstreetbets,HITIF,12,6,6,0,2,2,0,2,OTC
4288,10-02-2021 00:00,24 hrs.,wallstreetbets,JETMF,6,6,0,6,1,1,0,1,OTC
4288,10-02-2021 00:00,24 hrs.,wallstreetbets,JUVAF,7,7,0,7,1,1,1,1,OTC
4288,10-02-2021 00:00,24 hrs.,wallstreetbets,KGEIF,6,6,0,6,1,1,0,1,OTC
4288,10-02-2021 00:00,24 hrs.,wallstreetbets,LXXGF,7,7,0,7,1,1,1,1,OTC
4288,10-02-2021 00:00,24 hrs.,wallstreetbets,MMEDF,12,0,12,-12,2,2,0,2,OTC
4288,10-02-2021 00:00,24 hrs.,wallstreetbets,MMNFF,25,13,12,1,4,4,1,4,OTC
4288,10-02-2021 00:00,24 hrs.,wallstreetbets,OTGLY,6,6,0,6,1,1,0,1,OTC
4288,10-02-2021 00:00,24 hrs.,wallstreetbets,RAZFF,21,0,21,-21,3,2,5,1,OTC
4288,10-02-2021 00:00,24 hrs.,wallstreetbets,REZZF,6,6,0,6,1,1,0,1,OTC
4288,10-02-2021 00:00,24 hrs.,wallstreetbets,RKMSF,6,0,6,-6,1,1,0,1,OTC
4288,10-02-2021 00:00,24 hrs.,wallstreetbets,RLFTF,6,0,6,-6,1,1,0,1,OTC
4288,10-02-2021 00:00,24 hrs.,wallstreetbets,RYCEY,12,12,0,12,2,2,0,2,OTC
4288,10-02-2021 00:00,24 hrs.,wallstreetbets,SHLDQ,6,6,0,6,1,1,0,1,OTC
4288,10-02-2021 00:00,24 hrs.,wallstreetbets,SPONF,12,0,12,-12,2,2,0,1,OTC
4288,10-02-2021 00:00,24 hrs.,wallstreetbets,SPRWF,7,7,0,7,1,1,1,1,OTC
4288,10-02-2021 00:00,24 hrs.,wallstreetbets,TAKOF,6,0,6,-6,1,1,0,1,OTC
4288,10-02-2021 00:00,24 hrs.,wallstreetbets,TGODF,25,25,0,25,4,4,1,1,OTC
4288,10-02-2021 00:00,24 hrs.,wallstreetbets,ZBISF,37,37,0,37,5,4,9,4,OTC
4288,10-02-2021 00:00,24 hrs.,wallstreetbets,ACY,6,0,6,-6,1,1,0,1,AMEX
4288,10-02-2021 00:00,24 hrs.,wallstreetbets,AMS,6,6,0,6,1,1,0,1,AMEX
4288,10-02-2021 00:00,24 hrs.,wallstreetbets,APT,12,12,0,12,2,2,0,2,AMEX
4288,10-02-2021 00:00,24 hrs.,wallstreetbets,CEI,18,6,12,-6,3,3,0,2,AMEX
4288,10-02-2021 00:00,24 hrs.,wallstreetbets,CVM,6,0,6,-6,1,1,0,1,AMEX
4288,10-02-2021 00:00,24 hrs.,wallstreetbets,DNN,19,13,6,7,3,3,1,3,AMEX
4288,10-02-2021 00:00,24 hrs.,wallstreetbets,DPW,6,0,6,-6,1,1,0,1,AMEX
4288,10-02-2021 00:00,24 hrs.,wallstreetbets,DSS,6,0,6,-6,1,1,0,1,AMEX
4288,10-02-2021 00:00,24 hrs.,wallstreetbets,GLU,7,7,0,7,1,1,1,1,AMEX
4288,10-02-2021 00:00,24 hrs.,wallstreetbets,IGC,18,18,0,18,3,3,0,3,AMEX
4288,10-02-2021 00:00,24 hrs.,wallstreetbets,ISR,12,12,0,12,2,2,0,2,AMEX
4288,10-02-2021 00:00,24 hrs.,wallstreetbets,ITP,12,6,6,0,2,2,0,2,AMEX
4288,10-02-2021 00:00,24 hrs.,wallstreetbets,MXC,6,6,0,6,1,1,0,1,AMEX
4288,10-02-2021 00:00,24 hrs.,wallstreetbets,NAK,18,12,6,6,3,3,0,2,AMEX
4288,10-02-2021 00:00,24 hrs.,wallstreetbets,NBA,222,222,0,222,1,102,14,1,AMEX
4288,10-02-2021 00:00,24 hrs.,wallstreetbets,PTN,6,6,0,6,1,1,0,1,AMEX
4288,10-02-2021 00:00,24 hrs.,wallstreetbets,REI,12,6,6,0,2,2,0,2,AMEX
4288,10-02-2021 00:00,24 hrs.,wallstreetbets,SYN,6,0,6,-6,1,1,0,1,AMEX
4288,10-02-2021 00:00,24 hrs.,wallstreetbets,TRX,30,18,12,6,5,5,0,5,AMEX
4288,10-02-2021 00:00,24 hrs.,wallstreetbets,UEC,6,6,0,6,1,1,0,1,AMEX
4288,10-02-2021 00:00,24 hrs.,wallstreetbets,ZOM,279,67,212,-145,16,84,47,15,AMEX
4288,10-02-2021 00:00,24 hrs.,wallstreetbets,AMBO,6,6,0,6,1,1,0,1,AMEX
4288,10-02-2021 00:00,24 hrs.,wallstreetbets,AMPE,6,6,0,6,1,1,0,1,AMEX
4288,10-02-2021 00:00,24 hrs.,wallstreetbets,CPHI,18,18,0,18,3,3,0,2,AMEX
4288,10-02-2021 00:00,24 hrs.,wallstreetbets,CRMD,6,6,0,6,1,1,0,1,AMEX
4288,10-02-2021 00:00,24 hrs.,wallstreetbets,GOED,6,0,6,-6,1,1,0,1,AMEX
4288,10-02-2021 00:00,24 hrs.,wallstreetbets,GSAT,264,264,0,264,12,89,38,11,AMEX
4288,10-02-2021 00:00,24 hrs.,wallstreetbets,IBIO,6,6,0,6,1,1,0,1,AMEX
4288,10-02-2021 00:00,24 hrs.,wallstreetbets,INUV,6,6,0,6,1,1,0,1,AMEX
4288,10-02-2021 00:00,24 hrs.,wallstreetbets,NSPR,18,6,12,-6,3,3,0,3,AMEX
4288,10-02-2021 00:00,24 hrs.,wallstreetbets,OGEN,24,12,12,0,4,4,0,4,AMEX
4288,10-02-2021 00:00,24 hrs.,wallstreetbets,SENS,24,18,6,12,4,4,0,4,AMEX
4288,10-02-2021 00:00,24 hrs.,wallstreetbets,UAVS,6,6,0,6,1,1,0,1,AMEX
4288,10-02-2021 00:00,24 hrs.,wallstreetbets,ACB,79,55,24,31,13,13,1,11,NYSE
4288,10-02-2021 00:00,24 hrs.,wallstreetbets,AES,6,0,6,-6,1,1,0,1,NYSE
4288,10-02-2021 00:00,24 hrs.,wallstreetbets,AMC,39305,38267,1038,37229,238,17421,3511,206,NYSE
4288,10-02-2021 00:00,24 hrs.,wallstreetbets,AME,7,7,0,7,1,1,1,1,NYSE
4288,10-02-2021 00:00,24 hrs.,wallstreetbets,ASA,6,0,6,-6,1,1,0,1,NYSE
4288,10-02-2021 00:00,24 hrs.,wallstreetbets,HQGE,6,0,6,-6,1,1,0,1,OTC
4288,10-02-2021 00:00,24 hrs.,wallstreetbets,HYSR,6,0,6,-6,1,1,0,1,OTC
4288,10-02-2021 00:00,24 hrs.,wallstreetbets,IGXT,6,0,6,-6,1,1,0,1,OTC
4288,10-02-2021 00:00,24 hrs.,wallstreetbets,IMJX,6,6,0,6,1,1,0,1,OTC
4288,10-02-2021 00:00,24 hrs.,wallstreetbets,INCC,6,0,6,-6,1,1,0,1,OTC
4288,10-02-2021 00:00,24 hrs.,wallstreetbets,INKW,6,0,6,-6,1,1,0,1,OTC
4288,10-02-2021 00:00,24 hrs.,wallstreetbets,INND,12,12,0,12,2,2,0,2,OTC
4288,10-02-2021 00:00,24 hrs.,wallstreetbets,IPIX,6,0,6,-6,1,1,0,1,OTC
4288,10-02-2021 00:00,24 hrs.,wallstreetbets,IPWG,6,6,0,6,1,1,0,1,OTC
4288,10-02-2021 00:00,24 hrs.,wallstreetbets,JETR,6,0,6,-6,1,1,0,1,OTC
4288,10-02-2021 00:00,24 hrs.,wallstreetbets,KPAY,12,12,0,12,2,2,0,1,OTC
4288,10-02-2021 00:00,24 hrs.,wallstreetbets,KWBT,6,6,0,6,1,1,0,1,OTC
4288,10-02-2021 00:00,24 hrs.,wallstreetbets,KYNC,6,6,0,6,1,1,0,1,OTC
4288,10-02-2021 00:00,24 hrs.,wallstreetbets,LINK,234,228,6,222,3,104,14,3,OTC
4288,10-02-2021 00:00,24 hrs.,wallstreetbets,LITH,6,6,0,6,1,1,0,1,OTC
4288,10-02-2021 00:00,24 hrs.,wallstreetbets,MCOA,24,12,12,0,4,4,0,4,OTC
4288,10-02-2021 00:00,24 hrs.,wallstreetbets,MDCN,9,0,9,-9,1,2,1,1,OTC
4288,10-02-2021 00:00,24 hrs.,wallstreetbets,MGTI,6,6,0,6,1,1,0,1,OTC
4288,10-02-2021 00:00,24 hrs.,wallstreetbets,MINE,24,24,0,24,4,4,0,4,OTC
4288,10-02-2021 00:00,24 hrs.,wallstreetbets,MJNA,19,19,0,19,3,3,1,3,OTC
4288,10-02-2021 00:00,24 hrs.,wallstreetbets,MMEX,6,6,0,6,1,1,0,1,OTC
4288,10-02-2021 00:00,24 hrs.,wallstreetbets,MOST,24,6,18,-12,4,4,0,4,OTC
4288,10-02-2021 00:00,24 hrs.,wallstreetbets,MSPC,18,18,0,18,3,3,0,2,OTC
4288,10-02-2021 00:00,24 hrs.,wallstreetbets,NGBL,6,6,0,6,1,1,0,1,OTC
4288,10-02-2021 00:00,24 hrs.,wallstreetbets,NMTC,6,6,0,6,1,1,0,1,OTC
4288,10-02-2021 00:00,24 hrs.,wallstreetbets,NTRR,6,6,0,6,1,1,0,1,OTC
4288,10-02-2021 00:00,24 hrs.,wallstreetbets,NUGS,6,6,0,6,1,1,0,1,OTC
4288,10-02-2021 00:00,24 hrs.,wallstreetbets,NWBO,6,0,6,-6,1,1,0,1,OTC
4288,10-02-2021 00:00,24 hrs.,wallstreetbets,OZSC,24,12,12,0,4,4,0,4,OTC
4288,10-02-2021 00:00,24 hrs.,wallstreetbets,PHMB,12,12,0,12,2,2,0,2,OTC
4288,10-02-2021 00:00,24 hrs.,wallstreetbets,PHOT,24,24,0,24,4,4,0,2,OTC
4288,10-02-2021 00:00,24 hrs.,wallstreetbets,PONT,6,6,0,6,1,1,0,1,OTC
4288,10-02-2021 00:00,24 hrs.,wallstreetbets,PPJE,6,6,0,6,1,1,0,1,OTC
4288,10-02-2021 00:00,24 hrs.,wallstreetbets,PURA,6,6,0,6,1,1,0,1,OTC
4288,10-02-2021 00:00,24 hrs.,wallstreetbets,QBIO,19,19,0,19,3,3,1,1,OTC
4288,10-02-2021 00:00,24 hrs.,wallstreetbets,RSHN,6,0,6,-6,1,1,0,1,OTC
4288,10-02-2021 00:00,24 hrs.,wallstreetbets,SHMP,6,6,0,6,1,1,0,1,OTC
4288,10-02-2021 00:00,24 hrs.,wallstreetbets,SHWZ,6,6,0,6,1,1,0,1,OTC
4288,10-02-2021 00:00,24 hrs.,wallstreetbets,SING,12,12,0,12,2,2,0,2,OTC
4288,10-02-2021 00:00,24 hrs.,wallstreetbets,SLOT,6,6,0,6,1,1,0,1,OTC
4288,10-02-2021 00:00,24 hrs.,wallstreetbets,SMVI,6,6,0,6,1,1,0,1,OTC
4288,10-02-2021 00:00,24 hrs.,wallstreetbets,SNRS,6,6,0,6,1,1,0,1,OTC
4288,10-02-2021 00:00,24 hrs.,wallstreetbets,SNRY,12,0,12,-12,2,2,0,2,OTC
4288,10-02-2021 00:00,24 hrs.,wallstreetbets,SNVP,6,6,0,6,1,1,0,1,OTC
4288,10-02-2021 00:00,24 hrs.,wallstreetbets,SRMX,6,6,0,6,1,1,0,1,OTC
4288,10-02-2021 00:00,24 hrs.,wallstreetbets,SUIC,12,12,0,12,2,2,0,1,OTC
4288,10-02-2021 00:00,24 hrs.,wallstreetbets,TIDE,6,6,0,6,1,1,0,1,OTC
4288,10-02-2021 00:00,24 hrs.,wallstreetbets,TLSS,6,6,0,6,1,1,0,1,OTC
4288,10-02-2021 00:00,24 hrs.,wallstreetbets,TMRC,6,6,0,6,1,1,0,1,OTC
4288,10-02-2021 00:00,24 hrs.,wallstreetbets,TSNP,6,0,6,-6,1,1,0,1,OTC
4288,10-02-2021 00:00,24 hrs.,wallstreetbets,TSOI,6,6,0,6,1,1,0,1,OTC
4288,10-02-2021 00:00,24 hrs.,wallstreetbets,TXGE,6,6,0,6,1,1,0,1,OTC
4288,10-02-2021 00:00,24 hrs.,wallstreetbets,TXTM,6,6,0,6,1,1,0,1,OTC
4288,10-02-2021 00:00,24 hrs.,wallstreetbets,USMJ,44,44,0,44,7,8,0,6,OTC
4288,10-02-2021 00:00,24 hrs.,wallstreetbets,UVSE,7,7,0,7,1,1,1,1,OTC
4288,10-02-2021 00:00,24 hrs.,wallstreetbets,VISM,6,6,0,6,1,1,0,1,OTC
4288,10-02-2021 00:00,24 hrs.,wallstreetbets,VPOR,12,12,0,12,2,2,0,1,OTC
4288,10-02-2021 00:00,24 hrs.,wallstreetbets,WCVC,6,6,0,6,1,1,0,1,OTC
4288,10-02-2021 00:00,24 hrs.,wallstreetbets,WHEN,19,13,6,7,3,3,1,3,OTC
4288,10-02-2021 00:00,24 hrs.,wallstreetbets,YRIV,6,6,0,6,1,1,0,1,OTC
4288,10-02-2021 00:00,24 hrs.,wallstreetbets,ZENG,6,6,0,6,1,1,0,1,OTC
4288,10-02-2021 00:00,24 hrs.,wallstreetbets,ABEPF,6,6,0,6,1,1,0,1,OTC
4288,10-02-2021 00:00,24 hrs.,wallstreetbets,AGNPF,6,6,0,6,1,1,0,1,OTC
4288,10-02-2021 00:00,24 hrs.,wallstreetbets,BLIAQ,6,6,0,6,1,1,0,1,OTC
4288,10-02-2021 00:00,24 hrs.,pennystocks,SIOX,12,12,0,12,2,2,0,2,NASDAQ
4288,10-02-2021 00:00,24 hrs.,pennystocks,SNDL,54,54,0,54,9,8,2,8,NASDAQ
4288,10-02-2021 00:00,24 hrs.,pennystocks,SNGX,9,0,9,-9,1,2,1,1,NASDAQ
4288,10-02-2021 00:00,24 hrs.,pennystocks,SONM,6,6,0,6,1,1,0,1,NASDAQ
4288,10-02-2021 00:00,24 hrs.,pennystocks,SRGA,40,40,0,40,2,13,6,2,NASDAQ
4288,10-02-2021 00:00,24 hrs.,pennystocks,STCN,6,6,0,6,1,1,0,1,NASDAQ
4288,10-02-2021 00:00,24 hrs.,pennystocks,TBLT,7,0,7,-7,1,1,1,1,NASDAQ
4288,10-02-2021 00:00,24 hrs.,pennystocks,TECH,50,50,0,50,1,18,10,1,NASDAQ
4288,10-02-2021 00:00,24 hrs.,pennystocks,THRM,7,0,7,-7,1,1,1,1,NASDAQ
4288,10-02-2021 00:00,24 hrs.,pennystocks,TNXP,7874,6184,1690,4494,7,3534,778,7,NASDAQ
4288,10-02-2021 00:00,24 hrs.,pennystocks,TRCH,67,7,60,-53,3,24,7,3,NASDAQ
4288,10-02-2021 00:00,24 hrs.,pennystocks,TRIP,963,0,963,-963,1,413,133,1,NASDAQ
4288,10-02-2021 00:00,24 hrs.,pennystocks,TTOO,505,505,0,505,1,190,121,1,NASDAQ
4288,10-02-2021 00:00,24 hrs.,pennystocks,TYME,17,11,6,5,2,4,1,2,NASDAQ
4288,10-02-2021 00:00,24 hrs.,pennystocks,VERB,6,0,6,-6,1,1,0,1,NASDAQ
4288,10-02-2021 00:00,24 hrs.,pennystocks,VIVE,6,6,0,6,1,1,0,1,NASDAQ
4288,10-02-2021 00:00,24 hrs.,pennystocks,VYNE,6,6,0,6,1,1,0,1,NASDAQ
4288,10-02-2021 00:00,24 hrs.,pennystocks,WTER,8,8,0,8,1,0,4,1,NASDAQ
4288,10-02-2021 00:00,24 hrs.,pennystocks,ZKIN,7,7,0,7,1,1,1,1,NASDAQ
4288,10-02-2021 00:00,24 hrs.,pennystocks,ZSAN,1832,97,1735,-1638,17,768,228,16,NASDAQ
4288,10-02-2021 00:00,24 hrs.,wallstreetbets,ABML,12,0,12,-12,2,2,0,2,OTC
4288,10-02-2021 00:00,24 hrs.,wallstreetbets,ABWN,6,6,0,6,1,1,0,1,OTC
4288,10-02-2021 00:00,24 hrs.,wallstreetbets,ADVT,6,6,0,6,1,1,0,1,OTC
4288,10-02-2021 00:00,24 hrs.,wallstreetbets,AFPW,6,0,6,-6,1,1,0,1,OTC
4288,10-02-2021 00:00,24 hrs.,wallstreetbets,ALPP,6,6,0,6,1,1,0,1,OTC
4288,10-02-2021 00:00,24 hrs.,wallstreetbets,ALYI,7,7,0,7,1,1,1,1,OTC
4288,10-02-2021 00:00,24 hrs.,wallstreetbets,AMBS,6,6,0,6,1,1,0,1,OTC
4288,10-02-2021 00:00,24 hrs.,wallstreetbets,ASTI,30,12,18,-6,5,5,0,3,OTC
4288,10-02-2021 00:00,24 hrs.,wallstreetbets,AWSL,6,6,0,6,1,1,0,1,OTC
4288,10-02-2021 00:00,24 hrs.,wallstreetbets,AXXA,6,0,6,-6,1,1,0,1,OTC
4288,10-02-2021 00:00,24 hrs.,wallstreetbets,BANT,6,6,0,6,1,1,0,1,OTC
4288,10-02-2021 00:00,24 hrs.,wallstreetbets,BCAP,6,6,0,6,1,1,0,1,OTC
4288,10-02-2021 00:00,24 hrs.,wallstreetbets,BFCH,6,0,6,-6,1,1,0,1,OTC
4288,10-02-2021 00:00,24 hrs.,wallstreetbets,BLSP,48,24,24,0,8,8,0,5,OTC
4288,10-02-2021 00:00,24 hrs.,wallstreetbets,BOTY,18,12,6,6,3,3,0,3,OTC
4288,10-02-2021 00:00,24 hrs.,wallstreetbets,BTCS,6,0,6,-6,1,1,0,1,OTC
4288,10-02-2021 00:00,24 hrs.,wallstreetbets,CBTC,12,12,0,12,2,2,0,2,OTC
4288,10-02-2021 00:00,24 hrs.,wallstreetbets,CCTL,6,6,0,6,1,1,0,1,OTC
4288,10-02-2021 00:00,24 hrs.,wallstreetbets,CLWD,12,12,0,12,2,2,0,2,OTC
4288,10-02-2021 00:00,24 hrs.,wallstreetbets,CNXS,6,6,0,6,1,1,0,1,OTC
4288,10-02-2021 00:00,24 hrs.,wallstreetbets,CTTH,6,6,0,6,1,1,0,1,OTC
4288,10-02-2021 00:00,24 hrs.,wallstreetbets,DKAM,6,6,0,6,1,1,0,1,OTC
4288,10-02-2021 00:00,24 hrs.,wallstreetbets,DKMR,13,6,7,-1,2,2,1,2,OTC
4288,10-02-2021 00:00,24 hrs.,wallstreetbets,DPLS,18,18,0,18,3,3,0,2,OTC
4288,10-02-2021 00:00,24 hrs.,wallstreetbets,DRNG,6,0,6,-6,1,1,0,1,OTC
4288,10-02-2021 00:00,24 hrs.,wallstreetbets,DRNK,6,6,0,6,1,1,0,1,OTC
4288,10-02-2021 00:00,24 hrs.,wallstreetbets,DTGI,6,6,0,6,1,1,0,1,OTC
4288,10-02-2021 00:00,24 hrs.,wallstreetbets,ECOS,6,6,0,6,1,1,0,1,OTC
4288,10-02-2021 00:00,24 hrs.,wallstreetbets,EDXC,19,19,0,19,3,3,1,2,OTC
4288,10-02-2021 00:00,24 hrs.,wallstreetbets,ENZC,36,30,6,24,6,6,0,6,OTC
4288,10-02-2021 00:00,24 hrs.,wallstreetbets,ERBB,7,7,0,7,1,1,1,1,OTC
4288,10-02-2021 00:00,24 hrs.,wallstreetbets,ETFM,13,13,0,13,2,2,1,1,OTC
4288,10-02-2021 00:00,24 hrs.,wallstreetbets,EUSP,6,6,0,6,1,1,0,1,OTC
4288,10-02-2021 00:00,24 hrs.,wallstreetbets,EWLL,6,6,0,6,1,1,0,1,OTC
4288,10-02-2021 00:00,24 hrs.,wallstreetbets,FBCD,7,7,0,7,1,1,1,1,OTC
4288,10-02-2021 00:00,24 hrs.,wallstreetbets,FMCC,6,0,6,-6,1,1,0,1,OTC
4288,10-02-2021 00:00,24 hrs.,wallstreetbets,FNMA,6,0,6,-6,1,1,0,1,OTC
4288,10-02-2021 00:00,24 hrs.,wallstreetbets,FPVD,6,6,0,6,1,1,0,1,OTC
4288,10-02-2021 00:00,24 hrs.,wallstreetbets,GAXY,6,6,0,6,1,1,0,1,OTC
4288,10-02-2021 00:00,24 hrs.,wallstreetbets,GBTC,6,6,0,6,1,1,0,1,OTC
4288,10-02-2021 00:00,24 hrs.,wallstreetbets,GTEH,12,0,12,-12,2,2,0,2,OTC
4288,10-02-2021 00:00,24 hrs.,wallstreetbets,GTLL,6,6,0,6,1,1,0,1,OTC
4288,10-02-2021 00:00,24 hrs.,wallstreetbets,HCMC,157,97,60,37,26,26,1,25,OTC
4288,10-02-2021 00:00,24 hrs.,wallstreetbets,HEMP,18,6,12,-6,3,3,0,3,OTC
4288,10-02-2021 00:00,24 hrs.,pennystocks,CGC,963,0,963,-963,1,413,133,1,NASDAQ
4288,10-02-2021 00:00,24 hrs.,pennystocks,III,40,40,0,40,1,8,20,1,NASDAQ
4288,10-02-2021 00:00,24 hrs.,pennystocks,NEO,963,0,963,-963,1,413,133,1,NASDAQ
4288,10-02-2021 00:00,24 hrs.,pennystocks,OGI,14,14,0,14,2,2,2,2,NASDAQ
4288,10-02-2021 00:00,24 hrs.,pennystocks,RUN,7,7,0,7,1,1,1,1,NASDAQ
4288,10-02-2021 00:00,24 hrs.,pennystocks,AAME,6,6,0,6,1,1,0,1,NASDAQ
4288,10-02-2021 00:00,24 hrs.,pennystocks,ABEO,151,23,128,-105,2,56,31,2,NASDAQ
4288,10-02-2021 00:00,24 hrs.,pennystocks,ABUS,7,7,0,7,1,1,1,1,NASDAQ
4288,10-02-2021 00:00,24 hrs.,pennystocks,ACST,7,7,0,7,1,1,1,1,NASDAQ
4288,10-02-2021 00:00,24 hrs.,pennystocks,ADMP,21,21,0,21,1,8,1,1,NASDAQ
4288,10-02-2021 00:00,24 hrs.,pennystocks,ADXS,12,12,0,12,2,2,0,2,NASDAQ
4288,10-02-2021 00:00,24 hrs.,pennystocks,AEZS,23,23,0,23,4,3,1,3,NASDAQ
4288,10-02-2021 00:00,24 hrs.,pennystocks,AGTC,6,6,0,6,1,1,0,1,NASDAQ
4288,10-02-2021 00:00,24 hrs.,pennystocks,AKBA,102,0,102,-102,1,36,26,1,NASDAQ
4288,10-02-2021 00:00,24 hrs.,pennystocks,APWC,6,0,6,-6,1,1,0,1,NASDAQ
4288,10-02-2021 00:00,24 hrs.,pennystocks,AREC,7,7,0,7,1,1,1,1,NASDAQ
4288,10-02-2021 00:00,24 hrs.,pennystocks,ARPO,22,0,22,-22,1,6,6,1,NASDAQ
4288,10-02-2021 00:00,24 hrs.,pennystocks,ASTC,7,0,7,-7,1,1,1,1,NASDAQ
4288,10-02-2021 00:00,24 hrs.,pennystocks,ATOS,517,517,0,517,3,192,121,3,NASDAQ
4288,10-02-2021 00:00,24 hrs.,pennystocks,AUVI,6,6,0,6,1,1,0,1,NASDAQ
4288,10-02-2021 00:00,24 hrs.,pennystocks,BIOL,19,6,13,-7,3,3,1,3,NASDAQ
4288,10-02-2021 00:00,24 hrs.,pennystocks,BKEP,7,7,0,7,1,1,1,1,NASDAQ
4288,10-02-2021 00:00,24 hrs.,pennystocks,BSQR,123,0,123,-123,1,49,21,1,NASDAQ
4288,10-02-2021 00:00,24 hrs.,pennystocks,BTBT,6,6,0,6,1,1,0,1,NASDAQ
4288,10-02-2021 00:00,24 hrs.,pennystocks,BXRX,13,13,0,13,2,2,1,2,NASDAQ
4288,10-02-2021 00:00,24 hrs.,pennystocks,CHEK,6,6,0,6,1,1,0,1,NASDAQ
4288,10-02-2021 00:00,24 hrs.,pennystocks,CHMA,9,9,0,9,1,2,1,1,NASDAQ
4288,10-02-2021 00:00,24 hrs.,pennystocks,CIDM,88,13,75,-62,3,19,38,3,NASDAQ
4288,10-02-2021 00:00,24 hrs.,pennystocks,CLBS,127,127,0,127,1,51,21,1,NASDAQ
4288,10-02-2021 00:00,24 hrs.,pennystocks,CLNE,6,0,6,-6,1,1,0,1,NASDAQ
4288,10-02-2021 00:00,24 hrs.,pennystocks,CLVR,9,9,0,9,1,0,5,1,NASDAQ
4288,10-02-2021 00:00,24 hrs.,pennystocks,CMPS,963,0,963,-963,1,413,133,1,NASDAQ
4288,10-02-2021 00:00,24 hrs.,pennystocks,CSCW,6,6,0,6,1,1,0,1,NASDAQ
4288,10-02-2021 00:00,24 hrs.,pennystocks,CTRM,149,39,110,-71,11,26,53,11,NASDAQ
4288,10-02-2021 00:00,24 hrs.,pennystocks,CTXR,16,16,0,16,1,4,4,1,NASDAQ
4288,10-02-2021 00:00,24 hrs.,pennystocks,EDIT,73,73,0,73,1,28,13,1,NASDAQ
4288,10-02-2021 00:00,24 hrs.,pennystocks,GHSI,88,13,75,-62,2,20,40,2,NASDAQ
4288,10-02-2021 00:00,24 hrs.,pennystocks,GOLD,50,50,0,50,1,18,10,1,NASDAQ
4288,10-02-2021 00:00,24 hrs.,pennystocks,GOVX,6,6,0,6,1,1,0,1,NASDAQ
4288,10-02-2021 00:00,24 hrs.,pennystocks,IDEX,7,0,7,-7,1,1,1,1,NASDAQ
4288,10-02-2021 00:00,24 hrs.,pennystocks,INFI,6,0,6,-6,1,1,0,1,NASDAQ
4288,10-02-2021 00:00,24 hrs.,pennystocks,INFO,6,0,6,-6,1,1,0,1,NASDAQ
4288,10-02-2021 00:00,24 hrs.,pennystocks,INPX,7,7,0,7,1,1,1,1,NASDAQ
4288,10-02-2021 00:00,24 hrs.,pennystocks,INVE,6,6,0,6,1,1,0,1,NASDAQ
4288,10-02-2021 00:00,24 hrs.,pennystocks,ITRM,6,0,6,-6,1,1,0,1,NASDAQ
4288,10-02-2021 00:00,24 hrs.,pennystocks,JAGX,8,8,0,8,1,1,2,1,NASDAQ
4288,10-02-2021 00:00,24 hrs.,pennystocks,KTRA,560,560,0,560,1,251,54,1,NASDAQ
4288,10-02-2021 00:00,24 hrs.,pennystocks,LPCN,399,0,399,-399,1,172,51,1,NASDAQ
4288,10-02-2021 00:00,24 hrs.,pennystocks,MARA,6,6,0,6,1,1,0,1,NASDAQ
4288,10-02-2021 00:00,24 hrs.,pennystocks,NAKD,27,13,14,-1,3,2,11,3,NASDAQ
4288,10-02-2021 00:00,24 hrs.,pennystocks,NMTR,13,13,0,13,2,2,1,2,NASDAQ
4288,10-02-2021 00:00,24 hrs.,pennystocks,NOVN,279,61,218,-157,6,92,71,6,NASDAQ
4288,10-02-2021 00:00,24 hrs.,pennystocks,NTEC,6,6,0,6,1,1,0,1,NASDAQ
4288,10-02-2021 00:00,24 hrs.,pennystocks,OCGN,2274,571,1703,-1132,13,922,378,13,NASDAQ
4288,10-02-2021 00:00,24 hrs.,pennystocks,ONTX,19,12,7,5,3,3,1,3,NASDAQ
4288,10-02-2021 00:00,24 hrs.,pennystocks,OPGN,14,14,0,14,1,4,2,1,NASDAQ
4288,10-02-2021 00:00,24 hrs.,pennystocks,PAVM,12,12,0,12,2,2,0,2,NASDAQ
4288,10-02-2021 00:00,24 hrs.,pennystocks,PLAY,10,10,0,10,1,1,4,1,NASDAQ
4288,10-02-2021 00:00,24 hrs.,pennystocks,PNNT,7,0,7,-7,1,1,1,1,NASDAQ
4288,10-02-2021 00:00,24 hrs.,pennystocks,RIGL,7,7,0,7,1,1,1,1,NASDAQ
4288,10-02-2021 00:00,24 hrs.,pennystocks,RIOT,12,6,6,0,2,2,0,2,NASDAQ
4288,10-02-2021 00:00,24 hrs.,pennystocks,RMTI,14,14,0,14,2,2,2,2,NASDAQ
4288,10-02-2021 00:00,24 hrs.,pennystocks,SAVA,57,0,57,-57,1,8,37,1,NASDAQ
4288,10-02-2021 00:00,24 hrs.,pennystocks,SEEL,969,0,969,-969,2,414,133,2,NASDAQ
4288,10-02-2021 00:00,24 hrs.,pennystocks,HITIF,379,379,0,379,3,111,145,3,OTC
4288,10-02-2021 00:00,24 hrs.,pennystocks,HLLPF,15,15,0,15,1,5,1,1,OTC
4288,10-02-2021 00:00,24 hrs.,pennystocks,HVBTF,6,6,0,6,1,1,0,1,OTC
4288,10-02-2021 00:00,24 hrs.,pennystocks,LKYSF,963,0,963,-963,1,413,133,1,OTC
4288,10-02-2021 00:00,24 hrs.,pennystocks,LLKKF,25,6,19,-13,4,4,1,4,OTC
4288,10-02-2021 00:00,24 hrs.,pennystocks,LXXGF,6,6,0,6,1,1,0,1,OTC
4288,10-02-2021 00:00,24 hrs.,pennystocks,MGROF,6,6,0,6,1,1,0,1,OTC
4288,10-02-2021 00:00,24 hrs.,pennystocks,MMEDF,977,14,963,-949,3,415,135,2,OTC
4288,10-02-2021 00:00,24 hrs.,pennystocks,MMNFF,6,6,0,6,1,1,0,1,OTC
4288,10-02-2021 00:00,24 hrs.,pennystocks,MNXXF,71,71,0,71,1,30,7,1,OTC
4288,10-02-2021 00:00,24 hrs.,pennystocks,MPXOF,6,0,6,-6,1,1,0,1,OTC
4288,10-02-2021 00:00,24 hrs.,pennystocks,NXGWF,366,366,0,366,1,109,144,1,OTC
4288,10-02-2021 00:00,24 hrs.,pennystocks,RAZFF,45,45,0,45,1,16,9,1,OTC
4288,10-02-2021 00:00,24 hrs.,pennystocks,RECAF,7,7,0,7,1,1,1,1,OTC
4288,10-02-2021 00:00,24 hrs.,pennystocks,REZZF,6,0,6,-6,1,1,0,1,OTC
4288,10-02-2021 00:00,24 hrs.,pennystocks,RLFTF,99,92,7,85,5,24,31,4,OTC
4288,10-02-2021 00:00,24 hrs.,pennystocks,RLLCF,6,6,0,6,1,1,0,1,OTC
4288,10-02-2021 00:00,24 hrs.,pennystocks,RVVTF,983,20,963,-943,4,416,135,3,OTC
4288,10-02-2021 00:00,24 hrs.,pennystocks,RYCEY,7,7,0,7,1,1,1,1,OTC
4288,10-02-2021 00:00,24 hrs.,pennystocks,TFECY,18,0,18,-18,3,3,0,1,OTC
4288,10-02-2021 00:00,24 hrs.,pennystocks,TGODF,7,7,0,7,1,1,1,1,OTC
4288,10-02-2021 00:00,24 hrs.,pennystocks,TLOFF,6,0,6,-6,1,1,0,1,OTC
4288,10-02-2021 00:00,24 hrs.,pennystocks,TRUFF,963,0,963,-963,1,413,133,1,OTC
4288,10-02-2021 00:00,24 hrs.,pennystocks,UBMRF,59,0,59,-59,1,24,7,1,OTC
4288,10-02-2021 00:00,24 hrs.,pennystocks,UCCPF,6,0,6,-6,1,1,0,1,OTC
4288,10-02-2021 00:00,24 hrs.,pennystocks,WDDMF,366,366,0,366,1,109,144,1,OTC
4288,10-02-2021 00:00,24 hrs.,pennystocks,DNN,36,36,0,36,1,8,16,1,AMEX
4288,10-02-2021 00:00,24 hrs.,pennystocks,DSS,6,6,0,6,1,1,0,1,AMEX
4288,10-02-2021 00:00,24 hrs.,pennystocks,FCO,18,18,0,18,3,3,0,1,AMEX
4288,10-02-2021 00:00,24 hrs.,pennystocks,GTE,187,6,181,-175,2,82,15,2,AMEX
4288,10-02-2021 00:00,24 hrs.,pennystocks,IGC,7,7,0,7,1,1,1,1,AMEX
4288,10-02-2021 00:00,24 hrs.,pennystocks,ITP,1846,228,1618,-1390,3,802,230,3,AMEX
4288,10-02-2021 00:00,24 hrs.,pennystocks,KIQ,7,0,7,-7,1,1,1,1,AMEX
4288,10-02-2021 00:00,24 hrs.,pennystocks,MCF,6,6,0,6,1,1,0,1,AMEX
4288,10-02-2021 00:00,24 hrs.,pennystocks,PLX,78,78,0,78,1,32,10,1,AMEX
4288,10-02-2021 00:00,24 hrs.,pennystocks,REI,6,0,6,-6,1,1,0,1,AMEX
4288,10-02-2021 00:00,24 hrs.,pennystocks,SYN,129,129,0,129,1,54,17,1,AMEX
4288,10-02-2021 00:00,24 hrs.,pennystocks,UEC,6,6,0,6,1,1,0,1,AMEX
4288,10-02-2021 00:00,24 hrs.,pennystocks,ZOM,573,566,7,559,6,201,147,5,AMEX
4288,10-02-2021 00:00,24 hrs.,pennystocks,ARMP,6,0,6,-6,1,1,0,1,AMEX
4288,10-02-2021 00:00,24 hrs.,pennystocks,GSAT,19,19,0,19,2,1,9,2,AMEX
4288,10-02-2021 00:00,24 hrs.,pennystocks,LCTX,6,0,6,-6,1,1,0,1,AMEX
4288,10-02-2021 00:00,24 hrs.,pennystocks,NSPR,23,0,23,-23,2,4,7,2,AMEX
4288,10-02-2021 00:00,24 hrs.,pennystocks,OGEN,6,6,0,6,1,1,0,1,AMEX
4288,10-02-2021 00:00,24 hrs.,pennystocks,SENS,37,6,31,-25,4,8,5,4,AMEX
4288,10-02-2021 00:00,24 hrs.,pennystocks,SNMP,6,0,6,-6,1,1,0,1,AMEX
4288,10-02-2021 00:00,24 hrs.,pennystocks,TMBR,31,0,31,-31,1,8,11,1,AMEX
4288,10-02-2021 00:00,24 hrs.,pennystocks,AMC,18,0,18,-18,3,3,0,3,NYSE
4288,10-02-2021 00:00,24 hrs.,pennystocks,ASX,22,0,22,-22,1,6,6,1,NYSE
4288,10-02-2021 00:00,24 hrs.,pennystocks,BTT,6,0,6,-6,1,1,0,1,NYSE
4288,10-02-2021 00:00,24 hrs.,pennystocks,CBD,342,336,6,330,9,113,80,9,NYSE
4288,10-02-2021 00:00,24 hrs.,pennystocks,COO,963,0,963,-963,1,413,133,1,NYSE
4288,10-02-2021 00:00,24 hrs.,pennystocks,CVS,969,6,963,-957,2,414,133,2,NYSE
4288,10-02-2021 00:00,24 hrs.,pennystocks,EAT,6,0,6,-6,1,1,0,1,NYSE
4288,10-02-2021 00:00,24 hrs.,pennystocks,EMF,7,7,0,7,1,1,1,1,NYSE
4288,10-02-2021 00:00,24 hrs.,pennystocks,GHG,13,13,0,13,2,2,1,1,NYSE
4288,10-02-2021 00:00,24 hrs.,pennystocks,GME,1690,0,1690,-1690,2,715,252,2,NYSE
4288,10-02-2021 00:00,24 hrs.,pennystocks,MPX,6,0,6,-6,1,1,0,1,NYSE
4288,10-02-2021 00:00,24 hrs.,pennystocks,NOK,6,0,6,-6,1,1,0,1,NYSE
4288,10-02-2021 00:00,24 hrs.,pennystocks,SAP,963,0,963,-963,1,413,133,1,NYSE
4288,10-02-2021 00:00,24 hrs.,pennystocks,SOS,12,6,6,0,2,2,0,2,NYSE
4288,10-02-2021 00:00,24 hrs.,pennystocks,WIT,8,8,0,8,1,2,0,1,NYSE
4288,10-02-2021 00:00,24 hrs.,pennystocks,BORR,6,0,6,-6,1,1,0,1,NYSE
4288,10-02-2021 00:00,24 hrs.,pennystocks,FENG,8,8,0,8,1,2,0,1,NYSE
4288,10-02-2021 00:00,24 hrs.,pennystocks,PONT,12,12,0,12,2,2,0,1,OTC
4288,10-02-2021 00:00,24 hrs.,pennystocks,PPJE,8,8,0,8,1,1,2,1,OTC
4288,10-02-2021 00:00,24 hrs.,pennystocks,PTTN,11,11,0,11,1,2,3,1,OTC
4288,10-02-2021 00:00,24 hrs.,pennystocks,PURA,18,0,18,-18,3,3,0,3,OTC
4288,10-02-2021 00:00,24 hrs.,pennystocks,PVDG,92,12,80,-68,3,19,42,3,OTC
4288,10-02-2021 00:00,24 hrs.,pennystocks,QSEP,7,0,7,-7,1,1,1,1,OTC
4288,10-02-2021 00:00,24 hrs.,pennystocks,RHCO,43,43,0,43,1,6,27,1,OTC
4288,10-02-2021 00:00,24 hrs.,pennystocks,RMTD,17,0,17,-17,1,2,9,1,OTC
4288,10-02-2021 00:00,24 hrs.,pennystocks,RSCF,6,6,0,6,1,1,0,1,OTC
4288,10-02-2021 00:00,24 hrs.,pennystocks,RSSV,177,7,170,-163,3,58,49,3,OTC
4288,10-02-2021 00:00,24 hrs.,pennystocks,RTON,378,378,0,378,3,111,144,3,OTC
4288,10-02-2021 00:00,24 hrs.,pennystocks,SBFM,6,0,6,-6,1,1,0,1,OTC
4288,10-02-2021 00:00,24 hrs.,pennystocks,SFOR,6,6,0,6,1,1,0,1,OTC
4288,10-02-2021 00:00,24 hrs.,pennystocks,SGMD,57,57,0,57,1,19,15,1,OTC
4288,10-02-2021 00:00,24 hrs.,pennystocks,SHMP,6,6,0,6,1,1,0,1,OTC
4288,10-02-2021 00:00,24 hrs.,pennystocks,SHWZ,7,0,7,-7,1,1,1,1,OTC
4288,10-02-2021 00:00,24 hrs.,pennystocks,SING,6,6,0,6,1,1,0,1,OTC
4288,10-02-2021 00:00,24 hrs.,pennystocks,SIRC,6,0,6,-6,1,1,0,1,OTC
4288,10-02-2021 00:00,24 hrs.,pennystocks,SKYF,43,43,0,43,1,6,27,1,OTC
4288,10-02-2021 00:00,24 hrs.,pennystocks,SMAA,25,0,25,-25,1,6,9,1,OTC
4288,10-02-2021 00:00,24 hrs.,pennystocks,SMGI,15,15,0,15,1,5,1,1,OTC
4288,10-02-2021 00:00,24 hrs.,pennystocks,SNPW,602,7,595,-588,2,241,112,2,OTC
4288,10-02-2021 00:00,24 hrs.,pennystocks,SRMX,19,19,0,19,3,3,1,3,OTC
4288,10-02-2021 00:00,24 hrs.,pennystocks,SSFT,531,270,261,9,3,211,97,3,OTC
4288,10-02-2021 00:00,24 hrs.,pennystocks,SVTE,6,0,6,-6,1,1,0,1,OTC
4288,10-02-2021 00:00,24 hrs.,pennystocks,TLSS,267,261,6,255,3,103,49,3,OTC
4288,10-02-2021 00:00,24 hrs.,pennystocks,TONR,43,43,0,43,1,6,27,1,OTC
4288,10-02-2021 00:00,24 hrs.,pennystocks,TRTC,16,10,6,4,2,3,2,2,OTC
4288,10-02-2021 00:00,24 hrs.,pennystocks,TSNP,28,20,8,12,4,3,6,4,OTC
4288,10-02-2021 00:00,24 hrs.,pennystocks,UBQU,110,110,0,110,3,20,58,3,OTC
4288,10-02-2021 00:00,24 hrs.,pennystocks,UPCO,6,0,6,-6,1,1,0,1,OTC
4288,10-02-2021 00:00,24 hrs.,pennystocks,USMJ,41,41,0,41,1,14,9,1,OTC
4288,10-02-2021 00:00,24 hrs.,pennystocks,VGLS,7,0,7,-7,1,1,1,1,OTC
4288,10-02-2021 00:00,24 hrs.,pennystocks,VMHG,43,43,0,43,1,6,27,1,OTC
4288,10-02-2021 00:00,24 hrs.,pennystocks,VPER,250,42,208,-166,6,89,48,5,OTC
4288,10-02-2021 00:00,24 hrs.,pennystocks,VPOR,7,7,0,7,1,1,1,1,OTC
4288,10-02-2021 00:00,24 hrs.,pennystocks,VYST,6,0,6,-6,1,1,0,1,OTC
4288,10-02-2021 00:00,24 hrs.,pennystocks,WARM,6,6,0,6,1,1,0,1,OTC
4288,10-02-2021 00:00,24 hrs.,pennystocks,WDHR,6,6,0,6,1,1,0,1,OTC
4288,10-02-2021 00:00,24 hrs.,pennystocks,WDLF,21,13,8,5,3,2,5,2,OTC
4288,10-02-2021 00:00,24 hrs.,pennystocks,WRFX,13,7,6,1,2,2,1,2,OTC
4288,10-02-2021 00:00,24 hrs.,pennystocks,XDSL,6,6,0,6,1,1,0,1,OTC
4288,10-02-2021 00:00,24 hrs.,pennystocks,XMET,7,7,0,7,1,1,1,1,OTC
4288,10-02-2021 00:00,24 hrs.,pennystocks,AAIRF,15,15,0,15,2,2,3,1,OTC
4288,10-02-2021 00:00,24 hrs.,pennystocks,ABEPF,199,199,0,199,5,72,35,5,OTC
4288,10-02-2021 00:00,24 hrs.,pennystocks,AGFAF,6,0,6,-6,1,1,0,1,OTC
4288,10-02-2021 00:00,24 hrs.,pennystocks,AMYZF,6,6,0,6,1,1,0,1,OTC
4288,10-02-2021 00:00,24 hrs.,pennystocks,APAAF,20,0,20,-20,1,5,6,1,OTC
4288,10-02-2021 00:00,24 hrs.,pennystocks,ARSMF,6,6,0,6,1,1,0,1,OTC
4288,10-02-2021 00:00,24 hrs.,pennystocks,ATBPF,7,0,7,-7,1,1,1,1,OTC
4288,10-02-2021 00:00,24 hrs.,pennystocks,BLOZF,6,6,0,6,1,1,0,1,OTC
4288,10-02-2021 00:00,24 hrs.,pennystocks,CCIHY,6,6,0,6,1,1,0,1,OTC
4288,10-02-2021 00:00,24 hrs.,pennystocks,DFLYF,22,0,22,-22,1,4,10,1,OTC
4288,10-02-2021 00:00,24 hrs.,pennystocks,DIGAF,6,6,0,6,1,1,0,1,OTC
4288,10-02-2021 00:00,24 hrs.,pennystocks,EFLVF,73,73,0,73,1,28,13,1,OTC
4288,10-02-2021 00:00,24 hrs.,pennystocks,EHVVF,969,0,969,-969,2,414,133,2,OTC
4288,10-02-2021 00:00,24 hrs.,pennystocks,EPWCF,6,6,0,6,1,1,0,1,OTC
4288,10-02-2021 00:00,24 hrs.,pennystocks,FBSGF,18,18,0,18,3,3,0,1,OTC
4288,10-02-2021 00:00,24 hrs.,pennystocks,FTRPF,963,0,963,-963,1,413,133,1,OTC
4288,10-02-2021 00:00,24 hrs.,pennystocks,FUSEF,255,255,0,255,1,101,49,1,OTC
4288,10-02-2021 00:00,24 hrs.,pennystocks,GBOKF,963,0,963,-963,1,413,133,1,OTC
4288,10-02-2021 00:00,24 hrs.,pennystocks,GLDFF,6,6,0,6,1,1,0,1,OTC
4288,10-02-2021 00:00,24 hrs.,pennystocks,GOOLF,6,0,6,-6,1,1,0,1,OTC
4288,10-02-2021 00:00,24 hrs.,pennystocks,HAPBF,6,6,0,6,1,1,0,1,OTC
4288,10-02-2021 00:00,24 hrs.,pennystocks,ECGI,43,43,0,43,1,6,27,1,OTC
4288,10-02-2021 00:00,24 hrs.,pennystocks,EDXC,19,19,0,19,3,3,1,3,OTC
4288,10-02-2021 00:00,24 hrs.,pennystocks,EHOS,43,43,0,43,1,6,27,1,OTC
4288,10-02-2021 00:00,24 hrs.,pennystocks,EMLL,27,0,27,-27,1,8,7,1,OTC
4288,10-02-2021 00:00,24 hrs.,pennystocks,ENDO,6,6,0,6,1,1,0,1,OTC
4288,10-02-2021 00:00,24 hrs.,pennystocks,ENZC,98,0,98,-98,4,20,42,4,OTC
4288,10-02-2021 00:00,24 hrs.,pennystocks,ERBB,366,366,0,366,1,109,144,1,OTC
4288,10-02-2021 00:00,24 hrs.,pennystocks,ETFM,329,0,329,-329,1,112,101,1,OTC
4288,10-02-2021 00:00,24 hrs.,pennystocks,FITX,7,7,0,7,1,1,1,1,OTC
4288,10-02-2021 00:00,24 hrs.,pennystocks,FPFI,7,7,0,7,1,1,1,1,OTC
4288,10-02-2021 00:00,24 hrs.,pennystocks,FPVD,7,7,0,7,1,1,1,1,OTC
4288,10-02-2021 00:00,24 hrs.,pennystocks,FTEG,255,255,0,255,1,101,49,1,OTC
4288,10-02-2021 00:00,24 hrs.,pennystocks,FTXP,43,43,0,43,1,6,27,1,OTC
4288,10-02-2021 00:00,24 hrs.,pennystocks,FWDG,11,11,0,11,1,0,7,1,OTC
4288,10-02-2021 00:00,24 hrs.,pennystocks,GFTX,4,0,4,-4,1,0,0,1,OTC
4288,10-02-2021 00:00,24 hrs.,pennystocks,GGII,8,0,8,-8,1,1,2,1,OTC
4288,10-02-2021 00:00,24 hrs.,pennystocks,GRNH,6,0,6,-6,1,1,0,1,OTC
4288,10-02-2021 00:00,24 hrs.,pennystocks,GRPS,34,7,27,-20,3,7,8,3,OTC
4288,10-02-2021 00:00,24 hrs.,pennystocks,GTEH,1694,0,1694,-1694,2,750,186,2,OTC
4288,10-02-2021 00:00,24 hrs.,pennystocks,GTII,50,50,0,50,1,18,10,1,OTC
4288,10-02-2021 00:00,24 hrs.,pennystocks,GTLL,7,0,7,-7,1,1,1,1,OTC
4288,10-02-2021 00:00,24 hrs.,pennystocks,GWSN,24,0,24,-24,1,4,12,1,OTC
4288,10-02-2021 00:00,24 hrs.,pennystocks,HAON,18,6,12,-6,3,3,0,2,OTC
4288,10-02-2021 00:00,24 hrs.,pennystocks,HBRM,6,6,0,6,1,1,0,1,OTC
4288,10-02-2021 00:00,24 hrs.,pennystocks,HCMC,57,32,25,7,9,9,3,9,OTC
4288,10-02-2021 00:00,24 hrs.,pennystocks,HEMP,13,0,13,-13,2,2,1,1,OTC
4288,10-02-2021 00:00,24 hrs.,pennystocks,HESG,43,43,0,43,1,6,27,1,OTC
4288,10-02-2021 00:00,24 hrs.,pennystocks,HFBG,6,0,6,-6,1,1,0,1,OTC
4288,10-02-2021 00:00,24 hrs.,pennystocks,HPNN,71,71,0,71,2,14,35,2,OTC
4288,10-02-2021 00:00,24 hrs.,pennystocks,HQGE,57,57,0,57,3,8,29,3,OTC
4288,10-02-2021 00:00,24 hrs.,pennystocks,HYII,7,7,0,7,1,1,1,1,OTC
4288,10-02-2021 00:00,24 hrs.,pennystocks,HYSR,10,0,10,-10,1,2,2,1,OTC
4288,10-02-2021 00:00,24 hrs.,pennystocks,ICLD,6,6,0,6,1,1,0,1,OTC
4288,10-02-2021 00:00,24 hrs.,pennystocks,IFXY,13,13,0,13,2,2,1,1,OTC
4288,10-02-2021 00:00,24 hrs.,pennystocks,INAR,6,6,0,6,1,1,0,1,OTC
4288,10-02-2021 00:00,24 hrs.,pennystocks,INKW,18,12,6,6,3,3,0,3,OTC
4288,10-02-2021 00:00,24 hrs.,pennystocks,INND,155,149,6,143,5,30,75,5,OTC
4288,10-02-2021 00:00,24 hrs.,pennystocks,IWSY,255,255,0,255,1,101,49,1,OTC
4288,10-02-2021 00:00,24 hrs.,pennystocks,JAMN,43,43,0,43,1,6,27,1,OTC
4288,10-02-2021 00:00,24 hrs.,pennystocks,KAVL,16,16,0,16,2,3,2,2,OTC
4288,10-02-2021 00:00,24 hrs.,pennystocks,LINK,36,0,36,-36,1,14,4,1,OTC
4288,10-02-2021 00:00,24 hrs.,pennystocks,MCOA,12,6,6,0,2,2,0,2,OTC
4288,10-02-2021 00:00,24 hrs.,pennystocks,MDCN,13,13,0,13,2,2,1,2,OTC
4288,10-02-2021 00:00,24 hrs.,pennystocks,MEGH,43,43,0,43,1,6,27,1,OTC
4288,10-02-2021 00:00,24 hrs.,pennystocks,MGON,6,0,6,-6,1,1,0,1,OTC
4288,10-02-2021 00:00,24 hrs.,pennystocks,MINE,159,159,0,159,5,57,25,5,OTC
4288,10-02-2021 00:00,24 hrs.,pennystocks,MJLB,6,0,6,-6,1,1,0,1,OTC
4288,10-02-2021 00:00,24 hrs.,pennystocks,MLFB,6,6,0,6,1,1,0,1,OTC
4288,10-02-2021 00:00,24 hrs.,pennystocks,MMEX,12,12,0,12,2,2,0,2,OTC
4288,10-02-2021 00:00,24 hrs.,pennystocks,MNGG,6,0,6,-6,1,1,0,1,OTC
4288,10-02-2021 00:00,24 hrs.,pennystocks,MSPC,6,6,0,6,1,1,0,1,OTC
4288,10-02-2021 00:00,24 hrs.,pennystocks,NACB,43,43,0,43,1,6,27,1,OTC
4288,10-02-2021 00:00,24 hrs.,pennystocks,NRBT,7,7,0,7,1,1,1,1,OTC
4288,10-02-2021 00:00,24 hrs.,pennystocks,NSPT,43,43,0,43,1,6,27,1,OTC
4288,10-02-2021 00:00,24 hrs.,pennystocks,NSPX,6,0,6,-6,1,1,0,1,OTC
4288,10-02-2021 00:00,24 hrs.,pennystocks,NUGS,12,0,12,-12,2,2,0,2,OTC
4288,10-02-2021 00:00,24 hrs.,pennystocks,NVGT,43,43,0,43,1,6,27,1,OTC
4288,10-02-2021 00:00,24 hrs.,pennystocks,OPVS,7,7,0,7,1,1,1,1,OTC
4288,10-02-2021 00:00,24 hrs.,pennystocks,OZSC,1642,12,1630,-1618,5,732,158,5,OTC
4288,10-02-2021 00:00,24 hrs.,pennystocks,PAOG,6,6,0,6,1,1,0,1,OTC
4288,10-02-2021 00:00,24 hrs.,pennystocks,PBIO,6,0,6,-6,1,1,0,1,OTC
4288,10-02-2021 00:00,24 hrs.,pennystocks,PBYA,43,43,0,43,1,6,27,1,OTC
4288,10-02-2021 00:00,24 hrs.,pennystocks,PGTK,12,0,12,-12,2,2,0,2,OTC
4288,10-02-2021 00:00,24 hrs.,pennystocks,PLPL,7,7,0,7,1,1,1,1,OTC
4288,10-02-2021 00:00,24 hrs.,StockMarket,GRTS,6,6,0,6,1,1,0,1,NASDAQ
4288,10-02-2021 00:00,24 hrs.,StockMarket,GRWG,6,6,0,6,1,1,0,1,NASDAQ
4288,10-02-2021 00:00,24 hrs.,StockMarket,GWPH,142,0,142,-142,1,46,46,1,NASDAQ
4288,10-02-2021 00:00,24 hrs.,StockMarket,HAIN,62,62,0,62,1,23,12,1,NASDAQ
4288,10-02-2021 00:00,24 hrs.,StockMarket,HGSH,12,12,0,12,2,2,0,1,NASDAQ
4288,10-02-2021 00:00,24 hrs.,StockMarket,HTBX,463,463,0,463,2,165,125,2,NASDAQ
4288,10-02-2021 00:00,24 hrs.,StockMarket,ICLN,12,12,0,12,1,4,0,1,NASDAQ
4288,10-02-2021 00:00,24 hrs.,StockMarket,IMMP,6,0,6,-6,1,1,0,1,NASDAQ
4288,10-02-2021 00:00,24 hrs.,StockMarket,KALV,401,401,0,401,1,142,113,1,NASDAQ
4288,10-02-2021 00:00,24 hrs.,StockMarket,LIVE,82,62,20,42,2,28,18,2,NASDAQ
4288,10-02-2021 00:00,24 hrs.,StockMarket,LMFA,6,0,6,-6,1,1,0,1,NASDAQ
4288,10-02-2021 00:00,24 hrs.,StockMarket,LUNG,6,6,0,6,1,1,0,1,NASDAQ
4288,10-02-2021 00:00,24 hrs.,StockMarket,MARA,6,0,6,-6,1,1,0,1,NASDAQ
4288,10-02-2021 00:00,24 hrs.,StockMarket,MOGO,6,0,6,-6,1,1,0,1,NASDAQ
4288,10-02-2021 00:00,24 hrs.,StockMarket,MOSY,10,0,10,-10,1,3,0,1,NASDAQ
4288,10-02-2021 00:00,24 hrs.,StockMarket,MVIS,37,0,37,-37,1,15,3,1,NASDAQ
4288,10-02-2021 00:00,24 hrs.,StockMarket,NMTR,12,6,6,0,2,2,0,2,NASDAQ
4288,10-02-2021 00:00,24 hrs.,StockMarket,OBLN,6,0,6,-6,1,1,0,1,NASDAQ
4288,10-02-2021 00:00,24 hrs.,StockMarket,OCGN,557,557,0,557,3,205,135,3,NASDAQ
4288,10-02-2021 00:00,24 hrs.,StockMarket,QDEL,62,62,0,62,1,23,12,1,NASDAQ
4288,10-02-2021 00:00,24 hrs.,StockMarket,QGEN,62,62,0,62,1,23,12,1,NASDAQ
4288,10-02-2021 00:00,24 hrs.,StockMarket,SAVA,6,0,6,-6,1,1,0,1,NASDAQ
4288,10-02-2021 00:00,24 hrs.,StockMarket,SNDL,12,12,0,12,2,2,0,2,NASDAQ
4288,10-02-2021 00:00,24 hrs.,StockMarket,SSRM,7,7,0,7,1,1,1,1,NASDAQ
4288,10-02-2021 00:00,24 hrs.,StockMarket,THRM,6,6,0,6,1,1,0,1,NASDAQ
4288,10-02-2021 00:00,24 hrs.,StockMarket,TLRY,101,101,0,101,5,34,13,5,NASDAQ
4288,10-02-2021 00:00,24 hrs.,StockMarket,TRIT,6,0,6,-6,1,1,0,1,NASDAQ
4288,10-02-2021 00:00,24 hrs.,StockMarket,TTWO,62,62,0,62,1,23,12,1,NASDAQ
4288,10-02-2021 00:00,24 hrs.,StockMarket,UONE,6,0,6,-6,1,1,0,1,NASDAQ
4288,10-02-2021 00:00,24 hrs.,StockMarket,VBIV,10,0,10,-10,1,3,0,1,NASDAQ
4288,10-02-2021 00:00,24 hrs.,StockMarket,VIVE,6,0,6,-6,1,1,0,1,NASDAQ
4288,10-02-2021 00:00,24 hrs.,StockMarket,ZNGA,6,6,0,6,1,1,0,1,NASDAQ
4288,10-02-2021 00:00,24 hrs.,pennystocks,AEPT,7,7,0,7,1,1,1,1,OTC
4288,10-02-2021 00:00,24 hrs.,pennystocks,AGYP,7,7,0,7,1,1,1,1,OTC
4288,10-02-2021 00:00,24 hrs.,pennystocks,AITX,13,6,7,-1,2,2,1,2,OTC
4288,10-02-2021 00:00,24 hrs.,pennystocks,ALKM,12,6,6,0,2,2,0,2,OTC
4288,10-02-2021 00:00,24 hrs.,pennystocks,ALYI,40,7,33,-26,6,5,6,5,OTC
4288,10-02-2021 00:00,24 hrs.,pennystocks,ASKE,38,38,0,38,2,7,16,2,OTC
4288,10-02-2021 00:00,24 hrs.,pennystocks,ASTI,31,25,6,19,5,5,1,5,OTC
4288,10-02-2021 00:00,24 hrs.,pennystocks,BANT,16,16,0,16,1,3,6,1,OTC
4288,10-02-2021 00:00,24 hrs.,pennystocks,BDGR,7,7,0,7,1,1,1,1,OTC
4288,10-02-2021 00:00,24 hrs.,pennystocks,BFCH,6,0,6,-6,1,1,0,1,OTC
4288,10-02-2021 00:00,24 hrs.,pennystocks,BIEL,7,7,0,7,1,1,1,1,OTC
4288,10-02-2021 00:00,24 hrs.,pennystocks,BLDV,37,37,0,37,1,11,11,1,OTC
4288,10-02-2021 00:00,24 hrs.,pennystocks,BLSP,254,165,89,76,4,94,50,4,OTC
4288,10-02-2021 00:00,24 hrs.,pennystocks,BOTY,369,57,312,-255,11,115,95,10,OTC
4288,10-02-2021 00:00,24 hrs.,pennystocks,BRTX,13,13,0,13,2,2,1,1,OTC
4288,10-02-2021 00:00,24 hrs.,pennystocks,BTSC,13,0,13,-13,2,2,1,2,OTC
4288,10-02-2021 00:00,24 hrs.,pennystocks,CATV,6,0,6,-6,1,1,0,1,OTC
4288,10-02-2021 00:00,24 hrs.,pennystocks,CBBT,149,55,94,-39,6,41,43,6,OTC
4288,10-02-2021 00:00,24 hrs.,pennystocks,CBDD,372,366,6,360,2,110,144,2,OTC
4288,10-02-2021 00:00,24 hrs.,pennystocks,CCTL,13,13,0,13,2,2,1,2,OTC
4288,10-02-2021 00:00,24 hrs.,pennystocks,CHNC,7,7,0,7,1,1,1,1,OTC
4288,10-02-2021 00:00,24 hrs.,pennystocks,CLSH,6,6,0,6,1,1,0,1,OTC
4288,10-02-2021 00:00,24 hrs.,pennystocks,CLTS,6,0,6,-6,1,1,0,1,OTC
4288,10-02-2021 00:00,24 hrs.,pennystocks,CLWD,116,116,0,116,4,34,32,3,OTC
4288,10-02-2021 00:00,24 hrs.,pennystocks,CNBX,6,6,0,6,1,1,0,1,OTC
4288,10-02-2021 00:00,24 hrs.,pennystocks,COMS,39,39,0,39,1,14,7,1,OTC
4288,10-02-2021 00:00,24 hrs.,pennystocks,CTLE,72,72,0,72,1,28,12,1,OTC
4288,10-02-2021 00:00,24 hrs.,pennystocks,CTYX,7,0,7,-7,1,1,1,1,OTC
4288,10-02-2021 00:00,24 hrs.,pennystocks,CYDY,7,7,0,7,1,1,1,1,OTC
4288,10-02-2021 00:00,24 hrs.,pennystocks,CYIO,13,7,6,1,2,2,1,2,OTC
4288,10-02-2021 00:00,24 hrs.,pennystocks,DPLS,117,0,117,-117,2,49,11,2,OTC
4288,10-02-2021 00:00,24 hrs.,pennystocks,DRNK,33,33,0,33,1,13,3,1,OTC
4288,10-02-2021 00:00,24 hrs.,StockMarket,SGMD,12,12,0,12,2,2,0,1,OTC
4288,10-02-2021 00:00,24 hrs.,StockMarket,SNPW,16,16,0,16,1,3,6,1,OTC
4288,10-02-2021 00:00,24 hrs.,StockMarket,VPOR,6,0,6,-6,1,1,0,1,OTC
4288,10-02-2021 00:00,24 hrs.,StockMarket,VSPC,6,0,6,-6,1,1,0,1,OTC
4288,10-02-2021 00:00,24 hrs.,StockMarket,WHEN,6,6,0,6,1,1,0,1,OTC
4288,10-02-2021 00:00,24 hrs.,StockMarket,MMNFF,33,33,0,33,1,10,9,1,OTC
4288,10-02-2021 00:00,24 hrs.,StockMarket,PKLBF,6,6,0,6,1,1,0,1,OTC
4288,10-02-2021 00:00,24 hrs.,StockMarket,REGRF,6,6,0,6,1,1,0,1,OTC
4288,10-02-2021 00:00,24 hrs.,StockMarket,ACY,6,0,6,-6,1,1,0,1,AMEX
4288,10-02-2021 00:00,24 hrs.,StockMarket,CVM,6,0,6,-6,1,1,0,1,AMEX
4288,10-02-2021 00:00,24 hrs.,StockMarket,DPW,6,0,6,-6,1,1,0,1,AMEX
4288,10-02-2021 00:00,24 hrs.,StockMarket,NBA,62,62,0,62,1,23,12,1,AMEX
4288,10-02-2021 00:00,24 hrs.,StockMarket,TRXC,6,6,0,6,1,0,2,1,AMEX
4288,10-02-2021 00:00,24 hrs.,StockMarket,AMC,49,0,49,-49,3,1,35,3,NYSE
4288,10-02-2021 00:00,24 hrs.,StockMarket,CBD,154,6,148,-142,3,48,46,3,NYSE
4288,10-02-2021 00:00,24 hrs.,StockMarket,CBO,62,62,0,62,1,23,12,1,NYSE
4288,10-02-2021 00:00,24 hrs.,StockMarket,CLF,62,62,0,62,1,23,12,1,NYSE
4288,10-02-2021 00:00,24 hrs.,StockMarket,CNC,62,62,0,62,1,23,12,1,NYSE
4288,10-02-2021 00:00,24 hrs.,StockMarket,DIS,695,695,0,695,1,306,79,1,NYSE
4288,10-02-2021 00:00,24 hrs.,StockMarket,DOW,28,28,0,28,1,9,6,1,NYSE
4288,10-02-2021 00:00,24 hrs.,StockMarket,EPC,62,62,0,62,1,23,12,1,NYSE
4288,10-02-2021 00:00,24 hrs.,StockMarket,FLT,6,6,0,6,1,1,0,1,NYSE
4288,10-02-2021 00:00,24 hrs.,StockMarket,GME,282,31,251,-220,6,88,82,6,NYSE
4288,10-02-2021 00:00,24 hrs.,StockMarket,HBI,62,62,0,62,1,23,12,1,NYSE
4288,10-02-2021 00:00,24 hrs.,StockMarket,IBM,6,6,0,6,1,1,0,1,NYSE
4288,10-02-2021 00:00,24 hrs.,StockMarket,LLY,62,62,0,62,1,23,12,1,NYSE
4288,10-02-2021 00:00,24 hrs.,StockMarket,NIO,32,0,32,-32,2,12,0,2,NYSE
4288,10-02-2021 00:00,24 hrs.,StockMarket,NOK,2734,0,2734,-2734,2,1292,142,2,NYSE
4288,10-02-2021 00:00,24 hrs.,StockMarket,SPG,62,62,0,62,1,23,12,1,NYSE
4288,10-02-2021 00:00,24 hrs.,StockMarket,TMO,62,62,0,62,1,23,12,1,NYSE
4288,10-02-2021 00:00,24 hrs.,StockMarket,VGR,6,6,0,6,1,1,0,1,NYSE
4288,10-02-2021 00:00,24 hrs.,StockMarket,YPF,6,6,0,6,1,1,0,1,NYSE
4288,10-02-2021 00:00,24 hrs.,StockMarket,CARR,62,62,0,62,1,23,12,1,NYSE
4288,10-02-2021 00:00,24 hrs.,StockMarket,CCIV,6,0,6,-6,1,1,0,1,NYSE
4288,10-02-2021 00:00,24 hrs.,StockMarket,CHGG,62,62,0,62,1,23,12,1,NYSE
4288,10-02-2021 00:00,24 hrs.,StockMarket,COTY,62,62,0,62,1,23,12,1,NYSE
4288,10-02-2021 00:00,24 hrs.,StockMarket,EXPR,12,6,6,0,2,2,0,2,NYSE
4288,10-02-2021 00:00,24 hrs.,StockMarket,PLTR,6,0,6,-6,1,1,0,1,NYSE
4288,10-02-2021 00:00,24 hrs.,StockMarket,AAL,12,6,6,0,2,2,0,2,NASDAQ
4288,10-02-2021 00:00,24 hrs.,StockMarket,CGC,62,62,0,62,1,23,12,1,NASDAQ
4288,10-02-2021 00:00,24 hrs.,StockMarket,DYN,6,0,6,-6,1,1,0,1,NASDAQ
4288,10-02-2021 00:00,24 hrs.,StockMarket,III,142,0,142,-142,1,46,46,1,NASDAQ
4288,10-02-2021 00:00,24 hrs.,StockMarket,VPN,6,6,0,6,1,1,0,1,NASDAQ
4288,10-02-2021 00:00,24 hrs.,StockMarket,AEZS,6,6,0,6,1,1,0,1,NASDAQ
4288,10-02-2021 00:00,24 hrs.,StockMarket,AGTC,6,6,0,6,1,1,0,1,NASDAQ
4288,10-02-2021 00:00,24 hrs.,StockMarket,AMRN,10,10,0,10,1,3,0,1,NASDAQ
4288,10-02-2021 00:00,24 hrs.,StockMarket,AMTX,6,0,6,-6,1,1,0,1,NASDAQ
4288,10-02-2021 00:00,24 hrs.,StockMarket,APHA,12,6,6,0,2,2,0,2,NASDAQ
4288,10-02-2021 00:00,24 hrs.,StockMarket,APPS,6,0,6,-6,1,1,0,1,NASDAQ
4288,10-02-2021 00:00,24 hrs.,StockMarket,APWC,6,0,6,-6,1,1,0,1,NASDAQ
4288,10-02-2021 00:00,24 hrs.,StockMarket,AUVI,463,463,0,463,2,165,125,2,NASDAQ
4288,10-02-2021 00:00,24 hrs.,StockMarket,BBIG,6,0,6,-6,1,1,0,1,NASDAQ
4288,10-02-2021 00:00,24 hrs.,StockMarket,BLNK,13,13,0,13,1,2,5,1,NASDAQ
4288,10-02-2021 00:00,24 hrs.,StockMarket,BTBT,6,0,6,-6,1,1,0,1,NASDAQ
4288,10-02-2021 00:00,24 hrs.,StockMarket,CHCI,401,401,0,401,1,142,113,1,NASDAQ
4288,10-02-2021 00:00,24 hrs.,StockMarket,CLSK,6,0,6,-6,1,1,0,1,NASDAQ
4288,10-02-2021 00:00,24 hrs.,StockMarket,CLVS,12,6,6,0,2,2,0,2,NASDAQ
4288,10-02-2021 00:00,24 hrs.,StockMarket,CMPS,6,6,0,6,1,1,0,1,NASDAQ
4288,10-02-2021 00:00,24 hrs.,StockMarket,CODX,62,62,0,62,1,23,12,1,NASDAQ
4288,10-02-2021 00:00,24 hrs.,StockMarket,CRSR,62,62,0,62,1,23,12,1,NASDAQ
4288,10-02-2021 00:00,24 hrs.,StockMarket,CYTH,62,62,0,62,1,23,12,1,NASDAQ
4288,10-02-2021 00:00,24 hrs.,StockMarket,FCEL,6,0,6,-6,1,1,0,1,NASDAQ
4288,10-02-2021 00:00,24 hrs.,StockMarket,GLUU,62,62,0,62,1,23,12,1,NASDAQ
4288,10-02-2021 00:00,24 hrs.,StockMarket,GNUS,6,0,6,-6,1,1,0,1,NASDAQ
4288,10-02-2021 00:00,24 hrs.,Daytrading,NAKD,31,0,31,-31,1,13,1,1,NASDAQ
4288,10-02-2021 00:00,24 hrs.,Daytrading,OCGN,1213,1213,0,1213,1,530,149,1,NASDAQ
4288,10-02-2021 00:00,24 hrs.,Daytrading,ORTX,1213,1213,0,1213,1,530,149,1,NASDAQ
4288,10-02-2021 00:00,24 hrs.,Daytrading,OTLK,6,6,0,6,1,1,0,1,NASDAQ
4288,10-02-2021 00:00,24 hrs.,Daytrading,PACB,156,156,0,156,1,63,26,1,NASDAQ
4288,10-02-2021 00:00,24 hrs.,Daytrading,PERI,1213,1213,0,1213,1,530,149,1,NASDAQ
4288,10-02-2021 00:00,24 hrs.,Daytrading,RIOT,1213,1213,0,1213,1,530,149,1,NASDAQ
4288,10-02-2021 00:00,24 hrs.,Daytrading,THBR,6,0,6,-6,1,1,0,1,NASDAQ
4288,10-02-2021 00:00,24 hrs.,Daytrading,TLRY,1213,1213,0,1213,1,530,149,1,NASDAQ
4288,10-02-2021 00:00,24 hrs.,Daytrading,TNXP,6,0,6,-6,1,1,0,1,NASDAQ
4288,10-02-2021 00:00,24 hrs.,Daytrading,TYME,1213,1213,0,1213,1,530,149,1,NASDAQ
4288,10-02-2021 00:00,24 hrs.,Daytrading,WKHS,1213,1213,0,1213,1,530,149,1,NASDAQ
4288,10-02-2021 00:00,24 hrs.,Daytrading,ZSAN,6,0,6,-6,1,1,0,1,NASDAQ
4288,10-02-2021 00:00,24 hrs.,trakstocks,ALPP,50,0,50,-50,1,16,14,1,OTC
4288,10-02-2021 00:00,24 hrs.,trakstocks,SNPW,8,8,0,8,1,2,0,1,OTC
4288,10-02-2021 00:00,24 hrs.,trakstocks,TPTW,44,0,44,-44,2,15,6,2,OTC
4288,10-02-2021 00:00,24 hrs.,trakstocks,NMTLF,15,0,15,-15,1,3,5,1,OTC
4288,10-02-2021 00:00,24 hrs.,trakstocks,TLOFF,65,65,0,65,1,26,9,1,OTC
4288,10-02-2021 00:00,24 hrs.,trakstocks,GSAT,122,122,0,122,1,53,12,1,AMEX
4288,10-02-2021 00:00,24 hrs.,trakstocks,ATH,8,8,0,8,1,2,0,1,NYSE
4288,10-02-2021 00:00,24 hrs.,trakstocks,FLT,15,15,0,15,1,5,1,1,NYSE
4288,10-02-2021 00:00,24 hrs.,trakstocks,GME,117,0,117,-117,1,52,9,1,NYSE
4288,10-02-2021 00:00,24 hrs.,trakstocks,LOW,16,16,0,16,1,6,0,1,NYSE
4288,10-02-2021 00:00,24 hrs.,trakstocks,NAV,32,16,16,0,2,12,0,2,NYSE
4288,10-02-2021 00:00,24 hrs.,trakstocks,PFS,15,0,15,-15,1,3,5,1,NYSE
4288,10-02-2021 00:00,24 hrs.,trakstocks,CCIV,10,0,10,-10,1,2,2,1,NYSE
4288,10-02-2021 00:00,24 hrs.,trakstocks,PACE,16,16,0,16,1,6,0,1,NYSE
4288,10-02-2021 00:00,24 hrs.,trakstocks,SNPR,15,0,15,-15,1,5,1,1,NYSE
4288,10-02-2021 00:00,24 hrs.,trakstocks,STPK,38,38,0,38,1,13,8,1,NYSE
4288,10-02-2021 00:00,24 hrs.,trakstocks,API,43,43,0,43,1,17,5,1,NASDAQ
4288,10-02-2021 00:00,24 hrs.,trakstocks,LCY,16,0,16,-16,1,6,0,1,NASDAQ
4288,10-02-2021 00:00,24 hrs.,trakstocks,PTE,12,12,0,12,1,1,6,1,NASDAQ
4288,10-02-2021 00:00,24 hrs.,trakstocks,WWR,15,15,0,15,1,5,1,1,NASDAQ
4288,10-02-2021 00:00,24 hrs.,trakstocks,ACEV,17,17,0,17,1,4,5,1,NASDAQ
4288,10-02-2021 00:00,24 hrs.,trakstocks,ACRX,56,56,0,56,1,23,6,1,NASDAQ
4288,10-02-2021 00:00,24 hrs.,trakstocks,BNGO,74,74,0,74,1,30,10,1,NASDAQ
4288,10-02-2021 00:00,24 hrs.,trakstocks,BSQR,6,0,6,-6,1,1,0,1,NASDAQ
4288,10-02-2021 00:00,24 hrs.,trakstocks,CFII,6,0,6,-6,1,1,0,1,NASDAQ
4288,10-02-2021 00:00,24 hrs.,trakstocks,CHEK,5,5,0,5,1,0,1,1,NASDAQ
4288,10-02-2021 00:00,24 hrs.,trakstocks,DGLY,258,0,258,-258,1,104,46,1,NASDAQ
4288,10-02-2021 00:00,24 hrs.,trakstocks,DKNG,9,0,9,-9,1,2,1,1,NASDAQ
4288,10-02-2021 00:00,24 hrs.,trakstocks,EVFM,34,28,6,22,2,6,14,2,NASDAQ
4288,10-02-2021 00:00,24 hrs.,trakstocks,FLEX,43,43,0,43,1,17,5,1,NASDAQ
4288,10-02-2021 00:00,24 hrs.,trakstocks,JAGX,67,0,67,-67,1,28,7,1,NASDAQ
4288,10-02-2021 00:00,24 hrs.,trakstocks,PERI,28,28,0,28,1,8,8,1,NASDAQ
4288,10-02-2021 00:00,24 hrs.,trakstocks,PLAY,16,16,0,16,1,6,0,1,NASDAQ
4288,10-02-2021 00:00,24 hrs.,trakstocks,SVVC,6,6,0,6,1,1,0,1,NASDAQ
4288,10-02-2021 00:00,24 hrs.,StockMarket,ALPP,16,16,0,16,1,4,4,1,OTC
4288,10-02-2021 00:00,24 hrs.,StockMarket,ANDI,6,6,0,6,1,1,0,1,OTC
4288,10-02-2021 00:00,24 hrs.,StockMarket,BLSP,27,0,27,-27,1,7,9,1,OTC
4288,10-02-2021 00:00,24 hrs.,StockMarket,BRLL,6,6,0,6,1,1,0,1,OTC
4288,10-02-2021 00:00,24 hrs.,StockMarket,BUNM,6,6,0,6,1,1,0,1,OTC
4288,10-02-2021 00:00,24 hrs.,StockMarket,CURR,6,6,0,6,1,1,0,1,OTC
4288,10-02-2021 00:00,24 hrs.,StockMarket,DROP,6,6,0,6,1,1,0,1,OTC
4288,10-02-2021 00:00,24 hrs.,StockMarket,HCMC,75,0,75,-75,2,31,5,2,OTC
4288,10-02-2021 00:00,24 hrs.,StockMarket,HQGE,6,6,0,6,1,1,0,1,OTC
4288,10-02-2021 00:00,24 hrs.,StockMarket,INKW,8,8,0,8,1,2,0,1,OTC
4288,10-02-2021 00:00,24 hrs.,StockMarket,IPIX,6,0,6,-6,1,1,0,1,OTC
4288,10-02-2021 00:00,24 hrs.,StockMarket,LINK,62,62,0,62,1,23,12,1,OTC
4288,10-02-2021 00:00,24 hrs.,StockMarket,MEDH,6,6,0,6,1,1,0,1,OTC
4288,10-02-2021 00:00,24 hrs.,StockMarket,MINE,6,0,6,-6,1,1,0,1,OTC
4288,10-02-2021 00:00,24 hrs.,StockMarket,MJNA,142,0,142,-142,1,46,46,1,OTC
4288,10-02-2021 00:00,24 hrs.,StockMarket,MOST,62,62,0,62,1,23,12,1,OTC
4288,10-02-2021 00:00,24 hrs.,StockMarket,RTON,6,6,0,6,1,1,0,1,OTC
4288,10-02-2021 00:00,24 hrs.,stocks,PLUG,16,16,0,16,1,3,6,1,NASDAQ
4288,10-02-2021 00:00,24 hrs.,stocks,QCLN,74,32,42,-10,2,16,34,2,NASDAQ
4288,10-02-2021 00:00,24 hrs.,stocks,QCOM,23,23,0,23,1,8,3,1,NASDAQ
4288,10-02-2021 00:00,24 hrs.,stocks,QDEL,27,27,0,27,1,8,7,1,NASDAQ
4288,10-02-2021 00:00,24 hrs.,stocks,QGEN,27,27,0,27,1,8,7,1,NASDAQ
4288,10-02-2021 00:00,24 hrs.,stocks,SABR,15,0,15,-15,1,2,7,1,NASDAQ
4288,10-02-2021 00:00,24 hrs.,stocks,SIRI,6,6,0,6,1,1,0,1,NASDAQ
4288,10-02-2021 00:00,24 hrs.,stocks,SNDL,12,12,0,12,2,2,0,2,NASDAQ
4288,10-02-2021 00:00,24 hrs.,stocks,SONM,6,6,0,6,1,1,0,1,NASDAQ
4288,10-02-2021 00:00,24 hrs.,stocks,SOXX,28,28,0,28,1,9,6,1,NASDAQ
4288,10-02-2021 00:00,24 hrs.,stocks,TBLT,6,0,6,-6,1,1,0,1,NASDAQ
4288,10-02-2021 00:00,24 hrs.,stocks,TECH,9,0,9,-9,1,2,1,1,NASDAQ
4288,10-02-2021 00:00,24 hrs.,stocks,THCB,6,6,0,6,1,1,0,1,NASDAQ
4288,10-02-2021 00:00,24 hrs.,stocks,TLRY,134,134,0,134,4,39,40,4,NASDAQ
4288,10-02-2021 00:00,24 hrs.,stocks,TTWO,27,27,0,27,1,8,7,1,NASDAQ
4288,10-02-2021 00:00,24 hrs.,stocks,TXMD,6,6,0,6,1,1,0,1,NASDAQ
4288,10-02-2021 00:00,24 hrs.,stocks,TYME,6,6,0,6,1,1,0,1,NASDAQ
4288,10-02-2021 00:00,24 hrs.,stocks,VISL,7,7,0,7,1,1,1,1,NASDAQ
4288,10-02-2021 00:00,24 hrs.,stocks,WYNN,15,0,15,-15,1,2,7,1,NASDAQ
4288,10-02-2021 00:00,24 hrs.,stocks,ZSAN,282,134,148,-14,3,101,68,3,NASDAQ
4288,10-02-2021 00:00,24 hrs.,Daytrading,IPIX,6,0,6,-6,1,1,0,1,OTC
4288,10-02-2021 00:00,24 hrs.,Daytrading,RMRK,6,6,0,6,1,1,0,1,OTC
4288,10-02-2021 00:00,24 hrs.,Daytrading,SIGN,48,48,0,48,1,21,2,1,OTC
4288,10-02-2021 00:00,24 hrs.,Daytrading,SNPW,19,19,0,19,1,6,3,1,OTC
4288,10-02-2021 00:00,24 hrs.,Daytrading,MNKKQ,6,0,6,-6,1,1,0,1,OTC
4288,10-02-2021 00:00,24 hrs.,Daytrading,KIQ,1213,1213,0,1213,1,530,149,1,AMEX
4288,10-02-2021 00:00,24 hrs.,Daytrading,ZOM,22,22,0,22,2,4,6,2,AMEX
4288,10-02-2021 00:00,24 hrs.,Daytrading,ACB,1219,1213,6,1207,2,531,149,2,NYSE
4288,10-02-2021 00:00,24 hrs.,Daytrading,ATH,1369,1369,0,1369,2,593,175,2,NYSE
4288,10-02-2021 00:00,24 hrs.,Daytrading,BIO,156,156,0,156,1,63,26,1,NYSE
4288,10-02-2021 00:00,24 hrs.,Daytrading,CLF,1213,1213,0,1213,1,530,149,1,NYSE
4288,10-02-2021 00:00,24 hrs.,Daytrading,DHF,6,0,6,-6,1,1,0,1,NYSE
4288,10-02-2021 00:00,24 hrs.,Daytrading,GME,1213,1213,0,1213,1,530,149,1,NYSE
4288,10-02-2021 00:00,24 hrs.,Daytrading,NIO,156,156,0,156,1,63,26,1,NYSE
4288,10-02-2021 00:00,24 hrs.,Daytrading,NKE,48,48,0,48,1,21,2,1,NYSE
4288,10-02-2021 00:00,24 hrs.,Daytrading,RMO,156,156,0,156,1,63,26,1,NYSE
4288,10-02-2021 00:00,24 hrs.,Daytrading,SOS,1213,1213,0,1213,1,530,149,1,NYSE
4288,10-02-2021 00:00,24 hrs.,Daytrading,TDA,6,0,6,-6,1,1,0,1,NYSE
4288,10-02-2021 00:00,24 hrs.,Daytrading,BABA,6,6,0,6,1,1,0,1,NYSE
4288,10-02-2021 00:00,24 hrs.,Daytrading,EARN,6,0,6,-6,1,1,0,1,NYSE
4288,10-02-2021 00:00,24 hrs.,Daytrading,SKLZ,6,6,0,6,1,1,0,1,NYSE
4288,10-02-2021 00:00,24 hrs.,Daytrading,SPCE,156,156,0,156,1,63,26,1,NYSE
4288,10-02-2021 00:00,24 hrs.,Daytrading,API,6,0,6,-6,1,1,0,1,NASDAQ
4288,10-02-2021 00:00,24 hrs.,Daytrading,CGC,1213,1213,0,1213,1,530,149,1,NASDAQ
4288,10-02-2021 00:00,24 hrs.,Daytrading,OGI,6,0,6,-6,1,1,0,1,NASDAQ
4288,10-02-2021 00:00,24 hrs.,Daytrading,QQQ,156,156,0,156,1,63,26,1,NASDAQ
4288,10-02-2021 00:00,24 hrs.,Daytrading,APHA,1213,1213,0,1213,1,530,149,1,NASDAQ
4288,10-02-2021 00:00,24 hrs.,Daytrading,AUVI,1220,1220,0,1220,2,531,150,2,NASDAQ
4288,10-02-2021 00:00,24 hrs.,Daytrading,BSQR,1213,1213,0,1213,1,530,149,1,NASDAQ
4288,10-02-2021 00:00,24 hrs.,Daytrading,CHCI,1213,1213,0,1213,1,530,149,1,NASDAQ
4288,10-02-2021 00:00,24 hrs.,Daytrading,CHEK,1213,1213,0,1213,1,530,149,1,NASDAQ
4288,10-02-2021 00:00,24 hrs.,Daytrading,CRSP,156,156,0,156,1,63,26,1,NASDAQ
4288,10-02-2021 00:00,24 hrs.,Daytrading,CRSR,1213,1213,0,1213,1,530,149,1,NASDAQ
4288,10-02-2021 00:00,24 hrs.,Daytrading,CYTH,1213,1213,0,1213,1,530,149,1,NASDAQ
4288,10-02-2021 00:00,24 hrs.,Daytrading,EDIT,1740,1740,0,1740,1,799,138,1,NASDAQ
4288,10-02-2021 00:00,24 hrs.,Daytrading,EKSO,1213,1213,0,1213,1,530,149,1,NASDAQ
4288,10-02-2021 00:00,24 hrs.,Daytrading,EVGN,156,156,0,156,1,63,26,1,NASDAQ
4288,10-02-2021 00:00,24 hrs.,Daytrading,GLUU,1213,1213,0,1213,1,530,149,1,NASDAQ
4288,10-02-2021 00:00,24 hrs.,Daytrading,HTBX,1213,1213,0,1213,1,530,149,1,NASDAQ
4288,10-02-2021 00:00,24 hrs.,Daytrading,ITRM,1232,1232,0,1232,2,535,154,2,NASDAQ
4288,10-02-2021 00:00,24 hrs.,Daytrading,KALV,1213,1213,0,1213,1,530,149,1,NASDAQ
4288,10-02-2021 00:00,24 hrs.,Daytrading,MARA,1213,1213,0,1213,1,530,149,1,NASDAQ
4288,10-02-2021 00:00,24 hrs.,Daytrading,MDVL,1213,1213,0,1213,1,530,149,1,NASDAQ
4288,10-02-2021 00:00,24 hrs.,Daytrading,MGNI,1213,1213,0,1213,1,530,149,1,NASDAQ
4288,10-02-2021 00:00,24 hrs.,stocks,MYT,14,14,0,14,1,0,10,1,NASDAQ
4288,10-02-2021 00:00,24 hrs.,stocks,RNA,47,47,0,47,1,19,5,1,NASDAQ
4288,10-02-2021 00:00,24 hrs.,stocks,SFT,16,0,16,-16,1,5,2,1,NASDAQ
4288,10-02-2021 00:00,24 hrs.,stocks,VFF,6,6,0,6,1,1,0,1,NASDAQ
4288,10-02-2021 00:00,24 hrs.,stocks,ADMA,6,6,0,6,1,1,0,1,NASDAQ
4288,10-02-2021 00:00,24 hrs.,stocks,ADMP,6,6,0,6,1,1,0,1,NASDAQ
4288,10-02-2021 00:00,24 hrs.,stocks,AEZS,6,6,0,6,1,1,0,1,NASDAQ
4288,10-02-2021 00:00,24 hrs.,stocks,AMRN,27,27,0,27,1,11,1,1,NASDAQ
4288,10-02-2021 00:00,24 hrs.,stocks,APHA,61,61,0,61,4,13,19,4,NASDAQ
4288,10-02-2021 00:00,24 hrs.,stocks,APPS,13,13,0,13,1,2,5,1,NASDAQ
4288,10-02-2021 00:00,24 hrs.,stocks,AUPH,75,0,75,-75,1,31,9,1,NASDAQ
4288,10-02-2021 00:00,24 hrs.,stocks,BIDU,10823,0,10823,-10823,1,5138,543,1,NASDAQ
4288,10-02-2021 00:00,24 hrs.,stocks,BXRX,6,6,0,6,1,1,0,1,NASDAQ
4288,10-02-2021 00:00,24 hrs.,stocks,CIBR,28,28,0,28,1,9,6,1,NASDAQ
4288,10-02-2021 00:00,24 hrs.,stocks,CODX,7,7,0,7,1,1,1,1,NASDAQ
4288,10-02-2021 00:00,24 hrs.,stocks,CRSR,562,562,0,562,4,201,144,4,NASDAQ
4288,10-02-2021 00:00,24 hrs.,stocks,CTRM,6,0,6,-6,1,1,0,1,NASDAQ
4288,10-02-2021 00:00,24 hrs.,stocks,DCRB,43,43,0,43,2,16,3,2,NASDAQ
4288,10-02-2021 00:00,24 hrs.,stocks,DKNG,107,42,65,-23,2,23,53,2,NASDAQ
4288,10-02-2021 00:00,24 hrs.,stocks,EDIT,267,267,0,267,2,108,43,2,NASDAQ
4288,10-02-2021 00:00,24 hrs.,stocks,ENVB,6,0,6,-6,1,1,0,1,NASDAQ
4288,10-02-2021 00:00,24 hrs.,stocks,EWEB,41,0,41,-41,1,8,21,1,NASDAQ
4288,10-02-2021 00:00,24 hrs.,stocks,EXPI,28,0,28,-28,1,6,12,1,NASDAQ
4288,10-02-2021 00:00,24 hrs.,stocks,FREQ,6,6,0,6,1,1,0,1,NASDAQ
4288,10-02-2021 00:00,24 hrs.,stocks,FTXL,28,28,0,28,1,9,6,1,NASDAQ
4288,10-02-2021 00:00,24 hrs.,stocks,GLUU,43,43,0,43,3,10,11,2,NASDAQ
4288,10-02-2021 00:00,24 hrs.,stocks,GMBL,12,6,6,0,2,2,0,2,NASDAQ
4288,10-02-2021 00:00,24 hrs.,stocks,GNUS,6,0,6,-6,1,1,0,1,NASDAQ
4288,10-02-2021 00:00,24 hrs.,stocks,GRID,28,28,0,28,1,9,6,1,NASDAQ
4288,10-02-2021 00:00,24 hrs.,stocks,HAIN,27,27,0,27,1,8,7,1,NASDAQ
4288,10-02-2021 00:00,24 hrs.,stocks,HTBX,6,6,0,6,1,1,0,1,NASDAQ
4288,10-02-2021 00:00,24 hrs.,stocks,IBKR,6,6,0,6,1,1,0,1,NASDAQ
4288,10-02-2021 00:00,24 hrs.,stocks,ICLN,119,60,59,1,4,28,47,4,NASDAQ
4288,10-02-2021 00:00,24 hrs.,stocks,ITRM,6,0,6,-6,1,1,0,1,NASDAQ
4288,10-02-2021 00:00,24 hrs.,stocks,KALV,13,13,0,13,2,2,1,2,NASDAQ
4288,10-02-2021 00:00,24 hrs.,stocks,KOPN,187,0,187,-187,1,70,43,1,NASDAQ
4288,10-02-2021 00:00,24 hrs.,stocks,LEGN,14,14,0,14,1,5,0,1,NASDAQ
4288,10-02-2021 00:00,24 hrs.,stocks,LGND,53,53,0,53,1,24,1,1,NASDAQ
4288,10-02-2021 00:00,24 hrs.,stocks,LIVE,27,27,0,27,1,8,7,1,NASDAQ
4288,10-02-2021 00:00,24 hrs.,stocks,LULU,47,47,0,47,1,19,5,1,NASDAQ
4288,10-02-2021 00:00,24 hrs.,stocks,MARA,12,12,0,12,2,2,0,2,NASDAQ
4288,10-02-2021 00:00,24 hrs.,stocks,MBRX,7,7,0,7,1,1,1,1,NASDAQ
4288,10-02-2021 00:00,24 hrs.,stocks,MOGO,6,6,0,6,1,1,0,1,NASDAQ
4288,10-02-2021 00:00,24 hrs.,stocks,MSFT,51,51,0,51,1,14,19,1,NASDAQ
4288,10-02-2021 00:00,24 hrs.,stocks,NYMT,12,12,0,12,1,3,2,1,NASDAQ
4288,10-02-2021 00:00,24 hrs.,stocks,OCGN,12,6,6,0,2,2,0,2,NASDAQ
4288,10-02-2021 00:00,24 hrs.,stocks,OLED,6,0,6,-6,1,1,0,1,NASDAQ
4288,10-02-2021 00:00,24 hrs.,stocks,PAYA,12,12,0,12,1,2,4,1,NASDAQ
4288,10-02-2021 00:00,24 hrs.,stocks,PENN,65,0,65,-65,1,11,39,1,NASDAQ
4288,10-02-2021 00:00,24 hrs.,stocks,PFE,12,0,12,-12,1,2,4,1,NYSE
4288,10-02-2021 00:00,24 hrs.,stocks,PFS,34,34,0,34,1,12,6,1,NYSE
4288,10-02-2021 00:00,24 hrs.,stocks,RSI,1252,0,1252,-1252,1,72,1104,1,NYSE
4288,10-02-2021 00:00,24 hrs.,stocks,SAP,10823,0,10823,-10823,1,5138,543,1,NYSE
4288,10-02-2021 00:00,24 hrs.,stocks,SPG,27,27,0,27,1,8,7,1,NYSE
4288,10-02-2021 00:00,24 hrs.,stocks,SPH,6,6,0,6,1,1,0,1,NYSE
4288,10-02-2021 00:00,24 hrs.,stocks,TGT,47,47,0,47,1,19,5,1,NYSE
4288,10-02-2021 00:00,24 hrs.,stocks,TMO,74,74,0,74,2,27,12,2,NYSE
4288,10-02-2021 00:00,24 hrs.,stocks,TXT,11,11,0,11,1,1,5,1,NYSE
4288,10-02-2021 00:00,24 hrs.,stocks,APLE,12,12,0,12,1,3,2,1,NYSE
4288,10-02-2021 00:00,24 hrs.,stocks,CARR,27,27,0,27,1,8,7,1,NYSE
4288,10-02-2021 00:00,24 hrs.,stocks,CCIV,14,0,14,-14,2,2,2,1,NYSE
4288,10-02-2021 00:00,24 hrs.,stocks,CHGG,27,27,0,27,1,8,7,1,NYSE
4288,10-02-2021 00:00,24 hrs.,stocks,COLD,9,0,9,-9,1,2,1,1,NYSE
4288,10-02-2021 00:00,24 hrs.,stocks,COTY,27,27,0,27,1,8,7,1,NYSE
4288,10-02-2021 00:00,24 hrs.,stocks,CVNA,47,47,0,47,1,19,5,1,NYSE
4288,10-02-2021 00:00,24 hrs.,stocks,FSLY,24,0,24,-24,1,3,14,1,NYSE
4288,10-02-2021 00:00,24 hrs.,stocks,LGVW,30,0,30,-30,1,11,4,1,NYSE
4288,10-02-2021 00:00,24 hrs.,stocks,PACE,6,6,0,6,1,1,0,1,NYSE
4288,10-02-2021 00:00,24 hrs.,stocks,PGRE,6,6,0,6,1,1,0,1,NYSE
4288,10-02-2021 00:00,24 hrs.,stocks,PLTR,6,0,6,-6,1,1,0,1,NYSE
4288,10-02-2021 00:00,24 hrs.,stocks,RACE,6,6,0,6,1,1,0,1,NYSE
4288,10-02-2021 00:00,24 hrs.,stocks,SHOP,35,0,35,-35,1,11,9,1,NYSE
4288,10-02-2021 00:00,24 hrs.,stocks,SNAP,41,0,41,-41,2,12,9,2,NYSE
4288,10-02-2021 00:00,24 hrs.,stocks,SNPR,6,6,0,6,1,1,0,1,NYSE
4288,10-02-2021 00:00,24 hrs.,stocks,VSTO,16,0,16,-16,1,5,2,1,NYSE
4288,10-02-2021 00:00,24 hrs.,stocks,AMD,76,34,42,-8,3,18,28,3,NASDAQ
4288,10-02-2021 00:00,24 hrs.,stocks,BJK,15,0,15,-15,1,2,7,1,NASDAQ
4288,10-02-2021 00:00,24 hrs.,stocks,CGC,27,27,0,27,1,8,7,1,NASDAQ
4288,10-02-2021 00:00,24 hrs.,stocks,CSF,34,34,0,34,1,12,6,1,NASDAQ
4288,10-02-2021 00:00,24 hrs.,stocks,INO,6,6,0,6,1,1,0,1,NASDAQ
4288,10-02-2021 00:00,24 hrs.,SPACs,IBKR,14,14,0,14,1,0,10,1,NASDAQ
4288,10-02-2021 00:00,24 hrs.,SPACs,INAQ,288,288,0,288,2,109,62,2,NASDAQ
4288,10-02-2021 00:00,24 hrs.,SPACs,MCAC,60,60,0,60,1,19,18,1,NASDAQ
4288,10-02-2021 00:00,24 hrs.,SPACs,NBAC,17,0,17,-17,1,6,1,1,NASDAQ
4288,10-02-2021 00:00,24 hrs.,SPACs,NGAC,18,11,7,4,3,2,2,3,NASDAQ
4288,10-02-2021 00:00,24 hrs.,SPACs,PHUN,7,0,7,-7,1,1,1,1,NASDAQ
4288,10-02-2021 00:00,24 hrs.,SPACs,THCB,47,40,7,33,5,6,15,3,NASDAQ
4288,10-02-2021 00:00,24 hrs.,SPACs,TSIA,202,202,0,202,1,80,38,1,NASDAQ
4288,10-02-2021 00:00,24 hrs.,SPACs,UNIT,6,6,0,6,1,1,0,1,NASDAQ
4288,10-02-2021 00:00,24 hrs.,SPACs,VSPR,202,202,0,202,1,80,38,1,NASDAQ
4288,10-02-2021 00:00,24 hrs.,stocks,ALYI,6,0,6,-6,1,1,0,1,OTC
4288,10-02-2021 00:00,24 hrs.,stocks,BLSP,12,6,6,0,2,2,0,2,OTC
4288,10-02-2021 00:00,24 hrs.,stocks,BOTY,6,6,0,6,1,1,0,1,OTC
4288,10-02-2021 00:00,24 hrs.,stocks,CATV,6,0,6,-6,1,1,0,1,OTC
4288,10-02-2021 00:00,24 hrs.,stocks,EXMT,7,7,0,7,1,1,1,1,OTC
4288,10-02-2021 00:00,24 hrs.,stocks,HCMC,18,12,6,6,3,3,0,3,OTC
4288,10-02-2021 00:00,24 hrs.,stocks,HEMP,7,7,0,7,1,1,1,1,OTC
4288,10-02-2021 00:00,24 hrs.,stocks,HQGE,6,0,6,-6,1,1,0,1,OTC
4288,10-02-2021 00:00,24 hrs.,stocks,HYSR,6,6,0,6,1,1,0,1,OTC
4288,10-02-2021 00:00,24 hrs.,stocks,INND,6,6,0,6,1,1,0,1,OTC
4288,10-02-2021 00:00,24 hrs.,stocks,IPIX,12,0,12,-12,2,2,0,2,OTC
4288,10-02-2021 00:00,24 hrs.,stocks,LINK,33,33,0,33,2,9,7,2,OTC
4288,10-02-2021 00:00,24 hrs.,stocks,PHOT,6,6,0,6,1,1,0,1,OTC
4288,10-02-2021 00:00,24 hrs.,stocks,TXTM,6,6,0,6,1,1,0,1,OTC
4288,10-02-2021 00:00,24 hrs.,stocks,USEI,6,0,6,-6,1,1,0,1,OTC
4288,10-02-2021 00:00,24 hrs.,stocks,USRM,6,0,6,-6,1,1,0,1,OTC
4288,10-02-2021 00:00,24 hrs.,stocks,VPOR,12,0,12,-12,2,2,0,1,OTC
4288,10-02-2021 00:00,24 hrs.,stocks,CURLF,6,0,6,-6,1,1,0,1,OTC
4288,10-02-2021 00:00,24 hrs.,stocks,CYLYF,44,0,44,-44,1,17,6,1,OTC
4288,10-02-2021 00:00,24 hrs.,stocks,GTBIF,6,0,6,-6,1,1,0,1,OTC
4288,10-02-2021 00:00,24 hrs.,stocks,OTGLY,6,0,6,-6,1,1,0,1,OTC
4288,10-02-2021 00:00,24 hrs.,stocks,REZZF,7,7,0,7,1,1,1,1,OTC
4288,10-02-2021 00:00,24 hrs.,stocks,DNN,10,10,0,10,1,2,2,1,AMEX
4288,10-02-2021 00:00,24 hrs.,stocks,GLU,19,0,19,-19,1,3,9,1,AMEX
4288,10-02-2021 00:00,24 hrs.,stocks,NBA,27,27,0,27,1,8,7,1,AMEX
4288,10-02-2021 00:00,24 hrs.,stocks,REI,6,0,6,-6,1,1,0,1,AMEX
4288,10-02-2021 00:00,24 hrs.,stocks,ZOM,19,7,12,-5,3,3,1,3,AMEX
4288,10-02-2021 00:00,24 hrs.,stocks,TMBR,12,12,0,12,2,2,0,1,AMEX
4288,10-02-2021 00:00,24 hrs.,stocks,ABT,47,47,0,47,1,19,5,1,NYSE
4288,10-02-2021 00:00,24 hrs.,stocks,AMC,11018,91,10927,-10836,10,5171,636,10,NYSE
4288,10-02-2021 00:00,24 hrs.,stocks,ATH,42,0,42,-42,1,8,22,1,NYSE
4288,10-02-2021 00:00,24 hrs.,stocks,ATR,1252,0,1252,-1252,1,72,1104,1,NYSE
4288,10-02-2021 00:00,24 hrs.,stocks,CBO,27,27,0,27,1,8,7,1,NYSE
4288,10-02-2021 00:00,24 hrs.,stocks,CMG,13,0,13,-13,1,2,5,1,NYSE
4288,10-02-2021 00:00,24 hrs.,stocks,CNC,27,27,0,27,1,8,7,1,NYSE
4288,10-02-2021 00:00,24 hrs.,stocks,CPE,6,6,0,6,1,1,0,1,NYSE
4288,10-02-2021 00:00,24 hrs.,stocks,DAL,15,0,15,-15,1,2,7,1,NYSE
4288,10-02-2021 00:00,24 hrs.,stocks,DFS,34,34,0,34,1,12,6,1,NYSE
4288,10-02-2021 00:00,24 hrs.,stocks,DIS,47,47,0,47,1,19,5,1,NYSE
4288,10-02-2021 00:00,24 hrs.,stocks,EPC,27,27,0,27,1,8,7,1,NYSE
4288,10-02-2021 00:00,24 hrs.,stocks,EQC,12,12,0,12,1,3,2,1,NYSE
4288,10-02-2021 00:00,24 hrs.,stocks,FLT,6,6,0,6,1,1,0,1,NYSE
4288,10-02-2021 00:00,24 hrs.,stocks,FMS,18,12,6,6,2,4,2,2,NYSE
4288,10-02-2021 00:00,24 hrs.,stocks,FRO,6,0,6,-6,1,1,0,1,NYSE
4288,10-02-2021 00:00,24 hrs.,stocks,GME,11025,103,10922,-10819,11,5180,621,10,NYSE
4288,10-02-2021 00:00,24 hrs.,stocks,GNW,6,0,6,-6,1,1,0,1,NYSE
4288,10-02-2021 00:00,24 hrs.,stocks,HBI,27,27,0,27,1,8,7,1,NYSE
4288,10-02-2021 00:00,24 hrs.,stocks,IDT,47,47,0,47,1,19,5,1,NYSE
4288,10-02-2021 00:00,24 hrs.,stocks,JNJ,47,47,0,47,1,19,5,1,NYSE
4288,10-02-2021 00:00,24 hrs.,stocks,KIM,12,12,0,12,1,3,2,1,NYSE
4288,10-02-2021 00:00,24 hrs.,stocks,LLY,27,27,0,27,1,8,7,1,NYSE
4288,10-02-2021 00:00,24 hrs.,stocks,MOD,28,28,0,28,1,9,6,1,NYSE
4288,10-02-2021 00:00,24 hrs.,stocks,NIO,6,0,6,-6,1,1,0,1,NYSE
4288,10-02-2021 00:00,24 hrs.,stocks,NOK,10823,0,10823,-10823,1,5138,543,1,NYSE
4262,09-02-2021 18:00,24 hrs.,stocks,DNLI,795,795,0,795,1,372,47,1,NASDAQ
4262,09-02-2021 18:00,24 hrs.,stocks,DOYU,232,0,232,-232,1,93,42,1,NASDAQ
4262,09-02-2021 18:00,24 hrs.,stocks,DVAX,14,0,14,-14,1,3,4,1,NASDAQ
4262,09-02-2021 18:00,24 hrs.,stocks,EDIT,132,91,41,50,4,35,46,4,NASDAQ
4262,09-02-2021 18:00,24 hrs.,stocks,ENVB,6,0,6,-6,1,1,0,1,NASDAQ
4262,09-02-2021 18:00,24 hrs.,stocks,ESPO,37,0,37,-37,1,11,11,1,NASDAQ
4262,09-02-2021 18:00,24 hrs.,stocks,EWEB,59,38,21,17,2,12,27,2,NASDAQ
4262,09-02-2021 18:00,24 hrs.,stocks,EXEL,795,795,0,795,1,372,47,1,NASDAQ
4262,09-02-2021 18:00,24 hrs.,stocks,EXPI,142,56,86,-30,3,31,68,3,NASDAQ
4262,09-02-2021 18:00,24 hrs.,stocks,FLGT,12,6,6,0,2,2,0,2,NASDAQ
4262,09-02-2021 18:00,24 hrs.,stocks,FREQ,6,6,0,6,1,1,0,1,NASDAQ
4262,09-02-2021 18:00,24 hrs.,stocks,FUTU,6,6,0,6,1,1,0,1,NASDAQ
4262,09-02-2021 18:00,24 hrs.,stocks,GBDC,7,0,7,-7,1,1,1,1,NASDAQ
4262,09-02-2021 18:00,24 hrs.,stocks,GENE,6,0,6,-6,1,1,0,1,NASDAQ
4262,09-02-2021 18:00,24 hrs.,RobinHoodPennyStocks,SAVA,489,0,489,-489,2,193,95,2,NASDAQ
4262,09-02-2021 18:00,24 hrs.,RobinHoodPennyStocks,SBBP,442,0,442,-442,1,183,72,1,NASDAQ
4262,09-02-2021 18:00,24 hrs.,RobinHoodPennyStocks,SEED,442,0,442,-442,1,183,72,1,NASDAQ
4262,09-02-2021 18:00,24 hrs.,RobinHoodPennyStocks,SELB,6,6,0,6,1,1,0,1,NASDAQ
4262,09-02-2021 18:00,24 hrs.,RobinHoodPennyStocks,SHIP,448,6,442,-436,2,184,72,2,NASDAQ
4262,09-02-2021 18:00,24 hrs.,RobinHoodPennyStocks,SLGG,22,22,0,22,1,6,6,1,NASDAQ
4262,09-02-2021 18:00,24 hrs.,RobinHoodPennyStocks,SLRX,6,6,0,6,1,1,0,1,NASDAQ
4262,09-02-2021 18:00,24 hrs.,RobinHoodPennyStocks,SNDL,1066,533,533,0,34,372,186,24,NASDAQ
4262,09-02-2021 18:00,24 hrs.,RobinHoodPennyStocks,SOLO,442,0,442,-442,1,183,72,1,NASDAQ
4262,09-02-2021 18:00,24 hrs.,RobinHoodPennyStocks,SONM,25,25,0,25,1,9,3,1,NASDAQ
4262,09-02-2021 18:00,24 hrs.,RobinHoodPennyStocks,SRGA,2492,2492,0,2492,3,1149,182,3,NASDAQ
4262,09-02-2021 18:00,24 hrs.,RobinHoodPennyStocks,SUNW,442,0,442,-442,1,183,72,1,NASDAQ
4262,09-02-2021 18:00,24 hrs.,RobinHoodPennyStocks,SXTC,442,0,442,-442,1,183,72,1,NASDAQ
4262,09-02-2021 18:00,24 hrs.,RobinHoodPennyStocks,SYPR,442,0,442,-442,1,183,72,1,NASDAQ
4262,09-02-2021 18:00,24 hrs.,RobinHoodPennyStocks,TANH,442,0,442,-442,1,183,72,1,NASDAQ
4262,09-02-2021 18:00,24 hrs.,RobinHoodPennyStocks,TAOP,442,0,442,-442,1,183,72,1,NASDAQ
4262,09-02-2021 18:00,24 hrs.,RobinHoodPennyStocks,TEDU,442,0,442,-442,1,183,72,1,NASDAQ
4262,09-02-2021 18:00,24 hrs.,RobinHoodPennyStocks,TIGR,442,0,442,-442,1,183,72,1,NASDAQ
4262,09-02-2021 18:00,24 hrs.,RobinHoodPennyStocks,TLRY,442,0,442,-442,1,183,72,1,NASDAQ
4262,09-02-2021 18:00,24 hrs.,RobinHoodPennyStocks,TLSA,442,0,442,-442,1,183,72,1,NASDAQ
4262,09-02-2021 18:00,24 hrs.,RobinHoodPennyStocks,TNXP,2701,2593,108,2485,9,1227,211,8,NASDAQ
4262,09-02-2021 18:00,24 hrs.,RobinHoodPennyStocks,TOPS,18,18,0,18,3,3,0,3,NASDAQ
4262,09-02-2021 18:00,24 hrs.,RobinHoodPennyStocks,TRCH,456,14,442,-428,2,188,72,2,NASDAQ
4262,09-02-2021 18:00,24 hrs.,RobinHoodPennyStocks,TRVN,484,42,442,-400,2,201,74,2,NASDAQ
4262,09-02-2021 18:00,24 hrs.,RobinHoodPennyStocks,TSLA,6,6,0,6,1,1,0,1,NASDAQ
4262,09-02-2021 18:00,24 hrs.,RobinHoodPennyStocks,TTOO,442,0,442,-442,1,183,72,1,NASDAQ
4262,09-02-2021 18:00,24 hrs.,RobinHoodPennyStocks,TXMD,48,36,12,24,7,9,2,6,NASDAQ
4262,09-02-2021 18:00,24 hrs.,RobinHoodPennyStocks,TYME,454,6,448,-442,3,185,72,3,NASDAQ
4262,09-02-2021 18:00,24 hrs.,RobinHoodPennyStocks,UONE,442,0,442,-442,1,183,72,1,NASDAQ
4262,09-02-2021 18:00,24 hrs.,RobinHoodPennyStocks,USWS,27,27,0,27,1,8,7,1,NASDAQ
4262,09-02-2021 18:00,24 hrs.,RobinHoodPennyStocks,UXIN,442,0,442,-442,1,183,72,1,NASDAQ
4262,09-02-2021 18:00,24 hrs.,RobinHoodPennyStocks,VBIV,12,12,0,12,2,2,0,1,NASDAQ
4262,09-02-2021 18:00,24 hrs.,RobinHoodPennyStocks,VERU,24,12,12,0,3,3,6,3,NASDAQ
4262,09-02-2021 18:00,24 hrs.,RobinHoodPennyStocks,VTVT,442,0,442,-442,1,183,72,1,NASDAQ
4262,09-02-2021 18:00,24 hrs.,RobinHoodPennyStocks,VXRT,442,0,442,-442,1,183,72,1,NASDAQ
4262,09-02-2021 18:00,24 hrs.,RobinHoodPennyStocks,VYNE,6,6,0,6,1,1,0,1,NASDAQ
4262,09-02-2021 18:00,24 hrs.,RobinHoodPennyStocks,WATT,442,0,442,-442,1,183,72,1,NASDAQ
4262,09-02-2021 18:00,24 hrs.,RobinHoodPennyStocks,WIMI,442,0,442,-442,1,183,72,1,NASDAQ
4262,09-02-2021 18:00,24 hrs.,RobinHoodPennyStocks,XSPA,16,0,16,-16,1,6,0,1,NASDAQ
4262,09-02-2021 18:00,24 hrs.,RobinHoodPennyStocks,YGMZ,442,0,442,-442,1,183,72,1,NASDAQ
4262,09-02-2021 18:00,24 hrs.,RobinHoodPennyStocks,ZKIN,6,0,6,-6,1,1,0,1,NASDAQ
4262,09-02-2021 18:00,24 hrs.,RobinHoodPennyStocks,ZSAN,3000,2965,35,2930,14,1311,322,14,NASDAQ
4262,09-02-2021 18:00,24 hrs.,RobinHoodPennyStocks,UONEK,442,0,442,-442,1,183,72,1,NASDAQ
4262,09-02-2021 18:00,24 hrs.,stocks,SNAP,46,40,6,34,3,12,10,3,NYSE
4262,09-02-2021 18:00,24 hrs.,stocks,SNOW,16,0,16,-16,1,3,6,1,NYSE
4262,09-02-2021 18:00,24 hrs.,stocks,SPCE,51,0,51,-51,1,20,7,1,NYSE
4262,09-02-2021 18:00,24 hrs.,stocks,TDOC,9,0,9,-9,1,0,5,1,NYSE
4262,09-02-2021 18:00,24 hrs.,stocks,VSTO,14,0,14,-14,1,4,2,1,NYSE
4262,09-02-2021 18:00,24 hrs.,stocks,WBAI,6,0,6,-6,1,1,0,1,NYSE
4262,09-02-2021 18:00,24 hrs.,stocks,AIQ,33,33,0,33,1,9,11,1,NASDAQ
4262,09-02-2021 18:00,24 hrs.,stocks,ALT,13,0,13,-13,1,1,7,1,NASDAQ
4262,09-02-2021 18:00,24 hrs.,stocks,AMD,99,75,24,51,5,20,39,5,NASDAQ
4262,09-02-2021 18:00,24 hrs.,stocks,BJK,15,15,0,15,1,2,7,1,NASDAQ
4262,09-02-2021 18:00,24 hrs.,stocks,CFO,457,0,457,-457,2,194,61,2,NASDAQ
4262,09-02-2021 18:00,24 hrs.,stocks,CGC,32,32,0,32,2,7,10,2,NASDAQ
4262,09-02-2021 18:00,24 hrs.,stocks,CSF,25,25,0,25,1,8,5,1,NASDAQ
4262,09-02-2021 18:00,24 hrs.,stocks,DYN,6,6,0,6,1,1,0,1,NASDAQ
4262,09-02-2021 18:00,24 hrs.,stocks,HAS,6,6,0,6,1,1,0,1,NASDAQ
4262,09-02-2021 18:00,24 hrs.,stocks,MOR,795,795,0,795,1,372,47,1,NASDAQ
4262,09-02-2021 18:00,24 hrs.,stocks,MWK,7,0,7,-7,1,1,1,1,NASDAQ
4262,09-02-2021 18:00,24 hrs.,stocks,MYT,13,13,0,13,1,0,9,1,NASDAQ
4262,09-02-2021 18:00,24 hrs.,stocks,OEG,27,0,27,-27,1,4,15,1,NASDAQ
4262,09-02-2021 18:00,24 hrs.,stocks,OGI,6,0,6,-6,1,1,0,1,NASDAQ
4262,09-02-2021 18:00,24 hrs.,stocks,QQQ,31,0,31,-31,2,5,13,2,NASDAQ
4262,09-02-2021 18:00,24 hrs.,stocks,RNA,19,19,0,19,1,6,3,1,NASDAQ
4262,09-02-2021 18:00,24 hrs.,stocks,SFT,12,0,12,-12,1,3,2,1,NASDAQ
4262,09-02-2021 18:00,24 hrs.,stocks,SMH,13,13,0,13,1,1,7,1,NASDAQ
4262,09-02-2021 18:00,24 hrs.,stocks,SND,6,0,6,-6,1,1,0,1,NASDAQ
4262,09-02-2021 18:00,24 hrs.,stocks,VFF,6,6,0,6,1,1,0,1,NASDAQ
4262,09-02-2021 18:00,24 hrs.,stocks,AAPL,73,43,30,13,3,19,23,3,NASDAQ
4262,09-02-2021 18:00,24 hrs.,stocks,ADMA,35,35,0,35,2,10,7,2,NASDAQ
4262,09-02-2021 18:00,24 hrs.,stocks,ADMP,6,6,0,6,1,1,0,1,NASDAQ
4262,09-02-2021 18:00,24 hrs.,stocks,ADXS,6,0,6,-6,1,1,0,1,NASDAQ
4262,09-02-2021 18:00,24 hrs.,stocks,AEZS,18,6,12,-6,3,3,0,3,NASDAQ
4262,09-02-2021 18:00,24 hrs.,stocks,AGTC,6,0,6,-6,1,1,0,1,NASDAQ
4262,09-02-2021 18:00,24 hrs.,stocks,AMRN,31,31,0,31,1,13,1,1,NASDAQ
4262,09-02-2021 18:00,24 hrs.,stocks,AMTX,6,6,0,6,1,1,0,1,NASDAQ
4262,09-02-2021 18:00,24 hrs.,stocks,AMZN,51,7,44,-37,3,6,27,3,NASDAQ
4262,09-02-2021 18:00,24 hrs.,stocks,APHA,74,47,27,20,4,17,24,4,NASDAQ
4262,09-02-2021 18:00,24 hrs.,stocks,APPS,19,13,6,7,2,3,5,2,NASDAQ
4262,09-02-2021 18:00,24 hrs.,stocks,APWC,6,6,0,6,1,1,0,1,NASDAQ
4262,09-02-2021 18:00,24 hrs.,stocks,ASRT,6,0,6,-6,1,1,0,1,NASDAQ
4262,09-02-2021 18:00,24 hrs.,stocks,AUPH,71,0,71,-71,1,29,9,1,NASDAQ
4262,09-02-2021 18:00,24 hrs.,stocks,AVXL,12,0,12,-12,2,2,0,1,NASDAQ
4262,09-02-2021 18:00,24 hrs.,stocks,BBIG,6,6,0,6,1,1,0,1,NASDAQ
4262,09-02-2021 18:00,24 hrs.,stocks,BCRX,1311,0,1311,-1311,1,564,179,1,NASDAQ
4262,09-02-2021 18:00,24 hrs.,stocks,BIDU,10013,0,10013,-10013,1,4757,495,1,NASDAQ
4262,09-02-2021 18:00,24 hrs.,stocks,BIOL,6,0,6,-6,1,1,0,1,NASDAQ
4262,09-02-2021 18:00,24 hrs.,stocks,BNTX,6,0,6,-6,1,1,0,1,NASDAQ
4262,09-02-2021 18:00,24 hrs.,stocks,BSQR,39,33,6,27,2,10,11,2,NASDAQ
4262,09-02-2021 18:00,24 hrs.,stocks,BTBT,6,6,0,6,1,1,0,1,NASDAQ
4262,09-02-2021 18:00,24 hrs.,stocks,BVXV,7,0,7,-7,1,1,1,1,NASDAQ
4262,09-02-2021 18:00,24 hrs.,stocks,BXRX,16,6,10,-4,2,4,0,2,NASDAQ
4262,09-02-2021 18:00,24 hrs.,stocks,CBAY,6,0,6,-6,1,1,0,1,NASDAQ
4262,09-02-2021 18:00,24 hrs.,stocks,CDMO,795,795,0,795,1,372,47,1,NASDAQ
4262,09-02-2021 18:00,24 hrs.,stocks,CHCI,12,6,6,0,2,2,0,2,NASDAQ
4262,09-02-2021 18:00,24 hrs.,stocks,CHKP,6,0,6,-6,1,1,0,1,NASDAQ
4262,09-02-2021 18:00,24 hrs.,stocks,CLNE,7,7,0,7,1,1,1,1,NASDAQ
4262,09-02-2021 18:00,24 hrs.,stocks,CLSK,6,6,0,6,1,1,0,1,NASDAQ
4262,09-02-2021 18:00,24 hrs.,stocks,CODX,7,7,0,7,1,1,1,1,NASDAQ
4262,09-02-2021 18:00,24 hrs.,stocks,CRBP,14,0,14,-14,1,4,2,1,NASDAQ
4262,09-02-2021 18:00,24 hrs.,stocks,CRSR,557,557,0,557,9,190,141,8,NASDAQ
4262,09-02-2021 18:00,24 hrs.,stocks,CTRM,6,6,0,6,1,1,0,1,NASDAQ
4262,09-02-2021 18:00,24 hrs.,stocks,DCRB,37,37,0,37,2,13,3,2,NASDAQ
4262,09-02-2021 18:00,24 hrs.,stocks,DDOG,21,0,21,-21,1,4,9,1,NASDAQ
4262,09-02-2021 18:00,24 hrs.,stocks,DISH,436,0,436,-436,1,190,52,1,NASDAQ
4262,09-02-2021 18:00,24 hrs.,stocks,DKNG,544,37,507,-470,4,212,104,4,NASDAQ
4262,09-02-2021 18:00,24 hrs.,RobinHoodPennyStocks,JRJC,442,0,442,-442,1,183,72,1,NASDAQ
4262,09-02-2021 18:00,24 hrs.,RobinHoodPennyStocks,KALV,7,7,0,7,1,1,1,1,NASDAQ
4262,09-02-2021 18:00,24 hrs.,RobinHoodPennyStocks,KERN,442,0,442,-442,1,183,72,1,NASDAQ
4262,09-02-2021 18:00,24 hrs.,RobinHoodPennyStocks,KTRA,143,143,0,143,1,58,23,1,NASDAQ
4262,09-02-2021 18:00,24 hrs.,RobinHoodPennyStocks,KXIN,442,0,442,-442,1,183,72,1,NASDAQ
4262,09-02-2021 18:00,24 hrs.,RobinHoodPennyStocks,LIVE,6,6,0,6,1,1,0,1,NASDAQ
4262,09-02-2021 18:00,24 hrs.,RobinHoodPennyStocks,LKCO,12,12,0,12,2,2,0,2,NASDAQ
4262,09-02-2021 18:00,24 hrs.,RobinHoodPennyStocks,LLNW,26,26,0,26,1,7,8,1,NASDAQ
4262,09-02-2021 18:00,24 hrs.,RobinHoodPennyStocks,LMFA,442,0,442,-442,1,183,72,1,NASDAQ
4262,09-02-2021 18:00,24 hrs.,RobinHoodPennyStocks,LMNL,442,0,442,-442,1,183,72,1,NASDAQ
4262,09-02-2021 18:00,24 hrs.,RobinHoodPennyStocks,LXEH,442,0,442,-442,1,183,72,1,NASDAQ
4262,09-02-2021 18:00,24 hrs.,RobinHoodPennyStocks,MARA,521,6,515,-509,3,211,87,3,NASDAQ
4262,09-02-2021 18:00,24 hrs.,RobinHoodPennyStocks,MBRX,442,0,442,-442,1,183,72,1,NASDAQ
4262,09-02-2021 18:00,24 hrs.,RobinHoodPennyStocks,MOGO,442,0,442,-442,1,183,72,1,NASDAQ
4262,09-02-2021 18:00,24 hrs.,RobinHoodPennyStocks,MOXC,442,0,442,-442,1,183,72,1,NASDAQ
4262,09-02-2021 18:00,24 hrs.,RobinHoodPennyStocks,MRKR,7,0,7,-7,1,1,1,1,NASDAQ
4262,09-02-2021 18:00,24 hrs.,RobinHoodPennyStocks,MVIS,6,0,6,-6,1,1,0,1,NASDAQ
4262,09-02-2021 18:00,24 hrs.,RobinHoodPennyStocks,MYSZ,6,6,0,6,1,1,0,1,NASDAQ
4262,09-02-2021 18:00,24 hrs.,RobinHoodPennyStocks,NAKD,2500,2488,12,2476,4,1150,184,4,NASDAQ
4262,09-02-2021 18:00,24 hrs.,RobinHoodPennyStocks,NBRV,6,6,0,6,1,1,0,1,NASDAQ
4262,09-02-2021 18:00,24 hrs.,RobinHoodPennyStocks,NCTY,442,0,442,-442,1,183,72,1,NASDAQ
4262,09-02-2021 18:00,24 hrs.,RobinHoodPennyStocks,NDRA,30,0,30,-30,2,7,8,1,NASDAQ
4262,09-02-2021 18:00,24 hrs.,RobinHoodPennyStocks,NKTX,442,0,442,-442,1,183,72,1,NASDAQ
4262,09-02-2021 18:00,24 hrs.,RobinHoodPennyStocks,NMTR,26,0,26,-26,1,9,4,1,NASDAQ
4262,09-02-2021 18:00,24 hrs.,RobinHoodPennyStocks,NOVN,138,53,85,-32,7,42,26,7,NASDAQ
4262,09-02-2021 18:00,24 hrs.,RobinHoodPennyStocks,NXTD,454,12,442,-430,3,185,72,3,NASDAQ
4262,09-02-2021 18:00,24 hrs.,RobinHoodPennyStocks,OCGN,1623,803,820,-17,11,625,329,10,NASDAQ
4262,09-02-2021 18:00,24 hrs.,RobinHoodPennyStocks,ONTX,78,30,48,-18,8,15,16,7,NASDAQ
4262,09-02-2021 18:00,24 hrs.,RobinHoodPennyStocks,OPGN,521,39,482,-443,12,199,75,4,NASDAQ
4262,09-02-2021 18:00,24 hrs.,RobinHoodPennyStocks,OPTT,442,0,442,-442,1,183,72,1,NASDAQ
4262,09-02-2021 18:00,24 hrs.,RobinHoodPennyStocks,ORIC,442,0,442,-442,1,183,72,1,NASDAQ
4262,09-02-2021 18:00,24 hrs.,RobinHoodPennyStocks,OTLK,22,6,16,-10,3,3,4,3,NASDAQ
4262,09-02-2021 18:00,24 hrs.,RobinHoodPennyStocks,PBTS,2462,2462,0,2462,1,1140,178,1,NASDAQ
4262,09-02-2021 18:00,24 hrs.,RobinHoodPennyStocks,PECK,442,0,442,-442,1,183,72,1,NASDAQ
4262,09-02-2021 18:00,24 hrs.,RobinHoodPennyStocks,PEIX,442,0,442,-442,1,183,72,1,NASDAQ
4262,09-02-2021 18:00,24 hrs.,RobinHoodPennyStocks,PETZ,442,0,442,-442,1,183,72,1,NASDAQ
4262,09-02-2021 18:00,24 hrs.,RobinHoodPennyStocks,PHUN,442,0,442,-442,1,183,72,1,NASDAQ
4262,09-02-2021 18:00,24 hrs.,RobinHoodPennyStocks,PLAY,2462,2462,0,2462,1,1140,178,1,NASDAQ
4262,09-02-2021 18:00,24 hrs.,RobinHoodPennyStocks,PLIN,442,0,442,-442,1,183,72,1,NASDAQ
4262,09-02-2021 18:00,24 hrs.,RobinHoodPennyStocks,PLRX,442,0,442,-442,1,183,72,1,NASDAQ
4262,09-02-2021 18:00,24 hrs.,RobinHoodPennyStocks,PLUG,442,0,442,-442,1,183,72,1,NASDAQ
4262,09-02-2021 18:00,24 hrs.,RobinHoodPennyStocks,PLUS,442,0,442,-442,1,183,72,1,NASDAQ
4262,09-02-2021 18:00,24 hrs.,RobinHoodPennyStocks,PLYA,6,6,0,6,1,1,0,1,NASDAQ
4262,09-02-2021 18:00,24 hrs.,RobinHoodPennyStocks,PRTA,442,0,442,-442,1,183,72,1,NASDAQ
4262,09-02-2021 18:00,24 hrs.,RobinHoodPennyStocks,PSHG,442,0,442,-442,1,183,72,1,NASDAQ
4262,09-02-2021 18:00,24 hrs.,RobinHoodPennyStocks,RCON,442,0,442,-442,1,183,72,1,NASDAQ
4262,09-02-2021 18:00,24 hrs.,RobinHoodPennyStocks,REGI,442,0,442,-442,1,183,72,1,NASDAQ
4262,09-02-2021 18:00,24 hrs.,RobinHoodPennyStocks,RIOT,521,6,515,-509,3,211,87,3,NASDAQ
4262,09-02-2021 18:00,24 hrs.,RobinHoodPennyStocks,SALM,442,0,442,-442,1,183,72,1,NASDAQ
4262,09-02-2021 18:00,24 hrs.,stocks,DSSI,6,6,0,6,1,1,0,1,NYSE
4262,09-02-2021 18:00,24 hrs.,stocks,EXPR,6,6,0,6,1,1,0,1,NYSE
4262,09-02-2021 18:00,24 hrs.,stocks,FSLY,26,0,26,-26,1,5,12,1,NYSE
4262,09-02-2021 18:00,24 hrs.,stocks,FUBO,436,0,436,-436,1,190,52,1,NYSE
4262,09-02-2021 18:00,24 hrs.,stocks,FVRR,6,0,6,-6,1,1,0,1,NYSE
4262,09-02-2021 18:00,24 hrs.,stocks,HUYA,232,0,232,-232,1,93,42,1,NYSE
4262,09-02-2021 18:00,24 hrs.,stocks,IPOE,117,117,0,117,1,21,71,1,NYSE
4262,09-02-2021 18:00,24 hrs.,stocks,JMIA,86,0,86,-86,1,18,46,1,NYSE
4262,09-02-2021 18:00,24 hrs.,stocks,LGVW,36,30,6,24,2,12,4,2,NYSE
4262,09-02-2021 18:00,24 hrs.,stocks,LMND,117,117,0,117,1,21,71,1,NYSE
4262,09-02-2021 18:00,24 hrs.,stocks,PACE,6,6,0,6,1,1,0,1,NYSE
4262,09-02-2021 18:00,24 hrs.,stocks,PGRE,6,6,0,6,1,1,0,1,NYSE
4262,09-02-2021 18:00,24 hrs.,stocks,PLTR,45,6,39,-33,3,7,19,3,NYSE
4262,09-02-2021 18:00,24 hrs.,stocks,RACE,6,6,0,6,1,1,0,1,NYSE
4262,09-02-2021 18:00,24 hrs.,stocks,SHOP,40,40,0,40,2,11,10,2,NYSE
4262,09-02-2021 18:00,24 hrs.,stocks,FRO,6,0,6,-6,1,1,0,1,NYSE
4262,09-02-2021 18:00,24 hrs.,stocks,FSR,13,0,13,-13,1,1,7,1,NYSE
4262,09-02-2021 18:00,24 hrs.,stocks,GME,12855,2602,10253,-7651,32,5892,943,30,NYSE
4262,09-02-2021 18:00,24 hrs.,stocks,GNW,18,0,18,-18,3,3,0,1,NYSE
4262,09-02-2021 18:00,24 hrs.,stocks,HBI,23,23,0,23,1,6,7,1,NYSE
4262,09-02-2021 18:00,24 hrs.,stocks,IDT,19,19,0,19,1,6,3,1,NYSE
4262,09-02-2021 18:00,24 hrs.,stocks,JNJ,19,19,0,19,1,6,3,1,NYSE
4262,09-02-2021 18:00,24 hrs.,stocks,KIM,8,8,0,8,1,2,0,1,NYSE
4262,09-02-2021 18:00,24 hrs.,stocks,LLY,23,23,0,23,1,6,7,1,NYSE
4262,09-02-2021 18:00,24 hrs.,stocks,NIO,12,6,6,0,2,2,0,2,NYSE
4262,09-02-2021 18:00,24 hrs.,stocks,NOK,10121,6,10115,-10109,6,4781,535,6,NYSE
4262,09-02-2021 18:00,24 hrs.,stocks,PFE,10,10,0,10,1,1,4,1,NYSE
4262,09-02-2021 18:00,24 hrs.,stocks,PFS,25,25,0,25,1,8,5,1,NYSE
4262,09-02-2021 18:00,24 hrs.,stocks,RBC,13,6,7,-1,2,1,3,2,NYSE
4262,09-02-2021 18:00,24 hrs.,stocks,RCL,6,6,0,6,1,1,0,1,NYSE
4262,09-02-2021 18:00,24 hrs.,stocks,RKT,104,0,104,-104,1,29,42,1,NYSE
4262,09-02-2021 18:00,24 hrs.,stocks,RSI,804,804,0,804,1,47,706,1,NYSE
4262,09-02-2021 18:00,24 hrs.,stocks,SAP,10013,0,10013,-10013,1,4757,495,1,NYSE
4262,09-02-2021 18:00,24 hrs.,stocks,SOS,6,0,6,-6,1,1,0,1,NYSE
4262,09-02-2021 18:00,24 hrs.,stocks,SPG,23,23,0,23,1,6,7,1,NYSE
4262,09-02-2021 18:00,24 hrs.,stocks,SPH,6,6,0,6,1,1,0,1,NYSE
4262,09-02-2021 18:00,24 hrs.,stocks,SWN,22,0,22,-22,1,7,4,1,NYSE
4262,09-02-2021 18:00,24 hrs.,stocks,TDA,10,0,10,-10,1,2,2,1,NYSE
4262,09-02-2021 18:00,24 hrs.,stocks,TGT,19,19,0,19,1,6,3,1,NYSE
4262,09-02-2021 18:00,24 hrs.,stocks,TMO,42,42,0,42,2,12,10,2,NYSE
4262,09-02-2021 18:00,24 hrs.,stocks,TXT,11,11,0,11,1,1,5,1,NYSE
4262,09-02-2021 18:00,24 hrs.,stocks,WMT,28,0,28,-28,1,3,18,1,NYSE
4262,09-02-2021 18:00,24 hrs.,stocks,XOM,9,0,9,-9,1,2,1,1,NYSE
4262,09-02-2021 18:00,24 hrs.,stocks,ALUS,6,0,6,-6,1,1,0,1,NYSE
4262,09-02-2021 18:00,24 hrs.,stocks,APLE,8,8,0,8,1,2,0,1,NYSE
4262,09-02-2021 18:00,24 hrs.,stocks,ARGO,6,6,0,6,1,1,0,1,NYSE
4262,09-02-2021 18:00,24 hrs.,stocks,BEPC,13,13,0,13,1,4,1,1,NYSE
4262,09-02-2021 18:00,24 hrs.,stocks,CARR,23,23,0,23,1,6,7,1,NYSE
4262,09-02-2021 18:00,24 hrs.,stocks,CCIV,20,6,14,-8,3,3,2,2,NYSE
4262,09-02-2021 18:00,24 hrs.,stocks,CHGG,40,23,17,6,2,9,14,2,NYSE
4262,09-02-2021 18:00,24 hrs.,stocks,COLD,7,0,7,-7,1,1,1,1,NYSE
4262,09-02-2021 18:00,24 hrs.,stocks,COTY,29,23,6,17,2,7,7,2,NYSE
4262,09-02-2021 18:00,24 hrs.,stocks,CVNA,19,19,0,19,1,6,3,1,NYSE
4262,09-02-2021 18:00,24 hrs.,RobinHoodPennyStocks,EBON,442,0,442,-442,1,183,72,1,NASDAQ
4262,09-02-2021 18:00,24 hrs.,RobinHoodPennyStocks,EDIT,282,282,0,282,1,114,50,1,NASDAQ
4262,09-02-2021 18:00,24 hrs.,RobinHoodPennyStocks,ELYS,442,0,442,-442,1,183,72,1,NASDAQ
4262,09-02-2021 18:00,24 hrs.,RobinHoodPennyStocks,ENVB,129,0,129,-129,5,41,27,3,NASDAQ
4262,09-02-2021 18:00,24 hrs.,RobinHoodPennyStocks,EQOS,442,0,442,-442,1,183,72,1,NASDAQ
4262,09-02-2021 18:00,24 hrs.,RobinHoodPennyStocks,ETTX,6,0,6,-6,1,1,0,1,NASDAQ
4262,09-02-2021 18:00,24 hrs.,RobinHoodPennyStocks,EVFM,18,0,18,-18,1,0,14,1,NASDAQ
4262,09-02-2021 18:00,24 hrs.,RobinHoodPennyStocks,EVOK,7,7,0,7,1,1,1,1,NASDAQ
4262,09-02-2021 18:00,24 hrs.,RobinHoodPennyStocks,FCEL,442,0,442,-442,1,183,72,1,NASDAQ
4262,09-02-2021 18:00,24 hrs.,RobinHoodPennyStocks,GEVO,448,0,448,-448,2,184,72,2,NASDAQ
4262,09-02-2021 18:00,24 hrs.,RobinHoodPennyStocks,GHSI,35,29,6,23,2,11,5,2,NASDAQ
4262,09-02-2021 18:00,24 hrs.,RobinHoodPennyStocks,GLUU,442,0,442,-442,1,183,72,1,NASDAQ
4262,09-02-2021 18:00,24 hrs.,RobinHoodPennyStocks,GMDA,442,0,442,-442,1,183,72,1,NASDAQ
4262,09-02-2021 18:00,24 hrs.,RobinHoodPennyStocks,GNPX,6,0,6,-6,1,1,0,1,NASDAQ
4262,09-02-2021 18:00,24 hrs.,RobinHoodPennyStocks,HEPA,18,0,18,-18,1,0,14,1,NASDAQ
4262,09-02-2021 18:00,24 hrs.,RobinHoodPennyStocks,HGEN,442,0,442,-442,1,183,72,1,NASDAQ
4262,09-02-2021 18:00,24 hrs.,RobinHoodPennyStocks,HGSH,442,0,442,-442,1,183,72,1,NASDAQ
4262,09-02-2021 18:00,24 hrs.,RobinHoodPennyStocks,HSTO,12,0,12,-12,2,2,0,1,NASDAQ
4262,09-02-2021 18:00,24 hrs.,RobinHoodPennyStocks,IDEX,473,11,462,-451,3,190,81,3,NASDAQ
4262,09-02-2021 18:00,24 hrs.,RobinHoodPennyStocks,IMNM,442,0,442,-442,1,183,72,1,NASDAQ
4262,09-02-2021 18:00,24 hrs.,RobinHoodPennyStocks,IMTE,442,0,442,-442,1,183,72,1,NASDAQ
4262,09-02-2021 18:00,24 hrs.,RobinHoodPennyStocks,INPX,39,6,33,-27,3,8,11,3,NASDAQ
4262,09-02-2021 18:00,24 hrs.,RobinHoodPennyStocks,IPDN,442,0,442,-442,1,183,72,1,NASDAQ
4262,09-02-2021 18:00,24 hrs.,RobinHoodPennyStocks,ITRM,506,6,500,-494,5,202,82,5,NASDAQ
4262,09-02-2021 18:00,24 hrs.,RobinHoodPennyStocks,IZEA,442,0,442,-442,1,183,72,1,NASDAQ
4262,09-02-2021 18:00,24 hrs.,RobinHoodPennyStocks,JFIN,442,0,442,-442,1,183,72,1,NASDAQ
4262,09-02-2021 18:00,24 hrs.,RobinHoodPennyStocks,CPRX,6,0,6,-6,1,1,0,1,NASDAQ
4262,09-02-2021 18:00,24 hrs.,RobinHoodPennyStocks,CRBP,442,0,442,-442,1,183,72,1,NASDAQ
4262,09-02-2021 18:00,24 hrs.,RobinHoodPennyStocks,CRON,442,0,442,-442,1,183,72,1,NASDAQ
4262,09-02-2021 18:00,24 hrs.,RobinHoodPennyStocks,CTRM,1028,341,687,-346,28,348,220,23,NASDAQ
4262,09-02-2021 18:00,24 hrs.,RobinHoodPennyStocks,DARE,6,0,6,-6,1,1,0,1,NASDAQ
4262,09-02-2021 18:00,24 hrs.,RobinHoodPennyStocks,EAST,3543,3274,269,3005,9,1585,337,9,NASDAQ
4262,09-02-2021 18:00,24 hrs.,stocks,RTON,6,6,0,6,1,1,0,1,OTC
4262,09-02-2021 18:00,24 hrs.,stocks,SGMD,6,0,6,-6,1,1,0,1,OTC
4262,09-02-2021 18:00,24 hrs.,stocks,SING,6,0,6,-6,1,1,0,1,OTC
4262,09-02-2021 18:00,24 hrs.,stocks,SIRC,6,0,6,-6,1,1,0,1,OTC
4262,09-02-2021 18:00,24 hrs.,stocks,SLNG,12,12,0,12,2,2,0,1,OTC
4262,09-02-2021 18:00,24 hrs.,stocks,SNPW,7,0,7,-7,1,1,1,1,OTC
4262,09-02-2021 18:00,24 hrs.,stocks,TSNP,20,20,0,20,1,7,2,1,OTC
4262,09-02-2021 18:00,24 hrs.,stocks,TXTM,6,6,0,6,1,1,0,1,OTC
4262,09-02-2021 18:00,24 hrs.,stocks,USEI,6,0,6,-6,1,1,0,1,OTC
4262,09-02-2021 18:00,24 hrs.,stocks,USRM,6,0,6,-6,1,1,0,1,OTC
4262,09-02-2021 18:00,24 hrs.,stocks,VPOR,18,0,18,-18,3,3,0,1,OTC
4262,09-02-2021 18:00,24 hrs.,stocks,WHEN,6,6,0,6,1,1,0,1,OTC
4262,09-02-2021 18:00,24 hrs.,stocks,CURLF,6,6,0,6,1,1,0,1,OTC
4262,09-02-2021 18:00,24 hrs.,stocks,CYLYF,46,0,46,-46,1,18,6,1,OTC
4262,09-02-2021 18:00,24 hrs.,stocks,GAYMF,6,0,6,-6,1,1,0,1,OTC
4262,09-02-2021 18:00,24 hrs.,stocks,GTBIF,6,6,0,6,1,1,0,1,OTC
4262,09-02-2021 18:00,24 hrs.,stocks,HAPBF,6,6,0,6,1,1,0,1,OTC
4262,09-02-2021 18:00,24 hrs.,stocks,HITIF,13,0,13,-13,2,2,1,1,OTC
4262,09-02-2021 18:00,24 hrs.,stocks,MMNFF,6,6,0,6,1,1,0,1,OTC
4262,09-02-2021 18:00,24 hrs.,stocks,OTGLY,6,6,0,6,1,1,0,1,OTC
4262,09-02-2021 18:00,24 hrs.,stocks,PDYPY,436,0,436,-436,1,190,52,1,OTC
4262,09-02-2021 18:00,24 hrs.,stocks,REZZF,7,7,0,7,1,1,1,1,OTC
4262,09-02-2021 18:00,24 hrs.,stocks,WXIBF,795,795,0,795,1,372,47,1,OTC
4262,09-02-2021 18:00,24 hrs.,stocks,ACY,6,6,0,6,1,1,0,1,AMEX
4262,09-02-2021 18:00,24 hrs.,stocks,CVM,6,6,0,6,1,1,0,1,AMEX
4262,09-02-2021 18:00,24 hrs.,stocks,DPW,6,6,0,6,1,1,0,1,AMEX
4262,09-02-2021 18:00,24 hrs.,stocks,GLU,19,0,19,-19,1,3,9,1,AMEX
4262,09-02-2021 18:00,24 hrs.,stocks,GTE,6,0,6,-6,1,1,0,1,AMEX
4262,09-02-2021 18:00,24 hrs.,stocks,NBA,459,23,436,-413,2,196,59,2,AMEX
4262,09-02-2021 18:00,24 hrs.,stocks,REI,21,6,15,-9,3,4,1,3,AMEX
4262,09-02-2021 18:00,24 hrs.,stocks,ZOM,86,19,67,-48,14,14,2,8,AMEX
4262,09-02-2021 18:00,24 hrs.,stocks,CANF,6,6,0,6,1,1,0,1,AMEX
4262,09-02-2021 18:00,24 hrs.,stocks,NSPR,6,0,6,-6,1,1,0,1,AMEX
4262,09-02-2021 18:00,24 hrs.,stocks,OGEN,6,0,6,-6,1,1,0,1,AMEX
4262,09-02-2021 18:00,24 hrs.,stocks,TMBR,12,12,0,12,2,2,0,1,AMEX
4262,09-02-2021 18:00,24 hrs.,stocks,ABC,11,11,0,11,1,1,5,1,NYSE
4262,09-02-2021 18:00,24 hrs.,stocks,ABT,19,19,0,19,1,6,3,1,NYSE
4262,09-02-2021 18:00,24 hrs.,stocks,ACH,6,0,6,-6,1,1,0,1,NYSE
4262,09-02-2021 18:00,24 hrs.,stocks,AMC,10268,30,10238,-10208,19,4800,592,19,NYSE
4262,09-02-2021 18:00,24 hrs.,stocks,ATH,89,36,53,-17,3,22,33,3,NYSE
4262,09-02-2021 18:00,24 hrs.,stocks,ATR,804,804,0,804,1,47,706,1,NYSE
4262,09-02-2021 18:00,24 hrs.,stocks,CBO,23,23,0,23,1,6,7,1,NYSE
4262,09-02-2021 18:00,24 hrs.,stocks,CCL,6,6,0,6,1,1,0,1,NYSE
4262,09-02-2021 18:00,24 hrs.,stocks,CMG,13,13,0,13,1,2,5,1,NYSE
4262,09-02-2021 18:00,24 hrs.,stocks,CMO,436,0,436,-436,1,190,52,1,NYSE
4262,09-02-2021 18:00,24 hrs.,stocks,CNC,23,23,0,23,1,6,7,1,NYSE
4262,09-02-2021 18:00,24 hrs.,stocks,CNK,6,6,0,6,1,1,0,1,NYSE
4262,09-02-2021 18:00,24 hrs.,stocks,CNR,21,21,0,21,1,8,1,1,NYSE
4262,09-02-2021 18:00,24 hrs.,stocks,CNS,6,0,6,-6,1,1,0,1,NYSE
4262,09-02-2021 18:00,24 hrs.,stocks,CRM,157,0,157,-157,1,44,65,1,NYSE
4262,09-02-2021 18:00,24 hrs.,stocks,DAL,15,15,0,15,1,2,7,1,NYSE
4262,09-02-2021 18:00,24 hrs.,stocks,DFS,25,25,0,25,1,8,5,1,NYSE
4262,09-02-2021 18:00,24 hrs.,stocks,DHT,6,0,6,-6,1,1,0,1,NYSE
4262,09-02-2021 18:00,24 hrs.,stocks,DIS,509,19,490,-471,4,209,75,4,NYSE
4262,09-02-2021 18:00,24 hrs.,stocks,EPC,23,23,0,23,1,6,7,1,NYSE
4262,09-02-2021 18:00,24 hrs.,stocks,EQC,8,8,0,8,1,2,0,1,NYSE
4262,09-02-2021 18:00,24 hrs.,stocks,FLT,12,6,6,0,2,2,0,2,NYSE
4262,09-02-2021 18:00,24 hrs.,stocks,FMS,6,0,6,-6,1,1,0,1,NYSE
4262,09-02-2021 18:00,24 hrs.,RobinHoodPennyStocks,MGI,442,0,442,-442,1,183,72,1,NASDAQ
4262,09-02-2021 18:00,24 hrs.,RobinHoodPennyStocks,OCG,442,0,442,-442,1,183,72,1,NASDAQ
4262,09-02-2021 18:00,24 hrs.,RobinHoodPennyStocks,OEG,448,0,448,-448,2,184,72,2,NASDAQ
4262,09-02-2021 18:00,24 hrs.,RobinHoodPennyStocks,OGI,453,11,442,-431,2,186,73,2,NASDAQ
4262,09-02-2021 18:00,24 hrs.,RobinHoodPennyStocks,OPK,11,11,0,11,1,3,1,1,NASDAQ
4262,09-02-2021 18:00,24 hrs.,RobinHoodPennyStocks,PTE,25,25,0,25,1,7,7,1,NASDAQ
4262,09-02-2021 18:00,24 hrs.,RobinHoodPennyStocks,QTT,442,0,442,-442,1,183,72,1,NASDAQ
4262,09-02-2021 18:00,24 hrs.,RobinHoodPennyStocks,SIC,442,0,442,-442,1,183,72,1,NASDAQ
4262,09-02-2021 18:00,24 hrs.,RobinHoodPennyStocks,SLS,442,0,442,-442,1,183,72,1,NASDAQ
4262,09-02-2021 18:00,24 hrs.,RobinHoodPennyStocks,SND,10,0,10,-10,2,1,0,1,NASDAQ
4262,09-02-2021 18:00,24 hrs.,RobinHoodPennyStocks,SPI,442,0,442,-442,1,183,72,1,NASDAQ
4262,09-02-2021 18:00,24 hrs.,RobinHoodPennyStocks,WWR,442,0,442,-442,1,183,72,1,NASDAQ
4262,09-02-2021 18:00,24 hrs.,RobinHoodPennyStocks,ABEO,51,11,40,-29,3,15,9,3,NASDAQ
4262,09-02-2021 18:00,24 hrs.,RobinHoodPennyStocks,ABUS,6,6,0,6,1,1,0,1,NASDAQ
4262,09-02-2021 18:00,24 hrs.,RobinHoodPennyStocks,ACRX,209,95,114,-19,7,64,53,6,NASDAQ
4262,09-02-2021 18:00,24 hrs.,RobinHoodPennyStocks,ACST,38,38,0,38,1,11,12,1,NASDAQ
4262,09-02-2021 18:00,24 hrs.,RobinHoodPennyStocks,ACTG,6,6,0,6,1,1,0,1,NASDAQ
4262,09-02-2021 18:00,24 hrs.,RobinHoodPennyStocks,ADIL,442,0,442,-442,1,183,72,1,NASDAQ
4262,09-02-2021 18:00,24 hrs.,RobinHoodPennyStocks,ADMP,442,0,442,-442,1,183,72,1,NASDAQ
4262,09-02-2021 18:00,24 hrs.,RobinHoodPennyStocks,ADMS,442,0,442,-442,1,183,72,1,NASDAQ
4262,09-02-2021 18:00,24 hrs.,RobinHoodPennyStocks,ADXS,42,36,6,30,7,7,0,4,NASDAQ
4262,09-02-2021 18:00,24 hrs.,RobinHoodPennyStocks,AEZS,2409,224,2185,-1961,37,930,401,32,NASDAQ
4262,09-02-2021 18:00,24 hrs.,RobinHoodPennyStocks,AGEN,442,0,442,-442,1,183,72,1,NASDAQ
4262,09-02-2021 18:00,24 hrs.,RobinHoodPennyStocks,AGTC,2675,2523,152,2371,10,1203,229,10,NASDAQ
4262,09-02-2021 18:00,24 hrs.,RobinHoodPennyStocks,AIHS,442,0,442,-442,1,183,72,1,NASDAQ
4262,09-02-2021 18:00,24 hrs.,RobinHoodPennyStocks,AKBA,2462,2462,0,2462,1,1140,178,1,NASDAQ
4262,09-02-2021 18:00,24 hrs.,RobinHoodPennyStocks,AKER,442,0,442,-442,1,183,72,1,NASDAQ
4262,09-02-2021 18:00,24 hrs.,RobinHoodPennyStocks,ALAC,442,0,442,-442,1,183,72,1,NASDAQ
4262,09-02-2021 18:00,24 hrs.,RobinHoodPennyStocks,ALVR,442,0,442,-442,1,183,72,1,NASDAQ
4262,09-02-2021 18:00,24 hrs.,RobinHoodPennyStocks,AMTX,442,0,442,-442,1,183,72,1,NASDAQ
4262,09-02-2021 18:00,24 hrs.,RobinHoodPennyStocks,AMZN,6,0,6,-6,1,1,0,1,NASDAQ
4262,09-02-2021 18:00,24 hrs.,RobinHoodPennyStocks,APHA,448,0,448,-448,2,184,72,2,NASDAQ
4262,09-02-2021 18:00,24 hrs.,RobinHoodPennyStocks,APTX,442,0,442,-442,1,183,72,1,NASDAQ
4262,09-02-2021 18:00,24 hrs.,RobinHoodPennyStocks,AQMS,442,0,442,-442,1,183,72,1,NASDAQ
4262,09-02-2021 18:00,24 hrs.,RobinHoodPennyStocks,ARDS,42,42,0,42,1,18,2,1,NASDAQ
4262,09-02-2021 18:00,24 hrs.,RobinHoodPennyStocks,ARTL,448,6,442,-436,2,184,72,2,NASDAQ
4262,09-02-2021 18:00,24 hrs.,RobinHoodPennyStocks,ASRT,148,70,78,-8,7,41,38,6,NASDAQ
4262,09-02-2021 18:00,24 hrs.,RobinHoodPennyStocks,ATHE,442,0,442,-442,1,183,72,1,NASDAQ
4262,09-02-2021 18:00,24 hrs.,RobinHoodPennyStocks,ATIF,442,0,442,-442,1,183,72,1,NASDAQ
4262,09-02-2021 18:00,24 hrs.,RobinHoodPennyStocks,ATNF,14,14,0,14,1,4,2,1,NASDAQ
4262,09-02-2021 18:00,24 hrs.,RobinHoodPennyStocks,ATOS,812,193,619,-426,11,306,156,11,NASDAQ
4262,09-02-2021 18:00,24 hrs.,RobinHoodPennyStocks,AZRX,442,0,442,-442,1,183,72,1,NASDAQ
4262,09-02-2021 18:00,24 hrs.,RobinHoodPennyStocks,BCRX,5,5,0,5,1,0,1,1,NASDAQ
4262,09-02-2021 18:00,24 hrs.,RobinHoodPennyStocks,BHAT,442,0,442,-442,1,183,72,1,NASDAQ
4262,09-02-2021 18:00,24 hrs.,RobinHoodPennyStocks,BIOL,2520,2502,18,2484,6,1157,182,6,NASDAQ
4262,09-02-2021 18:00,24 hrs.,RobinHoodPennyStocks,BNTC,6,6,0,6,1,1,0,1,NASDAQ
4262,09-02-2021 18:00,24 hrs.,RobinHoodPennyStocks,BRQS,486,0,486,-486,2,193,92,2,NASDAQ
4262,09-02-2021 18:00,24 hrs.,RobinHoodPennyStocks,BSQR,6,6,0,6,1,1,0,1,NASDAQ
4262,09-02-2021 18:00,24 hrs.,RobinHoodPennyStocks,BWAC,442,0,442,-442,1,183,72,1,NASDAQ
4262,09-02-2021 18:00,24 hrs.,RobinHoodPennyStocks,BXRX,69,0,69,-69,1,26,13,1,NASDAQ
4262,09-02-2021 18:00,24 hrs.,RobinHoodPennyStocks,BYFC,442,0,442,-442,1,183,72,1,NASDAQ
4262,09-02-2021 18:00,24 hrs.,RobinHoodPennyStocks,CAAS,442,0,442,-442,1,183,72,1,NASDAQ
4262,09-02-2021 18:00,24 hrs.,RobinHoodPennyStocks,CARV,442,0,442,-442,1,183,72,1,NASDAQ
4262,09-02-2021 18:00,24 hrs.,RobinHoodPennyStocks,CBAT,442,0,442,-442,1,183,72,1,NASDAQ
4262,09-02-2021 18:00,24 hrs.,RobinHoodPennyStocks,CCNC,442,0,442,-442,1,183,72,1,NASDAQ
4262,09-02-2021 18:00,24 hrs.,RobinHoodPennyStocks,CETX,442,0,442,-442,1,183,72,1,NASDAQ
4262,09-02-2021 18:00,24 hrs.,RobinHoodPennyStocks,CHCI,459,17,442,-425,2,187,77,2,NASDAQ
4262,09-02-2021 18:00,24 hrs.,RobinHoodPennyStocks,CHEK,22,6,16,-10,2,4,6,2,NASDAQ
4262,09-02-2021 18:00,24 hrs.,RobinHoodPennyStocks,CIDM,151,69,82,-13,5,50,31,5,NASDAQ
4262,09-02-2021 18:00,24 hrs.,RobinHoodPennyStocks,CLEU,448,0,448,-448,2,184,72,2,NASDAQ
4262,09-02-2021 18:00,24 hrs.,RobinHoodPennyStocks,CLSK,442,0,442,-442,1,183,72,1,NASDAQ
4262,09-02-2021 18:00,24 hrs.,RobinHoodPennyStocks,CLSN,6,6,0,6,1,1,0,1,NASDAQ
4262,09-02-2021 18:00,24 hrs.,RobinHoodPennyStocks,CLVS,6,6,0,6,1,1,0,1,NASDAQ
4262,09-02-2021 18:00,24 hrs.,RobinHoodPennyStocks,CNSP,454,12,442,-430,2,187,72,2,NASDAQ
4262,09-02-2021 18:00,24 hrs.,stocks,ALPP,6,0,6,-6,1,1,0,1,OTC
4262,09-02-2021 18:00,24 hrs.,stocks,ALYI,6,0,6,-6,1,1,0,1,OTC
4262,09-02-2021 18:00,24 hrs.,stocks,BLSP,6,0,6,-6,1,1,0,1,OTC
4262,09-02-2021 18:00,24 hrs.,stocks,BOTY,6,6,0,6,1,1,0,1,OTC
4262,09-02-2021 18:00,24 hrs.,stocks,CATV,12,0,12,-12,2,2,0,2,OTC
4262,09-02-2021 18:00,24 hrs.,stocks,CBBT,6,0,6,-6,1,1,0,1,OTC
4262,09-02-2021 18:00,24 hrs.,stocks,ENZC,18,18,0,18,3,3,0,2,OTC
4262,09-02-2021 18:00,24 hrs.,stocks,GAXY,25,25,0,25,1,8,5,1,OTC
4262,09-02-2021 18:00,24 hrs.,stocks,HBRM,6,0,6,-6,1,1,0,1,OTC
4262,09-02-2021 18:00,24 hrs.,stocks,HCMC,30,18,12,6,5,5,0,5,OTC
4262,09-02-2021 18:00,24 hrs.,stocks,HEMP,14,7,7,0,2,2,2,2,OTC
4262,09-02-2021 18:00,24 hrs.,stocks,HMPQ,16,0,16,-16,1,3,6,1,OTC
4262,09-02-2021 18:00,24 hrs.,stocks,HQGE,6,0,6,-6,1,1,0,1,OTC
4262,09-02-2021 18:00,24 hrs.,stocks,HYSR,6,6,0,6,1,1,0,1,OTC
4262,09-02-2021 18:00,24 hrs.,stocks,INND,6,6,0,6,1,1,0,1,OTC
4262,09-02-2021 18:00,24 hrs.,stocks,IPIX,18,12,6,6,3,3,0,2,OTC
4262,09-02-2021 18:00,24 hrs.,stocks,IQST,6,0,6,-6,1,1,0,1,OTC
4262,09-02-2021 18:00,24 hrs.,stocks,KPAY,6,0,6,-6,1,1,0,1,OTC
4262,09-02-2021 18:00,24 hrs.,stocks,KWBT,6,6,0,6,1,1,0,1,OTC
4262,09-02-2021 18:00,24 hrs.,stocks,LATF,6,6,0,6,1,1,0,1,OTC
4262,09-02-2021 18:00,24 hrs.,stocks,LCDX,6,0,6,-6,1,1,0,1,OTC
4262,09-02-2021 18:00,24 hrs.,stocks,LINK,29,29,0,29,2,7,7,2,OTC
4262,09-02-2021 18:00,24 hrs.,stocks,NLST,6,0,6,-6,1,1,0,1,OTC
4262,09-02-2021 18:00,24 hrs.,stocks,OZSC,18,18,0,18,3,3,0,2,OTC
4262,09-02-2021 18:00,24 hrs.,stocks,PHOT,6,6,0,6,1,1,0,1,OTC
4262,09-02-2021 18:00,24 hrs.,stocks,PURA,6,0,6,-6,1,1,0,1,OTC
4262,09-02-2021 18:00,24 hrs.,stocks,RELI,7,7,0,7,1,1,1,1,OTC
4262,09-02-2021 18:00,24 hrs.,stocks,ROTH,26,26,0,26,1,8,6,1,OTC
4262,09-02-2021 18:00,24 hrs.,RobinHoodPennyStocks,CGC,442,0,442,-442,1,183,72,1,NASDAQ
4262,09-02-2021 18:00,24 hrs.,RobinHoodPennyStocks,ENG,442,0,442,-442,1,183,72,1,NASDAQ
4262,09-02-2021 18:00,24 hrs.,RobinHoodPennyStocks,EVK,442,0,442,-442,1,183,72,1,NASDAQ
4262,09-02-2021 18:00,24 hrs.,RobinHoodPennyStocks,HAS,6,0,6,-6,1,1,0,1,NASDAQ
4262,09-02-2021 18:00,24 hrs.,RobinHoodPennyStocks,JFU,6,6,0,6,1,1,0,1,NASDAQ
4262,09-02-2021 18:00,24 hrs.,RobinHoodPennyStocks,BIO,410,0,410,-410,1,88,230,1,NYSE
4262,09-02-2021 18:00,24 hrs.,RobinHoodPennyStocks,CBD,6,6,0,6,1,1,0,1,NYSE
4262,09-02-2021 18:00,24 hrs.,RobinHoodPennyStocks,CCM,442,0,442,-442,1,183,72,1,NYSE
4262,09-02-2021 18:00,24 hrs.,RobinHoodPennyStocks,CNS,42,42,0,42,1,18,2,1,NYSE
4262,09-02-2021 18:00,24 hrs.,RobinHoodPennyStocks,CRL,42,42,0,42,1,18,2,1,NYSE
4262,09-02-2021 18:00,24 hrs.,RobinHoodPennyStocks,CTK,442,0,442,-442,1,183,72,1,NYSE
4262,09-02-2021 18:00,24 hrs.,RobinHoodPennyStocks,CVS,2462,2462,0,2462,1,1140,178,1,NYSE
4262,09-02-2021 18:00,24 hrs.,RobinHoodPennyStocks,DEA,42,42,0,42,1,18,2,1,NYSE
4262,09-02-2021 18:00,24 hrs.,RobinHoodPennyStocks,GME,836,824,12,812,4,325,170,4,NYSE
4262,09-02-2021 18:00,24 hrs.,RobinHoodPennyStocks,GSX,442,0,442,-442,1,183,72,1,NYSE
4262,09-02-2021 18:00,24 hrs.,RobinHoodPennyStocks,HOG,442,0,442,-442,1,183,72,1,NYSE
4262,09-02-2021 18:00,24 hrs.,RobinHoodPennyStocks,IPV,6,0,6,-6,1,1,0,1,NYSE
4262,09-02-2021 18:00,24 hrs.,RobinHoodPennyStocks,NGS,88,0,88,-88,1,33,18,1,NYSE
4262,09-02-2021 18:00,24 hrs.,RobinHoodPennyStocks,NIO,6,6,0,6,1,1,0,1,NYSE
4262,09-02-2021 18:00,24 hrs.,RobinHoodPennyStocks,NOK,62,6,56,-50,4,18,10,4,NYSE
4262,09-02-2021 18:00,24 hrs.,RobinHoodPennyStocks,PKG,2462,2462,0,2462,1,1140,178,1,NYSE
4262,09-02-2021 18:00,24 hrs.,RobinHoodPennyStocks,REX,442,0,442,-442,1,183,72,1,NYSE
4262,09-02-2021 18:00,24 hrs.,RobinHoodPennyStocks,RMO,442,0,442,-442,1,183,72,1,NYSE
4262,09-02-2021 18:00,24 hrs.,RobinHoodPennyStocks,SOS,564,12,552,-540,8,218,96,8,NYSE
4262,09-02-2021 18:00,24 hrs.,RobinHoodPennyStocks,TAL,442,0,442,-442,1,183,72,1,NYSE
4262,09-02-2021 18:00,24 hrs.,RobinHoodPennyStocks,TTM,442,0,442,-442,1,183,72,1,NYSE
4262,09-02-2021 18:00,24 hrs.,RobinHoodPennyStocks,WEI,442,0,442,-442,1,183,72,1,NYSE
4262,09-02-2021 18:00,24 hrs.,RobinHoodPennyStocks,XOM,2510,2462,48,2414,2,1159,184,2,NYSE
4262,09-02-2021 18:00,24 hrs.,RobinHoodPennyStocks,ARGO,6,6,0,6,1,1,0,1,NYSE
4262,09-02-2021 18:00,24 hrs.,RobinHoodPennyStocks,BABA,442,0,442,-442,1,183,72,1,NYSE
4262,09-02-2021 18:00,24 hrs.,RobinHoodPennyStocks,BORR,34,0,34,-34,1,12,6,1,NYSE
4262,09-02-2021 18:00,24 hrs.,RobinHoodPennyStocks,CMCM,442,0,442,-442,1,183,72,1,NYSE
4262,09-02-2021 18:00,24 hrs.,RobinHoodPennyStocks,HEXO,448,0,448,-448,2,184,72,2,NYSE
4262,09-02-2021 18:00,24 hrs.,RobinHoodPennyStocks,LAIX,442,0,442,-442,1,183,72,1,NYSE
4262,09-02-2021 18:00,24 hrs.,RobinHoodPennyStocks,MITT,120,0,120,-120,1,48,20,1,NYSE
4262,09-02-2021 18:00,24 hrs.,RobinHoodPennyStocks,PGRE,6,6,0,6,1,1,0,1,NYSE
4262,09-02-2021 18:00,24 hrs.,RobinHoodPennyStocks,AIH,442,0,442,-442,1,183,72,1,NASDAQ
4262,09-02-2021 18:00,24 hrs.,RobinHoodPennyStocks,APM,6,0,6,-6,1,1,0,1,NASDAQ
4262,09-02-2021 18:00,24 hrs.,RobinHoodPennyStocks,SEGI,8,0,8,-8,1,0,4,1,OTC
4262,09-02-2021 18:00,24 hrs.,RobinHoodPennyStocks,SGMD,2462,2462,0,2462,1,1140,178,1,OTC
4262,09-02-2021 18:00,24 hrs.,RobinHoodPennyStocks,SNPW,6,0,6,-6,1,1,0,1,OTC
4262,09-02-2021 18:00,24 hrs.,RobinHoodPennyStocks,TSNP,12,0,12,-12,1,0,8,1,OTC
4262,09-02-2021 18:00,24 hrs.,RobinHoodPennyStocks,VPOR,6,6,0,6,1,1,0,1,OTC
4262,09-02-2021 18:00,24 hrs.,RobinHoodPennyStocks,BDRBF,41,6,35,-29,2,14,5,2,OTC
4262,09-02-2021 18:00,24 hrs.,RobinHoodPennyStocks,DIGAF,6,6,0,6,1,1,0,1,OTC
4262,09-02-2021 18:00,24 hrs.,RobinHoodPennyStocks,DJIFF,8,0,8,-8,1,0,4,1,OTC
4262,09-02-2021 18:00,24 hrs.,RobinHoodPennyStocks,ERPNF,2462,2462,0,2462,1,1140,178,1,OTC
4262,09-02-2021 18:00,24 hrs.,RobinHoodPennyStocks,HREEF,6,0,6,-6,1,1,0,1,OTC
4262,09-02-2021 18:00,24 hrs.,RobinHoodPennyStocks,HVBTF,6,6,0,6,1,1,0,1,OTC
4262,09-02-2021 18:00,24 hrs.,RobinHoodPennyStocks,MMNFF,6,0,6,-6,1,1,0,1,OTC
4262,09-02-2021 18:00,24 hrs.,RobinHoodPennyStocks,PTNYF,2462,2462,0,2462,1,1140,178,1,OTC
4262,09-02-2021 18:00,24 hrs.,RobinHoodPennyStocks,REZZF,6,0,6,-6,1,1,0,1,OTC
4262,09-02-2021 18:00,24 hrs.,RobinHoodPennyStocks,DLA,442,0,442,-442,1,183,72,1,AMEX
4262,09-02-2021 18:00,24 hrs.,RobinHoodPennyStocks,DNN,454,6,448,-442,3,185,72,3,AMEX
4262,09-02-2021 18:00,24 hrs.,RobinHoodPennyStocks,DPW,442,0,442,-442,1,183,72,1,AMEX
4262,09-02-2021 18:00,24 hrs.,RobinHoodPennyStocks,DSS,442,0,442,-442,1,183,72,1,AMEX
4262,09-02-2021 18:00,24 hrs.,RobinHoodPennyStocks,GBR,6,0,6,-6,1,1,0,1,AMEX
4262,09-02-2021 18:00,24 hrs.,RobinHoodPennyStocks,GTE,66,30,36,-6,11,11,0,9,AMEX
4262,09-02-2021 18:00,24 hrs.,RobinHoodPennyStocks,IGC,6,6,0,6,1,1,0,1,AMEX
4262,09-02-2021 18:00,24 hrs.,RobinHoodPennyStocks,ISR,11,11,0,11,1,3,1,1,AMEX
4262,09-02-2021 18:00,24 hrs.,RobinHoodPennyStocks,ITP,18,0,18,-18,3,3,0,3,AMEX
4262,09-02-2021 18:00,24 hrs.,RobinHoodPennyStocks,KIQ,470,0,470,-470,3,189,80,3,AMEX
4262,09-02-2021 18:00,24 hrs.,RobinHoodPennyStocks,NAK,50,12,38,-26,6,10,6,5,AMEX
4262,09-02-2021 18:00,24 hrs.,RobinHoodPennyStocks,REI,2534,2462,72,2390,6,1163,184,5,AMEX
4262,09-02-2021 18:00,24 hrs.,RobinHoodPennyStocks,TRX,442,0,442,-442,1,183,72,1,AMEX
4262,09-02-2021 18:00,24 hrs.,RobinHoodPennyStocks,UEC,442,0,442,-442,1,183,72,1,AMEX
4262,09-02-2021 18:00,24 hrs.,RobinHoodPennyStocks,URG,442,0,442,-442,1,183,72,1,AMEX
4262,09-02-2021 18:00,24 hrs.,RobinHoodPennyStocks,ZOM,1058,211,847,-636,27,343,264,26,AMEX
4262,09-02-2021 18:00,24 hrs.,RobinHoodPennyStocks,ANVS,442,0,442,-442,1,183,72,1,AMEX
4262,09-02-2021 18:00,24 hrs.,RobinHoodPennyStocks,AUMN,13,13,0,13,2,2,1,2,AMEX
4262,09-02-2021 18:00,24 hrs.,RobinHoodPennyStocks,CRMD,442,0,442,-442,1,183,72,1,AMEX
4262,09-02-2021 18:00,24 hrs.,RobinHoodPennyStocks,GSAT,6,6,0,6,1,1,0,1,AMEX
4262,09-02-2021 18:00,24 hrs.,RobinHoodPennyStocks,LCTX,12,12,0,12,2,2,0,1,AMEX
4262,09-02-2021 18:00,24 hrs.,RobinHoodPennyStocks,NSPR,58,0,58,-58,6,12,10,6,AMEX
4262,09-02-2021 18:00,24 hrs.,RobinHoodPennyStocks,OGEN,12,12,0,12,2,2,0,2,AMEX
4262,09-02-2021 18:00,24 hrs.,RobinHoodPennyStocks,PLAG,442,0,442,-442,1,183,72,1,AMEX
4262,09-02-2021 18:00,24 hrs.,RobinHoodPennyStocks,SENS,54,0,54,-54,2,21,4,2,AMEX
4262,09-02-2021 18:00,24 hrs.,RobinHoodPennyStocks,TKAT,442,0,442,-442,1,183,72,1,AMEX
4262,09-02-2021 18:00,24 hrs.,RobinHoodPennyStocks,UUUU,442,0,442,-442,1,183,72,1,AMEX
4262,09-02-2021 18:00,24 hrs.,RobinHoodPennyStocks,ACB,453,11,442,-431,2,186,73,2,NYSE
4262,09-02-2021 18:00,24 hrs.,RobinHoodPennyStocks,AHT,6,6,0,6,1,1,0,1,NYSE
4262,09-02-2021 18:00,24 hrs.,RobinHoodPennyStocks,AMC,124,100,24,76,6,37,26,5,NYSE
4262,09-02-2021 18:00,24 hrs.,RobinHoodPennyStocks,ATH,410,0,410,-410,1,88,230,1,NYSE
4262,09-02-2021 18:00,24 hrs.,pennystocks,RMTI,42,42,0,42,5,8,6,5,NASDAQ
4262,09-02-2021 18:00,24 hrs.,pennystocks,SAVA,101,0,101,-101,2,25,43,2,NASDAQ
4262,09-02-2021 18:00,24 hrs.,pennystocks,SEAC,20,6,14,-8,2,5,2,2,NASDAQ
4262,09-02-2021 18:00,24 hrs.,pennystocks,SEEL,882,0,882,-882,2,375,124,2,NASDAQ
4262,09-02-2021 18:00,24 hrs.,pennystocks,SINO,44,0,44,-44,1,17,6,1,NASDAQ
4262,09-02-2021 18:00,24 hrs.,pennystocks,SIOX,18,18,0,18,3,3,0,3,NASDAQ
4262,09-02-2021 18:00,24 hrs.,pennystocks,SLGG,44,0,44,-44,1,17,6,1,NASDAQ
4262,09-02-2021 18:00,24 hrs.,pennystocks,SNDL,105,87,18,69,17,16,5,14,NASDAQ
4262,09-02-2021 18:00,24 hrs.,pennystocks,SNGX,9,0,9,-9,1,2,1,1,NASDAQ
4262,09-02-2021 18:00,24 hrs.,pennystocks,SONM,310,13,297,-284,5,127,36,5,NASDAQ
4262,09-02-2021 18:00,24 hrs.,pennystocks,SRGA,29,29,0,29,2,8,5,2,NASDAQ
4262,09-02-2021 18:00,24 hrs.,pennystocks,SRNE,7,0,7,-7,1,1,1,1,NASDAQ
4262,09-02-2021 18:00,24 hrs.,pennystocks,SSPK,6,0,6,-6,1,1,0,1,NASDAQ
4262,09-02-2021 18:00,24 hrs.,pennystocks,SXTC,7,0,7,-7,1,1,1,1,NASDAQ
4262,09-02-2021 18:00,24 hrs.,pennystocks,TBLT,1479,0,1479,-1479,4,610,243,4,NASDAQ
4262,09-02-2021 18:00,24 hrs.,pennystocks,TECH,52,52,0,52,2,17,10,2,NASDAQ
4262,09-02-2021 18:00,24 hrs.,pennystocks,THRM,14,14,0,14,2,2,2,1,NASDAQ
4262,09-02-2021 18:00,24 hrs.,pennystocks,TLRY,6,0,6,-6,1,1,0,1,NASDAQ
4262,09-02-2021 18:00,24 hrs.,pennystocks,TNXP,4139,2516,1623,893,12,1841,409,12,NASDAQ
4262,09-02-2021 18:00,24 hrs.,pennystocks,TRCH,65,7,58,-51,3,23,7,3,NASDAQ
4262,09-02-2021 18:00,24 hrs.,pennystocks,TRIP,876,0,876,-876,1,374,124,1,NASDAQ
4262,09-02-2021 18:00,24 hrs.,pennystocks,TRIT,6,6,0,6,1,1,0,1,NASDAQ
4262,09-02-2021 18:00,24 hrs.,pennystocks,TSLA,7,7,0,7,1,0,3,1,NASDAQ
4262,09-02-2021 18:00,24 hrs.,pennystocks,TTOO,150,150,0,150,1,51,44,1,NASDAQ
4262,09-02-2021 18:00,24 hrs.,pennystocks,TXMD,12,6,6,0,2,2,0,2,NASDAQ
4262,09-02-2021 18:00,24 hrs.,pennystocks,TYME,176,15,161,-146,5,61,34,4,NASDAQ
4262,09-02-2021 18:00,24 hrs.,pennystocks,UONE,6,6,0,6,1,1,0,1,NASDAQ
4262,09-02-2021 18:00,24 hrs.,pennystocks,USWS,7,7,0,7,1,1,1,1,NASDAQ
4262,09-02-2021 18:00,24 hrs.,pennystocks,VBIV,6,6,0,6,1,1,0,1,NASDAQ
4262,09-02-2021 18:00,24 hrs.,pennystocks,VERB,6,0,6,-6,1,1,0,1,NASDAQ
4262,09-02-2021 18:00,24 hrs.,pennystocks,VIVE,18,18,0,18,3,3,0,3,NASDAQ
4262,09-02-2021 18:00,24 hrs.,pennystocks,VIVO,75,0,75,-75,3,21,21,2,NASDAQ
4262,09-02-2021 18:00,24 hrs.,pennystocks,ZKIN,7,7,0,7,1,1,1,1,NASDAQ
4262,09-02-2021 18:00,24 hrs.,pennystocks,ZNGA,7,0,7,-7,1,1,1,1,NASDAQ
4262,09-02-2021 18:00,24 hrs.,pennystocks,ZSAN,2489,347,2142,-1795,37,1001,339,34,NASDAQ
4262,09-02-2021 18:00,24 hrs.,RobinHoodPennyStocks,ADSV,6,0,6,-6,1,1,0,1,OTC
4262,09-02-2021 18:00,24 hrs.,RobinHoodPennyStocks,AITX,2462,2462,0,2462,1,1140,178,1,OTC
4262,09-02-2021 18:00,24 hrs.,RobinHoodPennyStocks,ALST,6,6,0,6,1,1,0,1,OTC
4262,09-02-2021 18:00,24 hrs.,RobinHoodPennyStocks,BFCH,6,0,6,-6,1,1,0,1,OTC
4262,09-02-2021 18:00,24 hrs.,RobinHoodPennyStocks,BLSP,14,0,14,-14,1,0,10,1,OTC
4262,09-02-2021 18:00,24 hrs.,RobinHoodPennyStocks,BOTY,7,7,0,7,1,1,1,1,OTC
4262,09-02-2021 18:00,24 hrs.,RobinHoodPennyStocks,CATV,6,0,6,-6,1,1,0,1,OTC
4262,09-02-2021 18:00,24 hrs.,RobinHoodPennyStocks,CETY,8,0,8,-8,1,0,4,1,OTC
4262,09-02-2021 18:00,24 hrs.,RobinHoodPennyStocks,CLWD,7,7,0,7,1,0,3,1,OTC
4262,09-02-2021 18:00,24 hrs.,RobinHoodPennyStocks,HCMC,24,6,18,-12,4,4,0,4,OTC
4262,09-02-2021 18:00,24 hrs.,RobinHoodPennyStocks,HESG,6,0,6,-6,1,1,0,1,OTC
4262,09-02-2021 18:00,24 hrs.,RobinHoodPennyStocks,INND,2474,2462,12,2450,3,1142,178,3,OTC
4262,09-02-2021 18:00,24 hrs.,RobinHoodPennyStocks,ISWH,6,6,0,6,1,1,0,1,OTC
4262,09-02-2021 18:00,24 hrs.,RobinHoodPennyStocks,LBUY,6,0,6,-6,1,1,0,1,OTC
4262,09-02-2021 18:00,24 hrs.,RobinHoodPennyStocks,MCOA,6,0,6,-6,1,1,0,1,OTC
4262,09-02-2021 18:00,24 hrs.,RobinHoodPennyStocks,MITI,2462,2462,0,2462,1,1140,178,1,OTC
4262,09-02-2021 18:00,24 hrs.,RobinHoodPennyStocks,MJLB,2468,2468,0,2468,2,1141,178,2,OTC
4262,09-02-2021 18:00,24 hrs.,RobinHoodPennyStocks,MJNA,6,0,6,-6,1,1,0,1,OTC
4262,09-02-2021 18:00,24 hrs.,RobinHoodPennyStocks,MMEX,18,0,18,-18,3,3,0,2,OTC
4262,09-02-2021 18:00,24 hrs.,RobinHoodPennyStocks,NUUU,12,12,0,12,2,2,0,2,OTC
4262,09-02-2021 18:00,24 hrs.,RobinHoodPennyStocks,OZSC,2480,2468,12,2456,4,1143,178,4,OTC
4262,09-02-2021 18:00,24 hrs.,RobinHoodPennyStocks,PAOG,6,6,0,6,1,1,0,1,OTC
4262,09-02-2021 18:00,24 hrs.,RobinHoodPennyStocks,PURA,6,6,0,6,1,1,0,1,OTC
4262,09-02-2021 18:00,24 hrs.,RobinHoodPennyStocks,RGBP,6,0,6,-6,1,1,0,1,OTC
4262,09-02-2021 18:00,24 hrs.,pennystocks,MOGO,13,13,0,13,2,1,3,2,NASDAQ
4262,09-02-2021 18:00,24 hrs.,pennystocks,MRKR,6,0,6,-6,1,1,0,1,NASDAQ
4262,09-02-2021 18:00,24 hrs.,pennystocks,MRNA,12,12,0,12,2,2,0,1,NASDAQ
4262,09-02-2021 18:00,24 hrs.,pennystocks,MTRX,6,6,0,6,1,1,0,1,NASDAQ
4262,09-02-2021 18:00,24 hrs.,pennystocks,NAKD,29,23,6,17,3,3,11,3,NASDAQ
4262,09-02-2021 18:00,24 hrs.,pennystocks,NMTR,7,7,0,7,1,1,1,1,NASDAQ
4262,09-02-2021 18:00,24 hrs.,pennystocks,NOVN,384,163,221,-58,9,124,100,7,NASDAQ
4262,09-02-2021 18:00,24 hrs.,pennystocks,NTEC,6,6,0,6,1,1,0,1,NASDAQ
4262,09-02-2021 18:00,24 hrs.,pennystocks,NXTD,51,7,44,-37,2,18,7,2,NASDAQ
4262,09-02-2021 18:00,24 hrs.,pennystocks,OBLN,6,6,0,6,1,1,0,1,NASDAQ
4262,09-02-2021 18:00,24 hrs.,pennystocks,OCGN,1565,1273,292,981,30,575,295,25,NASDAQ
4262,09-02-2021 18:00,24 hrs.,pennystocks,ONTX,32,0,32,-32,2,10,4,2,NASDAQ
4262,09-02-2021 18:00,24 hrs.,pennystocks,OPGN,77,20,57,-37,5,23,11,5,NASDAQ
4262,09-02-2021 18:00,24 hrs.,pennystocks,OPTT,7,7,0,7,1,0,3,1,NASDAQ
4262,09-02-2021 18:00,24 hrs.,pennystocks,OTLK,62,12,50,-38,4,20,6,4,NASDAQ
4262,09-02-2021 18:00,24 hrs.,pennystocks,PAVM,18,12,6,6,3,3,0,3,NASDAQ
4262,09-02-2021 18:00,24 hrs.,pennystocks,PLAY,6,0,6,-6,1,1,0,1,NASDAQ
4262,09-02-2021 18:00,24 hrs.,pennystocks,PNNT,23,0,23,-23,2,5,5,1,NASDAQ
4262,09-02-2021 18:00,24 hrs.,pennystocks,POAI,6,0,6,-6,1,1,0,1,NASDAQ
4262,09-02-2021 18:00,24 hrs.,pennystocks,PTON,6,6,0,6,1,1,0,1,NASDAQ
4262,09-02-2021 18:00,24 hrs.,pennystocks,RELL,21,21,0,21,1,7,3,1,NASDAQ
4262,09-02-2021 18:00,24 hrs.,pennystocks,REYN,10,0,10,-10,1,0,6,1,NASDAQ
4262,09-02-2021 18:00,24 hrs.,pennystocks,RIGL,7,7,0,7,1,1,1,1,NASDAQ
4262,09-02-2021 18:00,24 hrs.,pennystocks,RIOT,12,12,0,12,2,2,0,2,NASDAQ
4262,09-02-2021 18:00,24 hrs.,pennystocks,RKDA,47,47,0,47,1,17,9,1,NASDAQ
4262,09-02-2021 18:00,24 hrs.,pennystocks,INPX,7,7,0,7,1,1,1,1,NASDAQ
4262,09-02-2021 18:00,24 hrs.,pennystocks,INVE,6,0,6,-6,1,1,0,1,NASDAQ
4262,09-02-2021 18:00,24 hrs.,pennystocks,ITRM,112,6,106,-100,4,32,32,4,NASDAQ
4262,09-02-2021 18:00,24 hrs.,pennystocks,JAGX,8,8,0,8,1,1,2,1,NASDAQ
4262,09-02-2021 18:00,24 hrs.,pennystocks,JAKK,29,0,29,-29,1,9,7,1,NASDAQ
4262,09-02-2021 18:00,24 hrs.,pennystocks,KTRA,1408,1408,0,1408,3,607,182,3,NASDAQ
4262,09-02-2021 18:00,24 hrs.,pennystocks,LIFE,44,0,44,-44,1,17,6,1,NASDAQ
4262,09-02-2021 18:00,24 hrs.,pennystocks,LIVE,13,13,0,13,2,2,1,2,NASDAQ
4262,09-02-2021 18:00,24 hrs.,pennystocks,LIZI,44,0,44,-44,1,17,6,1,NASDAQ
4262,09-02-2021 18:00,24 hrs.,pennystocks,LLIT,30,30,0,30,1,10,6,1,NASDAQ
4262,09-02-2021 18:00,24 hrs.,pennystocks,LPCN,384,384,0,384,1,167,46,1,NASDAQ
4262,09-02-2021 18:00,24 hrs.,pennystocks,LRCX,30,30,0,30,1,10,6,1,NASDAQ
4262,09-02-2021 18:00,24 hrs.,pennystocks,MARA,559,12,547,-535,3,214,119,3,NASDAQ
4262,09-02-2021 18:00,24 hrs.,pennystocks,ARPO,28,0,28,-28,2,7,6,1,NASDAQ
4262,09-02-2021 18:00,24 hrs.,pennystocks,ASRT,69,0,69,-69,2,13,35,2,NASDAQ
4262,09-02-2021 18:00,24 hrs.,pennystocks,ASTC,7,7,0,7,1,1,1,1,NASDAQ
4262,09-02-2021 18:00,24 hrs.,pennystocks,ATHE,116,0,116,-116,1,40,32,1,NASDAQ
4262,09-02-2021 18:00,24 hrs.,pennystocks,ATOS,156,156,0,156,2,52,44,2,NASDAQ
4262,09-02-2021 18:00,24 hrs.,pennystocks,AUVI,13,13,0,13,2,2,1,2,NASDAQ
4262,09-02-2021 18:00,24 hrs.,pennystocks,AVGR,7,7,0,7,1,1,1,1,NASDAQ
4262,09-02-2021 18:00,24 hrs.,pennystocks,AZRX,7,7,0,7,1,1,1,1,NASDAQ
4262,09-02-2021 18:00,24 hrs.,pennystocks,BBIG,6,6,0,6,1,1,0,1,NASDAQ
4262,09-02-2021 18:00,24 hrs.,pennystocks,BHAT,12,6,6,0,2,2,0,2,NASDAQ
4262,09-02-2021 18:00,24 hrs.,pennystocks,BIOL,25,6,19,-13,4,4,1,4,NASDAQ
4262,09-02-2021 18:00,24 hrs.,pennystocks,BKEP,7,7,0,7,1,1,1,1,NASDAQ
4262,09-02-2021 18:00,24 hrs.,pennystocks,BLCM,6,0,6,-6,1,1,0,1,NASDAQ
4262,09-02-2021 18:00,24 hrs.,pennystocks,BLRX,6,6,0,6,1,1,0,1,NASDAQ
4262,09-02-2021 18:00,24 hrs.,pennystocks,BSQR,125,125,0,125,1,50,21,1,NASDAQ
4262,09-02-2021 18:00,24 hrs.,pennystocks,BTBT,6,6,0,6,1,1,0,1,NASDAQ
4262,09-02-2021 18:00,24 hrs.,pennystocks,BXRX,89,0,89,-89,1,33,19,1,NASDAQ
4262,09-02-2021 18:00,24 hrs.,pennystocks,CAPR,44,0,44,-44,1,17,6,1,NASDAQ
4262,09-02-2021 18:00,24 hrs.,pennystocks,CBAT,26,0,26,-26,4,4,2,3,NASDAQ
4262,09-02-2021 18:00,24 hrs.,pennystocks,CCRC,44,0,44,-44,1,17,6,1,NASDAQ
4262,09-02-2021 18:00,24 hrs.,pennystocks,CHCI,6,0,6,-6,1,1,0,1,NASDAQ
4262,09-02-2021 18:00,24 hrs.,pennystocks,CHEK,6,6,0,6,1,1,0,1,NASDAQ
4262,09-02-2021 18:00,24 hrs.,pennystocks,CHMA,9,9,0,9,1,2,1,1,NASDAQ
4262,09-02-2021 18:00,24 hrs.,pennystocks,CIDM,982,843,139,704,7,411,132,7,NASDAQ
4262,09-02-2021 18:00,24 hrs.,pennystocks,CLBS,123,123,0,123,1,49,21,1,NASDAQ
4262,09-02-2021 18:00,24 hrs.,pennystocks,CLNE,6,0,6,-6,1,1,0,1,NASDAQ
4262,09-02-2021 18:00,24 hrs.,pennystocks,CLSK,6,6,0,6,1,1,0,1,NASDAQ
4262,09-02-2021 18:00,24 hrs.,pennystocks,CLSN,8,8,0,8,1,0,4,1,NASDAQ
4262,09-02-2021 18:00,24 hrs.,pennystocks,CMPS,876,0,876,-876,1,374,124,1,NASDAQ
4262,09-02-2021 18:00,24 hrs.,pennystocks,CNET,44,0,44,-44,1,17,6,1,NASDAQ
4262,09-02-2021 18:00,24 hrs.,pennystocks,CNSP,6,0,6,-6,1,1,0,1,NASDAQ
4262,09-02-2021 18:00,24 hrs.,pennystocks,CRTD,15,0,15,-15,2,3,1,2,NASDAQ
4262,09-02-2021 18:00,24 hrs.,pennystocks,CSBR,6,0,6,-6,1,1,0,1,NASDAQ
4262,09-02-2021 18:00,24 hrs.,pennystocks,CSCW,13,6,7,-1,2,2,1,2,NASDAQ
4262,09-02-2021 18:00,24 hrs.,pennystocks,CTRM,234,88,146,-58,22,38,70,22,NASDAQ
4262,09-02-2021 18:00,24 hrs.,pennystocks,CTXR,201,23,178,-155,3,79,31,2,NASDAQ
4262,09-02-2021 18:00,24 hrs.,pennystocks,DARE,63,63,0,63,1,21,17,1,NASDAQ
4262,09-02-2021 18:00,24 hrs.,pennystocks,DLTR,7,7,0,7,1,1,1,1,NASDAQ
4262,09-02-2021 18:00,24 hrs.,pennystocks,EAST,239,82,157,-75,4,88,47,3,NASDAQ
4262,09-02-2021 18:00,24 hrs.,pennystocks,EDIT,76,76,0,76,2,27,14,2,NASDAQ
4262,09-02-2021 18:00,24 hrs.,pennystocks,EFOI,13,13,0,13,1,0,9,1,NASDAQ
4262,09-02-2021 18:00,24 hrs.,pennystocks,EKSO,44,0,44,-44,1,17,6,1,NASDAQ
4262,09-02-2021 18:00,24 hrs.,pennystocks,ENVB,13,0,13,-13,2,2,1,2,NASDAQ
4262,09-02-2021 18:00,24 hrs.,pennystocks,EVFM,145,145,0,145,1,59,23,1,NASDAQ
4262,09-02-2021 18:00,24 hrs.,pennystocks,EVOK,5,5,0,5,1,0,1,1,NASDAQ
4262,09-02-2021 18:00,24 hrs.,pennystocks,GAIN,15,15,0,15,1,5,1,1,NASDAQ
4262,09-02-2021 18:00,24 hrs.,pennystocks,GEVO,6,6,0,6,1,1,0,1,NASDAQ
4262,09-02-2021 18:00,24 hrs.,pennystocks,GHSI,131,0,131,-131,5,31,49,5,NASDAQ
4262,09-02-2021 18:00,24 hrs.,pennystocks,GMBL,44,0,44,-44,1,17,6,1,NASDAQ
4262,09-02-2021 18:00,24 hrs.,pennystocks,GNLN,6,0,6,-6,1,1,0,1,NASDAQ
4262,09-02-2021 18:00,24 hrs.,pennystocks,GNUS,62,6,56,-50,2,23,8,2,NASDAQ
4262,09-02-2021 18:00,24 hrs.,pennystocks,GOLD,45,45,0,45,1,16,9,1,NASDAQ
4262,09-02-2021 18:00,24 hrs.,pennystocks,GOVX,6,6,0,6,1,1,0,1,NASDAQ
4262,09-02-2021 18:00,24 hrs.,pennystocks,GRTS,6,6,0,6,1,1,0,1,NASDAQ
4262,09-02-2021 18:00,24 hrs.,pennystocks,HALO,6,6,0,6,1,1,0,1,NASDAQ
4262,09-02-2021 18:00,24 hrs.,pennystocks,HGSH,6,6,0,6,1,1,0,1,NASDAQ
4262,09-02-2021 18:00,24 hrs.,pennystocks,HJLI,6,0,6,-6,1,1,0,1,NASDAQ
4262,09-02-2021 18:00,24 hrs.,pennystocks,HMHC,18,0,18,-18,1,5,4,1,NASDAQ
4262,09-02-2021 18:00,24 hrs.,pennystocks,IDEX,7,7,0,7,1,1,1,1,NASDAQ
4262,09-02-2021 18:00,24 hrs.,pennystocks,IDXG,6,0,6,-6,1,1,0,1,NASDAQ
4262,09-02-2021 18:00,24 hrs.,pennystocks,IGMS,44,0,44,-44,1,17,6,1,NASDAQ
4262,09-02-2021 18:00,24 hrs.,pennystocks,IMMP,6,6,0,6,1,1,0,1,NASDAQ
4262,09-02-2021 18:00,24 hrs.,pennystocks,INFI,6,0,6,-6,1,1,0,1,NASDAQ
4262,09-02-2021 18:00,24 hrs.,pennystocks,INFO,744,0,744,-744,2,277,182,2,NASDAQ
4262,09-02-2021 18:00,24 hrs.,pennystocks,ADMP,44,27,17,10,3,9,14,3,NASDAQ
4262,09-02-2021 18:00,24 hrs.,pennystocks,AESE,44,0,44,-44,1,17,6,1,NASDAQ
4262,09-02-2021 18:00,24 hrs.,pennystocks,AEZS,291,34,257,-223,23,73,53,20,NASDAQ
4262,09-02-2021 18:00,24 hrs.,pennystocks,AGTC,34,27,7,20,3,4,14,3,NASDAQ
4262,09-02-2021 18:00,24 hrs.,pennystocks,AKBA,82,82,0,82,1,29,20,1,NASDAQ
4262,09-02-2021 18:00,24 hrs.,pennystocks,AMTX,12,12,0,12,2,2,0,2,NASDAQ
4262,09-02-2021 18:00,24 hrs.,pennystocks,APPS,6,6,0,6,1,1,0,1,NASDAQ
4262,09-02-2021 18:00,24 hrs.,pennystocks,APWC,12,12,0,12,2,2,0,2,NASDAQ
4262,09-02-2021 18:00,24 hrs.,pennystocks,AREC,7,7,0,7,1,1,1,1,NASDAQ
4262,09-02-2021 18:00,24 hrs.,pennystocks,COTY,30,30,0,30,1,10,6,1,NYSE
4262,09-02-2021 18:00,24 hrs.,pennystocks,EXPR,12,12,0,12,2,2,0,2,NYSE
4262,09-02-2021 18:00,24 hrs.,pennystocks,HEXO,6,0,6,-6,1,1,0,1,NYSE
4262,09-02-2021 18:00,24 hrs.,pennystocks,LMND,6,6,0,6,1,1,0,1,NYSE
4262,09-02-2021 18:00,24 hrs.,pennystocks,LUMN,37,30,7,23,2,11,7,2,NYSE
4262,09-02-2021 18:00,24 hrs.,pennystocks,NVTA,7,0,7,-7,1,1,1,1,NYSE
4262,09-02-2021 18:00,24 hrs.,pennystocks,PRTY,6,6,0,6,1,1,0,1,NYSE
4262,09-02-2021 18:00,24 hrs.,pennystocks,WBAI,44,0,44,-44,1,17,6,1,NYSE
4262,09-02-2021 18:00,24 hrs.,pennystocks,AQB,31,0,31,-31,2,10,3,2,NASDAQ
4262,09-02-2021 18:00,24 hrs.,pennystocks,AZN,12,12,0,12,2,2,0,1,NASDAQ
4262,09-02-2021 18:00,24 hrs.,pennystocks,BBI,14,7,7,0,2,2,2,2,NASDAQ
4262,09-02-2021 18:00,24 hrs.,pennystocks,CGC,876,0,876,-876,1,374,124,1,NASDAQ
4262,09-02-2021 18:00,24 hrs.,pennystocks,DYN,6,6,0,6,1,1,0,1,NASDAQ
4262,09-02-2021 18:00,24 hrs.,pennystocks,ESG,42,42,0,42,1,11,16,1,NASDAQ
4262,09-02-2021 18:00,24 hrs.,pennystocks,III,31,31,0,31,1,7,13,1,NASDAQ
4262,09-02-2021 18:00,24 hrs.,pennystocks,NEO,876,0,876,-876,1,374,124,1,NASDAQ
4262,09-02-2021 18:00,24 hrs.,pennystocks,OGI,14,14,0,14,2,2,2,2,NASDAQ
4262,09-02-2021 18:00,24 hrs.,pennystocks,OSS,11,0,11,-11,1,3,1,1,NASDAQ
4262,09-02-2021 18:00,24 hrs.,pennystocks,PTE,7,7,0,7,1,1,1,1,NASDAQ
4262,09-02-2021 18:00,24 hrs.,pennystocks,RUN,19,19,0,19,3,3,1,2,NASDAQ
4262,09-02-2021 18:00,24 hrs.,pennystocks,SND,6,0,6,-6,1,1,0,1,NASDAQ
4262,09-02-2021 18:00,24 hrs.,pennystocks,TTD,46,0,46,-46,1,16,10,1,NASDAQ
4262,09-02-2021 18:00,24 hrs.,pennystocks,AACG,44,0,44,-44,1,17,6,1,NASDAQ
4262,09-02-2021 18:00,24 hrs.,pennystocks,AAME,6,6,0,6,1,1,0,1,NASDAQ
4262,09-02-2021 18:00,24 hrs.,pennystocks,ABEO,144,139,5,134,3,50,32,3,NASDAQ
4262,09-02-2021 18:00,24 hrs.,pennystocks,ABUS,7,7,0,7,1,1,1,1,NASDAQ
4262,09-02-2021 18:00,24 hrs.,pennystocks,ACRX,526,0,526,-526,1,229,64,1,NASDAQ
4262,09-02-2021 18:00,24 hrs.,pennystocks,ACST,57,7,50,-43,3,19,7,3,NASDAQ
4262,09-02-2021 18:00,24 hrs.,pennystocks,ADMA,77,77,0,77,1,31,11,1,NASDAQ
4262,09-02-2021 18:00,24 hrs.,pennystocks,DSS,33,27,6,21,3,10,1,3,AMEX
4262,09-02-2021 18:00,24 hrs.,pennystocks,FCO,30,30,0,30,4,3,8,3,AMEX
4262,09-02-2021 18:00,24 hrs.,pennystocks,GTE,165,6,159,-153,3,70,13,3,AMEX
4262,09-02-2021 18:00,24 hrs.,pennystocks,IGC,14,14,0,14,2,2,2,2,AMEX
4262,09-02-2021 18:00,24 hrs.,pennystocks,ISR,6,0,6,-6,1,1,0,1,AMEX
4262,09-02-2021 18:00,24 hrs.,pennystocks,ITP,1983,191,1792,-1601,5,858,247,5,AMEX
4262,09-02-2021 18:00,24 hrs.,pennystocks,KIQ,20,20,0,20,3,3,2,1,AMEX
4262,09-02-2021 18:00,24 hrs.,pennystocks,MCF,6,6,0,6,1,1,0,1,AMEX
4262,09-02-2021 18:00,24 hrs.,pennystocks,NAK,21,14,7,7,3,3,3,3,AMEX
4262,09-02-2021 18:00,24 hrs.,pennystocks,NBY,18,18,0,18,1,5,4,1,AMEX
4262,09-02-2021 18:00,24 hrs.,pennystocks,PLX,70,70,0,70,1,29,8,1,AMEX
4262,09-02-2021 18:00,24 hrs.,pennystocks,PTN,12,12,0,12,2,2,0,2,AMEX
4262,09-02-2021 18:00,24 hrs.,pennystocks,REI,77,0,77,-77,3,21,23,3,AMEX
4262,09-02-2021 18:00,24 hrs.,pennystocks,SYN,26,0,26,-26,1,8,6,1,AMEX
4262,09-02-2021 18:00,24 hrs.,pennystocks,UEC,6,6,0,6,1,1,0,1,AMEX
4262,09-02-2021 18:00,24 hrs.,pennystocks,WYY,44,0,44,-44,1,17,6,1,AMEX
4262,09-02-2021 18:00,24 hrs.,pennystocks,ZOM,1575,255,1320,-1065,29,552,355,29,AMEX
4262,09-02-2021 18:00,24 hrs.,pennystocks,ARMP,6,6,0,6,1,1,0,1,AMEX
4262,09-02-2021 18:00,24 hrs.,pennystocks,CANF,41,35,6,29,2,12,9,2,AMEX
4262,09-02-2021 18:00,24 hrs.,pennystocks,CPHI,7,7,0,7,1,1,1,1,AMEX
4262,09-02-2021 18:00,24 hrs.,pennystocks,EMAN,7,7,0,7,1,1,1,1,AMEX
4262,09-02-2021 18:00,24 hrs.,pennystocks,ENSV,44,0,44,-44,1,17,6,1,AMEX
4262,09-02-2021 18:00,24 hrs.,pennystocks,GSAT,91,91,0,91,4,25,25,4,AMEX
4262,09-02-2021 18:00,24 hrs.,pennystocks,INUV,6,0,6,-6,1,1,0,1,AMEX
4262,09-02-2021 18:00,24 hrs.,pennystocks,LCTX,6,6,0,6,1,1,0,1,AMEX
4262,09-02-2021 18:00,24 hrs.,pennystocks,NSPR,49,14,35,-21,6,7,11,6,AMEX
4262,09-02-2021 18:00,24 hrs.,pennystocks,OGEN,57,0,57,-57,3,19,7,3,AMEX
4262,09-02-2021 18:00,24 hrs.,pennystocks,SENS,112,13,99,-86,6,38,12,6,AMEX
4262,09-02-2021 18:00,24 hrs.,pennystocks,SNMP,12,0,12,-12,2,2,0,2,AMEX
4262,09-02-2021 18:00,24 hrs.,pennystocks,TMBR,29,29,0,29,1,7,11,1,AMEX
4262,09-02-2021 18:00,24 hrs.,pennystocks,TRXC,6,6,0,6,1,1,0,1,AMEX
4262,09-02-2021 18:00,24 hrs.,pennystocks,AMC,43,12,31,-19,7,7,1,7,NYSE
4262,09-02-2021 18:00,24 hrs.,pennystocks,ASX,156,114,42,72,3,49,46,3,NYSE
4262,09-02-2021 18:00,24 hrs.,pennystocks,BLL,108,0,108,-108,1,43,18,1,NYSE
4262,09-02-2021 18:00,24 hrs.,pennystocks,BTT,24,24,0,24,4,4,0,3,NYSE
4262,09-02-2021 18:00,24 hrs.,pennystocks,CBD,219,207,12,195,9,64,55,8,NYSE
4262,09-02-2021 18:00,24 hrs.,pennystocks,COO,876,0,876,-876,1,374,124,1,NYSE
4262,09-02-2021 18:00,24 hrs.,pennystocks,CVS,888,12,876,-864,3,376,124,3,NYSE
4262,09-02-2021 18:00,24 hrs.,pennystocks,DSX,18,0,18,-18,1,5,4,1,NYSE
4262,09-02-2021 18:00,24 hrs.,pennystocks,DVN,7,7,0,7,1,1,1,1,NYSE
4262,09-02-2021 18:00,24 hrs.,pennystocks,EAT,6,0,6,-6,1,1,0,1,NYSE
4262,09-02-2021 18:00,24 hrs.,pennystocks,EMF,7,7,0,7,1,1,1,1,NYSE
4262,09-02-2021 18:00,24 hrs.,pennystocks,FRA,260,0,260,-260,1,107,42,1,NYSE
4262,09-02-2021 18:00,24 hrs.,pennystocks,GME,1050,1024,26,998,9,429,156,8,NYSE
4262,09-02-2021 18:00,24 hrs.,pennystocks,GSX,21,21,0,21,1,8,1,1,NYSE
4262,09-02-2021 18:00,24 hrs.,pennystocks,HVT,7,7,0,7,1,1,1,1,NYSE
4262,09-02-2021 18:00,24 hrs.,pennystocks,ICD,7,7,0,7,1,1,1,1,NYSE
4262,09-02-2021 18:00,24 hrs.,pennystocks,IPV,6,0,6,-6,1,1,0,1,NYSE
4262,09-02-2021 18:00,24 hrs.,pennystocks,JPM,6,0,6,-6,1,1,0,1,NYSE
4262,09-02-2021 18:00,24 hrs.,pennystocks,MPX,744,0,744,-744,2,277,182,2,NYSE
4262,09-02-2021 18:00,24 hrs.,pennystocks,NOK,19,13,6,7,3,3,1,3,NYSE
4262,09-02-2021 18:00,24 hrs.,pennystocks,SAP,876,0,876,-876,1,374,124,1,NYSE
4262,09-02-2021 18:00,24 hrs.,pennystocks,SOS,12,12,0,12,2,2,0,2,NYSE
4262,09-02-2021 18:00,24 hrs.,pennystocks,TDA,28,7,21,-14,2,5,10,2,NYSE
4262,09-02-2021 18:00,24 hrs.,pennystocks,TSE,6,6,0,6,1,1,0,1,NYSE
4262,09-02-2021 18:00,24 hrs.,pennystocks,XOM,64,0,64,-64,1,19,22,1,NYSE
4262,09-02-2021 18:00,24 hrs.,pennystocks,AMRX,6,0,6,-6,1,1,0,1,NYSE
4262,09-02-2021 18:00,24 hrs.,pennystocks,BORR,22,6,16,-10,2,5,4,2,NYSE
4262,09-02-2021 18:00,24 hrs.,pennystocks,CCIV,12,12,0,12,2,2,0,2,NYSE
4262,09-02-2021 18:00,24 hrs.,pennystocks,RVVTF,897,14,883,-869,4,377,127,3,OTC
4262,09-02-2021 18:00,24 hrs.,pennystocks,RYCEY,7,7,0,7,1,1,1,1,OTC
4262,09-02-2021 18:00,24 hrs.,pennystocks,SPLIF,9,9,0,9,1,2,1,1,OTC
4262,09-02-2021 18:00,24 hrs.,pennystocks,SPRWF,260,0,260,-260,1,107,42,1,OTC
4262,09-02-2021 18:00,24 hrs.,pennystocks,TFECY,18,0,18,-18,3,3,0,1,OTC
4262,09-02-2021 18:00,24 hrs.,pennystocks,TGODF,13,13,0,13,2,2,1,2,OTC
4262,09-02-2021 18:00,24 hrs.,pennystocks,TLOFF,3482,6,3476,-3470,2,1446,582,2,OTC
4262,09-02-2021 18:00,24 hrs.,pennystocks,TOMDF,6,0,6,-6,1,1,0,1,OTC
4262,09-02-2021 18:00,24 hrs.,pennystocks,TRMNF,6,0,6,-6,1,1,0,1,OTC
4262,09-02-2021 18:00,24 hrs.,pennystocks,TRUFF,876,0,876,-876,1,374,124,1,OTC
4262,09-02-2021 18:00,24 hrs.,pennystocks,UBMRF,51,51,0,51,1,20,7,1,OTC
4262,09-02-2021 18:00,24 hrs.,pennystocks,UCCPF,6,6,0,6,1,1,0,1,OTC
4262,09-02-2021 18:00,24 hrs.,pennystocks,VSBGF,6,0,6,-6,1,1,0,1,OTC
4262,09-02-2021 18:00,24 hrs.,pennystocks,WALRF,26,26,0,26,1,7,8,1,OTC
4262,09-02-2021 18:00,24 hrs.,pennystocks,WDDMF,6,0,6,-6,1,1,0,1,OTC
4262,09-02-2021 18:00,24 hrs.,pennystocks,ZBISF,7,0,7,-7,1,1,1,1,OTC
4262,09-02-2021 18:00,24 hrs.,pennystocks,ACY,6,6,0,6,1,1,0,1,AMEX
4262,09-02-2021 18:00,24 hrs.,pennystocks,CVM,6,6,0,6,1,1,0,1,AMEX
4262,09-02-2021 18:00,24 hrs.,pennystocks,DNN,17,0,17,-17,2,3,3,2,AMEX
4262,09-02-2021 18:00,24 hrs.,pennystocks,DPW,6,6,0,6,1,1,0,1,AMEX
4262,09-02-2021 18:00,24 hrs.,pennystocks,WHEN,6,6,0,6,1,1,0,1,OTC
4262,09-02-2021 18:00,24 hrs.,pennystocks,WRFX,6,0,6,-6,1,1,0,1,OTC
4262,09-02-2021 18:00,24 hrs.,pennystocks,WSGF,14,0,14,-14,2,2,2,1,OTC
4262,09-02-2021 18:00,24 hrs.,pennystocks,XALL,7,7,0,7,1,1,1,1,OTC
4262,09-02-2021 18:00,24 hrs.,pennystocks,XDSL,18,18,0,18,3,3,0,2,OTC
4262,09-02-2021 18:00,24 hrs.,pennystocks,XMET,12,0,12,-12,1,3,2,1,OTC
4262,09-02-2021 18:00,24 hrs.,pennystocks,ZENG,6,0,6,-6,1,1,0,1,OTC
4262,09-02-2021 18:00,24 hrs.,pennystocks,AAIRF,15,15,0,15,2,2,3,1,OTC
4262,09-02-2021 18:00,24 hrs.,pennystocks,ABEPF,19,19,0,19,3,3,1,3,OTC
4262,09-02-2021 18:00,24 hrs.,pennystocks,ABXXF,42,42,0,42,1,11,16,1,OTC
4262,09-02-2021 18:00,24 hrs.,pennystocks,AGFAF,6,0,6,-6,1,1,0,1,OTC
4262,09-02-2021 18:00,24 hrs.,pennystocks,AMYZF,13,0,13,-13,1,0,9,1,OTC
4262,09-02-2021 18:00,24 hrs.,pennystocks,APAAF,22,0,22,-22,1,6,6,1,OTC
4262,09-02-2021 18:00,24 hrs.,pennystocks,ARSMF,6,6,0,6,1,1,0,1,OTC
4262,09-02-2021 18:00,24 hrs.,pennystocks,ARXRF,6,0,6,-6,1,1,0,1,OTC
4262,09-02-2021 18:00,24 hrs.,pennystocks,ATBPF,7,7,0,7,1,1,1,1,OTC
4262,09-02-2021 18:00,24 hrs.,pennystocks,AZKLF,6,6,0,6,1,1,0,1,OTC
4262,09-02-2021 18:00,24 hrs.,pennystocks,BBRRF,220,0,220,-220,1,90,36,1,OTC
4262,09-02-2021 18:00,24 hrs.,pennystocks,BLOZF,6,6,0,6,1,1,0,1,OTC
4262,09-02-2021 18:00,24 hrs.,pennystocks,CCIHY,6,6,0,6,1,1,0,1,OTC
4262,09-02-2021 18:00,24 hrs.,pennystocks,CHOOF,7,0,7,-7,1,1,1,1,OTC
4262,09-02-2021 18:00,24 hrs.,pennystocks,CNTTQ,9,9,0,9,1,2,1,1,OTC
4262,09-02-2021 18:00,24 hrs.,pennystocks,CNVCF,32,32,0,32,1,8,12,1,OTC
4262,09-02-2021 18:00,24 hrs.,pennystocks,DFLYF,18,0,18,-18,1,3,8,1,OTC
4262,09-02-2021 18:00,24 hrs.,pennystocks,DGTHF,6,0,6,-6,1,1,0,1,OTC
4262,09-02-2021 18:00,24 hrs.,pennystocks,DYFSF,28,28,0,28,1,9,6,1,OTC
4262,09-02-2021 18:00,24 hrs.,pennystocks,EFLVF,46,46,0,46,1,17,8,1,OTC
4262,09-02-2021 18:00,24 hrs.,pennystocks,EHVVF,882,6,876,-870,2,375,124,2,OTC
4262,09-02-2021 18:00,24 hrs.,pennystocks,ENGMF,46,0,46,-46,1,16,10,1,OTC
4262,09-02-2021 18:00,24 hrs.,pennystocks,ENTEF,7,0,7,-7,1,1,1,1,OTC
4262,09-02-2021 18:00,24 hrs.,pennystocks,ERPNF,190,0,190,-190,1,60,66,1,OTC
4262,09-02-2021 18:00,24 hrs.,pennystocks,FBRKF,6,0,6,-6,1,1,0,1,OTC
4262,09-02-2021 18:00,24 hrs.,pennystocks,FBSGF,18,18,0,18,3,3,0,2,OTC
4262,09-02-2021 18:00,24 hrs.,pennystocks,FLOOF,6,0,6,-6,1,1,0,1,OTC
4262,09-02-2021 18:00,24 hrs.,pennystocks,FTRPF,876,0,876,-876,1,374,124,1,OTC
4262,09-02-2021 18:00,24 hrs.,pennystocks,FUSEF,138,138,0,138,1,52,30,1,OTC
4262,09-02-2021 18:00,24 hrs.,pennystocks,GBOKF,876,0,876,-876,1,374,124,1,OTC
4262,09-02-2021 18:00,24 hrs.,pennystocks,GLDFF,6,6,0,6,1,1,0,1,OTC
4262,09-02-2021 18:00,24 hrs.,pennystocks,GOOLF,6,0,6,-6,1,1,0,1,OTC
4262,09-02-2021 18:00,24 hrs.,pennystocks,GTSIF,6,6,0,6,1,1,0,1,OTC
4262,09-02-2021 18:00,24 hrs.,pennystocks,HAPBF,12,6,6,0,2,2,0,2,OTC
4262,09-02-2021 18:00,24 hrs.,pennystocks,HITIF,961,748,213,535,8,393,143,8,OTC
4262,09-02-2021 18:00,24 hrs.,pennystocks,HVBTF,6,6,0,6,1,1,0,1,OTC
4262,09-02-2021 18:00,24 hrs.,pennystocks,JETMF,15,15,0,15,1,4,3,1,OTC
4262,09-02-2021 18:00,24 hrs.,pennystocks,KHRIF,86,86,0,86,1,35,12,1,OTC
4262,09-02-2021 18:00,24 hrs.,pennystocks,LGLOF,6,6,0,6,1,1,0,1,OTC
4262,09-02-2021 18:00,24 hrs.,pennystocks,LKYSF,876,0,876,-876,1,374,124,1,OTC
4262,09-02-2021 18:00,24 hrs.,pennystocks,LLKKF,270,137,133,4,8,89,60,8,OTC
4262,09-02-2021 18:00,24 hrs.,pennystocks,LXXGF,17,17,0,17,2,4,1,2,OTC
4262,09-02-2021 18:00,24 hrs.,pennystocks,MGROF,6,6,0,6,1,1,0,1,OTC
4262,09-02-2021 18:00,24 hrs.,pennystocks,MJARF,7,0,7,-7,1,1,1,1,OTC
4262,09-02-2021 18:00,24 hrs.,pennystocks,MMEDF,890,14,876,-862,3,376,126,2,OTC
4262,09-02-2021 18:00,24 hrs.,pennystocks,MMNFF,63,13,50,-37,5,16,11,3,OTC
4262,09-02-2021 18:00,24 hrs.,pennystocks,MNXXF,68,68,0,68,1,29,6,1,OTC
4262,09-02-2021 18:00,24 hrs.,pennystocks,MPXOF,744,0,744,-744,2,277,182,2,OTC
4262,09-02-2021 18:00,24 hrs.,pennystocks,MSNVF,6,0,6,-6,1,1,0,1,OTC
4262,09-02-2021 18:00,24 hrs.,pennystocks,NMGRF,6,6,0,6,1,1,0,1,OTC
4262,09-02-2021 18:00,24 hrs.,pennystocks,RACMF,6,0,6,-6,1,1,0,1,OTC
4262,09-02-2021 18:00,24 hrs.,pennystocks,RAZFF,31,31,0,31,1,9,9,1,OTC
4262,09-02-2021 18:00,24 hrs.,pennystocks,RECAF,7,7,0,7,1,1,1,1,OTC
4262,09-02-2021 18:00,24 hrs.,pennystocks,REZZF,25,0,25,-25,4,4,1,2,OTC
4262,09-02-2021 18:00,24 hrs.,pennystocks,RHHNF,6,0,6,-6,1,1,0,1,OTC
4262,09-02-2021 18:00,24 hrs.,pennystocks,RLFTF,158,118,40,78,10,33,52,8,OTC
4262,09-02-2021 18:00,24 hrs.,pennystocks,RLLCF,6,6,0,6,1,1,0,1,OTC
4262,09-02-2021 18:00,24 hrs.,pennystocks,PHIL,33,33,0,33,1,9,11,1,OTC
4262,09-02-2021 18:00,24 hrs.,pennystocks,PHOT,7,7,0,7,1,1,1,1,OTC
4262,09-02-2021 18:00,24 hrs.,pennystocks,PLPL,7,7,0,7,1,1,1,1,OTC
4262,09-02-2021 18:00,24 hrs.,pennystocks,PLYZ,13,0,13,-13,2,2,1,1,OTC
4262,09-02-2021 18:00,24 hrs.,pennystocks,PMDP,25,25,0,25,1,4,13,1,OTC
4262,09-02-2021 18:00,24 hrs.,pennystocks,PONT,12,12,0,12,2,2,0,1,OTC
4262,09-02-2021 18:00,24 hrs.,pennystocks,PPJE,7,0,7,-7,1,1,1,1,OTC
4262,09-02-2021 18:00,24 hrs.,pennystocks,PTCO,7,0,7,-7,1,1,1,1,OTC
4262,09-02-2021 18:00,24 hrs.,pennystocks,PTOI,6,0,6,-6,1,1,0,1,OTC
4262,09-02-2021 18:00,24 hrs.,pennystocks,PTTN,6,6,0,6,1,1,0,1,OTC
4262,09-02-2021 18:00,24 hrs.,pennystocks,PURA,25,0,25,-25,4,4,1,4,OTC
4262,09-02-2021 18:00,24 hrs.,pennystocks,PVDG,388,40,348,-308,9,103,146,7,OTC
4262,09-02-2021 18:00,24 hrs.,pennystocks,QNTA,6,0,6,-6,1,1,0,1,OTC
4262,09-02-2021 18:00,24 hrs.,pennystocks,QSEP,7,0,7,-7,1,1,1,1,OTC
4262,09-02-2021 18:00,24 hrs.,pennystocks,REFG,49,0,49,-49,1,15,15,1,OTC
4262,09-02-2021 18:00,24 hrs.,pennystocks,RHCO,39,39,0,39,1,5,25,1,OTC
4262,09-02-2021 18:00,24 hrs.,pennystocks,RMTD,16,16,0,16,1,2,8,1,OTC
4262,09-02-2021 18:00,24 hrs.,pennystocks,RSCF,14,14,0,14,2,2,2,1,OTC
4262,09-02-2021 18:00,24 hrs.,pennystocks,RSSV,403,7,396,-389,6,127,125,6,OTC
4262,09-02-2021 18:00,24 hrs.,pennystocks,RTON,22,16,6,10,3,3,4,3,OTC
4262,09-02-2021 18:00,24 hrs.,pennystocks,SANP,6,0,6,-6,1,1,0,1,OTC
4262,09-02-2021 18:00,24 hrs.,pennystocks,SBFM,6,0,6,-6,1,1,0,1,OTC
4262,09-02-2021 18:00,24 hrs.,pennystocks,SEGI,24,10,14,-4,3,2,8,3,OTC
4262,09-02-2021 18:00,24 hrs.,pennystocks,SENY,104,0,104,-104,1,27,46,1,OTC
4262,09-02-2021 18:00,24 hrs.,pennystocks,SETY,6,0,6,-6,1,1,0,1,OTC
4262,09-02-2021 18:00,24 hrs.,pennystocks,SFOR,19,6,13,-7,3,3,1,3,OTC
4262,09-02-2021 18:00,24 hrs.,pennystocks,SGMD,36,30,6,24,3,11,2,3,OTC
4262,09-02-2021 18:00,24 hrs.,pennystocks,SGSI,13,0,13,-13,2,2,1,1,OTC
4262,09-02-2021 18:00,24 hrs.,pennystocks,SHMP,197,12,185,-173,5,59,59,5,OTC
4262,09-02-2021 18:00,24 hrs.,pennystocks,SHWZ,13,0,13,-13,2,2,1,1,OTC
4262,09-02-2021 18:00,24 hrs.,pennystocks,SIML,14,0,14,-14,2,2,2,2,OTC
4262,09-02-2021 18:00,24 hrs.,pennystocks,SING,47,6,41,-35,2,9,21,2,OTC
4262,09-02-2021 18:00,24 hrs.,pennystocks,SIRC,13,0,13,-13,2,2,1,2,OTC
4262,09-02-2021 18:00,24 hrs.,pennystocks,SKYF,39,39,0,39,1,5,25,1,OTC
4262,09-02-2021 18:00,24 hrs.,pennystocks,SMAA,25,0,25,-25,1,6,9,1,OTC
4262,09-02-2021 18:00,24 hrs.,pennystocks,SMGI,15,15,0,15,1,5,1,1,OTC
4262,09-02-2021 18:00,24 hrs.,pennystocks,SNPW,672,451,221,230,9,242,152,8,OTC
4262,09-02-2021 18:00,24 hrs.,pennystocks,SNRY,8,8,0,8,1,1,2,1,OTC
4262,09-02-2021 18:00,24 hrs.,pennystocks,SRMX,82,54,28,26,6,19,20,5,OTC
4262,09-02-2021 18:00,24 hrs.,pennystocks,SSFT,433,178,255,-77,7,162,81,6,OTC
4262,09-02-2021 18:00,24 hrs.,pennystocks,SVTE,6,0,6,-6,1,1,0,1,OTC
4262,09-02-2021 18:00,24 hrs.,pennystocks,TBEV,13,13,0,13,1,4,1,1,OTC
4262,09-02-2021 18:00,24 hrs.,pennystocks,TLSS,163,157,6,151,5,56,31,5,OTC
4262,09-02-2021 18:00,24 hrs.,pennystocks,TMRC,6,0,6,-6,1,1,0,1,OTC
4262,09-02-2021 18:00,24 hrs.,pennystocks,TNRI,15,0,15,-15,1,1,9,1,OTC
4262,09-02-2021 18:00,24 hrs.,pennystocks,TONR,39,39,0,39,1,5,25,1,OTC
4262,09-02-2021 18:00,24 hrs.,pennystocks,TRTC,27,21,6,15,3,6,3,3,OTC
4262,09-02-2021 18:00,24 hrs.,pennystocks,TSNP,125,56,69,-13,12,28,21,11,OTC
4262,09-02-2021 18:00,24 hrs.,pennystocks,TSOI,6,0,6,-6,1,1,0,1,OTC
4262,09-02-2021 18:00,24 hrs.,pennystocks,TXTM,24,0,24,-24,1,7,6,1,OTC
4262,09-02-2021 18:00,24 hrs.,pennystocks,UBQU,100,87,13,74,5,17,46,5,OTC
4262,09-02-2021 18:00,24 hrs.,pennystocks,UPCO,6,6,0,6,1,1,0,1,OTC
4262,09-02-2021 18:00,24 hrs.,pennystocks,USMJ,40,40,0,40,3,11,6,3,OTC
4262,09-02-2021 18:00,24 hrs.,pennystocks,USRM,7,0,7,-7,1,1,1,1,OTC
4262,09-02-2021 18:00,24 hrs.,pennystocks,VGLS,7,0,7,-7,1,1,1,1,OTC
4262,09-02-2021 18:00,24 hrs.,pennystocks,VIZC,6,0,6,-6,1,1,0,1,OTC
4262,09-02-2021 18:00,24 hrs.,pennystocks,VMHG,39,39,0,39,1,5,25,1,OTC
4262,09-02-2021 18:00,24 hrs.,pennystocks,VPER,280,280,0,280,9,97,50,7,OTC
4262,09-02-2021 18:00,24 hrs.,pennystocks,VPOR,13,13,0,13,2,2,1,1,OTC
4262,09-02-2021 18:00,24 hrs.,pennystocks,VSYM,14,14,0,14,1,3,4,1,OTC
4262,09-02-2021 18:00,24 hrs.,pennystocks,VYST,13,7,6,1,2,2,1,2,OTC
4262,09-02-2021 18:00,24 hrs.,pennystocks,WARM,6,6,0,6,1,1,0,1,OTC
4262,09-02-2021 18:00,24 hrs.,pennystocks,WDHR,19,19,0,19,3,3,1,1,OTC
4262,09-02-2021 18:00,24 hrs.,pennystocks,WDLF,49,25,24,1,6,6,13,5,OTC
4262,09-02-2021 18:00,24 hrs.,pennystocks,HFBG,6,0,6,-6,1,1,0,1,OTC
4262,09-02-2021 18:00,24 hrs.,pennystocks,HIMR,6,0,6,-6,1,1,0,1,OTC
4262,09-02-2021 18:00,24 hrs.,pennystocks,HIPH,6,0,6,-6,1,1,0,1,OTC
4262,09-02-2021 18:00,24 hrs.,pennystocks,HLIX,6,6,0,6,1,1,0,1,OTC
4262,09-02-2021 18:00,24 hrs.,pennystocks,HQGE,129,46,83,-37,8,25,47,7,OTC
4262,09-02-2021 18:00,24 hrs.,pennystocks,HYII,134,7,127,-120,2,45,36,2,OTC
4262,09-02-2021 18:00,24 hrs.,pennystocks,HYSR,90,90,0,90,3,29,20,3,OTC
4262,09-02-2021 18:00,24 hrs.,pennystocks,ICLD,6,6,0,6,1,1,0,1,OTC
4262,09-02-2021 18:00,24 hrs.,pennystocks,IFBC,7,7,0,7,1,1,1,1,OTC
4262,09-02-2021 18:00,24 hrs.,pennystocks,IFXY,13,13,0,13,2,2,1,1,OTC
4262,09-02-2021 18:00,24 hrs.,pennystocks,ILUS,13,6,7,-1,2,2,1,2,OTC
4262,09-02-2021 18:00,24 hrs.,pennystocks,IMTV,6,6,0,6,1,1,0,1,OTC
4262,09-02-2021 18:00,24 hrs.,pennystocks,INAR,6,6,0,6,1,1,0,1,OTC
4262,09-02-2021 18:00,24 hrs.,pennystocks,INCC,6,0,6,-6,1,1,0,1,OTC
4262,09-02-2021 18:00,24 hrs.,pennystocks,INIS,15,0,15,-15,2,3,1,1,OTC
4262,09-02-2021 18:00,24 hrs.,pennystocks,INKW,79,42,37,5,13,13,1,11,OTC
4262,09-02-2021 18:00,24 hrs.,pennystocks,INND,400,139,261,-122,24,78,148,22,OTC
4262,09-02-2021 18:00,24 hrs.,pennystocks,INQD,6,0,6,-6,1,1,0,1,OTC
4262,09-02-2021 18:00,24 hrs.,pennystocks,IONI,6,6,0,6,1,1,0,1,OTC
4262,09-02-2021 18:00,24 hrs.,pennystocks,IPIX,31,0,31,-31,1,7,13,1,OTC
4262,09-02-2021 18:00,24 hrs.,pennystocks,IPWG,6,6,0,6,1,1,0,1,OTC
4262,09-02-2021 18:00,24 hrs.,pennystocks,IWSY,138,138,0,138,1,52,30,1,OTC
4262,09-02-2021 18:00,24 hrs.,pennystocks,JAMN,46,39,7,32,2,6,26,2,OTC
4262,09-02-2021 18:00,24 hrs.,pennystocks,JBZY,13,0,13,-13,2,2,1,1,OTC
4262,09-02-2021 18:00,24 hrs.,pennystocks,JETR,6,0,6,-6,1,1,0,1,OTC
4262,09-02-2021 18:00,24 hrs.,pennystocks,KAVL,22,22,0,22,3,4,2,2,OTC
4262,09-02-2021 18:00,24 hrs.,pennystocks,KNOS,7,0,7,-7,1,1,1,1,OTC
4262,09-02-2021 18:00,24 hrs.,pennystocks,KWBT,6,6,0,6,1,1,0,1,OTC
4262,09-02-2021 18:00,24 hrs.,pennystocks,LBUY,10,10,0,10,1,2,2,1,OTC
4262,09-02-2021 18:00,24 hrs.,pennystocks,LINK,34,0,34,-34,1,13,4,1,OTC
4262,09-02-2021 18:00,24 hrs.,pennystocks,LVVV,55,7,48,-41,2,13,21,2,OTC
4262,09-02-2021 18:00,24 hrs.,pennystocks,MATN,14,0,14,-14,1,0,10,1,OTC
4262,09-02-2021 18:00,24 hrs.,pennystocks,MCOA,26,12,14,-2,4,3,4,4,OTC
4262,09-02-2021 18:00,24 hrs.,pennystocks,MDCN,13,13,0,13,2,2,1,2,OTC
4262,09-02-2021 18:00,24 hrs.,pennystocks,MEDH,6,6,0,6,1,1,0,1,OTC
4262,09-02-2021 18:00,24 hrs.,pennystocks,MEGH,39,39,0,39,1,5,25,1,OTC
4262,09-02-2021 18:00,24 hrs.,pennystocks,MGON,6,0,6,-6,1,1,0,1,OTC
4262,09-02-2021 18:00,24 hrs.,pennystocks,MINE,247,234,13,221,9,82,47,9,OTC
4262,09-02-2021 18:00,24 hrs.,pennystocks,MJLB,6,0,6,-6,1,1,0,1,OTC
4262,09-02-2021 18:00,24 hrs.,pennystocks,MJNA,25,0,25,-25,4,4,1,4,OTC
4262,09-02-2021 18:00,24 hrs.,pennystocks,MLFB,202,6,196,-190,3,62,66,3,OTC
4262,09-02-2021 18:00,24 hrs.,pennystocks,MMEX,195,142,53,89,7,57,53,6,OTC
4262,09-02-2021 18:00,24 hrs.,pennystocks,MNGG,6,0,6,-6,1,1,0,1,OTC
4262,09-02-2021 18:00,24 hrs.,pennystocks,MSPC,6,6,0,6,1,1,0,1,OTC
4262,09-02-2021 18:00,24 hrs.,pennystocks,MTVX,7,7,0,7,1,1,1,1,OTC
4262,09-02-2021 18:00,24 hrs.,pennystocks,NACB,39,39,0,39,1,5,25,1,OTC
4262,09-02-2021 18:00,24 hrs.,pennystocks,NECA,12,0,12,-12,1,2,4,1,OTC
4262,09-02-2021 18:00,24 hrs.,pennystocks,NLST,56,0,56,-56,2,21,6,2,OTC
4262,09-02-2021 18:00,24 hrs.,pennystocks,NRBT,7,7,0,7,1,1,1,1,OTC
4262,09-02-2021 18:00,24 hrs.,pennystocks,NROM,6,0,6,-6,1,1,0,1,OTC
4262,09-02-2021 18:00,24 hrs.,pennystocks,NSPT,39,39,0,39,1,5,25,1,OTC
4262,09-02-2021 18:00,24 hrs.,pennystocks,NSPX,12,0,12,-12,2,2,0,2,OTC
4262,09-02-2021 18:00,24 hrs.,pennystocks,NTRR,24,0,24,-24,4,4,0,4,OTC
4262,09-02-2021 18:00,24 hrs.,pennystocks,NUGS,24,12,12,0,4,4,0,4,OTC
4262,09-02-2021 18:00,24 hrs.,pennystocks,NVGT,39,39,0,39,1,5,25,1,OTC
4262,09-02-2021 18:00,24 hrs.,pennystocks,ONCI,25,0,25,-25,1,8,5,1,OTC
4262,09-02-2021 18:00,24 hrs.,pennystocks,OPTI,77,71,6,65,4,26,9,4,OTC
4262,09-02-2021 18:00,24 hrs.,pennystocks,OPVS,7,7,0,7,1,1,1,1,OTC
4262,09-02-2021 18:00,24 hrs.,pennystocks,OZSC,1695,30,1665,-1635,13,742,159,12,OTC
4262,09-02-2021 18:00,24 hrs.,pennystocks,PAOG,6,6,0,6,1,1,0,1,OTC
4262,09-02-2021 18:00,24 hrs.,pennystocks,PBIO,18,0,18,-18,3,3,0,1,OTC
4262,09-02-2021 18:00,24 hrs.,pennystocks,PBYA,39,39,0,39,1,5,25,1,OTC
4262,09-02-2021 18:00,24 hrs.,pennystocks,PGTK,12,0,12,-12,2,2,0,2,OTC
4262,09-02-2021 18:00,24 hrs.,pennystocks,PHBI,235,40,195,-155,2,92,43,2,OTC
4262,09-02-2021 18:00,24 hrs.,pennystocks,BOTY,491,114,377,-263,19,141,133,17,OTC
4262,09-02-2021 18:00,24 hrs.,pennystocks,BRTX,18,13,5,8,3,2,2,2,OTC
4262,09-02-2021 18:00,24 hrs.,pennystocks,BRZL,7,7,0,7,1,1,1,1,OTC
4262,09-02-2021 18:00,24 hrs.,pennystocks,BTCS,6,6,0,6,1,1,0,1,OTC
4262,09-02-2021 18:00,24 hrs.,pennystocks,BTSC,26,13,13,0,4,4,2,4,OTC
4262,09-02-2021 18:00,24 hrs.,pennystocks,CAFS,8,0,8,-8,1,1,2,1,OTC
4262,09-02-2021 18:00,24 hrs.,pennystocks,CANN,6,0,6,-6,1,1,0,1,OTC
4262,09-02-2021 18:00,24 hrs.,pennystocks,CAPC,505,505,0,505,1,231,39,1,OTC
4262,09-02-2021 18:00,24 hrs.,pennystocks,CATV,19,0,19,-19,3,3,1,2,OTC
4262,09-02-2021 18:00,24 hrs.,pennystocks,CBBT,313,123,190,-67,12,76,113,11,OTC
4262,09-02-2021 18:00,24 hrs.,pennystocks,CBDD,71,6,65,-59,3,17,25,3,OTC
4262,09-02-2021 18:00,24 hrs.,pennystocks,CBDL,6,0,6,-6,1,1,0,1,OTC
4262,09-02-2021 18:00,24 hrs.,pennystocks,CCTL,18,12,6,6,3,2,2,3,OTC
4262,09-02-2021 18:00,24 hrs.,pennystocks,CELZ,6,0,6,-6,1,1,0,1,OTC
4262,09-02-2021 18:00,24 hrs.,pennystocks,CETY,5,0,5,-5,1,0,1,1,OTC
4262,09-02-2021 18:00,24 hrs.,pennystocks,CLSH,12,12,0,12,2,2,0,1,OTC
4262,09-02-2021 18:00,24 hrs.,pennystocks,CLTS,6,0,6,-6,1,1,0,1,OTC
4262,09-02-2021 18:00,24 hrs.,pennystocks,CLWD,64,64,0,64,4,14,20,3,OTC
4262,09-02-2021 18:00,24 hrs.,pennystocks,COMS,29,29,0,29,1,10,5,1,OTC
4262,09-02-2021 18:00,24 hrs.,pennystocks,COWI,6,6,0,6,1,1,0,1,OTC
4262,09-02-2021 18:00,24 hrs.,pennystocks,CTLE,52,52,0,52,1,20,8,1,OTC
4262,09-02-2021 18:00,24 hrs.,pennystocks,CTYX,15,0,15,-15,2,2,3,1,OTC
4262,09-02-2021 18:00,24 hrs.,pennystocks,CYBL,7,0,7,-7,1,1,1,1,OTC
4262,09-02-2021 18:00,24 hrs.,pennystocks,CYDY,7,7,0,7,1,1,1,1,OTC
4262,09-02-2021 18:00,24 hrs.,pennystocks,CYIO,6,0,6,-6,1,1,0,1,OTC
4262,09-02-2021 18:00,24 hrs.,pennystocks,DPLS,203,22,181,-159,9,68,31,8,OTC
4262,09-02-2021 18:00,24 hrs.,pennystocks,DRNK,47,16,31,-15,2,17,5,2,OTC
4262,09-02-2021 18:00,24 hrs.,pennystocks,DSCR,18,0,18,-18,1,4,6,1,OTC
4262,09-02-2021 18:00,24 hrs.,pennystocks,DSGT,15,15,0,15,1,5,1,1,OTC
4262,09-02-2021 18:00,24 hrs.,pennystocks,ECGI,39,39,0,39,1,5,25,1,OTC
4262,09-02-2021 18:00,24 hrs.,pennystocks,EDXC,25,25,0,25,4,4,1,3,OTC
4262,09-02-2021 18:00,24 hrs.,pennystocks,EHOS,39,39,0,39,1,5,25,1,OTC
4262,09-02-2021 18:00,24 hrs.,pennystocks,EMLL,27,0,27,-27,1,8,7,1,OTC
4262,09-02-2021 18:00,24 hrs.,pennystocks,ENZC,166,80,86,-6,8,37,60,8,OTC
4262,09-02-2021 18:00,24 hrs.,pennystocks,ERBB,6,0,6,-6,1,1,0,1,OTC
4262,09-02-2021 18:00,24 hrs.,pennystocks,ETFM,296,7,289,-282,2,106,76,2,OTC
4262,09-02-2021 18:00,24 hrs.,pennystocks,EUSP,14,0,14,-14,2,2,2,2,OTC
4262,09-02-2021 18:00,24 hrs.,pennystocks,EVUS,7,0,7,-7,1,1,1,1,OTC
4262,09-02-2021 18:00,24 hrs.,pennystocks,EXMT,7,0,7,-7,1,1,1,1,OTC
4262,09-02-2021 18:00,24 hrs.,pennystocks,FPFI,6,0,6,-6,1,1,0,1,OTC
4262,09-02-2021 18:00,24 hrs.,pennystocks,FPVD,13,7,6,1,2,2,1,2,OTC
4262,09-02-2021 18:00,24 hrs.,pennystocks,FTEG,144,138,6,132,2,53,30,2,OTC
4262,09-02-2021 18:00,24 hrs.,pennystocks,FTWS,6,0,6,-6,1,1,0,1,OTC
4262,09-02-2021 18:00,24 hrs.,pennystocks,FTXP,39,39,0,39,1,5,25,1,OTC
4262,09-02-2021 18:00,24 hrs.,pennystocks,GAXY,84,0,84,-84,5,23,18,5,OTC
4262,09-02-2021 18:00,24 hrs.,pennystocks,GFTX,36,0,36,-36,3,0,24,3,OTC
4262,09-02-2021 18:00,24 hrs.,pennystocks,GGII,8,0,8,-8,1,1,2,1,OTC
4262,09-02-2021 18:00,24 hrs.,pennystocks,GPFT,6,0,6,-6,1,1,0,1,OTC
4262,09-02-2021 18:00,24 hrs.,pennystocks,GRBX,34,0,34,-34,1,12,6,1,OTC
4262,09-02-2021 18:00,24 hrs.,pennystocks,GRNH,13,7,6,1,2,2,1,2,OTC
4262,09-02-2021 18:00,24 hrs.,pennystocks,GRPS,44,44,0,44,4,10,8,3,OTC
4262,09-02-2021 18:00,24 hrs.,pennystocks,GRSO,123,9,114,-105,2,40,35,2,OTC
4262,09-02-2021 18:00,24 hrs.,pennystocks,GSFI,54,6,48,-42,2,17,12,2,OTC
4262,09-02-2021 18:00,24 hrs.,pennystocks,GTEH,1572,0,1572,-1572,3,699,162,3,OTC
4262,09-02-2021 18:00,24 hrs.,pennystocks,GTII,45,45,0,45,1,16,9,1,OTC
4262,09-02-2021 18:00,24 hrs.,pennystocks,GTLA,7,0,7,-7,1,1,1,1,OTC
4262,09-02-2021 18:00,24 hrs.,pennystocks,GTLL,13,0,13,-13,2,2,1,2,OTC
4262,09-02-2021 18:00,24 hrs.,pennystocks,GWSN,22,0,22,-22,1,3,12,1,OTC
4262,09-02-2021 18:00,24 hrs.,pennystocks,GYOG,11,0,11,-11,1,0,7,1,OTC
4262,09-02-2021 18:00,24 hrs.,pennystocks,HAON,12,0,12,-12,2,2,0,1,OTC
4262,09-02-2021 18:00,24 hrs.,pennystocks,HBRM,12,0,12,-12,2,2,0,2,OTC
4262,09-02-2021 18:00,24 hrs.,pennystocks,HCMC,265,77,188,-111,42,42,13,31,OTC
4262,09-02-2021 18:00,24 hrs.,pennystocks,HEMP,76,7,69,-62,9,15,10,8,OTC
4262,09-02-2021 18:00,24 hrs.,pennystocks,HESG,45,39,6,33,2,6,25,2,OTC
4262,09-02-2021 18:00,24 hrs.,StockMarket,NCLH,76,0,76,-76,1,14,44,1,NASDAQ
4262,09-02-2021 18:00,24 hrs.,StockMarket,NMTR,18,0,18,-18,3,3,0,1,NASDAQ
4262,09-02-2021 18:00,24 hrs.,StockMarket,NOVN,6,0,6,-6,1,1,0,1,NASDAQ
4262,09-02-2021 18:00,24 hrs.,StockMarket,OBLN,6,6,0,6,1,1,0,1,NASDAQ
4262,09-02-2021 18:00,24 hrs.,StockMarket,OCGN,343,309,34,275,6,118,83,6,NASDAQ
4262,09-02-2021 18:00,24 hrs.,StockMarket,OPTT,6,0,6,-6,1,1,0,1,NASDAQ
4262,09-02-2021 18:00,24 hrs.,StockMarket,OTLK,19,19,0,19,1,2,11,1,NASDAQ
4262,09-02-2021 18:00,24 hrs.,StockMarket,PIXY,7,0,7,-7,1,1,1,1,NASDAQ
4262,09-02-2021 18:00,24 hrs.,StockMarket,QDEL,48,48,0,48,1,17,10,1,NASDAQ
4262,09-02-2021 18:00,24 hrs.,StockMarket,QGEN,48,48,0,48,1,17,10,1,NASDAQ
4262,09-02-2021 18:00,24 hrs.,StockMarket,REGN,125,0,125,-125,1,50,21,1,NASDAQ
4262,09-02-2021 18:00,24 hrs.,StockMarket,RIOT,6,6,0,6,1,1,0,1,NASDAQ
4262,09-02-2021 18:00,24 hrs.,StockMarket,RKDA,6,6,0,6,1,1,0,1,NASDAQ
4262,09-02-2021 18:00,24 hrs.,StockMarket,ROKU,125,0,125,-125,1,50,21,1,NASDAQ
4262,09-02-2021 18:00,24 hrs.,StockMarket,SAVA,6,6,0,6,1,1,0,1,NASDAQ
4262,09-02-2021 18:00,24 hrs.,StockMarket,SNDL,12,12,0,12,2,2,0,2,NASDAQ
4262,09-02-2021 18:00,24 hrs.,StockMarket,SRNE,12,0,12,-12,2,2,0,2,NASDAQ
4262,09-02-2021 18:00,24 hrs.,StockMarket,SSPK,8,8,0,8,1,1,2,1,NASDAQ
4262,09-02-2021 18:00,24 hrs.,StockMarket,SYRS,6,0,6,-6,1,1,0,1,NASDAQ
4262,09-02-2021 18:00,24 hrs.,StockMarket,THRM,6,6,0,6,1,1,0,1,NASDAQ
4262,09-02-2021 18:00,24 hrs.,StockMarket,TLRY,101,88,13,75,7,28,17,6,NASDAQ
4262,09-02-2021 18:00,24 hrs.,StockMarket,TNXP,27,27,0,27,1,10,3,1,NASDAQ
4262,09-02-2021 18:00,24 hrs.,StockMarket,TRIT,6,6,0,6,1,1,0,1,NASDAQ
4262,09-02-2021 18:00,24 hrs.,StockMarket,TSLA,125,0,125,-125,1,50,21,1,NASDAQ
4262,09-02-2021 18:00,24 hrs.,StockMarket,TTWO,48,48,0,48,1,17,10,1,NASDAQ
4262,09-02-2021 18:00,24 hrs.,StockMarket,TYME,6,0,6,-6,1,1,0,1,NASDAQ
4262,09-02-2021 18:00,24 hrs.,StockMarket,UONE,6,6,0,6,1,1,0,1,NASDAQ
4262,09-02-2021 18:00,24 hrs.,StockMarket,VBIV,11,11,0,11,1,3,1,1,NASDAQ
4262,09-02-2021 18:00,24 hrs.,StockMarket,VIVE,6,6,0,6,1,1,0,1,NASDAQ
4262,09-02-2021 18:00,24 hrs.,StockMarket,WDFC,6,6,0,6,1,1,0,1,NASDAQ
4262,09-02-2021 18:00,24 hrs.,StockMarket,WKHS,8,8,0,8,1,1,2,1,NASDAQ
4262,09-02-2021 18:00,24 hrs.,StockMarket,ZLAB,125,0,125,-125,1,50,21,1,NASDAQ
4262,09-02-2021 18:00,24 hrs.,StockMarket,ZNGA,12,12,0,12,2,2,0,2,NASDAQ
4262,09-02-2021 18:00,24 hrs.,StockMarket,CMCSA,6,6,0,6,1,1,0,1,NASDAQ
4262,09-02-2021 18:00,24 hrs.,pennystocks,ABML,108,0,108,-108,1,43,18,1,OTC
4262,09-02-2021 18:00,24 hrs.,pennystocks,ACCR,6,6,0,6,1,1,0,1,OTC
4262,09-02-2021 18:00,24 hrs.,pennystocks,ADGO,6,0,6,-6,1,1,0,1,OTC
4262,09-02-2021 18:00,24 hrs.,pennystocks,ADTM,13,13,0,13,2,2,1,1,OTC
4262,09-02-2021 18:00,24 hrs.,pennystocks,AEPT,7,7,0,7,1,1,1,1,OTC
4262,09-02-2021 18:00,24 hrs.,pennystocks,AERN,7,7,0,7,1,1,1,1,OTC
4262,09-02-2021 18:00,24 hrs.,pennystocks,AGYP,7,7,0,7,1,1,1,1,OTC
4262,09-02-2021 18:00,24 hrs.,pennystocks,AITX,209,19,190,-171,4,63,67,4,OTC
4262,09-02-2021 18:00,24 hrs.,pennystocks,ALKM,33,13,20,-7,5,4,5,5,OTC
4262,09-02-2021 18:00,24 hrs.,pennystocks,ALPP,122,109,13,96,4,41,24,4,OTC
4262,09-02-2021 18:00,24 hrs.,pennystocks,ALST,91,91,0,91,2,32,19,2,OTC
4262,09-02-2021 18:00,24 hrs.,pennystocks,ALYI,45,6,39,-33,7,7,3,6,OTC
4262,09-02-2021 18:00,24 hrs.,pennystocks,AMLH,6,0,6,-6,1,1,0,1,OTC
4262,09-02-2021 18:00,24 hrs.,pennystocks,ARTM,12,0,12,-12,2,1,2,1,OTC
4262,09-02-2021 18:00,24 hrs.,pennystocks,ARYC,7,0,7,-7,1,1,1,1,OTC
4262,09-02-2021 18:00,24 hrs.,pennystocks,ASCK,49,0,49,-49,1,15,15,1,OTC
4262,09-02-2021 18:00,24 hrs.,pennystocks,ASKE,8,8,0,8,1,1,2,1,OTC
4262,09-02-2021 18:00,24 hrs.,pennystocks,ASTI,96,44,52,-8,11,18,16,11,OTC
4262,09-02-2021 18:00,24 hrs.,pennystocks,ATVK,22,0,22,-22,1,4,10,1,OTC
4262,09-02-2021 18:00,24 hrs.,pennystocks,AXXA,6,0,6,-6,1,1,0,1,OTC
4262,09-02-2021 18:00,24 hrs.,pennystocks,BANT,23,23,0,23,1,7,5,1,OTC
4262,09-02-2021 18:00,24 hrs.,pennystocks,BBRW,31,0,31,-31,2,1,21,2,OTC
4262,09-02-2021 18:00,24 hrs.,pennystocks,BDGR,21,0,21,-21,3,3,3,2,OTC
4262,09-02-2021 18:00,24 hrs.,pennystocks,BFCH,95,37,58,-21,3,25,33,3,OTC
4262,09-02-2021 18:00,24 hrs.,pennystocks,BIEL,7,7,0,7,1,1,1,1,OTC
4262,09-02-2021 18:00,24 hrs.,pennystocks,BLAB,13,0,13,-13,2,2,1,2,OTC
4262,09-02-2021 18:00,24 hrs.,pennystocks,BLDV,89,89,0,89,1,30,25,1,OTC
4262,09-02-2021 18:00,24 hrs.,pennystocks,BLSP,279,88,191,-103,16,81,53,12,OTC
4262,09-02-2021 18:00,24 hrs.,pennystocks,BMIX,51,33,18,15,2,13,17,2,OTC
4262,09-02-2021 18:00,24 hrs.,pennystocks,BOTH,108,0,108,-108,1,43,18,1,OTC
4262,09-02-2021 18:00,24 hrs.,StockMarket,AGTC,6,6,0,6,1,1,0,1,NASDAQ
4262,09-02-2021 18:00,24 hrs.,StockMarket,AMRN,18,18,0,18,2,5,0,2,NASDAQ
4262,09-02-2021 18:00,24 hrs.,StockMarket,AMTX,6,6,0,6,1,1,0,1,NASDAQ
4262,09-02-2021 18:00,24 hrs.,StockMarket,APHA,32,20,12,8,5,5,2,4,NASDAQ
4262,09-02-2021 18:00,24 hrs.,StockMarket,APPS,6,0,6,-6,1,1,0,1,NASDAQ
4262,09-02-2021 18:00,24 hrs.,StockMarket,APWC,6,6,0,6,1,1,0,1,NASDAQ
4262,09-02-2021 18:00,24 hrs.,StockMarket,AQST,6,0,6,-6,1,1,0,1,NASDAQ
4262,09-02-2021 18:00,24 hrs.,StockMarket,ASYS,14,8,6,2,2,3,0,2,NASDAQ
4262,09-02-2021 18:00,24 hrs.,StockMarket,AUVI,309,309,0,309,2,113,75,2,NASDAQ
4262,09-02-2021 18:00,24 hrs.,StockMarket,BBIG,6,6,0,6,1,1,0,1,NASDAQ
4262,09-02-2021 18:00,24 hrs.,StockMarket,BCRX,22,22,0,22,1,8,2,1,NASDAQ
4262,09-02-2021 18:00,24 hrs.,StockMarket,BIDU,125,0,125,-125,1,50,21,1,NASDAQ
4262,09-02-2021 18:00,24 hrs.,StockMarket,BIOL,6,0,6,-6,1,1,0,1,NASDAQ
4262,09-02-2021 18:00,24 hrs.,StockMarket,BNGO,8,8,0,8,1,1,2,1,NASDAQ
4262,09-02-2021 18:00,24 hrs.,StockMarket,BTBT,6,6,0,6,1,1,0,1,NASDAQ
4262,09-02-2021 18:00,24 hrs.,StockMarket,CFMS,5,0,5,-5,1,0,1,1,NASDAQ
4262,09-02-2021 18:00,24 hrs.,StockMarket,CHCI,261,261,0,261,1,96,65,1,NASDAQ
4262,09-02-2021 18:00,24 hrs.,StockMarket,CLEU,6,6,0,6,1,1,0,1,NASDAQ
4262,09-02-2021 18:00,24 hrs.,StockMarket,CLSK,6,6,0,6,1,1,0,1,NASDAQ
4262,09-02-2021 18:00,24 hrs.,StockMarket,CLVR,6,6,0,6,1,1,0,1,NASDAQ
4262,09-02-2021 18:00,24 hrs.,StockMarket,CLVS,12,6,6,0,2,2,0,2,NASDAQ
4262,09-02-2021 18:00,24 hrs.,StockMarket,CODX,48,48,0,48,1,17,10,1,NASDAQ
4262,09-02-2021 18:00,24 hrs.,StockMarket,CRSR,173,48,125,-77,2,67,31,2,NASDAQ
4262,09-02-2021 18:00,24 hrs.,StockMarket,CTRM,6,0,6,-6,1,1,0,1,NASDAQ
4262,09-02-2021 18:00,24 hrs.,StockMarket,CYTH,72,72,0,72,4,22,12,4,NASDAQ
4262,09-02-2021 18:00,24 hrs.,StockMarket,DARE,8,0,8,-8,1,1,2,1,NASDAQ
4262,09-02-2021 18:00,24 hrs.,StockMarket,DKNG,25,0,25,-25,2,5,7,2,NASDAQ
4262,09-02-2021 18:00,24 hrs.,StockMarket,DRIV,8,8,0,8,1,1,2,1,NASDAQ
4262,09-02-2021 18:00,24 hrs.,StockMarket,EDAP,8,8,0,8,1,2,0,1,NASDAQ
4262,09-02-2021 18:00,24 hrs.,StockMarket,EDIT,76,0,76,-76,1,14,44,1,NASDAQ
4262,09-02-2021 18:00,24 hrs.,StockMarket,ENVB,6,0,6,-6,1,1,0,1,NASDAQ
4262,09-02-2021 18:00,24 hrs.,StockMarket,EVER,6,0,6,-6,1,1,0,1,NASDAQ
4262,09-02-2021 18:00,24 hrs.,StockMarket,EXPI,26,26,0,26,1,7,8,1,NASDAQ
4262,09-02-2021 18:00,24 hrs.,StockMarket,FCEL,14,14,0,14,2,2,2,2,NASDAQ
4262,09-02-2021 18:00,24 hrs.,StockMarket,GAIN,6,0,6,-6,1,1,0,1,NASDAQ
4262,09-02-2021 18:00,24 hrs.,StockMarket,GENE,6,0,6,-6,1,1,0,1,NASDAQ
4262,09-02-2021 18:00,24 hrs.,StockMarket,GEVO,8,8,0,8,1,1,2,1,NASDAQ
4262,09-02-2021 18:00,24 hrs.,StockMarket,GLUU,48,48,0,48,1,17,10,1,NASDAQ
4262,09-02-2021 18:00,24 hrs.,StockMarket,GMBL,10,0,10,-10,1,2,2,1,NASDAQ
4262,09-02-2021 18:00,24 hrs.,StockMarket,GNUS,6,6,0,6,1,1,0,1,NASDAQ
4262,09-02-2021 18:00,24 hrs.,StockMarket,GOEV,6,0,6,-6,1,1,0,1,NASDAQ
4262,09-02-2021 18:00,24 hrs.,StockMarket,GRTS,6,6,0,6,1,1,0,1,NASDAQ
4262,09-02-2021 18:00,24 hrs.,StockMarket,GRWG,61,6,55,-49,2,20,13,2,NASDAQ
4262,09-02-2021 18:00,24 hrs.,StockMarket,GWPH,123,123,0,123,1,41,37,1,NASDAQ
4262,09-02-2021 18:00,24 hrs.,StockMarket,HAIN,48,48,0,48,1,17,10,1,NASDAQ
4262,09-02-2021 18:00,24 hrs.,StockMarket,HGSH,12,12,0,12,2,2,0,1,NASDAQ
4262,09-02-2021 18:00,24 hrs.,StockMarket,HTBX,309,309,0,309,2,113,75,2,NASDAQ
4262,09-02-2021 18:00,24 hrs.,StockMarket,ICLN,8,8,0,8,1,2,0,1,NASDAQ
4262,09-02-2021 18:00,24 hrs.,StockMarket,IDEX,8,8,0,8,1,1,2,1,NASDAQ
4262,09-02-2021 18:00,24 hrs.,StockMarket,IMMP,6,6,0,6,1,1,0,1,NASDAQ
4262,09-02-2021 18:00,24 hrs.,StockMarket,INPX,6,0,6,-6,1,1,0,1,NASDAQ
4262,09-02-2021 18:00,24 hrs.,StockMarket,ITRM,12,12,0,12,1,4,0,1,NASDAQ
4262,09-02-2021 18:00,24 hrs.,StockMarket,KALV,261,261,0,261,1,96,65,1,NASDAQ
4262,09-02-2021 18:00,24 hrs.,StockMarket,KERN,8,8,0,8,1,1,2,1,NASDAQ
4262,09-02-2021 18:00,24 hrs.,StockMarket,LIVE,66,66,0,66,2,21,16,2,NASDAQ
4262,09-02-2021 18:00,24 hrs.,StockMarket,LMFA,6,6,0,6,1,1,0,1,NASDAQ
4262,09-02-2021 18:00,24 hrs.,StockMarket,LUNG,6,6,0,6,1,1,0,1,NASDAQ
4262,09-02-2021 18:00,24 hrs.,StockMarket,LYFT,125,0,125,-125,1,50,21,1,NASDAQ
4262,09-02-2021 18:00,24 hrs.,StockMarket,MARA,153,28,125,-97,5,55,23,5,NASDAQ
4262,09-02-2021 18:00,24 hrs.,StockMarket,MOGO,6,6,0,6,1,1,0,1,NASDAQ
4262,09-02-2021 18:00,24 hrs.,StockMarket,MOSY,10,0,10,-10,1,3,0,1,NASDAQ
4262,09-02-2021 18:00,24 hrs.,StockMarket,MSFT,17,0,17,-17,1,5,3,1,NASDAQ
4262,09-02-2021 18:00,24 hrs.,StockMarket,MSTR,30,12,18,-6,3,8,2,3,NASDAQ
4262,09-02-2021 18:00,24 hrs.,StockMarket,MVIS,44,6,38,-32,3,15,2,3,NASDAQ
4262,09-02-2021 18:00,24 hrs.,StockMarket,NBA,48,48,0,48,1,17,10,1,AMEX
4262,09-02-2021 18:00,24 hrs.,StockMarket,ZOM,220,12,208,-196,5,86,28,5,AMEX
4262,09-02-2021 18:00,24 hrs.,StockMarket,AMPE,6,0,6,-6,1,1,0,1,AMEX
4262,09-02-2021 18:00,24 hrs.,StockMarket,MLSS,8,8,0,8,1,1,2,1,AMEX
4262,09-02-2021 18:00,24 hrs.,StockMarket,TRXC,6,6,0,6,1,0,2,1,AMEX
4262,09-02-2021 18:00,24 hrs.,StockMarket,ABC,125,0,125,-125,1,50,21,1,NYSE
4262,09-02-2021 18:00,24 hrs.,StockMarket,AMC,65,6,59,-53,4,5,39,4,NYSE
4262,09-02-2021 18:00,24 hrs.,StockMarket,CBD,141,129,12,117,4,44,37,4,NYSE
4262,09-02-2021 18:00,24 hrs.,StockMarket,CBO,48,48,0,48,1,17,10,1,NYSE
4262,09-02-2021 18:00,24 hrs.,StockMarket,CCL,76,0,76,-76,1,14,44,1,NYSE
4262,09-02-2021 18:00,24 hrs.,StockMarket,CLF,48,48,0,48,1,17,10,1,NYSE
4262,09-02-2021 18:00,24 hrs.,StockMarket,CNC,48,48,0,48,1,17,10,1,NYSE
4262,09-02-2021 18:00,24 hrs.,StockMarket,CVS,125,0,125,-125,1,50,21,1,NYSE
4262,09-02-2021 18:00,24 hrs.,StockMarket,DIS,493,368,125,243,2,212,61,2,NYSE
4262,09-02-2021 18:00,24 hrs.,StockMarket,DOW,22,22,0,22,1,7,4,1,NYSE
4262,09-02-2021 18:00,24 hrs.,StockMarket,EPC,48,48,0,48,1,17,10,1,NYSE
4262,09-02-2021 18:00,24 hrs.,StockMarket,FDX,12,12,0,12,1,4,0,1,NYSE
4262,09-02-2021 18:00,24 hrs.,StockMarket,FLT,6,6,0,6,1,1,0,1,NYSE
4262,09-02-2021 18:00,24 hrs.,StockMarket,GME,597,242,355,-113,21,190,133,21,NYSE
4262,09-02-2021 18:00,24 hrs.,StockMarket,HBI,48,48,0,48,1,17,10,1,NYSE
4262,09-02-2021 18:00,24 hrs.,StockMarket,IBM,30,0,30,-30,1,13,0,1,NYSE
4262,09-02-2021 18:00,24 hrs.,StockMarket,IRS,12,0,12,-12,1,0,8,1,NYSE
4262,09-02-2021 18:00,24 hrs.,StockMarket,JNJ,18,0,18,-18,1,6,2,1,NYSE
4262,09-02-2021 18:00,24 hrs.,StockMarket,LIN,125,0,125,-125,1,50,21,1,NYSE
4262,09-02-2021 18:00,24 hrs.,StockMarket,LLY,48,48,0,48,1,17,10,1,NYSE
4262,09-02-2021 18:00,24 hrs.,StockMarket,MGM,89,0,89,-89,1,33,19,1,NYSE
4262,09-02-2021 18:00,24 hrs.,StockMarket,NIO,42,8,34,-26,3,14,2,3,NYSE
4262,09-02-2021 18:00,24 hrs.,StockMarket,NOK,2591,6,2585,-2579,2,1227,129,2,NYSE
4262,09-02-2021 18:00,24 hrs.,StockMarket,RCL,76,0,76,-76,1,14,44,1,NYSE
4262,09-02-2021 18:00,24 hrs.,StockMarket,RKT,6,0,6,-6,1,1,0,1,NYSE
4262,09-02-2021 18:00,24 hrs.,StockMarket,SAM,125,0,125,-125,1,50,21,1,NYSE
4262,09-02-2021 18:00,24 hrs.,StockMarket,SMG,55,0,55,-55,1,19,13,1,NYSE
4262,09-02-2021 18:00,24 hrs.,StockMarket,SPG,48,48,0,48,1,17,10,1,NYSE
4262,09-02-2021 18:00,24 hrs.,StockMarket,SPH,12,12,0,12,1,3,2,1,NYSE
4262,09-02-2021 18:00,24 hrs.,StockMarket,TDA,13,0,13,-13,1,2,5,1,NYSE
4262,09-02-2021 18:00,24 hrs.,StockMarket,TMO,48,48,0,48,1,17,10,1,NYSE
4262,09-02-2021 18:00,24 hrs.,StockMarket,VGR,6,6,0,6,1,1,0,1,NYSE
4262,09-02-2021 18:00,24 hrs.,StockMarket,WTI,9,9,0,9,1,2,1,1,NYSE
4262,09-02-2021 18:00,24 hrs.,StockMarket,CARR,48,48,0,48,1,17,10,1,NYSE
4262,09-02-2021 18:00,24 hrs.,StockMarket,CCIV,20,6,14,-8,2,3,6,2,NYSE
4262,09-02-2021 18:00,24 hrs.,StockMarket,CHGG,54,48,6,42,2,18,10,2,NYSE
4262,09-02-2021 18:00,24 hrs.,StockMarket,COTY,48,48,0,48,1,17,10,1,NYSE
4262,09-02-2021 18:00,24 hrs.,StockMarket,DASH,125,0,125,-125,1,50,21,1,NYSE
4262,09-02-2021 18:00,24 hrs.,StockMarket,EXPR,12,12,0,12,2,2,0,2,NYSE
4262,09-02-2021 18:00,24 hrs.,StockMarket,PANW,125,0,125,-125,1,50,21,1,NYSE
4262,09-02-2021 18:00,24 hrs.,StockMarket,PLTR,6,0,6,-6,1,1,0,1,NYSE
4262,09-02-2021 18:00,24 hrs.,StockMarket,SPCE,6,6,0,6,1,1,0,1,NYSE
4262,09-02-2021 18:00,24 hrs.,StockMarket,TWTR,125,0,125,-125,1,50,21,1,NYSE
4262,09-02-2021 18:00,24 hrs.,StockMarket,UBER,125,0,125,-125,1,50,21,1,NYSE
4262,09-02-2021 18:00,24 hrs.,StockMarket,VGAC,6,0,6,-6,1,1,0,1,NYSE
4262,09-02-2021 18:00,24 hrs.,StockMarket,AAL,12,6,6,0,2,2,0,2,NASDAQ
4262,09-02-2021 18:00,24 hrs.,StockMarket,CDC,76,0,76,-76,1,14,44,1,NASDAQ
4262,09-02-2021 18:00,24 hrs.,StockMarket,CGC,48,48,0,48,1,17,10,1,NASDAQ
4262,09-02-2021 18:00,24 hrs.,StockMarket,DYN,6,6,0,6,1,1,0,1,NASDAQ
4262,09-02-2021 18:00,24 hrs.,StockMarket,GBT,6,6,0,6,1,1,0,1,NASDAQ
4262,09-02-2021 18:00,24 hrs.,StockMarket,III,123,123,0,123,1,41,37,1,NASDAQ
4262,09-02-2021 18:00,24 hrs.,StockMarket,OEG,8,8,0,8,1,1,2,1,NASDAQ
4262,09-02-2021 18:00,24 hrs.,StockMarket,QQQ,140,0,140,-140,2,53,26,2,NASDAQ
4262,09-02-2021 18:00,24 hrs.,StockMarket,SND,22,0,22,-22,1,5,8,1,NASDAQ
4262,09-02-2021 18:00,24 hrs.,StockMarket,TTD,12,12,0,12,2,2,0,1,NASDAQ
4262,09-02-2021 18:00,24 hrs.,StockMarket,VFF,55,0,55,-55,1,19,13,1,NASDAQ
4262,09-02-2021 18:00,24 hrs.,StockMarket,VPN,6,6,0,6,1,1,0,1,NASDAQ
4262,09-02-2021 18:00,24 hrs.,StockMarket,ABNB,125,0,125,-125,1,50,21,1,NASDAQ
4262,09-02-2021 18:00,24 hrs.,StockMarket,AEZS,6,6,0,6,1,1,0,1,NASDAQ
4262,09-02-2021 18:00,24 hrs.,Daytrading,TEDU,336,0,336,-336,1,138,56,1,NASDAQ
4262,09-02-2021 18:00,24 hrs.,Daytrading,THBR,6,6,0,6,1,1,0,1,NASDAQ
4262,09-02-2021 18:00,24 hrs.,Daytrading,TIGR,336,0,336,-336,1,138,56,1,NASDAQ
4262,09-02-2021 18:00,24 hrs.,Daytrading,TLRY,1165,829,336,493,3,497,159,3,NASDAQ
4262,09-02-2021 18:00,24 hrs.,Daytrading,TLSA,336,0,336,-336,1,138,56,1,NASDAQ
4262,09-02-2021 18:00,24 hrs.,Daytrading,TNXP,6,0,6,-6,1,1,0,1,NASDAQ
4262,09-02-2021 18:00,24 hrs.,Daytrading,TRCH,336,0,336,-336,1,138,56,1,NASDAQ
4262,09-02-2021 18:00,24 hrs.,Daytrading,TRVN,336,0,336,-336,1,138,56,1,NASDAQ
4262,09-02-2021 18:00,24 hrs.,Daytrading,TTOO,336,0,336,-336,1,138,56,1,NASDAQ
4262,09-02-2021 18:00,24 hrs.,Daytrading,TYME,1113,777,336,441,2,478,149,2,NASDAQ
4262,09-02-2021 18:00,24 hrs.,Daytrading,UONE,336,0,336,-336,1,138,56,1,NASDAQ
4262,09-02-2021 18:00,24 hrs.,Daytrading,UXIN,336,0,336,-336,1,138,56,1,NASDAQ
4262,09-02-2021 18:00,24 hrs.,Daytrading,VTVT,336,0,336,-336,1,138,56,1,NASDAQ
4262,09-02-2021 18:00,24 hrs.,Daytrading,VXRT,336,0,336,-336,1,138,56,1,NASDAQ
4262,09-02-2021 18:00,24 hrs.,Daytrading,WATT,336,0,336,-336,1,138,56,1,NASDAQ
4262,09-02-2021 18:00,24 hrs.,Daytrading,WIMI,336,0,336,-336,1,138,56,1,NASDAQ
4262,09-02-2021 18:00,24 hrs.,Daytrading,WKHS,777,777,0,777,1,340,93,1,NASDAQ
4262,09-02-2021 18:00,24 hrs.,Daytrading,YGMZ,336,0,336,-336,1,138,56,1,NASDAQ
4262,09-02-2021 18:00,24 hrs.,Daytrading,ZSAN,6,0,6,-6,1,1,0,1,NASDAQ
4262,09-02-2021 18:00,24 hrs.,Daytrading,UONEK,336,0,336,-336,1,138,56,1,NASDAQ
4262,09-02-2021 18:00,24 hrs.,StockMarket,ASTI,6,0,6,-6,1,1,0,1,OTC
4262,09-02-2021 18:00,24 hrs.,StockMarket,BLSP,24,0,24,-24,1,6,8,1,OTC
4262,09-02-2021 18:00,24 hrs.,StockMarket,CURR,6,6,0,6,1,1,0,1,OTC
4262,09-02-2021 18:00,24 hrs.,StockMarket,CWRK,4,4,0,4,1,0,0,1,OTC
4262,09-02-2021 18:00,24 hrs.,StockMarket,DROP,6,6,0,6,1,1,0,1,OTC
4262,09-02-2021 18:00,24 hrs.,StockMarket,ENZC,6,6,0,6,1,1,0,1,OTC
4262,09-02-2021 18:00,24 hrs.,StockMarket,GTEH,6,6,0,6,1,1,0,1,OTC
4262,09-02-2021 18:00,24 hrs.,StockMarket,HCMC,89,0,89,-89,4,34,5,4,OTC
4262,09-02-2021 18:00,24 hrs.,StockMarket,HEMP,30,6,24,-18,5,5,0,4,OTC
4262,09-02-2021 18:00,24 hrs.,StockMarket,HQGE,6,6,0,6,1,1,0,1,OTC
4262,09-02-2021 18:00,24 hrs.,StockMarket,IPIX,12,12,0,12,2,2,0,1,OTC
4262,09-02-2021 18:00,24 hrs.,StockMarket,ISWH,12,12,0,12,2,2,0,2,OTC
4262,09-02-2021 18:00,24 hrs.,StockMarket,LINK,62,56,6,50,3,20,10,3,OTC
4262,09-02-2021 18:00,24 hrs.,StockMarket,MEDH,6,6,0,6,1,1,0,1,OTC
4262,09-02-2021 18:00,24 hrs.,StockMarket,MINE,12,0,12,-12,2,2,0,1,OTC
4262,09-02-2021 18:00,24 hrs.,StockMarket,MJNA,136,136,0,136,2,43,42,2,OTC
4262,09-02-2021 18:00,24 hrs.,StockMarket,MOST,48,48,0,48,1,17,10,1,OTC
4262,09-02-2021 18:00,24 hrs.,StockMarket,PSYC,6,6,0,6,1,1,0,1,OTC
4262,09-02-2021 18:00,24 hrs.,StockMarket,RTON,6,6,0,6,1,1,0,1,OTC
4262,09-02-2021 18:00,24 hrs.,StockMarket,SNPW,11,11,0,11,1,2,3,1,OTC
4262,09-02-2021 18:00,24 hrs.,StockMarket,TSNP,6,6,0,6,1,1,0,1,OTC
4262,09-02-2021 18:00,24 hrs.,StockMarket,VPER,6,0,6,-6,1,1,0,1,OTC
4262,09-02-2021 18:00,24 hrs.,StockMarket,VPOR,6,0,6,-6,1,1,0,1,OTC
4262,09-02-2021 18:00,24 hrs.,StockMarket,VSPC,6,0,6,-6,1,1,0,1,OTC
4262,09-02-2021 18:00,24 hrs.,StockMarket,YAYO,6,0,6,-6,1,1,0,1,OTC
4262,09-02-2021 18:00,24 hrs.,StockMarket,AYRWF,55,0,55,-55,1,19,13,1,OTC
4262,09-02-2021 18:00,24 hrs.,StockMarket,BMWLF,55,0,55,-55,1,19,13,1,OTC
4262,09-02-2021 18:00,24 hrs.,StockMarket,CRLBF,55,0,55,-55,1,19,13,1,OTC
4262,09-02-2021 18:00,24 hrs.,StockMarket,CURLF,55,0,55,-55,1,19,13,1,OTC
4262,09-02-2021 18:00,24 hrs.,StockMarket,GTBIF,55,0,55,-55,1,19,13,1,OTC
4262,09-02-2021 18:00,24 hrs.,StockMarket,HITIF,151,0,151,-151,1,51,45,1,OTC
4262,09-02-2021 18:00,24 hrs.,StockMarket,HVBTF,6,6,0,6,1,1,0,1,OTC
4262,09-02-2021 18:00,24 hrs.,StockMarket,LHSIF,55,0,55,-55,1,19,13,1,OTC
4262,09-02-2021 18:00,24 hrs.,StockMarket,MMNFF,22,22,0,22,1,4,10,1,OTC
4262,09-02-2021 18:00,24 hrs.,StockMarket,NQMLF,10,0,10,-10,1,3,0,1,OTC
4262,09-02-2021 18:00,24 hrs.,StockMarket,PKLBF,6,6,0,6,1,1,0,1,OTC
4262,09-02-2021 18:00,24 hrs.,StockMarket,REGRF,6,6,0,6,1,1,0,1,OTC
4262,09-02-2021 18:00,24 hrs.,StockMarket,RWBYF,55,0,55,-55,1,19,13,1,OTC
4262,09-02-2021 18:00,24 hrs.,StockMarket,SFTBY,125,0,125,-125,1,50,21,1,OTC
4262,09-02-2021 18:00,24 hrs.,StockMarket,TCNNF,55,0,55,-55,1,19,13,1,OTC
4262,09-02-2021 18:00,24 hrs.,StockMarket,ACY,6,6,0,6,1,1,0,1,AMEX
4262,09-02-2021 18:00,24 hrs.,StockMarket,CVM,6,6,0,6,1,1,0,1,AMEX
4262,09-02-2021 18:00,24 hrs.,StockMarket,DPW,6,6,0,6,1,1,0,1,AMEX
4262,09-02-2021 18:00,24 hrs.,StockMarket,GTE,6,0,6,-6,1,1,0,1,AMEX
4262,09-02-2021 18:00,24 hrs.,Daytrading,GMDA,336,0,336,-336,1,138,56,1,NASDAQ
4262,09-02-2021 18:00,24 hrs.,Daytrading,HGEN,336,0,336,-336,1,138,56,1,NASDAQ
4262,09-02-2021 18:00,24 hrs.,Daytrading,HGSH,336,0,336,-336,1,138,56,1,NASDAQ
4262,09-02-2021 18:00,24 hrs.,Daytrading,HSTO,49,0,49,-49,2,15,11,2,NASDAQ
4262,09-02-2021 18:00,24 hrs.,Daytrading,HTBX,829,829,0,829,2,359,103,2,NASDAQ
4262,09-02-2021 18:00,24 hrs.,Daytrading,IDEX,336,0,336,-336,1,138,56,1,NASDAQ
4262,09-02-2021 18:00,24 hrs.,Daytrading,IMNM,336,0,336,-336,1,138,56,1,NASDAQ
4262,09-02-2021 18:00,24 hrs.,Daytrading,IMTE,336,0,336,-336,1,138,56,1,NASDAQ
4262,09-02-2021 18:00,24 hrs.,Daytrading,IPDN,336,0,336,-336,1,138,56,1,NASDAQ
4262,09-02-2021 18:00,24 hrs.,Daytrading,ITRM,1174,838,336,502,4,499,160,4,NASDAQ
4262,09-02-2021 18:00,24 hrs.,Daytrading,IZEA,336,0,336,-336,1,138,56,1,NASDAQ
4262,09-02-2021 18:00,24 hrs.,Daytrading,JFIN,336,0,336,-336,1,138,56,1,NASDAQ
4262,09-02-2021 18:00,24 hrs.,Daytrading,JRJC,336,0,336,-336,1,138,56,1,NASDAQ
4262,09-02-2021 18:00,24 hrs.,Daytrading,KALV,777,777,0,777,1,340,93,1,NASDAQ
4262,09-02-2021 18:00,24 hrs.,Daytrading,KERN,336,0,336,-336,1,138,56,1,NASDAQ
4262,09-02-2021 18:00,24 hrs.,Daytrading,KOSS,6,6,0,6,1,1,0,1,NASDAQ
4262,09-02-2021 18:00,24 hrs.,Daytrading,KXIN,336,0,336,-336,1,138,56,1,NASDAQ
4262,09-02-2021 18:00,24 hrs.,Daytrading,LMFA,336,0,336,-336,1,138,56,1,NASDAQ
4262,09-02-2021 18:00,24 hrs.,Daytrading,LMNL,336,0,336,-336,1,138,56,1,NASDAQ
4262,09-02-2021 18:00,24 hrs.,Daytrading,LXEH,336,0,336,-336,1,138,56,1,NASDAQ
4262,09-02-2021 18:00,24 hrs.,Daytrading,MARA,1113,777,336,441,2,478,149,2,NASDAQ
4262,09-02-2021 18:00,24 hrs.,Daytrading,MBRX,336,0,336,-336,1,138,56,1,NASDAQ
4262,09-02-2021 18:00,24 hrs.,Daytrading,MDVL,777,777,0,777,1,340,93,1,NASDAQ
4262,09-02-2021 18:00,24 hrs.,Daytrading,MGNI,777,777,0,777,1,340,93,1,NASDAQ
4262,09-02-2021 18:00,24 hrs.,Daytrading,MMLP,6,6,0,6,1,1,0,1,NASDAQ
4262,09-02-2021 18:00,24 hrs.,Daytrading,MOGO,336,0,336,-336,1,138,56,1,NASDAQ
4262,09-02-2021 18:00,24 hrs.,Daytrading,MOXC,336,0,336,-336,1,138,56,1,NASDAQ
4262,09-02-2021 18:00,24 hrs.,Daytrading,NAKD,33,33,0,33,1,14,1,1,NASDAQ
4262,09-02-2021 18:00,24 hrs.,Daytrading,NCTY,336,0,336,-336,1,138,56,1,NASDAQ
4262,09-02-2021 18:00,24 hrs.,Daytrading,NKTX,336,0,336,-336,1,138,56,1,NASDAQ
4262,09-02-2021 18:00,24 hrs.,Daytrading,NXTD,336,0,336,-336,1,138,56,1,NASDAQ
4262,09-02-2021 18:00,24 hrs.,Daytrading,OCGN,1323,829,494,335,7,544,207,6,NASDAQ
4262,09-02-2021 18:00,24 hrs.,Daytrading,OPGN,336,0,336,-336,1,138,56,1,NASDAQ
4262,09-02-2021 18:00,24 hrs.,Daytrading,OPTT,336,0,336,-336,1,138,56,1,NASDAQ
4262,09-02-2021 18:00,24 hrs.,Daytrading,ORIC,336,0,336,-336,1,138,56,1,NASDAQ
4262,09-02-2021 18:00,24 hrs.,Daytrading,ORTX,777,777,0,777,1,340,93,1,NASDAQ
4262,09-02-2021 18:00,24 hrs.,Daytrading,OTLK,6,6,0,6,1,1,0,1,NASDAQ
4262,09-02-2021 18:00,24 hrs.,Daytrading,PACB,108,108,0,108,1,45,14,1,NASDAQ
4262,09-02-2021 18:00,24 hrs.,Daytrading,PECK,336,0,336,-336,1,138,56,1,NASDAQ
4262,09-02-2021 18:00,24 hrs.,Daytrading,PEIX,336,0,336,-336,1,138,56,1,NASDAQ
4262,09-02-2021 18:00,24 hrs.,Daytrading,PERI,777,777,0,777,1,340,93,1,NASDAQ
4262,09-02-2021 18:00,24 hrs.,Daytrading,PETZ,336,0,336,-336,1,138,56,1,NASDAQ
4262,09-02-2021 18:00,24 hrs.,Daytrading,PHUN,336,0,336,-336,1,138,56,1,NASDAQ
4262,09-02-2021 18:00,24 hrs.,Daytrading,PLIN,336,0,336,-336,1,138,56,1,NASDAQ
4262,09-02-2021 18:00,24 hrs.,Daytrading,PLRX,336,0,336,-336,1,138,56,1,NASDAQ
4262,09-02-2021 18:00,24 hrs.,Daytrading,PLUG,336,0,336,-336,1,138,56,1,NASDAQ
4262,09-02-2021 18:00,24 hrs.,Daytrading,PLUS,336,0,336,-336,1,138,56,1,NASDAQ
4262,09-02-2021 18:00,24 hrs.,Daytrading,PRTA,336,0,336,-336,1,138,56,1,NASDAQ
4262,09-02-2021 18:00,24 hrs.,Daytrading,PSHG,336,0,336,-336,1,138,56,1,NASDAQ
4262,09-02-2021 18:00,24 hrs.,Daytrading,RCON,336,0,336,-336,1,138,56,1,NASDAQ
4262,09-02-2021 18:00,24 hrs.,Daytrading,REGI,336,0,336,-336,1,138,56,1,NASDAQ
4262,09-02-2021 18:00,24 hrs.,Daytrading,RIOT,1113,777,336,441,2,478,149,2,NASDAQ
4262,09-02-2021 18:00,24 hrs.,Daytrading,SALM,336,0,336,-336,1,138,56,1,NASDAQ
4262,09-02-2021 18:00,24 hrs.,Daytrading,SAVA,336,0,336,-336,1,138,56,1,NASDAQ
4262,09-02-2021 18:00,24 hrs.,Daytrading,SBBP,336,0,336,-336,1,138,56,1,NASDAQ
4262,09-02-2021 18:00,24 hrs.,Daytrading,SEED,336,0,336,-336,1,138,56,1,NASDAQ
4262,09-02-2021 18:00,24 hrs.,Daytrading,SHIP,336,0,336,-336,1,138,56,1,NASDAQ
4262,09-02-2021 18:00,24 hrs.,Daytrading,SNDL,336,0,336,-336,1,138,56,1,NASDAQ
4262,09-02-2021 18:00,24 hrs.,Daytrading,SOLO,336,0,336,-336,1,138,56,1,NASDAQ
4262,09-02-2021 18:00,24 hrs.,Daytrading,SUNW,336,0,336,-336,1,138,56,1,NASDAQ
4262,09-02-2021 18:00,24 hrs.,Daytrading,SXTC,336,0,336,-336,1,138,56,1,NASDAQ
4262,09-02-2021 18:00,24 hrs.,Daytrading,SYPR,336,0,336,-336,1,138,56,1,NASDAQ
4262,09-02-2021 18:00,24 hrs.,Daytrading,TANH,336,0,336,-336,1,138,56,1,NASDAQ
4262,09-02-2021 18:00,24 hrs.,Daytrading,TAOP,336,0,336,-336,1,138,56,1,NASDAQ
4262,09-02-2021 18:00,24 hrs.,Daytrading,API,8,0,8,-8,1,2,0,1,NASDAQ
4262,09-02-2021 18:00,24 hrs.,Daytrading,CGC,1113,777,336,441,2,478,149,2,NASDAQ
4262,09-02-2021 18:00,24 hrs.,Daytrading,ENG,336,0,336,-336,1,138,56,1,NASDAQ
4262,09-02-2021 18:00,24 hrs.,Daytrading,EVK,336,0,336,-336,1,138,56,1,NASDAQ
4262,09-02-2021 18:00,24 hrs.,Daytrading,MGI,336,0,336,-336,1,138,56,1,NASDAQ
4262,09-02-2021 18:00,24 hrs.,Daytrading,OCG,336,0,336,-336,1,138,56,1,NASDAQ
4262,09-02-2021 18:00,24 hrs.,Daytrading,OEG,336,0,336,-336,1,138,56,1,NASDAQ
4262,09-02-2021 18:00,24 hrs.,Daytrading,OGI,342,6,336,-330,2,139,56,2,NASDAQ
4262,09-02-2021 18:00,24 hrs.,Daytrading,QQQ,108,108,0,108,1,45,14,1,NASDAQ
4262,09-02-2021 18:00,24 hrs.,Daytrading,QTT,336,0,336,-336,1,138,56,1,NASDAQ
4262,09-02-2021 18:00,24 hrs.,Daytrading,SIC,336,0,336,-336,1,138,56,1,NASDAQ
4262,09-02-2021 18:00,24 hrs.,Daytrading,SLS,336,0,336,-336,1,138,56,1,NASDAQ
4262,09-02-2021 18:00,24 hrs.,Daytrading,SPI,336,0,336,-336,1,138,56,1,NASDAQ
4262,09-02-2021 18:00,24 hrs.,Daytrading,WWR,336,0,336,-336,1,138,56,1,NASDAQ
4262,09-02-2021 18:00,24 hrs.,Daytrading,ADIL,336,0,336,-336,1,138,56,1,NASDAQ
4262,09-02-2021 18:00,24 hrs.,Daytrading,ADMP,336,0,336,-336,1,138,56,1,NASDAQ
4262,09-02-2021 18:00,24 hrs.,Daytrading,ADMS,336,0,336,-336,1,138,56,1,NASDAQ
4262,09-02-2021 18:00,24 hrs.,Daytrading,AEZS,336,0,336,-336,1,138,56,1,NASDAQ
4262,09-02-2021 18:00,24 hrs.,Daytrading,AGEN,336,0,336,-336,1,138,56,1,NASDAQ
4262,09-02-2021 18:00,24 hrs.,Daytrading,AIHS,336,0,336,-336,1,138,56,1,NASDAQ
4262,09-02-2021 18:00,24 hrs.,Daytrading,AKER,336,0,336,-336,1,138,56,1,NASDAQ
4262,09-02-2021 18:00,24 hrs.,Daytrading,ALAC,336,0,336,-336,1,138,56,1,NASDAQ
4262,09-02-2021 18:00,24 hrs.,Daytrading,ALVR,336,0,336,-336,1,138,56,1,NASDAQ
4262,09-02-2021 18:00,24 hrs.,Daytrading,AMTX,336,0,336,-336,1,138,56,1,NASDAQ
4262,09-02-2021 18:00,24 hrs.,Daytrading,APHA,1113,777,336,441,2,478,149,2,NASDAQ
4262,09-02-2021 18:00,24 hrs.,Daytrading,APPS,6,0,6,-6,1,1,0,1,NASDAQ
4262,09-02-2021 18:00,24 hrs.,Daytrading,APTX,336,0,336,-336,1,138,56,1,NASDAQ
4262,09-02-2021 18:00,24 hrs.,Daytrading,AQMS,336,0,336,-336,1,138,56,1,NASDAQ
4262,09-02-2021 18:00,24 hrs.,Daytrading,ARTL,336,0,336,-336,1,138,56,1,NASDAQ
4262,09-02-2021 18:00,24 hrs.,Daytrading,ATHE,336,0,336,-336,1,138,56,1,NASDAQ
4262,09-02-2021 18:00,24 hrs.,Daytrading,ATIF,336,0,336,-336,1,138,56,1,NASDAQ
4262,09-02-2021 18:00,24 hrs.,Daytrading,ATOS,336,0,336,-336,1,138,56,1,NASDAQ
4262,09-02-2021 18:00,24 hrs.,Daytrading,AUVI,818,818,0,818,3,350,106,3,NASDAQ
4262,09-02-2021 18:00,24 hrs.,Daytrading,AZRX,336,0,336,-336,1,138,56,1,NASDAQ
4262,09-02-2021 18:00,24 hrs.,Daytrading,BHAT,336,0,336,-336,1,138,56,1,NASDAQ
4262,09-02-2021 18:00,24 hrs.,Daytrading,BRQS,336,0,336,-336,1,138,56,1,NASDAQ
4262,09-02-2021 18:00,24 hrs.,Daytrading,BSQR,777,777,0,777,1,340,93,1,NASDAQ
4262,09-02-2021 18:00,24 hrs.,Daytrading,BWAC,336,0,336,-336,1,138,56,1,NASDAQ
4262,09-02-2021 18:00,24 hrs.,Daytrading,BYFC,336,0,336,-336,1,138,56,1,NASDAQ
4262,09-02-2021 18:00,24 hrs.,Daytrading,CAAS,336,0,336,-336,1,138,56,1,NASDAQ
4262,09-02-2021 18:00,24 hrs.,Daytrading,CARV,336,0,336,-336,1,138,56,1,NASDAQ
4262,09-02-2021 18:00,24 hrs.,Daytrading,CBAT,336,0,336,-336,1,138,56,1,NASDAQ
4262,09-02-2021 18:00,24 hrs.,Daytrading,CCNC,336,0,336,-336,1,138,56,1,NASDAQ
4262,09-02-2021 18:00,24 hrs.,Daytrading,CETX,336,0,336,-336,1,138,56,1,NASDAQ
4262,09-02-2021 18:00,24 hrs.,Daytrading,CHCI,1113,777,336,441,2,478,149,2,NASDAQ
4262,09-02-2021 18:00,24 hrs.,Daytrading,CHEK,777,777,0,777,1,340,93,1,NASDAQ
4262,09-02-2021 18:00,24 hrs.,Daytrading,CLEU,336,0,336,-336,1,138,56,1,NASDAQ
4262,09-02-2021 18:00,24 hrs.,Daytrading,CLSK,336,0,336,-336,1,138,56,1,NASDAQ
4262,09-02-2021 18:00,24 hrs.,Daytrading,CNSP,336,0,336,-336,1,138,56,1,NASDAQ
4262,09-02-2021 18:00,24 hrs.,Daytrading,CRBP,336,0,336,-336,1,138,56,1,NASDAQ
4262,09-02-2021 18:00,24 hrs.,Daytrading,CRON,336,0,336,-336,1,138,56,1,NASDAQ
4262,09-02-2021 18:00,24 hrs.,Daytrading,CRSP,108,108,0,108,1,45,14,1,NASDAQ
4262,09-02-2021 18:00,24 hrs.,Daytrading,CRSR,777,777,0,777,1,340,93,1,NASDAQ
4262,09-02-2021 18:00,24 hrs.,Daytrading,CTRM,336,0,336,-336,1,138,56,1,NASDAQ
4262,09-02-2021 18:00,24 hrs.,Daytrading,CYTH,777,777,0,777,1,340,93,1,NASDAQ
4262,09-02-2021 18:00,24 hrs.,Daytrading,DENN,6,0,6,-6,1,1,0,1,NASDAQ
4262,09-02-2021 18:00,24 hrs.,Daytrading,EBON,336,0,336,-336,1,138,56,1,NASDAQ
4262,09-02-2021 18:00,24 hrs.,Daytrading,EKSO,777,777,0,777,1,340,93,1,NASDAQ
4262,09-02-2021 18:00,24 hrs.,Daytrading,ELYS,336,0,336,-336,1,138,56,1,NASDAQ
4262,09-02-2021 18:00,24 hrs.,Daytrading,EQOS,336,0,336,-336,1,138,56,1,NASDAQ
4262,09-02-2021 18:00,24 hrs.,Daytrading,EVGN,108,108,0,108,1,45,14,1,NASDAQ
4262,09-02-2021 18:00,24 hrs.,Daytrading,FCEL,336,0,336,-336,1,138,56,1,NASDAQ
4262,09-02-2021 18:00,24 hrs.,Daytrading,GEVO,336,0,336,-336,1,138,56,1,NASDAQ
4262,09-02-2021 18:00,24 hrs.,Daytrading,GLUU,1165,829,336,493,3,497,159,3,NASDAQ
4262,09-02-2021 18:00,24 hrs.,stocks,TSLA,210,0,210,-210,4,43,108,4,NASDAQ
4262,09-02-2021 18:00,24 hrs.,stocks,TTCF,13,0,13,-13,1,1,7,1,NASDAQ
4262,09-02-2021 18:00,24 hrs.,stocks,TTWO,23,23,0,23,1,6,7,1,NASDAQ
4262,09-02-2021 18:00,24 hrs.,stocks,TXMD,6,6,0,6,1,1,0,1,NASDAQ
4262,09-02-2021 18:00,24 hrs.,stocks,UONE,6,6,0,6,1,1,0,1,NASDAQ
4262,09-02-2021 18:00,24 hrs.,stocks,VISL,7,7,0,7,1,1,1,1,NASDAQ
4262,09-02-2021 18:00,24 hrs.,stocks,VIVE,6,6,0,6,1,1,0,1,NASDAQ
4262,09-02-2021 18:00,24 hrs.,stocks,VXRT,6,0,6,-6,1,1,0,1,NASDAQ
4262,09-02-2021 18:00,24 hrs.,stocks,WYNN,15,15,0,15,1,2,7,1,NASDAQ
4262,09-02-2021 18:00,24 hrs.,stocks,ZSAN,245,95,150,-55,5,83,59,4,NASDAQ
4262,09-02-2021 18:00,24 hrs.,stocks,CMCSA,6,6,0,6,1,1,0,1,NASDAQ
4262,09-02-2021 18:00,24 hrs.,Daytrading,HCMC,6,6,0,6,1,1,0,1,OTC
4262,09-02-2021 18:00,24 hrs.,Daytrading,IPIX,6,6,0,6,1,1,0,1,OTC
4262,09-02-2021 18:00,24 hrs.,Daytrading,PURA,6,0,6,-6,1,1,0,1,OTC
4262,09-02-2021 18:00,24 hrs.,Daytrading,RELI,7,0,7,-7,1,1,1,1,OTC
4262,09-02-2021 18:00,24 hrs.,Daytrading,RMRK,6,6,0,6,1,1,0,1,OTC
4262,09-02-2021 18:00,24 hrs.,Daytrading,SIGN,18,18,0,18,1,6,2,1,OTC
4262,09-02-2021 18:00,24 hrs.,Daytrading,SNPW,14,14,0,14,1,4,2,1,OTC
4262,09-02-2021 18:00,24 hrs.,Daytrading,MNKKQ,6,0,6,-6,1,1,0,1,OTC
4262,09-02-2021 18:00,24 hrs.,Daytrading,DLA,336,0,336,-336,1,138,56,1,AMEX
4262,09-02-2021 18:00,24 hrs.,Daytrading,DNN,336,0,336,-336,1,138,56,1,AMEX
4262,09-02-2021 18:00,24 hrs.,Daytrading,DPW,336,0,336,-336,1,138,56,1,AMEX
4262,09-02-2021 18:00,24 hrs.,Daytrading,DSS,336,0,336,-336,1,138,56,1,AMEX
4262,09-02-2021 18:00,24 hrs.,Daytrading,KIQ,1113,777,336,441,2,478,149,2,AMEX
4262,09-02-2021 18:00,24 hrs.,Daytrading,TRX,336,0,336,-336,1,138,56,1,AMEX
4262,09-02-2021 18:00,24 hrs.,Daytrading,UEC,336,0,336,-336,1,138,56,1,AMEX
4262,09-02-2021 18:00,24 hrs.,Daytrading,URG,336,0,336,-336,1,138,56,1,AMEX
4262,09-02-2021 18:00,24 hrs.,Daytrading,ZOM,22,22,0,22,2,4,6,2,AMEX
4262,09-02-2021 18:00,24 hrs.,Daytrading,ANVS,336,0,336,-336,1,138,56,1,AMEX
4262,09-02-2021 18:00,24 hrs.,Daytrading,CRMD,336,0,336,-336,1,138,56,1,AMEX
4262,09-02-2021 18:00,24 hrs.,Daytrading,PLAG,336,0,336,-336,1,138,56,1,AMEX
4262,09-02-2021 18:00,24 hrs.,Daytrading,TKAT,336,0,336,-336,1,138,56,1,AMEX
4262,09-02-2021 18:00,24 hrs.,Daytrading,UUUU,336,0,336,-336,1,138,56,1,AMEX
4262,09-02-2021 18:00,24 hrs.,Daytrading,ACB,1119,777,342,435,3,479,149,3,NYSE
4262,09-02-2021 18:00,24 hrs.,Daytrading,AMC,6,0,6,-6,1,1,0,1,NYSE
4262,09-02-2021 18:00,24 hrs.,Daytrading,ATH,885,885,0,885,2,385,107,2,NYSE
4262,09-02-2021 18:00,24 hrs.,Daytrading,BIO,108,108,0,108,1,45,14,1,NYSE
4262,09-02-2021 18:00,24 hrs.,Daytrading,CCM,336,0,336,-336,1,138,56,1,NYSE
4262,09-02-2021 18:00,24 hrs.,Daytrading,CLF,777,777,0,777,1,340,93,1,NYSE
4262,09-02-2021 18:00,24 hrs.,Daytrading,CTK,336,0,336,-336,1,138,56,1,NYSE
4262,09-02-2021 18:00,24 hrs.,Daytrading,DHF,6,6,0,6,1,1,0,1,NYSE
4262,09-02-2021 18:00,24 hrs.,Daytrading,ETN,6,0,6,-6,1,1,0,1,NYSE
4262,09-02-2021 18:00,24 hrs.,Daytrading,GME,816,777,39,738,2,340,128,2,NYSE
4262,09-02-2021 18:00,24 hrs.,Daytrading,GSX,336,0,336,-336,1,138,56,1,NYSE
4262,09-02-2021 18:00,24 hrs.,Daytrading,HOG,336,0,336,-336,1,138,56,1,NYSE
4262,09-02-2021 18:00,24 hrs.,Daytrading,IPI,12,12,0,12,1,2,4,1,NYSE
4262,09-02-2021 18:00,24 hrs.,Daytrading,NIO,108,108,0,108,1,45,14,1,NYSE
4262,09-02-2021 18:00,24 hrs.,Daytrading,NKE,18,18,0,18,1,6,2,1,NYSE
4262,09-02-2021 18:00,24 hrs.,Daytrading,NOK,12,12,0,12,1,2,4,1,NYSE
4262,09-02-2021 18:00,24 hrs.,Daytrading,REX,336,0,336,-336,1,138,56,1,NYSE
4262,09-02-2021 18:00,24 hrs.,Daytrading,RMO,444,108,336,-228,2,183,70,2,NYSE
4262,09-02-2021 18:00,24 hrs.,Daytrading,SOS,1113,777,336,441,2,478,149,2,NYSE
4262,09-02-2021 18:00,24 hrs.,Daytrading,TAL,336,0,336,-336,1,138,56,1,NYSE
4262,09-02-2021 18:00,24 hrs.,Daytrading,TDA,8,0,8,-8,1,2,0,1,NYSE
4262,09-02-2021 18:00,24 hrs.,Daytrading,TTM,336,0,336,-336,1,138,56,1,NYSE
4262,09-02-2021 18:00,24 hrs.,Daytrading,WEI,336,0,336,-336,1,138,56,1,NYSE
4262,09-02-2021 18:00,24 hrs.,Daytrading,BABA,342,6,336,-330,2,139,56,2,NYSE
4262,09-02-2021 18:00,24 hrs.,Daytrading,CMCM,336,0,336,-336,1,138,56,1,NYSE
4262,09-02-2021 18:00,24 hrs.,Daytrading,EARN,6,6,0,6,1,1,0,1,NYSE
4262,09-02-2021 18:00,24 hrs.,Daytrading,HEXO,336,0,336,-336,1,138,56,1,NYSE
4262,09-02-2021 18:00,24 hrs.,Daytrading,LAIX,336,0,336,-336,1,138,56,1,NYSE
4262,09-02-2021 18:00,24 hrs.,Daytrading,SKLZ,6,6,0,6,1,1,0,1,NYSE
4262,09-02-2021 18:00,24 hrs.,Daytrading,SPCE,108,108,0,108,1,45,14,1,NYSE
4262,09-02-2021 18:00,24 hrs.,Daytrading,AIH,336,0,336,-336,1,138,56,1,NASDAQ
4262,09-02-2021 18:00,24 hrs.,stocks,GLUU,72,48,24,24,6,14,20,5,NASDAQ
4262,09-02-2021 18:00,24 hrs.,stocks,GMBL,18,6,12,-6,3,3,0,2,NASDAQ
4262,09-02-2021 18:00,24 hrs.,stocks,GNUS,24,6,18,-12,4,4,0,2,NASDAQ
4262,09-02-2021 18:00,24 hrs.,stocks,GOEV,13,0,13,-13,1,1,7,1,NASDAQ
4262,09-02-2021 18:00,24 hrs.,stocks,GOOG,436,0,436,-436,1,190,52,1,NASDAQ
4262,09-02-2021 18:00,24 hrs.,stocks,GTHX,27,27,0,27,1,9,5,1,NASDAQ
4262,09-02-2021 18:00,24 hrs.,stocks,GWPH,22,0,22,-22,2,4,6,2,NASDAQ
4262,09-02-2021 18:00,24 hrs.,stocks,HAIN,23,23,0,23,1,6,7,1,NASDAQ
4262,09-02-2021 18:00,24 hrs.,stocks,HERO,37,0,37,-37,1,11,11,1,NASDAQ
4262,09-02-2021 18:00,24 hrs.,stocks,HTBX,6,6,0,6,1,1,0,1,NASDAQ
4262,09-02-2021 18:00,24 hrs.,stocks,ICLN,136,74,62,12,6,29,54,6,NASDAQ
4262,09-02-2021 18:00,24 hrs.,stocks,IMMP,6,6,0,6,1,1,0,1,NASDAQ
4262,09-02-2021 18:00,24 hrs.,stocks,INTC,27,27,0,27,1,9,5,1,NASDAQ
4262,09-02-2021 18:00,24 hrs.,stocks,ITRM,12,6,6,0,2,2,0,2,NASDAQ
4262,09-02-2021 18:00,24 hrs.,stocks,JAZZ,12,0,12,-12,1,3,2,1,NASDAQ
4262,09-02-2021 18:00,24 hrs.,stocks,KALV,13,13,0,13,2,2,1,2,NASDAQ
4262,09-02-2021 18:00,24 hrs.,stocks,KOPN,166,0,166,-166,1,64,34,1,NASDAQ
4262,09-02-2021 18:00,24 hrs.,stocks,KXIN,6,6,0,6,1,1,0,1,NASDAQ
4262,09-02-2021 18:00,24 hrs.,stocks,LEGN,16,16,0,16,1,6,0,1,NASDAQ
4262,09-02-2021 18:00,24 hrs.,stocks,LIVE,29,23,6,17,2,7,7,2,NASDAQ
4262,09-02-2021 18:00,24 hrs.,stocks,LULU,19,19,0,19,1,6,3,1,NASDAQ
4262,09-02-2021 18:00,24 hrs.,stocks,MARA,36,30,6,24,6,6,0,5,NASDAQ
4262,09-02-2021 18:00,24 hrs.,stocks,MAXN,7,7,0,7,1,0,3,1,NASDAQ
4262,09-02-2021 18:00,24 hrs.,stocks,MEIP,6,0,6,-6,1,1,0,1,NASDAQ
4262,09-02-2021 18:00,24 hrs.,stocks,MGNI,86,0,86,-86,1,18,46,1,NASDAQ
4262,09-02-2021 18:00,24 hrs.,stocks,MNKD,6,6,0,6,1,1,0,1,NASDAQ
4262,09-02-2021 18:00,24 hrs.,stocks,MOGO,18,18,0,18,3,3,0,3,NASDAQ
4262,09-02-2021 18:00,24 hrs.,stocks,MRNA,7,0,7,-7,1,1,1,1,NASDAQ
4262,09-02-2021 18:00,24 hrs.,stocks,MSFT,82,82,0,82,2,22,30,2,NASDAQ
4262,09-02-2021 18:00,24 hrs.,stocks,MVIS,18,0,18,-18,3,3,0,3,NASDAQ
4262,09-02-2021 18:00,24 hrs.,stocks,NAKD,40,0,40,-40,1,3,30,1,NASDAQ
4262,09-02-2021 18:00,24 hrs.,stocks,NMTR,12,0,12,-12,2,2,0,1,NASDAQ
4262,09-02-2021 18:00,24 hrs.,stocks,NNDM,6,6,0,6,1,1,0,1,NASDAQ
4262,09-02-2021 18:00,24 hrs.,stocks,NOVN,6,0,6,-6,1,1,0,1,NASDAQ
4262,09-02-2021 18:00,24 hrs.,stocks,NYMT,8,8,0,8,1,2,0,1,NASDAQ
4262,09-02-2021 18:00,24 hrs.,stocks,OBLN,6,6,0,6,1,1,0,1,NASDAQ
4262,09-02-2021 18:00,24 hrs.,stocks,OCGN,80,12,68,-56,13,13,2,10,NASDAQ
4262,09-02-2021 18:00,24 hrs.,stocks,OLED,6,0,6,-6,1,1,0,1,NASDAQ
4262,09-02-2021 18:00,24 hrs.,stocks,OVID,6,6,0,6,1,1,0,1,NASDAQ
4262,09-02-2021 18:00,24 hrs.,stocks,PAVM,28,0,28,-28,1,10,4,1,NASDAQ
4262,09-02-2021 18:00,24 hrs.,stocks,PAYA,27,12,15,-3,2,6,7,2,NASDAQ
4262,09-02-2021 18:00,24 hrs.,stocks,PENN,501,0,501,-501,2,201,91,2,NASDAQ
4262,09-02-2021 18:00,24 hrs.,stocks,PERI,86,0,86,-86,1,18,46,1,NASDAQ
4262,09-02-2021 18:00,24 hrs.,stocks,POAI,6,0,6,-6,1,1,0,1,NASDAQ
4262,09-02-2021 18:00,24 hrs.,stocks,POTX,13,0,13,-13,1,1,7,1,NASDAQ
4262,09-02-2021 18:00,24 hrs.,stocks,QCLN,36,36,0,36,1,6,20,1,NASDAQ
4262,09-02-2021 18:00,24 hrs.,stocks,QCOM,11,11,0,11,1,3,1,1,NASDAQ
4262,09-02-2021 18:00,24 hrs.,stocks,QDEL,23,23,0,23,1,6,7,1,NASDAQ
4262,09-02-2021 18:00,24 hrs.,stocks,QGEN,23,23,0,23,1,6,7,1,NASDAQ
4262,09-02-2021 18:00,24 hrs.,stocks,REGN,20,0,20,-20,1,4,8,1,NASDAQ
4262,09-02-2021 18:00,24 hrs.,stocks,RIDE,6,6,0,6,1,1,0,1,NASDAQ
4262,09-02-2021 18:00,24 hrs.,stocks,RIOT,6,6,0,6,1,1,0,1,NASDAQ
4262,09-02-2021 18:00,24 hrs.,stocks,SABR,15,15,0,15,1,2,7,1,NASDAQ
4262,09-02-2021 18:00,24 hrs.,stocks,SAVA,7,0,7,-7,1,1,1,1,NASDAQ
4262,09-02-2021 18:00,24 hrs.,stocks,SIRI,6,6,0,6,1,1,0,1,NASDAQ
4262,09-02-2021 18:00,24 hrs.,stocks,SMMT,6,0,6,-6,1,1,0,1,NASDAQ
4262,09-02-2021 18:00,24 hrs.,stocks,SNDL,55,37,18,19,9,9,1,9,NASDAQ
4262,09-02-2021 18:00,24 hrs.,stocks,SONM,15,6,9,-3,2,3,1,2,NASDAQ
4262,09-02-2021 18:00,24 hrs.,stocks,SSSS,6,0,6,-6,1,1,0,1,NASDAQ
4262,09-02-2021 18:00,24 hrs.,stocks,TBLT,6,6,0,6,1,1,0,1,NASDAQ
4262,09-02-2021 18:00,24 hrs.,stocks,TECH,7,0,7,-7,1,1,1,1,NASDAQ
4262,09-02-2021 18:00,24 hrs.,stocks,THCB,30,0,30,-30,5,5,0,1,NASDAQ
4262,09-02-2021 18:00,24 hrs.,stocks,TLRY,464,93,371,-278,6,150,140,6,NASDAQ
4262,09-02-2021 18:00,24 hrs.,stocks,TRIT,6,6,0,6,1,1,0,1,NASDAQ
4194,09-02-2021 02:00,24 hrs.,pennystocks,HIPH,6,6,0,6,1,1,0,1,OTC
4194,09-02-2021 02:00,24 hrs.,pennystocks,HLIX,14,14,0,14,1,3,4,1,OTC
4194,09-02-2021 02:00,24 hrs.,pennystocks,HQGE,113,113,0,113,7,29,27,6,OTC
4194,09-02-2021 02:00,24 hrs.,pennystocks,HYII,107,107,0,107,1,38,27,1,OTC
4194,09-02-2021 02:00,24 hrs.,pennystocks,ICBU,7,7,0,7,1,1,1,1,OTC
4194,09-02-2021 02:00,24 hrs.,pennystocks,IGEN,50,50,0,50,1,19,8,1,OTC
4194,09-02-2021 02:00,24 hrs.,pennystocks,ILUS,7,7,0,7,1,1,1,1,OTC
4194,09-02-2021 02:00,24 hrs.,pennystocks,IMII,24,24,0,24,4,4,0,1,OTC
4194,09-02-2021 02:00,24 hrs.,pennystocks,IMJX,13,13,0,13,2,2,1,2,OTC
4194,09-02-2021 02:00,24 hrs.,pennystocks,INCC,6,6,0,6,1,1,0,1,OTC
4194,09-02-2021 02:00,24 hrs.,pennystocks,DPLS,97,97,0,97,9,22,17,6,OTC
4194,09-02-2021 02:00,24 hrs.,pennystocks,DRWN,6,6,0,6,1,1,0,1,OTC
4194,09-02-2021 02:00,24 hrs.,pennystocks,DSCR,18,18,0,18,1,4,6,1,OTC
4194,09-02-2021 02:00,24 hrs.,pennystocks,ELCR,7,7,0,7,1,1,1,1,OTC
4194,09-02-2021 02:00,24 hrs.,pennystocks,ENZC,77,77,0,77,5,14,29,5,OTC
4194,09-02-2021 02:00,24 hrs.,pennystocks,ABQQ,6,6,0,6,1,1,0,1,OTC
4194,09-02-2021 02:00,24 hrs.,pennystocks,ACAN,6,6,0,6,1,1,0,1,OTC
4194,09-02-2021 02:00,24 hrs.,pennystocks,ADGO,6,6,0,6,1,1,0,1,OTC
4194,09-02-2021 02:00,24 hrs.,pennystocks,AFPW,6,6,0,6,1,1,0,1,OTC
4194,09-02-2021 02:00,24 hrs.,pennystocks,AITX,209,209,0,209,4,64,65,4,OTC
4194,09-02-2021 02:00,24 hrs.,pennystocks,ALKM,13,13,0,13,2,2,1,2,OTC
4194,09-02-2021 02:00,24 hrs.,pennystocks,ALPP,13,13,0,13,2,2,1,2,OTC
4194,09-02-2021 02:00,24 hrs.,pennystocks,ALST,20,20,0,20,1,5,6,1,OTC
4194,09-02-2021 02:00,24 hrs.,pennystocks,ALYI,33,33,0,33,5,5,3,4,OTC
4194,09-02-2021 02:00,24 hrs.,pennystocks,AMLH,6,6,0,6,1,1,0,1,OTC
4194,09-02-2021 02:00,24 hrs.,pennystocks,APYP,7,7,0,7,1,1,1,1,OTC
4194,09-02-2021 02:00,24 hrs.,pennystocks,ARTM,12,12,0,12,2,1,2,1,OTC
4194,09-02-2021 02:00,24 hrs.,pennystocks,ARYC,7,7,0,7,1,1,1,1,OTC
4194,09-02-2021 02:00,24 hrs.,pennystocks,ASTI,81,81,0,81,5,21,19,5,OTC
4194,09-02-2021 02:00,24 hrs.,pennystocks,ATDS,6,6,0,6,1,1,0,1,OTC
4194,09-02-2021 02:00,24 hrs.,pennystocks,ATVK,24,24,0,24,1,5,10,1,OTC
4194,09-02-2021 02:00,24 hrs.,pennystocks,AVVH,7,7,0,7,1,1,1,1,OTC
4194,09-02-2021 02:00,24 hrs.,pennystocks,AXXA,6,6,0,6,1,1,0,1,OTC
4194,09-02-2021 02:00,24 hrs.,pennystocks,BBRW,58,58,0,58,4,6,30,4,OTC
4194,09-02-2021 02:00,24 hrs.,pennystocks,BDGR,21,21,0,21,3,3,3,2,OTC
4194,09-02-2021 02:00,24 hrs.,pennystocks,BFCH,36,36,0,36,2,7,14,2,OTC
4194,09-02-2021 02:00,24 hrs.,pennystocks,BLAB,13,13,0,13,2,2,1,2,OTC
4194,09-02-2021 02:00,24 hrs.,pennystocks,BLDV,33,33,0,33,2,6,13,2,OTC
4194,09-02-2021 02:00,24 hrs.,pennystocks,BLSP,187,187,0,187,15,46,35,8,OTC
4194,09-02-2021 02:00,24 hrs.,pennystocks,BMIX,18,18,0,18,1,4,6,1,OTC
4194,09-02-2021 02:00,24 hrs.,pennystocks,BOTY,235,235,0,235,15,58,59,15,OTC
4194,09-02-2021 02:00,24 hrs.,pennystocks,BRTX,7,7,0,7,1,1,1,1,OTC
4194,09-02-2021 02:00,24 hrs.,pennystocks,BRZL,31,31,0,31,1,10,7,1,OTC
4194,09-02-2021 02:00,24 hrs.,pennystocks,CAFS,8,8,0,8,1,1,2,1,OTC
4194,09-02-2021 02:00,24 hrs.,pennystocks,CANN,6,6,0,6,1,1,0,1,OTC
4194,09-02-2021 02:00,24 hrs.,pennystocks,CAPC,1038,1038,0,1038,2,499,32,1,OTC
4194,09-02-2021 02:00,24 hrs.,pennystocks,CATV,19,19,0,19,3,3,1,2,OTC
4194,09-02-2021 02:00,24 hrs.,pennystocks,CBBT,710,710,0,710,10,250,170,8,OTC
4194,09-02-2021 02:00,24 hrs.,pennystocks,CBDD,19,19,0,19,2,4,3,2,OTC
4194,09-02-2021 02:00,24 hrs.,pennystocks,CBDL,6,6,0,6,1,1,0,1,OTC
4194,09-02-2021 02:00,24 hrs.,pennystocks,CCTL,6,6,0,6,1,1,0,1,OTC
4194,09-02-2021 02:00,24 hrs.,pennystocks,CELZ,6,6,0,6,1,1,0,1,OTC
4194,09-02-2021 02:00,24 hrs.,pennystocks,CETY,19,19,0,19,3,3,1,3,OTC
4194,09-02-2021 02:00,24 hrs.,pennystocks,CNXS,8,8,0,8,1,1,2,1,OTC
4194,09-02-2021 02:00,24 hrs.,pennystocks,COWI,6,6,0,6,1,1,0,1,OTC
4194,09-02-2021 02:00,24 hrs.,pennystocks,CTYX,8,8,0,8,1,1,2,1,OTC
4194,09-02-2021 02:00,24 hrs.,pennystocks,CVSI,6,6,0,6,1,1,0,1,OTC
4194,09-02-2021 02:00,24 hrs.,pennystocks,CYBL,7,7,0,7,1,1,1,1,OTC
4194,09-02-2021 02:00,24 hrs.,pennystocks,DKAM,7,7,0,7,1,1,1,1,OTC
4194,09-02-2021 02:00,24 hrs.,pennystocks,MLFB,209,209,0,209,3,59,79,3,OTC
4194,09-02-2021 02:00,24 hrs.,pennystocks,MMEX,59,59,0,59,5,11,17,4,OTC
4194,09-02-2021 02:00,24 hrs.,pennystocks,MNGG,6,6,0,6,1,1,0,1,OTC
4194,09-02-2021 02:00,24 hrs.,pennystocks,MRNJ,13,13,0,13,2,2,1,2,OTC
4194,09-02-2021 02:00,24 hrs.,pennystocks,NECA,12,12,0,12,1,2,4,1,OTC
4194,09-02-2021 02:00,24 hrs.,pennystocks,NLST,66,66,0,66,5,20,6,5,OTC
4194,09-02-2021 02:00,24 hrs.,pennystocks,NMTC,14,14,0,14,1,3,4,1,OTC
4194,09-02-2021 02:00,24 hrs.,pennystocks,NOVC,12,12,0,12,2,2,0,1,OTC
4194,09-02-2021 02:00,24 hrs.,pennystocks,NROM,6,6,0,6,1,1,0,1,OTC
4194,09-02-2021 02:00,24 hrs.,pennystocks,NSPX,6,6,0,6,1,1,0,1,OTC
4194,09-02-2021 02:00,24 hrs.,pennystocks,NTRR,24,24,0,24,4,4,0,4,OTC
4194,09-02-2021 02:00,24 hrs.,pennystocks,ONCI,23,23,0,23,1,7,5,1,OTC
4194,09-02-2021 02:00,24 hrs.,pennystocks,OPTI,6,6,0,6,1,1,0,1,OTC
4194,09-02-2021 02:00,24 hrs.,pennystocks,OZSC,203,203,0,203,10,61,41,8,OTC
4194,09-02-2021 02:00,24 hrs.,pennystocks,PAOG,27,27,0,27,1,5,13,1,OTC
4194,09-02-2021 02:00,24 hrs.,pennystocks,PBIO,18,18,0,18,3,3,0,2,OTC
4194,09-02-2021 02:00,24 hrs.,pennystocks,PGTK,6,6,0,6,1,1,0,1,OTC
4194,09-02-2021 02:00,24 hrs.,pennystocks,PHBI,212,212,0,212,2,82,40,1,OTC
4194,09-02-2021 02:00,24 hrs.,pennystocks,PLYZ,13,13,0,13,2,2,1,1,OTC
4194,09-02-2021 02:00,24 hrs.,pennystocks,PPJE,7,7,0,7,1,1,1,1,OTC
4194,09-02-2021 02:00,24 hrs.,pennystocks,PTCO,7,7,0,7,1,1,1,1,OTC
4194,09-02-2021 02:00,24 hrs.,pennystocks,PTOI,6,6,0,6,1,1,0,1,OTC
4194,09-02-2021 02:00,24 hrs.,pennystocks,PURA,31,31,0,31,5,5,1,5,OTC
4194,09-02-2021 02:00,24 hrs.,pennystocks,PVCT,7,7,0,7,1,1,1,1,OTC
4194,09-02-2021 02:00,24 hrs.,pennystocks,PVDG,193,193,0,193,2,50,85,2,OTC
4194,09-02-2021 02:00,24 hrs.,pennystocks,QNTA,6,6,0,6,1,1,0,1,OTC
4194,09-02-2021 02:00,24 hrs.,pennystocks,QTMM,6,6,0,6,1,1,0,1,OTC
4194,09-02-2021 02:00,24 hrs.,pennystocks,REFG,48,48,0,48,1,15,14,1,OTC
4194,09-02-2021 02:00,24 hrs.,pennystocks,RELI,10,10,0,10,1,2,2,1,OTC
4194,09-02-2021 02:00,24 hrs.,pennystocks,RSSV,324,324,0,324,9,91,106,9,OTC
4194,09-02-2021 02:00,24 hrs.,pennystocks,RTON,15,15,0,15,2,3,1,2,OTC
4194,09-02-2021 02:00,24 hrs.,pennystocks,SANP,6,6,0,6,1,1,0,1,OTC
4194,09-02-2021 02:00,24 hrs.,pennystocks,SEGI,15,15,0,15,2,1,5,2,OTC
4194,09-02-2021 02:00,24 hrs.,pennystocks,SENY,89,89,0,89,1,21,43,1,OTC
4194,09-02-2021 02:00,24 hrs.,pennystocks,SETY,6,6,0,6,1,1,0,1,OTC
4194,09-02-2021 02:00,24 hrs.,pennystocks,SFIO,6,6,0,6,1,1,0,1,OTC
4194,09-02-2021 02:00,24 hrs.,pennystocks,SFOR,35,35,0,35,3,6,11,3,OTC
4194,09-02-2021 02:00,24 hrs.,pennystocks,SGMD,12,12,0,12,2,2,0,2,OTC
4194,09-02-2021 02:00,24 hrs.,pennystocks,SGSI,7,7,0,7,1,1,1,1,OTC
4194,09-02-2021 02:00,24 hrs.,pennystocks,ERBB,33,33,0,33,2,6,13,2,OTC
4194,09-02-2021 02:00,24 hrs.,pennystocks,ETFM,7,7,0,7,1,1,1,1,OTC
4194,09-02-2021 02:00,24 hrs.,pennystocks,EUSP,14,14,0,14,2,2,2,2,OTC
4194,09-02-2021 02:00,24 hrs.,pennystocks,EVUS,13,13,0,13,2,2,1,2,OTC
4194,09-02-2021 02:00,24 hrs.,pennystocks,EXMT,7,7,0,7,1,1,1,1,OTC
4194,09-02-2021 02:00,24 hrs.,pennystocks,FBEC,6,6,0,6,1,1,0,1,OTC
4194,09-02-2021 02:00,24 hrs.,pennystocks,FPFI,13,13,0,13,2,2,1,1,OTC
4194,09-02-2021 02:00,24 hrs.,pennystocks,FPVD,19,19,0,19,3,3,1,3,OTC
4194,09-02-2021 02:00,24 hrs.,pennystocks,FTEG,6,6,0,6,1,1,0,1,OTC
4194,09-02-2021 02:00,24 hrs.,pennystocks,FTWS,6,6,0,6,1,1,0,1,OTC
4194,09-02-2021 02:00,24 hrs.,pennystocks,GAXY,93,93,0,93,8,20,21,8,OTC
4194,09-02-2021 02:00,24 hrs.,pennystocks,GFTX,18,18,0,18,1,0,14,1,OTC
4194,09-02-2021 02:00,24 hrs.,pennystocks,GMER,12,12,0,12,2,2,0,2,OTC
4194,09-02-2021 02:00,24 hrs.,pennystocks,GPFT,6,6,0,6,1,1,0,1,OTC
4194,09-02-2021 02:00,24 hrs.,pennystocks,GRBX,38,38,0,38,1,14,6,1,OTC
4194,09-02-2021 02:00,24 hrs.,pennystocks,GRSO,115,115,0,115,2,35,37,2,OTC
4194,09-02-2021 02:00,24 hrs.,pennystocks,GSFI,40,40,0,40,2,11,10,2,OTC
4194,09-02-2021 02:00,24 hrs.,pennystocks,GTEH,166,166,0,166,6,50,42,6,OTC
4194,09-02-2021 02:00,24 hrs.,pennystocks,GTLL,6,6,0,6,1,1,0,1,OTC
4194,09-02-2021 02:00,24 hrs.,pennystocks,GYOG,15,15,0,15,2,1,5,2,OTC
4194,09-02-2021 02:00,24 hrs.,pennystocks,HBRM,18,18,0,18,3,3,0,3,OTC
4194,09-02-2021 02:00,24 hrs.,pennystocks,HCMC,477,477,0,477,69,84,33,52,OTC
4194,09-02-2021 02:00,24 hrs.,pennystocks,HEMP,115,115,0,115,13,24,15,11,OTC
4194,09-02-2021 02:00,24 hrs.,pennystocks,HESG,6,6,0,6,1,1,0,1,OTC
4194,09-02-2021 02:00,24 hrs.,pennystocks,HIMR,6,6,0,6,1,1,0,1,OTC
4194,09-02-2021 02:00,24 hrs.,pennystocks,SIRC,20,20,0,20,3,3,2,1,OTC
4194,09-02-2021 02:00,24 hrs.,pennystocks,SNPW,365,365,0,365,8,119,95,7,OTC
4194,09-02-2021 02:00,24 hrs.,pennystocks,SNRY,6,6,0,6,1,1,0,1,OTC
4194,09-02-2021 02:00,24 hrs.,pennystocks,SRMX,39,39,0,39,4,9,5,4,OTC
4194,09-02-2021 02:00,24 hrs.,pennystocks,SSFT,18,18,0,18,3,3,0,2,OTC
4194,09-02-2021 02:00,24 hrs.,pennystocks,STWC,14,14,0,14,2,3,0,1,OTC
4194,09-02-2021 02:00,24 hrs.,pennystocks,TAUG,7,7,0,7,1,1,1,1,OTC
4194,09-02-2021 02:00,24 hrs.,pennystocks,TLSS,18,18,0,18,3,3,0,3,OTC
4194,09-02-2021 02:00,24 hrs.,pennystocks,TMRC,6,6,0,6,1,1,0,1,OTC
4194,09-02-2021 02:00,24 hrs.,pennystocks,TNRI,14,14,0,14,1,2,6,1,OTC
4194,09-02-2021 02:00,24 hrs.,pennystocks,TPTW,7,7,0,7,1,1,1,1,OTC
4194,09-02-2021 02:00,24 hrs.,pennystocks,TRTC,6,6,0,6,1,1,0,1,OTC
4194,09-02-2021 02:00,24 hrs.,pennystocks,TSNP,47,47,0,47,5,12,3,5,OTC
4194,09-02-2021 02:00,24 hrs.,pennystocks,TSOI,32,32,0,32,5,5,2,5,OTC
4194,09-02-2021 02:00,24 hrs.,pennystocks,TXTM,35,35,0,35,2,10,7,2,OTC
4194,09-02-2021 02:00,24 hrs.,pennystocks,UAPC,10,10,0,10,1,0,6,1,OTC
4194,09-02-2021 02:00,24 hrs.,pennystocks,UBQU,1076,1076,0,1076,4,357,346,4,OTC
4194,09-02-2021 02:00,24 hrs.,pennystocks,USMJ,47,47,0,47,4,8,15,4,OTC
4194,09-02-2021 02:00,24 hrs.,pennystocks,USRM,7,7,0,7,1,1,1,1,OTC
4194,09-02-2021 02:00,24 hrs.,pennystocks,VIZC,6,6,0,6,1,1,0,1,OTC
4194,09-02-2021 02:00,24 hrs.,pennystocks,VYST,6,6,0,6,1,1,0,1,OTC
4194,09-02-2021 02:00,24 hrs.,pennystocks,WCVC,6,6,0,6,1,1,0,1,OTC
4194,09-02-2021 02:00,24 hrs.,pennystocks,WDLF,13,13,0,13,2,2,1,2,OTC
4194,09-02-2021 02:00,24 hrs.,pennystocks,WHEN,6,6,0,6,1,1,0,1,OTC
4194,09-02-2021 02:00,24 hrs.,pennystocks,WSGF,14,14,0,14,2,2,2,1,OTC
4194,09-02-2021 02:00,24 hrs.,pennystocks,XMET,16,16,0,16,1,5,2,1,OTC
4194,09-02-2021 02:00,24 hrs.,pennystocks,ZENG,27,27,0,27,2,6,7,2,OTC
4194,09-02-2021 02:00,24 hrs.,pennystocks,AGFAF,6,6,0,6,1,1,0,1,OTC
4194,09-02-2021 02:00,24 hrs.,pennystocks,AMYZF,12,12,0,12,1,0,8,1,OTC
4194,09-02-2021 02:00,24 hrs.,pennystocks,ARSMF,6,6,0,6,1,1,0,1,OTC
4194,09-02-2021 02:00,24 hrs.,pennystocks,ARXRF,6,6,0,6,1,1,0,1,OTC
4194,09-02-2021 02:00,24 hrs.,pennystocks,AXPWQ,7,7,0,7,1,1,1,1,OTC
4194,09-02-2021 02:00,24 hrs.,pennystocks,BBRRF,161,161,0,161,1,68,21,1,OTC
4194,09-02-2021 02:00,24 hrs.,pennystocks,CHOOF,7,7,0,7,1,1,1,1,OTC
4194,09-02-2021 02:00,24 hrs.,pennystocks,CINGF,39,39,0,39,1,12,11,1,OTC
4194,09-02-2021 02:00,24 hrs.,pennystocks,DGTHF,6,6,0,6,1,1,0,1,OTC
4194,09-02-2021 02:00,24 hrs.,pennystocks,DMNXF,62,62,0,62,1,22,14,1,OTC
4194,09-02-2021 02:00,24 hrs.,pennystocks,ENGMF,40,40,0,40,1,14,8,1,OTC
4194,09-02-2021 02:00,24 hrs.,pennystocks,ENTEF,7,7,0,7,1,1,1,1,OTC
4194,09-02-2021 02:00,24 hrs.,pennystocks,ERPNF,140,140,0,140,1,40,56,1,OTC
4194,09-02-2021 02:00,24 hrs.,pennystocks,FBRKF,6,6,0,6,1,1,0,1,OTC
4194,09-02-2021 02:00,24 hrs.,pennystocks,FLOOF,6,6,0,6,1,1,0,1,OTC
4194,09-02-2021 02:00,24 hrs.,pennystocks,FLURF,30,30,0,30,1,10,6,1,OTC
4194,09-02-2021 02:00,24 hrs.,pennystocks,FTRPF,30,30,0,30,1,11,4,1,OTC
4194,09-02-2021 02:00,24 hrs.,pennystocks,GBOKF,30,30,0,30,1,11,4,1,OTC
4194,09-02-2021 02:00,24 hrs.,pennystocks,GOOLF,6,6,0,6,1,1,0,1,OTC
4194,09-02-2021 02:00,24 hrs.,pennystocks,HAPBF,6,6,0,6,1,1,0,1,OTC
4194,09-02-2021 02:00,24 hrs.,pennystocks,HITIF,1829,1829,0,1829,10,702,385,8,OTC
4194,09-02-2021 02:00,24 hrs.,pennystocks,INIS,12,12,0,12,2,2,0,1,OTC
4194,09-02-2021 02:00,24 hrs.,pennystocks,INKW,18,18,0,18,3,3,0,3,OTC
4194,09-02-2021 02:00,24 hrs.,pennystocks,INND,618,618,0,618,24,144,234,21,OTC
4194,09-02-2021 02:00,24 hrs.,pennystocks,INQD,6,6,0,6,1,1,0,1,OTC
4194,09-02-2021 02:00,24 hrs.,pennystocks,IWSY,21,21,0,21,1,4,9,1,OTC
4194,09-02-2021 02:00,24 hrs.,pennystocks,JAMN,7,7,0,7,1,1,1,1,OTC
4194,09-02-2021 02:00,24 hrs.,pennystocks,JBZY,13,13,0,13,2,2,1,1,OTC
4194,09-02-2021 02:00,24 hrs.,pennystocks,KNOS,7,7,0,7,1,1,1,1,OTC
4194,09-02-2021 02:00,24 hrs.,pennystocks,KYNC,6,6,0,6,1,1,0,1,OTC
4194,09-02-2021 02:00,24 hrs.,pennystocks,LVVV,32,32,0,32,1,8,12,1,OTC
4194,09-02-2021 02:00,24 hrs.,pennystocks,MATN,14,14,0,14,1,0,10,1,OTC
4194,09-02-2021 02:00,24 hrs.,pennystocks,MAXD,6,6,0,6,1,1,0,1,OTC
4194,09-02-2021 02:00,24 hrs.,pennystocks,MCOA,23,23,0,23,3,3,5,3,OTC
4194,09-02-2021 02:00,24 hrs.,pennystocks,MINE,81,81,0,81,5,16,29,5,OTC
4194,09-02-2021 02:00,24 hrs.,pennystocks,MJLB,12,12,0,12,2,2,0,2,OTC
4194,09-02-2021 02:00,24 hrs.,pennystocks,MJNA,32,32,0,32,5,5,2,5,OTC
4194,09-02-2021 02:00,24 hrs.,pennystocks,AESE,32,32,0,32,1,12,4,1,NASDAQ
4194,09-02-2021 02:00,24 hrs.,pennystocks,AEZS,250,250,0,250,17,63,56,16,NASDAQ
4194,09-02-2021 02:00,24 hrs.,pennystocks,AGTC,13,13,0,13,2,2,1,2,NASDAQ
4194,09-02-2021 02:00,24 hrs.,pennystocks,AKBA,15,15,0,15,1,5,1,1,NASDAQ
4194,09-02-2021 02:00,24 hrs.,pennystocks,AREC,6,6,0,6,1,1,0,1,NASDAQ
4194,09-02-2021 02:00,24 hrs.,pennystocks,ARTL,13,13,0,13,2,2,1,1,NASDAQ
4194,09-02-2021 02:00,24 hrs.,pennystocks,ASRT,80,80,0,80,4,10,44,4,NASDAQ
4194,09-02-2021 02:00,24 hrs.,pennystocks,ATHE,67,67,0,67,1,23,17,1,NASDAQ
4194,09-02-2021 02:00,24 hrs.,pennystocks,ATOS,36,36,0,36,3,7,10,2,NASDAQ
4194,09-02-2021 02:00,24 hrs.,pennystocks,AVEO,10,10,0,10,1,1,4,1,NASDAQ
4194,09-02-2021 02:00,24 hrs.,pennystocks,BHAT,6,6,0,6,1,1,0,1,NASDAQ
4194,09-02-2021 02:00,24 hrs.,pennystocks,BIOL,44,44,0,44,7,7,2,5,NASDAQ
4194,09-02-2021 02:00,24 hrs.,pennystocks,BLCM,6,6,0,6,1,1,0,1,NASDAQ
4194,09-02-2021 02:00,24 hrs.,pennystocks,BNGO,7,7,0,7,1,1,1,1,NASDAQ
4194,09-02-2021 02:00,24 hrs.,pennystocks,BXRX,70,70,0,70,1,24,18,1,NASDAQ
4194,09-02-2021 02:00,24 hrs.,pennystocks,CAPR,32,32,0,32,1,12,4,1,NASDAQ
4194,09-02-2021 02:00,24 hrs.,pennystocks,CBAT,26,26,0,26,4,4,2,3,NASDAQ
4194,09-02-2021 02:00,24 hrs.,pennystocks,ZOM,838,838,0,838,24,266,210,24,AMEX
4194,09-02-2021 02:00,24 hrs.,pennystocks,AUMN,22,22,0,22,1,4,10,1,AMEX
4194,09-02-2021 02:00,24 hrs.,pennystocks,CANF,6,6,0,6,1,1,0,1,AMEX
4194,09-02-2021 02:00,24 hrs.,pennystocks,ENSV,32,32,0,32,1,12,4,1,AMEX
4194,09-02-2021 02:00,24 hrs.,pennystocks,GSAT,7,7,0,7,1,1,1,1,AMEX
4194,09-02-2021 02:00,24 hrs.,pennystocks,KHRIF,26,26,0,26,1,6,10,1,OTC
4194,09-02-2021 02:00,24 hrs.,pennystocks,LKYSF,30,30,0,30,1,11,4,1,OTC
4194,09-02-2021 02:00,24 hrs.,pennystocks,LLKKF,19,19,0,19,3,3,1,3,OTC
4194,09-02-2021 02:00,24 hrs.,pennystocks,LNGLY,7,7,0,7,1,1,1,1,OTC
4194,09-02-2021 02:00,24 hrs.,pennystocks,MMEDF,30,30,0,30,1,11,4,1,OTC
4194,09-02-2021 02:00,24 hrs.,pennystocks,MMNFF,52,52,0,52,3,15,10,2,OTC
4194,09-02-2021 02:00,24 hrs.,pennystocks,MNXXF,13,13,0,13,1,4,1,1,OTC
4194,09-02-2021 02:00,24 hrs.,pennystocks,MSNVF,12,12,0,12,2,2,0,2,OTC
4194,09-02-2021 02:00,24 hrs.,pennystocks,NMHLY,20,20,0,20,3,3,2,1,OTC
4194,09-02-2021 02:00,24 hrs.,pennystocks,PMEDF,6,6,0,6,1,1,0,1,OTC
4194,09-02-2021 02:00,24 hrs.,pennystocks,PTNYF,49,49,0,49,1,16,13,1,OTC
4194,09-02-2021 02:00,24 hrs.,pennystocks,RACMF,6,6,0,6,1,1,0,1,OTC
4194,09-02-2021 02:00,24 hrs.,pennystocks,REZZF,19,19,0,19,3,3,1,1,OTC
4194,09-02-2021 02:00,24 hrs.,pennystocks,RHHNF,6,6,0,6,1,1,0,1,OTC
4194,09-02-2021 02:00,24 hrs.,pennystocks,RLFTF,78,78,0,78,5,16,26,4,OTC
4194,09-02-2021 02:00,24 hrs.,pennystocks,RVVTF,30,30,0,30,1,11,4,1,OTC
4194,09-02-2021 02:00,24 hrs.,pennystocks,SEOVF,7,7,0,7,1,1,1,1,OTC
4194,09-02-2021 02:00,24 hrs.,pennystocks,SHRMF,6,6,0,6,1,1,0,1,OTC
4194,09-02-2021 02:00,24 hrs.,pennystocks,SPRWF,152,152,0,152,1,60,28,1,OTC
4194,09-02-2021 02:00,24 hrs.,pennystocks,TFECY,18,18,0,18,3,3,0,1,OTC
4194,09-02-2021 02:00,24 hrs.,pennystocks,TLOFF,588,588,0,588,1,221,142,1,OTC
4194,09-02-2021 02:00,24 hrs.,pennystocks,TOMDF,6,6,0,6,1,1,0,1,OTC
4194,09-02-2021 02:00,24 hrs.,pennystocks,TRMNF,6,6,0,6,1,1,0,1,OTC
4194,09-02-2021 02:00,24 hrs.,pennystocks,TRUFF,30,30,0,30,1,11,4,1,OTC
4194,09-02-2021 02:00,24 hrs.,pennystocks,VSBGF,6,6,0,6,1,1,0,1,OTC
4194,09-02-2021 02:00,24 hrs.,pennystocks,WALRF,96,96,0,96,1,40,12,1,OTC
4194,09-02-2021 02:00,24 hrs.,pennystocks,WDDMF,12,12,0,12,2,2,0,1,OTC
4194,09-02-2021 02:00,24 hrs.,pennystocks,ZBISF,6,6,0,6,1,1,0,1,OTC
4194,09-02-2021 02:00,24 hrs.,pennystocks,AIM,6,6,0,6,1,1,0,1,AMEX
4194,09-02-2021 02:00,24 hrs.,pennystocks,DNN,17,17,0,17,2,3,3,2,AMEX
4194,09-02-2021 02:00,24 hrs.,pennystocks,DSS,47,47,0,47,2,16,7,2,AMEX
4194,09-02-2021 02:00,24 hrs.,pennystocks,GPL,7,7,0,7,1,1,1,1,AMEX
4194,09-02-2021 02:00,24 hrs.,pennystocks,GTE,503,503,0,503,3,204,83,2,AMEX
4194,09-02-2021 02:00,24 hrs.,pennystocks,ITP,343,343,0,343,3,129,73,3,AMEX
4194,09-02-2021 02:00,24 hrs.,pennystocks,NAK,7,7,0,7,1,1,1,1,AMEX
4194,09-02-2021 02:00,24 hrs.,pennystocks,PLX,40,40,0,40,1,11,14,1,AMEX
4194,09-02-2021 02:00,24 hrs.,pennystocks,REI,72,72,0,72,3,20,20,3,AMEX
4194,09-02-2021 02:00,24 hrs.,pennystocks,SYN,30,30,0,30,1,10,6,1,AMEX
4194,09-02-2021 02:00,24 hrs.,pennystocks,WYY,32,32,0,32,1,12,4,1,AMEX
4194,09-02-2021 02:00,24 hrs.,pennystocks,SHMP,13,13,0,13,2,2,1,2,OTC
4194,09-02-2021 02:00,24 hrs.,pennystocks,SIML,20,20,0,20,3,3,2,3,OTC
4194,09-02-2021 02:00,24 hrs.,pennystocks,SING,15,15,0,15,1,2,7,1,OTC
4194,09-02-2021 02:00,24 hrs.,pennystocks,CHCI,6,6,0,6,1,1,0,1,NASDAQ
4194,09-02-2021 02:00,24 hrs.,pennystocks,CIDM,56,56,0,56,2,21,6,2,NASDAQ
4194,09-02-2021 02:00,24 hrs.,pennystocks,CLNE,6,6,0,6,1,1,0,1,NASDAQ
4194,09-02-2021 02:00,24 hrs.,pennystocks,CMPS,30,30,0,30,1,11,4,1,NASDAQ
4194,09-02-2021 02:00,24 hrs.,pennystocks,CNET,32,32,0,32,1,12,4,1,NASDAQ
4194,09-02-2021 02:00,24 hrs.,pennystocks,CNSP,6,6,0,6,1,1,0,1,NASDAQ
4194,09-02-2021 02:00,24 hrs.,pennystocks,CRTD,12,12,0,12,2,2,0,2,NASDAQ
4194,09-02-2021 02:00,24 hrs.,pennystocks,CSBR,6,6,0,6,1,1,0,1,NASDAQ
4194,09-02-2021 02:00,24 hrs.,pennystocks,CSCW,7,7,0,7,1,1,1,1,NASDAQ
4194,09-02-2021 02:00,24 hrs.,pennystocks,CTRM,75,75,0,75,11,11,9,11,NASDAQ
4194,09-02-2021 02:00,24 hrs.,pennystocks,CTXR,71,71,0,71,1,26,15,1,NASDAQ
4194,09-02-2021 02:00,24 hrs.,pennystocks,EAST,38,38,0,38,1,11,12,1,NASDAQ
4194,09-02-2021 02:00,24 hrs.,pennystocks,EDIT,111,111,0,111,1,22,63,1,NASDAQ
4194,09-02-2021 02:00,24 hrs.,pennystocks,EKSO,32,32,0,32,1,12,4,1,NASDAQ
4194,09-02-2021 02:00,24 hrs.,pennystocks,ENVB,14,14,0,14,2,2,2,2,NASDAQ
4194,09-02-2021 02:00,24 hrs.,pennystocks,EVER,6,6,0,6,1,1,0,1,NASDAQ
4194,09-02-2021 02:00,24 hrs.,pennystocks,GHSI,50,50,0,50,4,11,12,4,NASDAQ
4194,09-02-2021 02:00,24 hrs.,pennystocks,INUV,6,6,0,6,1,1,0,1,AMEX
4194,09-02-2021 02:00,24 hrs.,pennystocks,NSPR,23,23,0,23,3,4,3,3,AMEX
4194,09-02-2021 02:00,24 hrs.,pennystocks,OGEN,45,45,0,45,3,14,5,3,AMEX
4194,09-02-2021 02:00,24 hrs.,pennystocks,SENS,59,59,0,59,4,18,7,4,AMEX
4194,09-02-2021 02:00,24 hrs.,pennystocks,SNMP,6,6,0,6,1,1,0,1,AMEX
4194,09-02-2021 02:00,24 hrs.,pennystocks,AFI,6,6,0,6,1,1,0,1,NYSE
4194,09-02-2021 02:00,24 hrs.,pennystocks,AMC,32,32,0,32,5,5,2,5,NYSE
4194,09-02-2021 02:00,24 hrs.,pennystocks,ATH,17,17,0,17,1,2,9,1,NYSE
4194,09-02-2021 02:00,24 hrs.,pennystocks,BTT,7,7,0,7,1,1,1,1,NYSE
4194,09-02-2021 02:00,24 hrs.,pennystocks,CBD,19,19,0,19,3,3,1,3,NYSE
4194,09-02-2021 02:00,24 hrs.,pennystocks,COO,30,30,0,30,1,11,4,1,NYSE
4194,09-02-2021 02:00,24 hrs.,pennystocks,CVS,74,74,0,74,2,29,8,2,NYSE
4194,09-02-2021 02:00,24 hrs.,pennystocks,EAT,6,6,0,6,1,1,0,1,NYSE
4194,09-02-2021 02:00,24 hrs.,pennystocks,EFT,111,111,0,111,1,22,63,1,NYSE
4194,09-02-2021 02:00,24 hrs.,pennystocks,FRA,152,152,0,152,1,60,28,1,NYSE
4194,09-02-2021 02:00,24 hrs.,pennystocks,GME,32,32,0,32,5,5,2,4,NYSE
4194,09-02-2021 02:00,24 hrs.,pennystocks,JPM,6,6,0,6,1,1,0,1,NYSE
4194,09-02-2021 02:00,24 hrs.,pennystocks,KOS,7,7,0,7,1,1,1,1,NYSE
4194,09-02-2021 02:00,24 hrs.,pennystocks,KYN,6,6,0,6,1,1,0,1,NYSE
4194,09-02-2021 02:00,24 hrs.,pennystocks,PKG,49,49,0,49,1,16,13,1,NYSE
4194,09-02-2021 02:00,24 hrs.,pennystocks,SAP,30,30,0,30,1,11,4,1,NYSE
4194,09-02-2021 02:00,24 hrs.,pennystocks,TDA,21,21,0,21,1,4,9,1,NYSE
4194,09-02-2021 02:00,24 hrs.,pennystocks,XOM,59,59,0,59,1,18,19,1,NYSE
4194,09-02-2021 02:00,24 hrs.,pennystocks,ARGO,7,7,0,7,1,1,1,1,NYSE
4194,09-02-2021 02:00,24 hrs.,pennystocks,COTY,12,12,0,12,2,2,0,2,NYSE
4194,09-02-2021 02:00,24 hrs.,pennystocks,FEDU,13,13,0,13,2,2,1,2,NYSE
4194,09-02-2021 02:00,24 hrs.,pennystocks,HEXO,6,6,0,6,1,1,0,1,NYSE
4194,09-02-2021 02:00,24 hrs.,pennystocks,LUMN,7,7,0,7,1,1,1,1,NYSE
4194,09-02-2021 02:00,24 hrs.,pennystocks,NVTA,7,7,0,7,1,1,1,1,NYSE
4194,09-02-2021 02:00,24 hrs.,pennystocks,PUMP,5,5,0,5,1,0,1,1,NYSE
4194,09-02-2021 02:00,24 hrs.,pennystocks,WBAI,32,32,0,32,1,12,4,1,NYSE
4194,09-02-2021 02:00,24 hrs.,pennystocks,AQB,31,31,0,31,2,10,3,2,NASDAQ
4194,09-02-2021 02:00,24 hrs.,pennystocks,BBI,14,14,0,14,2,2,2,1,NASDAQ
4194,09-02-2021 02:00,24 hrs.,pennystocks,CGC,30,30,0,30,1,11,4,1,NASDAQ
4194,09-02-2021 02:00,24 hrs.,pennystocks,HAS,15,15,0,15,1,4,3,1,NASDAQ
4194,09-02-2021 02:00,24 hrs.,pennystocks,NEO,30,30,0,30,1,11,4,1,NASDAQ
4194,09-02-2021 02:00,24 hrs.,pennystocks,OGI,61,61,0,61,2,22,9,2,NASDAQ
4194,09-02-2021 02:00,24 hrs.,pennystocks,OSS,11,11,0,11,1,3,1,1,NASDAQ
4194,09-02-2021 02:00,24 hrs.,pennystocks,PTE,7,7,0,7,1,1,1,1,NASDAQ
4194,09-02-2021 02:00,24 hrs.,pennystocks,SND,6,6,0,6,1,1,0,1,NASDAQ
4194,09-02-2021 02:00,24 hrs.,pennystocks,TTD,40,40,0,40,1,14,8,1,NASDAQ
4194,09-02-2021 02:00,24 hrs.,pennystocks,AACG,32,32,0,32,1,12,4,1,NASDAQ
4194,09-02-2021 02:00,24 hrs.,pennystocks,ABEO,11,11,0,11,2,1,1,2,NASDAQ
4194,09-02-2021 02:00,24 hrs.,pennystocks,ABUS,6,6,0,6,1,1,0,1,NASDAQ
4194,09-02-2021 02:00,24 hrs.,pennystocks,ACRX,299,299,0,299,2,122,47,2,NASDAQ
4194,09-02-2021 02:00,24 hrs.,pennystocks,ACST,38,38,0,38,2,13,4,2,NASDAQ
4194,09-02-2021 02:00,24 hrs.,pennystocks,ADMP,17,17,0,17,1,0,13,1,NASDAQ
4194,09-02-2021 02:00,24 hrs.,pennystocks,REYN,10,10,0,10,1,0,6,1,NASDAQ
4194,09-02-2021 02:00,24 hrs.,pennystocks,RIDE,6,6,0,6,1,1,0,1,NASDAQ
4194,09-02-2021 02:00,24 hrs.,pennystocks,RIOT,7,7,0,7,1,1,1,1,NASDAQ
4194,09-02-2021 02:00,24 hrs.,pennystocks,SAVA,84,84,0,84,2,21,34,2,NASDAQ
4194,09-02-2021 02:00,24 hrs.,pennystocks,SEAC,14,14,0,14,1,4,2,1,NASDAQ
4194,09-02-2021 02:00,24 hrs.,pennystocks,SEEL,30,30,0,30,1,11,4,1,NASDAQ
4194,09-02-2021 02:00,24 hrs.,pennystocks,SESN,6,6,0,6,1,1,0,1,NASDAQ
4194,09-02-2021 02:00,24 hrs.,pennystocks,SINO,32,32,0,32,1,12,4,1,NASDAQ
4194,09-02-2021 02:00,24 hrs.,pennystocks,SLGG,32,32,0,32,1,12,4,1,NASDAQ
4194,09-02-2021 02:00,24 hrs.,pennystocks,SNDL,28,28,0,28,5,4,0,5,NASDAQ
4194,09-02-2021 02:00,24 hrs.,pennystocks,SONM,171,171,0,171,3,66,27,3,NASDAQ
4194,09-02-2021 02:00,24 hrs.,pennystocks,SRAX,13,13,0,13,2,2,1,2,NASDAQ
4194,09-02-2021 02:00,24 hrs.,pennystocks,SRGA,39,39,0,39,1,15,5,1,NASDAQ
4194,09-02-2021 02:00,24 hrs.,pennystocks,SRNE,7,7,0,7,1,1,1,1,NASDAQ
4194,09-02-2021 02:00,24 hrs.,pennystocks,SSPK,6,6,0,6,1,1,0,1,NASDAQ
4194,09-02-2021 02:00,24 hrs.,pennystocks,STAF,7,7,0,7,1,1,1,1,NASDAQ
4194,09-02-2021 02:00,24 hrs.,pennystocks,SXTC,7,7,0,7,1,1,1,1,NASDAQ
4194,09-02-2021 02:00,24 hrs.,pennystocks,TBLT,877,877,0,877,4,349,163,4,NASDAQ
4194,09-02-2021 02:00,24 hrs.,pennystocks,TLRY,6,6,0,6,1,1,0,1,NASDAQ
4194,09-02-2021 02:00,24 hrs.,pennystocks,TNXP,170,170,0,170,8,54,30,8,NASDAQ
4194,09-02-2021 02:00,24 hrs.,pennystocks,TRIP,30,30,0,30,1,11,4,1,NASDAQ
4194,09-02-2021 02:00,24 hrs.,pennystocks,TXMD,12,12,0,12,2,2,0,2,NASDAQ
4194,09-02-2021 02:00,24 hrs.,pennystocks,TYME,205,205,0,205,5,74,37,5,NASDAQ
4194,09-02-2021 02:00,24 hrs.,pennystocks,VISL,11,11,0,11,1,3,1,1,NASDAQ
4194,09-02-2021 02:00,24 hrs.,pennystocks,VIVO,12,12,0,12,2,2,0,2,NASDAQ
4194,09-02-2021 02:00,24 hrs.,pennystocks,VTSI,6,6,0,6,1,1,0,1,NASDAQ
4194,09-02-2021 02:00,24 hrs.,pennystocks,VXRT,20,20,0,20,1,5,6,1,NASDAQ
4194,09-02-2021 02:00,24 hrs.,pennystocks,VYNE,6,6,0,6,1,1,0,1,NASDAQ
4194,09-02-2021 02:00,24 hrs.,pennystocks,WPRT,6,6,0,6,1,1,0,1,NASDAQ
4194,09-02-2021 02:00,24 hrs.,pennystocks,ZNGA,7,7,0,7,1,1,1,1,NASDAQ
4194,09-02-2021 02:00,24 hrs.,pennystocks,ZSAN,10659,10659,0,10659,16,4726,1143,15,NASDAQ
4194,09-02-2021 02:00,24 hrs.,pennystocks,GLSI,6,6,0,6,1,1,0,1,NASDAQ
4194,09-02-2021 02:00,24 hrs.,pennystocks,GMBL,32,32,0,32,1,12,4,1,NASDAQ
4194,09-02-2021 02:00,24 hrs.,pennystocks,GNLN,6,6,0,6,1,1,0,1,NASDAQ
4194,09-02-2021 02:00,24 hrs.,pennystocks,HJLI,6,6,0,6,1,1,0,1,NASDAQ
4194,09-02-2021 02:00,24 hrs.,pennystocks,HMHC,18,18,0,18,1,5,4,1,NASDAQ
4194,09-02-2021 02:00,24 hrs.,pennystocks,IBKR,7,7,0,7,1,0,3,1,NASDAQ
4194,09-02-2021 02:00,24 hrs.,pennystocks,IDEX,19,19,0,19,1,3,9,1,NASDAQ
4194,09-02-2021 02:00,24 hrs.,pennystocks,IDXG,6,6,0,6,1,1,0,1,NASDAQ
4194,09-02-2021 02:00,24 hrs.,pennystocks,IGMS,32,32,0,32,1,12,4,1,NASDAQ
4194,09-02-2021 02:00,24 hrs.,pennystocks,INFI,6,6,0,6,1,1,0,1,NASDAQ
4194,09-02-2021 02:00,24 hrs.,pennystocks,INVE,6,6,0,6,1,1,0,1,NASDAQ
4194,09-02-2021 02:00,24 hrs.,pennystocks,ITRM,82,82,0,82,3,21,28,3,NASDAQ
4194,09-02-2021 02:00,24 hrs.,pennystocks,JAKK,29,29,0,29,1,9,7,1,NASDAQ
4194,09-02-2021 02:00,24 hrs.,pennystocks,LIFE,32,32,0,32,1,12,4,1,NASDAQ
4194,09-02-2021 02:00,24 hrs.,pennystocks,LIZI,32,32,0,32,1,12,4,1,NASDAQ
4194,09-02-2021 02:00,24 hrs.,pennystocks,MARA,107,107,0,107,1,32,39,1,NASDAQ
4194,09-02-2021 02:00,24 hrs.,pennystocks,MRKR,6,6,0,6,1,1,0,1,NASDAQ
4194,09-02-2021 02:00,24 hrs.,pennystocks,NAKD,6,6,0,6,1,1,0,1,NASDAQ
4194,09-02-2021 02:00,24 hrs.,pennystocks,NOVN,100,100,0,100,5,33,14,5,NASDAQ
4194,09-02-2021 02:00,24 hrs.,pennystocks,NXTD,32,32,0,32,1,12,4,1,NASDAQ
4194,09-02-2021 02:00,24 hrs.,pennystocks,OCGN,381,381,0,381,22,93,107,20,NASDAQ
4194,09-02-2021 02:00,24 hrs.,pennystocks,OCUP,17,17,0,17,1,0,13,1,NASDAQ
4194,09-02-2021 02:00,24 hrs.,pennystocks,ONTX,15,15,0,15,1,4,3,1,NASDAQ
4194,09-02-2021 02:00,24 hrs.,pennystocks,OPGN,58,58,0,58,5,15,8,4,NASDAQ
4194,09-02-2021 02:00,24 hrs.,pennystocks,OTLK,45,45,0,45,3,14,5,3,NASDAQ
4194,09-02-2021 02:00,24 hrs.,pennystocks,PAVM,6,6,0,6,1,1,0,1,NASDAQ
4194,09-02-2021 02:00,24 hrs.,pennystocks,PBTS,7,7,0,7,1,1,1,1,NASDAQ
4194,09-02-2021 02:00,24 hrs.,pennystocks,PLAY,6,6,0,6,1,1,0,1,NASDAQ
4194,09-02-2021 02:00,24 hrs.,pennystocks,PNNT,15,15,0,15,2,2,3,1,NASDAQ
4194,09-02-2021 02:00,24 hrs.,pennystocks,POAI,6,6,0,6,1,1,0,1,NASDAQ
4194,09-02-2021 02:00,24 hrs.,pennystocks,RAVE,6,6,0,6,1,1,0,1,NASDAQ
4194,09-02-2021 02:00,24 hrs.,pennystocks,CBAY,8,8,0,8,1,2,0,1,NASDAQ
4194,09-02-2021 02:00,24 hrs.,pennystocks,CCRC,32,32,0,32,1,12,4,1,NASDAQ
4179,08-02-2021 20:00,24 hrs.,pennystocks,WPRT,6,6,0,6,1,1,0,1,NASDAQ
4179,08-02-2021 20:00,24 hrs.,pennystocks,ZSAN,4398,4398,0,4398,10,1895,568,9,NASDAQ
4179,08-02-2021 20:00,24 hrs.,pennystocks,BBI,7,7,0,7,1,1,1,1,NASDAQ
4179,08-02-2021 20:00,24 hrs.,pennystocks,ESG,7,0,7,-7,1,1,1,1,NASDAQ
4179,08-02-2021 20:00,24 hrs.,pennystocks,HAS,15,15,0,15,1,4,3,1,NASDAQ
4179,08-02-2021 20:00,24 hrs.,pennystocks,OGI,41,41,0,41,2,13,7,2,NASDAQ
4179,08-02-2021 20:00,24 hrs.,pennystocks,PTE,7,7,0,7,1,1,1,1,NASDAQ
4179,08-02-2021 20:00,24 hrs.,pennystocks,ABEO,6,6,0,6,1,1,0,1,NASDAQ
4179,08-02-2021 20:00,24 hrs.,pennystocks,ABUS,6,6,0,6,1,1,0,1,NASDAQ
4179,08-02-2021 20:00,24 hrs.,pennystocks,ACRX,76,29,47,-18,2,17,34,2,NASDAQ
4179,08-02-2021 20:00,24 hrs.,pennystocks,ACST,6,6,0,6,1,1,0,1,NASDAQ
4179,08-02-2021 20:00,24 hrs.,pennystocks,AEZS,7,7,0,7,1,1,1,1,NASDAQ
4179,08-02-2021 20:00,24 hrs.,pennystocks,AGTC,53,6,47,-41,2,11,23,2,NASDAQ
4179,08-02-2021 20:00,24 hrs.,pennystocks,AKBA,11,11,0,11,1,3,1,1,NASDAQ
4179,08-02-2021 20:00,24 hrs.,pennystocks,AREC,6,6,0,6,1,1,0,1,NASDAQ
4179,08-02-2021 20:00,24 hrs.,pennystocks,ARTL,13,13,0,13,2,2,1,1,NASDAQ
4179,08-02-2021 20:00,24 hrs.,pennystocks,ASRT,51,51,0,51,3,8,23,3,NASDAQ
4179,08-02-2021 20:00,24 hrs.,pennystocks,ATOS,83,36,47,-11,4,17,33,3,NASDAQ
4179,08-02-2021 20:00,24 hrs.,pennystocks,AVEO,10,10,0,10,1,1,4,1,NASDAQ
4179,08-02-2021 20:00,24 hrs.,pennystocks,BHAT,6,6,0,6,1,1,0,1,NASDAQ
4179,08-02-2021 20:00,24 hrs.,pennystocks,BIOL,38,38,0,38,6,6,2,4,NASDAQ
4179,08-02-2021 20:00,24 hrs.,pennystocks,BLCM,6,6,0,6,1,1,0,1,NASDAQ
4179,08-02-2021 20:00,24 hrs.,pennystocks,BNGO,7,7,0,7,1,1,1,1,NASDAQ
4179,08-02-2021 20:00,24 hrs.,pennystocks,CBAT,8,8,0,8,1,1,2,1,NASDAQ
4179,08-02-2021 20:00,24 hrs.,pennystocks,CBAY,8,8,0,8,1,2,0,1,NASDAQ
4179,08-02-2021 20:00,24 hrs.,pennystocks,CIDM,14,14,0,14,1,4,2,1,NASDAQ
4179,08-02-2021 20:00,24 hrs.,pennystocks,CNSP,6,6,0,6,1,1,0,1,NASDAQ
4179,08-02-2021 20:00,24 hrs.,pennystocks,CSBR,6,6,0,6,1,1,0,1,NASDAQ
4179,08-02-2021 20:00,24 hrs.,pennystocks,CSCW,7,7,0,7,1,1,1,1,NASDAQ
4179,08-02-2021 20:00,24 hrs.,pennystocks,CTRM,34,34,0,34,5,5,4,5,NASDAQ
4179,08-02-2021 20:00,24 hrs.,pennystocks,EVER,6,6,0,6,1,1,0,1,NASDAQ
4179,08-02-2021 20:00,24 hrs.,pennystocks,GHSI,16,16,0,16,1,3,6,1,NASDAQ
4179,08-02-2021 20:00,24 hrs.,pennystocks,GLSI,6,6,0,6,1,1,0,1,NASDAQ
4179,08-02-2021 20:00,24 hrs.,pennystocks,IBKR,7,7,0,7,1,0,3,1,NASDAQ
4179,08-02-2021 20:00,24 hrs.,pennystocks,IDEX,19,19,0,19,1,3,9,1,NASDAQ
4179,08-02-2021 20:00,24 hrs.,pennystocks,ITRM,9,9,0,9,1,0,5,1,NASDAQ
4179,08-02-2021 20:00,24 hrs.,pennystocks,JAKK,6,6,0,6,1,1,0,1,NASDAQ
4179,08-02-2021 20:00,24 hrs.,pennystocks,JOBS,5,0,5,-5,1,0,1,1,NASDAQ
4179,08-02-2021 20:00,24 hrs.,pennystocks,LIVE,7,0,7,-7,1,1,1,1,NASDAQ
4179,08-02-2021 20:00,24 hrs.,pennystocks,MVIS,97,0,97,-97,1,44,5,1,NASDAQ
4179,08-02-2021 20:00,24 hrs.,pennystocks,NAKD,6,6,0,6,1,1,0,1,NASDAQ
4179,08-02-2021 20:00,24 hrs.,pennystocks,NOVN,19,19,0,19,3,3,1,3,NASDAQ
4179,08-02-2021 20:00,24 hrs.,pennystocks,OCGN,503,166,337,-171,16,154,131,15,NASDAQ
4179,08-02-2021 20:00,24 hrs.,pennystocks,OCUP,14,14,0,14,1,0,10,1,NASDAQ
4179,08-02-2021 20:00,24 hrs.,pennystocks,OPGN,26,26,0,26,4,3,4,3,NASDAQ
4179,08-02-2021 20:00,24 hrs.,pennystocks,OTLK,7,7,0,7,1,1,1,1,NASDAQ
4179,08-02-2021 20:00,24 hrs.,pennystocks,PBTS,7,7,0,7,1,1,1,1,NASDAQ
4179,08-02-2021 20:00,24 hrs.,pennystocks,RAVE,6,6,0,6,1,1,0,1,NASDAQ
4179,08-02-2021 20:00,24 hrs.,pennystocks,RIDE,6,6,0,6,1,1,0,1,NASDAQ
4179,08-02-2021 20:00,24 hrs.,pennystocks,RIOT,7,7,0,7,1,1,1,1,NASDAQ
4179,08-02-2021 20:00,24 hrs.,pennystocks,SESN,6,6,0,6,1,1,0,1,NASDAQ
4179,08-02-2021 20:00,24 hrs.,pennystocks,SNDL,17,10,7,3,3,2,1,3,NASDAQ
4179,08-02-2021 20:00,24 hrs.,pennystocks,SRAX,13,13,0,13,2,2,1,2,NASDAQ
4179,08-02-2021 20:00,24 hrs.,pennystocks,SRGA,34,34,0,34,1,13,4,1,NASDAQ
4179,08-02-2021 20:00,24 hrs.,pennystocks,SRNE,7,7,0,7,1,1,1,1,NASDAQ
4179,08-02-2021 20:00,24 hrs.,pennystocks,STAF,7,7,0,7,1,1,1,1,NASDAQ
4179,08-02-2021 20:00,24 hrs.,pennystocks,TBLT,141,141,0,141,3,53,23,3,NASDAQ
4179,08-02-2021 20:00,24 hrs.,pennystocks,TNXP,32,26,6,20,5,5,2,5,NASDAQ
4179,08-02-2021 20:00,24 hrs.,pennystocks,TRVN,7,0,7,-7,1,1,1,1,NASDAQ
4179,08-02-2021 20:00,24 hrs.,pennystocks,TTOO,7,0,7,-7,1,1,1,1,NASDAQ
4179,08-02-2021 20:00,24 hrs.,pennystocks,TXMD,30,6,24,-18,5,5,0,2,NASDAQ
4179,08-02-2021 20:00,24 hrs.,pennystocks,TYME,150,150,0,150,4,55,24,4,NASDAQ
4179,08-02-2021 20:00,24 hrs.,pennystocks,VISL,25,11,14,-3,2,6,5,2,NASDAQ
4179,08-02-2021 20:00,24 hrs.,pennystocks,VTSI,6,6,0,6,1,1,0,1,NASDAQ
4179,08-02-2021 20:00,24 hrs.,pennystocks,VXRT,18,18,0,18,1,4,6,1,NASDAQ
4179,08-02-2021 20:00,24 hrs.,pennystocks,VYNE,6,6,0,6,1,1,0,1,NASDAQ
4179,08-02-2021 20:00,24 hrs.,pennystocks,CINGF,32,32,0,32,1,10,8,1,OTC
4179,08-02-2021 20:00,24 hrs.,pennystocks,CNABQ,7,0,7,-7,1,1,1,1,OTC
4179,08-02-2021 20:00,24 hrs.,pennystocks,DGTHF,6,6,0,6,1,1,0,1,OTC
4179,08-02-2021 20:00,24 hrs.,pennystocks,DMNXF,51,51,0,51,1,18,11,1,OTC
4179,08-02-2021 20:00,24 hrs.,pennystocks,ENTEF,7,7,0,7,1,1,1,1,OTC
4179,08-02-2021 20:00,24 hrs.,pennystocks,ERPNF,15,15,0,15,1,4,3,1,OTC
4179,08-02-2021 20:00,24 hrs.,pennystocks,FBRKF,6,6,0,6,1,1,0,1,OTC
4179,08-02-2021 20:00,24 hrs.,pennystocks,FLOOF,6,6,0,6,1,1,0,1,OTC
4179,08-02-2021 20:00,24 hrs.,pennystocks,FLURF,29,29,0,29,1,10,5,1,OTC
4179,08-02-2021 20:00,24 hrs.,pennystocks,HITIF,1036,1036,0,1036,6,406,200,5,OTC
4179,08-02-2021 20:00,24 hrs.,pennystocks,KHRIF,23,23,0,23,1,5,9,1,OTC
4179,08-02-2021 20:00,24 hrs.,pennystocks,LBRMF,7,0,7,-7,1,1,1,1,OTC
4179,08-02-2021 20:00,24 hrs.,pennystocks,LNGLY,7,7,0,7,1,1,1,1,OTC
4179,08-02-2021 20:00,24 hrs.,pennystocks,MMNFF,54,21,33,-12,2,16,14,2,OTC
4179,08-02-2021 20:00,24 hrs.,pennystocks,MNXXF,11,11,0,11,1,3,1,1,OTC
4179,08-02-2021 20:00,24 hrs.,pennystocks,MSNVF,12,12,0,12,2,2,0,2,OTC
4179,08-02-2021 20:00,24 hrs.,pennystocks,NEXCF,7,0,7,-7,1,1,1,1,OTC
4179,08-02-2021 20:00,24 hrs.,pennystocks,NMHLY,20,20,0,20,3,3,2,1,OTC
4179,08-02-2021 20:00,24 hrs.,pennystocks,PMEDF,6,6,0,6,1,1,0,1,OTC
4179,08-02-2021 20:00,24 hrs.,pennystocks,PTNYF,43,43,0,43,1,15,9,1,OTC
4179,08-02-2021 20:00,24 hrs.,pennystocks,RLFTF,53,53,0,53,2,13,19,2,OTC
4179,08-02-2021 20:00,24 hrs.,pennystocks,SEOVF,7,7,0,7,1,1,1,1,OTC
4179,08-02-2021 20:00,24 hrs.,pennystocks,SHRMF,6,6,0,6,1,1,0,1,OTC
4179,08-02-2021 20:00,24 hrs.,pennystocks,TAKOF,7,0,7,-7,1,1,1,1,OTC
4179,08-02-2021 20:00,24 hrs.,pennystocks,TRMNF,6,6,0,6,1,1,0,1,OTC
4179,08-02-2021 20:00,24 hrs.,pennystocks,VSBGF,6,6,0,6,1,1,0,1,OTC
4179,08-02-2021 20:00,24 hrs.,pennystocks,WALRF,82,82,0,82,1,33,12,1,OTC
4179,08-02-2021 20:00,24 hrs.,pennystocks,WDDMF,6,6,0,6,1,1,0,1,OTC
4179,08-02-2021 20:00,24 hrs.,pennystocks,AIM,6,6,0,6,1,1,0,1,AMEX
4179,08-02-2021 20:00,24 hrs.,pennystocks,DNN,17,17,0,17,2,3,3,2,AMEX
4179,08-02-2021 20:00,24 hrs.,pennystocks,DSS,38,38,0,38,1,15,4,1,AMEX
4179,08-02-2021 20:00,24 hrs.,pennystocks,GPL,7,7,0,7,1,1,1,1,AMEX
4179,08-02-2021 20:00,24 hrs.,pennystocks,GTE,326,319,7,312,3,132,50,3,AMEX
4179,08-02-2021 20:00,24 hrs.,pennystocks,ITP,186,186,0,186,1,70,42,1,AMEX
4179,08-02-2021 20:00,24 hrs.,pennystocks,PLX,24,24,0,24,1,7,6,1,AMEX
4179,08-02-2021 20:00,24 hrs.,pennystocks,REI,6,6,0,6,1,1,0,1,AMEX
4179,08-02-2021 20:00,24 hrs.,pennystocks,ZOM,245,198,47,151,12,51,95,12,AMEX
4179,08-02-2021 20:00,24 hrs.,pennystocks,AUMN,23,23,0,23,1,6,7,1,AMEX
4179,08-02-2021 20:00,24 hrs.,pennystocks,GSAT,7,7,0,7,1,1,1,1,AMEX
4179,08-02-2021 20:00,24 hrs.,pennystocks,NSPR,16,16,0,16,2,3,2,2,AMEX
4179,08-02-2021 20:00,24 hrs.,pennystocks,SENS,6,6,0,6,1,1,0,1,AMEX
4179,08-02-2021 20:00,24 hrs.,pennystocks,SNMP,6,6,0,6,1,1,0,1,AMEX
4179,08-02-2021 20:00,24 hrs.,pennystocks,UAVS,97,0,97,-97,1,44,5,1,AMEX
4179,08-02-2021 20:00,24 hrs.,pennystocks,ABT,46,0,46,-46,1,14,14,1,NYSE
4179,08-02-2021 20:00,24 hrs.,pennystocks,AFI,6,6,0,6,1,1,0,1,NYSE
4179,08-02-2021 20:00,24 hrs.,pennystocks,AMC,20,20,0,20,3,3,2,3,NYSE
4179,08-02-2021 20:00,24 hrs.,pennystocks,ASX,7,0,7,-7,1,1,1,1,NYSE
4179,08-02-2021 20:00,24 hrs.,pennystocks,ATH,17,17,0,17,1,2,9,1,NYSE
4179,08-02-2021 20:00,24 hrs.,pennystocks,BSL,367,0,367,-367,1,160,43,1,NYSE
4179,08-02-2021 20:00,24 hrs.,pennystocks,BTT,7,7,0,7,1,1,1,1,NYSE
4179,08-02-2021 20:00,24 hrs.,pennystocks,CBD,89,7,82,-75,2,36,9,2,NYSE
4179,08-02-2021 20:00,24 hrs.,pennystocks,CMG,32,0,32,-32,1,10,8,1,NYSE
4179,08-02-2021 20:00,24 hrs.,pennystocks,CVS,88,42,46,-4,2,31,18,2,NYSE
4179,08-02-2021 20:00,24 hrs.,pennystocks,GME,58,26,32,-6,5,14,10,4,NYSE
4179,08-02-2021 20:00,24 hrs.,pennystocks,KOS,7,7,0,7,1,1,1,1,NYSE
4179,08-02-2021 20:00,24 hrs.,pennystocks,KYN,6,6,0,6,1,1,0,1,NYSE
4179,08-02-2021 20:00,24 hrs.,pennystocks,PKG,43,43,0,43,1,15,9,1,NYSE
4179,08-02-2021 20:00,24 hrs.,pennystocks,UNH,46,0,46,-46,1,14,14,1,NYSE
4179,08-02-2021 20:00,24 hrs.,pennystocks,ARGO,7,7,0,7,1,1,1,1,NYSE
4179,08-02-2021 20:00,24 hrs.,pennystocks,COTY,12,12,0,12,2,2,0,2,NYSE
4179,08-02-2021 20:00,24 hrs.,pennystocks,FEDU,13,13,0,13,2,2,1,2,NYSE
4179,08-02-2021 20:00,24 hrs.,pennystocks,NVTA,7,7,0,7,1,1,1,1,NYSE
4179,08-02-2021 20:00,24 hrs.,pennystocks,PUMP,5,5,0,5,1,0,1,1,NYSE
4179,08-02-2021 20:00,24 hrs.,pennystocks,API,97,0,97,-97,1,44,5,1,NASDAQ
4179,08-02-2021 20:00,24 hrs.,pennystocks,MATN,13,13,0,13,1,0,9,1,OTC
4179,08-02-2021 20:00,24 hrs.,pennystocks,MAXD,12,6,6,0,2,2,0,2,OTC
4179,08-02-2021 20:00,24 hrs.,pennystocks,MCOA,7,7,0,7,1,1,1,1,OTC
4179,08-02-2021 20:00,24 hrs.,pennystocks,MINE,53,53,0,53,3,11,19,3,OTC
4179,08-02-2021 20:00,24 hrs.,pennystocks,MJLB,13,6,7,-1,2,2,1,2,OTC
4179,08-02-2021 20:00,24 hrs.,pennystocks,MJNA,13,13,0,13,2,2,1,2,OTC
4179,08-02-2021 20:00,24 hrs.,pennystocks,MLFB,76,76,0,76,2,22,24,2,OTC
4179,08-02-2021 20:00,24 hrs.,pennystocks,MMEX,61,61,0,61,5,12,17,4,OTC
4179,08-02-2021 20:00,24 hrs.,pennystocks,MRNJ,13,13,0,13,2,2,1,2,OTC
4179,08-02-2021 20:00,24 hrs.,pennystocks,NLST,18,18,0,18,3,3,0,3,OTC
4179,08-02-2021 20:00,24 hrs.,pennystocks,NMTC,14,14,0,14,1,3,4,1,OTC
4179,08-02-2021 20:00,24 hrs.,pennystocks,NOVC,12,12,0,12,2,2,0,1,OTC
4179,08-02-2021 20:00,24 hrs.,pennystocks,OPTI,20,0,20,-20,3,3,2,2,OTC
4179,08-02-2021 20:00,24 hrs.,pennystocks,OZSC,121,63,58,5,8,36,17,7,OTC
4179,08-02-2021 20:00,24 hrs.,pennystocks,PBIO,12,12,0,12,2,2,0,1,OTC
4179,08-02-2021 20:00,24 hrs.,pennystocks,PHBI,59,59,0,59,1,20,15,1,OTC
4179,08-02-2021 20:00,24 hrs.,pennystocks,PHIL,7,0,7,-7,1,1,1,1,OTC
4179,08-02-2021 20:00,24 hrs.,pennystocks,PUGE,6,0,6,-6,1,1,0,1,OTC
4179,08-02-2021 20:00,24 hrs.,pennystocks,PURA,6,6,0,6,1,1,0,1,OTC
4179,08-02-2021 20:00,24 hrs.,pennystocks,PVCT,7,7,0,7,1,1,1,1,OTC
4179,08-02-2021 20:00,24 hrs.,pennystocks,PVDG,15,15,0,15,1,4,3,1,OTC
4179,08-02-2021 20:00,24 hrs.,pennystocks,QTMM,6,6,0,6,1,1,0,1,OTC
4179,08-02-2021 20:00,24 hrs.,pennystocks,REFG,29,29,0,29,1,10,5,1,OTC
4179,08-02-2021 20:00,24 hrs.,pennystocks,RELI,10,10,0,10,1,2,2,1,OTC
4179,08-02-2021 20:00,24 hrs.,pennystocks,RSSV,77,77,0,77,6,22,9,6,OTC
4179,08-02-2021 20:00,24 hrs.,pennystocks,RTON,9,9,0,9,1,2,1,1,OTC
4179,08-02-2021 20:00,24 hrs.,pennystocks,SAML,73,0,73,-73,1,29,11,1,OTC
4179,08-02-2021 20:00,24 hrs.,pennystocks,SEGI,19,19,0,19,2,3,5,2,OTC
4179,08-02-2021 20:00,24 hrs.,pennystocks,SFIO,6,6,0,6,1,1,0,1,OTC
4179,08-02-2021 20:00,24 hrs.,pennystocks,SFOR,22,22,0,22,1,4,10,1,OTC
4179,08-02-2021 20:00,24 hrs.,pennystocks,SGMD,118,6,112,-106,2,43,24,2,OTC
4179,08-02-2021 20:00,24 hrs.,pennystocks,SGSI,7,7,0,7,1,1,1,1,OTC
4179,08-02-2021 20:00,24 hrs.,pennystocks,SHMP,13,13,0,13,2,2,1,2,OTC
4179,08-02-2021 20:00,24 hrs.,pennystocks,SIML,6,6,0,6,1,1,0,1,OTC
4179,08-02-2021 20:00,24 hrs.,pennystocks,SIRC,13,13,0,13,2,2,1,1,OTC
4179,08-02-2021 20:00,24 hrs.,pennystocks,SLNG,7,0,7,-7,1,1,1,1,OTC
4179,08-02-2021 20:00,24 hrs.,pennystocks,SNPW,141,141,0,141,4,47,31,4,OTC
4179,08-02-2021 20:00,24 hrs.,pennystocks,SNRY,6,6,0,6,1,1,0,1,OTC
4179,08-02-2021 20:00,24 hrs.,pennystocks,SRMX,30,30,0,30,3,7,4,3,OTC
4179,08-02-2021 20:00,24 hrs.,pennystocks,SSFT,6,6,0,6,1,1,0,1,OTC
4179,08-02-2021 20:00,24 hrs.,pennystocks,STWC,21,14,7,7,3,4,1,2,OTC
4179,08-02-2021 20:00,24 hrs.,pennystocks,TAUG,7,7,0,7,1,1,1,1,OTC
4179,08-02-2021 20:00,24 hrs.,pennystocks,TLSS,12,12,0,12,2,2,0,2,OTC
4179,08-02-2021 20:00,24 hrs.,pennystocks,TPTW,33,7,26,-19,3,3,15,2,OTC
4179,08-02-2021 20:00,24 hrs.,pennystocks,TRTC,6,6,0,6,1,1,0,1,OTC
4179,08-02-2021 20:00,24 hrs.,pennystocks,TSNP,18,12,6,6,3,3,0,3,OTC
4179,08-02-2021 20:00,24 hrs.,pennystocks,TSOI,26,26,0,26,4,4,2,4,OTC
4179,08-02-2021 20:00,24 hrs.,pennystocks,TXTM,35,35,0,35,2,11,5,2,OTC
4179,08-02-2021 20:00,24 hrs.,pennystocks,UAPC,10,10,0,10,1,0,6,1,OTC
4179,08-02-2021 20:00,24 hrs.,pennystocks,UBQU,426,426,0,426,2,132,154,2,OTC
4179,08-02-2021 20:00,24 hrs.,pennystocks,USMJ,20,20,0,20,3,3,2,3,OTC
4179,08-02-2021 20:00,24 hrs.,pennystocks,VISM,7,0,7,-7,1,1,1,1,OTC
4179,08-02-2021 20:00,24 hrs.,pennystocks,VIZC,6,6,0,6,1,1,0,1,OTC
4179,08-02-2021 20:00,24 hrs.,pennystocks,VMSI,6,0,6,-6,1,1,0,1,OTC
4179,08-02-2021 20:00,24 hrs.,pennystocks,WCVC,6,6,0,6,1,1,0,1,OTC
4179,08-02-2021 20:00,24 hrs.,pennystocks,WDLF,26,13,13,0,4,4,2,4,OTC
4179,08-02-2021 20:00,24 hrs.,pennystocks,WHEN,6,6,0,6,1,1,0,1,OTC
4179,08-02-2021 20:00,24 hrs.,pennystocks,WSGF,14,14,0,14,2,2,2,1,OTC
4179,08-02-2021 20:00,24 hrs.,pennystocks,XMET,14,14,0,14,1,4,2,1,OTC
4179,08-02-2021 20:00,24 hrs.,pennystocks,ZENG,23,23,0,23,1,6,7,1,OTC
4179,08-02-2021 20:00,24 hrs.,pennystocks,AMYZF,9,9,0,9,1,0,5,1,OTC
4179,08-02-2021 20:00,24 hrs.,pennystocks,ARSMF,6,6,0,6,1,1,0,1,OTC
4179,08-02-2021 20:00,24 hrs.,pennystocks,AXPWQ,7,7,0,7,1,1,1,1,OTC
4179,08-02-2021 20:00,24 hrs.,pennystocks,BLOZF,7,0,7,-7,1,1,1,1,OTC
4179,08-02-2021 20:00,24 hrs.,pennystocks,ABML,159,0,159,-159,1,27,101,1,OTC
4179,08-02-2021 20:00,24 hrs.,pennystocks,ABQQ,6,6,0,6,1,1,0,1,OTC
4179,08-02-2021 20:00,24 hrs.,pennystocks,ACAN,6,6,0,6,1,1,0,1,OTC
4179,08-02-2021 20:00,24 hrs.,pennystocks,AFPW,6,6,0,6,1,1,0,1,OTC
4179,08-02-2021 20:00,24 hrs.,pennystocks,AITX,80,80,0,80,4,26,12,4,OTC
4179,08-02-2021 20:00,24 hrs.,pennystocks,ALPP,7,7,0,7,1,1,1,1,OTC
4179,08-02-2021 20:00,24 hrs.,pennystocks,ALST,25,25,0,25,1,8,5,1,OTC
4179,08-02-2021 20:00,24 hrs.,pennystocks,APYP,7,7,0,7,1,1,1,1,OTC
4179,08-02-2021 20:00,24 hrs.,pennystocks,ARTM,14,14,0,14,2,2,2,1,OTC
4179,08-02-2021 20:00,24 hrs.,pennystocks,ARYC,7,7,0,7,1,1,1,1,OTC
4179,08-02-2021 20:00,24 hrs.,pennystocks,ASTI,12,12,0,12,2,2,0,2,OTC
4179,08-02-2021 20:00,24 hrs.,pennystocks,ATDS,6,6,0,6,1,1,0,1,OTC
4179,08-02-2021 20:00,24 hrs.,pennystocks,AVVH,7,7,0,7,1,1,1,1,OTC
4179,08-02-2021 20:00,24 hrs.,pennystocks,BBRW,47,47,0,47,3,5,25,3,OTC
4179,08-02-2021 20:00,24 hrs.,pennystocks,BDGR,14,14,0,14,2,2,2,1,OTC
4179,08-02-2021 20:00,24 hrs.,pennystocks,BFCH,13,13,0,13,2,2,1,2,OTC
4179,08-02-2021 20:00,24 hrs.,pennystocks,BLDV,6,6,0,6,1,1,0,1,OTC
4179,08-02-2021 20:00,24 hrs.,pennystocks,BLSP,69,69,0,69,7,16,9,3,OTC
4179,08-02-2021 20:00,24 hrs.,pennystocks,BOTY,219,212,7,205,12,57,57,12,OTC
4179,08-02-2021 20:00,24 hrs.,pennystocks,BRAV,7,0,7,-7,1,1,1,1,OTC
4179,08-02-2021 20:00,24 hrs.,pennystocks,CAPC,666,666,0,666,2,313,32,1,OTC
4179,08-02-2021 20:00,24 hrs.,pennystocks,CBBT,492,333,159,174,8,134,192,7,OTC
4179,08-02-2021 20:00,24 hrs.,pennystocks,CBDD,12,6,6,0,2,2,0,2,OTC
4179,08-02-2021 20:00,24 hrs.,pennystocks,CBDL,6,6,0,6,1,1,0,1,OTC
4179,08-02-2021 20:00,24 hrs.,pennystocks,CETY,12,12,0,12,2,2,0,2,OTC
4179,08-02-2021 20:00,24 hrs.,pennystocks,CNXS,8,8,0,8,1,1,2,1,OTC
4179,08-02-2021 20:00,24 hrs.,pennystocks,COWI,6,6,0,6,1,1,0,1,OTC
4179,08-02-2021 20:00,24 hrs.,pennystocks,CVSI,6,6,0,6,1,1,0,1,OTC
4179,08-02-2021 20:00,24 hrs.,pennystocks,DKAM,7,7,0,7,1,1,1,1,OTC
4179,08-02-2021 20:00,24 hrs.,pennystocks,DPLS,41,41,0,41,6,6,5,3,OTC
4179,08-02-2021 20:00,24 hrs.,pennystocks,DRWN,6,6,0,6,1,1,0,1,OTC
4179,08-02-2021 20:00,24 hrs.,pennystocks,ELCR,7,7,0,7,1,1,1,1,OTC
4179,08-02-2021 20:00,24 hrs.,pennystocks,ENZC,18,18,0,18,3,3,0,3,OTC
4179,08-02-2021 20:00,24 hrs.,pennystocks,ERBB,6,6,0,6,1,1,0,1,OTC
4179,08-02-2021 20:00,24 hrs.,pennystocks,ETFM,7,7,0,7,1,1,1,1,OTC
4179,08-02-2021 20:00,24 hrs.,pennystocks,EVUS,6,6,0,6,1,1,0,1,OTC
4179,08-02-2021 20:00,24 hrs.,pennystocks,FBEC,6,6,0,6,1,1,0,1,OTC
4179,08-02-2021 20:00,24 hrs.,pennystocks,FPFI,13,13,0,13,2,2,1,1,OTC
4179,08-02-2021 20:00,24 hrs.,pennystocks,FPVD,13,13,0,13,2,2,1,2,OTC
4179,08-02-2021 20:00,24 hrs.,pennystocks,FTWS,6,6,0,6,1,1,0,1,OTC
4179,08-02-2021 20:00,24 hrs.,pennystocks,GAXY,28,28,0,28,4,4,4,4,OTC
4179,08-02-2021 20:00,24 hrs.,pennystocks,GMER,12,12,0,12,2,2,0,2,OTC
4179,08-02-2021 20:00,24 hrs.,pennystocks,GPFT,6,6,0,6,1,1,0,1,OTC
4179,08-02-2021 20:00,24 hrs.,pennystocks,GSFI,8,8,0,8,1,1,2,1,OTC
4179,08-02-2021 20:00,24 hrs.,pennystocks,GTCH,7,0,7,-7,1,1,1,1,OTC
4179,08-02-2021 20:00,24 hrs.,pennystocks,GTEH,13,13,0,13,2,2,1,2,OTC
4179,08-02-2021 20:00,24 hrs.,pennystocks,GTLL,7,0,7,-7,1,1,1,1,OTC
4179,08-02-2021 20:00,24 hrs.,pennystocks,GYOG,7,7,0,7,1,1,1,1,OTC
4179,08-02-2021 20:00,24 hrs.,pennystocks,HBRM,12,12,0,12,2,2,0,2,OTC
4179,08-02-2021 20:00,24 hrs.,pennystocks,HCMC,430,417,13,404,61,77,32,52,OTC
4179,08-02-2021 20:00,24 hrs.,pennystocks,HEMP,54,54,0,54,7,10,6,6,OTC
4179,08-02-2021 20:00,24 hrs.,pennystocks,HESG,6,6,0,6,1,1,0,1,OTC
4179,08-02-2021 20:00,24 hrs.,pennystocks,HLIX,8,8,0,8,1,1,2,1,OTC
4179,08-02-2021 20:00,24 hrs.,pennystocks,HQGE,24,24,0,24,3,3,6,2,OTC
4179,08-02-2021 20:00,24 hrs.,pennystocks,ICBU,7,7,0,7,1,1,1,1,OTC
4179,08-02-2021 20:00,24 hrs.,pennystocks,IGEN,46,46,0,46,1,18,6,1,OTC
4179,08-02-2021 20:00,24 hrs.,pennystocks,ILUS,7,7,0,7,1,1,1,1,OTC
4179,08-02-2021 20:00,24 hrs.,pennystocks,IMII,24,24,0,24,4,4,0,1,OTC
4179,08-02-2021 20:00,24 hrs.,pennystocks,IMJX,13,13,0,13,2,2,1,2,OTC
4179,08-02-2021 20:00,24 hrs.,pennystocks,INND,2131,338,1793,-1455,13,891,297,13,OTC
4179,08-02-2021 20:00,24 hrs.,pennystocks,INQD,6,6,0,6,1,1,0,1,OTC
4179,08-02-2021 20:00,24 hrs.,pennystocks,IPIX,24,0,24,-24,1,5,10,1,OTC
4179,08-02-2021 20:00,24 hrs.,pennystocks,JBZY,13,13,0,13,2,2,1,1,OTC
4179,08-02-2021 20:00,24 hrs.,pennystocks,KYNC,6,6,0,6,1,1,0,1,OTC
3728,04-02-2021 18:00,24 hrs.,stocks,NOK,6,0,6,-6,1,1,0,1,NYSE
3728,04-02-2021 18:00,24 hrs.,RobinHoodPennyStocks,TNXP,43,0,43,-43,1,19,1,1,NASDAQ
3728,04-02-2021 18:00,24 hrs.,stocks,HOL,6,0,6,-6,1,1,0,1,NASDAQ
3728,04-02-2021 18:00,24 hrs.,stocks,SEEL,6,0,6,-6,1,1,0,1,NASDAQ
3728,04-02-2021 18:00,24 hrs.,stocks,TLSA,6,0,6,-6,1,1,0,1,NASDAQ
3728,04-02-2021 18:00,24 hrs.,stocks,TSIA,6,0,6,-6,1,1,0,1,NASDAQ
3728,04-02-2021 18:00,24 hrs.,Daytrading,TAKOF,6,0,6,-6,1,1,0,1,OTC
3728,04-02-2021 18:00,24 hrs.,StockMarket,MMEDF,6,0,6,-6,1,1,0,1,OTC
3728,04-02-2021 18:00,24 hrs.,StockMarket,RYCEY,6,0,6,-6,1,1,0,1,OTC
3728,04-02-2021 18:00,24 hrs.,StockMarket,SPCE,6,0,6,-6,1,1,0,1,NYSE
3728,04-02-2021 18:00,24 hrs.,pennystocks,INKW,6,0,6,-6,1,1,0,1,OTC
3728,04-02-2021 18:00,24 hrs.,pennystocks,OZSC,12,0,12,-12,2,2,0,2,OTC
3728,04-02-2021 18:00,24 hrs.,pennystocks,SGMD,6,0,6,-6,1,1,0,1,OTC
3728,04-02-2021 18:00,24 hrs.,pennystocks,TAKOF,6,0,6,-6,1,1,0,1,OTC
3728,04-02-2021 18:00,24 hrs.,pennystocks,AMC,6,0,6,-6,1,1,0,1,NYSE
3728,04-02-2021 18:00,24 hrs.,pennystocks,III,7,0,7,-7,1,1,1,1,NASDAQ
3728,04-02-2021 18:00,24 hrs.,pennystocks,ADIL,8,0,8,-8,1,1,2,1,NASDAQ
3728,04-02-2021 18:00,24 hrs.,pennystocks,ADMA,6,0,6,-6,1,1,0,1,NASDAQ
3728,04-02-2021 18:00,24 hrs.,pennystocks,CTXR,7,0,7,-7,1,1,1,1,NASDAQ
3728,04-02-2021 18:00,24 hrs.,pennystocks,GRNQ,7,0,7,-7,1,1,1,1,NASDAQ
3728,04-02-2021 18:00,24 hrs.,RobinHoodPennyStocks,SNDL,38,0,38,-38,1,10,14,1,NASDAQ
3728,04-02-2021 18:00,24 hrs.,stocks,CCIV,6,0,6,-6,1,1,0,1,NYSE
3715,04-02-2021 16:00,24 hrs.,pennystocks,III,7,0,7,-7,1,1,1,1,NASDAQ
3715,04-02-2021 16:00,24 hrs.,pennystocks,AMC,6,0,6,-6,1,1,0,1,NYSE
3715,04-02-2021 16:00,24 hrs.,pennystocks,ADMA,6,0,6,-6,1,1,0,1,NASDAQ
3715,04-02-2021 16:00,24 hrs.,pennystocks,CTXR,7,0,7,-7,1,1,1,1,NASDAQ
3715,04-02-2021 16:00,24 hrs.,pennystocks,GRNQ,7,0,7,-7,1,1,1,1,NASDAQ
3715,04-02-2021 16:00,24 hrs.,wallstreetbets,NWBO,6,0,6,-6,1,1,0,1,OTC
3715,04-02-2021 16:00,24 hrs.,wallstreetbets,OVTZ,7,0,7,-7,1,1,1,1,OTC
3715,04-02-2021 16:00,24 hrs.,wallstreetbets,TSNP,6,0,6,-6,1,1,0,1,OTC
3715,04-02-2021 16:00,24 hrs.,wallstreetbets,AGFAF,6,0,6,-6,1,1,0,1,OTC
3715,04-02-2021 16:00,24 hrs.,wallstreetbets,CRMBQ,6,0,6,-6,1,1,0,1,OTC
3715,04-02-2021 16:00,24 hrs.,wallstreetbets,HOFSQ,6,0,6,-6,1,1,0,1,OTC
3715,04-02-2021 16:00,24 hrs.,wallstreetbets,AMC,145,0,145,-145,23,24,5,21,NYSE
3715,04-02-2021 16:00,24 hrs.,wallstreetbets,GME,1348,0,1348,-1348,41,545,94,32,NYSE
3715,04-02-2021 16:00,24 hrs.,wallstreetbets,NOK,12,0,12,-12,2,2,0,2,NYSE
3715,04-02-2021 16:00,24 hrs.,wallstreetbets,PSA,161,0,161,-161,1,75,7,1,NYSE
3715,04-02-2021 16:00,24 hrs.,wallstreetbets,RYN,6,0,6,-6,1,1,0,1,NYSE
3715,04-02-2021 16:00,24 hrs.,wallstreetbets,WMC,6,0,6,-6,1,1,0,1,NYSE
3715,04-02-2021 16:00,24 hrs.,wallstreetbets,HYLN,12,0,12,-12,2,2,0,1,NYSE
3715,04-02-2021 16:00,24 hrs.,wallstreetbets,SPCE,43,0,43,-43,7,7,1,1,NYSE
3715,04-02-2021 16:00,24 hrs.,wallstreetbets,APHA,6,0,6,-6,1,1,0,1,NASDAQ
3715,04-02-2021 16:00,24 hrs.,wallstreetbets,DGLY,6,0,6,-6,1,1,0,1,NASDAQ
3715,04-02-2021 16:00,24 hrs.,wallstreetbets,GLMD,6,0,6,-6,1,1,0,1,NASDAQ
3715,04-02-2021 16:00,24 hrs.,wallstreetbets,MNKD,6,0,6,-6,1,1,0,1,NASDAQ
3715,04-02-2021 16:00,24 hrs.,wallstreetbets,NAKD,7,0,7,-7,1,1,1,1,NASDAQ
3715,04-02-2021 16:00,24 hrs.,wallstreetbets,NCLH,6,0,6,-6,1,1,0,1,NASDAQ
3715,04-02-2021 16:00,24 hrs.,wallstreetbets,SNDL,19,0,19,-19,3,3,1,3,NASDAQ
3715,04-02-2021 16:00,24 hrs.,wallstreetbets,SRNE,6,0,6,-6,1,1,0,1,NASDAQ
3715,04-02-2021 16:00,24 hrs.,wallstreetbets,TYME,6,0,6,-6,1,1,0,1,NASDAQ
3715,04-02-2021 16:00,24 hrs.,RobinHoodPennyStocks,SNDL,30,0,30,-30,1,6,14,1,NASDAQ
3715,04-02-2021 16:00,24 hrs.,RobinHoodPennyStocks,TNXP,41,0,41,-41,1,18,1,1,NASDAQ
3715,04-02-2021 16:00,24 hrs.,stocks,NOK,6,0,6,-6,1,1,0,1,NYSE
3715,04-02-2021 16:00,24 hrs.,stocks,CCIV,6,0,6,-6,1,1,0,1,NYSE
3715,04-02-2021 16:00,24 hrs.,stocks,HOL,6,0,6,-6,1,1,0,1,NASDAQ
3715,04-02-2021 16:00,24 hrs.,stocks,SEEL,6,0,6,-6,1,1,0,1,NASDAQ
3715,04-02-2021 16:00,24 hrs.,stocks,TLSA,6,0,6,-6,1,1,0,1,NASDAQ
3715,04-02-2021 16:00,24 hrs.,stocks,TSIA,6,0,6,-6,1,1,0,1,NASDAQ
3715,04-02-2021 16:00,24 hrs.,Daytrading,TAKOF,6,0,6,-6,1,1,0,1,OTC
3715,04-02-2021 16:00,24 hrs.,trakstocks,CPSH,195,0,195,-195,1,72,47,1,NASDAQ
3715,04-02-2021 16:00,24 hrs.,StockMarket,MMEDF,6,0,6,-6,1,1,0,1,OTC
3715,04-02-2021 16:00,24 hrs.,StockMarket,RYCEY,6,0,6,-6,1,1,0,1,OTC
3715,04-02-2021 16:00,24 hrs.,StockMarket,SPCE,6,0,6,-6,1,1,0,1,NYSE
3715,04-02-2021 16:00,24 hrs.,pennystocks,INKW,6,0,6,-6,1,1,0,1,OTC
3715,04-02-2021 16:00,24 hrs.,pennystocks,OZSC,12,0,12,-12,2,2,0,2,OTC
3715,04-02-2021 16:00,24 hrs.,pennystocks,SGMD,6,0,6,-6,1,1,0,1,OTC
3715,04-02-2021 16:00,24 hrs.,pennystocks,TAKOF,6,0,6,-6,1,1,0,1,OTC
3715,04-02-2021 16:00,24 hrs.,pennystocks,ADIL,8,0,8,-8,1,1,2,1,NASDAQ
3703,04-02-2021 14:00,24 hrs.,stocks,NOK,6,0,6,-6,1,1,0,1,NYSE
3703,04-02-2021 14:00,24 hrs.,RobinHoodPennyStocks,TNXP,39,0,39,-39,1,17,1,1,NASDAQ
3703,04-02-2021 14:00,24 hrs.,stocks,HOL,6,0,6,-6,1,1,0,1,NASDAQ
3703,04-02-2021 14:00,24 hrs.,stocks,SEEL,6,0,6,-6,1,1,0,1,NASDAQ
3703,04-02-2021 14:00,24 hrs.,stocks,TLSA,6,0,6,-6,1,1,0,1,NASDAQ
3703,04-02-2021 14:00,24 hrs.,stocks,TSIA,6,0,6,-6,1,1,0,1,NASDAQ
3703,04-02-2021 14:00,24 hrs.,Daytrading,TAKOF,6,0,6,-6,1,1,0,1,OTC
3703,04-02-2021 14:00,24 hrs.,trakstocks,CPSH,186,0,186,-186,1,68,46,1,NASDAQ
3703,04-02-2021 14:00,24 hrs.,StockMarket,MMEDF,6,0,6,-6,1,1,0,1,OTC
3703,04-02-2021 14:00,24 hrs.,StockMarket,RYCEY,6,0,6,-6,1,1,0,1,OTC
3703,04-02-2021 14:00,24 hrs.,StockMarket,SPCE,6,0,6,-6,1,1,0,1,NYSE
3703,04-02-2021 14:00,24 hrs.,pennystocks,INKW,6,0,6,-6,1,1,0,1,OTC
3703,04-02-2021 14:00,24 hrs.,pennystocks,OZSC,12,0,12,-12,2,2,0,2,OTC
3703,04-02-2021 14:00,24 hrs.,pennystocks,SGMD,6,0,6,-6,1,1,0,1,OTC
3703,04-02-2021 14:00,24 hrs.,pennystocks,TAKOF,6,0,6,-6,1,1,0,1,OTC
3703,04-02-2021 14:00,24 hrs.,pennystocks,AMC,6,0,6,-6,1,1,0,1,NYSE
3703,04-02-2021 14:00,24 hrs.,pennystocks,III,7,0,7,-7,1,1,1,1,NASDAQ
3703,04-02-2021 14:00,24 hrs.,pennystocks,ADIL,8,0,8,-8,1,1,2,1,NASDAQ
3703,04-02-2021 14:00,24 hrs.,pennystocks,ADMA,6,0,6,-6,1,1,0,1,NASDAQ
3703,04-02-2021 14:00,24 hrs.,pennystocks,CTXR,7,0,7,-7,1,1,1,1,NASDAQ
3703,04-02-2021 14:00,24 hrs.,pennystocks,GRNQ,7,0,7,-7,1,1,1,1,NASDAQ
3703,04-02-2021 14:00,24 hrs.,wallstreetbets,NWBO,6,0,6,-6,1,1,0,1,OTC
3703,04-02-2021 14:00,24 hrs.,wallstreetbets,OVTZ,7,0,7,-7,1,1,1,1,OTC
3703,04-02-2021 14:00,24 hrs.,wallstreetbets,TSNP,6,0,6,-6,1,1,0,1,OTC
3703,04-02-2021 14:00,24 hrs.,wallstreetbets,AGFAF,6,0,6,-6,1,1,0,1,OTC
3703,04-02-2021 14:00,24 hrs.,wallstreetbets,CRMBQ,6,0,6,-6,1,1,0,1,OTC
3703,04-02-2021 14:00,24 hrs.,wallstreetbets,HOFSQ,6,0,6,-6,1,1,0,1,OTC
3703,04-02-2021 14:00,24 hrs.,wallstreetbets,AMC,145,0,145,-145,23,24,5,21,NYSE
3703,04-02-2021 14:00,24 hrs.,wallstreetbets,GME,1356,0,1356,-1356,41,549,94,32,NYSE
3703,04-02-2021 14:00,24 hrs.,wallstreetbets,NOK,12,0,12,-12,2,2,0,2,NYSE
3703,04-02-2021 14:00,24 hrs.,wallstreetbets,PSA,161,0,161,-161,1,75,7,1,NYSE
3703,04-02-2021 14:00,24 hrs.,wallstreetbets,RYN,6,0,6,-6,1,1,0,1,NYSE
3703,04-02-2021 14:00,24 hrs.,wallstreetbets,WMC,6,0,6,-6,1,1,0,1,NYSE
3703,04-02-2021 14:00,24 hrs.,wallstreetbets,HYLN,12,0,12,-12,2,2,0,1,NYSE
3703,04-02-2021 14:00,24 hrs.,wallstreetbets,SPCE,43,0,43,-43,7,7,1,1,NYSE
3703,04-02-2021 14:00,24 hrs.,wallstreetbets,APHA,6,0,6,-6,1,1,0,1,NASDAQ
3703,04-02-2021 14:00,24 hrs.,wallstreetbets,DGLY,6,0,6,-6,1,1,0,1,NASDAQ
3703,04-02-2021 14:00,24 hrs.,wallstreetbets,GLMD,6,0,6,-6,1,1,0,1,NASDAQ
3703,04-02-2021 14:00,24 hrs.,wallstreetbets,MNKD,6,0,6,-6,1,1,0,1,NASDAQ
3703,04-02-2021 14:00,24 hrs.,wallstreetbets,NAKD,7,0,7,-7,1,1,1,1,NASDAQ
3703,04-02-2021 14:00,24 hrs.,wallstreetbets,NCLH,6,0,6,-6,1,1,0,1,NASDAQ
3703,04-02-2021 14:00,24 hrs.,wallstreetbets,SNDL,19,0,19,-19,3,3,1,3,NASDAQ
3703,04-02-2021 14:00,24 hrs.,wallstreetbets,SRNE,6,0,6,-6,1,1,0,1,NASDAQ
3703,04-02-2021 14:00,24 hrs.,wallstreetbets,TYME,6,0,6,-6,1,1,0,1,NASDAQ
3703,04-02-2021 14:00,24 hrs.,RobinHoodPennyStocks,SNDL,32,0,32,-32,1,7,14,1,NASDAQ
3703,04-02-2021 14:00,24 hrs.,stocks,CCIV,6,0,6,-6,1,1,0,1,NYSE
3692,04-02-2021 12:00,24 hrs.,RobinHoodPennyStocks,SNDL,32,0,32,-32,1,7,14,1,NASDAQ
3692,04-02-2021 12:00,24 hrs.,wallstreetbets,TYME,6,0,6,-6,1,1,0,1,NASDAQ
3692,04-02-2021 12:00,24 hrs.,stocks,NOK,6,0,6,-6,1,1,0,1,NYSE
3692,04-02-2021 12:00,24 hrs.,stocks,CCIV,6,0,6,-6,1,1,0,1,NYSE
3692,04-02-2021 12:00,24 hrs.,stocks,HOL,6,0,6,-6,1,1,0,1,NASDAQ
3692,04-02-2021 12:00,24 hrs.,stocks,SEEL,6,0,6,-6,1,1,0,1,NASDAQ
3692,04-02-2021 12:00,24 hrs.,stocks,TLSA,6,0,6,-6,1,1,0,1,NASDAQ
3692,04-02-2021 12:00,24 hrs.,stocks,TSIA,6,0,6,-6,1,1,0,1,NASDAQ
3692,04-02-2021 12:00,24 hrs.,Daytrading,TAKOF,6,0,6,-6,1,1,0,1,OTC
3692,04-02-2021 12:00,24 hrs.,trakstocks,CPSH,177,0,177,-177,1,64,45,1,NASDAQ
3692,04-02-2021 12:00,24 hrs.,StockMarket,MMEDF,6,0,6,-6,1,1,0,1,OTC
3692,04-02-2021 12:00,24 hrs.,StockMarket,RYCEY,6,0,6,-6,1,1,0,1,OTC
3692,04-02-2021 12:00,24 hrs.,StockMarket,SPCE,6,0,6,-6,1,1,0,1,NYSE
3692,04-02-2021 12:00,24 hrs.,pennystocks,INKW,6,0,6,-6,1,1,0,1,OTC
3692,04-02-2021 12:00,24 hrs.,pennystocks,OZSC,12,0,12,-12,2,2,0,2,OTC
3692,04-02-2021 12:00,24 hrs.,pennystocks,SGMD,6,0,6,-6,1,1,0,1,OTC
3692,04-02-2021 12:00,24 hrs.,pennystocks,TAKOF,6,0,6,-6,1,1,0,1,OTC
3692,04-02-2021 12:00,24 hrs.,pennystocks,AMC,6,0,6,-6,1,1,0,1,NYSE
3692,04-02-2021 12:00,24 hrs.,pennystocks,III,7,0,7,-7,1,1,1,1,NASDAQ
3692,04-02-2021 12:00,24 hrs.,pennystocks,ADIL,6,0,6,-6,1,1,0,1,NASDAQ
3692,04-02-2021 12:00,24 hrs.,pennystocks,ADMA,6,0,6,-6,1,1,0,1,NASDAQ
3692,04-02-2021 12:00,24 hrs.,pennystocks,CTXR,7,0,7,-7,1,1,1,1,NASDAQ
3692,04-02-2021 12:00,24 hrs.,pennystocks,GRNQ,7,0,7,-7,1,1,1,1,NASDAQ
3692,04-02-2021 12:00,24 hrs.,wallstreetbets,NWBO,6,0,6,-6,1,1,0,1,OTC
3692,04-02-2021 12:00,24 hrs.,wallstreetbets,OVTZ,7,0,7,-7,1,1,1,1,OTC
3692,04-02-2021 12:00,24 hrs.,wallstreetbets,TSNP,6,0,6,-6,1,1,0,1,OTC
3692,04-02-2021 12:00,24 hrs.,wallstreetbets,AGFAF,6,0,6,-6,1,1,0,1,OTC
3692,04-02-2021 12:00,24 hrs.,wallstreetbets,CRMBQ,6,0,6,-6,1,1,0,1,OTC
3692,04-02-2021 12:00,24 hrs.,wallstreetbets,HOFSQ,6,0,6,-6,1,1,0,1,OTC
3692,04-02-2021 12:00,24 hrs.,wallstreetbets,AMC,145,0,145,-145,23,24,5,21,NYSE
3692,04-02-2021 12:00,24 hrs.,wallstreetbets,GME,1348,0,1348,-1348,41,545,94,32,NYSE
3692,04-02-2021 12:00,24 hrs.,wallstreetbets,NOK,12,0,12,-12,2,2,0,2,NYSE
3692,04-02-2021 12:00,24 hrs.,wallstreetbets,PSA,161,0,161,-161,1,75,7,1,NYSE
3692,04-02-2021 12:00,24 hrs.,wallstreetbets,RYN,6,0,6,-6,1,1,0,1,NYSE
3692,04-02-2021 12:00,24 hrs.,wallstreetbets,WMC,6,0,6,-6,1,1,0,1,NYSE
3692,04-02-2021 12:00,24 hrs.,wallstreetbets,HYLN,12,0,12,-12,2,2,0,1,NYSE
3692,04-02-2021 12:00,24 hrs.,wallstreetbets,SPCE,43,0,43,-43,7,7,1,1,NYSE
3692,04-02-2021 12:00,24 hrs.,wallstreetbets,APHA,6,0,6,-6,1,1,0,1,NASDAQ
3692,04-02-2021 12:00,24 hrs.,wallstreetbets,DGLY,6,0,6,-6,1,1,0,1,NASDAQ
3692,04-02-2021 12:00,24 hrs.,wallstreetbets,GLMD,6,0,6,-6,1,1,0,1,NASDAQ
3692,04-02-2021 12:00,24 hrs.,wallstreetbets,MNKD,6,0,6,-6,1,1,0,1,NASDAQ
3692,04-02-2021 12:00,24 hrs.,wallstreetbets,NAKD,7,0,7,-7,1,1,1,1,NASDAQ
3692,04-02-2021 12:00,24 hrs.,wallstreetbets,NCLH,6,0,6,-6,1,1,0,1,NASDAQ
3692,04-02-2021 12:00,24 hrs.,wallstreetbets,SNDL,19,0,19,-19,3,3,1,3,NASDAQ
3692,04-02-2021 12:00,24 hrs.,wallstreetbets,SRNE,6,0,6,-6,1,1,0,1,NASDAQ
3692,04-02-2021 12:00,24 hrs.,RobinHoodPennyStocks,TNXP,35,0,35,-35,1,15,1,1,NASDAQ
3680,04-02-2021 10:00,24 hrs.,wallstreetbets,HOFSQ,6,0,6,-6,1,1,0,1,OTC
3680,04-02-2021 10:00,24 hrs.,wallstreetbets,CRMBQ,6,0,6,-6,1,1,0,1,OTC
3680,04-02-2021 10:00,24 hrs.,wallstreetbets,GME,1342,0,1342,-1342,41,542,94,32,NYSE
3680,04-02-2021 10:00,24 hrs.,wallstreetbets,NOK,12,0,12,-12,2,2,0,2,NYSE
3680,04-02-2021 10:00,24 hrs.,wallstreetbets,PSA,161,0,161,-161,1,75,7,1,NYSE
3680,04-02-2021 10:00,24 hrs.,wallstreetbets,RYN,6,0,6,-6,1,1,0,1,NYSE
3680,04-02-2021 10:00,24 hrs.,wallstreetbets,WMC,6,0,6,-6,1,1,0,1,NYSE
3680,04-02-2021 10:00,24 hrs.,wallstreetbets,HYLN,12,0,12,-12,2,2,0,1,NYSE
3680,04-02-2021 10:00,24 hrs.,wallstreetbets,SPCE,43,0,43,-43,7,7,1,1,NYSE
3680,04-02-2021 10:00,24 hrs.,wallstreetbets,APHA,6,0,6,-6,1,1,0,1,NASDAQ
3680,04-02-2021 10:00,24 hrs.,wallstreetbets,DGLY,6,0,6,-6,1,1,0,1,NASDAQ
3680,04-02-2021 10:00,24 hrs.,wallstreetbets,GLMD,6,0,6,-6,1,1,0,1,NASDAQ
3680,04-02-2021 10:00,24 hrs.,wallstreetbets,MNKD,6,0,6,-6,1,1,0,1,NASDAQ
3680,04-02-2021 10:00,24 hrs.,wallstreetbets,NAKD,7,0,7,-7,1,1,1,1,NASDAQ
3680,04-02-2021 10:00,24 hrs.,wallstreetbets,NCLH,6,0,6,-6,1,1,0,1,NASDAQ
3680,04-02-2021 10:00,24 hrs.,wallstreetbets,SNDL,19,0,19,-19,3,3,1,3,NASDAQ
3680,04-02-2021 10:00,24 hrs.,wallstreetbets,SRNE,6,0,6,-6,1,1,0,1,NASDAQ
3680,04-02-2021 10:00,24 hrs.,wallstreetbets,TYME,6,0,6,-6,1,1,0,1,NASDAQ
3680,04-02-2021 10:00,24 hrs.,RobinHoodPennyStocks,SNDL,30,0,30,-30,1,6,14,1,NASDAQ
3680,04-02-2021 10:00,24 hrs.,RobinHoodPennyStocks,TNXP,37,0,37,-37,1,16,1,1,NASDAQ
3680,04-02-2021 10:00,24 hrs.,stocks,NOK,6,0,6,-6,1,1,0,1,NYSE
3680,04-02-2021 10:00,24 hrs.,stocks,CCIV,6,0,6,-6,1,1,0,1,NYSE
3680,04-02-2021 10:00,24 hrs.,stocks,HOL,6,0,6,-6,1,1,0,1,NASDAQ
3680,04-02-2021 10:00,24 hrs.,stocks,SEEL,6,0,6,-6,1,1,0,1,NASDAQ
3680,04-02-2021 10:00,24 hrs.,stocks,TLSA,6,0,6,-6,1,1,0,1,NASDAQ
3680,04-02-2021 10:00,24 hrs.,stocks,TSIA,6,0,6,-6,1,1,0,1,NASDAQ
3680,04-02-2021 10:00,24 hrs.,Daytrading,TAKOF,6,0,6,-6,1,1,0,1,OTC
3680,04-02-2021 10:00,24 hrs.,trakstocks,CPSH,171,0,171,-171,1,62,43,1,NASDAQ
3680,04-02-2021 10:00,24 hrs.,StockMarket,MMEDF,6,0,6,-6,1,1,0,1,OTC
3680,04-02-2021 10:00,24 hrs.,StockMarket,RYCEY,6,0,6,-6,1,1,0,1,OTC
3680,04-02-2021 10:00,24 hrs.,StockMarket,SPCE,6,0,6,-6,1,1,0,1,NYSE
3680,04-02-2021 10:00,24 hrs.,pennystocks,INKW,6,0,6,-6,1,1,0,1,OTC
3680,04-02-2021 10:00,24 hrs.,pennystocks,OZSC,12,0,12,-12,2,2,0,2,OTC
3680,04-02-2021 10:00,24 hrs.,pennystocks,SGMD,6,0,6,-6,1,1,0,1,OTC
3680,04-02-2021 10:00,24 hrs.,pennystocks,TAKOF,6,0,6,-6,1,1,0,1,OTC
3680,04-02-2021 10:00,24 hrs.,pennystocks,AMC,6,0,6,-6,1,1,0,1,NYSE
3680,04-02-2021 10:00,24 hrs.,pennystocks,III,7,0,7,-7,1,1,1,1,NASDAQ
3680,04-02-2021 10:00,24 hrs.,pennystocks,ADIL,6,0,6,-6,1,1,0,1,NASDAQ
3680,04-02-2021 10:00,24 hrs.,pennystocks,ADMA,6,0,6,-6,1,1,0,1,NASDAQ
3680,04-02-2021 10:00,24 hrs.,pennystocks,CTXR,7,0,7,-7,1,1,1,1,NASDAQ
3680,04-02-2021 10:00,24 hrs.,pennystocks,GRNQ,7,0,7,-7,1,1,1,1,NASDAQ
3680,04-02-2021 10:00,24 hrs.,wallstreetbets,NWBO,6,0,6,-6,1,1,0,1,OTC
3680,04-02-2021 10:00,24 hrs.,wallstreetbets,OVTZ,7,0,7,-7,1,1,1,1,OTC
3680,04-02-2021 10:00,24 hrs.,wallstreetbets,TSNP,6,0,6,-6,1,1,0,1,OTC
3680,04-02-2021 10:00,24 hrs.,wallstreetbets,AGFAF,6,0,6,-6,1,1,0,1,OTC
3680,04-02-2021 10:00,24 hrs.,wallstreetbets,AMC,145,0,145,-145,23,24,5,21,NYSE
3668,04-02-2021 08:00,24 hrs.,StockMarket,MMEDF,6,0,6,-6,1,1,0,1,OTC
3668,04-02-2021 08:00,24 hrs.,StockMarket,RYCEY,6,0,6,-6,1,1,0,1,OTC
3668,04-02-2021 08:00,24 hrs.,StockMarket,SPCE,6,0,6,-6,1,1,0,1,NYSE
3668,04-02-2021 08:00,24 hrs.,pennystocks,INKW,6,0,6,-6,1,1,0,1,OTC
3668,04-02-2021 08:00,24 hrs.,pennystocks,OZSC,12,0,12,-12,2,2,0,2,OTC
3668,04-02-2021 08:00,24 hrs.,pennystocks,SGMD,6,0,6,-6,1,1,0,1,OTC
3668,04-02-2021 08:00,24 hrs.,pennystocks,TAKOF,6,0,6,-6,1,1,0,1,OTC
3668,04-02-2021 08:00,24 hrs.,pennystocks,AMC,6,0,6,-6,1,1,0,1,NYSE
3668,04-02-2021 08:00,24 hrs.,pennystocks,III,7,0,7,-7,1,1,1,1,NASDAQ
3668,04-02-2021 08:00,24 hrs.,pennystocks,ADIL,6,0,6,-6,1,1,0,1,NASDAQ
3668,04-02-2021 08:00,24 hrs.,pennystocks,ADMA,6,0,6,-6,1,1,0,1,NASDAQ
3668,04-02-2021 08:00,24 hrs.,pennystocks,CTXR,7,0,7,-7,1,1,1,1,NASDAQ
3668,04-02-2021 08:00,24 hrs.,pennystocks,GRNQ,7,0,7,-7,1,1,1,1,NASDAQ
3668,04-02-2021 08:00,24 hrs.,wallstreetbets,NWBO,6,0,6,-6,1,1,0,1,OTC
3668,04-02-2021 08:00,24 hrs.,wallstreetbets,OVTZ,7,0,7,-7,1,1,1,1,OTC
3668,04-02-2021 08:00,24 hrs.,wallstreetbets,TSNP,6,0,6,-6,1,1,0,1,OTC
3668,04-02-2021 08:00,24 hrs.,wallstreetbets,AGFAF,6,0,6,-6,1,1,0,1,OTC
3668,04-02-2021 08:00,24 hrs.,wallstreetbets,CRMBQ,6,0,6,-6,1,1,0,1,OTC
3668,04-02-2021 08:00,24 hrs.,wallstreetbets,HOFSQ,6,0,6,-6,1,1,0,1,OTC
3668,04-02-2021 08:00,24 hrs.,wallstreetbets,AMC,145,0,145,-145,23,24,5,21,NYSE
3668,04-02-2021 08:00,24 hrs.,wallstreetbets,GME,1344,0,1344,-1344,41,543,94,33,NYSE
3668,04-02-2021 08:00,24 hrs.,wallstreetbets,NOK,12,0,12,-12,2,2,0,2,NYSE
3668,04-02-2021 08:00,24 hrs.,wallstreetbets,PSA,159,0,159,-159,1,74,7,1,NYSE
3668,04-02-2021 08:00,24 hrs.,wallstreetbets,RYN,6,0,6,-6,1,1,0,1,NYSE
3668,04-02-2021 08:00,24 hrs.,wallstreetbets,WMC,6,0,6,-6,1,1,0,1,NYSE
3668,04-02-2021 08:00,24 hrs.,wallstreetbets,HYLN,12,0,12,-12,2,2,0,1,NYSE
3668,04-02-2021 08:00,24 hrs.,wallstreetbets,SPCE,43,0,43,-43,7,7,1,1,NYSE
3668,04-02-2021 08:00,24 hrs.,wallstreetbets,APHA,6,0,6,-6,1,1,0,1,NASDAQ
3668,04-02-2021 08:00,24 hrs.,wallstreetbets,DGLY,6,0,6,-6,1,1,0,1,NASDAQ
3668,04-02-2021 08:00,24 hrs.,wallstreetbets,GLMD,6,0,6,-6,1,1,0,1,NASDAQ
3668,04-02-2021 08:00,24 hrs.,wallstreetbets,MNKD,6,0,6,-6,1,1,0,1,NASDAQ
3668,04-02-2021 08:00,24 hrs.,wallstreetbets,NAKD,7,0,7,-7,1,1,1,1,NASDAQ
3668,04-02-2021 08:00,24 hrs.,wallstreetbets,NCLH,6,0,6,-6,1,1,0,1,NASDAQ
3668,04-02-2021 08:00,24 hrs.,wallstreetbets,SNDL,19,0,19,-19,3,3,1,3,NASDAQ
3668,04-02-2021 08:00,24 hrs.,wallstreetbets,SRNE,6,0,6,-6,1,1,0,1,NASDAQ
3668,04-02-2021 08:00,24 hrs.,wallstreetbets,TYME,6,0,6,-6,1,1,0,1,NASDAQ
3668,04-02-2021 08:00,24 hrs.,RobinHoodPennyStocks,SNDL,36,0,36,-36,1,9,14,1,NASDAQ
3668,04-02-2021 08:00,24 hrs.,RobinHoodPennyStocks,TNXP,35,0,35,-35,1,15,1,1,NASDAQ
3668,04-02-2021 08:00,24 hrs.,stocks,NOK,6,0,6,-6,1,1,0,1,NYSE
3668,04-02-2021 08:00,24 hrs.,stocks,CCIV,6,0,6,-6,1,1,0,1,NYSE
3668,04-02-2021 08:00,24 hrs.,stocks,HOL,6,0,6,-6,1,1,0,1,NASDAQ
3668,04-02-2021 08:00,24 hrs.,stocks,SEEL,6,0,6,-6,1,1,0,1,NASDAQ
3668,04-02-2021 08:00,24 hrs.,stocks,TLSA,6,0,6,-6,1,1,0,1,NASDAQ
3668,04-02-2021 08:00,24 hrs.,stocks,TSIA,6,0,6,-6,1,1,0,1,NASDAQ
3668,04-02-2021 08:00,24 hrs.,Daytrading,TAKOF,6,0,6,-6,1,1,0,1,OTC
3668,04-02-2021 08:00,24 hrs.,trakstocks,CPSH,165,0,165,-165,1,59,43,1,NASDAQ
3656,04-02-2021 06:00,24 hrs.,stocks,NOK,6,6,0,6,1,1,0,1,NYSE
3656,04-02-2021 06:00,24 hrs.,RobinHoodPennyStocks,TNXP,35,35,0,35,1,15,1,1,NASDAQ
3656,04-02-2021 06:00,24 hrs.,stocks,HOL,6,6,0,6,1,1,0,1,NASDAQ
3656,04-02-2021 06:00,24 hrs.,stocks,SEEL,6,6,0,6,1,1,0,1,NASDAQ
3656,04-02-2021 06:00,24 hrs.,stocks,TLSA,6,6,0,6,1,1,0,1,NASDAQ
3656,04-02-2021 06:00,24 hrs.,stocks,TSIA,6,6,0,6,1,1,0,1,NASDAQ
3656,04-02-2021 06:00,24 hrs.,Daytrading,TAKOF,6,6,0,6,1,1,0,1,OTC
3656,04-02-2021 06:00,24 hrs.,trakstocks,CPSH,166,166,0,166,1,60,42,1,NASDAQ
3656,04-02-2021 06:00,24 hrs.,StockMarket,MMEDF,6,6,0,6,1,1,0,1,OTC
3656,04-02-2021 06:00,24 hrs.,StockMarket,RYCEY,6,6,0,6,1,1,0,1,OTC
3656,04-02-2021 06:00,24 hrs.,StockMarket,SPCE,6,6,0,6,1,1,0,1,NYSE
3656,04-02-2021 06:00,24 hrs.,pennystocks,INKW,6,6,0,6,1,1,0,1,OTC
3656,04-02-2021 06:00,24 hrs.,pennystocks,OZSC,12,12,0,12,2,2,0,2,OTC
3656,04-02-2021 06:00,24 hrs.,pennystocks,SGMD,6,6,0,6,1,1,0,1,OTC
3656,04-02-2021 06:00,24 hrs.,pennystocks,TAKOF,6,6,0,6,1,1,0,1,OTC
3656,04-02-2021 06:00,24 hrs.,pennystocks,AMC,6,6,0,6,1,1,0,1,NYSE
3656,04-02-2021 06:00,24 hrs.,pennystocks,III,7,7,0,7,1,1,1,1,NASDAQ
3656,04-02-2021 06:00,24 hrs.,pennystocks,ADIL,6,6,0,6,1,1,0,1,NASDAQ
3656,04-02-2021 06:00,24 hrs.,pennystocks,ADMA,6,6,0,6,1,1,0,1,NASDAQ
3656,04-02-2021 06:00,24 hrs.,pennystocks,CTXR,7,7,0,7,1,1,1,1,NASDAQ
3656,04-02-2021 06:00,24 hrs.,pennystocks,GRNQ,7,7,0,7,1,1,1,1,NASDAQ
3656,04-02-2021 06:00,24 hrs.,wallstreetbets,NWBO,6,6,0,6,1,1,0,1,OTC
3656,04-02-2021 06:00,24 hrs.,wallstreetbets,OVTZ,7,7,0,7,1,1,1,1,OTC
3656,04-02-2021 06:00,24 hrs.,wallstreetbets,TSNP,6,6,0,6,1,1,0,1,OTC
3656,04-02-2021 06:00,24 hrs.,wallstreetbets,AGFAF,6,6,0,6,1,1,0,1,OTC
3656,04-02-2021 06:00,24 hrs.,wallstreetbets,CRMBQ,6,6,0,6,1,1,0,1,OTC
3656,04-02-2021 06:00,24 hrs.,wallstreetbets,HOFSQ,6,6,0,6,1,1,0,1,OTC
3656,04-02-2021 06:00,24 hrs.,wallstreetbets,AMC,145,145,0,145,23,24,5,21,NYSE
3656,04-02-2021 06:00,24 hrs.,wallstreetbets,GME,1348,1348,0,1348,41,545,94,33,NYSE
3656,04-02-2021 06:00,24 hrs.,wallstreetbets,NOK,12,12,0,12,2,2,0,2,NYSE
3656,04-02-2021 06:00,24 hrs.,wallstreetbets,PSA,157,157,0,157,1,73,7,1,NYSE
3656,04-02-2021 06:00,24 hrs.,wallstreetbets,RYN,6,6,0,6,1,1,0,1,NYSE
3656,04-02-2021 06:00,24 hrs.,wallstreetbets,WMC,6,6,0,6,1,1,0,1,NYSE
3656,04-02-2021 06:00,24 hrs.,wallstreetbets,HYLN,12,12,0,12,2,2,0,1,NYSE
3656,04-02-2021 06:00,24 hrs.,wallstreetbets,SPCE,43,43,0,43,7,7,1,1,NYSE
3656,04-02-2021 06:00,24 hrs.,wallstreetbets,APHA,6,6,0,6,1,1,0,1,NASDAQ
3656,04-02-2021 06:00,24 hrs.,wallstreetbets,DGLY,6,6,0,6,1,1,0,1,NASDAQ
3656,04-02-2021 06:00,24 hrs.,wallstreetbets,GLMD,6,6,0,6,1,1,0,1,NASDAQ
3656,04-02-2021 06:00,24 hrs.,wallstreetbets,MNKD,6,6,0,6,1,1,0,1,NASDAQ
3656,04-02-2021 06:00,24 hrs.,wallstreetbets,NAKD,7,7,0,7,1,1,1,1,NASDAQ
3656,04-02-2021 06:00,24 hrs.,wallstreetbets,NCLH,6,6,0,6,1,1,0,1,NASDAQ
3656,04-02-2021 06:00,24 hrs.,wallstreetbets,SNDL,19,19,0,19,3,3,1,3,NASDAQ
3656,04-02-2021 06:00,24 hrs.,wallstreetbets,SRNE,6,6,0,6,1,1,0,1,NASDAQ
3656,04-02-2021 06:00,24 hrs.,wallstreetbets,TYME,6,6,0,6,1,1,0,1,NASDAQ
3656,04-02-2021 06:00,24 hrs.,RobinHoodPennyStocks,SNDL,30,30,0,30,1,6,14,1,NASDAQ
3656,04-02-2021 06:00,24 hrs.,stocks,CCIV,6,6,0,6,1,1,0,1,NYSE
3643,04-02-2021 04:00,24 hrs.,wallstreetbets,DGLY,6,6,0,6,1,1,0,1,NASDAQ
3643,04-02-2021 04:00,24 hrs.,wallstreetbets,APHA,6,6,0,6,1,1,0,1,NASDAQ
3643,04-02-2021 04:00,24 hrs.,wallstreetbets,MNKD,6,6,0,6,1,1,0,1,NASDAQ
3643,04-02-2021 04:00,24 hrs.,wallstreetbets,NAKD,7,7,0,7,1,1,1,1,NASDAQ
3643,04-02-2021 04:00,24 hrs.,wallstreetbets,NCLH,6,6,0,6,1,1,0,1,NASDAQ
3643,04-02-2021 04:00,24 hrs.,wallstreetbets,SNDL,19,19,0,19,3,3,1,3,NASDAQ
3643,04-02-2021 04:00,24 hrs.,wallstreetbets,SRNE,6,6,0,6,1,1,0,1,NASDAQ
3643,04-02-2021 04:00,24 hrs.,wallstreetbets,TYME,6,6,0,6,1,1,0,1,NASDAQ
3643,04-02-2021 04:00,24 hrs.,RobinHoodPennyStocks,SNDL,23,23,0,23,1,5,9,1,NASDAQ
3643,04-02-2021 04:00,24 hrs.,RobinHoodPennyStocks,TNXP,29,29,0,29,1,12,1,1,NASDAQ
3643,04-02-2021 04:00,24 hrs.,stocks,NOK,6,6,0,6,1,1,0,1,NYSE
3643,04-02-2021 04:00,24 hrs.,stocks,CCIV,6,6,0,6,1,1,0,1,NYSE
3643,04-02-2021 04:00,24 hrs.,stocks,HOL,6,6,0,6,1,1,0,1,NASDAQ
3643,04-02-2021 04:00,24 hrs.,stocks,SEEL,6,6,0,6,1,1,0,1,NASDAQ
3643,04-02-2021 04:00,24 hrs.,stocks,TLSA,6,6,0,6,1,1,0,1,NASDAQ
3643,04-02-2021 04:00,24 hrs.,stocks,TSIA,6,6,0,6,1,1,0,1,NASDAQ
3643,04-02-2021 04:00,24 hrs.,Daytrading,TAKOF,6,6,0,6,1,1,0,1,OTC
3643,04-02-2021 04:00,24 hrs.,trakstocks,CPSH,154,154,0,154,1,55,40,1,NASDAQ
3643,04-02-2021 04:00,24 hrs.,StockMarket,MMEDF,6,6,0,6,1,1,0,1,OTC
3643,04-02-2021 04:00,24 hrs.,StockMarket,RYCEY,6,6,0,6,1,1,0,1,OTC
3643,04-02-2021 04:00,24 hrs.,StockMarket,SPCE,6,6,0,6,1,1,0,1,NYSE
3643,04-02-2021 04:00,24 hrs.,pennystocks,INKW,6,6,0,6,1,1,0,1,OTC
3643,04-02-2021 04:00,24 hrs.,pennystocks,OZSC,12,12,0,12,2,2,0,2,OTC
3643,04-02-2021 04:00,24 hrs.,pennystocks,SGMD,6,6,0,6,1,1,0,1,OTC
3643,04-02-2021 04:00,24 hrs.,pennystocks,TAKOF,6,6,0,6,1,1,0,1,OTC
3643,04-02-2021 04:00,24 hrs.,pennystocks,AMC,6,6,0,6,1,1,0,1,NYSE
3643,04-02-2021 04:00,24 hrs.,pennystocks,III,7,7,0,7,1,1,1,1,NASDAQ
3643,04-02-2021 04:00,24 hrs.,pennystocks,ADIL,6,6,0,6,1,1,0,1,NASDAQ
3643,04-02-2021 04:00,24 hrs.,pennystocks,ADMA,6,6,0,6,1,1,0,1,NASDAQ
3643,04-02-2021 04:00,24 hrs.,pennystocks,CTXR,7,7,0,7,1,1,1,1,NASDAQ
3643,04-02-2021 04:00,24 hrs.,pennystocks,GRNQ,7,7,0,7,1,1,1,1,NASDAQ
3643,04-02-2021 04:00,24 hrs.,wallstreetbets,NWBO,6,6,0,6,1,1,0,1,OTC
3643,04-02-2021 04:00,24 hrs.,wallstreetbets,OVTZ,7,7,0,7,1,1,1,1,OTC
3643,04-02-2021 04:00,24 hrs.,wallstreetbets,TSNP,6,6,0,6,1,1,0,1,OTC
3643,04-02-2021 04:00,24 hrs.,wallstreetbets,AGFAF,6,6,0,6,1,1,0,1,OTC
3643,04-02-2021 04:00,24 hrs.,wallstreetbets,CRMBQ,6,6,0,6,1,1,0,1,OTC
3643,04-02-2021 04:00,24 hrs.,wallstreetbets,HOFSQ,6,6,0,6,1,1,0,1,OTC
3643,04-02-2021 04:00,24 hrs.,wallstreetbets,AMC,145,145,0,145,23,24,5,21,NYSE
3643,04-02-2021 04:00,24 hrs.,wallstreetbets,GME,1338,1338,0,1338,41,540,94,33,NYSE
3643,04-02-2021 04:00,24 hrs.,wallstreetbets,NOK,12,12,0,12,2,2,0,2,NYSE
3643,04-02-2021 04:00,24 hrs.,wallstreetbets,PSA,162,162,0,162,1,76,6,1,NYSE
3643,04-02-2021 04:00,24 hrs.,wallstreetbets,RYN,6,6,0,6,1,1,0,1,NYSE
3643,04-02-2021 04:00,24 hrs.,wallstreetbets,WMC,6,6,0,6,1,1,0,1,NYSE
3643,04-02-2021 04:00,24 hrs.,wallstreetbets,HYLN,12,12,0,12,2,2,0,1,NYSE
3643,04-02-2021 04:00,24 hrs.,wallstreetbets,SPCE,43,43,0,43,7,7,1,1,NYSE
3643,04-02-2021 04:00,24 hrs.,wallstreetbets,GLMD,6,6,0,6,1,1,0,1,NASDAQ
3632,04-02-2021 02:00,24 hrs.,pennystocks,ADMA,6,6,0,6,1,1,0,1,NASDAQ
3632,04-02-2021 02:00,24 hrs.,pennystocks,ADIL,6,6,0,6,1,1,0,1,NASDAQ
3632,04-02-2021 02:00,24 hrs.,pennystocks,GRNQ,7,7,0,7,1,1,1,1,NASDAQ
3632,04-02-2021 02:00,24 hrs.,wallstreetbets,NWBO,6,6,0,6,1,1,0,1,OTC
3632,04-02-2021 02:00,24 hrs.,wallstreetbets,OVTZ,7,7,0,7,1,1,1,1,OTC
3632,04-02-2021 02:00,24 hrs.,wallstreetbets,TSNP,6,6,0,6,1,1,0,1,OTC
3632,04-02-2021 02:00,24 hrs.,wallstreetbets,AGFAF,6,6,0,6,1,1,0,1,OTC
3632,04-02-2021 02:00,24 hrs.,wallstreetbets,CRMBQ,6,6,0,6,1,1,0,1,OTC
3632,04-02-2021 02:00,24 hrs.,wallstreetbets,HOFSQ,6,6,0,6,1,1,0,1,OTC
3632,04-02-2021 02:00,24 hrs.,wallstreetbets,AMC,145,145,0,145,23,24,5,21,NYSE
3632,04-02-2021 02:00,24 hrs.,wallstreetbets,GME,1348,1348,0,1348,41,545,94,33,NYSE
3632,04-02-2021 02:00,24 hrs.,wallstreetbets,NOK,12,12,0,12,2,2,0,2,NYSE
3632,04-02-2021 02:00,24 hrs.,wallstreetbets,PSA,152,152,0,152,1,71,6,1,NYSE
3632,04-02-2021 02:00,24 hrs.,wallstreetbets,RYN,6,6,0,6,1,1,0,1,NYSE
3632,04-02-2021 02:00,24 hrs.,wallstreetbets,WMC,6,6,0,6,1,1,0,1,NYSE
3632,04-02-2021 02:00,24 hrs.,wallstreetbets,HYLN,12,12,0,12,2,2,0,1,NYSE
3632,04-02-2021 02:00,24 hrs.,wallstreetbets,SPCE,43,43,0,43,7,7,1,1,NYSE
3632,04-02-2021 02:00,24 hrs.,wallstreetbets,APHA,6,6,0,6,1,1,0,1,NASDAQ
3632,04-02-2021 02:00,24 hrs.,wallstreetbets,DGLY,6,6,0,6,1,1,0,1,NASDAQ
3632,04-02-2021 02:00,24 hrs.,wallstreetbets,GLMD,6,6,0,6,1,1,0,1,NASDAQ
3632,04-02-2021 02:00,24 hrs.,wallstreetbets,MNKD,6,6,0,6,1,1,0,1,NASDAQ
3632,04-02-2021 02:00,24 hrs.,wallstreetbets,NAKD,7,7,0,7,1,1,1,1,NASDAQ
3632,04-02-2021 02:00,24 hrs.,wallstreetbets,NCLH,6,6,0,6,1,1,0,1,NASDAQ
3632,04-02-2021 02:00,24 hrs.,wallstreetbets,SNDL,19,19,0,19,3,3,1,3,NASDAQ
3632,04-02-2021 02:00,24 hrs.,wallstreetbets,SRNE,6,6,0,6,1,1,0,1,NASDAQ
3632,04-02-2021 02:00,24 hrs.,wallstreetbets,TYME,6,6,0,6,1,1,0,1,NASDAQ
3632,04-02-2021 02:00,24 hrs.,RobinHoodPennyStocks,SNDL,25,25,0,25,1,7,7,1,NASDAQ
3632,04-02-2021 02:00,24 hrs.,RobinHoodPennyStocks,TNXP,31,31,0,31,1,13,1,1,NASDAQ
3632,04-02-2021 02:00,24 hrs.,stocks,NOK,6,6,0,6,1,1,0,1,NYSE
3632,04-02-2021 02:00,24 hrs.,stocks,CCIV,6,6,0,6,1,1,0,1,NYSE
3632,04-02-2021 02:00,24 hrs.,stocks,HOL,6,6,0,6,1,1,0,1,NASDAQ
3632,04-02-2021 02:00,24 hrs.,stocks,SEEL,6,6,0,6,1,1,0,1,NASDAQ
3632,04-02-2021 02:00,24 hrs.,stocks,TLSA,6,6,0,6,1,1,0,1,NASDAQ
3632,04-02-2021 02:00,24 hrs.,stocks,TSIA,6,6,0,6,1,1,0,1,NASDAQ
3632,04-02-2021 02:00,24 hrs.,Daytrading,TAKOF,6,6,0,6,1,1,0,1,OTC
3632,04-02-2021 02:00,24 hrs.,trakstocks,CPSH,117,117,0,117,1,43,27,1,NASDAQ
3632,04-02-2021 02:00,24 hrs.,StockMarket,MMEDF,6,6,0,6,1,1,0,1,OTC
3632,04-02-2021 02:00,24 hrs.,StockMarket,RYCEY,6,6,0,6,1,1,0,1,OTC
3632,04-02-2021 02:00,24 hrs.,StockMarket,SPCE,6,6,0,6,1,1,0,1,NYSE
3632,04-02-2021 02:00,24 hrs.,pennystocks,INKW,6,6,0,6,1,1,0,1,OTC
3632,04-02-2021 02:00,24 hrs.,pennystocks,OZSC,12,12,0,12,2,2,0,2,OTC
3632,04-02-2021 02:00,24 hrs.,pennystocks,SGMD,6,6,0,6,1,1,0,1,OTC
3632,04-02-2021 02:00,24 hrs.,pennystocks,TAKOF,6,6,0,6,1,1,0,1,OTC
3632,04-02-2021 02:00,24 hrs.,pennystocks,AMC,6,6,0,6,1,1,0,1,NYSE
3632,04-02-2021 02:00,24 hrs.,pennystocks,III,7,7,0,7,1,1,1,1,NASDAQ
3632,04-02-2021 02:00,24 hrs.,pennystocks,CTXR,7,7,0,7,1,1,1,1,NASDAQ
3619,04-02-2021 00:00,24 hrs.,stocks,NOK,6,6,0,6,1,1,0,1,NYSE
3619,04-02-2021 00:00,24 hrs.,RobinHoodPennyStocks,TNXP,29,29,0,29,1,12,1,1,NASDAQ
3619,04-02-2021 00:00,24 hrs.,stocks,HOL,6,6,0,6,1,1,0,1,NASDAQ
3619,04-02-2021 00:00,24 hrs.,stocks,SEEL,6,6,0,6,1,1,0,1,NASDAQ
3619,04-02-2021 00:00,24 hrs.,stocks,TLSA,6,6,0,6,1,1,0,1,NASDAQ
3619,04-02-2021 00:00,24 hrs.,stocks,TSIA,6,6,0,6,1,1,0,1,NASDAQ
3619,04-02-2021 00:00,24 hrs.,Daytrading,TAKOF,6,6,0,6,1,1,0,1,OTC
3619,04-02-2021 00:00,24 hrs.,trakstocks,CPSH,102,102,0,102,1,39,20,1,NASDAQ
3619,04-02-2021 00:00,24 hrs.,StockMarket,MMEDF,6,6,0,6,1,1,0,1,OTC
3619,04-02-2021 00:00,24 hrs.,StockMarket,RYCEY,6,6,0,6,1,1,0,1,OTC
3619,04-02-2021 00:00,24 hrs.,StockMarket,SPCE,6,6,0,6,1,1,0,1,NYSE
3619,04-02-2021 00:00,24 hrs.,pennystocks,INKW,6,6,0,6,1,1,0,1,OTC
3619,04-02-2021 00:00,24 hrs.,pennystocks,OZSC,12,12,0,12,2,2,0,2,OTC
3619,04-02-2021 00:00,24 hrs.,pennystocks,SGMD,6,6,0,6,1,1,0,1,OTC
3619,04-02-2021 00:00,24 hrs.,pennystocks,TAKOF,6,6,0,6,1,1,0,1,OTC
3619,04-02-2021 00:00,24 hrs.,pennystocks,AMC,6,6,0,6,1,1,0,1,NYSE
3619,04-02-2021 00:00,24 hrs.,pennystocks,III,7,7,0,7,1,1,1,1,NASDAQ
3619,04-02-2021 00:00,24 hrs.,pennystocks,ADIL,6,6,0,6,1,1,0,1,NASDAQ
3619,04-02-2021 00:00,24 hrs.,pennystocks,ADMA,6,6,0,6,1,1,0,1,NASDAQ
3619,04-02-2021 00:00,24 hrs.,pennystocks,CTXR,7,7,0,7,1,1,1,1,NASDAQ
3619,04-02-2021 00:00,24 hrs.,pennystocks,GRNQ,7,7,0,7,1,1,1,1,NASDAQ
3619,04-02-2021 00:00,24 hrs.,wallstreetbets,NWBO,6,6,0,6,1,1,0,1,OTC
3619,04-02-2021 00:00,24 hrs.,wallstreetbets,OVTZ,7,7,0,7,1,1,1,1,OTC
3619,04-02-2021 00:00,24 hrs.,wallstreetbets,TSNP,6,6,0,6,1,1,0,1,OTC
3619,04-02-2021 00:00,24 hrs.,wallstreetbets,AGFAF,6,6,0,6,1,1,0,1,OTC
3619,04-02-2021 00:00,24 hrs.,wallstreetbets,CRMBQ,6,6,0,6,1,1,0,1,OTC
3619,04-02-2021 00:00,24 hrs.,wallstreetbets,HOFSQ,6,6,0,6,1,1,0,1,OTC
3619,04-02-2021 00:00,24 hrs.,wallstreetbets,AMC,145,145,0,145,23,24,5,21,NYSE
3619,04-02-2021 00:00,24 hrs.,wallstreetbets,GME,1326,1326,0,1326,41,534,94,33,NYSE
3619,04-02-2021 00:00,24 hrs.,wallstreetbets,NOK,12,12,0,12,2,2,0,2,NYSE
3619,04-02-2021 00:00,24 hrs.,wallstreetbets,PSA,144,144,0,144,1,68,4,1,NYSE
3619,04-02-2021 00:00,24 hrs.,wallstreetbets,RYN,6,6,0,6,1,1,0,1,NYSE
3619,04-02-2021 00:00,24 hrs.,wallstreetbets,WMC,6,6,0,6,1,1,0,1,NYSE
3619,04-02-2021 00:00,24 hrs.,wallstreetbets,HYLN,12,12,0,12,2,2,0,1,NYSE
3619,04-02-2021 00:00,24 hrs.,wallstreetbets,SPCE,43,43,0,43,7,7,1,1,NYSE
3619,04-02-2021 00:00,24 hrs.,wallstreetbets,APHA,6,6,0,6,1,1,0,1,NASDAQ
3619,04-02-2021 00:00,24 hrs.,wallstreetbets,DGLY,6,6,0,6,1,1,0,1,NASDAQ
3619,04-02-2021 00:00,24 hrs.,wallstreetbets,GLMD,6,6,0,6,1,1,0,1,NASDAQ
3619,04-02-2021 00:00,24 hrs.,wallstreetbets,MNKD,6,6,0,6,1,1,0,1,NASDAQ
3619,04-02-2021 00:00,24 hrs.,wallstreetbets,NAKD,7,7,0,7,1,1,1,1,NASDAQ
3619,04-02-2021 00:00,24 hrs.,wallstreetbets,NCLH,6,6,0,6,1,1,0,1,NASDAQ
3619,04-02-2021 00:00,24 hrs.,wallstreetbets,SNDL,19,19,0,19,3,3,1,3,NASDAQ
3619,04-02-2021 00:00,24 hrs.,wallstreetbets,SRNE,6,6,0,6,1,1,0,1,NASDAQ
3619,04-02-2021 00:00,24 hrs.,wallstreetbets,TYME,6,6,0,6,1,1,0,1,NASDAQ
3619,04-02-2021 00:00,24 hrs.,RobinHoodPennyStocks,SNDL,29,29,0,29,1,9,7,1,NASDAQ
3619,04-02-2021 00:00,24 hrs.,stocks,CCIV,6,6,0,6,1,1,0,1,NYSE
3607,03-02-2021 22:00,24 hrs.,pennystocks,ADMA,6,6,0,6,1,1,0,1,NASDAQ
3607,03-02-2021 22:00,24 hrs.,pennystocks,CTXR,7,7,0,7,1,1,1,1,NASDAQ
3607,03-02-2021 22:00,24 hrs.,pennystocks,GRNQ,7,7,0,7,1,1,1,1,NASDAQ
3607,03-02-2021 22:00,24 hrs.,wallstreetbets,NWBO,6,6,0,6,1,1,0,1,OTC
3607,03-02-2021 22:00,24 hrs.,wallstreetbets,OVTZ,7,7,0,7,1,1,1,1,OTC
3607,03-02-2021 22:00,24 hrs.,wallstreetbets,TSNP,6,6,0,6,1,1,0,1,OTC
3607,03-02-2021 22:00,24 hrs.,wallstreetbets,AGFAF,6,6,0,6,1,1,0,1,OTC
3607,03-02-2021 22:00,24 hrs.,wallstreetbets,CRMBQ,6,6,0,6,1,1,0,1,OTC
3607,03-02-2021 22:00,24 hrs.,wallstreetbets,HOFSQ,6,6,0,6,1,1,0,1,OTC
3607,03-02-2021 22:00,24 hrs.,wallstreetbets,AMC,145,145,0,145,23,24,5,22,NYSE
3607,03-02-2021 22:00,24 hrs.,wallstreetbets,GME,1302,1302,0,1302,41,523,92,33,NYSE
3607,03-02-2021 22:00,24 hrs.,wallstreetbets,NOK,12,12,0,12,2,2,0,2,NYSE
3607,03-02-2021 22:00,24 hrs.,wallstreetbets,PSA,137,137,0,137,1,65,3,1,NYSE
3607,03-02-2021 22:00,24 hrs.,wallstreetbets,RYN,6,6,0,6,1,1,0,1,NYSE
3607,03-02-2021 22:00,24 hrs.,wallstreetbets,WMC,6,6,0,6,1,1,0,1,NYSE
3607,03-02-2021 22:00,24 hrs.,wallstreetbets,HYLN,12,12,0,12,2,2,0,1,NYSE
3607,03-02-2021 22:00,24 hrs.,wallstreetbets,SPCE,43,43,0,43,7,7,1,1,NYSE
3607,03-02-2021 22:00,24 hrs.,wallstreetbets,APHA,6,6,0,6,1,1,0,1,NASDAQ
3607,03-02-2021 22:00,24 hrs.,wallstreetbets,DGLY,6,6,0,6,1,1,0,1,NASDAQ
3607,03-02-2021 22:00,24 hrs.,wallstreetbets,GLMD,6,6,0,6,1,1,0,1,NASDAQ
3607,03-02-2021 22:00,24 hrs.,wallstreetbets,MNKD,6,6,0,6,1,1,0,1,NASDAQ
3607,03-02-2021 22:00,24 hrs.,wallstreetbets,NAKD,7,7,0,7,1,1,1,1,NASDAQ
3607,03-02-2021 22:00,24 hrs.,wallstreetbets,NCLH,6,6,0,6,1,1,0,1,NASDAQ
3607,03-02-2021 22:00,24 hrs.,wallstreetbets,SNDL,19,19,0,19,3,3,1,3,NASDAQ
3607,03-02-2021 22:00,24 hrs.,wallstreetbets,SRNE,6,6,0,6,1,1,0,1,NASDAQ
3607,03-02-2021 22:00,24 hrs.,wallstreetbets,TYME,6,6,0,6,1,1,0,1,NASDAQ
3607,03-02-2021 22:00,24 hrs.,RobinHoodPennyStocks,SNDL,25,25,0,25,1,7,7,1,NASDAQ
3607,03-02-2021 22:00,24 hrs.,RobinHoodPennyStocks,TNXP,29,29,0,29,1,12,1,1,NASDAQ
3607,03-02-2021 22:00,24 hrs.,stocks,NOK,6,6,0,6,1,1,0,1,NYSE
3607,03-02-2021 22:00,24 hrs.,stocks,CCIV,6,6,0,6,1,1,0,1,NYSE
3607,03-02-2021 22:00,24 hrs.,stocks,HOL,6,6,0,6,1,1,0,1,NASDAQ
3607,03-02-2021 22:00,24 hrs.,stocks,SEEL,6,6,0,6,1,1,0,1,NASDAQ
3607,03-02-2021 22:00,24 hrs.,stocks,TLSA,6,6,0,6,1,1,0,1,NASDAQ
3607,03-02-2021 22:00,24 hrs.,stocks,TSIA,6,6,0,6,1,1,0,1,NASDAQ
3607,03-02-2021 22:00,24 hrs.,Daytrading,TAKOF,6,6,0,6,1,1,0,1,OTC
3607,03-02-2021 22:00,24 hrs.,trakstocks,CPSH,60,60,0,60,1,22,12,1,NASDAQ
3607,03-02-2021 22:00,24 hrs.,StockMarket,MMEDF,6,6,0,6,1,1,0,1,OTC
3607,03-02-2021 22:00,24 hrs.,StockMarket,RYCEY,6,6,0,6,1,1,0,1,OTC
3607,03-02-2021 22:00,24 hrs.,StockMarket,SPCE,6,6,0,6,1,1,0,1,NYSE
3607,03-02-2021 22:00,24 hrs.,pennystocks,INKW,6,6,0,6,1,1,0,1,OTC
3607,03-02-2021 22:00,24 hrs.,pennystocks,OZSC,12,12,0,12,2,2,0,2,OTC
3607,03-02-2021 22:00,24 hrs.,pennystocks,SGMD,6,6,0,6,1,1,0,1,OTC
3607,03-02-2021 22:00,24 hrs.,pennystocks,TAKOF,6,6,0,6,1,1,0,1,OTC
3607,03-02-2021 22:00,24 hrs.,pennystocks,AMC,6,6,0,6,1,1,0,1,NYSE
3607,03-02-2021 22:00,24 hrs.,pennystocks,III,7,7,0,7,1,1,1,1,NASDAQ
3607,03-02-2021 22:00,24 hrs.,pennystocks,ADIL,6,6,0,6,1,1,0,1,NASDAQ
3606,03-02-2021 21:16,24 hrs.,stocks,NOK,6,6,0,6,1,1,0,1,NYSE
3606,03-02-2021 21:16,24 hrs.,RobinHoodPennyStocks,TNXP,22,22,0,22,1,9,0,1,NASDAQ
3606,03-02-2021 21:16,24 hrs.,stocks,HOL,6,6,0,6,1,1,0,1,NASDAQ
3606,03-02-2021 21:16,24 hrs.,stocks,SEEL,6,6,0,6,1,1,0,1,NASDAQ
3606,03-02-2021 21:16,24 hrs.,stocks,TLSA,6,6,0,6,1,1,0,1,NASDAQ
3606,03-02-2021 21:16,24 hrs.,stocks,TSIA,6,6,0,6,1,1,0,1,NASDAQ
3606,03-02-2021 21:16,24 hrs.,Daytrading,TAKOF,6,6,0,6,1,1,0,1,OTC
3606,03-02-2021 21:16,24 hrs.,trakstocks,CPSH,46,46,0,46,1,17,8,1,NASDAQ
3606,03-02-2021 21:16,24 hrs.,StockMarket,MMEDF,6,6,0,6,1,1,0,1,OTC
3606,03-02-2021 21:16,24 hrs.,StockMarket,RYCEY,6,6,0,6,1,1,0,1,OTC
3606,03-02-2021 21:16,24 hrs.,StockMarket,SPCE,6,6,0,6,1,1,0,1,NYSE
3606,03-02-2021 21:16,24 hrs.,pennystocks,INKW,6,6,0,6,1,1,0,1,OTC
3606,03-02-2021 21:16,24 hrs.,pennystocks,OZSC,12,12,0,12,2,2,0,2,OTC
3606,03-02-2021 21:16,24 hrs.,pennystocks,SGMD,6,6,0,6,1,1,0,1,OTC
3606,03-02-2021 21:16,24 hrs.,pennystocks,TAKOF,6,6,0,6,1,1,0,1,OTC
3606,03-02-2021 21:16,24 hrs.,pennystocks,AMC,6,6,0,6,1,1,0,1,NYSE
3606,03-02-2021 21:16,24 hrs.,pennystocks,III,7,7,0,7,1,1,1,1,NASDAQ
3606,03-02-2021 21:16,24 hrs.,pennystocks,ADIL,6,6,0,6,1,1,0,1,NASDAQ
3606,03-02-2021 21:16,24 hrs.,pennystocks,ADMA,6,6,0,6,1,1,0,1,NASDAQ
3606,03-02-2021 21:16,24 hrs.,pennystocks,CTXR,7,7,0,7,1,1,1,1,NASDAQ
3606,03-02-2021 21:16,24 hrs.,pennystocks,GRNQ,7,7,0,7,1,1,1,1,NASDAQ
3606,03-02-2021 21:16,24 hrs.,wallstreetbets,NWBO,6,6,0,6,1,1,0,1,OTC
3606,03-02-2021 21:16,24 hrs.,wallstreetbets,OVTZ,7,7,0,7,1,1,1,1,OTC
3606,03-02-2021 21:16,24 hrs.,wallstreetbets,TSNP,6,6,0,6,1,1,0,1,OTC
3606,03-02-2021 21:16,24 hrs.,wallstreetbets,AGFAF,6,6,0,6,1,1,0,1,OTC
3606,03-02-2021 21:16,24 hrs.,wallstreetbets,CRMBQ,6,6,0,6,1,1,0,1,OTC
3606,03-02-2021 21:16,24 hrs.,wallstreetbets,HOFSQ,6,6,0,6,1,1,0,1,OTC
3606,03-02-2021 21:16,24 hrs.,wallstreetbets,AMC,145,145,0,145,23,24,5,22,NYSE
3606,03-02-2021 21:16,24 hrs.,wallstreetbets,GME,1245,1245,0,1245,41,495,91,33,NYSE
3606,03-02-2021 21:16,24 hrs.,wallstreetbets,NOK,12,12,0,12,2,2,0,2,NYSE
3606,03-02-2021 21:16,24 hrs.,wallstreetbets,PSA,133,133,0,133,1,63,3,1,NYSE
3606,03-02-2021 21:16,24 hrs.,wallstreetbets,RYN,6,6,0,6,1,1,0,1,NYSE
3606,03-02-2021 21:16,24 hrs.,wallstreetbets,WMC,6,6,0,6,1,1,0,1,NYSE
3606,03-02-2021 21:16,24 hrs.,wallstreetbets,HYLN,12,12,0,12,2,2,0,1,NYSE
3606,03-02-2021 21:16,24 hrs.,wallstreetbets,SPCE,43,43,0,43,7,7,1,1,NYSE
3606,03-02-2021 21:16,24 hrs.,wallstreetbets,APHA,6,6,0,6,1,1,0,1,NASDAQ
3606,03-02-2021 21:16,24 hrs.,wallstreetbets,DGLY,6,6,0,6,1,1,0,1,NASDAQ
3606,03-02-2021 21:16,24 hrs.,wallstreetbets,GLMD,6,6,0,6,1,1,0,1,NASDAQ
3606,03-02-2021 21:16,24 hrs.,wallstreetbets,MNKD,6,6,0,6,1,1,0,1,NASDAQ
3606,03-02-2021 21:16,24 hrs.,wallstreetbets,NAKD,7,7,0,7,1,1,1,1,NASDAQ
3606,03-02-2021 21:16,24 hrs.,wallstreetbets,NCLH,6,6,0,6,1,1,0,1,NASDAQ
3606,03-02-2021 21:16,24 hrs.,wallstreetbets,SNDL,19,19,0,19,3,3,1,3,NASDAQ
3606,03-02-2021 21:16,24 hrs.,wallstreetbets,SRNE,6,6,0,6,1,1,0,1,NASDAQ
3606,03-02-2021 21:16,24 hrs.,wallstreetbets,TYME,6,6,0,6,1,1,0,1,NASDAQ
3606,03-02-2021 21:16,24 hrs.,RobinHoodPennyStocks,SNDL,23,23,0,23,1,7,5,1,NASDAQ
3606,03-02-2021 21:16,24 hrs.,stocks,CCIV,6,6,0,6,1,1,0,1,NYSE
